chrom	geneName	splicedExonStart	splicedExonEnd	splicedExonReadCount(rc)	splicedExonLength(sl)	othersExonsReadCount(RC)	othersExonsLength(L)	RC - rc	L - sl	splicedExonAverageReadCoverage(n)	otherExonsAverageReadCoverage(N)
chr1	LINC01409	804841	804966	0	126	30465	6771	30465	6645	0.0	4.584650112866817
chr1	LINC01409	782044	782136	256	93	30465	6771	30209	6678	2.752688172043011	4.52365977837676
chr1	LINC01128	852015	852110	677	96	50545	13620	49868	13524	7.052083333333333	3.6873706004140785
chr1	LINC01128	852095	852110	16	16	50545	13620	50529	13604	1.0	3.7142752131725962
chr1	LINC01128	841374	844498	8466	3125	50545	13620	42079	10495	2.70912	4.009433063363506
chr1	LINC01128	855122	855136	15	15	50545	13620	50530	13605	1.0	3.7140757074604926
chr1	LINC01128	852111	852766	1558	656	50545	13620	48987	12964	2.375	3.778694847269361
chr1	LINC01128	827776	827853	0	78	50545	13620	50545	13542	0.0	3.7324619701668884
chr1	LINC01128	827850	827853	0	4	50545	13620	50545	13616	0.0	3.7121768507638073
chr1	LINC01128	852015	852094	661	80	50545	13620	49884	13540	8.2625	3.684194977843427
chr1	LINC01128	827854	828127	0	274	50545	13620	50545	13346	0.0	3.787277086767571
chr1	LINC01128	827850	828127	0	278	50545	13620	50545	13342	0.0	3.7884125318542945
chr1	SAMD11	939413	939460	55	48	10829	4083	10774	4035	1.1458333333333333	2.6701363073110285
chr1	KLHL17	964168	964180	0	13	1938	3324	1938	3311	0.0	0.585321655089097
chr1	ISG15	1001264	1001281	993	18	6900	864	5907	846	55.166666666666664	6.9822695035460995
chr1	TTLL10	1179738	1179853	0	116	13160	4015	13160	3899	0.0	3.3752244165170557
chr1	SCNN1D	1282316	1282319	0	4	22405	3430	22405	3426	0.0	6.539696438995914
chr1	MRPL20-AS1	1399686	1399689	0	4	0	2407	0	2403	0.0	0.0
chr1	MIB2	1623483	1623699	839	217	73128	7887	72289	7670	3.866359447004608	9.42490221642764
chr1	MIB2	1623680	1623699	74	20	73128	7887	73054	7867	3.7	9.286131943561713
chr1	MIB2	1623483	1623679	765	197	73128	7887	72363	7690	3.883248730964467	9.41001300390117
chr1	MMP23B	1633356	1633480	0	125	103840	2013	103840	1888	0.0	55.0
chr1	GABRD	2025402	2025432	0	31	102	4393	102	4362	0.0	0.023383768913342505
chr1	GABRD	2028288	2028292	0	5	102	4393	102	4388	0.0	0.02324521422060164
chr1	GABRD	2029267	2029408	0	142	102	4393	102	4251	0.0	0.02399435426958363
chr1	PLCH2	2502410	2502910	0	501	2749	6815	2749	6314	0.0	0.43538169147925243
chr1	TNFRSF14	2555851	2556252	0	402	0	4905	0	4503	0.0	0.0
chr1	TNFRSF14	2556033	2556252	0	220	0	4905	0	4685	0.0	0.0
chr1	TNFRSF14	2556253	2556261	0	9	0	4905	0	4896	0.0	0.0
chr1	SMIM1	3772789	3772841	0	53	7915	996	7915	943	0.0	8.393425238600212
chr1	DFFB	3858845	3858866	0	22	0	3880	0	3858	0.0	0.0
chr1	LINC01777	4412350	4412632	0	283	102	2582	102	2299	0.0	0.04436711613745106
chr1	KCNAB2	6097358	6097555	0	198	24733	13510	24733	13312	0.0	1.8579477163461537
chr1	KCNAB2	6034795	6034963	0	169	24733	13510	24733	13341	0.0	1.853909002323664
chr1	KCNAB2	6046184	6046357	9803	174	24733	13510	14930	13336	56.339080459770116	1.1195260947810437
chr1	KCNAB2	6094486	6094962	0	477	24733	13510	24733	13033	0.0	1.8977211693393692
chr1	ESPN	6448803	6449091	51	289	5713	6800	5662	6511	0.17647058823529413	0.8696052833666104
chr1	ZBTB48	6580050	6580136	0	87	236380	3499	236380	3412	0.0	69.27901524032825
chr1	ZBTB48	6580071	6580136	0	66	236380	3499	236380	3433	0.0	68.85522866297698
chr1	ZBTB48	6580050	6580070	0	21	236380	3499	236380	3478	0.0	67.96434732604945
chr1	LINC01672	6724851	6724855	73	5	5244	2191	5171	2186	14.6	2.365507776761208
chr1	PER3	7810568	7810588	0	21	17971	7397	17971	7376	0.0	2.4364154013015185
chr1	PARK7	7961736	7961793	0	58	997	2378	997	2320	0.0	0.42974137931034484
chr1	PARK7	7962082	7962101	0	20	997	2378	997	2358	0.0	0.42281594571670905
chr1	AL139424.2	10396371	10396376	6	6	8036	1237	8030	1231	1.0	6.523151909017059
chr1	TARDBP	11012429	11012480	0	52	102	4648	102	4596	0.0	0.022193211488250653
chr1	TARDBP	11012429	11012606	0	178	102	4648	102	4470	0.0	0.022818791946308724
chr1	TARDBP	11012481	11012606	0	126	102	4648	102	4522	0.0	0.022556390977443608
chr1	TARDBP	11022178	11022241	16	64	102	4648	86	4584	0.25	0.018760907504363003
chr1	TARDBP	11022242	11022250	9	9	102	4648	93	4639	1.0	0.020047424013796077
chr1	TARDBP	11022178	11022250	25	73	102	4648	77	4575	0.3424657534246575	0.016830601092896174
chr1	TARDBP	11022242	11022268	27	27	102	4648	75	4621	1.0	0.016230253191949793
chr1	TARDBP	11022251	11022268	18	18	102	4648	84	4630	1.0	0.01814254859611231
chr1	TARDBP	11022178	11022268	43	91	102	4648	59	4557	0.4725274725274725	0.01294711432960281
chr1	TARDBP	11023330	11023667	0	338	102	4648	102	4310	0.0	0.023665893271461718
chr1	EXOSC10-AS1	11099815	11099910	0	96	0	538	0	442	0.0	0.0
chr1	FBXO44	11658365	11658393	0	29	0	3061	0	3032	0.0	0.0
chr1	AGTRAP	11748590	11748610	0	21	212944	2351	212944	2330	0.0	91.39227467811159
chr1	MFN2	12007250	12007295	0	46	424359	10140	424359	10094	0.0	42.0407172577769
chr1	PDPN	13614406	13614411	0	6	0	3705	0	3699	0.0	0.0
chr1	PDPN	13584101	13584188	0	88	0	3705	0	3617	0.0	0.0
chr1	PDPN	13585569	13585639	0	71	0	3705	0	3634	0.0	0.0
chr1	PRDM2	13732856	13732882	0	27	701	10938	701	10911	0.0	0.06424709009256713
chr1	FHAD1	15341889	15341893	0	5	4423	11501	4423	11496	0.0	0.3847425191370912
chr1	DNAJC16	15566181	15566410	0	230	1531	7125	1531	6895	0.0	0.22204496011602612
chr1	DNAJC16	15566300	15566410	0	111	1531	7125	1531	7014	0.0	0.21827773025377817
chr1	DNAJC16	15566181	15566299	0	119	1531	7125	1531	7006	0.0	0.2185269768769626
chr1	FBLIM1	15756729	15756732	949	4	30156	4315	29207	4311	237.25	6.774994200881466
chr1	FBLIM1	15758330	15758355	48	26	30156	4315	30108	4289	1.8461538461538463	7.01981813942644
chr1	FBLIM1	15764548	15764685	1	138	30156	4315	30155	4177	0.007246376811594203	7.219296145559014
chr1	NECAP2	16447943	16447974	252	32	1660932	4594	1660680	4562	7.875	364.0245506356861
chr1	NECAP2	16440776	16440853	32	78	1660932	4594	1660900	4516	0.41025641025641024	367.7812223206377
chr1	BX284668.2	16873108	16873143	0	36	77	2347	77	2311	0.0	0.033318909562959756
chr1	BX284668.2	16873144	16873429	44	286	77	2347	33	2061	0.15384615384615385	0.01601164483260553
chr1	BX284668.2	16873108	16873507	77	400	77	2347	0	1947	0.1925	0.0
chr1	BX284668.2	16873144	16873507	77	364	77	2347	0	1983	0.21153846153846154	0.0
chr1	BX284668.2	16873430	16873507	33	78	77	2347	44	2269	0.4230769230769231	0.019391802556192154
chr1	LINC02810	17718721	17718791	0	71	3237	1332	3237	1261	0.0	2.5670103092783507
chr1	PLA2G5	20069033	20069034	0	2	8324	3257	8324	3255	0.0	2.5572964669738862
chr1	VWA5B1	20348359	20348376	0	18	135	6402	135	6384	0.0	0.021146616541353382
chr1	VWA5B1	20303213	20303349	0	137	135	6402	135	6265	0.0	0.02154828411811652
chr1	NBPF3	21478197	21478307	0	111	3157	6838	3157	6727	0.0	0.46930280957336107
chr1	NBPF3	21478228	21478307	0	80	3157	6838	3157	6758	0.0	0.4671500443918319
chr1	NBPF3	21478197	21478227	0	31	3157	6838	3157	6807	0.0	0.46378727780226237
chr1	LINC00339	22025640	22025945	0	306	23942	3569	23942	3263	0.0	7.337419552558995
chr1	LINC00339	22025644	22025945	0	302	23942	3569	23942	3267	0.0	7.328435873890419
chr1	LINC00339	22025946	22026119	0	174	23942	3569	23942	3395	0.0	7.052135493372607
chr1	LINC00339	22025644	22026119	0	476	23942	3569	23942	3093	0.0	7.740704817329454
chr1	LINC00339	22025640	22025643	0	4	23942	3569	23942	3565	0.0	6.7158485273492285
chr1	LINC00339	22025946	22026649	0	704	23942	3569	23942	2865	0.0	8.356719022687608
chr1	LINC00339	22026120	22026649	0	530	23942	3569	23942	3039	0.0	7.878249424152682
chr1	LINC00339	22025644	22026649	0	1006	23942	3569	23942	2563	0.0	9.341396800624269
chr1	LINC00339	22027535	22028379	12036	845	23942	3569	11906	2724	14.24378698224852	4.370778267254038
chr1	LINC00339	22027781	22028379	12036	599	23942	3569	11906	2970	20.093489148580968	4.008754208754209
chr1	CDC42	22052743	22052868	516	126	15009	13175	14493	13049	4.095238095238095	1.110659820675914
chr1	C1QC	22643715	22643737	0	23	0	1335	0	1312	0.0	0.0
chr1	C1QC	22643715	22643886	0	172	0	1335	0	1163	0.0	0.0
chr1	C1QC	22643738	22643886	0	149	0	1335	0	1186	0.0	0.0
chr1	ZNF436-AS1	23369325	23369513	0	189	1334	1052	1334	863	0.0	1.5457705677867903
chr1	RPL11	23691830	23692060	0	231	12009	2664	12009	2433	0.0	4.935881627620222
chr1	GRHL3	24319569	24319747	176	179	663	3924	487	3745	0.9832402234636871	0.1300400534045394
chr1	RCAN3	24503118	24503150	0	33	153	6672	153	6639	0.0	0.023045639403524627
chr1	SRRM1	24655124	24655129	0	6	2729	5651	2729	5645	0.0	0.48343666961913195
chr1	MTFR1L	25823324	25823439	304	116	11895	4825	11591	4709	2.6206896551724137	2.461456784880017
chr1	MTFR1L	25820350	25820414	0	65	11895	4825	11895	4760	0.0	2.4989495798319328
chr1	MTFR1L	25820350	25820659	0	310	11895	4825	11895	4515	0.0	2.6345514950166113
chr1	MTFR1L	25820415	25820659	0	245	11895	4825	11895	4580	0.0	2.5971615720524017
chr1	MTFR1L	25820922	25821003	0	82	11895	4825	11895	4743	0.0	2.5079063883617962
chr1	CNKSR1	26177581	26177599	212	19	92523	3847	92311	3828	11.157894736842104	24.11468129571578
chr1	CNKSR1	26183415	26183435	0	21	92523	3847	92523	3826	0.0	24.18269733403032
chr1	CATSPER4	26201042	26201075	166	34	20775	2040	20609	2006	4.882352941176471	10.273678963110669
chr1	ZPLD2P	26222757	26222770	377	14	967913	3201	967536	3187	26.928571428571427	303.588327580797
chr1	ZPLD2P	26223602	26223753	0	152	967913	3201	967913	3049	0.0	317.45260741226633
chr1	DHDDS	26432377	26432395	0	19	2827	5593	2827	5574	0.0	0.5071761750986724
chr1	DHDDS	26432377	26432415	0	39	2827	5593	2827	5554	0.0	0.5090025207057977
chr1	DHDDS	26432396	26432415	0	20	2827	5593	2827	5573	0.0	0.5072671810514983
chr1	DHDDS	26432377	26432518	0	142	2827	5593	2827	5451	0.0	0.5186204366171344
chr1	DHDDS	26432396	26432518	0	123	2827	5593	2827	5470	0.0	0.516819012797075
chr1	DHDDS	26432416	26432518	0	103	2827	5593	2827	5490	0.0	0.514936247723133
chr1	DHDDS	26432493	26432518	0	26	2827	5593	2827	5567	0.0	0.5078139033590803
chr1	DHDDS	26432377	26432594	0	218	2827	5593	2827	5375	0.0	0.525953488372093
chr1	DHDDS	26432396	26432594	0	199	2827	5593	2827	5394	0.0	0.5241008527994068
chr1	DHDDS	26432416	26432594	0	179	2827	5593	2827	5414	0.0	0.5221647580347248
chr1	DHDDS	26432519	26432594	0	76	2827	5593	2827	5517	0.0	0.512416168207359
chr1	DHDDS	26432493	26432594	0	102	2827	5593	2827	5491	0.0	0.5148424694955381
chr1	DHDDS	26432377	26432641	0	265	2827	5593	2827	5328	0.0	0.5305930930930931
chr1	DHDDS	26432396	26432641	0	246	2827	5593	2827	5347	0.0	0.5287076865532074
chr1	DHDDS	26432416	26432641	0	226	2827	5593	2827	5367	0.0	0.5267374697223774
chr1	DHDDS	26432519	26432641	0	123	2827	5593	2827	5470	0.0	0.516819012797075
chr1	DHDDS	26432595	26432641	0	47	2827	5593	2827	5546	0.0	0.5097367472051929
chr1	DHDDS	26432493	26432641	0	149	2827	5593	2827	5444	0.0	0.519287288758266
chr1	DHDDS	26432377	26432492	0	116	2827	5593	2827	5477	0.0	0.5161584809202118
chr1	DHDDS	26432396	26432492	0	97	2827	5593	2827	5496	0.0	0.5143740902474527
chr1	DHDDS	26432416	26432492	0	77	2827	5593	2827	5516	0.0	0.5125090645395214
chr1	DHDDS	26432416	26432723	0	308	2827	5593	2827	5285	0.0	0.5349101229895932
chr1	DHDDS	26432519	26432723	0	205	2827	5593	2827	5388	0.0	0.5246844840386043
chr1	DHDDS	26432595	26432723	0	129	2827	5593	2827	5464	0.0	0.5173865300146413
chr1	DHDDS	26432642	26432723	0	82	2827	5593	2827	5511	0.0	0.5129740518962076
chr1	DHDDS	26432493	26432723	0	231	2827	5593	2827	5362	0.0	0.5272286460276017
chr1	ARID1A	26696101	26697540	0	1440	112352	12546	112352	11106	0.0	10.116333513416171
chr1	PIGV	26795215	26795234	0	20	806961	5866	806961	5846	0.0	138.03643516934656
chr1	PIGV	26787990	26788268	0	279	806961	5866	806961	5587	0.0	144.43547521030965
chr1	PIGV	26788269	26788394	0	126	806961	5866	806961	5740	0.0	140.5855400696864
chr1	PIGV	26788269	26788819	51	551	806961	5866	806910	5315	0.0925589836660617	151.81749764816556
chr1	PIGV	26788395	26788819	51	425	806961	5866	806910	5441	0.12	148.30178276052197
chr1	ZDHHC18	26832054	26832072	0	19	1240	2665	1240	2646	0.0	0.46863189720332576
chr1	TRNP1	26994613	26994630	0	18	51	1981	51	1963	0.0	0.02598064187468161
chr1	AL445490.1	27669541	27669586	80	46	28988	1636	28908	1590	1.7391304347826086	18.181132075471698
chr1	PPP1R8	27830892	27831366	0	475	561	2822	561	2347	0.0	0.2390285470813805
chr1	PPP1R8	27831247	27831366	0	120	561	2822	561	2702	0.0	0.2076239822353812
chr1	PPP1R8	27830892	27831246	0	355	561	2822	561	2467	0.0	0.22740170247263883
chr1	THEMIS2	27872641	27872665	0	25	21416	2665	21416	2640	0.0	8.112121212121211
chr1	THEMIS2	27882078	27882125	0	48	21416	2665	21416	2617	0.0	8.183416125334352
chr1	MED18	28329125	28329180	0	56	3562	1315	3562	1259	0.0	2.8292295472597297
chr1	PHACTR4	28457856	28457859	3	4	2745	7336	2742	7332	0.75	0.3739770867430442
chr1	RCC1	28508902	28508905	0	4	117680	3738	117680	3734	0.0	31.515800749866095
chr1	RCC1	28516854	28516867	14	14	117680	3738	117666	3724	1.0	31.596670247046188
chr1	RCC1	28530574	28530615	36	42	117680	3738	117644	3696	0.8571428571428571	31.83008658008658
chr1	YTHDF2	28738330	28738338	36	9	7271	3737	7235	3728	4.0	1.9407188841201717
chr1	EPB41	29068769	29068783	45	15	325029	17917	324984	17902	3.0	18.15350240196626
chr1	EPB41	28914769	28914773	15	5	325029	17917	325014	17912	3.0	18.145042429656097
chr1	PTPRU	29311545	29311553	0	9	485	6715	485	6706	0.0	0.0723232925738145
chr1	MATN1-AS1	30719566	30721174	0	1609	0	3750	0	2141	0.0	0.0
chr1	MATN1-AS1	30719233	30721174	0	1942	0	3750	0	1808	0.0	0.0
chr1	MATN1-AS1	30719233	30719565	0	333	0	3750	0	3417	0.0	0.0
chr1	ZCCHC17	31297097	31297213	0	117	1173	1930	1173	1813	0.0	0.6469939327082185
chr1	ZCCHC17	31297076	31297213	0	138	1173	1930	1173	1792	0.0	0.6545758928571429
chr1	ZCCHC17	31346741	31346818	0	78	1173	1930	1173	1852	0.0	0.6333693304535637
chr1	LDC1P	31501528	31501539	0	12	2565	2358	2565	2346	0.0	1.0933503836317136
chr1	PEF1-AS1	31645121	31645146	0	26	351	2148	351	2122	0.0	0.1654099905749293
chr1	PEF1-AS1	31645139	31645146	0	8	351	2148	351	2140	0.0	0.16401869158878504
chr1	PEF1-AS1	31645121	31645138	0	18	351	2148	351	2130	0.0	0.1647887323943662
chr1	PEF1-AS1	31645342	31645382	0	41	351	2148	351	2107	0.0	0.1665875652586616
chr1	PEF1-AS1	31656045	31656185	0	141	351	2148	351	2007	0.0	0.17488789237668162
chr1	KPNA6	32156928	32156945	0	18	909	7472	909	7454	0.0	0.12194794741078616
chr1	IQCC	32205724	32205963	8571	240	45625	2467	37054	2227	35.7125	16.638527166591828
chr1	EIF3I	32226284	32226320	0	37	21504	5731	21504	5694	0.0	3.7766069546891465
chr1	EIF3I	32228817	32229208	0	392	21504	5731	21504	5339	0.0	4.027720546918899
chr1	EIF3I	32228817	32229024	0	208	21504	5731	21504	5523	0.0	3.893536121673004
chr1	RBBP4	32651716	32651822	1770	107	285335	9163	283565	9056	16.542056074766354	31.312389575971732
chr1	RBBP4	32679699	32679817	0	119	285335	9163	285335	9044	0.0	31.549646174259177
chr1	S100PBP	32817600	32817689	0	90	53288	9206	53288	9116	0.0	5.845546292233435
chr1	S100PBP	32825430	32825485	946	56	53288	9206	52342	9150	16.892857142857142	5.720437158469945
chr1	AL513327.1	33307438	33307449	8	12	13138	3838	13130	3826	0.6666666666666666	3.4317825405122844
chr1	ZSCAN20	33472688	33472691	0	4	15862	5316	15862	5312	0.0	2.9860692771084336
chr1	CSMD2-AS1	33870425	33870494	0	70	507	2628	507	2558	0.0	0.1982017200938233
chr1	ZMYM1	35094010	35094083	0	74	51	5220	51	5146	0.0	0.009910610182666148
chr1	NCDN	35557884	35558223	204	340	78052	4926	77848	4586	0.6	16.9751417357174
chr1	C1ORF122	37808307	37808439	0	133	0	1487	0	1354	0.0	0.0
chr1	LINC01685	38513938	38514011	0	74	1621	3681	1621	3607	0.0	0.4494039367895758
chr1	NDUFS5	39026399	39026402	0	4	0	551	0	547	0.0	0.0
chr1	MACF1	39269688	39269720	0	33	286688	41060	286688	41027	0.0	6.98778852950496
chr1	PPIE	39738924	39738931	0	8	7240	11133	7240	11125	0.0	0.6507865168539326
chr1	PPIE	39741922	39742031	0	110	7240	11133	7240	11023	0.0	0.6568084913362968
chr1	PPIE	39745499	39748767	3765	3269	7240	11133	3475	7864	1.151728357295809	0.4418870803662258
chr1	MFSD2A	39955380	39955385	0	6	204	3841	204	3835	0.0	0.053194263363754886
chr1	CAP1	40040468	40040783	504	316	53087	3616	52583	3300	1.5949367088607596	15.934242424242424
chr1	CAP1	40040784	40040801	0	18	53087	3616	53087	3598	0.0	14.754585881045026
chr1	EXO5	40508909	40509790	0	882	3874	2819	3874	1937	0.0	2.0
chr1	EXO5	40508878	40509790	88	913	3874	2819	3786	1906	0.0963855421686747	1.9863588667366212
chr1	EXO5	40508890	40509790	0	901	3874	2819	3874	1918	0.0	2.019812304483837
chr1	EXO5	40509350	40509790	0	441	3874	2819	3874	2378	0.0	1.6291000841042893
chr1	EXO5	40508878	40508908	88	31	3874	2819	3786	2788	2.838709677419355	1.3579626972740315
chr1	EXO5	40508890	40508908	0	19	3874	2819	3874	2800	0.0	1.3835714285714287
chr1	EXO5	40508878	40508889	88	12	3874	2819	3786	2807	7.333333333333333	1.3487709298183113
chr1	PPCS	42456629	42457073	16	445	652	3395	636	2950	0.035955056179775284	0.21559322033898304
chr1	CCDC30	42463891	42463898	0	8	197370	22898	197370	22890	0.0	8.62254259501966
chr1	CCDC30	42463658	42463898	0	241	197370	22898	197370	22657	0.0	8.71121507701814
chr1	CCDC30	42498893	42498916	0	24	197370	22898	197370	22874	0.0	8.628573926729038
chr1	CCDC30	42463658	42463890	0	233	197370	22898	197370	22665	0.0	8.70814030443415
chr1	PPIH	42659252	42659370	0	119	9233	4021	9233	3902	0.0	2.366222450025628
chr1	ERMAP	42825736	42825738	0	3	0	5141	0	5138	0.0	0.0
chr1	ERMAP	42835761	42835764	0	4	0	5141	0	5137	0.0	0.0
chr1	FAM183A	43148085	43148091	34	7	2602	811	2568	804	4.857142857142857	3.1940298507462686
chr1	FAM183A	43152932	43152979	3	48	2602	811	2599	763	0.0625	3.406290956749672
chr1	CFAP57	43172403	43172453	0	51	25573	5416	25573	5365	0.0	4.7666356011183595
chr1	CFAP57	43219538	43219631	0	94	25573	5416	25573	5322	0.0	4.805148440435926
chr1	SZT2	43419945	43419961	0	17	31845	24016	31845	23999	0.0	1.3269302887620318
chr1	PTPRF	43603528	43603533	0	6	4099	10480	4099	10474	0.0	0.3913500095474508
chr1	ST3GAL3	43801542	43801545	0	4	242611	18223	242611	18219	0.0	13.316373017179867
chr1	ST3GAL3	43814934	43815004	561	71	242611	18223	242050	18152	7.901408450704225	13.334618774790657
chr1	ST3GAL3	43736381	43736425	0	45	242611	18223	242611	18178	0.0	13.346407745626582
chr1	ST3GAL3	43899264	43899289	202	26	242611	18223	242409	18197	7.769230769230769	13.321371654668352
chr1	ST3GAL3	43920929	43920940	0	12	242611	18223	242611	18211	0.0	13.322222832354072
chr1	ST3GAL3	43898299	43898438	236	140	242611	18223	242375	18083	1.6857142857142857	13.403472875076039
chr1	DPH2	43970271	43970322	0	52	0	2729	0	2677	0.0	0.0
chr1	DPH2	43970315	43970322	0	8	0	2729	0	2721	0.0	0.0
chr1	DPH2	43970313	43970322	0	10	0	2729	0	2719	0.0	0.0
chr1	DPH2	43970709	43970817	0	109	0	2729	0	2620	0.0	0.0
chr1	DPH2	43971541	43972070	0	530	0	2729	0	2199	0.0	0.0
chr1	DPH2	43970271	43970314	0	44	0	2729	0	2685	0.0	0.0
chr1	DPH2	43970313	43970314	0	2	0	2729	0	2727	0.0	0.0
chr1	DPH2	43970271	43970312	0	42	0	2729	0	2687	0.0	0.0
chr1	ATP6V0B	43975108	43975297	0	190	0	2433	0	2243	0.0	0.0
chr1	ATP6V0B	43975108	43975307	0	200	0	2433	0	2233	0.0	0.0
chr1	B4GALT2	43979512	43979616	0	105	153	5400	153	5295	0.0	0.028895184135977338
chr1	B4GALT2	43980047	43980614	0	568	153	5400	153	4832	0.0	0.031663907284768214
chr1	AL139220.2	44030469	44030557	0	89	64101	9671	64101	9582	0.0	6.689730745147151
chr1	AL139220.2	44044759	44045269	7049	511	64101	9671	57052	9160	13.794520547945206	6.228384279475983
chr1	AL139220.2	44051108	44051158	132	51	64101	9671	63969	9620	2.588235294117647	6.6495841995842
chr1	AL139220.2	44051495	44051531	159	37	64101	9671	63942	9634	4.297297297297297	6.637118538509446
chr1	DMAP1	44213528	44213662	46	135	3735	2653	3689	2518	0.34074074074074073	1.46505162827641
chr1	RNF220	44405527	44405530	0	4	15812	8963	15812	8959	0.0	1.7649291215537448
chr1	RNF220	44635589	44635666	0	78	15812	8963	15812	8885	0.0	1.7796285875070343
chr1	RNF220	44632209	44632212	0	4	15812	8963	15812	8959	0.0	1.7649291215537448
chr1	KIF2C	44740003	44740042	0	40	41451	3547	41451	3507	0.0	11.819503849443969
chr1	RPS8	44776715	44776774	0	60	1806	2666	1806	2606	0.0	0.6930161166538756
chr1	RPS8	44777738	44777789	0	52	1806	2666	1806	2614	0.0	0.6908951798010712
chr1	BTBD19	44810250	44810426	1428	177	9155	3529	7727	3352	8.067796610169491	2.3051909307875893
chr1	RAD54L	46248599	46248623	0	25	42953	4044	42953	4019	0.0	10.687484448867878
chr1	RAD54L	46261016	46261074	0	59	42953	4044	42953	3985	0.0	10.778670012547051
chr1	UQCRH	46309128	46309143	0	16	1347	1345	1347	1329	0.0	1.0135440180586908
chr1	NSUN4	46344963	46345144	0	182	2697	8320	2697	8138	0.0	0.3314082084050135
chr1	NSUN4	46341498	46341865	816	368	2697	8320	1881	7952	2.217391304347826	0.23654426559356137
chr1	NSUN4	46341866	46344294	816	2429	2697	8320	1881	5891	0.33594071634417455	0.3193006280767272
chr1	SLC5A9	48229166	48229177	0	12	0	4404	0	4392	0.0	0.0
chr1	OSBPL9	51669513	51669814	0	302	1293	7377	1293	7075	0.0	0.18275618374558303
chr1	OSBPL9	51730002	51730124	0	123	1293	7377	1293	7254	0.0	0.1782464846980976
chr1	AL050343.2	51794054	51794074	0	21	0	1470	0	1449	0.0	0.0
chr1	CPT2	53211251	53211319	0	69	306	5091	306	5022	0.0	0.06093189964157706
chr1	CPT2	53211251	53211369	0	119	306	5091	306	4972	0.0	0.06154465004022526
chr1	CPT2	53211320	53211369	0	50	306	5091	306	5041	0.0	0.06070224161872644
chr1	DIO1	53894439	53894547	20	109	122	2265	102	2156	0.1834862385321101	0.04730983302411874
chr1	DIO1	53894356	53894547	20	192	122	2265	102	2073	0.10416666666666667	0.049204052098408106
chr1	DIO1	53894356	53894438	0	83	122	2265	122	2182	0.0	0.05591200733272227
chr1	MRPL37	54200242	54200589	204	348	357	2523	153	2175	0.5862068965517241	0.0703448275862069
chr1	DHCR24-DT	54887784	54887976	0	193	0	691	0	498	0.0	0.0
chr1	DHCR24-DT	54887969	54887976	0	8	0	691	0	683	0.0	0.0
chr1	LINC01767	56415151	56415609	0	459	0	2023	0	1564	0.0	0.0
chr1	LINC01767	56415343	56415353	0	11	0	2023	0	2012	0.0	0.0
chr1	LINC01767	56415610	56415695	0	86	0	2023	0	1937	0.0	0.0
chr1	DAB1-AS1	57860920	57860926	0	7	0	4284	0	4277	0.0	0.0
chr1	DAB1-AS1	57860910	57860926	0	17	0	4284	0	4267	0.0	0.0
chr1	DAB1-AS1	57860873	57860926	0	54	0	4284	0	4230	0.0	0.0
chr1	DAB1-AS1	57860927	57861033	0	107	0	4284	0	4177	0.0	0.0
chr1	DAB1-AS1	57860920	57861033	0	114	0	4284	0	4170	0.0	0.0
chr1	DAB1-AS1	57860910	57861033	0	124	0	4284	0	4160	0.0	0.0
chr1	DAB1-AS1	57860936	57861033	0	98	0	4284	0	4186	0.0	0.0
chr1	DAB1-AS1	57860873	57861033	0	161	0	4284	0	4123	0.0	0.0
chr1	DAB1-AS1	57860910	57860919	0	10	0	4284	0	4274	0.0	0.0
chr1	DAB1-AS1	57860873	57860919	0	47	0	4284	0	4237	0.0	0.0
chr1	DAB1-AS1	57860873	57860909	0	37	0	4284	0	4247	0.0	0.0
chr1	DAB1-AS1	57860927	57860935	0	9	0	4284	0	4275	0.0	0.0
chr1	DAB1-AS1	57860920	57860935	0	16	0	4284	0	4268	0.0	0.0
chr1	DAB1-AS1	57860910	57860935	0	26	0	4284	0	4258	0.0	0.0
chr1	DAB1-AS1	57860873	57860935	0	63	0	4284	0	4221	0.0	0.0
chr1	DAB1-AS1	57862520	57863040	0	521	0	4284	0	3763	0.0	0.0
chr1	DAB1-AS1	57862928	57863040	0	113	0	4284	0	4171	0.0	0.0
chr1	DAB1-AS1	57862520	57862927	0	408	0	4284	0	3876	0.0	0.0
chr1	LINC01358	59056750	59057032	0	283	9058	8361	9058	8078	0.0	1.1213171577123051
chr1	USP1	62436468	62436562	0	95	0	3878	0	3783	0.0	0.0
chr1	ATG4C	62784226	62784273	0	48	102	3126	102	3078	0.0	0.03313840155945419
chr1	ALG6	63411156	63411331	0	176	408	5100	408	4924	0.0	0.08285946385052803
chr1	ALG6	63371060	63371287	0	228	408	5100	408	4872	0.0	0.08374384236453201
chr1	EFCAB7	63523570	63523634	0	65	0	5719	0	5654	0.0	0.0
chr1	MIER1	66984593	66984652	0	60	153	6542	153	6482	0.0	0.023603825979635916
chr1	LINC01707	69192587	69192610	0	24	51	6166	51	6142	0.0	0.008303484207098664
chr1	HHLA3	70355108	70355111	0	4	10710	1228	10710	1224	0.0	8.75
chr1	HHLA3	70355108	70355208	0	101	10710	1228	10710	1127	0.0	9.503105590062113
chr1	HHLA3	70355112	70355208	0	97	10710	1228	10710	1131	0.0	9.46949602122016
chr1	ZRANB2-AS2	71237196	71237386	0	191	51	14846	51	14655	0.0	0.003480040941658137
chr1	ZRANB2-AS2	71202057	71202131	0	75	51	14846	51	14771	0.0	0.0034527113939476
chr1	ZRANB2-AS2	71407816	71407871	0	56	51	14846	51	14790	0.0	0.0034482758620689655
chr1	ZRANB2-AS2	71488048	71488148	0	101	51	14846	51	14745	0.0	0.0034587995930824007
chr1	ZRANB2-AS2	71486514	71486534	0	21	51	14846	51	14825	0.0	0.0034401349072512646
chr1	LINC01360	73306275	73306297	0	23	0	5538	0	5515	0.0	0.0
chr1	LINC01360	73307364	73307384	0	21	0	5538	0	5517	0.0	0.0
chr1	FPGT	74199832	74199845	0	14	0	3573	0	3559	0.0	0.0
chr1	FPGT	74198361	74198426	0	66	0	3573	0	3507	0.0	0.0
chr1	AC092813.1	75932617	75932670	0	54	0	2089	0	2035	0.0	0.0
chr1	MIGA1	77783268	77783351	30	84	764	6906	734	6822	0.35714285714285715	0.10759308120785693
chr1	DNAJB4	77979294	77979619	0	326	357	3709	357	3383	0.0	0.10552763819095477
chr1	MGC27382	78250374	78251010	306	637	3730	2490	3424	1853	0.4803767660910518	1.847814355099838
chr1	IFI44L	78628019	78628393	0	375	51	7676	51	7301	0.0	0.006985344473359814
chr1	IFI44	78662879	78662917	0	39	102	1958	102	1919	0.0	0.053152683689421575
chr1	ADGRL2	81800480	81800512	0	33	10445	19025	10445	18992	0.0	0.5499684077506318
chr1	ADGRL2	81989696	81989709	0	14	10445	19025	10445	19011	0.0	0.5494187575614118
chr1	LINC01362	82903455	82903823	0	369	2	2150	2	1781	0.0	0.0011229646266142617
chr1	LINC01362	82952729	82952837	0	109	2	2150	2	2041	0.0	0.0009799118079372856
chr1	SAMD13	84301802	84302014	0	213	1224	3415	1224	3202	0.0	0.38226108682073706
chr1	LINC01140	87132864	87132912	0	49	612	6060	612	6011	0.0	0.10181334220595575
chr1	LINC01140	87132253	87132259	0	7	612	6060	612	6053	0.0	0.10110688914587808
chr1	AC092805.1	90719703	90719706	0	4	0	2433	0	2429	0.0	0.0
chr1	BRDT	91949489	91949682	0	194	34576	4344	34576	4150	0.0	8.331566265060241
chr1	BRDT	91968261	91968272	36	12	34576	4344	34540	4332	3.0	7.973222530009234
chr1	BRDT	91949489	91949519	0	31	34576	4344	34576	4313	0.0	8.016693716670531
chr1	BRDT	91949959	91950474	0	516	34576	4344	34576	3828	0.0	9.03239289446186
chr1	RPL5	92832118	92832251	462	134	2276	2191	1814	2057	3.4477611940298507	0.881866796305299
chr1	CCDC18	93180280	93180418	0	139	653	5355	653	5216	0.0	0.12519171779141106
chr1	CCDC18	93180419	93180882	0	464	653	5355	653	4891	0.0	0.1335105295440605
chr1	CCDC18	93180853	93180882	0	30	653	5355	653	5325	0.0	0.12262910798122066
chr1	ARHGAP29-AS1	94248040	94248134	0	95	46667	3779	46667	3684	0.0	12.667480998914224
chr1	SLC44A3	94827548	94827643	0	96	186	2888	186	2792	0.0	0.0666189111747851
chr1	RWDD3	95244652	95244698	0	47	0	1781	0	1734	0.0	0.0
chr1	LINC02790	95992123	95992238	0	116	0	2786	0	2670	0.0	0.0
chr1	LINC02790	96006422	96006425	0	4	0	2786	0	2782	0.0	0.0
chr1	PTBP2	96721873	96721896	0	24	0	14696	0	14672	0.0	0.0
chr1	AL445433.2	99144131	99144151	0	21	1024	5989	1024	5968	0.0	0.17158176943699732
chr1	AGL	99850619	99850898	0	280	0	8193	0	7913	0.0	0.0
chr1	SLC35A3	99970163	99970300	0	138	867	15955	867	15817	0.0	0.05481444015932225
chr1	SLC35A3	99993742	99993745	0	4	867	15955	867	15951	0.0	0.05435395899943577
chr1	VCAM1	100720566	100720751	0	186	63554	3110	63554	2924	0.0	21.735294117647058
chr1	AC093157.1	101025948	101026061	0	114	0	7130	0	7016	0.0	0.0
chr1	RNPC3	103525824	103526262	0	439	102	5469	102	5030	0.0	0.020278330019880716
chr1	RNPC3	103525824	103525930	0	107	102	5469	102	5362	0.0	0.019022752704214847
chr1	AL355306.2	106041912	106042040	0	129	0	8939	0	8810	0.0	0.0
chr1	LINC02785	108050736	108050788	0	53	0	4139	0	4086	0.0	0.0
chr1	GPSM2	108918790	108919150	1498	361	5867	18055	4369	17694	4.149584487534626	0.2469198598394936
chr1	TMEM167B	109093022	109093082	0	61	0	3617	0	3556	0.0	0.0
chr1	ELAPOR1	109113916	109113992	0	77	178014	9175	178014	9098	0.0	19.56627830292372
chr1	ELAPOR1	109113989	109113992	0	4	178014	9175	178014	9171	0.0	19.410533202486096
chr1	CYB561D1	109494155	109494287	2597	133	76138	5618	73541	5485	19.526315789473685	13.407657247037374
chr1	GPR61	109545374	109545389	0	16	2587	3508	2587	3492	0.0	0.7408361970217641
chr1	AMPD2	109630407	109630439	0	33	70772	8217	70772	8184	0.0	8.647605083088955
chr1	GSTM4	109657280	109657671	408	392	2041	3643	1633	3251	1.0408163265306123	0.5023069824669333
chr1	GSTM2	109668484	109668500	0	17	1713	5816	1713	5799	0.0	0.29539575788929123
chr1	AHCYL1	109985173	109985543	0	371	17007	5052	17007	4681	0.0	3.63319803460799
chr1	RBM15	110342182	110342268	279	87	873	3757	594	3670	3.206896551724138	0.16185286103542235
chr1	LAMTOR5-AS1	110407816	110407954	311	139	1596	11148	1285	11009	2.237410071942446	0.11672268144245618
chr1	LAMTOR5-AS1	110418367	110418375	0	9	1596	11148	1596	11139	0.0	0.14328036628063562
chr1	LAMTOR5-AS1	110407955	110409158	46	1204	1596	11148	1550	9944	0.03820598006644518	0.15587288817377312
chr1	LAMTOR5-AS1	110407816	110409158	357	1343	1596	11148	1239	9805	0.26582278481012656	0.1263640999490056
chr1	LAMTOR5-AS1	110408228	110409158	0	931	1596	11148	1596	10217	0.0	0.15621023783889595
chr1	AL358215.3	110484945	110485078	0	134	0	1194	0	1060	0.0	0.0
chr1	CHI3L2	111235001	111235057	0	57	0	3296	0	3239	0.0	0.0
chr1	CHI3L2	111229811	111229881	0	71	0	3296	0	3225	0.0	0.0
chr1	CHIAP2	111281753	111281861	0	109	0	2199	0	2090	0.0	0.0
chr1	RAP1A	111627560	111627563	0	4	45483	5543	45483	5539	0.0	8.21141000180538
chr1	INKA2-AS1	111740078	111740098	0	21	408	2417	408	2396	0.0	0.17028380634390652
chr1	KCND3-AS1	111910277	111910313	0	37	0	744	0	707	0.0	0.0
chr1	SLC16A1-AS1	112956957	112957722	1122	766	73700	12689	72578	11923	1.4647519582245432	6.087226369202382
chr1	AL137856.1	113812613	113812825	0	213	0	1590	0	1377	0.0	0.0
chr1	HIPK1	113957185	113957286	40	102	1453	9171	1413	9069	0.39215686274509803	0.15580549123387363
chr1	VANGL1	115659768	115659773	0	6	1020	9055	1020	9049	0.0	0.11271963752900874
chr1	LINC01649	115922446	115922566	0	121	0	2435	0	2314	0.0	0.0
chr1	LINC01525	117296634	117296801	0	168	0	862	0	694	0.0	0.0
chr1	HSD3B1	119507220	119507262	0	43	0	2447	0	2404	0.0	0.0
chr1	PHGDH	119741877	119741897	0	21	19639	6218	19639	6197	0.0	3.1691140874616752
chr1	PHGDH	119721322	119721654	4182	333	19639	6218	15457	5885	12.558558558558559	2.6265080713678843
chr1	PHGDH	119721335	119721654	3012	320	19639	6218	16627	5898	9.4125	2.8190912173618177
chr1	PHGDH	119724876	119724957	2070	82	19639	6218	17569	6136	25.24390243902439	2.8632659713168187
chr1	PHGDH	119724876	119724967	2219	92	19639	6218	17420	6126	24.119565217391305	2.843617368592883
chr1	PHGDH	119724958	119724967	149	10	19639	6218	19490	6208	14.9	3.1394974226804124
chr1	PHGDH	119721322	119721334	1170	13	19639	6218	18469	6205	90.0	2.976470588235294
chr1	NBPF26	120822157	120822267	0	111	41854	6817	41854	6706	0.0	6.24127646883388
chr1	NBPF26	120805454	120805458	0	5	41854	6817	41854	6812	0.0	6.144157369348209
chr1	FCGR1B	121094959	121095021	0	63	1167	4239	1167	4176	0.0	0.27945402298850575
chr1	GNRHR2	145919420	145919569	25	150	2085	2338	2060	2188	0.16666666666666666	0.9414990859232175
chr1	LIX1L-AS1	145947146	145947361	0	216	2255	3264	2255	3048	0.0	0.7398293963254593
chr1	LIX1L-AS1	145927658	145927794	0	137	2255	3264	2255	3127	0.0	0.7211384713783179
chr1	LINC01719	146057989	146058461	1415	473	19342	2631	17927	2158	2.9915433403805496	8.30722891566265
chr1	NBPF12	146960007	146960011	0	5	0	7308	0	7303	0.0	0.0
chr1	CHD1L	147256563	147256570	0	8	51	4200	51	4192	0.0	0.012166030534351144
chr1	CHD1L	147271006	147271113	0	108	51	4200	51	4092	0.0	0.012463343108504398
chr1	CHD1L	147272282	147272630	0	349	51	4200	51	3851	0.0	0.013243313425084394
chr1	CHD1L	147271006	147271195	0	190	51	4200	51	4010	0.0	0.012718204488778055
chr1	CHD1L	147271114	147271195	0	82	51	4200	51	4118	0.0	0.01238465274405051
chr1	CHD1L	147243168	147243190	0	23	51	4200	51	4177	0.0	0.01220971989466124
chr1	BCL9	147612978	147613199	993	222	52642	6342	51649	6120	4.472972972972973	8.439379084967321
chr1	LINC02805	148163816	148163866	0	51	32	5857	32	5806	0.0	0.005511539786427834
chr1	LINC02805	148162993	148163588	0	596	32	5857	32	5261	0.0	0.006082493822467212
chr1	LINC02805	148162993	148163815	0	823	32	5857	32	5034	0.0	0.006356773937226857
chr1	AC245100.4	148427944	148427958	0	15	0	3322	0	3307	0.0	0.0
chr1	AC245100.4	148424639	148424678	0	40	0	3322	0	3282	0.0	0.0
chr1	AC245100.4	148427959	148427992	0	34	0	3322	0	3288	0.0	0.0
chr1	AC245100.4	148427944	148427992	0	49	0	3322	0	3273	0.0	0.0
chr1	PDE4DIP	149001697	149002026	0	330	2142	23819	2142	23489	0.0	0.09119162161011538
chr1	PDE4DIP	148952155	148953905	1581	1751	2142	23819	561	22068	0.9029126213592233	0.02542142468733007
chr1	LINC00869	149646655	149646945	51	291	21464	10886	21413	10595	0.17525773195876287	2.0210476639924493
chr1	LINC00869	149636694	149636716	0	23	21464	10886	21464	10863	0.0	1.9758814323851606
chr1	LINC00869	149646946	149647064	0	119	21464	10886	21464	10767	0.0	1.9934986532924677
chr1	H4C14	149833115	149833864	18046	750	23373	1868	5327	1118	24.061333333333334	4.764758497316637
chr1	BOLA1	149899673	149899730	4550	58	165490	1464	160940	1406	78.44827586206897	114.46657183499289
chr1	VPS45	150067607	150067950	712	344	17797	5991	17085	5647	2.0697674418604652	3.025500265627767
chr1	SETDB1	150926349	150926517	0	169	85120	7114	85120	6945	0.0	12.256299496040317
chr1	SETDB1	150926464	150926517	0	54	85120	7114	85120	7060	0.0	12.056657223796034
chr1	SETDB1	150926349	150926531	0	183	85120	7114	85120	6931	0.0	12.281056124657336
chr1	SETDB1	150926518	150926531	0	14	85120	7114	85120	7100	0.0	11.988732394366197
chr1	SETDB1	150926464	150926531	0	68	85120	7114	85120	7046	0.0	12.080613113823446
chr1	SETDB1	150926518	150926544	0	27	85120	7114	85120	7087	0.0	12.010723860589811
chr1	SETDB1	150926532	150926544	0	13	85120	7114	85120	7101	0.0	11.987044078298831
chr1	BNIPL	151038565	151038568	0	4	7618	3554	7618	3550	0.0	2.1459154929577466
chr1	SCNM1	151166204	151166252	0	49	7618	3270	7618	3221	0.0	2.3651040049674013
chr1	PIP5K1A	151199082	151199187	0	106	124237	5373	124237	5267	0.0	23.587810898044427
chr1	PSMD4	151266113	151266121	180	9	256556	2624	256376	2615	20.0	98.04053537284895
chr1	PSMD4	151266122	151266198	645	77	256556	2624	255911	2547	8.376623376623376	100.47546132705143
chr1	PSMD4	151266113	151266198	825	86	256556	2624	255731	2538	9.593023255813954	100.76083530338849
chr1	PSMB4	151400186	151400187	28	2	37410	1700	37382	1698	14.0	22.015312131919906
chr1	SNX27	151612382	151612512	51	131	200518	16235	200467	16104	0.3893129770992366	12.448273720814704
chr1	AL450992.1	152018838	152018839	0	2	1495	4122	1495	4120	0.0	0.3628640776699029
chr1	FLG-AS1	152189509	152189655	3	147	3230	12348	3227	12201	0.02040816326530612	0.26448651749856567
chr1	FLG-AS1	152189482	152189655	6	174	3230	12348	3224	12174	0.034482758620689655	0.2648266798094299
chr1	FLG-AS1	152189482	152189508	3	27	3230	12348	3227	12321	0.1111111111111111	0.2619105592078565
chr1	LCE1E	152786308	152786363	0	56	189	1147	189	1091	0.0	0.17323556370302476
chr1	CREB3L4	153968640	153968699	0	60	336129	2539	336129	2479	0.0	135.59056070996368
chr1	CREB3L4	153968165	153968184	46588	20	336129	2539	289541	2519	2329.4	114.9428344581183
chr1	UBAP2L	154234739	154234759	675	21	175259	6628	174584	6607	32.142857142857146	26.424095656122294
chr1	UBAP2L	154234760	154234792	873	33	175259	6628	174386	6595	26.454545454545453	26.442153146322973
chr1	UBAP2L	154234739	154234792	1548	54	175259	6628	173711	6574	28.666666666666668	26.423942804989352
chr1	UBAP2L	154220976	154221040	319	65	175259	6628	174940	6563	4.907692307692308	26.655492914825537
chr1	HAX1	154273535	154273598	0	64	51	1613	51	1549	0.0	0.0329244673983215
chr1	IL6R	154430596	154430606	0	11	323	6465	323	6454	0.0	0.05004648280136349
chr1	TDRD10	154547480	154547568	315	89	14018	2719	13703	2630	3.539325842696629	5.210266159695817
chr1	CHRNB2	154569837	154569842	6	6	93980	4878	93974	4872	1.0	19.288587848932675
chr1	CKS1B	154974805	154974912	0	108	17081	2309	17081	2201	0.0	7.76056338028169
chr1	FLAD1	154990258	154990528	15826	271	174719	3992	158893	3721	58.398523985239855	42.7016930932545
chr1	ADAM15	155061976	155062117	0	142	3893	4801	3893	4659	0.0	0.8355870358446018
chr1	SLC50A1	155135599	155135680	0	82	0	1885	0	1803	0.0	0.0
chr1	SLC50A1	155136377	155136396	0	20	0	1885	0	1865	0.0	0.0
chr1	TRIM46	155174030	155174039	182	10	455013	4548	454831	4538	18.2	100.2271925958572
chr1	MTX1	155210416	155210435	10563	20	25217	2569	14654	2549	528.15	5.748921145547273
chr1	HCN3	155288708	155289007	3505	300	681385	3866	677880	3566	11.683333333333334	190.09534492428492
chr1	FDPS	155308966	155309076	297	111	6119	3010	5822	2899	2.675675675675676	2.008278716798896
chr1	RUSC1	155324365	155324544	988	180	6881	4428	5893	4248	5.488888888888889	1.387241054613936
chr1	RUSC1	155324545	155324587	81	43	6881	4428	6800	4385	1.8837209302325582	1.5507411630558723
chr1	RUSC1	155324810	155324943	30	134	6881	4428	6851	4294	0.22388059701492538	1.595482068001863
chr1	MSTO1	155613734	155613766	90	33	7524	4041	7434	4008	2.727272727272727	1.8547904191616766
chr1	DAP3	155689175	155689243	0	69	54517	4354	54517	4285	0.0	12.722753792298716
chr1	LMNA	156134524	156134528	0	5	328592	7357	328592	7352	0.0	44.69423286180631
chr1	LMNA	156138608	156138757	0	150	328592	7357	328592	7207	0.0	45.59345081171084
chr1	LMNA	156136437	156136549	0	113	328592	7357	328592	7244	0.0	45.360574268360025
chr1	LMNA	156114792	156114911	423	120	328592	7357	328169	7237	3.525	45.34599972364239
chr1	LMNA	156126916	156126949	0	34	328592	7357	328592	7323	0.0	44.87122763894579
chr1	TMEM79	156285268	156285983	19150	716	29172	3037	10022	2321	26.74581005586592	4.3179663937957775
chr1	BCAN	156642272	156642275	0	4	0	4571	0	4567	0.0	0.0
chr1	RRNAD1	156734053	156734493	51	441	1224	2891	1173	2450	0.11564625850340136	0.47877551020408166
chr1	PRCC	156767584	156768239	2346	656	2856	4062	510	3406	3.576219512195122	0.14973576042278333
chr1	AL357143.1	157183015	157183252	0	238	0	5822	0	5584	0.0	0.0
chr1	KIRREL1	157993729	157993732	0	4	6570	7887	6570	7883	0.0	0.8334390460484588
chr1	CD1D	158181051	158181162	0	112	459	4291	459	4179	0.0	0.10983488872936109
chr1	CD1E	158355941	158356105	0	165	23	2210	23	2045	0.0	0.011246943765281174
chr1	CD1E	158356002	158356105	0	104	23	2210	23	2106	0.0	0.010921177587844255
chr1	CD1E	158355941	158356001	0	61	23	2210	23	2149	0.0	0.010702652396463471
chr1	MNDA	158847890	158847916	0	27	0	2032	0	2005	0.0	0.0
chr1	CADM3	159193903	159194040	0	138	51	3857	51	3719	0.0	0.013713363807475128
chr1	DUSP23	159780994	159781000	0	7	0	801	0	794	0.0	0.0
chr1	ATP1A4	160167413	160167429	0	17	421232	6294	421232	6277	0.0	67.10721682332324
chr1	ATP1A4	160176563	160176602	478	40	421232	6294	420754	6254	11.95	67.27758234729772
chr1	PEA15	160211651	160211716	294	66	59406	2770	59112	2704	4.454545454545454	21.86094674556213
chr1	NCSTN	160343803	160343888	0	86	97	4150	97	4064	0.0	0.02386811023622047
chr1	AL121985.1	160683696	160683785	0	90	0	4131	0	4041	0.0	0.0
chr1	SLAMF7	160750094	160750132	0	39	0	3183	0	3144	0.0	0.0
chr1	NIT1	161118179	161118209	0	31	3264	3450	3264	3419	0.0	0.9546651067563615
chr1	NIT1	161118179	161118551	51	373	3264	3450	3213	3077	0.13672922252010725	1.0441988950276244
chr1	NIT1	161118240	161118551	51	312	3264	3450	3213	3138	0.16346153846153846	1.0239005736137667
chr1	NIT1	161118179	161118225	0	47	3264	3450	3264	3403	0.0	0.9591536879224214
chr1	NIT1	161118210	161118225	0	16	3264	3450	3264	3434	0.0	0.9504950495049505
chr1	NIT1	161118179	161118239	0	61	3264	3450	3264	3389	0.0	0.9631159634110357
chr1	NIT1	161118210	161118239	0	30	3264	3450	3264	3420	0.0	0.9543859649122807
chr1	NIT1	161118226	161118239	0	14	3264	3450	3264	3436	0.0	0.9499417927823051
chr1	UFC1	161154071	161154120	0	50	1712	1386	1712	1336	0.0	1.281437125748503
chr1	USP21	161163923	161163981	2873	59	67773	3470	64900	3411	48.69491525423729	19.02667839343301
chr1	PPOX	161166612	161166672	821	61	31353	4416	30532	4355	13.459016393442623	7.010792192881745
chr1	NDUFS2	161212655	161213182	10	528	37441	7304	37431	6776	0.01893939393939394	5.524055489964581
chr1	NDUFS2	161213922	161214032	78	111	37441	7304	37363	7193	0.7027027027027027	5.19435562352287
chr1	NDUFS2	161214021	161214032	12	12	37441	7304	37429	7292	1.0	5.132885353812397
chr1	NDUFS2	161213947	161214032	53	86	37441	7304	37388	7218	0.6162790697674418	5.179828207259629
chr1	NDUFS2	161213922	161214020	66	99	37441	7304	37375	7205	0.6666666666666666	5.1873698820263705
chr1	NDUFS2	161213947	161214020	41	74	37441	7304	37400	7230	0.5540540540540541	5.172890733056708
chr1	NDUFS2	161213922	161213946	25	25	37441	7304	37416	7279	1.0	5.140266520126391
chr1	NDUFS2	161213922	161214053	94	132	37441	7304	37347	7172	0.7121212121212122	5.207334076965979
chr1	NDUFS2	161214033	161214053	16	21	37441	7304	37425	7283	0.7619047619047619	5.138679115749005
chr1	NDUFS2	161214021	161214053	28	33	37441	7304	37413	7271	0.8484848484848485	5.145509558520149
chr1	NDUFS2	161213947	161214053	69	107	37441	7304	37372	7197	0.6448598130841121	5.192719188550785
chr1	FCGR2A	161506592	161506707	0	116	1781	4043	1781	3927	0.0	0.45352686529157116
chr1	FCRLA	161710864	161710912	0	49	0	2862	0	2813	0.0	0.0
chr1	RGS4	163069409	163069528	0	120	663	3740	663	3620	0.0	0.18314917127071823
chr1	NUF2	163322067	163322212	1750	146	3843	3228	2093	3082	11.986301369863014	0.6791044776119403
chr1	AL356441.1	165598623	165598684	0	62	139262	2014	139262	1952	0.0	71.34323770491804
chr1	POGK	166839605	166839769	0	165	1443	8441	1443	8276	0.0	0.17435959400676657
chr1	BLZF1	169368343	169368362	0	20	677	3828	677	3808	0.0	0.17778361344537816
chr1	FMO1	171248615	171248623	0	9	3654	2776	3654	2767	0.0	1.3205637874954825
chr1	FMO1	171282066	171282333	55	268	3654	2776	3599	2508	0.20522388059701493	1.4350079744816586
chr1	FMO1	171282334	171283216	47	883	3654	2776	3607	1893	0.053227633069082674	1.9054410987849975
chr1	PRRC2C	171514631	171514645	651	15	70197	11736	69546	11721	43.4	5.933452777066803
chr1	PRRC2C	171584527	171584541	0	15	70197	11736	70197	11721	0.0	5.988994113130279
chr1	PRRC2C	171591201	171591204	0	4	70197	11736	70197	11732	0.0	5.983378793044664
chr1	EEF1AKNMT	171781796	171782120	0	325	0	3836	0	3511	0.0	0.0
chr1	SUCO	172588925	172589926	0	1002	6701	7919	6701	6917	0.0	0.9687725892728062
chr1	RABGAP1L	174219185	174219295	0	111	78645	13119	78645	13008	0.0	6.045894833948339
chr1	RABGAP1L	174700747	174700865	0	119	78645	13119	78645	13000	0.0	6.049615384615384
chr1	RABGAP1L	174701123	174701145	0	23	78645	13119	78645	13096	0.0	6.005268784361637
chr1	CACYBP	175004815	175004833	0	19	59	4456	59	4437	0.0	0.01329727293216137
chr1	TEX35	178514078	178514185	1816	108	3931	3115	2115	3007	16.814814814814813	0.7033588293980712
chr1	TEX35	178513228	178513251	0	24	3931	3115	3931	3091	0.0	1.2717567130378518
chr1	AXDND1	179365982	179366000	0	19	132	6113	132	6094	0.0	0.021660649819494584
chr1	AXDND1	179366001	179366126	0	126	132	6113	132	5987	0.0	0.022047770168698848
chr1	AXDND1	179365982	179366126	0	145	132	6113	132	5968	0.0	0.022117962466487937
chr1	AXDND1	179366001	179366011	0	11	132	6113	132	6102	0.0	0.021632251720747297
chr1	TOR1AIP1	179882978	179882992	90	15	16494	4707	16404	4692	6.0	3.49616368286445
chr1	LHX4	180248457	180248469	13	13	3178	6091	3165	6078	1.0	0.5207305034550839
chr1	OVAAL	180562267	180562344	0	78	153	2221	153	2143	0.0	0.07139524031731218
chr1	OVAAL	180562345	180562349	0	5	153	2221	153	2216	0.0	0.06904332129963899
chr1	OVAAL	180562267	180562349	0	83	153	2221	153	2138	0.0	0.0715622076707203
chr1	RGSL1	182460735	182460756	0	22	10133	8963	10133	8941	0.0	1.1333184207583045
chr1	NPL	182806233	182806531	304	299	3452	4113	3148	3814	1.0167224080267558	0.8253801782905087
chr1	SMG7	183542365	183542502	0	138	27613	8348	27613	8210	0.0	3.3633373934226554
chr1	TSEN15	184072299	184072310	0	12	651	8390	651	8378	0.0	0.07770350919073765
chr1	TSEN15	184072195	184072310	0	116	651	8390	651	8274	0.0	0.07868020304568528
chr1	TSEN15	184072195	184072298	0	104	651	8390	651	8286	0.0	0.07856625633598842
chr1	RO60	193069182	193069634	0	453	51598	8943	51598	8490	0.0	6.077502944640754
chr1	RO60	193084658	193084698	0	41	51598	8943	51598	8902	0.0	5.79622556728825
chr1	CRB1	197442293	197442534	0	242	10558	9131	10558	8889	0.0	1.1877601529980875
chr1	C1ORF53	197902851	197902913	6	63	51	484	45	421	0.09523809523809523	0.10688836104513064
chr1	NEK7	198157097	198157276	0	180	2895	5465	2895	5285	0.0	0.5477767265846736
chr1	PTPRC	198639335	198639341	0	7	0	9077	0	9070	0.0	0.0
chr1	AC104461.1	200474183	200474186	0	4	0	4073	0	4069	0.0	0.0
chr1	AC104461.1	200474101	200474186	0	86	0	4073	0	3987	0.0	0.0
chr1	AC104461.1	200474101	200474182	0	82	0	4073	0	3991	0.0	0.0
chr1	INAVA	200891403	200891701	0	299	0	4229	0	3930	0.0	0.0
chr1	MROH3P	200928418	200928421	0	4	195	3084	195	3080	0.0	0.0633116883116883
chr1	MROH3P	200937332	200937334	0	3	195	3084	195	3081	0.0	0.06329113924050633
chr1	MROH3P	200958988	200959038	0	51	195	3084	195	3033	0.0	0.06429277942631058
chr1	AL358473.1	201024077	201024085	0	9	0	3510	0	3501	0.0	0.0
chr1	ELF3	202010707	202011299	0	593	0	4243	0	3650	0.0	0.0
chr1	ELF3	202011294	202011299	0	6	0	4243	0	4237	0.0	0.0
chr1	ELF3	202010707	202010820	0	114	0	4243	0	4129	0.0	0.0
chr1	PTPRVP	202168108	202168511	0	404	0	6628	0	6224	0.0	0.0
chr1	PTPRVP	202177302	202177333	0	32	0	6628	0	6596	0.0	0.0
chr1	LINC01353	203288251	203288306	0	56	0	1392	0	1336	0.0	0.0
chr1	LAX1	203765384	203765654	17397	271	68355	3342	50958	3071	64.19557195571956	16.59329208726799
chr1	ZC3H11A	203795776	203795794	49	19	25925	8033	25876	8014	2.5789473684210527	3.228849513351635
chr1	ZC3H11A	203796497	203796601	86	105	25925	8033	25839	7928	0.819047619047619	3.259207870837538
chr1	ZC3H11A	203796497	203796607	92	111	25925	8033	25833	7922	0.8288288288288288	3.2609189598586217
chr1	ZC3H11A	203796602	203796607	6	6	25925	8033	25919	8027	1.0	3.228977201943441
chr1	ERLNC1	204141793	204142016	0	224	0	1534	0	1310	0.0	0.0
chr1	ERLNC1	204141793	204142260	0	468	0	1534	0	1066	0.0	0.0
chr1	ERLNC1	204142017	204142260	0	244	0	1534	0	1290	0.0	0.0
chr1	CNTN2	205073842	205073912	164	71	198164	14396	198000	14325	2.3098591549295775	13.821989528795811
chr1	CNTN2	205073237	205073564	818	328	198164	14396	197346	14068	2.4939024390243905	14.028006823997725
chr1	CDK18	205523626	205523715	0	90	102	5600	102	5510	0.0	0.018511796733212342
chr1	CDK18	205504797	205504878	0	82	102	5600	102	5518	0.0	0.018484958318231243
chr1	AC119673.2	205858294	205858320	153	27	15286	5942	15133	5915	5.666666666666667	2.5584108199492817
chr1	AC119673.2	205858290	205858320	153	31	15286	5942	15133	5911	4.935483870967742	2.5601421079343596
chr1	AC119673.2	205858290	205858293	0	4	15286	5942	15286	5938	0.0	2.5742674301111483
chr1	SRGAP2	206203483	206203650	0	168	24	12849	24	12681	0.0	0.0018925952211970665
chr1	SRGAP2	206342901	206343008	0	108	24	12849	24	12741	0.0	0.0018836825994819873
chr1	RASSF5	206584685	206585295	633	611	24944	5452	24311	4841	1.0360065466448445	5.021896302416856
chr1	DYRK3	206635781	206635835	7162	55	163741	10320	156579	10265	130.21818181818182	15.253677545056016
chr1	DYRK3	206635836	206636224	44298	389	163741	10320	119443	9931	113.87660668380462	12.027288289195448
chr1	IL19	206770831	206771078	0	248	181255	6241	181255	5993	0.0	30.244451860503922
chr1	CD46	207752098	207752309	0	212	0	7781	0	7569	0.0	0.0
chr1	LINC01717	208728730	208728734	0	5	0	1633	0	1628	0.0	0.0
chr1	LINC01717	208728730	208728932	0	203	0	1633	0	1430	0.0	0.0
chr1	LINC01717	208728735	208728932	0	198	0	1633	0	1435	0.0	0.0
chr1	MIR205HG	209428883	209429088	0	206	0	2601	0	2395	0.0	0.0
chr1	MIR205HG	209430477	209430500	0	24	0	2601	0	2577	0.0	0.0
chr1	MIR205HG	209430501	209431825	0	1325	0	2601	0	1276	0.0	0.0
chr1	MIR205HG	209429409	209431825	0	2417	0	2601	0	184	0.0	0.0
chr1	MIR205HG	209430477	209431825	0	1349	0	2601	0	1252	0.0	0.0
chr1	CAMK1G	209583773	209583932	0	160	0	3342	0	3182	0.0	0.0
chr1	TRAF3IP3	209760325	209760384	0	60	0	5521	0	5461	0.0	0.0
chr1	SYT14	210100191	210100461	0	271	61132	13990	61132	13719	0.0	4.456009913258984
chr1	RCOR3	211312836	211312961	0	126	114	9078	114	8952	0.0	0.012734584450402145
chr1	LINC00467	211422640	211422700	0	61	18341	6958	18341	6897	0.0	2.659272147310425
chr1	LINC00467	211422671	211422700	0	30	18341	6958	18341	6928	0.0	2.6473729792147807
chr1	LINC00467	211396832	211396841	0	10	18341	6958	18341	6948	0.0	2.6397524467472655
chr1	LINC00467	211422640	211422670	0	31	18341	6958	18341	6927	0.0	2.6477551609643424
chr1	LINC00467	211382926	211382975	0	50	18341	6958	18341	6908	0.0	2.6550376375217137
chr1	LINC01693	211639890	211640189	0	300	0	2205	0	1905	0.0	0.0
chr1	LINC01693	211640190	211640360	0	171	0	2205	0	2034	0.0	0.0
chr1	LINC01693	211639890	211640360	0	471	0	2205	0	1734	0.0	0.0
chr1	AC096637.2	211685793	211685806	0	14	0	2423	0	2409	0.0	0.0
chr1	KCNK2	215083308	215083431	0	124	0	3448	0	3324	0.0	0.0
chr1	MTARC1	220798015	220798065	256	51	3438	9006	3182	8955	5.019607843137255	0.3553322166387493
chr1	TAF1A-AS1	222589963	222590407	0	445	0	2263	0	1818	0.0	0.0
chr1	DISP1	222942971	222943332	0	362	44838	10206	44838	9844	0.0	4.554855749695246
chr1	DISP1	222815079	222815171	18529	93	44838	10206	26309	10113	199.23655913978496	2.6015030159201027
chr1	AC138393.1	223996002	223996094	51	93	1275	3147	1224	3054	0.5483870967741935	0.40078585461689586
chr1	DNAH14	224967515	224967583	0	69	2459	19791	2459	19722	0.0	0.12468309502078896
chr1	DNAH14	225051685	225051795	0	111	2459	19791	2459	19680	0.0	0.12494918699186992
chr1	DNAH14	225367877	225368032	0	156	2459	19791	2459	19635	0.0	0.12523554876496054
chr1	DNAH14	225250704	225250707	36	4	2459	19791	2423	19787	9.0	0.12245413655430333
chr1	EPHX1	225810170	225810615	1290	446	3078	2518	1788	2072	2.89237668161435	0.862934362934363
chr1	H3-3A	226062812	226062948	0	137	35025	3832	35025	3695	0.0	9.479025710419485
chr1	H3-3A	226065810	226065817	0	8	35025	3832	35025	3824	0.0	9.159257322175732
chr1	H3-3A	226063597	226063681	0	85	35025	3832	35025	3747	0.0	9.347477982385909
chr1	LINC01703	226083642	226083968	0	327	153	1616	153	1289	0.0	0.1186966640806827
chr1	PSEN2	226891845	226891849	0	5	2692	12917	2692	12912	0.0	0.20848822800495662
chr1	ARF1	228082766	228082850	0	85	0	3176	0	3091	0.0	0.0
chr1	ARF1	228083310	228083374	0	65	0	3176	0	3111	0.0	0.0
chr1	ARF1	228083353	228083374	0	22	0	3176	0	3154	0.0	0.0
chr1	ARF1	228083310	228083352	0	43	0	3176	0	3133	0.0	0.0
chr1	GUK1	228148457	228148539	0	83	0	2999	0	2916	0.0	0.0
chr1	GUK1	228145625	228145649	0	25	0	2999	0	2974	0.0	0.0
chr1	GUK1	228141508	228141829	0	322	0	2999	0	2677	0.0	0.0
chr1	OBSCN	228374749	228374752	0	4	3739400	37944	3739400	37940	0.0	98.56088560885608
chr1	OBSCN	228356194	228356344	0	151	3739400	37944	3739400	37793	0.0	98.94424893498795
chr1	LINC01736	230006025	230006098	0	74	77	1189	77	1115	0.0	0.06905829596412556
chr1	AL118511.1	230874716	230875155	0	440	0	1948	0	1508	0.0	0.0
chr1	ARV1	230979257	230979279	1260	23	14061	2003	12801	1980	54.78260869565217	6.465151515151515
chr1	TRIM67	231201512	231201517	0	6	252	8359	252	8353	0.0	0.03016880162815755
chr1	GNPAT	231260654	231260683	0	30	0	2954	0	2924	0.0	0.0
chr1	DISC1	232008984	232009049	0	66	50684	12565	50684	12499	0.0	4.055044403552285
chr1	TBCE	235414470	235414618	0	149	14167	8049	14167	7900	0.0	1.7932911392405064
chr1	TBCE	235419516	235419561	57	46	14167	8049	14110	8003	1.2391304347826086	1.7630888416843684
chr1	TBCE	235433099	235433171	0	73	14167	8049	14167	7976	0.0	1.7762036108324974
chr1	AL357556.3	235329184	235330500	4305	1317	11600	5210	7295	3893	3.2687927107061503	1.8738761880297972
chr1	AL357556.3	235330501	235330602	4744	102	11600	5210	6856	5108	46.509803921568626	1.342208300704777
chr1	TBCE	235367505	235367552	0	48	14167	8049	14167	8001	0.0	1.7706536682914635
chr1	TBCE	235438923	235438988	0	66	14167	8049	14167	7983	0.0	1.7746461230113992
chr1	TBCE	235438927	235438988	0	62	14167	8049	14167	7987	0.0	1.7737573557030175
chr1	TBCE	235438923	235438926	0	4	14167	8049	14167	8045	0.0	1.760969546302051
chr1	TBCE	235442912	235442961	0	50	14167	8049	14167	7999	0.0	1.7710963870483811
chr1	MTR	236838519	236838599	0	81	2805	12378	2805	12297	0.0	0.22810441571114906
chr1	CHRM3	239632277	239632286	0	10	0	15165	0	15155	0.0	0.0
chr1	CHRM3	239545750	239545753	0	4	0	15165	0	15161	0.0	0.0
chr1	AL365184.1	240763660	240763862	0	203	79	2738	79	2535	0.0	0.03116370808678501
chr1	AL365184.1	240768232	240768304	0	73	79	2738	79	2665	0.0	0.029643527204502813
chr1	AL359764.2	241436504	241436522	0	19	51	9640	51	9621	0.0	0.005300904271905207
chr1	AL359764.2	241424550	241424714	0	165	51	9640	51	9475	0.0	0.005382585751978892
chr1	EXO1	241848273	241848353	0	81	16	4110	16	4029	0.0	0.003971208736659221
chr1	EXO1	241853473	241853481	0	9	16	4110	16	4101	0.0	0.003901487442087296
chr1	CNST	246566664	246566789	0	126	6732	5943	6732	5817	0.0	1.1572975760701392
chr1	LINC01341	246780510	246780583	0	74	5952	4672	5952	4598	0.0	1.2944758590691605
chr1	LINC01341	246790847	246791195	102	349	5952	4672	5850	4323	0.2922636103151863	1.3532269257460097
chr1	NLRP3	247425600	247425770	0	171	102	4587	102	4416	0.0	0.02309782608695652
chr1	AL390860.1	247640430	247640433	0	4	0	3842	0	3838	0.0	0.0
chr1	AL627309.1	120720	120773	96	54	3884	3729	3788	3675	1.7777777777777777	1.030748299319728
chr1	AL627309.5	167958	168098	1181	141	31498	7438	30317	7297	8.375886524822695	4.154721118267782
chr1	AL732372.2	502464	502860	0	397	0	6130	0	5733	0.0	0.0
chr1	AL732372.2	498046	498071	0	26	0	6130	0	6104	0.0	0.0
chr1	AL732372.2	517155	517183	0	29	0	6130	0	6101	0.0	0.0
chr1	FAM41C	874111	875038	22344	928	24252	1807	1908	879	24.07758620689655	2.1706484641638224
chr1	HES4	999691	999864	51	174	2340	966	2289	792	0.29310344827586204	2.890151515151515
chr1	C1ORF159	1083914	1084351	0	438	510	4115	510	3677	0.0	0.13870002719608376
chr1	TNFRSF18	1204033	1204053	0	21	12528	1276	12528	1255	0.0	9.982470119521912
chr1	UBE2J2	1267732	1267860	0	129	354458	4676	354458	4547	0.0	77.95425555311195
chr1	UBE2J2	1273498	1273664	24263	167	354458	4676	330195	4509	145.2874251497006	73.23020625415835
chr1	UBE2J2	1273376	1273664	31688	289	354458	4676	322770	4387	109.6470588235294	73.57419648962845
chr1	UBE2J2	1273376	1273497	7425	122	354458	4676	347033	4554	60.86065573770492	76.20399648660518
chr1	UBE2J2	1262169	1262267	18608	99	354458	4676	335850	4577	187.95959595959596	73.3777583570024
chr1	UBE2J2	1272852	1273375	785	524	354458	4676	353673	4152	1.498091603053435	85.18135838150289
chr1	INTS11	1322891	1323179	49832	289	392827	6765	342995	6476	172.42906574394465	52.96402100061766
chr1	INTS11	1323146	1323179	19600	34	392827	6765	373227	6731	576.4705882352941	55.448967463972664
chr1	INTS11	1322891	1323145	30232	255	392827	6765	362595	6510	118.55686274509804	55.69815668202765
chr1	DVL1	1339286	1339360	3018	75	203373	3895	200355	3820	40.24	52.44895287958115
chr1	AURKAIP1	1375074	1375152	0	79	5535	1466	5535	1387	0.0	3.9906272530641673
chr1	AURKAIP1	1374996	1375152	54	157	5535	1466	5481	1309	0.34394904458598724	4.18716577540107
chr1	AURKAIP1	1374996	1375073	54	78	5535	1466	5481	1388	0.6923076923076923	3.9488472622478388
chr1	CCNL2	1392678	1392788	0	111	97762	6208	97762	6097	0.0	16.034443168771528
chr1	CCNL2	1398987	1399017	0	31	97762	6208	97762	6177	0.0	15.826776752468836
chr1	ANKRD65	1420796	1420814	72	19	183396	2647	183324	2628	3.789473684210526	69.7579908675799
chr1	LINC01770	1434177	1434186	0	10	23426	854	23426	844	0.0	27.755924170616115
chr1	CDK11B	1642346	1642384	1131	39	227309	3502	226178	3463	29.0	65.31273462315912
chr1	CDK11A	1707408	1707523	689	116	173055	4549	172366	4433	5.939655172413793	38.882472366343336
chr1	CDK11A	1719327	1719356	274	30	173055	4549	172781	4519	9.133333333333333	38.23434388138969
chr1	CDK11A	1722587	1722706	896	120	173055	4549	172159	4429	7.466666666666667	38.87085120794762
chr1	CDK11A	1709478	1709516	0	39	173055	4549	173055	4510	0.0	38.37139689578714
chr1	CDK11A	1723799	1723947	488	149	173055	4549	172567	4400	3.2751677852348995	39.219772727272726
chr1	CDK11A	1723948	1724256	6	309	173055	4549	173049	4240	0.019417475728155338	40.81344339622642
chr1	NADK	1756738	1756777	891	40	276911	5178	276020	5138	22.275	53.72129233164655
chr1	FAAP20	2203435	2203562	153	128	47124	8807	46971	8679	1.1953125	5.41202903560318
chr1	FAAP20	2198753	2201048	6986	2296	47124	8807	40138	6511	3.042682926829268	6.164644447857472
chr1	FAAP20	2192646	2192843	1218	198	47124	8807	45906	8609	6.151515151515151	5.332326634916948
chr1	PEX10	2408451	2408454	0	4	0	3454	0	3450	0.0	0.0
chr1	PEX10	2410260	2410369	0	110	0	3454	0	3344	0.0	0.0
chr1	TNFRSF14-AS1	2554723	2555679	0	957	0	4264	0	3307	0.0	0.0
chr1	MMEL1	2592654	2592719	0	66	23	3894	23	3828	0.0	0.0060083594566353185
chr1	PRDM16-DT	3060500	3061105	0	606	0	4427	0	3821	0.0	0.0
chr1	TP73-AS1	3745380	3745605	723	226	120321	6550	119598	6324	3.1991150442477876	18.91176470588235
chr1	TP73-AS1	3746436	3746526	13276	91	120321	6550	107045	6459	145.8901098901099	16.572998916240905
chr1	TP73-AS1	3743279	3743299	3962	21	120321	6550	116359	6529	188.66666666666666	17.821871649563487
chr1	CEP104	3837287	3837290	0	4	8636	11552	8636	11548	0.0	0.7478351229650156
chr1	CEP104	3829132	3829264	0	133	8636	11552	8636	11419	0.0	0.7562833873368946
chr1	CHD5	6130147	6130202	0	56	14791	10138	14791	10082	0.0	1.467070025788534
chr1	TNFRSF25	6463064	6463070	14	7	373	3596	359	3589	2.0	0.10002786291446085
chr1	TNFRSF25	6462862	6463070	44	209	373	3596	329	3387	0.21052631578947367	0.09713610865072335
chr1	PLEKHG5	6485801	6485834	0	34	0	6625	0	6591	0.0	0.0
chr1	PLEKHG5	6485801	6485808	0	8	0	6625	0	6617	0.0	0.0
chr1	PLEKHG5	6491586	6491635	19	50	0	6625	-19	6575	0.38	-0.0028897338403041824
chr1	PLEKHG5	6485809	6485834	0	26	0	6625	0	6599	0.0	0.0
chr1	LZIC	9943248	9943347	172	100	56852	5468	56680	5368	1.72	10.558867362146051
chr1	DFFA	10462987	10463056	862	70	495472	6631	494610	6561	12.314285714285715	75.38637402834934
chr1	C1ORF127	10949623	10949700	0	78	0	3581	0	3503	0.0	0.0
chr1	SRM	11058709	11058798	0	90	357	1901	357	1811	0.0	0.19712865819988956
chr1	MAD2L2	11676808	11676846	0	39	0	2907	0	2868	0.0	0.0
chr1	MTHFR	11803404	11803797	0	394	73387	6734	73387	6340	0.0	11.575236593059937
chr1	MTHFR	11805346	11805886	12870	541	73387	6734	60517	6193	23.78927911275416	9.771839173260133
chr1	CASP9	15518109	15518248	212	140	6658	4712	6446	4572	1.5142857142857142	1.409886264216973
chr1	HSPB7	16017073	16017087	0	15	4108	2655	4108	2640	0.0	1.5560606060606061
chr1	ATP13A2	17004691	17004705	0	15	75763	5196	75763	5181	0.0	14.623238756996718
chr1	SDHB	17028599	17028652	0	54	0	2335	0	2281	0.0	0.0
chr1	EMC1	19244738	19244904	1734	167	28869	8562	27135	8395	10.383233532934131	3.2322811197141155
chr1	KIF17	20717348	20717474	0	127	765	4306	765	4179	0.0	0.18305814788226848
chr1	HP1BP3	20780344	20780348	0	5	138	5936	138	5931	0.0	0.02326757713707638
chr1	HP1BP3	20786185	20786251	0	67	138	5936	138	5869	0.0	0.023513375362071903
chr1	HP1BP3	20786252	20786647	0	396	138	5936	138	5540	0.0	0.024909747292418773
chr1	HP1BP3	20786252	20786512	0	261	138	5936	138	5675	0.0	0.024317180616740087
chr1	RAP1GAP	21603657	21603833	0	177	2637	5400	2637	5223	0.0	0.504882251579552
chr1	USP48	21736429	21736444	0	16	37164	9527	37164	9511	0.0	3.9074755546209654
chr1	LINC01635	22024805	22025058	0	254	102	1231	102	977	0.0	0.10440122824974411
chr1	ASAP3	23433076	23433156	0	81	5075	5015	5075	4934	0.0	1.0285772192946898
chr1	ASAP3	23484004	23484034	0	31	5075	5015	5075	4984	0.0	1.0182584269662922
chr1	ASAP3	23433361	23433423	0	63	5075	5015	5075	4952	0.0	1.0248384491114702
chr1	ASAP3	23435722	23435849	0	128	5075	5015	5075	4887	0.0	1.0384694086351545
chr1	ELOA-AS1	23772267	23772270	0	4	17606	2991	17606	2987	0.0	5.894208235687981
chr1	GALE	23800307	23800385	198	79	865	3023	667	2944	2.5063291139240507	0.2265625
chr1	RCAN3AS	24502347	24502371	3	25	3	767	0	742	0.12	0.0
chr1	RSRP1	25337039	25337976	0	938	0	5486	0	4548	0.0	0.0
chr1	RSRP1	25337039	25338067	0	1029	0	5486	0	4457	0.0	0.0
chr1	RSRP1	25244176	25245148	0	973	0	5486	0	4513	0.0	0.0
chr1	RSRP1	25244176	25244452	0	277	0	5486	0	5209	0.0	0.0
chr1	RSRP1	25337977	25338067	0	91	0	5486	0	5395	0.0	0.0
chr1	AL020996.1	25819643	25819710	60	68	1848	1576	1788	1508	0.8823529411764706	1.1856763925729443
chr1	AL020996.1	25818222	25818401	759	180	1848	1576	1089	1396	4.216666666666667	0.7800859598853869
chr1	CRYBG2	26354035	26354044	0	10	792	6090	792	6080	0.0	0.13026315789473683
chr1	ZNF683	26372463	26372667	0	205	123	2318	123	2113	0.0	0.05821107430194037
chr1	ZNF683	26372534	26372667	0	134	123	2318	123	2184	0.0	0.05631868131868132
chr1	AHDC1	27604105	27604108	0	4	2495	4518	2495	4514	0.0	0.5527248560035445
chr1	IFI6	27669220	27669243	0	24	150	847	150	823	0.0	0.1822600243013366
chr1	IFI6	27669220	27669231	0	12	150	847	150	835	0.0	0.17964071856287425
chr1	IFI6	27669232	27669243	0	12	150	847	150	835	0.0	0.17964071856287425
chr1	RPA2	27914421	27914432	0	12	1186	1976	1186	1964	0.0	0.6038696537678208
chr1	SNHG12	28579911	28579940	0	30	255	3699	255	3669	0.0	0.06950122649223221
chr1	SNHG12	28580424	28580558	0	135	255	3699	255	3564	0.0	0.07154882154882154
chr1	SNHG12	28581093	28581109	0	17	255	3699	255	3682	0.0	0.0692558392178164
chr1	SNHG12	28581589	28582088	0	500	255	3699	255	3199	0.0	0.07971241012816505
chr1	TAF12	28642654	28642990	0	337	1603	2346	1603	2009	0.0	0.7979094076655052
chr1	PUM1	31059203	31059297	0	95	0	6646	0	6551	0.0	0.0
chr1	PUM1	31065615	31065687	0	73	0	6646	0	6573	0.0	0.0
chr1	PUM1	30950126	30950131	0	6	0	6646	0	6640	0.0	0.0
chr1	PUM1	30941921	30941996	0	76	0	6646	0	6570	0.0	0.0
chr1	SPOCD1	31796589	31796591	0	3	9798	6982	9798	6979	0.0	1.4039260639060038
chr1	SPOCD1	31813950	31815346	1626	1397	9798	6982	8172	5585	1.1639226914817467	1.4632050134288273
chr1	SPOCD1	31815743	31815959	38	217	9798	6982	9760	6765	0.17511520737327188	1.442719881744272
chr1	PTP4A2	31937754	31937776	0	23	0	6592	0	6569	0.0	0.0
chr1	MTMR9LP	32239868	32239889	0	22	0	2789	0	2767	0.0	0.0
chr1	ZBTB8OS	32634701	32634766	8	66	45880	3541	45872	3475	0.12121212121212122	13.200575539568346
chr1	ZBTB8OS	32650428	32650431	26	4	45880	3541	45854	3537	6.5	12.964093864857224
chr1	ZBTB8OS	32650401	32650431	247	31	45880	3541	45633	3510	7.967741935483871	13.0008547008547
chr1	PHC2	33334089	33334183	0	95	95841	4902	95841	4807	0.0	19.9377990430622
chr1	PHC2	33354837	33354839	0	3	95841	4902	95841	4899	0.0	19.56338028169014
chr1	SMIM12	34859651	34859675	0	25	0	8690	0	8665	0.0	0.0
chr1	SMIM12	34859454	34859675	0	222	0	8690	0	8468	0.0	0.0
chr1	SMIM12	34859454	34859650	0	197	0	8690	0	8493	0.0	0.0
chr1	ZMYM6	35031525	35031629	0	105	51	9585	51	9480	0.0	0.005379746835443038
chr1	KIAA0319L	35557206	35557360	0	155	20963	9295	20963	9140	0.0	2.2935448577680524
chr1	KIAA0319L	35557047	35557205	0	159	20963	9295	20963	9136	0.0	2.294549036777583
chr1	KIAA0319L	35557047	35557360	0	314	20963	9295	20963	8981	0.0	2.3341498719518983
chr1	KIAA0319L	35554788	35554898	25	111	20963	9295	20938	9184	0.22522522522522523	2.279834494773519
chr1	COL8A2	36100049	36100193	0	145	309526	4673	309526	4528	0.0	68.35821554770318
chr1	TRAPPC3	36149259	36149335	0	77	204	3533	204	3456	0.0	0.059027777777777776
chr1	TRAPPC3	36149091	36149335	0	245	204	3533	204	3288	0.0	0.06204379562043796
chr1	TRAPPC3	36149091	36149258	0	168	204	3533	204	3365	0.0	0.06062407132243685
chr1	STK40	36367847	36367850	357	4	56769	5632	56412	5628	89.25	10.023454157782515
chr1	SNIP1	37554005	37554190	0	186	0	5537	0	5351	0.0	0.0
chr1	RSPO1	37629567	37629887	0	321	0	3066	0	2745	0.0	0.0
chr1	C1ORF109	37689605	37689656	0	52	0	3992	0	3940	0.0	0.0
chr1	C1ORF109	37690215	37690332	0	118	0	3992	0	3874	0.0	0.0
chr1	C1ORF109	37690001	37690332	0	332	0	3992	0	3660	0.0	0.0
chr1	C1ORF109	37690001	37690214	0	214	0	3992	0	3778	0.0	0.0
chr1	EPHA10	37718375	37718376	0	2	3	8168	3	8166	0.0	0.0003673769287288758
chr1	EPHA10	37719413	37719506	0	94	3	8168	3	8074	0.0	0.0003715630418627694
chr1	INPP5B	37931672	37931911	0	240	3781	5821	3781	5581	0.0	0.6774771546317864
chr1	FHL3	38005356	38005437	67	82	1122	2010	1055	1928	0.8170731707317073	0.5471991701244814
chr1	PPIEL	39529015	39529053	0	39	5231	3504	5231	3465	0.0	1.5096681096681097
chr1	PPIEL	39547578	39548860	0	1283	5231	3504	5231	2221	0.0	2.3552453849617287
chr1	PPIEL	39523557	39523560	0	4	5231	3504	5231	3500	0.0	1.4945714285714287
chr1	PABPC4	39561684	39561726	0	43	6584	8427	6584	8384	0.0	0.7853053435114504
chr1	PABPC4	39564685	39564699	0	15	6584	8427	6584	8412	0.0	0.7826913932477413
chr1	PABPC4	39564422	39564469	0	48	6584	8427	6584	8379	0.0	0.7857739587062895
chr1	PABPC4	39563526	39563612	0	87	6584	8427	6584	8340	0.0	0.7894484412470024
chr1	PABPC4	39571096	39571232	428	137	6584	8427	6156	8290	3.124087591240876	0.7425814234016888
chr1	TRIT1	39850118	39850121	0	4	10332	6546	10332	6542	0.0	1.579333537144604
chr1	PPT1	40076729	40076840	0	112	54	2932	54	2820	0.0	0.019148936170212766
chr1	PPT1	40097110	40097113	0	4	54	2932	54	2928	0.0	0.018442622950819672
chr1	PPT1	40096808	40097113	0	306	54	2932	54	2626	0.0	0.020563594821020565
chr1	PPT1	40096808	40097109	0	302	54	2932	54	2630	0.0	0.02053231939163498
chr1	SLFNL1	41021529	41021621	0	93	153	3549	153	3456	0.0	0.044270833333333336
chr1	SCMH1	41046406	41046416	0	11	10699	4464	10699	4453	0.0	2.402649898944532
chr1	P3H1	42747252	42747270	0	19	204	4271	204	4252	0.0	0.04797742238946378
chr1	C1ORF210	43285443	43285551	84	109	58895	1525	58811	1416	0.7706422018348624	41.53319209039548
chr1	ELOVL1	43364541	43364617	0	77	0	2516	0	2439	0.0	0.0
chr1	ELOVL1	43364541	43364613	0	73	0	2516	0	2443	0.0	0.0
chr1	ELOVL1	43364614	43364617	0	4	0	2516	0	2512	0.0	0.0
chr1	HYI	43451797	43451826	0	30	51	1686	51	1656	0.0	0.030797101449275364
chr1	HYI	43451409	43451426	0	18	51	1686	51	1668	0.0	0.030575539568345324
chr1	HYI	43453385	43453411	0	27	51	1686	51	1659	0.0	0.03074141048824593
chr1	SLC6A9	44010725	44010807	38423	83	59419	5268	20996	5185	462.9277108433735	4.0493731918997105
chr1	MUTYH	45340218	45340221	106	4	57316	5148	57210	5144	26.5	11.121695178849144
chr1	MUTYH	45331660	45332021	306	362	57316	5148	57010	4786	0.8453038674033149	11.91182615963226
chr1	MUTYH	45339661	45339897	505	237	57316	5148	56811	4911	2.130801687763713	11.568112400733048
chr1	MUTYH	45340202	45340217	234	16	57316	5148	57082	5132	14.625	11.122759158222914
chr1	MUTYH	45340202	45340221	340	20	57316	5148	56976	5128	17.0	11.110764430577223
chr1	MUTYH	45338185	45338505	773	321	57316	5148	56543	4827	2.4080996884735204	11.713900973689663
chr1	CCDC163	45497298	45497302	0	5	51	2764	51	2759	0.0	0.018484958318231243
chr1	PRDX1	45521608	45521856	0	249	50	1470	50	1221	0.0	0.04095004095004095
chr1	PRDX1	45521608	45521827	0	220	50	1470	50	1250	0.0	0.04
chr1	PRDX1	45521828	45521856	0	29	50	1470	50	1441	0.0	0.03469812630117974
chr1	CCDC17	45620527	45620721	0	195	0	2792	0	2597	0.0	0.0
chr1	PIK3R3	46132698	46132782	918	85	63799	7408	62881	7323	10.8	8.586781373753926
chr1	POMGNT1	46189457	46189482	0	26	5676	5476	5676	5450	0.0	1.0414678899082568
chr1	POMGNT1	46196730	46196777	0	48	5676	5476	5676	5428	0.0	1.0456890198968312
chr1	LINC01398	46449486	46449497	0	12	102	1768	102	1756	0.0	0.05808656036446469
chr1	MKNK1	46604184	46604225	0	42	3739	6721	3739	6679	0.0	0.5598143434645905
chr1	MKNK1	46604164	46604183	15	20	3739	6721	3724	6701	0.75	0.5557379495597672
chr1	MKNK1	46604164	46604225	15	62	3739	6721	3724	6659	0.24193548387096775	0.5592431295990389
chr1	EFCAB14	46716290	46716293	0	4	45758	13320	45758	13316	0.0	3.436317212376089
chr1	SPATA6	48355669	48355716	0	48	0	5955	0	5907	0.0	0.0
chr1	SPATA6	48400772	48400788	0	17	0	5955	0	5938	0.0	0.0
chr1	LINC02808	50280034	50280083	0	50	51	3525	51	3475	0.0	0.014676258992805755
chr1	CALR4P	51567173	51567750	0	578	408	2713	408	2135	0.0	0.19110070257611242
chr1	CC2D1B	52353517	52353601	0	85	688	7104	688	7019	0.0	0.09801966092035902
chr1	ECHDC2	52921482	52921551	68	70	61438	10086	61370	10016	0.9714285714285714	6.127196485623003
chr1	SLC1A7	53102263	53103344	0	1082	867	3662	867	2580	0.0	0.336046511627907
chr1	LRP8	53246917	53246954	0	38	79251	13559	79251	13521	0.0	5.861326824938984
chr1	LRP8	53246917	53246922	0	6	79251	13559	79251	13553	0.0	5.847487641112669
chr1	LRP8	53246923	53246954	0	32	79251	13559	79251	13527	0.0	5.858726990463517
chr1	TMEM59	54052999	54053354	1193	356	27443	9158	26250	8802	3.351123595505618	2.98227675528289
chr1	AL357673.1	54144465	54144567	0	103	908	3965	908	3862	0.0	0.2351113412739513
chr1	CYB5RL	54190737	54190746	0	10	8687	8739	8687	8729	0.0	0.9951884522854851
chr1	DHCR24	54886617	54886800	0	184	2550	4979	2550	4795	0.0	0.5318039624608968
chr1	AL590440.2	54979839	54979987	0	149	0	1589	0	1440	0.0	0.0
chr1	LINC01753	55921311	55921363	0	53	58	710	58	657	0.0	0.0882800608828006
chr1	DAB1	57062883	57062888	0	6	3895	7577	3895	7571	0.0	0.5144630828160085
chr1	OMA1	58546663	58546701	0	39	0	3704	0	3665	0.0	0.0
chr1	OMA1	58546663	58546688	0	26	0	3704	0	3678	0.0	0.0
chr1	OMA1	58546689	58546701	0	13	0	3704	0	3691	0.0	0.0
chr1	OMA1	58546689	58546739	0	51	0	3704	0	3653	0.0	0.0
chr1	OMA1	58546634	58546701	0	68	0	3704	0	3636	0.0	0.0
chr1	OMA1	58546634	58546662	0	29	0	3704	0	3675	0.0	0.0
chr1	OMA1	58546634	58546688	0	55	0	3704	0	3649	0.0	0.0
chr1	LINC02777	58896546	58896648	0	103	29	1976	29	1873	0.0	0.015483182060864922
chr1	HSD52	59133230	59133254	0	25	16526	6497	16526	6472	0.0	2.5534610630407912
chr1	CYP2J2	59926520	59926535	0	16	0	2983	0	2967	0.0	0.0
chr1	LINC01748	60542289	60542295	0	7	0	15481	0	15474	0.0	0.0
chr1	LINC01748	60596125	60596247	0	123	0	15481	0	15358	0.0	0.0
chr1	LINC01748	60596125	60596167	0	43	0	15481	0	15438	0.0	0.0
chr1	LINC01748	60596168	60596247	0	80	0	15481	0	15401	0.0	0.0
chr1	TM2D1	61724901	61724918	0	18	0	5509	0	5491	0.0	0.0
chr1	DOCK7	62513443	62513469	0	27	8017	19101	8017	19074	0.0	0.4203103701373598
chr1	ROR1-AS1	64111945	64111982	0	38	58222	4585	58222	4547	0.0	12.804486474598637
chr1	JAK1	64841450	64841554	0	105	51	11649	51	11544	0.0	0.004417879417879418
chr1	LINC01359	65002328	65002407	0	80	0	5118	0	5038	0.0	0.0
chr1	LINC01359	64993471	64993475	0	5	0	5118	0	5113	0.0	0.0
chr1	DNAI4	66890182	66891152	562	971	4444	6353	3882	5382	0.5787847579814624	0.7212931995540691
chr1	DEPDC1	68482045	68482639	0	595	0	5916	0	5321	0.0	0.0
chr1	LRRIQ3	74041212	74041689	0	478	0	6363	0	5885	0.0	0.0
chr1	USP33	77759642	77759699	679	58	5396	6945	4717	6887	11.706896551724139	0.6849136053434006
chr1	ADGRL4	79006542	79006631	0	90	6644	5737	6644	5647	0.0	1.176553922436692
chr1	UOX	84372041	84372041	24	1	797	2424	773	2423	24.0	0.31902600082542304
chr1	CTBS	84573915	84574237	0	323	18185	6941	18185	6618	0.0	2.747809005741916
chr1	SSX2IP	84671176	84671187	0	12	21044	8472	21044	8460	0.0	2.487470449172577
chr1	SSX2IP	84690153	84690369	0	217	21044	8472	21044	8255	0.0	2.549242883101151
chr1	MCOLN2	84996795	84997006	282	212	4016	3246	3734	3034	1.330188679245283	1.2307185234014502
chr1	MCOLN3	85047309	85047573	0	265	12191	6622	12191	6357	0.0	1.9177284882806356
chr1	BCL10	85274943	85276294	0	1352	0	2283	0	931	0.0	0.0
chr1	BCL10	85274943	85275161	0	219	0	2283	0	2064	0.0	0.0
chr1	SELENOF	86914027	86914313	0	287	0	2208	0	1921	0.0	0.0
chr1	SELENOF	86913805	86914026	0	222	0	2208	0	1986	0.0	0.0
chr1	PKN2-AS1	87903867	87903897	31	31	1303	16670	1272	16639	1.0	0.07644690185708276
chr1	GTF2B	88857205	88857371	0	167	26	2533	26	2366	0.0	0.01098901098901099
chr1	GTF2B	88887260	88887274	0	15	26	2533	26	2518	0.0	0.010325655281969817
chr1	GBP3	89013184	89013196	0	13	435	4282	435	4269	0.0	0.10189739985945186
chr1	GBP3	89020125	89020128	0	4	435	4282	435	4278	0.0	0.10168302945301542
chr1	GBP3	89014404	89014545	0	142	435	4282	435	4140	0.0	0.10507246376811594
chr1	GBP3	89020352	89020530	0	179	435	4282	435	4103	0.0	0.10601998537655374
chr1	LRRC8C-DT	89632015	89632018	0	4	5508	6795	5508	6791	0.0	0.81107347960536
chr1	LINC02609	90851482	90851539	0	58	51	14100	51	14042	0.0	0.0036319612590799033
chr1	LINC02609	90835825	90836000	0	176	51	14100	51	13924	0.0	0.00366274059178397
chr1	LINC02609	90834385	90834619	0	235	51	14100	51	13865	0.0	0.003678326721961774
chr1	LINC02609	90834385	90834508	0	124	51	14100	51	13976	0.0	0.0036491127647395537
chr1	LINC02609	90834509	90834619	0	111	51	14100	51	13989	0.0	0.003645721638430195
chr1	CCDC18-AS1	93337376	93339154	0	1779	32571	4958	32571	3179	0.0	10.245674740484429
chr1	CCDC18-AS1	93345539	93345722	0	184	32571	4958	32571	4774	0.0	6.82258064516129
chr1	CCDC18-AS1	93345539	93345644	0	106	32571	4958	32571	4852	0.0	6.7129018961253095
chr1	CCDC18-AS1	93345645	93345722	0	78	32571	4958	32571	4880	0.0	6.6743852459016395
chr1	SLC44A3-AS1	94623525	94623877	0	353	9674	10264	9674	9911	0.0	0.9760871758652003
chr1	PLPPR5	98914785	98914799	0	15	0	4707	0	4692	0.0	0.0
chr1	FRRS1	99710805	99710832	0	28	0	8643	0	8615	0.0	0.0
chr1	RTCA-AS1	100265814	100265827	0	14	306	7246	306	7232	0.0	0.04231194690265487
chr1	EXTL2	100878393	100878422	0	30	0	4022	0	3992	0.0	0.0
chr1	DPH5	101025664	101025681	0	18	0	2126	0	2108	0.0	0.0
chr1	DPH5	101025682	101025803	0	122	0	2126	0	2004	0.0	0.0
chr1	AMY1B	103696041	103696282	0	242	0	2346	0	2104	0.0	0.0
chr1	LINC01676	105618774	105618857	0	84	0	3046	0	2962	0.0	0.0
chr1	LINC01677	105992153	105992164	0	12	0	3134	0	3122	0.0	0.0
chr1	CLCC1	108963360	108963399	44	40	2556	6514	2512	6474	1.1	0.38801359283286996
chr1	CLCC1	108963360	108963379	20	20	2556	6514	2536	6494	1.0	0.3905143209116107
chr1	CLCC1	108934619	108934623	0	5	2556	6514	2556	6509	0.0	0.3926870487017975
chr1	CLCC1	108934566	108934623	0	58	2556	6514	2556	6456	0.0	0.395910780669145
chr1	CLCC1	108934566	108934618	0	53	2556	6514	2556	6461	0.0	0.3956043956043956
chr1	CLCC1	108963342	108963399	62	58	2556	6514	2494	6456	1.0689655172413792	0.38630731102850063
chr1	CLCC1	108963342	108963359	18	18	2556	6514	2538	6496	1.0	0.39070197044334976
chr1	CLCC1	108963342	108963379	38	38	2556	6514	2518	6476	1.0	0.3888202594193947
chr1	CLCC1	108962308	108963359	133	1052	2556	6514	2423	5462	0.12642585551330798	0.44361039912120104
chr1	CLCC1	108962308	108963399	177	1092	2556	6514	2379	5422	0.1620879120879121	0.4387679822943563
chr1	CLCC1	108962308	108963379	153	1072	2556	6514	2403	5442	0.14272388059701493	0.4415656008820287
chr1	CLCC1	108963380	108963399	24	20	2556	6514	2532	6494	1.2	0.38989836772405295
chr1	WDR47	109013819	109013839	0	21	3840	4440	3840	4419	0.0	0.8689748811948405
chr1	PSRC1	109283062	109283072	0	11	153	2373	153	2362	0.0	0.06477561388653684
chr1	PSRC1	109283027	109283061	0	35	153	2373	153	2338	0.0	0.06544054747647562
chr1	PSRC1	109283027	109283072	0	46	153	2373	153	2327	0.0	0.06574989256553503
chr1	LAMTOR5	110407032	110407584	342	553	954	1329	612	776	0.6184448462929476	0.788659793814433
chr1	KCNA2	110603888	110603891	0	4	422749	18742	422749	18738	0.0	22.56105240687373
chr1	LRIF1	110951287	110952530	404	1244	17938	3506	17534	2262	0.3247588424437299	7.751547303271441
chr1	DRAM2	111139500	111139586	0	87	0	3309	0	3222	0.0	0.0
chr1	DRAM2	111139500	111140036	0	537	0	3309	0	2772	0.0	0.0
chr1	DRAM2	111140037	111140041	0	5	0	3309	0	3304	0.0	0.0
chr1	AL390195.1	111440691	111441136	51	446	98	863	47	417	0.11434977578475336	0.11270983213429256
chr1	TMIGD3	111503004	111503497	0	494	17281	2276	17281	1782	0.0	9.697530864197532
chr1	LINC01160	111608135	111608211	0	77	0	1382	0	1305	0.0	0.0
chr1	ST7L	112618783	112618907	0	125	0	7822	0	7697	0.0	0.0
chr1	RHOC	112705052	112705098	0	47	0	2792	0	2745	0.0	0.0
chr1	RHOC	112706731	112706831	0	101	0	2792	0	2691	0.0	0.0
chr1	RHOC	112706731	112707076	0	346	0	2792	0	2446	0.0	0.0
chr1	PPM1J	112714057	112714974	0	918	0	2461	0	1543	0.0	0.0
chr1	PPM1J	112714057	112714632	0	576	0	2461	0	1885	0.0	0.0
chr1	SLC16A1	112955275	112956033	51	759	102	5162	51	4403	0.06719367588932806	0.011583011583011582
chr1	AP4B1	113904920	113904940	0	21	153	5835	153	5814	0.0	0.02631578947368421
chr1	HIPK1-AS1	113928702	113929224	51	523	102	3093	51	2570	0.09751434034416825	0.019844357976653695
chr1	HIPK1-AS1	113928702	113929207	51	506	102	3093	51	2587	0.1007905138339921	0.019713954387321223
chr1	HIPK1-AS1	113929208	113929224	0	17	102	3093	102	3076	0.0	0.03315994798439532
chr1	SYT6	114097726	114097746	0	21	1810	5075	1810	5054	0.0	0.3581321725366047
chr1	SYT6	114152622	114152764	0	143	1810	5075	1810	4932	0.0	0.36699107866991076
chr1	DENND2C	114623506	114623558	0	53	89	7434	89	7381	0.0	0.012057986722666305
chr1	AMPD1	114695436	114695448	0	13	0	2917	0	2904	0.0	0.0
chr1	SIKE1	114780436	114780447	0	12	0	5899	0	5887	0.0	0.0
chr1	TRIM45	117118033	117118086	798	54	10558	4375	9760	4321	14.777777777777779	2.2587364036102753
chr1	AL157902.1	117605556	117605644	0	89	1428	1095	1428	1006	0.0	1.41948310139165
chr1	FAM72B	121183337	121183456	0	120	0	2555	0	2435	0.0	0.0
chr1	AL592494.1	121510355	121510454	0	100	0	548	0	448	0.0	0.0
chr1	AC245595.1	144288342	144288353	0	12	94	1488	94	1476	0.0	0.06368563685636856
chr1	SRGAP2B	145095222	145095389	0	168	16724	7073	16724	6905	0.0	2.4220130340333093
chr1	NBPF20	145400385	145400387	0	3	120169	19134	120169	19131	0.0	6.281375777533846
chr1	ANKRD34A	145962420	145962814	0	395	0	3458	0	3063	0.0	0.0
chr1	HJV	146019174	146019696	0	523	247	2423	247	1900	0.0	0.13
chr1	FMO5	147225276	147225285	0	10	0	5996	0	5986	0.0	0.0
chr1	FMO5	147225286	147225572	0	287	0	5996	0	5709	0.0	0.0
chr1	PDZK1P1	147996522	147996586	0	65	56998	3684	56998	3619	0.0	15.749654600718431
chr1	NBPF11	148151719	148151748	0	30	0	5942	0	5912	0.0	0.0
chr1	AC239809.3	148206494	148206600	0	107	81262	14907	81262	14800	0.0	5.490675675675676
chr1	AC239809.3	148226493	148226733	0	241	81262	14907	81262	14666	0.0	5.540842765580254
chr1	NBPF14	148595849	148595853	407	5	175958	12061	175551	12056	81.4	14.561297279362973
chr1	NBPF9	149065525	149065635	0	111	298	8033	298	7922	0.0	0.037616763443574855
chr1	NBPF9	149082271	149082275	0	5	298	8033	298	8028	0.0	0.037120079720976584
chr1	AC243772.3	149747616	149747692	0	77	399	3275	399	3198	0.0	0.124765478424015
chr1	MTMR11	149936581	149936709	0	129	23540	4455	23540	4326	0.0	5.4415164123901985
chr1	AC244033.2	150066969	150067481	0	513	3440	3080	3440	2567	0.0	1.3400857031554343
chr1	ENSA	150627311	150627465	0	155	3073	2646	3073	2491	0.0	1.2336411079887595
chr1	ENSA	150627397	150627465	0	69	3073	2646	3073	2577	0.0	1.1924718665114473
chr1	ENSA	150627311	150627396	0	86	3073	2646	3073	2560	0.0	1.200390625
chr1	CTSK	150807129	150807247	0	119	121501	7254	121501	7135	0.0	17.028871758934827
chr1	CDC42SE1	151056650	151056654	0	5	2720	4192	2720	4187	0.0	0.649629806544065
chr1	SEMA6C	151137985	151138007	49	23	218031	3937	217982	3914	2.130434782608696	55.69289729177312
chr1	SEMA6C	151145023	151146431	1086	1409	218031	3937	216945	2528	0.7707594038325053	85.81685126582279
chr1	LYSMD1	151165078	151165745	458	668	1376	2511	918	1843	0.6856287425149701	0.4981009224091156
chr1	TMOD4	151175923	151175950	0	28	40530	1545	40530	1517	0.0	26.717205009887937
chr1	VPS72	151190004	151190122	975	119	18159	1217	17184	1098	8.193277310924369	15.650273224043715
chr1	ZNF687-AS1	151281542	151281807	867	266	96225	725	95358	459	3.2593984962406015	207.7516339869281
chr1	PI4KB	151294017	151294047	0	31	143827	5088	143827	5057	0.0	28.441170654538265
chr1	RFX5	151346204	151346213	0	10	400	3082	400	3072	0.0	0.13020833333333334
chr1	RFX5	151346481	151346487	0	7	400	3082	400	3075	0.0	0.13008130081300814
chr1	RFX5	151346481	151346483	0	3	400	3082	400	3079	0.0	0.12991230919129587
chr1	RFX5	151346481	151346577	0	97	400	3082	400	2985	0.0	0.13400335008375208
chr1	RFX5	151346488	151346577	0	90	400	3082	400	2992	0.0	0.13368983957219252
chr1	RFX5	151346484	151346487	0	4	400	3082	400	3078	0.0	0.1299545159194282
chr1	RFX5	151346484	151346577	0	94	400	3082	400	2988	0.0	0.13386880856760375
chr1	RFX5	151346421	151346480	0	60	400	3082	400	3022	0.0	0.13236267372600927
chr1	RFX5	151346421	151346487	0	67	400	3082	400	3015	0.0	0.13266998341625208
chr1	RFX5	151346421	151346483	0	63	400	3082	400	3019	0.0	0.13249420337860218
chr1	RFX5	151346421	151346577	0	157	400	3082	400	2925	0.0	0.13675213675213677
chr1	RFX5	151346754	151346938	0	185	400	3082	400	2897	0.0	0.1380738695201933
chr1	RFX5	151347150	151347209	0	60	400	3082	400	3022	0.0	0.13236267372600927
chr1	SELENBP1	151368999	151369002	0	4	65782	3236	65782	3232	0.0	20.353341584158414
chr1	MRPL9	151762949	151762988	63	40	5166	1368	5103	1328	1.575	3.8426204819277108
chr1	MRPL9	151762949	151762953	15	5	5166	1368	5151	1363	3.0	3.7791636096845194
chr1	MRPL9	151762954	151762988	48	35	5166	1368	5118	1333	1.3714285714285714	3.8394598649662415
chr1	MRPL9	151762104	151762111	0	8	5166	1368	5166	1360	0.0	3.7985294117647057
chr1	TDRKH	151790379	151790397	0	19	1029	4678	1029	4659	0.0	0.22086284610431423
chr1	TDRKH	151790379	151790403	0	25	1029	4678	1029	4653	0.0	0.22114764667956158
chr1	TDRKH	151779950	151780049	0	100	1029	4678	1029	4578	0.0	0.22477064220183487
chr1	TDRKH	151790398	151790403	0	6	1029	4678	1029	4672	0.0	0.2202482876712329
chr1	SPRR2D	153041669	153041770	0	102	0	954	0	852	0.0	0.0
chr1	S100A6	153535788	153535947	88	160	3159	974	3071	814	0.55	3.772727272727273
chr1	S100A16	153608898	153609176	71298	279	20070	1427	-51228	1148	255.5483870967742	-44.62369337979094
chr1	S100A14	153615828	153615866	5616	39	163950	1283	158334	1244	144.0	127.2781350482315
chr1	AL162258.1	153634213	153634241	8050	29	68719	1002	60669	973	277.58620689655174	62.35251798561151
chr1	GATAD2B	153817371	153817418	0	48	41693	9263	41693	9215	0.0	4.52447097124254
chr1	SLC39A1	153963494	153963595	10091	102	417813	3208	407722	3106	98.93137254901961	131.26915647134578
chr1	SLC39A1	153963058	153963175	0	118	417813	3208	417813	3090	0.0	135.2145631067961
chr1	SLC39A1	153967385	153967449	61	65	417813	3208	417752	3143	0.9384615384615385	132.9150493159402
chr1	SLC39A1	153963001	153963175	0	175	417813	3208	417813	3033	0.0	137.75568743818002
chr1	SLC39A1	153963001	153963057	0	57	417813	3208	417813	3151	0.0	132.59695334814344
chr1	SLC39A1	153962869	153963057	0	189	417813	3208	417813	3019	0.0	138.39450149055978
chr1	SLC39A1	153962869	153963000	0	132	417813	3208	417813	3076	0.0	135.82997399219767
chr1	JTB	153977169	153977337	0	169	102	1486	102	1317	0.0	0.0774487471526196
chr1	AL592078.2	154567423	154567548	1326	126	3382	1655	2056	1529	10.523809523809524	1.3446697187704382
chr1	AL592078.2	154567423	154567557	1326	135	3382	1655	2056	1520	9.822222222222223	1.3526315789473684
chr1	AL592078.2	154567549	154567557	0	9	3382	1655	3382	1646	0.0	2.054678007290401
chr1	ADAR	154590183	154590340	0	158	16562	9646	16562	9488	0.0	1.7455733558178752
chr1	ADAR	154590183	154590260	0	78	16562	9646	16562	9568	0.0	1.7309782608695652
chr1	ADAR	154627854	154627952	0	99	16562	9646	16562	9547	0.0	1.7347857965853148
chr1	ADAR	154590261	154590340	0	80	16562	9646	16562	9566	0.0	1.7313401630775664
chr1	PBXIP1	154948132	154948224	1670	93	526507	3603	524837	3510	17.956989247311828	149.52621082621081
chr1	SHC1	154965542	154965637	1306	96	137265	4260	135959	4164	13.604166666666666	32.651056676272816
chr1	KRTCAP2	155169786	155169789	1449	4	538639	3710	537190	3706	362.25	144.95143011332974
chr1	THBS3	155203085	155203091	832	7	266988	4646	266156	4639	118.85714285714286	57.37357189049364
chr1	THBS3	155206192	155206198	7367	7	266988	4646	259621	4639	1052.4285714285713	55.96486311705109
chr1	GBAP1	155217518	155217962	54520	445	270301	3205	215781	2760	122.51685393258427	78.18152173913043
chr1	GBAP1	155217518	155217703	38994	186	270301	3205	231307	3019	209.6451612903226	76.61709175223584
chr1	GBAP1	155218387	155218454	0	68	270301	3205	270301	3137	0.0	86.16544469238126
chr1	SCAMP3	155257284	155257296	0	13	14036	2310	14036	2297	0.0	6.110579016107967
chr1	ASH1L	155562152	155562777	0	626	10130	13816	10130	13190	0.0	0.7680060652009097
chr1	ASH1L	155440489	155440501	0	13	10130	13816	10130	13803	0.0	0.7338984278779975
chr1	ASH1L	155343591	155343602	0	12	10130	13816	10130	13804	0.0	0.7338452622428282
chr1	YY1AP1	155680381	155680414	12	34	9407	4688	9395	4654	0.35294117647058826	2.0186935969058872
chr1	YY1AP1	155688620	155688657	87	38	9407	4688	9320	4650	2.289473684210526	2.0043010752688173
chr1	YY1AP1	155688578	155688619	252	42	9407	4688	9155	4646	6.0	1.9705122686181662
chr1	GON4L	155857146	155857157	0	12	82462	11036	82462	11024	0.0	7.480224963715529
chr1	RIT1	155911242	155911270	0	29	81078	4045	81078	4016	0.0	20.18874501992032
chr1	ARHGEF2	155950268	155950297	539	30	746488	8670	745949	8640	17.966666666666665	86.33668981481482
chr1	SSR2	156018131	156018268	1074	138	140240	5038	139166	4900	7.782608695652174	28.40122448979592
chr1	SSR2	156018131	156018250	897	120	140240	5038	139343	4918	7.475	28.3332655551037
chr1	SSR2	156020726	156020886	0	161	140240	5038	140240	4877	0.0	28.755382407217553
chr1	SSR2	156020675	156020725	0	51	140240	5038	140240	4987	0.0	28.121114898736714
chr1	SSR2	156012384	156012393	289	10	140240	5038	139951	5028	28.9	27.834327764518694
chr1	PAQR6	156246680	156246688	6	9	18459	2498	18453	2489	0.6666666666666666	7.413820811570912
chr1	PAQR6	156244689	156244759	97	71	18459	2498	18362	2427	1.3661971830985915	7.565718994643593
chr1	PAQR6	156247914	156247955	0	42	18459	2498	18459	2456	0.0	7.515879478827362
chr1	GLMP	156295296	156295524	0	229	1814646	2595	1814646	2366	0.0	766.9678782755706
chr1	MIR9-1HG	156415396	156416767	209	1372	33808	7374	33599	6002	0.152332361516035	5.597967344218594
chr1	MIR9-1HG	156414055	156414082	0	28	33808	7374	33808	7346	0.0	4.602232507487067
chr1	ISG20L2	156728353	156728413	0	61	13756	4689	13756	4628	0.0	2.972342264477096
chr1	MRPL24	156741011	156741051	0	41	33408	1703	33408	1662	0.0	20.101083032490976
chr1	MRPL24	156740930	156741010	0	81	33408	1703	33408	1622	0.0	20.59679408138101
chr1	MRPL24	156740930	156741051	0	122	33408	1703	33408	1581	0.0	21.13092979127135
chr1	HDGF	156752037	156752227	19713	191	29850	3683	10137	3492	103.20942408376963	2.9029209621993126
chr1	FCRL3	157678594	157678741	0	148	13585	5345	13585	5197	0.0	2.61400808158553
chr1	FCRL3	157700661	157700701	0	41	13585	5345	13585	5304	0.0	2.5612745098039214
chr1	LINC01704	158132573	158132576	0	4	12291	2018	12291	2014	0.0	6.102780536246276
chr1	CD1B	158329369	158329533	0	165	0	1401	0	1236	0.0	0.0
chr1	SNHG28	159840710	159840767	0	58	1229	3025	1229	2967	0.0	0.4142231209976407
chr1	SNHG28	159854756	159854757	0	2	1229	3025	1229	3023	0.0	0.40654978498180616
chr1	SNHG28	159854756	159854920	0	165	1229	3025	1229	2860	0.0	0.4297202797202797
chr1	SNHG28	159854752	159854755	0	4	1229	3025	1229	3021	0.0	0.40681893412777226
chr1	SNHG28	159854752	159854757	0	6	1229	3025	1229	3019	0.0	0.4070884398807552
chr1	SNHG28	159838364	159840709	0	2346	1229	3025	1229	679	0.0	1.8100147275405007
chr1	SNHG28	159838364	159840767	0	2404	1229	3025	1229	621	0.0	1.9790660225442833
chr1	AL590560.2	159858089	159858167	130	79	1596	6349	1466	6270	1.6455696202531647	0.23381180223285486
chr1	SNHG28	159837916	159841124	0	3209	1229	3025	1229	-184	0.0	-6.679347826086956
chr1	SNHG28	159854758	159854920	0	163	1229	3025	1229	2862	0.0	0.4294199860237596
chr1	SLAMF9	159953308	159953443	0	136	156	1007	156	871	0.0	0.1791044776119403
chr1	KCNJ10	160041833	160042044	0	212	23954	4234	23954	4022	0.0	5.95574341123819
chr1	KCNJ10	160041335	160042044	0	710	23954	4234	23954	3524	0.0	6.79738933030647
chr1	KCNJ10	160041335	160041832	0	498	23954	4234	23954	3736	0.0	6.411670235546039
chr1	DCAF8	160262116	160262274	812	159	213997	6531	213185	6372	5.1069182389937104	33.45652856246077
chr1	DCAF8	160262116	160262447	96345	332	213997	6531	117652	6199	290.1957831325301	18.979190191966445
chr1	DCAF8	160262275	160262447	95533	173	213997	6531	118464	6358	552.2138728323699	18.63227430009437
chr1	COPA	160306353	160306453	875	101	25801	7549	24926	7448	8.663366336633663	3.346670247046187
chr1	CD84	160553359	160553376	0	18	51	9263	51	9245	0.0	0.005516495402920498
chr1	F11R	161001019	161001043	10	25	20170	5046	20160	5021	0.4	4.015136427006572
chr1	USF1	161041650	161041733	0	84	0	2093	0	2009	0.0	0.0
chr1	USF1	161041650	161041832	0	183	0	2093	0	1910	0.0	0.0
chr1	USF1	161042554	161042584	0	31	0	2093	0	2062	0.0	0.0
chr1	USF1	161041734	161041832	0	99	0	2093	0	1994	0.0	0.0
chr1	USF1	161043252	161043266	0	15	0	2093	0	2078	0.0	0.0
chr1	DEDD	161122984	161123073	0	90	98266	2740	98266	2650	0.0	37.08150943396227
chr1	DEDD	161124339	161124412	0	74	98266	2740	98266	2666	0.0	36.8589647411853
chr1	APOA2	161223501	161223593	0	93	0	769	0	676	0.0	0.0
chr1	APOA2	161223501	161223517	0	17	0	769	0	752	0.0	0.0
chr1	NR1I3	161236458	161236528	0	71	0	2001	0	1930	0.0	0.0
chr1	MPZ	161306707	161306787	0	81	1938	2155	1938	2074	0.0	0.9344262295081968
chr1	RGS5	163152537	163152548	0	12	25900	9121	25900	9109	0.0	2.8433417499176636
chr1	TMCO1	165768681	165768757	0	77	5457	5337	5457	5260	0.0	1.0374524714828897
chr1	TMCO1	165768481	165768680	0	200	5457	5337	5457	5137	0.0	1.0622931672182208
chr1	TMCO1	165768481	165768757	0	277	5457	5337	5457	5060	0.0	1.0784584980237155
chr1	FAM78B	166069831	166069833	0	3	612	5592	612	5589	0.0	0.10950080515297907
chr1	FAM78B	166069511	166069830	0	320	612	5592	612	5272	0.0	0.11608497723823975
chr1	FAM78B	166069511	166069833	0	323	612	5592	612	5269	0.0	0.11615107230973619
chr1	LINC01363	167195656	167195687	0	32	0	1348	0	1316	0.0	0.0
chr1	METTL18	169794814	169794868	0	55	8798	1578	8798	1523	0.0	5.776756401838477
chr1	BX284613.2	171247565	171247579	0	15	1020	7890	1020	7875	0.0	0.1295238095238095
chr1	VAMP4	171710713	171710758	0	46	1657	4062	1657	4016	0.0	0.4125996015936255
chr1	DNM3OS	172144557	172144652	0	96	0	2594	0	2498	0.0	0.0
chr1	CENPL	173806438	173806457	0	20	156089	4921	156089	4901	0.0	31.848398286064068
chr1	CENPL	173824137	173824210	115	74	156089	4921	155974	4847	1.554054054054054	32.17949246956881
chr1	GAS5	173867959	173867979	297	21	12941	4337	12644	4316	14.142857142857142	2.929564411492122
chr1	GAS5	173864483	173864673	975	191	12941	4337	11966	4146	5.104712041884817	2.8861553304389775
chr1	GAS5	173865470	173865508	72	39	12941	4337	12869	4298	1.8461538461538463	2.9941833410888785
chr1	GAS5	173865228	173865508	306	281	12941	4337	12635	4056	1.0889679715302492	3.115138067061144
chr1	GAS5	173867154	173867720	467	567	12941	4337	12474	3770	0.8236331569664903	3.3087533156498674
chr1	MRPS14	175023271	175023362	0	92	25597	884	25597	792	0.0	32.31944444444444
chr1	COP1	176163814	176163825	0	12	15779	4200	15779	4188	0.0	3.7676695319961797
chr1	CRYZL2P-SEC16B	177960341	177960789	42	449	756	6507	714	6058	0.0935412026726058	0.11786068009243975
chr1	CRYZL2P	178026071	178026153	0	83	3927	5510	3927	5427	0.0	0.7236042012161416
chr1	RASAL2-AS1	178093533	178093559	0	27	0	716	0	689	0.0	0.0
chr1	LINC01344	182128294	182128403	0	110	3	6690	3	6580	0.0	0.0004559270516717325
chr1	GLUL	182386255	182386360	0	106	102	10959	102	10853	0.0	0.009398323044319543
chr1	GLUL	182390496	182391677	51	1182	102	10959	51	9777	0.04314720812182741	0.005216324025774778
chr1	GLUL	182390496	182391173	0	678	102	10959	102	10281	0.0	0.009921213889699446
chr1	GLUL	182391174	182391677	51	504	102	10959	51	10455	0.10119047619047619	0.004878048780487805
chr1	LINC01350	185563167	185563237	0	71	0	2415	0	2344	0.0	0.0
chr1	UCHL5	193059184	193059411	18344	228	65016	6676	46672	6448	80.45614035087719	7.238213399503722
chr1	GLRX2	193105516	193105616	0	101	36686	6115	36686	6014	0.0	6.100099767209843
chr1	DENND1B	197775138	197775350	0	213	3241	11873	3241	11660	0.0	0.277958833619211
chr1	LINC00862	200373646	200373781	0	136	63125	3543	63125	3407	0.0	18.528030525388907
chr1	TMEM9	201146739	201146769	0	31	830	2290	830	2259	0.0	0.367419212040726
chr1	TMEM9	201153848	201153856	0	9	830	2290	830	2281	0.0	0.3638754932047348
chr1	TMEM9	201154147	201154360	0	214	830	2290	830	2076	0.0	0.39980732177263967
chr1	TMEM9	201153782	201153856	0	75	830	2290	830	2215	0.0	0.3747178329571106
chr1	TMEM9	201153782	201153847	0	66	830	2290	830	2224	0.0	0.3732014388489209
chr1	TNNT2	201361912	201361949	0	38	0	5980	0	5942	0.0	0.0
chr1	TNNT2	201373196	201373204	0	9	0	5980	0	5971	0.0	0.0
chr1	TNNT2	201361213	201361277	0	65	0	5980	0	5915	0.0	0.0
chr1	TNNT2	201372026	201372143	0	118	0	5980	0	5862	0.0	0.0
chr1	TNNI1	201417746	201417781	0	36	51	7068	51	7032	0.0	0.007252559726962458
chr1	PTPN7	202160544	202161385	452	842	579	3851	127	3009	0.5368171021377672	0.04220671319375208
chr1	UBE2T	202335641	202335644	4	4	51	1657	47	1653	1.0	0.028433151845130067
chr1	KDM5B	202741366	202741544	590	179	219740	17458	219150	17279	3.2960893854748603	12.683025638057758
chr1	KDM5B	202808101	202808115	0	15	219740	17458	219740	17443	0.0	12.597603623229949
chr1	LINC00303	204036968	204037254	0	287	102	1992	102	1705	0.0	0.05982404692082111
chr1	ETNK2	204141024	204141214	0	191	255	4420	255	4229	0.0	0.06029794277606999
chr1	RBBP5	205094872	205094985	0	114	16918	4418	16918	4304	0.0	3.9307620817843865
chr1	RAB29	205775272	205775372	0	101	103255	3871	103255	3770	0.0	27.388594164456233
chr1	RAB29	205774832	205775271	0	440	103255	3871	103255	3431	0.0	30.094724570096183
chr1	RAB29	205774832	205775127	0	296	103255	3871	103255	3575	0.0	28.882517482517482
chr1	FAM72A	206201873	206201992	0	120	51	3129	51	3009	0.0	0.01694915254237288
chr1	EIF2D	206608235	206608278	0	44	42282	5561	42282	5517	0.0	7.66394779771615
chr1	FCMR	206913758	206913860	0	103	468250	3427	468250	3324	0.0	140.86943441636583
chr1	PIGR	206939118	206939408	0	291	51	4383	51	4092	0.0	0.012463343108504398
chr1	AL137789.1	207606467	207606491	0	25	0	1513	0	1488	0.0	0.0
chr1	AC092810.2	209153505	209153663	0	159	0	3124	0	2965	0.0	0.0
chr1	AC092810.2	209153505	209153570	0	66	0	3124	0	3058	0.0	0.0
chr1	AC092810.2	209153571	209153663	0	93	0	3124	0	3031	0.0	0.0
chr1	SERTAD4-AS1	210233634	210233949	136	316	204	1007	68	691	0.43037974683544306	0.09840810419681621
chr1	KCNH1	211018782	211018862	0	81	124	4644	124	4563	0.0	0.02717510409818102
chr1	KCNH1	210683020	210683465	0	446	124	4644	124	4198	0.0	0.029537875178656504
chr1	KCNH1	210682620	210683019	0	400	124	4644	124	4244	0.0	0.029217719132893498
chr1	KCNH1	210682620	210683465	0	846	124	4644	124	3798	0.0	0.03264876250658241
chr1	INTS7	211952568	211952609	0	42	18399	5042	18399	5000	0.0	3.6798
chr1	LINC02773	212665318	212665334	0	17	0	1374	0	1357	0.0	0.0
chr1	ANGEL2	213015608	213015611	0	4	1947	7328	1947	7324	0.0	0.2658383397050792
chr1	PROX1-AS1	213895393	213895425	0	33	23	9778	23	9745	0.0	0.0023601847101077478
chr1	PROX1-AS1	213987472	213987502	0	31	23	9778	23	9747	0.0	0.002359700420642249
chr1	PROX1-AS1	213987472	213987578	0	107	23	9778	23	9671	0.0	0.0023782442353427772
chr1	ESRRG	216723239	216723242	0	4	0	10959	0	10955	0.0	0.0
chr1	LYPLAL1-AS1	219411717	219411847	0	131	0	2629	0	2498	0.0	0.0
chr1	BPNT1	220089643	220089684	0	42	0	2818	0	2776	0.0	0.0
chr1	LINC02817	221333901	221333914	0	14	0	2451	0	2437	0.0	0.0
chr1	LINC02817	221333834	221333900	0	67	0	2451	0	2384	0.0	0.0
chr1	LINC02817	221333834	221333914	0	81	0	2451	0	2370	0.0	0.0
chr1	AL513314.2	222504365	222504410	0	46	0	1548	0	1502	0.0	0.0
chr1	WDR26	224431476	224431523	0	48	13486	10645	13486	10597	0.0	1.272624327639898
chr1	CNIH3-AS2	224616020	224616073	408	54	4309	4139	3901	4085	7.555555555555555	0.9549571603427173
chr1	LINC02765	225464976	225465221	0	246	459	2015	459	1769	0.0	0.2594686263425664
chr1	PYCR2	225924043	225924043	0	1	3479	3483	3479	3482	0.0	0.9991384261918438
chr1	LIN9	226309108	226309624	0	517	1905	4458	1905	3941	0.0	0.4833798528292312
chr1	PARP1	226386218	226386324	0	107	9256	16916	9256	16809	0.0	0.5506573859242073
chr1	JMJD4	227732880	227732927	0	48	0	3976	0	3928	0.0	0.0
chr1	C1ORF35	228103133	228103321	0	189	0	3912	0	3723	0.0	0.0
chr1	MRPL55	228108436	228108439	0	4	6030	1672	6030	1668	0.0	3.615107913669065
chr1	MRPL55	228108234	228108243	166	10	6030	1672	5864	1662	16.6	3.5282791817087844
chr1	MRPL55	228109148	228109259	70	112	6030	1672	5960	1560	0.625	3.8205128205128207
chr1	MRPL55	228108436	228108953	1430	518	6030	1672	4600	1154	2.7606177606177607	3.9861351819757367
chr1	AL353593.1	228273759	228275294	19599	1536	95095	9434	75496	7898	12.759765625	9.558875664725248
chr1	TRIM17	228416386	228416537	0	152	102	3559	102	3407	0.0	0.029938362195479896
chr1	BTNL10	228512182	228512217	0	36	0	734	0	698	0.0	0.0
chr1	AL162595.1	229267953	229268241	0	289	0	4970	0	4681	0.0	0.0
chr1	AL162595.1	229270959	229270974	0	16	0	4970	0	4954	0.0	0.0
chr1	AL445524.2	231462437	231462470	354	34	15425	3699	15071	3665	10.411764705882353	4.112141882673943
chr1	AL445524.1	231527765	231528120	51	356	938	4123	887	3767	0.14325842696629212	0.23546588797451554
chr1	AL136171.2	231822679	231822723	0	45	0	5695	0	5650	0.0	0.0
chr1	SIPA1L2	232608826	232608910	0	85	1537	8582	1537	8497	0.0	0.18088737201365188
chr1	LINC01354	234531015	234531024	0	10	62223	3246	62223	3236	0.0	19.228368355995055
chr1	IRF2BP2	234608446	234608493	717	48	19506	4727	18789	4679	14.9375	4.015601624278692
chr1	AL391832.2	234962545	234962614	0	70	0	2943	0	2873	0.0	0.0
chr1	AL391832.2	234962958	234963037	0	80	0	2943	0	2863	0.0	0.0
chr1	AL391832.2	234962545	234962957	0	413	0	2943	0	2530	0.0	0.0
chr1	AL391832.2	234962615	234962957	0	343	0	2943	0	2600	0.0	0.0
chr1	AL391832.2	234962615	234963037	0	423	0	2943	0	2520	0.0	0.0
chr1	ARID4B	235213768	235213875	0	108	83	9671	83	9563	0.0	0.008679284743281397
chr1	ARID4B	235327768	235327934	0	167	83	9671	83	9504	0.0	0.008733164983164983
chr1	LYST	235766078	235766237	0	160	86694	19662	86694	19502	0.0	4.445390216388063
chr1	LINC01139	238485784	238485810	0	27	0	1865	0	1838	0.0	0.0
chr1	LINC01139	238486000	238486003	0	4	0	1865	0	1861	0.0	0.0
chr1	OPN3	241604259	241604418	0	160	0	3735	0	3575	0.0	0.0
chr1	PLD5	242265336	242265360	0	25	10150	9558	10150	9533	0.0	1.06472254274625
chr1	PLD5	242348098	242348104	0	7	10150	9558	10150	9551	0.0	1.0627159459742435
chr1	CEP170	243142315	243142365	0	51	725	8930	725	8879	0.0	0.08165333934001577
chr1	CEP170	243255039	243255045	0	7	725	8930	725	8923	0.0	0.08125070043707273
chr1	CEP170	243142285	243142314	0	30	725	8930	725	8900	0.0	0.08146067415730338
chr1	CEP170	243142285	243142365	0	81	725	8930	725	8849	0.0	0.08193016160018081
chr1	CEP170	243185778	243186257	0	480	725	8930	725	8450	0.0	0.08579881656804733
chr1	CEP170	243163157	243163271	0	115	725	8930	725	8815	0.0	0.0822461712989223
chr1	HNRNPU	244860334	244860356	0	23	50645	15411	50645	15388	0.0	3.291200935794125
chr1	HNRNPU	244860334	244860351	0	18	50645	15411	50645	15393	0.0	3.290131878126421
chr1	HNRNPU	244863616	244863672	339	57	50645	15411	50306	15354	5.947368421052632	3.276410056011463
chr1	HNRNPU	244860352	244860356	0	5	50645	15411	50645	15406	0.0	3.2873555757497077
chr1	AHCTF1	246931128	246931306	7356	179	15674	9618	8318	9439	41.09497206703911	0.8812374192181375
chr1	ZNF695	246988120	246988123	0	4	1719	3762	1719	3758	0.0	0.4574241617881852
chr1	ZNF695	246999911	246999946	0	36	1719	3762	1719	3726	0.0	0.4613526570048309
chr1	ZNF669	247101986	247101989	0	4	5159	1726	5159	1722	0.0	2.9959349593495936
chr1	ZNF669	247103938	247104195	612	258	5159	1726	4547	1468	2.372093023255814	3.0974114441416893
chr1	ZNF692	248856287	248856371	0	85	51	3751	51	3666	0.0	0.013911620294599018
chr1	ZNF692	248858917	248859013	0	97	51	3751	51	3654	0.0	0.013957307060755337
chr1	ZNF692	248855557	248855723	0	167	51	3751	51	3584	0.0	0.014229910714285714
chr2	SH3YL1	230546	231021	280	476	70692	8808	70412	8332	0.5882352941176471	8.450792126740279
chr2	AC079779.3	307110	307111	0	2	0	3482	0	3480	0.0	0.0
chr2	AC079779.3	308936	308970	0	35	0	3482	0	3447	0.0	0.0
chr2	AC079779.3	307077	307109	0	33	0	3482	0	3449	0.0	0.0
chr2	AC079779.3	307077	307111	0	35	0	3482	0	3447	0.0	0.0
chr2	AC079779.3	306448	306482	0	35	0	3482	0	3447	0.0	0.0
chr2	AC079779.3	308899	308970	0	72	0	3482	0	3410	0.0	0.0
chr2	AC079779.3	308899	308935	0	37	0	3482	0	3445	0.0	0.0
chr2	AC079779.3	312952	312955	0	4	0	3482	0	3478	0.0	0.0
chr2	AC079779.3	313873	314241	0	369	0	3482	0	3113	0.0	0.0
chr2	MYT1L	1903079	1903118	0	40	51	31707	51	31667	0.0	0.0016105093630593363
chr2	MYT1L	1922285	1922290	0	6	51	31707	51	31701	0.0	0.0016087820573483487
chr2	MYT1L	1801689	1801694	0	6	51	31707	51	31701	0.0	0.0016087820573483487
chr2	MYT1L	2324170	2324330	0	161	51	31707	51	31546	0.0	0.001616686743168706
chr2	MYT1L	1842642	1842767	0	126	51	31707	51	31581	0.0	0.0016148950318229315
chr2	AC011995.2	2836918	2836958	0	41	0	8792	0	8751	0.0	0.0
chr2	ADI1	3500584	3500812	1346	229	120289	5355	118943	5126	5.877729257641922	23.203862660944207
chr2	AC108488.1	3533107	3534111	0	1005	0	1197	0	192	0.0	0.0
chr2	RNASEH1	3557894	3558131	0	238	0	5954	0	5716	0.0	0.0
chr2	LINC01304	3959563	3959914	0	352	51	6379	51	6027	0.0	0.008461921353907416
chr2	MIR7515HG	6639050	6639112	0	63	11358	7267	11358	7204	0.0	1.5766240977234869
chr2	MIR7515HG	6633612	6633667	0	56	11358	7267	11358	7211	0.0	1.5750936069893218
chr2	MIR7515HG	6635390	6635434	0	45	11358	7267	11358	7222	0.0	1.5726945444475215
chr2	MIR7515HG	6634594	6634798	0	205	11358	7267	11358	7062	0.0	1.6083262531860663
chr2	MIR7515HG	6638966	6639049	0	84	11358	7267	11358	7183	0.0	1.581233467910344
chr2	MIR7515HG	6637799	6638089	0	291	11358	7267	11358	6976	0.0	1.6281536697247707
chr2	LINC00487	6731154	6731157	0	4	51	2205	51	2201	0.0	0.023171285779191277
chr2	CMPK2	6866409	6866424	0	16	0	4311	0	4295	0.0	0.0
chr2	GRASLND	6916815	6916848	0	34	255	4549	255	4515	0.0	0.05647840531561462
chr2	GRASLND	6918284	6918400	0	117	255	4549	255	4432	0.0	0.05753610108303249
chr2	GRASLND	6918280	6918400	0	121	255	4549	255	4428	0.0	0.05758807588075881
chr2	GRASLND	6918280	6918283	0	4	255	4549	255	4545	0.0	0.056105610561056105
chr2	AC068481.1	7077370	7077702	0	333	0	2046	0	1713	0.0	0.0
chr2	AC068481.1	7077346	7077369	0	24	0	2046	0	2022	0.0	0.0
chr2	AC068481.1	7077346	7077702	0	357	0	2046	0	1689	0.0	0.0
chr2	LINC00298	7979259	7979270	0	12	51	4416	51	4404	0.0	0.011580381471389645
chr2	LINC01814	8583713	8583715	0	3	51	13537	51	13534	0.0	0.003768287276488843
chr2	ID2-AS1	8675743	8675931	0	189	51	6592	51	6403	0.0	0.007965016398563174
chr2	ID2-AS1	8678740	8678757	0	18	51	6592	51	6574	0.0	0.007757833891086097
chr2	KIDINS220	8837468	8837478	0	11	220	14698	220	14687	0.0	0.014979233335602913
chr2	ITGB1BP1	9422478	9422964	102	487	918	6364	816	5877	0.20944558521560575	0.1388463501786626
chr2	ITGB1BP1	9412067	9412267	0	201	918	6364	918	6163	0.0	0.14895343177024176
chr2	ITGB1BP1	9422478	9422800	0	323	918	6364	918	6041	0.0	0.151961595762291
chr2	ITGB1BP1	9422801	9422964	102	164	918	6364	816	6200	0.6219512195121951	0.13161290322580646
chr2	ADAM17	9543152	9543219	1030	68	38014	10467	36984	10399	15.147058823529411	3.5564958169054717
chr2	YWHAQ	9630812	9630939	714	128	159727	2709	159013	2581	5.578125	61.60906625339016
chr2	ODC1	10447473	10447626	0	154	3538	2804	3538	2650	0.0	1.3350943396226416
chr2	AC062028.1	11131997	11132013	0	17	0	4225	0	4208	0.0	0.0
chr2	ROCK2	11218314	11218453	0	140	18	10233	18	10093	0.0	0.0017834142474982661
chr2	AC064875.1	13002423	13003822	0	1400	9203	4174	9203	2774	0.0	3.3175919250180246
chr2	AC064875.1	13002423	13003779	0	1357	9203	4174	9203	2817	0.0	3.2669506567270146
chr2	AC064875.1	13003780	13003822	0	43	9203	4174	9203	4131	0.0	2.227789881384653
chr2	SMC6	17752977	17753000	0	24	0	9859	0	9835	0.0	0.0
chr2	RDH14	18560179	18560628	0	450	0	1588	0	1138	0.0	0.0
chr2	NT5C1B	18586247	18586252	0	6	0	3862	0	3856	0.0	0.0
chr2	NT5C1B	18586942	18586992	0	51	0	3862	0	3811	0.0	0.0
chr2	WDR35	19932282	19932381	0	100	0	7835	0	7735	0.0	0.0
chr2	WDR35	19935466	19935469	0	4	0	7835	0	7831	0.0	0.0
chr2	PUM2	20350596	20350808	0	213	257844	6889	257844	6676	0.0	38.622528460155785
chr2	LDAH	20801291	20801308	60	18	3129	3421	3069	3403	3.3333333333333335	0.9018513076697032
chr2	AC009411.1	21649272	21649450	0	179	0	1365	0	1186	0.0	0.0
chr2	AC009411.1	21649272	21649337	0	66	0	1365	0	1299	0.0	0.0
chr2	AC009411.1	21649338	21649450	0	113	0	1365	0	1252	0.0	0.0
chr2	AC018467.1	23027805	23027865	0	61	0	1777	0	1716	0.0	0.0
chr2	AC009242.1	23672697	23672724	0	28	0	2820	0	2792	0.0	0.0
chr2	ATAD2B	23786026	23786040	0	15	0	10538	0	10523	0.0	0.0
chr2	TP53I3	24082884	24082999	0	116	1444	2318	1444	2202	0.0	0.6557674841053588
chr2	HADHA	26244524	26244528	5	5	6309	4348	6304	4343	1.0	1.4515311996315912
chr2	HADHA	26210544	26210693	0	150	6309	4348	6309	4198	0.0	1.5028585040495475
chr2	CGREF1	27118774	27118844	0	71	45	3355	45	3284	0.0	0.013702801461632157
chr2	PREB	27131671	27131672	0	2	0	2369	0	2367	0.0	0.0
chr2	PREB	27132203	27132228	0	26	0	2369	0	2343	0.0	0.0
chr2	SLC5A6	27211899	27212018	0	120	262	5118	262	4998	0.0	0.052420968387354945
chr2	SLC5A6	27211710	27211765	0	56	262	5118	262	5062	0.0	0.05175819834057685
chr2	EIF2B4	27367073	27367168	0	96	102	2597	102	2501	0.0	0.04078368652538984
chr2	EIF2B4	27370105	27370282	51	178	102	2597	51	2419	0.28651685393258425	0.02108309218685407
chr2	IFT172	27453629	27453980	510	352	648389	12448	647879	12096	1.4488636363636365	53.561425264550266
chr2	IFT172	27471232	27472248	0	1017	648389	12448	648389	11431	0.0	56.72198407838334
chr2	CCDC121	27628389	27628394	0	6	5781	2842	5781	2836	0.0	2.038434414668547
chr2	SUPT7L	27663328	27663513	36276	186	239208	5317	202932	5131	195.03225806451613	39.55018514909374
chr2	SUPT7L	27660983	27662177	6326	1195	239208	5317	232882	4122	5.293723849372385	56.4973313925279
chr2	AC093690.1	28309764	28309935	0	172	2244	3203	2244	3031	0.0	0.7403497195645001
chr2	TRMT61B	28851071	28851097	0	27	0	2045	0	2018	0.0	0.0
chr2	DPY30	32039592	32039731	0	140	0	2602	0	2462	0.0	0.0
chr2	NLRC4	32240941	32241031	0	91	21939	3799	21939	3708	0.0	5.916666666666667
chr2	SULT6B1	37191156	37191219	0	64	2	1336	2	1272	0.0	0.0015723270440251573
chr2	RMDN2-AS1	37963091	37963094	0	4	0	3034	0	3030	0.0	0.0
chr2	RMDN2-AS1	38029808	38029853	0	46	0	3034	0	2988	0.0	0.0
chr2	CYP1B1	38075779	38076017	0	239	0	2987	0	2748	0.0	0.0
chr2	CYP1B1	38075775	38075778	0	4	0	2987	0	2983	0.0	0.0
chr2	CYP1B1	38075775	38076017	0	243	0	2987	0	2744	0.0	0.0
chr2	LINC02613	38424385	38424420	0	36	51	5399	51	5363	0.0	0.009509602834234571
chr2	AC074366.1	38669338	38669448	0	111	0	1042	0	931	0.0	0.0
chr2	SRSF7	38748046	38748054	0	9	0	3873	0	3864	0.0	0.0
chr2	SRSF7	38748046	38748078	0	33	0	3873	0	3840	0.0	0.0
chr2	SRSF7	38748055	38748078	0	24	0	3873	0	3849	0.0	0.0
chr2	SOS1-IT1	38993391	38993408	0	18	0	1256	0	1238	0.0	0.0
chr2	THUMPD2	39769709	39769756	0	48	68	3435	68	3387	0.0	0.020076764098021848
chr2	THUMPD2	39771504	39771513	0	10	68	3435	68	3425	0.0	0.019854014598540148
chr2	COX7A2L	42360937	42361088	0	152	153	5464	153	5312	0.0	0.028802710843373495
chr2	KCNG3	42492836	42492868	0	33	1173	3678	1173	3645	0.0	0.32181069958847736
chr2	LINC01819	43032733	43033228	39	496	318	3848	279	3352	0.07862903225806452	0.08323389021479713
chr2	THADA	43595646	43595929	0	284	2289	14267	2289	13983	0.0	0.16369877708646213
chr2	LRPPRC	43995773	43995797	0	25	6494	10068	6494	10043	0.0	0.6466195359952206
chr2	PREPL	44361379	44361415	0	37	51	6296	51	6259	0.0	0.008148266496245407
chr2	PREPL	44361416	44361522	0	107	51	6296	51	6189	0.0	0.008240426563257392
chr2	PREPL	44361379	44361522	0	144	51	6296	51	6152	0.0	0.00828998699609883
chr2	LINC01820	46393112	46393221	0	110	0	640	0	530	0.0	0.0
chr2	PIGF	46616586	46616968	0	383	142714	3770	142714	3387	0.0	42.135813404192504
chr2	CALM2	47176235	47176439	61	205	1162	5477	1101	5272	0.2975609756097561	0.2088391502276176
chr2	CALM2	47176235	47176275	10	41	1162	5477	1152	5436	0.24390243902439024	0.2119205298013245
chr2	CALM2	47176276	47176439	51	164	1162	5477	1111	5313	0.31097560975609756	0.20910973084886128
chr2	FBXO11	47807993	47808193	0	201	0	7806	0	7605	0.0	0.0
chr2	NRXN1	49943703	49943711	0	9	0	25608	0	25599	0.0	0.0
chr2	NRXN1	51031980	51032404	0	425	0	25608	0	25183	0.0	0.0
chr2	NRXN1	49973964	49973966	0	3	0	25608	0	25605	0.0	0.0
chr2	NRXN1	50621204	50621224	0	21	0	25608	0	25587	0.0	0.0
chr2	NRXN1	51225506	51225520	0	15	0	25608	0	25593	0.0	0.0
chr2	NRXN1	51225464	51225505	0	42	0	25608	0	25566	0.0	0.0
chr2	NRXN1	51225464	51225520	0	57	0	25608	0	25551	0.0	0.0
chr2	NRXN1	51202927	51202989	0	63	0	25608	0	25545	0.0	0.0
chr2	ASB3	53786284	53786819	0	536	51	6051	51	5515	0.0	0.009247506799637352
chr2	RTN4	55049744	55050426	0	683	360	6380	360	5697	0.0	0.0631911532385466
chr2	CLHC1	55232222	55232234	0	13	512855	6648	512855	6635	0.0	77.29540316503392
chr2	CLHC1	55223995	55224189	0	195	512855	6648	512855	6453	0.0	79.47543778087712
chr2	MTIF2	55244028	55244153	51	126	11419	3390	11368	3264	0.40476190476190477	3.482843137254902
chr2	MTIF2	55269168	55269211	0	44	11419	3390	11419	3346	0.0	3.4127316198445907
chr2	MTIF2	55268816	55269167	1020	352	11419	3390	10399	3038	2.897727272727273	3.422975641869651
chr2	MTIF2	55268816	55268990	510	175	11419	3390	10909	3215	2.914285714285714	3.393157076205288
chr2	MTIF2	55268991	55269167	510	177	11419	3390	10909	3213	2.8813559322033897	3.3952692187986306
chr2	MTIF2	55268577	55268815	0	239	11419	3390	11419	3151	0.0	3.6239289114566806
chr2	CCDC88A	55299827	55299837	0	11	3693	27139	3693	27128	0.0	0.136132409318785
chr2	EFEMP1	55922570	55922608	0	39	2254	3973	2254	3934	0.0	0.5729537366548043
chr2	FANCL	58198578	58198592	0	15	0	2345	0	2330	0.0	0.0
chr2	AC007179.2	59240920	59240991	0	72	0	5116	0	5044	0.0	0.0
chr2	BCL11A	60460681	60462280	0	1600	0	10714	0	9114	0.0	0.0
chr2	BCL11A	60460529	60462280	0	1752	0	10714	0	8962	0.0	0.0
chr2	BCL11A	60460529	60460680	0	152	0	10714	0	10562	0.0	0.0
chr2	PUS10	61017144	61017147	0	4	5388	7352	5388	7348	0.0	0.733260751224823
chr2	XPO1	61534422	61534556	0	135	13238	18326	13238	18191	0.0	0.7277225001374306
chr2	XPO1	61536869	61537017	918	149	13238	18326	12320	18177	6.1610738255033555	0.6777796115970732
chr2	XPO1	61536709	61536868	815	160	13238	18326	12423	18166	5.09375	0.6838599581636023
chr2	XPO1	61536709	61537017	1733	309	13238	18326	11505	18017	5.608414239482201	0.6385635788422046
chr2	AC114752.1	64332632	64332767	153	136	720	554	567	418	1.125	1.3564593301435406
chr2	AC012370.2	65456018	65456303	51	286	1787	2484	1736	2198	0.17832167832167833	0.7898089171974523
chr2	AC012370.2	65450232	65450474	0	243	1787	2484	1787	2241	0.0	0.7974118697010263
chr2	AC012370.2	65455511	65455658	306	148	1787	2484	1481	2336	2.0675675675675675	0.6339897260273972
chr2	C1D	68062944	68062956	0	13	0	3571	0	3558	0.0	0.0
chr2	WDR92	68157260	68157372	0	113	0	3630	0	3517	0.0	0.0
chr2	NFU1	69437270	69437359	0	90	16	1756	16	1666	0.0	0.009603841536614645
chr2	AAK1	69643742	69643790	0	49	835976	21266	835976	21217	0.0	39.40123485883961
chr2	AAK1	69643574	69643790	0	217	835976	21266	835976	21049	0.0	39.715710960140626
chr2	AAK1	69643574	69643741	0	168	835976	21266	835976	21098	0.0	39.62347141909186
chr2	PCBP1-AS1	69964230	69964367	0	138	234223	25966	234223	25828	0.0	9.068568994889267
chr2	PCBP1-AS1	70086123	70086250	4	128	234223	25966	234219	25838	0.03125	9.064904404365663
chr2	PCBP1-AS1	70086123	70086220	0	98	234223	25966	234223	25868	0.0	9.054546157414567
chr2	PCBP1-AS1	69996685	69996856	0	172	234223	25966	234223	25794	0.0	9.08052260215554
chr2	PCBP1-AS1	70083506	70083536	0	31	234223	25966	234223	25935	0.0	9.031154810102178
chr2	PCBP1-AS1	70086054	70086122	0	69	234223	25966	234223	25897	0.0	9.044406688033362
chr2	PCBP1-AS1	70086054	70086250	4	197	234223	25966	234219	25769	0.02030456852791878	9.08917691800225
chr2	PCBP1-AS1	70086054	70086220	0	167	234223	25966	234223	25799	0.0	9.078762742741967
chr2	PCBP1-AS1	70085815	70086122	0	308	234223	25966	234223	25658	0.0	9.128653831163769
chr2	PCBP1-AS1	70085815	70086053	0	239	234223	25966	234223	25727	0.0	9.104170715590625
chr2	PCBP1-AS1	70085815	70086250	4	436	234223	25966	234219	25530	0.009174311926605505	9.174265569917743
chr2	PCBP1-AS1	70085815	70086220	0	406	234223	25966	234223	25560	0.0	9.163654147104852
chr2	PCBP1-AS1	70086251	70086341	47	91	234223	25966	234176	25875	0.5164835164835165	9.050280193236715
chr2	PCBP1-AS1	70055655	70055712	0	58	234223	25966	234223	25908	0.0	9.040566620348926
chr2	PCBP1-AS1	70087072	70087279	0	208	234223	25966	234223	25758	0.0	9.093213758832208
chr2	PCBP1-AS1	70086221	70086250	4	30	234223	25966	234219	25936	0.13333333333333333	9.030652375077112
chr2	PCBP1-AS1	70088429	70088596	8108	168	234223	25966	226115	25798	48.26190476190476	8.764826730754322
chr2	PCBP1-AS1	70018976	70019136	510	161	234223	25966	233713	25805	3.1677018633540373	9.056888199961248
chr2	PCBP1-AS1	70085815	70086341	51	527	234223	25966	234172	25439	0.0967741935483871	9.205236054876371
chr2	PCBP1-AS1	70088409	70088428	2657	20	234223	25966	231566	25946	132.85	8.924920989747939
chr2	PCBP1-AS1	70085546	70085666	0	121	234223	25966	234223	25845	0.0	9.062603985296963
chr2	C2ORF42	70182666	70182793	0	128	2815	3521	2815	3393	0.0	0.82964927792514
chr2	C2ORF42	70190917	70190971	0	55	2815	3521	2815	3466	0.0	0.8121754183496827
chr2	C2ORF42	70190183	70190689	110	507	2815	3521	2705	3014	0.21696252465483234	0.8974784339747843
chr2	C2ORF42	70190183	70190541	110	359	2815	3521	2705	3162	0.3064066852367688	0.8554712207463631
chr2	C2ORF42	70190183	70190501	110	319	2815	3521	2705	3202	0.3448275862068966	0.8447845096814491
chr2	C2ORF42	70190690	70190971	0	282	2815	3521	2815	3239	0.0	0.8690953998147577
chr2	C2ORF42	70190690	70190916	0	227	2815	3521	2815	3294	0.0	0.8545840922890103
chr2	C2ORF42	70190690	70190779	0	90	2815	3521	2815	3431	0.0	0.8204605071407752
chr2	C2ORF42	70190542	70190689	0	148	2815	3521	2815	3373	0.0	0.8345686332641565
chr2	C2ORF42	70190542	70190916	0	375	2815	3521	2815	3146	0.0	0.8947870311506675
chr2	C2ORF42	70190542	70190779	0	238	2815	3521	2815	3283	0.0	0.8574474565945781
chr2	C2ORF42	70190502	70190689	0	188	2815	3521	2815	3333	0.0	0.8445844584458446
chr2	C2ORF42	70190502	70190541	0	40	2815	3521	2815	3481	0.0	0.8086756679115197
chr2	TIA1	70216752	70216884	0	133	1838	6250	1838	6117	0.0	0.3004740886055256
chr2	SNRPG	70292674	70293151	0	478	102	1396	102	918	0.0	0.1111111111111111
chr2	FAM136A	70301603	70301923	0	321	204	3023	204	2702	0.0	0.07549962990377498
chr2	FAM136A	70301603	70301668	0	66	204	3023	204	2957	0.0	0.06898884004058167
chr2	FAM136A	70301669	70301923	0	255	204	3023	204	2768	0.0	0.07369942196531792
chr2	MCEE	71124205	71124366	0	162	3144	1469	3144	1307	0.0	2.4055087987758226
chr2	MCEE	71129716	71130178	2840	463	3144	1469	304	1006	6.133909287257019	0.30218687872763417
chr2	SFXN5	73001524	73001527	0	4	3820	11003	3820	10999	0.0	0.3473043003909446
chr2	FBXO41	73284153	73284158	6	6	3113	8074	3107	8068	1.0	0.38510163609320774
chr2	TPRKB	73734428	73734526	0	99	247	2011	247	1912	0.0	0.12918410041841005
chr2	DGUOK-AS1	73981108	73981133	0	26	1424	1162	1424	1136	0.0	1.2535211267605635
chr2	DCTN1	74380004	74380099	24276	96	331815	9854	307539	9758	252.875	31.516601762656283
chr2	DCTN1	74391482	74391792	1462	311	331815	9854	330353	9543	4.70096463022508	34.617311118097035
chr2	MOGS	74463189	74463378	216	190	714	3170	498	2980	1.1368421052631579	0.16711409395973154
chr2	MOGS	74464895	74465312	0	418	714	3170	714	2752	0.0	0.25944767441860467
chr2	MOGS	74464495	74464664	0	170	714	3170	714	3000	0.0	0.238
chr2	MOGS	74465081	74465312	0	232	714	3170	714	2938	0.0	0.2430224642614023
chr2	LBX2	74502666	74502834	0	169	0	2054	0	1885	0.0	0.0
chr2	DQX1	74526135	74526138	0	4	867	2764	867	2760	0.0	0.3141304347826087
chr2	GCFC2	75702198	75702311	0	114	966	5480	966	5366	0.0	0.1800223630264629
chr2	GCFC2	75710443	75710589	0	147	966	5480	966	5333	0.0	0.18113632102006375
chr2	REG1B	79085405	79085490	0	86	51	2089	51	2003	0.0	0.0254618072890664
chr2	LRRTM1	80304151	80304284	0	134	0	4963	0	4829	0.0	0.0
chr2	LRRTM1	80304147	80304150	0	4	0	4963	0	4959	0.0	0.0
chr2	LINC01815	81466573	81467026	0	454	0	1379	0	925	0.0	0.0
chr2	RETSAT	85345512	85345973	0	462	153	4060	153	3598	0.0	0.042523624235686494
chr2	CAPG	85399135	85399179	0	45	584	2163	584	2118	0.0	0.2757318224740321
chr2	GGCX	85558439	85558537	0	99	2063894	6215	2063894	6116	0.0	337.4581425768476
chr2	GGCX	85558916	85558944	0	29	2063894	6215	2063894	6186	0.0	333.63950856773357
chr2	TMEM150A	85601305	85601433	0	129	7118	2915	7118	2786	0.0	2.5549174443646807
chr2	C2ORF68	85611667	85611742	0	76	17985	4700	17985	4624	0.0	3.8894896193771626
chr2	ST3GAL5	85888227	85888275	0	49	273942	15937	273942	15888	0.0	17.242069486404834
chr2	ST3GAL5	85902388	85902464	0	77	273942	15937	273942	15860	0.0	17.27250945775536
chr2	POLR1A	86031329	86031511	0	183	12070	13555	12070	13372	0.0	0.9026323661381992
chr2	REEP1	86239921	86240019	0	99	98135	5860	98135	5761	0.0	17.034369033153965
chr2	PLGLB1	87017505	87017551	0	47	25181	2964	25181	2917	0.0	8.63249914295509
chr2	ZNF514	95158859	95159238	0	380	0	9390	0	9010	0.0	0.0
chr2	LINC00342	95813315	95814048	31488	734	131006	7663	99518	6929	42.8991825613079	14.362534276230337
chr2	GPAT2	96034816	96034851	0	36	440	5194	440	5158	0.0	0.08530438154323382
chr2	STARD7	96208144	96208537	306	394	10009	4283	9703	3889	0.7766497461928934	2.494985857546927
chr2	ANKRD23	96840786	96840825	0	40	1147	3843	1147	3803	0.0	0.3016039968445964
chr2	AC092683.1	97423788	97423796	0	9	62322	5579	62322	5570	0.0	11.18886894075404
chr2	AC092683.1	97423788	97423800	0	13	62322	5579	62322	5566	0.0	11.196909809558031
chr2	AC092683.1	97423797	97423800	0	4	62322	5579	62322	5575	0.0	11.178834080717488
chr2	AC092683.1	97425877	97426841	386	965	62322	5579	61936	4614	0.4	13.4234937147811
chr2	AC092683.1	97422954	97423034	0	81	62322	5579	62322	5498	0.0	11.33539468897781
chr2	TSGA10	99141067	99141081	0	15	7889	5121	7889	5106	0.0	1.545045045045045
chr2	TSGA10	99154692	99154835	0	144	7889	5121	7889	4977	0.0	1.5850914205344586
chr2	MITD1	99180706	99180829	0	124	18280	2343	18280	2219	0.0	8.237945020279405
chr2	TXNDC9	99332983	99333020	0	38	102	2824	102	2786	0.0	0.0366116295764537
chr2	AFF3	100105194	100105333	153	140	19357	15102	19204	14962	1.0928571428571427	1.2835182462237669
chr2	AFF3	100105671	100105778	0	108	19357	15102	19357	14994	0.0	1.290983059890623
chr2	AFF3	100105671	100105715	0	45	19357	15102	19357	15057	0.0	1.2855814571295743
chr2	AFF3	100105779	100106038	0	260	19357	15102	19357	14842	0.0	1.304204285136774
chr2	AFF3	100105716	100106038	0	323	19357	15102	19357	14779	0.0	1.3097638541173287
chr2	AFF3	100105716	100105778	0	63	19357	15102	19357	15039	0.0	1.2871201542655761
chr2	CHST10	100416847	100416987	0	141	0	4387	0	4246	0.0	0.0
chr2	CHST10	100416722	100416846	0	125	0	4387	0	4262	0.0	0.0
chr2	CHST10	100416722	100416987	0	266	0	4387	0	4121	0.0	0.0
chr2	TBC1D8	101090208	101090252	0	45	41191	6443	41191	6398	0.0	6.438105658018131
chr2	RFX8	101421699	101421722	0	24	0	3282	0	3258	0.0	0.0
chr2	MFSD9	102736529	102736644	0	116	2	2075	2	1959	0.0	0.0010209290454313426
chr2	FHL2	105398841	105398968	0	128	0	6508	0	6380	0.0	0.0
chr2	FHL2	105389875	105390105	0	231	0	6508	0	6277	0.0	0.0
chr2	AC010978.1	105856961	105857131	0	171	108	1458	108	1287	0.0	0.08391608391608392
chr2	UXS1	106138174	106138488	0	315	204	6685	204	6370	0.0	0.032025117739403454
chr2	RGPD4-AS1	107826552	107826679	0	128	0	2376	0	2248	0.0	0.0
chr2	RGPD4-AS1	107826552	107826639	0	88	0	2376	0	2288	0.0	0.0
chr2	RGPD4-AS1	107826640	107826679	0	40	0	2376	0	2336	0.0	0.0
chr2	GCC2-AS1	108533828	108533931	0	104	145	698	145	594	0.0	0.2441077441077441
chr2	SEPTIN10	109545384	109545458	0	75	716	3956	716	3881	0.0	0.18448853388301983
chr2	SEPTIN10	109593046	109593049	0	4	716	3956	716	3952	0.0	0.1811740890688259
chr2	SEPTIN10	109613111	109613419	0	309	716	3956	716	3647	0.0	0.1963257471894708
chr2	NPHP1	110164519	110164686	0	168	0	12937	0	12769	0.0	0.0
chr2	NPHP1	110164235	110164518	0	284	0	12937	0	12653	0.0	0.0
chr2	NPHP1	110164235	110164686	0	452	0	12937	0	12485	0.0	0.0
chr2	NPHP1	110125188	110125217	0	30	0	12937	0	12907	0.0	0.0
chr2	AC112229.1	110433435	110434563	0	1129	15	2891	15	1762	0.0	0.00851305334846765
chr2	BUB1	110676532	110676575	0	44	7675	6333	7675	6289	0.0	1.220384798855144
chr2	MIR4435-2HG	111365560	111367485	0	1926	40775	26838	40775	24912	0.0	1.636761400128452
chr2	MIR4435-2HG	111207719	111208486	0	768	40775	26838	40775	26070	0.0	1.5640583045646337
chr2	MIR4435-2HG	111469602	111469785	0	184	40775	26838	40775	26654	0.0	1.5297891498461769
chr2	AC017002.3	111611870	111611961	0	92	0	1314	0	1222	0.0	0.0
chr2	RGPD8	112433381	112433620	0	240	812	8209	812	7969	0.0	0.10189484251474464
chr2	IL1B	112836679	112836706	136	28	920	2980	784	2952	4.857142857142857	0.26558265582655827
chr2	IL1B	112836470	112836678	476	209	920	2980	444	2771	2.277511961722488	0.1602309635510646
chr2	PAX8	113227098	113227153	0	56	9028	6861	9028	6805	0.0	1.3266715650257164
chr2	RPL23AP7	113626829	113627036	0	208	3262	2131	3262	1923	0.0	1.6963078523140926
chr2	SLC35F5	113755854	113756368	0	515	0	4957	0	4442	0.0	0.0
chr2	THORLNC	118186230	118186353	0	124	0	2777	0	2653	0.0	0.0
chr2	C2ORF76	119366356	119366434	0	79	0	1563	0	1484	0.0	0.0
chr2	ERCC3	127293856	127294052	0	197	0	6406	0	6209	0.0	0.0
chr2	ERCC3	127293794	127294052	0	259	0	6406	0	6147	0.0	0.0
chr2	ERCC3	127293794	127293855	0	62	0	6406	0	6344	0.0	0.0
chr2	ERCC3	127291911	127292608	0	698	0	6406	0	5708	0.0	0.0
chr2	ERCC3	127291911	127292082	0	172	0	6406	0	6234	0.0	0.0
chr2	ERCC3	127292083	127292608	0	526	0	6406	0	5880	0.0	0.0
chr2	IWS1	127526174	127526409	0	236	0	4167	0	3931	0.0	0.0
chr2	IWS1	127526174	127526381	0	208	0	4167	0	3959	0.0	0.0
chr2	IWS1	127526382	127526409	0	28	0	4167	0	4139	0.0	0.0
chr2	LIMS2	127641988	127642047	0	60	51	7746	51	7686	0.0	0.00663544106167057
chr2	SAP130	128027091	128027256	16	166	73086	4395	73070	4229	0.0963855421686747	17.278316386852683
chr2	LINC02572	129877333	129877446	0	114	135	4097	135	3983	0.0	0.03389404971127291
chr2	CCDC74B	130144620	130144745	0	126	0	3013	0	2887	0.0	0.0
chr2	SMPD4	130154276	130154353	0	78	4	7065	4	6987	0.0	0.0005724917704308
chr2	SMPD4	130156034	130156051	0	18	4	7065	4	7047	0.0	0.0005676174258549738
chr2	SMPD4	130181295	130181528	0	234	4	7065	4	6831	0.0	0.0005855658029571073
chr2	CCDC115	130342014	130342132	0	119	0	2582	0	2463	0.0	0.0
chr2	FAM168B	131093213	131093330	0	118	193608	5324	193608	5206	0.0	37.18939684978871
chr2	NF1P8	131197872	131197933	0	62	0	1606	0	1544	0.0	0.0
chr2	LYPD1	132669846	132669879	0	34	40	3984	40	3950	0.0	0.010126582278481013
chr2	MAP3K19	134983675	134983706	0	32	56	6971	56	6939	0.0	0.008070327136474997
chr2	ZRANB3	135227811	135227816	0	6	35749	9098	35749	9092	0.0	3.9319181698196215
chr2	ZRANB3	135530497	135530524	0	28	35749	9098	35749	9070	0.0	3.941455347298787
chr2	DARS1	135985793	135985811	0	19	16656	4752	16656	4733	0.0	3.519121064863723
chr2	ZEB2	144430537	144430743	0	207	0	21461	0	21254	0.0	0.0
chr2	ZEB2	144519938	144520350	0	413	0	21461	0	21048	0.0	0.0
chr2	ZEB2	144517611	144517657	0	47	0	21461	0	21414	0.0	0.0
chr2	ZEB2	144517611	144517685	0	75	0	21461	0	21386	0.0	0.0
chr2	ZEB2	144517611	144517744	0	134	0	21461	0	21327	0.0	0.0
chr2	ZEB2	144517658	144517685	0	28	0	21461	0	21433	0.0	0.0
chr2	ZEB2	144517686	144517744	0	59	0	21461	0	21402	0.0	0.0
chr2	ZEB2	144517658	144517744	0	87	0	21461	0	21374	0.0	0.0
chr2	ORC4	148020607	148020631	0	25	0	8740	0	8715	0.0	0.0
chr2	RND3	150487548	150487633	0	86	0	3603	0	3517	0.0	0.0
chr2	ARL5A	151828130	151828387	0	258	204	6732	204	6474	0.0	0.03151065801668211
chr2	CACNB4	151869176	151870529	0	1354	102	14196	102	12842	0.0	0.007942688054820122
chr2	PRPF40A	152717229	152717354	0	126	178359	9227	178359	9101	0.0	19.597736512471158
chr2	LINC01876	156024469	156024483	0	15	0	2723	0	2708	0.0	0.0
chr2	LINC01876	156024469	156024495	0	27	0	2723	0	2696	0.0	0.0
chr2	LINC01876	156024465	156024468	0	4	0	2723	0	2719	0.0	0.0
chr2	LINC01876	156024465	156024483	0	19	0	2723	0	2704	0.0	0.0
chr2	LINC01876	156024465	156024495	0	31	0	2723	0	2692	0.0	0.0
chr2	LINC01876	156024484	156024495	0	12	0	2723	0	2711	0.0	0.0
chr2	NR4A2	156329322	156329912	0	591	153	3973	153	3382	0.0	0.0452395032525133
chr2	ERMN	157324117	157324145	0	29	1173	4361	1173	4332	0.0	0.2707756232686981
chr2	WDSUB1	159286359	159286581	0	223	0	1977	0	1754	0.0	0.0
chr2	WDSUB1	159286359	159286426	0	68	0	1977	0	1909	0.0	0.0
chr2	BAZ2B	159337461	159337565	0	105	26477	18526	26477	18421	0.0	1.437326963791325
chr2	ITGB6	160196215	160196387	0	173	1279	3902	1279	3729	0.0	0.3429873960847412
chr2	RBMS1	160286968	160286976	0	9	370	9745	370	9736	0.0	0.03800328677074774
chr2	AC009299.2	161250866	161250994	0	129	0	2835	0	2706	0.0	0.0
chr2	DPP4	162073839	162073974	0	136	14003	14461	14003	14325	0.0	0.977521815008726
chr2	DPP4	162038944	162038947	0	4	14003	14461	14003	14457	0.0	0.9685965276336723
chr2	FAP	162173054	162173147	15499	94	47867	6864	32368	6770	164.88297872340425	4.78109305760709
chr2	GRB14	164621118	164621233	0	116	396	3003	396	2887	0.0	0.1371666089366124
chr2	COBLL1	164841709	164841737	0	29	58	17102	58	17073	0.0	0.0033971768289111463
chr2	SCN3A	165140650	165140700	0	51	130	11548	130	11497	0.0	0.011307297555884143
chr2	SCN3A	165140650	165140783	0	134	130	11548	130	11414	0.0	0.011389521640091117
chr2	SCN3A	165140650	165140796	0	147	130	11548	130	11401	0.0	0.011402508551881414
chr2	SCN3A	165140650	165140787	0	138	130	11548	130	11410	0.0	0.011393514460999123
chr2	SCN3A	165122793	165122814	0	22	130	11548	130	11526	0.0	0.011278847822314766
chr2	SCN3A	165140701	165140783	0	83	130	11548	130	11465	0.0	0.0113388573920628
chr2	SCN3A	165140701	165140796	0	96	130	11548	130	11452	0.0	0.011351728955640936
chr2	SCN3A	165140701	165140787	0	87	130	11548	130	11461	0.0	0.011342814763109676
chr2	SCN3A	165140784	165140796	0	13	130	11548	130	11535	0.0	0.011270047680970958
chr2	SCN3A	165140784	165140787	0	4	130	11548	130	11544	0.0	0.01126126126126126
chr2	SCN3A	165140788	165140796	0	9	130	11548	130	11539	0.0	0.01126614091342404
chr2	GALNT3	165761842	165761903	0	62	90	4440	90	4378	0.0	0.02055733211512106
chr2	SCN1A	166043668	166043700	0	33	459	18837	459	18804	0.0	0.02440970006381621
chr2	SCN1A	166043668	166043834	0	167	459	18837	459	18670	0.0	0.024584895554365292
chr2	SCN1A	166043668	166043751	0	84	459	18837	459	18753	0.0	0.024476083826587745
chr2	SCN1A	166043701	166043834	0	134	459	18837	459	18703	0.0	0.024541517403625087
chr2	SCN1A	166043701	166043751	0	51	459	18837	459	18786	0.0	0.024433088470137337
chr2	SCN1A	166041214	166041229	0	16	459	18837	459	18821	0.0	0.024387652090749695
chr2	SCN1A	166043752	166043834	0	83	459	18837	459	18754	0.0	0.024474778713874372
chr2	SCN9A	166284452	166284484	0	33	153	13972	153	13939	0.0	0.010976397159050147
chr2	SCN9A	166375696	166375702	0	7	153	13972	153	13965	0.0	0.010955961331901182
chr2	FASTKD1	169572995	169573667	0	673	1194	5035	1194	4362	0.0	0.2737276478679505
chr2	METTL5	169824781	169824866	0	86	0	2425	0	2339	0.0	0.0
chr2	MYO3B-AS1	170343458	170343493	0	36	24581	5707	24581	5671	0.0	4.334508904955034
chr2	MYO3B-AS1	170340166	170340386	102	221	24581	5707	24479	5486	0.46153846153846156	4.462085308056872
chr2	MYO3B-AS1	170341188	170341384	0	197	24581	5707	24581	5510	0.0	4.461161524500907
chr2	MYO3B-AS1	170341329	170341384	0	56	24581	5707	24581	5651	0.0	4.349849584144399
chr2	MYO3B-AS1	170350735	170350877	534	143	24581	5707	24047	5564	3.734265734265734	4.321890726096334
chr2	MYO3B-AS1	170350317	170350460	3045	144	24581	5707	21536	5563	21.145833333333332	3.8712924680927556
chr2	AC007405.1	170770693	170770700	0	8	6662	6575	6662	6567	0.0	1.0144662707476777
chr2	METTL8	171331764	171331802	0	39	0	9953	0	9914	0.0	0.0
chr2	RAPGEF4-AS1	172678877	172678885	0	9	15243	5214	15243	5205	0.0	2.9285302593659943
chr2	CHN1	175004893	175005204	255	312	410167	9117	409912	8805	0.8173076923076923	46.55445769449177
chr2	CHN1	174846308	174846313	0	6	410167	9117	410167	9111	0.0	45.0188782790034
chr2	LNPK	175995552	175995556	0	5	49901	9098	49901	9093	0.0	5.4878477950071485
chr2	HAGLR	176177710	176178013	0	304	51	4973	51	4669	0.0	0.010923109873634611
chr2	HAGLR	176177710	176178001	0	292	51	4973	51	4681	0.0	0.010895107882930999
chr2	HAGLR	176178002	176178013	0	12	51	4973	51	4961	0.0	0.010280185446482563
chr2	LINC01116	176637136	176637460	0	325	459	2130	459	1805	0.0	0.25429362880886425
chr2	AC073636.1	176831230	176831394	0	165	1225	3276	1225	3111	0.0	0.3937640630022501
chr2	AC073636.1	176844832	176846208	51	1377	1225	3276	1174	1899	0.037037037037037035	0.6182201158504476
chr2	AC073636.1	176849250	176849273	0	24	1225	3276	1225	3252	0.0	0.37669126691266913
chr2	AC073636.1	176848574	176848818	306	245	1225	3276	919	3031	1.2489795918367348	0.30320026393929395
chr2	NFE2L2	177263402	177263435	0	34	0	4691	0	4657	0.0	0.0
chr2	NFE2L2	177263402	177263527	0	126	0	4691	0	4565	0.0	0.0
chr2	NFE2L2	177263436	177263527	0	92	0	4691	0	4599	0.0	0.0
chr2	AC019080.1	177287484	177287609	0	126	0	3664	0	3538	0.0	0.0
chr2	AC019080.1	177314795	177314915	0	121	0	3664	0	3543	0.0	0.0
chr2	PRKRA	178443266	178443288	0	23	51	10172	51	10149	0.0	0.005025125628140704
chr2	PRKRA	178447504	178447514	0	11	51	10172	51	10161	0.0	0.005019191024505462
chr2	PRKRA	178450241	178450364	0	124	51	10172	51	10048	0.0	0.005075636942675159
chr2	PRKRA	178447455	178447503	0	49	51	10172	51	10123	0.0	0.005038032203892127
chr2	PRKRA	178447455	178447514	0	60	51	10172	51	10112	0.0	0.005043512658227848
chr2	PRKRA	178450241	178450964	0	724	51	10172	51	9448	0.0	0.005397967823878069
chr2	SESTD1	179116573	179116666	0	94	4370	11426	4370	11332	0.0	0.3856336039534063
chr2	SESTD1	179263976	179264116	0	141	4370	11426	4370	11285	0.0	0.38723969871510855
chr2	CWC22	180006866	180007068	0	203	4536	3341	4536	3138	0.0	1.445506692160612
chr2	CERKL	181656768	181656978	0	211	0	4691	0	4480	0.0	0.0
chr2	PDE1A	182523028	182523101	0	74	0	6343	0	6269	0.0	0.0
chr2	ZSWIM2	186848694	186848964	0	271	0	2498	0	2227	0.0	0.0
chr2	SLC40A1	189581707	189581900	0	194	51	4036	51	3842	0.0	0.01327433628318584
chr2	OSGEPL1	189762566	189762683	0	118	0	3437	0	3319	0.0	0.0
chr2	OSGEPL1	189762531	189762683	0	153	0	3437	0	3284	0.0	0.0
chr2	OSGEPL1	189762531	189762565	0	35	0	3437	0	3402	0.0	0.0
chr2	HIBCH	190250259	190250373	0	115	519	6477	519	6362	0.0	0.08157812008802263
chr2	NEMP2	190534011	190534107	927	97	2410	6535	1483	6438	9.556701030927835	0.2303510406958683
chr2	AC006460.2	190627877	190628067	306	191	43184	7821	42878	7630	1.6020942408376964	5.619659239842726
chr2	STAT1	191014017	191014077	0	61	4	9766	4	9705	0.0	0.0004121586810922205
chr2	AC013401.1	192645267	192645303	0	37	0	591	0	554	0.0	0.0
chr2	GTF3C3	196799454	196799508	0	55	87	7152	87	7097	0.0	0.012258700859518107
chr2	GTF3C3	196799239	196799508	0	270	87	7152	87	6882	0.0	0.012641673931996512
chr2	GTF3C3	196799239	196799453	0	215	87	7152	87	6937	0.0	0.012541444428427273
chr2	SF3B1	197423807	197423892	0	86	306	10241	306	10155	0.0	0.030132939438700147
chr2	SF3B1	197418895	197420426	0	1532	306	10241	306	8709	0.0	0.03513606613847744
chr2	HSPD1	197494656	197494661	0	6	0	6724	0	6718	0.0	0.0
chr2	HSPD1	197498674	197498720	0	47	0	6724	0	6677	0.0	0.0
chr2	HSPD1	197499553	197499604	0	52	0	6724	0	6672	0.0	0.0
chr2	HSPD1	197499166	197499257	0	92	0	6724	0	6632	0.0	0.0
chr2	HSPD1	197499141	197499165	0	25	0	6724	0	6699	0.0	0.0
chr2	HSPD1	197499141	197499257	0	117	0	6724	0	6607	0.0	0.0
chr2	HSPD1	197499998	197500158	0	161	0	6724	0	6563	0.0	0.0
chr2	SATB2	199464835	199464919	0	85	0	10975	0	10890	0.0	0.0
chr2	FTCDNL1	199850739	199850757	0	19	153	2766	153	2747	0.0	0.05569712413542046
chr2	AC097717.1	199910801	199911023	0	223	455	6765	455	6542	0.0	0.06955059614796698
chr2	AC097717.1	199910801	199911041	0	241	455	6765	455	6524	0.0	0.06974248927038626
chr2	AC097717.1	199910801	199911018	0	218	455	6765	455	6547	0.0	0.06949747976172292
chr2	AC097717.1	199894442	199894581	0	140	455	6765	455	6625	0.0	0.06867924528301887
chr2	AC097717.1	199911024	199911041	0	18	455	6765	455	6747	0.0	0.0674373795761079
chr2	AC097717.1	199908862	199908895	0	34	455	6765	455	6731	0.0	0.06759768236517605
chr2	AC097717.1	199910762	199910800	0	39	455	6765	455	6726	0.0	0.06764793339280405
chr2	AC097717.1	199910762	199911023	0	262	455	6765	455	6503	0.0	0.06996770721205597
chr2	AC097717.1	199910762	199911041	0	280	455	6765	455	6485	0.0	0.07016191210485737
chr2	AC097717.1	199910762	199911018	0	257	455	6765	455	6508	0.0	0.0699139520590043
chr2	AC097717.1	199911019	199911023	0	5	455	6765	455	6760	0.0	0.0673076923076923
chr2	AC097717.1	199911019	199911041	0	23	455	6765	455	6742	0.0	0.06748739246514388
chr2	TYW5	199948317	199948335	0	19	357	9858	357	9839	0.0	0.03628417522105905
chr2	KCTD18	200504747	200504768	0	22	0	4917	0	4895	0.0	0.0
chr2	KCTD18	200509627	200510009	0	383	0	4917	0	4534	0.0	0.0
chr2	PPIL3	200888955	200889242	0	288	0	2472	0	2184	0.0	0.0
chr2	PPIL3	200888948	200888954	0	7	0	2472	0	2465	0.0	0.0
chr2	ORC2	200963048	200963217	0	170	0	5850	0	5680	0.0	0.0
chr2	CFLAR-AS1	201148715	201148732	0	18	51	4158	51	4140	0.0	0.012318840579710146
chr2	CFLAR-AS1	201148715	201149123	0	409	51	4158	51	3749	0.0	0.013603627634035742
chr2	CFLAR-AS1	201148733	201149123	0	391	51	4158	51	3767	0.0	0.013538624900451287
chr2	CFLAR-AS1	201145573	201145638	0	66	51	4158	51	4092	0.0	0.012463343108504398
chr2	CFLAR-AS1	201152821	201153309	51	489	51	4158	0	3669	0.10429447852760736	0.0
chr2	FLACC1	201356981	201357312	0	332	9688	2497	9688	2165	0.0	4.474826789838337
chr2	ICA1L	202871160	202871189	0	30	274	10225	274	10195	0.0	0.02687591956841589
chr2	ICA1L	202870929	202871189	0	261	274	10225	274	9964	0.0	0.027498996386993175
chr2	NDUFS1	206149779	206149816	0	38	51	12182	51	12144	0.0	0.004199604743083004
chr2	NDUFS1	206159083	206159094	0	12	51	12182	51	12170	0.0	0.00419063270336894
chr2	MDH1B	206756897	206756910	0	14	35	2903	35	2889	0.0	0.012114918656974732
chr2	KLF7	207123773	207123974	0	202	1798	9124	1798	8922	0.0	0.20152432190091907
chr2	KLF7	207123773	207124342	0	570	1798	9124	1798	8554	0.0	0.21019406125789106
chr2	KLF7	207123975	207124342	0	368	1798	9124	1798	8756	0.0	0.20534490634993147
chr2	METTL21A	207625061	207625263	0	203	507	4067	507	3864	0.0	0.13121118012422361
chr2	C2ORF80	208189873	208189951	0	79	0	1402	0	1323	0.0	0.0
chr2	LANCL1	210476708	210476720	0	13	0	5060	0	5047	0.0	0.0
chr2	LANCL1	210476619	210476707	0	89	0	5060	0	4971	0.0	0.0
chr2	LANCL1	210476619	210476645	0	27	0	5060	0	5033	0.0	0.0
chr2	LANCL1	210476619	210476720	0	102	0	5060	0	4958	0.0	0.0
chr2	IKZF2	213150143	213150179	0	37	0	12218	0	12181	0.0	0.0
chr2	IKZF2	213056832	213056909	0	78	0	12218	0	12140	0.0	0.0
chr2	BARD1	214780559	214780966	0	408	1632	7585	1632	7177	0.0	0.2273930611676188
chr2	LINC00607	215624111	215624141	0	31	1963	6966	1963	6935	0.0	0.28305695746214854
chr2	DIRC3	217433756	217433946	0	191	2397	8277	2397	8086	0.0	0.2964382883997032
chr2	AAMP	218266054	218266062	0	9	0	2719	0	2710	0.0	0.0
chr2	USP37	218562672	218562716	0	45	102	9311	102	9266	0.0	0.011007986186056551
chr2	RNF25	218668238	218668277	240	40	552	1825	312	1785	6.0	0.17478991596638654
chr2	PRKAG3	218830745	218830756	0	12	137	3347	137	3335	0.0	0.041079460269865066
chr2	CFAP65	219041422	219041486	0	65	315	10236	315	10171	0.0	0.030970406056434963
chr2	SLC23A3	219169520	219169556	0	37	64	3310	64	3273	0.0	0.01955392606171708
chr2	NHEJ1	219078073	219078087	0	15	24010	3122	24010	3107	0.0	7.727711618925008
chr2	SLC23A3	219169284	219169307	0	24	64	3310	64	3286	0.0	0.019476567255021303
chr2	SLC23A3	219168647	219168650	0	4	64	3310	64	3306	0.0	0.019358741681790685
chr2	SLC23A3	219169822	219169993	0	172	64	3310	64	3138	0.0	0.020395156150414276
chr2	ATG9A	219223868	219223926	0	59	0	4730	0	4671	0.0	0.0
chr2	ATG9A	219228423	219228432	0	10	0	4730	0	4720	0.0	0.0
chr2	PTPRN	219309217	219309427	51	211	306	6977	255	6766	0.24170616113744076	0.03768844221105527
chr2	PTPRN	219308881	219308976	0	96	306	6977	306	6881	0.0	0.04447028048248801
chr2	DNPEP	219387575	219387757	0	183	2483	5992	2483	5809	0.0	0.4274401790325357
chr2	DNPEP	219399865	219399938	0	74	2483	5992	2483	5918	0.0	0.4195674214261575
chr2	OBSL1	219556453	219556576	0	124	208638	9151	208638	9027	0.0	23.112662013958126
chr2	OBSL1	219570220	219571392	153	1173	208638	9151	208485	7978	0.13043478260869565	26.132489345700677
chr2	EPHA4	221426434	221426462	0	29	0	7576	0	7547	0.0	0.0
chr2	EPHA4	221573849	221573959	0	111	0	7576	0	7465	0.0	0.0
chr2	AP1S3	223777688	223777689	2	2	5355	5957	5353	5955	1.0	0.8989084802686818
chr2	CUL3	224562699	224563192	0	494	10453	10494	10453	10000	0.0	1.0453
chr2	MFF-DT	227265838	227265873	0	36	102	11480	102	11444	0.0	0.008912967493883258
chr2	C2ORF83	227642083	227642221	0	139	0	3494	0	3355	0.0	0.0
chr2	SLC19A3	227695518	227695887	0	370	32721	5687	32721	5317	0.0	6.154034229828851
chr2	SLC19A3	227706314	227706551	0	238	32721	5687	32721	5449	0.0	6.004955037621582
chr2	TRIP12	229807704	229807706	0	3	23	12692	23	12689	0.0	0.0018125935849948776
chr2	AC010149.1	230579900	230579903	0	4	195	700	195	696	0.0	0.2801724137931034
chr2	SPATA3-AS1	230995727	230995846	0	120	10	3752	10	3632	0.0	0.0027533039647577094
chr2	NCL	231463700	231464141	0	442	147	6296	147	5854	0.0	0.02511103518961394
chr2	NCL	231463700	231464158	0	459	147	6296	147	5837	0.0	0.025184169950316942
chr2	NCL	231464142	231464158	0	17	147	6296	147	6279	0.0	0.023411371237458192
chr2	LINC00471	231514081	231514095	0	15	0	1301	0	1286	0.0	0.0
chr2	ECEL1	232482850	232482855	0	6	138	2995	138	2989	0.0	0.046169287387085985
chr2	KCNJ13	232770902	232771137	0	236	0	1125	0	889	0.0	0.0
chr2	AC114812.1	233755006	233755142	0	137	408	1042	408	905	0.0	0.450828729281768
chr2	AC012063.1	236952620	236953903	510	1284	3813	13105	3303	11821	0.397196261682243	0.2794179849420523
chr2	RAB17	237585997	237586040	0	44	102	4078	102	4034	0.0	0.02528507684680218
chr2	RAB17	237585997	237586062	0	66	102	4078	102	4012	0.0	0.025423728813559324
chr2	RAB17	237586041	237586062	0	22	102	4078	102	4056	0.0	0.02514792899408284
chr2	ILKAP	238189852	238189861	110	10	2832	4683	2722	4673	11.0	0.5824951851059277
chr2	ILKAP	238189852	238189857	66	6	2832	4683	2766	4677	11.0	0.5914047466324567
chr2	ILKAP	238189858	238189861	44	4	2832	4683	2788	4679	11.0	0.5958538149177175
chr2	LINC02610	238231200	238231332	0	133	0	3731	0	3598	0.0	0.0
chr2	HES6	238239486	238239525	0	40	0	1138	0	1098	0.0	0.0
chr2	HES6	238239660	238239823	0	164	0	1138	0	974	0.0	0.0
chr2	HDAC4	239102775	239102789	348	15	68914	13056	68566	13041	23.2	5.257725634537229
chr2	NDUFA10	240018552	240018553	0	2	53071	18589	53071	18587	0.0	2.8552751923387314
chr2	NDUFA10	240025226	240025228	0	3	53071	18589	53071	18586	0.0	2.855428817389433
chr2	NDUFA10	240014738	240014839	0	102	53071	18589	53071	18487	0.0	2.8707199653810784
chr2	NDUFA10	240014738	240014767	0	30	53071	18589	53071	18559	0.0	2.8595829516676545
chr2	NDUFA10	239960954	239961021	0	68	53071	18589	53071	18521	0.0	2.865450029696021
chr2	NDUFA10	240021086	240021195	0	110	53071	18589	53071	18479	0.0	2.8719627685480815
chr2	NDUFA10	240025226	240025246	0	21	53071	18589	53071	18568	0.0	2.858196897888841
chr2	NDUFA10	240012331	240014737	3416	2407	53071	18589	49655	16182	1.4191940174491067	3.0685329378321593
chr2	NDUFA10	240012331	240014839	3416	2509	53071	18589	49655	16080	1.361498605021921	3.087997512437811
chr2	NDUFA10	240012331	240014693	3370	2363	53071	18589	49701	16226	1.426153195090986	3.063046961666461
chr2	NDUFA10	240012331	240012485	153	155	53071	18589	52918	18434	0.9870967741935484	2.8706737550179016
chr2	NDUFA10	240012331	240014767	3416	2437	53071	18589	49655	16152	1.4017234304472712	3.074232293214463
chr2	NDUFA10	240014694	240014737	46	44	53071	18589	53025	18545	1.0454545454545454	2.859261256403343
chr2	NDUFA10	240014694	240014839	46	146	53071	18589	53025	18443	0.3150684931506849	2.8750745540313396
chr2	NDUFA10	240014694	240014767	46	74	53071	18589	53025	18515	0.6216216216216216	2.8638941398865785
chr2	NDUFA10	240014768	240014839	0	72	53071	18589	53071	18517	0.0	2.866069017659448
chr2	NDUFA10	240018523	240018551	0	29	53071	18589	53071	18560	0.0	2.859428879310345
chr2	COPS9	240136191	240136220	0	30	0	2013	0	1983	0.0	0.0
chr2	ANKMY1	240560730	240561034	0	305	0	7366	0	7061	0.0	0.0
chr2	AQP12B	240677598	240678921	0	1324	0	1584	0	260	0.0	0.0
chr2	MAB21L4	240891872	240891928	0	57	4382	2563	4382	2506	0.0	1.7486033519553073
chr2	MTERF4	241095129	241096391	0	1263	95811	9722	95811	8459	0.0	11.32651613665918
chr2	MTERF4	241090277	241090301	0	25	95811	9722	95811	9697	0.0	9.880478498504692
chr2	PASK	241115021	241115041	0	21	51	10561	51	10540	0.0	0.004838709677419355
chr2	HDLBP	241262710	241262867	0	158	6	11245	6	11087	0.0	0.0005411743483358888
chr2	HDLBP	241267577	241267590	0	14	6	11245	6	11231	0.0	0.0005342355978986733
chr2	HDLBP	241268953	241268956	0	4	6	11245	6	11241	0.0	0.0005337603416066186
chr2	HDLBP	241269200	241269204	0	5	6	11245	6	11240	0.0	0.0005338078291814947
chr2	HDLBP	241268953	241269199	0	247	6	11245	6	10998	0.0	0.0005455537370430987
chr2	HDLBP	241268957	241269199	0	243	6	11245	6	11002	0.0	0.0005453553899291038
chr2	HDLBP	241268828	241268952	0	125	6	11245	6	11120	0.0	0.000539568345323741
chr2	HDLBP	241268828	241269199	0	372	6	11245	6	10873	0.0	0.0005518256231030994
chr2	HDLBP	241268828	241268956	0	129	6	11245	6	11116	0.0	0.0005397625044980209
chr2	STK25	241501477	241501526	631	50	35268	5262	34637	5212	12.62	6.645625479662318
chr2	STK25	241508442	241508503	2813	62	35268	5262	32455	5200	45.37096774193548	6.241346153846154
chr2	THAP4	241601814	241601894	0	81	0	2842	0	2761	0.0	0.0
chr2	DTYMK	241685768	241685805	0	38	102	2407	102	2369	0.0	0.043056141831996624
chr2	PDCD1	241852620	241852855	0	236	0	2102	0	1866	0.0	0.0
chr2	AC079779.1	198616	199901	0	1286	0	4340	0	3054	0.0	0.0
chr2	AC105393.1	421162	421264	0	103	1122	2432	1122	2329	0.0	0.48175182481751827
chr2	AC093326.1	558278	558339	0	62	0	2562	0	2500	0.0	0.0
chr2	TPO	1413546	1413550	0	5	41	6780	41	6775	0.0	0.006051660516605166
chr2	TRAPPC12	3379840	3379876	37	37	33941	8700	33904	8663	1.0	3.9136557774443035
chr2	TRAPPC12	3465696	3465708	568	13	33941	8700	33373	8687	43.69230769230769	3.8417175089213766
chr2	RPS7	3575351	3575448	0	98	11115	1880	11115	1782	0.0	6.237373737373737
chr2	LINC01824	6496397	6496616	0	220	0	2026	0	1806	0.0	0.0
chr2	LINC01824	6496253	6496616	0	364	0	2026	0	1662	0.0	0.0
chr2	LINC01824	6496253	6496396	0	144	0	2026	0	1882	0.0	0.0
chr2	AC013460.1	7423036	7424012	0	977	0	5222	0	4245	0.0	0.0
chr2	AC013460.1	7428457	7428470	0	14	0	5222	0	5208	0.0	0.0
chr2	AC013460.1	7428895	7429273	0	379	0	5222	0	4843	0.0	0.0
chr2	U91324.1	8139485	8139501	0	17	0	1720	0	1703	0.0	0.0
chr2	AC093904.3	9111063	9111171	44	109	44	1221	0	1112	0.4036697247706422	0.0
chr2	CPSF3	9423824	9424052	0	229	3704	3701	3704	3472	0.0	1.066820276497696
chr2	CPSF3	9424053	9424960	0	908	3704	3701	3704	2793	0.0	1.326172574292875
chr2	IAH1	9475148	9475217	0	70	62001	5393	62001	5323	0.0	11.647755025361638
chr2	GRHL1	9958857	9958964	0	108	582	4949	582	4841	0.0	0.12022309440198306
chr2	GRHL1	9990748	9990773	0	26	582	4949	582	4923	0.0	0.1182205971968312
chr2	LINC00570	11391876	11391996	53	121	497	2182	444	2061	0.4380165289256198	0.21542940320232898
chr2	LPIN1	11724540	11724642	0	103	204	11894	204	11791	0.0	0.017301331524043763
chr2	TRIB2	12717011	12718577	0	1567	0	4331	0	2764	0.0	0.0
chr2	DDX1	15630108	15630110	0	3	1760	8850	1760	8847	0.0	0.19893749293545834
chr2	DDX1	15627146	15628839	0	1694	1760	8850	1760	7156	0.0	0.24594745667970933
chr2	GACAT3	16081091	16081185	0	95	0	3700	0	3605	0.0	0.0
chr2	LINC01808	19469081	19469430	0	350	0	3067	0	2717	0.0	0.0
chr2	LINC01808	19479143	19479284	0	142	0	3067	0	2925	0.0	0.0
chr2	LINC01884	22516632	22516767	0	136	0	1354	0	1218	0.0	0.0
chr2	FAM228A	24179228	24179297	0	70	903	2289	903	2219	0.0	0.4069400630914827
chr2	CENPO	24793502	24793520	0	19	153	5526	153	5507	0.0	0.027782821863083347
chr2	DNAJC27-AS1	24972233	24972330	0	98	185163	5744	185163	5646	0.0	32.79543039319872
chr2	HADHB	26244991	26245139	0	149	744	3812	744	3663	0.0	0.2031122031122031
chr2	HADHB	26245140	26245441	0	302	744	3812	744	3510	0.0	0.21196581196581196
chr2	CENPA	26786081	26786296	0	216	0	1956	0	1740	0.0	0.0
chr2	MAPRE3	27024253	27024297	0	45	83981	3639	83981	3594	0.0	23.367000556483028
chr2	EMILIN1	27084012	27084026	0	15	51	3913	51	3898	0.0	0.013083632632119035
chr2	ATRAID	27212468	27212607	0	140	0	2026	0	1886	0.0	0.0
chr2	GTF3C2-AS1	27335721	27336088	1393	368	9489	3294	8096	2926	3.785326086956522	2.7669172932330826
chr2	SNX17	27371344	27371468	0	125	0	3482	0	3357	0.0	0.0
chr2	SLC4A1AP	27664050	27664577	74288	528	121725	4778	47437	4250	140.6969696969697	11.16164705882353
chr2	PLB1	28626509	28626548	24	40	20183	8664	20159	8624	0.6	2.3375463821892395
chr2	PPP1CB	28751784	28751820	0	37	612	5733	612	5696	0.0	0.1074438202247191
chr2	PPP1CB	28751821	28751924	0	104	612	5733	612	5629	0.0	0.10872268608989163
chr2	SPDYA	28810948	28811190	0	243	459	3497	459	3254	0.0	0.14105716041794714
chr2	CLIP4	29157348	29157402	0	55	14627	6993	14627	6938	0.0	2.108244450850389
chr2	YPEL5	30148306	30148541	0	236	0	3132	0	2896	0.0	0.0
chr2	YPEL5	30147966	30148091	0	126	0	3132	0	3006	0.0	0.0
chr2	LBH	30234508	30234511	0	4	0	4538	0	4534	0.0	0.0
chr2	LBH	30232207	30232594	0	388	0	4538	0	4150	0.0	0.0
chr2	LCLAT1	30447384	30447404	0	21	153	7528	153	7507	0.0	0.020380977754096176
chr2	LCLAT1	30447405	30447523	0	119	153	7528	153	7409	0.0	0.020650560129572143
chr2	BIRC6	32453943	32453954	0	12	100508	17804	100508	17792	0.0	5.6490557553956835
chr2	BIRC6	32471125	32471151	0	27	100508	17804	100508	17777	0.0	5.653822354728019
chr2	TTC27	32628134	32628380	0	247	2433	3468	2433	3221	0.0	0.7553554796647004
chr2	LINC00486	32927238	32927346	0	109	1871	7058	1871	6949	0.0	0.2692473737228378
chr2	LINC00486	32927347	32927662	0	316	1871	7058	1871	6742	0.0	0.277514090774251
chr2	LTBP1	33262822	33262824	0	3	1300	7385	1300	7382	0.0	0.1761040368463831
chr2	LINC01320	34384210	34384241	0	32	144	10145	144	10113	0.0	0.014239098190447939
chr2	LINC01320	34722075	34722121	0	47	144	10145	144	10098	0.0	0.0142602495543672
chr2	LINC01320	34713774	34713777	0	4	144	10145	144	10141	0.0	0.014199783058869934
chr2	LINC01320	34722122	34722438	0	317	144	10145	144	9828	0.0	0.014652014652014652
chr2	LINC01320	34722075	34722438	0	364	144	10145	144	9781	0.0	0.014722421020345568
chr2	NDUFAF7	37237836	37237867	0	32	14	3663	14	3631	0.0	0.003855687138529331
chr2	NDUFAF7	37241638	37241791	0	154	14	3663	14	3509	0.0	0.003989740666856654
chr2	NDUFAF7	37231836	37231879	0	44	14	3663	14	3619	0.0	0.0038684719535783366
chr2	NDUFAF7	37231880	37231989	0	110	14	3663	14	3553	0.0	0.003940332113706727
chr2	CYP1B1-AS1	38075790	38076068	0	279	51	8859	51	8580	0.0	0.005944055944055944
chr2	GEMIN6	38779326	38779441	0	116	525	4369	525	4253	0.0	0.12344227604044204
chr2	MORN2	38876111	38876211	0	101	0	1374	0	1273	0.0	0.0
chr2	ARHGEF33	38960640	38960648	0	9	353742	5091	353742	5082	0.0	69.60684769775679
chr2	MAP4K3-DT	39587035	39587353	0	319	10240	10725	10240	10406	0.0	0.9840476648087642
chr2	MAP4K3-DT	39516542	39517152	561	611	10240	10725	9679	10114	0.9181669394435352	0.9569903104607475
chr2	SLC8A1-AS1	39922890	39923018	0	129	102	8515	102	8386	0.0	0.012163129024564751
chr2	SLC8A1-AS1	40065473	40065855	0	383	102	8515	102	8132	0.0	0.012543039842597147
chr2	SLC8A1-AS1	40213219	40213479	0	261	102	8515	102	8254	0.0	0.012357644778289314
chr2	LINC01913	41877302	41877535	0	234	51	5091	51	4857	0.0	0.010500308832612723
chr2	MTA3	42709015	42709096	0	82	8393	10362	8393	10280	0.0	0.8164396887159533
chr2	SLC3A1	44313952	44313955	0	4	0	6140	0	6136	0.0	0.0
chr2	EPCAM	47369582	47369809	0	228	128410	2205	128410	1977	0.0	64.95194739504299
chr2	MSH6	47783232	47783493	0	262	40178	10902	40178	10640	0.0	3.776127819548872
chr2	MSH6	47783471	47783493	0	23	40178	10902	40178	10879	0.0	3.693170328155161
chr2	GTF2A1L	48621291	48621317	0	27	969	2063	969	2036	0.0	0.47593320235756387
chr2	GTF2A1L	48621305	48621317	0	13	969	2063	969	2050	0.0	0.47268292682926827
chr2	GTF2A1L	48621291	48621304	0	14	969	2063	969	2049	0.0	0.47291361639824303
chr2	C2ORF73	54334851	54335024	0	174	306	2412	306	2238	0.0	0.13672922252010725
chr2	EML6	54724671	54725258	0	588	166946	16043	166946	15455	0.0	10.802070527337431
chr2	RPS27A	55232519	55232708	0	190	1632	2836	1632	2646	0.0	0.6167800453514739
chr2	AC012358.2	55329520	55329713	0	194	0	4927	0	4733	0.0	0.0
chr2	VRK2	58046822	58046868	0	47	0	3484	0	3437	0.0	0.0
chr2	LINC01122	58460993	58461125	0	133	0	11565	0	11432	0.0	0.0
chr2	PAPOLG	60756350	60756495	0	146	51	7983	51	7837	0.0	0.006507592190889371
chr2	AHSA2P	61177619	61178384	0	766	1275	8068	1275	7302	0.0	0.17460969597370585
chr2	AHSA2P	61184801	61184924	48	124	1275	8068	1227	7944	0.3870967741935484	0.15445619335347432
chr2	AHSA2P	61183663	61184022	204	360	1275	8068	1071	7708	0.5666666666666667	0.13894654903995848
chr2	EHBP1	62948317	62949162	0	846	984	8254	984	7408	0.0	0.132829373650108
chr2	EHBP1	62674084	62674093	0	10	984	8254	984	8244	0.0	0.11935953420669577
chr2	EHBP1	62705705	62705736	0	32	984	8254	984	8222	0.0	0.11967891024081732
chr2	EHBP1	62705737	62706052	0	316	984	8254	984	7938	0.0	0.12396069538926682
chr2	UGP2	63857643	63857718	0	76	0	6812	0	6736	0.0	0.0
chr2	UGP2	63857717	63857718	0	2	0	6812	0	6810	0.0	0.0
chr2	UGP2	63857643	63857716	0	74	0	6812	0	6738	0.0	0.0
chr2	AC012368.1	64251835	64251983	0	149	10426	7851	10426	7702	0.0	1.3536743702934302
chr2	AC012368.1	64228523	64228629	0	107	10426	7851	10426	7744	0.0	1.3463326446280992
chr2	AC012368.1	64228523	64229288	48	766	10426	7851	10378	7085	0.06266318537859007	1.4647847565278758
chr2	AC012368.1	64228630	64229288	48	659	10426	7851	10378	7192	0.07283763277693475	1.4429922135706341
chr2	CEP68	65072570	65072980	0	411	306	6951	306	6540	0.0	0.046788990825688076
chr2	CEP68	65072981	65074178	0	1198	306	6951	306	5753	0.0	0.05318964018772814
chr2	CEP68	65072570	65074178	0	1609	306	6951	306	5342	0.0	0.057281916885061776
chr2	CEP68	65074150	65074178	0	29	306	6951	306	6922	0.0	0.044206876625252814
chr2	AC007389.1	65732935	65733389	0	455	2316	12371	2316	11916	0.0	0.19436052366565962
chr2	LINC01798	66691548	66691554	0	7	24	3925	24	3918	0.0	0.006125574272588055
chr2	LINC01828	67268545	67268638	0	94	0	8104	0	8010	0.0	0.0
chr2	LINC01828	67287819	67287823	0	5	0	8104	0	8099	0.0	0.0
chr2	LINC02831	67566885	67566972	0	88	0	3252	0	3164	0.0	0.0
chr2	LINC02831	67564887	67565423	0	537	0	3252	0	2715	0.0	0.0
chr2	APLF	68513681	68513684	0	4	1931	7146	1931	7142	0.0	0.2703724446933632
chr2	ANXA4	69806433	69806498	0	66	1497	4497	1497	4431	0.0	0.3378469871360867
chr2	ANXA4	69810674	69811456	0	783	1497	4497	1497	3714	0.0	0.40306946688206785
chr2	ANXA4	69807997	69808189	0	193	1497	4497	1497	4304	0.0	0.3478159851301115
chr2	VAX2	70963262	70963312	0	51	79	2993	79	2942	0.0	0.026852481305234533
chr2	ATP6V1B1	70961023	70961043	0	21	91	2671	91	2650	0.0	0.034339622641509436
chr2	NAGK	71068337	71068712	0	376	255	6678	255	6302	0.0	0.040463344969850844
chr2	NAGK	71075611	71075642	0	32	255	6678	255	6646	0.0	0.0383689437255492
chr2	NAGK	71068713	71069061	0	349	255	6678	255	6329	0.0	0.04029072523305419
chr2	ZNF638	71331866	71331875	0	10	42575	11438	42575	11428	0.0	3.725498774938747
chr2	SMYD5	73214706	73214749	0	44	5182	3320	5182	3276	0.0	1.5818070818070817
chr2	ALMS1	73490159	73491498	11707	1340	271625	14807	259918	13467	8.736567164179105	19.300363852379892
chr2	ALMS1P1	73673049	73673050	0	2	93	4699	93	4697	0.0	0.019799872258888653
chr2	STAMBP	73847573	73847753	0	181	4975	7527	4975	7346	0.0	0.6772393139123333
chr2	STAMBP	73828997	73829510	2601	514	4975	7527	2374	7013	5.060311284046692	0.338514187936689
chr2	STAMBP	73829071	73829510	2601	440	4975	7527	2374	7087	5.911363636363636	0.3349795400028221
chr2	STAMBP	73828997	73829070	0	74	4975	7527	4975	7453	0.0	0.667516436334362
chr2	ACTG2	73901438	73901480	0	43	0	3822	0	3779	0.0	0.0
chr2	MTHFD2	74187121	74187457	550	337	4110	11414	3560	11077	1.632047477744807	0.3213866570371039
chr2	MTHFD2	74206414	74206606	70	193	4110	11414	4040	11221	0.3626943005181347	0.3600392121914268
chr2	MTHFD2	74212110	74212128	0	19	4110	11414	4110	11395	0.0	0.3606845107503291
chr2	INO80B-WBP1	74457539	74457860	0	322	306	2048	306	1726	0.0	0.1772885283893395
chr2	INO80B	74455937	74455950	0	14	0	1446	0	1432	0.0	0.0
chr2	WBP1	74458538	74458671	0	134	306	1671	306	1537	0.0	0.19908913467794404
chr2	WBP1	74459099	74459117	0	19	306	1671	306	1652	0.0	0.18523002421307505
chr2	TTC31	74491667	74491672	0	6	289	4040	289	4034	0.0	0.07164105106593951
chr2	DOK1	74555283	74555453	135	171	629	2957	494	2786	0.7894736842105263	0.1773151471643934
chr2	AC012494.2	78088792	78088802	0	11	0	1400	0	1389	0.0	0.0
chr2	AC012494.2	78112101	78112130	0	30	0	1400	0	1370	0.0	0.0
chr2	KCMF1	84972241	84972245	0	5	74516	7740	74516	7735	0.0	9.63361344537815
chr2	ELMOD3	85355717	85357252	0	1536	153	6400	153	4864	0.0	0.03145559210526316
chr2	ELMOD3	85355599	85355716	0	118	153	6400	153	6282	0.0	0.024355300859598854
chr2	ELMOD3	85355599	85355896	0	298	153	6400	153	6102	0.0	0.025073746312684365
chr2	ELMOD3	85355717	85355896	0	180	153	6400	153	6220	0.0	0.024598070739549838
chr2	ELMOD3	85355785	85355896	0	112	153	6400	153	6288	0.0	0.02433206106870229
chr2	ELMOD3	85355599	85355784	0	186	153	6400	153	6214	0.0	0.0246218216929514
chr2	ELMOD3	85355717	85355784	0	68	153	6400	153	6332	0.0	0.02416298168035376
chr2	ELMOD3	85371210	85371562	0	353	153	6400	153	6047	0.0	0.02530180254671738
chr2	SH2D6	85435817	85435824	0	8	51	2703	51	2695	0.0	0.018923933209647494
chr2	SH2D6	85431269	85431331	0	63	51	2703	51	2640	0.0	0.019318181818181818
chr2	MAT2A	85539673	85540000	3070	328	137156	4399	134086	4071	9.359756097560975	32.93687054777696
chr2	USP39	85616457	85616463	0	7	28552	3963	28552	3956	0.0	7.217391304347826
chr2	GNLY	85694924	85694996	0	73	51	2772	51	2699	0.0	0.018895887365690995
chr2	CYTOR	87480363	87480423	0	61	867	17288	867	17227	0.0	0.05032797352992396
chr2	CYTOR	87480363	87480607	0	245	867	17288	867	17043	0.0	0.050871325470867805
chr2	CYTOR	87480424	87480607	0	184	867	17288	867	17104	0.0	0.05068989710009354
chr2	CYTOR	87604158	87604160	0	3	867	17288	867	17285	0.0	0.05015909748336708
chr2	ANKRD36BP2	88784794	88784926	0	133	68	4231	68	4098	0.0	0.016593460224499756
chr2	PROM2	95277497	95277566	0	70	0	4716	0	4646	0.0	0.0
chr2	FAHD2A	95402873	95402992	0	120	51	5683	51	5563	0.0	0.009167715261549523
chr2	AC008268.1	95666404	95666424	0	21	0	2062	0	2041	0.0	0.0
chr2	FAHD2CP	96010733	96010851	0	119	690	2143	690	2024	0.0	0.3409090909090909
chr2	FER1L5	96686336	96686350	0	15	4194	7511	4194	7496	0.0	0.5594983991462114
chr2	FER1L5	96686264	96686350	51	87	4194	7511	4143	7424	0.5862068965517241	0.5580549568965517
chr2	FER1L5	96690584	96690589	0	6	4194	7511	4194	7505	0.0	0.5588274483677548
chr2	FER1L5	96686264	96686335	51	72	4194	7511	4143	7439	0.7083333333333334	0.5569296948514585
chr2	FER1L5	96687948	96687954	28	7	4194	7511	4166	7504	4.0	0.5551705756929638
chr2	FER1L5	96687954	96687954	4	1	4194	7511	4190	7510	4.0	0.5579227696404794
chr2	FER1L5	96694465	96694631	0	167	4194	7511	4194	7344	0.0	0.571078431372549
chr2	FER1L5	96652021	96652026	12	6	4194	7511	4182	7505	2.0	0.5572285143237842
chr2	FER1L5	96687948	96687953	24	6	4194	7511	4170	7505	4.0	0.5556295802798135
chr2	FER1L5	96694465	96694632	0	168	4194	7511	4194	7343	0.0	0.5711562031867085
chr2	FER1L5	96694632	96694632	0	1	4194	7511	4194	7510	0.0	0.5584553928095872
chr2	FER1L5	96668969	96669004	0	36	4194	7511	4194	7475	0.0	0.5610702341137124
chr2	AC159540.2	97285008	97285523	29077	516	21131	1980	-7946	1464	56.35077519379845	-5.4275956284153
chr2	AC159540.2	97284161	97284164	0	4	21131	1980	21131	1976	0.0	10.693825910931174
chr2	C2ORF92	97671482	97671499	0	18	125	6194	125	6176	0.0	0.02023963730569948
chr2	C2ORF92	97674558	97674561	0	4	125	6194	125	6190	0.0	0.020193861066235864
chr2	INPP4A	98555692	98555808	51	117	2741	13221	2690	13104	0.4358974358974359	0.20528083028083027
chr2	NPAS2	100925295	100925300	0	6	51	11905	51	11899	0.0	0.004286074460038659
chr2	RPL31	101004284	101004361	0	78	9351	3899	9351	3821	0.0	2.4472651138445434
chr2	MAP4K4	101867310	101867318	0	9	218220	11035	218220	11026	0.0	19.79140214039543
chr2	MAP4K4	101887238	101887261	0	24	218220	11035	218220	11011	0.0	19.81836345472709
chr2	LINC01127	101984705	101984937	0	233	0	3392	0	3159	0.0	0.0
chr2	IL1R1	102141919	102141999	0	81	16662	6249	16662	6168	0.0	2.7013618677042803
chr2	IL1RL2	102187083	102187086	32	4	8950	2615	8918	2611	8.0	3.415549597855228
chr2	IL1RL1	102339023	102339047	0	25	3189	5719	3189	5694	0.0	0.5600632244467861
chr2	LINC01965	104051978	104052373	0	396	51	5510	51	5114	0.0	0.009972624168947985
chr2	AC068535.1	104406776	104406791	0	16	0	2412	0	2396	0.0	0.0
chr2	LINC01102	104505939	104506303	0	365	0	7010	0	6645	0.0	0.0
chr2	LINC01102	104506187	104506303	0	117	0	7010	0	6893	0.0	0.0
chr2	LINC01102	104505967	104506303	0	337	0	7010	0	6673	0.0	0.0
chr2	LINC01102	104505945	104506303	0	359	0	7010	0	6651	0.0	0.0
chr2	LINC01102	104505939	104506186	0	248	0	7010	0	6762	0.0	0.0
chr2	LINC01102	104505967	104506186	0	220	0	7010	0	6790	0.0	0.0
chr2	LINC01102	104505945	104506186	0	242	0	7010	0	6768	0.0	0.0
chr2	LINC01102	104505939	104505966	0	28	0	7010	0	6982	0.0	0.0
chr2	LINC01102	104505945	104505966	0	22	0	7010	0	6988	0.0	0.0
chr2	LINC01102	104505939	104505944	0	6	0	7010	0	7004	0.0	0.0
chr2	LINC01102	104506701	104506836	0	136	0	7010	0	6874	0.0	0.0
chr2	LINC01102	104518097	104518401	0	305	0	7010	0	6705	0.0	0.0
chr2	GCC2	108449281	108449289	0	9	5949	10494	5949	10485	0.0	0.567381974248927
chr2	CCDC138	108786805	108786915	0	111	0	5316	0	5205	0.0	0.0
chr2	AC013268.1	109936944	109938072	0	1129	260	3474	260	2345	0.0	0.11087420042643924
chr2	BCL2L11	111123870	111124139	0	270	24	6670	24	6400	0.0	0.00375
chr2	MERTK	111929305	111929540	51	236	10793	4566	10742	4330	0.21610169491525424	2.4808314087759817
chr2	POLR1B	112564405	112564499	51	95	36163	8624	36112	8529	0.5368421052631579	4.234025090866456
chr2	POLR1B	112542089	112542166	0	78	36163	8624	36163	8546	0.0	4.231570325298385
chr2	CHCHD5	112584487	112584649	204	163	4951	1263	4747	1100	1.2515337423312884	4.315454545454545
chr2	PAX8-AS1	113250907	113250922	0	16	54157	13369	54157	13353	0.0	4.055792705759005
chr2	PAX8-AS1	113236614	113236622	0	9	54157	13369	54157	13360	0.0	4.053667664670659
chr2	PAX8-AS1	113255550	113259584	44301	4035	54157	13369	9856	9334	10.97918215613383	1.0559245768159418
chr2	WASH2P	113596579	113596582	0	4	0	2827	0	2823	0.0	0.0
chr2	RABL2A	113641451	113641480	0	30	153	4010	153	3980	0.0	0.038442211055276385
chr2	INSIG2	118096427	118096800	0	374	102	3957	102	3583	0.0	0.028467764443204018
chr2	DBI	119367061	119367090	0	30	0	2515	0	2485	0.0	0.0
chr2	DBI	119367464	119367528	0	65	0	2515	0	2450	0.0	0.0
chr2	DBI	119367091	119367214	0	124	0	2515	0	2391	0.0	0.0
chr2	DBI	119367091	119367463	0	373	0	2515	0	2142	0.0	0.0
chr2	TMEM177	119679226	119679617	0	392	102	2591	102	2199	0.0	0.04638472032742155
chr2	TMEM177	119679277	119679617	0	341	102	2591	102	2250	0.0	0.04533333333333334
chr2	TMEM177	119679226	119679276	0	51	102	2591	102	2540	0.0	0.04015748031496063
chr2	PTPN4	119915243	119916690	0	1448	85337	13306	85337	11858	0.0	7.196576151121605
chr2	NIFK-AS1	121649737	121650381	0	645	0	4745	0	4100	0.0	0.0
chr2	NIFK-AS1	121649912	121650381	0	470	0	4745	0	4275	0.0	0.0
chr2	NIFK-AS1	121649737	121649911	0	175	0	4745	0	4570	0.0	0.0
chr2	TSN	121755846	121755953	0	108	0	4403	0	4295	0.0	0.0
chr2	TSN	121757334	121757434	0	101	0	4403	0	4302	0.0	0.0
chr2	LINC01823	121790456	121790519	0	64	0	3336	0	3272	0.0	0.0
chr2	LINC01823	121790504	121790519	0	16	0	3336	0	3320	0.0	0.0
chr2	LINC01823	121790456	121790503	0	48	0	3336	0	3288	0.0	0.0
chr2	LINC01823	121791454	121791503	0	50	0	3336	0	3286	0.0	0.0
chr2	TEX51	126899088	126899117	0	30	0	1165	0	1135	0.0	0.0
chr2	TEX51	126899064	126899117	0	54	0	1165	0	1111	0.0	0.0
chr2	TEX51	126901279	126901282	0	4	0	1165	0	1161	0.0	0.0
chr2	TEX51	126899064	126899087	0	24	0	1165	0	1141	0.0	0.0
chr2	MAP3K2-DT	127388312	127388384	0	73	0	3181	0	3108	0.0	0.0
chr2	AC010976.1	127455771	127455889	0	119	0	5506	0	5387	0.0	0.0
chr2	MYO7B	127620155	127620252	0	98	53	8008	53	7910	0.0	0.006700379266750948
chr2	UGGT1	128091383	128091415	0	33	11231	11392	11231	11359	0.0	0.9887314024121842
chr2	UGGT1	128091383	128091596	0	214	11231	11392	11231	11178	0.0	1.0047414564322776
chr2	UGGT1	128091416	128091596	0	181	11231	11392	11231	11211	0.0	1.0017839621800018
chr2	MZT2B	130181798	130181830	0	33	0	1525	0	1492	0.0	0.0
chr2	MZT2B	130182447	130182452	0	6	0	1525	0	1519	0.0	0.0
chr2	IMP4	130342936	130342962	0	27	0	3208	0	3181	0.0	0.0
chr2	IMP4	130346250	130346274	0	25	0	3208	0	3183	0.0	0.0
chr2	IMP4	130344713	130344725	0	13	0	3208	0	3195	0.0	0.0
chr2	AMER3	130755675	130755805	0	131	1988	6441	1988	6310	0.0	0.3150554675118859
chr2	PLEKHB2	131132992	131133015	10	24	206281	6740	206271	6716	0.4166666666666667	30.713371054198927
chr2	POTEE	131223711	131223740	0	30	102	4207	102	4177	0.0	0.02441943978932248
chr2	LINC01120	131405361	131405447	0	87	0	4214	0	4127	0.0	0.0
chr2	CCDC74A	131528221	131528346	0	126	51	3085	51	2959	0.0	0.01723555255153768
chr2	C2ORF27A	131682558	131682599	0	42	51	7103	51	7061	0.0	0.007222772978331681
chr2	NCKAP5-AS2	133266297	133266436	0	140	0	1764	0	1624	0.0	0.0
chr2	CCNT2	134946147	134946465	0	319	561	8883	561	8564	0.0	0.06550677253619804
chr2	CCNT2	134953269	134954379	0	1111	561	8883	561	7772	0.0	0.07218219248584663
chr2	CCNT2	134945976	134945982	0	7	561	8883	561	8876	0.0	0.06320414601171699
chr2	R3HDM1	135641605	135641790	0	186	2745	7930	2745	7744	0.0	0.35446797520661155
chr2	DARS-AS1	135993878	135993985	0	108	3985	5976	3985	5868	0.0	0.679107021131561
chr2	LINC02631	138602442	138602484	0	43	0	2371	0	2328	0.0	0.0
chr2	TEX41	145172089	145172131	29	43	7612	26381	7583	26338	0.6744186046511628	0.2879110031133723
chr2	TEX41	145113338	145113443	0	106	7612	26381	7612	26275	0.0	0.2897050428163654
chr2	TEX41	145174993	145174996	0	4	7612	26381	7612	26377	0.0	0.288584751867157
chr2	TEX41	145116511	145116821	0	311	7612	26381	7612	26070	0.0	0.2919831223628692
chr2	LINC01911	146838047	146838205	0	159	0	3576	0	3417	0.0	0.0
chr2	MBD5	148489501	148490594	102	1094	102	23435	0	22341	0.09323583180987204	0.0
chr2	MBD5	148483437	148484135	0	699	102	23435	102	22736	0.0	0.004486277269528501
chr2	MBD5	148490595	148490787	0	193	102	23435	102	23242	0.0	0.00438860683245848
chr2	MBD5	148489501	148490787	102	1287	102	23435	0	22148	0.07925407925407925	0.0
chr2	KIF5C	148978551	148978741	0	191	2422	31919	2422	31728	0.0	0.0763363590519415
chr2	MMADHC-DT	149587851	149587873	0	23	0	7157	0	7134	0.0	0.0
chr2	MMADHC-DT	149587874	149588470	0	597	0	7157	0	6560	0.0	0.0
chr2	LINC02612	150629122	150629582	0	461	0	3285	0	2824	0.0	0.0
chr2	RIF1	151409940	151410033	0	94	0	13734	0	13640	0.0	0.0
chr2	RIF1	151410034	151410527	0	494	0	13734	0	13240	0.0	0.0
chr2	GALNT13	153872177	153872303	0	127	51	6628	51	6501	0.0	0.007844946931241348
chr2	MARCHF7	159712607	159712661	0	55	51	6301	51	6246	0.0	0.008165225744476465
chr2	TANK	161160485	161160486	0	2	4044	5607	4044	5605	0.0	0.7214986619090098
chr2	TANK	161232810	161232897	0	88	4044	5607	4044	5519	0.0	0.732741438666425
chr2	PSMD14	161308605	161308786	0	182	153	7323	153	7141	0.0	0.021425570648368576
chr2	GCA	162319226	162319239	0	14	125988	5335	125988	5321	0.0	23.677504228528473
chr2	AC019197.1	164959330	164959360	0	31	51	10285	51	10254	0.0	0.00497366881217086
chr2	SCN2A	165296091	165296302	0	212	0	23956	0	23744	0.0	0.0
chr2	SCN2A	165326985	165328538	0	1554	0	23956	0	22402	0.0	0.0
chr2	SCN2A	165296091	165296892	0	802	0	23956	0	23154	0.0	0.0
chr2	SCN2A	165296303	165296892	0	590	0	23956	0	23366	0.0	0.0
chr2	SCN1A-AS1	166015730	166016650	0	921	0	18935	0	18014	0.0	0.0
chr2	SCN1A-AS1	166248277	166249384	0	1108	0	18935	0	17827	0.0	0.0
chr2	PPIG	169636163	169636228	0	66	23817	10326	23817	10260	0.0	2.321345029239766
chr2	PPIG	169584491	169584497	0	7	23817	10326	23817	10319	0.0	2.3080724876441514
chr2	PHOSPHO2	169694623	169694741	2	119	422	1494	420	1375	0.01680672268907563	0.3054545454545455
chr2	UBR3	170007191	170007202	0	12	0	9972	0	9960	0.0	0.0
chr2	AC007405.3	170770535	170770679	2448	145	4593	2602	2145	2457	16.882758620689657	0.873015873015873
chr2	AC007405.3	170771188	170771427	765	240	4593	2602	3828	2362	3.1875	1.6206604572396275
chr2	GAD1	170817049	170817052	0	4	613	7161	613	7157	0.0	0.08565041218387592
chr2	GORASP2	170948381	170948430	0	50	543	4718	543	4668	0.0	0.11632390745501285
chr2	DCAF17	171434271	171434703	0	433	380	7673	380	7240	0.0	0.052486187845303865
chr2	SCRN3	174395818	174396293	88	476	224	4074	136	3598	0.18487394957983194	0.03779877709838799
chr2	SCRN3	174395990	174396293	51	304	224	4074	173	3770	0.16776315789473684	0.04588859416445623
chr2	SCRN3	174396232	174396293	0	62	224	4074	224	4012	0.0	0.05583250249252243
chr2	SCRN3	174395818	174395989	37	172	224	4074	187	3902	0.21511627906976744	0.047924141465914914
chr2	SCRN3	174395818	174396231	88	414	224	4074	136	3660	0.21256038647342995	0.03715846994535519
chr2	SCRN3	174395990	174396231	51	242	224	4074	173	3832	0.21074380165289255	0.04514613778705637
chr2	AC010894.1	174487530	174487827	0	298	0	802	0	504	0.0	0.0
chr2	AC010894.1	174487659	174487827	0	169	0	802	0	633	0.0	0.0
chr2	AC010894.1	174487530	174487658	0	129	0	802	0	673	0.0	0.0
chr2	HOXD12	176100376	176100403	0	28	0	2579	0	2551	0.0	0.0
chr2	LINC01117	176638008	176638008	0	1	4169	1745	4169	1744	0.0	2.3904816513761467
chr2	HNRNPA3	177212806	177212871	0	66	132	6245	132	6179	0.0	0.021362680045314775
chr2	HNRNPA3	177219157	177219159	0	3	132	6245	132	6242	0.0	0.021147068247356616
chr2	HNRNPA3	177219315	177221976	0	2662	132	6245	132	3583	0.0	0.036840636338264024
chr2	CHROMR	178426506	178426661	0	156	11271	7002	11271	6846	0.0	1.6463628396143735
chr2	CHROMR	178426662	178426680	0	19	11271	7002	11271	6983	0.0	1.6140627237576972
chr2	CHROMR	178426506	178426680	0	175	11271	7002	11271	6827	0.0	1.6509447780870075
chr2	CHROMR	178426662	178426703	0	42	11271	7002	11271	6960	0.0	1.619396551724138
chr2	CHROMR	178426506	178426703	0	198	11271	7002	11271	6804	0.0	1.65652557319224
chr2	CHROMR	178426681	178426703	0	23	11271	7002	11271	6979	0.0	1.614987820604671
chr2	PJVK	178460421	178460446	0	26	0	3976	0	3950	0.0	0.0
chr2	PJVK	178451770	178451870	0	101	0	3976	0	3875	0.0	0.0
chr2	TTN-AS1	178583649	178583921	0	273	51	21966	51	21693	0.0	0.002350988798229844
chr2	TTN-AS1	178774516	178778755	0	4240	51	21966	51	17726	0.0	0.0028771296400767234
chr2	TTN-AS1	178761015	178761026	0	12	51	21966	51	21954	0.0	0.002323039081716316
chr2	TTN-AS1	178528814	178529336	0	523	51	21966	51	21443	0.0	0.0023783985449797136
chr2	TTN-AS1	178537448	178537530	0	83	51	21966	51	21883	0.0	0.002330576246401316
chr2	TTN-AS1	178539891	178539978	0	88	51	21966	51	21878	0.0	0.0023311088764969377
chr2	UBE2E3	180980460	180980546	0	87	0	2985	0	2898	0.0	0.0
chr2	UBE2E3	180981386	180981477	0	92	0	2985	0	2893	0.0	0.0
chr2	LINC01934	181226536	181226539	0	4	0	15079	0	15075	0.0	0.0
chr2	ITPRID2	181920651	181920662	0	12	1498	7648	1498	7636	0.0	0.1961760083813515
chr2	ITPRID2	181928200	181928278	0	79	1498	7648	1498	7569	0.0	0.19791253798388161
chr2	ITPRID2	181916428	181917005	0	578	1498	7648	1498	7070	0.0	0.21188118811881188
chr2	PPP1R1C	182117302	182117468	0	167	51	4899	51	4732	0.0	0.010777683854606932
chr2	ZC3H15	186502553	186502587	0	35	0	3040	0	3005	0.0	0.0
chr2	GULP1	188292167	188292219	0	53	153	5838	153	5785	0.0	0.02644770959377701
chr2	ASNSD1	189666154	189667596	0	1443	0	2491	0	1048	0.0	0.0
chr2	OSGEPL1-AS1	189762933	189762992	0	60	0	728	0	668	0.0	0.0
chr2	PMS1	189863975	189864228	59251	254	127486	4376	68235	4122	233.27165354330708	16.553857350800584
chr2	PMS1	189784565	189784770	0	206	127486	4376	127486	4170	0.0	30.572182254196644
chr2	PMS1	189784594	189784770	0	177	127486	4376	127486	4199	0.0	30.361038342462493
chr2	PMS1	189857406	189857504	816	99	127486	4376	126670	4277	8.242424242424242	29.616553659106852
chr2	C2ORF88	190181110	190181409	0	300	765	5627	765	5327	0.0	0.14360803454101745
chr2	C2ORF88	190181129	190181409	0	281	765	5627	765	5346	0.0	0.14309764309764308
chr2	C2ORF88	190181110	190181128	0	19	765	5627	765	5608	0.0	0.13641226818830243
chr2	INPP1	190343962	190344078	256	117	816	3107	560	2990	2.1880341880341883	0.18729096989966554
chr2	INPP1	190344075	190344078	0	4	816	3107	816	3103	0.0	0.2629713180792781
chr2	INPP1	190343962	190344074	256	113	816	3107	560	2994	2.265486725663717	0.18704074816299265
chr2	INPP1	190356618	190356808	0	191	816	3107	816	2916	0.0	0.27983539094650206
chr2	MYO1B	191245612	191245626	0	15	9111	9318	9111	9303	0.0	0.9793614962915189
chr2	NABP1	191684279	191684296	6	18	924	17438	918	17420	0.3333333333333333	0.05269804822043628
chr2	NABP1	191678242	191678705	0	464	924	17438	924	16974	0.0	0.0544361965358784
chr2	NABP1	191678397	191678705	0	309	924	17438	924	17129	0.0	0.05394360441356763
chr2	NABP1	191678242	191678396	0	155	924	17438	924	17283	0.0	0.053462940461725394
chr2	AC098872.1	191792838	191792921	204	84	497	930	293	846	2.4285714285714284	0.3463356973995272
chr2	AC098872.1	191793460	191793559	0	100	497	930	497	830	0.0	0.5987951807228916
chr2	CAVIN2-AS1	192031492	192031603	0	112	1371	4592	1371	4480	0.0	0.3060267857142857
chr2	CAVIN2-AS1	192030681	192030707	0	27	1371	4592	1371	4565	0.0	0.300328587075575
chr2	CCDC150	196719585	196719666	0	82	51	9384	51	9302	0.0	0.005482691894216298
chr2	MOB4	197535606	197535630	0	25	1732	4091	1732	4066	0.0	0.42597147073290703
chr2	SPATS2L	200306161	200306292	0	132	0	10302	0	10170	0.0	0.0
chr2	SPATS2L	200472993	200473052	0	60	0	10302	0	10242	0.0	0.0
chr2	SPATS2L	200306293	200306601	0	309	0	10302	0	9993	0.0	0.0
chr2	SPATS2L	200306161	200306601	0	441	0	10302	0	9861	0.0	0.0
chr2	SPATS2L	200306419	200306601	0	183	0	10302	0	10119	0.0	0.0
chr2	SPATS2L	200306293	200306418	0	126	0	10302	0	10176	0.0	0.0
chr2	AOX3P	200731106	200731175	15	70	716	4333	701	4263	0.21428571428571427	0.16443818906873095
chr2	BZW1	200811728	200811946	425	219	101754	8101	101329	7882	1.9406392694063928	12.855747272265923
chr2	BZW1	200811947	200811990	0	44	101754	8101	101754	8057	0.0	12.629266476355964
chr2	BZW1	200820019	200820120	330	102	101754	8101	101424	7999	3.235294117647059	12.679584948118515
chr2	NIF3L1	200889392	200889652	0	261	112	2001	112	1740	0.0	0.06436781609195402
chr2	CASP8	201233555	201233622	0	68	10393	7205	10393	7137	0.0	1.4562140955583578
chr2	CASP8	201258155	201258382	0	228	10393	7205	10393	6977	0.0	1.4896087143471406
chr2	CDK15	201806548	201806787	0	240	20099	6191	20099	5951	0.0	3.3774155604100153
chr2	KIAA2012	202105911	202106015	1769	105	74307	7680	72538	7575	16.847619047619048	9.575973597359736
chr2	CARF	202913103	202913114	0	12	1123	10132	1123	10120	0.0	0.11096837944664031
chr2	CARF	202912325	202913102	0	778	1123	10132	1123	9354	0.0	0.12005559119093435
chr2	NBEAL1	203016428	203016435	0	8	25539	16436	25539	16428	0.0	1.5546018991964938
chr2	CTLA4	203870649	203870933	0	285	76	2145	76	1860	0.0	0.04086021505376344
chr2	PARD3B	204546120	204546171	0	52	162	10729	162	10677	0.0	0.015172801348693454
chr2	NRP2	205766804	205766818	0	15	51	13919	51	13904	0.0	0.0036680092059838895
chr2	NRP2	205682579	205682905	0	327	51	13919	51	13592	0.0	0.003752207180694526
chr2	EEF1B2	206160019	206160059	0	41	0	1648	0	1607	0.0	0.0
chr2	ZDBF2	206275080	206275180	0	101	51	10892	51	10791	0.0	0.004726160689463442
chr2	FASTKD2	206765519	206765654	0	136	0	7236	0	7100	0.0	0.0
chr2	FASTKD2	206765655	206765762	0	108	0	7236	0	7128	0.0	0.0
chr2	FASTKD2	206765748	206765762	0	15	0	7236	0	7221	0.0	0.0
chr2	FASTKD2	206765655	206765747	0	93	0	7236	0	7143	0.0	0.0
chr2	CREB1	207530019	207530134	0	116	0	10644	0	10528	0.0	0.0
chr2	IDH1-AS1	208255432	208255622	0	191	0	657	0	466	0.0	0.0
chr2	MAP2	209579439	209579755	0	317	108	11629	108	11312	0.0	0.009547383309759547
chr2	UNC80	209826039	209826053	0	15	357	17565	357	17550	0.0	0.020341880341880343
chr2	UNC80	209839431	209839436	0	6	357	17565	357	17559	0.0	0.020331453955236632
chr2	RPE	210002773	210002783	11	11	119	3448	108	3437	1.0	0.03142275240034914
chr2	RPE	210003458	210003468	0	11	119	3448	119	3437	0.0	0.034623217922606926
chr2	CPS1	210519671	210519784	0	114	5653	11064	5653	10950	0.0	0.516255707762557
chr2	LINC01878	212817008	212817250	0	243	0	3201	0	2958	0.0	0.0
chr2	SPAG16	213296111	213296128	0	18	2126	8280	2126	8262	0.0	0.25732268215928344
chr2	AC072062.1	215029380	215029384	0	5	29	3513	29	3508	0.0	0.008266818700114024
chr2	ATIC	215312162	215312390	0	229	0	3806	0	3577	0.0	0.0
chr2	ATIC	215312344	215312390	0	47	0	3806	0	3759	0.0	0.0
chr2	ATIC	215312162	215312343	0	182	0	3806	0	3624	0.0	0.0
chr2	AC012462.1	215453726	215453833	0	108	0	1648	0	1540	0.0	0.0
chr2	TMEM169	216081974	216081975	0	2	0	3631	0	3629	0.0	0.0
chr2	TMEM169	216081974	216082232	0	259	0	3631	0	3372	0.0	0.0
chr2	TMEM169	216081976	216082232	0	257	0	3631	0	3374	0.0	0.0
chr2	TMEM169	216081980	216082232	0	253	0	3631	0	3378	0.0	0.0
chr2	TMEM169	216081974	216081979	0	6	0	3631	0	3625	0.0	0.0
chr2	TMEM169	216081976	216081979	0	4	0	3631	0	3627	0.0	0.0
chr2	SMARCAL1	216412604	216412648	0	45	0	5114	0	5069	0.0	0.0
chr2	SMARCAL1	216412604	216412734	0	131	0	5114	0	4983	0.0	0.0
chr2	SMARCAL1	216412649	216412734	0	86	0	5114	0	5028	0.0	0.0
chr2	SMARCAL1	216412718	216412734	0	17	0	5114	0	5097	0.0	0.0
chr2	SMARCAL1	216412604	216412717	0	114	0	5114	0	5000	0.0	0.0
chr2	SMARCAL1	216412649	216412717	0	69	0	5114	0	5045	0.0	0.0
chr2	SMARCAL1	216412799	216412936	0	138	0	5114	0	4976	0.0	0.0
chr2	RPL37A	216499152	216499180	0	29	0	5245	0	5216	0.0	0.0
chr2	RUFY4	218073886	218073945	0	60	51	3777	51	3717	0.0	0.013720742534301856
chr2	CXCR2	218125711	218125781	0	71	0	3220	0	3149	0.0	0.0
chr2	ARPC2	218217255	218217544	0	290	0	6079	0	5789	0.0	0.0
chr2	SLC11A1	218383071	218383102	0	32	0	7083	0	7051	0.0	0.0
chr2	CTDSP1	218400898	218400953	0	56	51	4475	51	4419	0.0	0.011541072640868975
chr2	VIL1	218425800	218425811	0	12	0	6912	0	6900	0.0	0.0
chr2	PLCD4	218615960	218616062	0	103	0	5717	0	5614	0.0	0.0
chr2	BCS1L	218661521	218661545	0	25	0	2642	0	2617	0.0	0.0
chr2	BCS1L	218660219	218660245	0	27	0	2642	0	2615	0.0	0.0
chr2	BCS1L	218660167	218660245	0	79	0	2642	0	2563	0.0	0.0
chr2	BCS1L	218660167	218660218	0	52	0	2642	0	2590	0.0	0.0
chr2	BCS1L	218660422	218660482	0	61	0	2642	0	2581	0.0	0.0
chr2	BCS1L	218659744	218659800	0	57	0	2642	0	2585	0.0	0.0
chr2	BCS1L	218660246	218660421	0	176	0	2642	0	2466	0.0	0.0
chr2	BCS1L	218660219	218660421	0	203	0	2642	0	2439	0.0	0.0
chr2	BCS1L	218660167	218660421	0	255	0	2642	0	2387	0.0	0.0
chr2	BCS1L	218659801	218660421	0	621	0	2642	0	2021	0.0	0.0
chr2	TTLL4	218752848	218752973	0	126	0	7190	0	7064	0.0	0.0
chr2	LINC00608	218976923	218977398	51	476	51	2164	0	1688	0.10714285714285714	0.0
chr2	ZFAND2B	219207775	219207779	65	5	12355	2754	12290	2749	13.0	4.470716624226991
chr2	ANKZF1	219230351	219230405	0	55	255	4424	255	4369	0.0	0.058365758754863814
chr2	ANKZF1	219229901	219230350	153	450	255	4424	102	3974	0.34	0.025666834423754403
chr2	ANKZF1	219229901	219229958	153	58	255	4424	102	4366	2.6379310344827585	0.0233623453962437
chr2	ANKZF1	219229901	219229980	153	80	255	4424	102	4344	1.9125	0.023480662983425413
chr2	ANKZF1	219229959	219229980	0	22	255	4424	255	4402	0.0	0.057928214447978195
chr2	STK16	219245523	219245796	0	274	102	4345	102	4071	0.0	0.025055268975681652
chr2	DNAJB2	219279450	219279518	0	69	102	5248	102	5179	0.0	0.01969492179957521
chr2	DNAJB2	219279519	219279687	0	169	102	5248	102	5079	0.0	0.02008269344359126
chr2	SPEG	219444985	219445161	847	177	103040	14929	102193	14752	4.785310734463277	6.92739967462039
chr2	SPEG	219443151	219443440	5234	290	103040	14929	97806	14639	18.048275862068966	6.68119407063324
chr2	GMPPA	219498939	219499254	9030	316	47477	3037	38447	2721	28.575949367088608	14.129731716280778
chr2	GMPPA	219498972	219499254	8358	283	47477	3037	39119	2754	29.53356890459364	14.204429920116194
chr2	GMPPA	219498939	219498971	672	33	47477	3037	46805	3004	20.363636363636363	15.580892143808256
chr2	STK11IP	219601441	219601554	0	114	46048	5318	46048	5204	0.0	8.84857801691007
chr2	STK11IP	219614547	219614871	7875	325	46048	5318	38173	4993	24.23076923076923	7.6453034247947125
chr2	CT75	222320830	222321264	0	435	793	2002	793	1567	0.0	0.5060625398851308
chr2	CT75	222321009	222321264	0	256	793	2002	793	1746	0.0	0.45418098510882016
chr2	MFF	227329660	227329783	0	124	0	4113	0	3989	0.0	0.0
chr2	MFF	227329698	227329783	0	86	0	4113	0	4027	0.0	0.0
chr2	MFF	227325428	227325542	0	115	0	4113	0	3998	0.0	0.0
chr2	MFF	227329660	227329697	0	38	0	4113	0	4075	0.0	0.0
chr2	MFF	227328790	227328899	0	110	0	4113	0	4003	0.0	0.0
chr2	MFF	227325543	227325660	0	118	0	4113	0	3995	0.0	0.0
chr2	AC009950.1	230172194	230172515	0	322	102	5424	102	5102	0.0	0.0199921599372795
chr2	SP140	230245072	230245080	0	9	0	5515	0	5506	0.0	0.0
chr2	SP100	230467207	230467215	0	9	0	14166	0	14157	0.0	0.0
chr2	CAB39	230713803	230714058	0	256	159	5325	159	5069	0.0	0.031367133556914575
chr2	ITM2C	230865387	230865403	0	17	10006	2579	10006	2562	0.0	3.9055425448868073
chr2	SPATA3	230996257	230996534	0	278	0	2820	0	2542	0.0	0.0
chr2	C2ORF72	231037662	231038199	525	538	5181	3782	4656	3244	0.9758364312267658	1.435265104808878
chr2	PSMD1	231062676	231062693	0	18	5976	14058	5976	14040	0.0	0.4256410256410256
chr2	PTMA	231710585	231710676	0	92	153	2703	153	2611	0.0	0.0585982382229031
chr2	CHRND	232528340	232528371	0	32	0	3144	0	3112	0.0	0.0
chr2	GIGYF2	232731235	232731258	0	24	350	15277	350	15253	0.0	0.02294630564479119
chr2	GIGYF2	232768260	232768405	0	146	350	15277	350	15131	0.0	0.023131319807018703
chr2	ATG16L1	233251941	233251942	0	2	402	4235	402	4233	0.0	0.09496810772501772
chr2	MROH2A	233822557	233822571	0	15	271	5773	271	5758	0.0	0.047064953108718305
chr2	MROH2A	233823665	233823682	0	18	271	5773	271	5755	0.0	0.047089487402258906
chr2	TRPM8	233983225	233983351	0	127	0	7914	0	7787	0.0	0.0
chr2	SH3BP4	234978901	234978985	0	85	51	7085	51	7000	0.0	0.007285714285714286
chr2	LRRFIP1	237772183	237772198	0	16	0	13249	0	13233	0.0	0.0
chr2	RBM44	237820287	237820351	0	65	0	6065	0	6000	0.0	0.0
chr2	SCLY	238061144	238061349	0	206	231	5749	231	5543	0.0	0.04167418365506044
chr2	TRAF3IP1	238320786	238320813	0	28	411	4631	411	4603	0.0	0.08928959374321095
chr2	HDAC4-AS1	239401881	239401892	0	12	140	616	140	604	0.0	0.23178807947019867
chr2	HDAC4-AS1	239401881	239401969	0	89	140	616	140	527	0.0	0.2656546489563567
chr2	HDAC4-AS1	239401893	239401969	0	77	140	616	140	539	0.0	0.2597402597402597
chr2	CAPN10	240591001	240591011	0	11	0	6540	0	6529	0.0	0.0
chr2	PPP1R7	241158532	241158549	0	18	0	3700	0	3682	0.0	0.0
chr2	PPP1R7	241149709	241150547	0	839	0	3700	0	2861	0.0	0.0
chr2	SEPTIN2	241316551	241316555	0	5	230	6771	230	6766	0.0	0.03399349689624594
chr2	SEPTIN2	241316541	241316555	0	15	230	6771	230	6756	0.0	0.03404381290704559
chr2	ATG4B	241671406	241671425	0	20	204	6287	204	6267	0.0	0.032551460028721876
chr2	ATG4B	241671426	241671441	0	16	204	6287	204	6271	0.0	0.03253069685855525
chr2	ATG4B	241671406	241671441	0	36	204	6287	204	6251	0.0	0.032634778435450325
chr2	ING5	241711489	241711584	0	96	142	6538	142	6442	0.0	0.022042843837317604
chr2	D2HGDH	241748943	241749929	0	987	0	4764	0	3777	0.0	0.0
chr2	D2HGDH	241749400	241749929	0	530	0	4764	0	4234	0.0	0.0
chr2	D2HGDH	241749009	241749929	0	921	0	4764	0	3843	0.0	0.0
chr2	NEU4	241811455	241811461	0	7	0	2880	0	2873	0.0	0.0
chr2	NEU4	241813514	241813669	0	156	0	2880	0	2724	0.0	0.0
chr2	LINC01237	241881475	241881478	0	4	0	1604	0	1600	0.0	0.0
chr2	LINC01881	242130813	242130866	0	54	41197	1821	41197	1767	0.0	23.314657611771363
chr3	LINC01986	11800	12659	0	860	0	2024	0	1164	0.0	0.0
chr3	CNTN6	1093121	1093129	0	9	0	5532	0	5523	0.0	0.0
chr3	TRNT1	3140579	3140648	0	70	0	5803	0	5733	0.0	0.0
chr3	TRNT1	3146564	3146623	0	60	0	5803	0	5743	0.0	0.0
chr3	TRNT1	3126991	3127289	0	299	0	5803	0	5504	0.0	0.0
chr3	TRNT1	3127290	3128018	0	729	0	5803	0	5074	0.0	0.0
chr3	ITPR1	4675222	4675248	72	27	21536	30866	21464	30839	2.6666666666666665	0.6960018158824864
chr3	ITPR1	4814733	4814763	0	31	21536	30866	21536	30835	0.0	0.6984271120479975
chr3	ARL8B	5170557	5170583	66	27	4094	3554	4028	3527	2.4444444444444446	1.1420470654947548
chr3	AC069277.1	6490943	6490946	0	4	1620	6372	1620	6368	0.0	0.2543969849246231
chr3	THUMPD3	9363333	9363525	0	193	1581	5167	1581	4974	0.0	0.3178528347406514
chr3	THUMPD3	9363128	9363525	0	398	1581	5167	1581	4769	0.0	0.33151604109876287
chr3	THUMPD3	9363128	9363332	0	205	1581	5167	1581	4962	0.0	0.3186215235792019
chr3	THUMPD3	9363526	9363728	0	203	1581	5167	1581	4964	0.0	0.3184931506849315
chr3	THUMPD3	9363333	9363728	0	396	1581	5167	1581	4771	0.0	0.33137706979668835
chr3	THUMPD3	9363128	9363728	0	601	1581	5167	1581	4566	0.0	0.34625492772667543
chr3	SETD5	9424527	9424539	211	13	345674	12159	345463	12146	16.23076923076923	28.442532520994565
chr3	MTMR14	9662286	9662375	0	90	1215	3678	1215	3588	0.0	0.338628762541806
chr3	BRPF1	9742154	9742171	151	18	180397	6082	180246	6064	8.38888888888889	29.723944591029024
chr3	BRPF1	9743254	9743471	714	218	180397	6082	179683	5864	3.2752293577981653	30.641712141882675
chr3	ARPC4	9792706	9793124	74096	419	188349	3616	114253	3197	176.8400954653938	35.73756646856428
chr3	ARPC4	9793125	9793174	0	50	188349	3616	188349	3566	0.0	52.818003365114976
chr3	TTLL3	9827073	9827240	18990	168	362171	7028	343181	6860	113.03571428571429	50.02638483965015
chr3	TTLL3	9827149	9827240	743	92	362171	7028	361428	6936	8.076086956521738	52.108996539792386
chr3	ARPC4	9793125	9793181	0	57	188349	3616	188349	3559	0.0	52.92188817083451
chr3	ARPC4	9793175	9793181	0	7	188349	3616	188349	3609	0.0	52.188694929343306
chr3	TTLL3	9809765	9809922	68	158	362171	7028	362103	6870	0.43037974683544306	52.70786026200874
chr3	TTLL3	9809849	9809922	55	74	362171	7028	362116	6954	0.7432432432432432	52.07305148116192
chr3	TTLL3	9809872	9809922	55	51	362171	7028	362116	6977	1.0784313725490196	51.90139028235632
chr3	TTLL3	9809765	9809848	13	84	362171	7028	362158	6944	0.15476190476190477	52.15408986175115
chr3	TTLL3	9809765	9809871	13	107	362171	7028	362158	6921	0.12149532710280374	52.327409333911284
chr3	TTLL3	9809849	9809871	0	23	362171	7028	362171	7005	0.0	51.70178443968594
chr3	TTLL3	9833246	9833273	0	28	362171	7028	362171	7000	0.0	51.73871428571429
chr3	TTLL3	9827073	9827148	18247	76	362171	7028	343924	6952	240.0921052631579	49.471231300345224
chr3	IL17RC	9918599	9918609	0	11	12687	3519	12687	3508	0.0	3.6165906499429874
chr3	IL17RC	9924021	9924137	0	117	12687	3519	12687	3402	0.0	3.7292768959435625
chr3	IL17RC	9917421	9917633	0	213	12687	3519	12687	3306	0.0	3.8375680580762253
chr3	IL17RC	9918076	9918111	0	36	12687	3519	12687	3483	0.0	3.6425495262704564
chr3	CRELD1	9941017	9941026	120	10	156318	3805	156198	3795	12.0	41.15889328063241
chr3	CRELD1	9943154	9943172	0	19	156318	3805	156318	3786	0.0	41.288431061806655
chr3	CRELD1	9933853	9933920	16	68	156318	3805	156302	3737	0.23529411764705882	41.825528498795826
chr3	CRELD1	9937673	9937710	0	38	156318	3805	156318	3767	0.0	41.49668170958322
chr3	FANCD2	10026474	10026626	396	153	231280	7736	230884	7583	2.588235294117647	30.44758011341158
chr3	TATDN2	10279035	10279063	0	29	23501	5581	23501	5552	0.0	4.232889048991354
chr3	GHRLOS	10288103	10288106	0	4	4567	3170	4567	3166	0.0	1.4425142135186355
chr3	SLC6A1	11017260	11017449	0	190	0	12472	0	12282	0.0	0.0
chr3	SLC6A1	11014185	11014874	0	690	0	12472	0	11782	0.0	0.0
chr3	SLC6A1	11015734	11015790	0	57	0	12472	0	12415	0.0	0.0
chr3	ATG7	11272431	11272709	1592	279	98972	8862	97380	8583	5.706093189964157	11.345683327507864
chr3	TSEN2	12484518	12484880	0	363	54797	4706	54797	4343	0.0	12.617315219894083
chr3	TSEN2	12484629	12484880	0	252	54797	4706	54797	4454	0.0	12.302873821284239
chr3	TSEN2	12484518	12484628	0	111	54797	4706	54797	4595	0.0	11.925353645266593
chr3	MKRN2	12568998	12569003	6	6	78645	8723	78639	8717	1.0	9.021337616152346
chr3	MKRN2	12572110	12572373	15472	264	78645	8723	63173	8459	58.60606060606061	7.46814044213264
chr3	MKRN2	12570253	12570484	7459	232	78645	8723	71186	8491	32.150862068965516	8.383700388646803
chr3	MKRN2	12570485	12570583	121	99	78645	8723	78524	8624	1.2222222222222223	9.105287569573283
chr3	MKRN2	12557526	12557876	214	351	78645	8723	78431	8372	0.6096866096866097	9.368251313903487
chr3	HDAC11	13480350	13480446	51	97	102	5097	51	5000	0.5257731958762887	0.0102
chr3	XPC-AS1	14145457	14145683	0	227	2119	4026	2119	3799	0.0	0.5577783627270334
chr3	XPC-AS1	14145684	14145964	0	281	2119	4026	2119	3745	0.0	0.5658210947930574
chr3	XPC-AS1	14145457	14145964	0	508	2119	4026	2119	3518	0.0	0.6023308698123934
chr3	SH3BP5-AS1	15260583	15260884	0	302	12888	6880	12888	6578	0.0	1.9592581331711767
chr3	SH3BP5-AS1	15257607	15258183	0	577	12888	6880	12888	6303	0.0	2.0447405997144217
chr3	BTD	15601648	15601770	32	123	168001	13089	167969	12966	0.2601626016260163	12.954573499922875
chr3	BTD	15601771	15601894	45	124	168001	13089	167956	12965	0.3629032258064516	12.954569996143464
chr3	BTD	15601895	15602310	6994	416	168001	13089	161007	12673	16.8125	12.704726584076383
chr3	BTD	15601771	15602310	7039	540	168001	13089	160962	12549	13.035185185185185	12.826679416686588
chr3	GALNT15	16195927	16195957	0	31	1859	6414	1859	6383	0.0	0.29124236252545826
chr3	LINC00690	16536433	16536494	0	62	0	3568	0	3506	0.0	0.0
chr3	LINC00690	16536433	16536666	0	234	0	3568	0	3334	0.0	0.0
chr3	LINC00690	16536495	16536666	0	172	0	3568	0	3396	0.0	0.0
chr3	SATB1-AS1	18527247	18527326	0	80	0	12779	0	12699	0.0	0.0
chr3	SATB1-AS1	18530186	18530326	0	141	0	12779	0	12638	0.0	0.0
chr3	RAB5A	19947522	19947863	0	342	52	3774	52	3432	0.0	0.015151515151515152
chr3	SGO1-AS1	20186475	20186658	147	184	2971	6600	2824	6416	0.7989130434782609	0.4401496259351621
chr3	RPL15	23917174	23917239	368	66	7244	6231	6876	6165	5.575757575757576	1.1153284671532846
chr3	RPL15	23917174	23917295	368	122	7244	6231	6876	6109	3.0163934426229506	1.1255524635783272
chr3	RPL15	23917240	23917295	0	56	7244	6231	7244	6175	0.0	1.1731174089068825
chr3	RARB	25428532	25428888	0	357	0	3708	0	3351	0.0	0.0
chr3	LINC01980	27826165	27826211	0	47	0	4756	0	4709	0.0	0.0
chr3	LINC01980	27802219	27802370	0	152	0	4756	0	4604	0.0	0.0
chr3	LINC01980	27841824	27841925	0	102	0	4756	0	4654	0.0	0.0
chr3	CMC1	28241813	28241901	0	89	3644	7283	3644	7194	0.0	0.5065332221295524
chr3	GPD1L	32106759	32106817	0	59	29	4164	29	4105	0.0	0.007064555420219245
chr3	CNOT10	32703898	32703962	0	65	40685	4488	40685	4423	0.0	9.198507800135655
chr3	FBXL2	33378742	33378834	0	93	3152	7427	3152	7334	0.0	0.42977911098991
chr3	LINC01811	34409350	34409361	0	12	0	7983	0	7971	0.0	0.0
chr3	ARPP21	35642409	35642431	0	23	0	9631	0	9608	0.0	0.0
chr3	ARPP21	35679693	35679701	0	9	0	9631	0	9622	0.0	0.0
chr3	ARPP21	35717358	35717361	0	4	0	9631	0	9627	0.0	0.0
chr3	ARPP21	35721835	35721837	0	3	0	9631	0	9628	0.0	0.0
chr3	MLH1	37001049	37001053	0	5	27312	6920	27312	6915	0.0	3.9496746203904554
chr3	MLH1	36993664	36993890	0	227	27312	6920	27312	6693	0.0	4.080681308830121
chr3	MLH1	36994904	36994953	0	50	27312	6920	27312	6870	0.0	3.975545851528384
chr3	MLH1	36993891	36994037	0	147	27312	6920	27312	6773	0.0	4.0324819134799945
chr3	GOLGA4	37289290	37289291	0	2	113066	10768	113066	10766	0.0	10.502136355192272
chr3	MYD88	38140550	38140568	0	19	0	3206	0	3187	0.0	0.0
chr3	MYD88	38140569	38140592	0	24	0	3206	0	3182	0.0	0.0
chr3	MYD88	38140550	38140592	0	43	0	3206	0	3163	0.0	0.0
chr3	OXSR1	38165515	38165946	1340	432	48703	6090	47363	5658	3.1018518518518516	8.370979144574054
chr3	EXOG	38497685	38497778	74	94	28599	4763	28525	4669	0.7872340425531915	6.10944527736132
chr3	EXOG	38497690	38497778	70	89	28599	4763	28529	4674	0.7865168539325843	6.103765511339324
chr3	TTC21A	39118154	39118177	0	24	245711	7452	245711	7428	0.0	33.079025309639206
chr3	TTC21A	39137254	39137387	5978	134	245711	7452	239733	7318	44.61194029850746	32.759360481005736
chr3	TTC21A	39110140	39110233	0	94	245711	7452	245711	7358	0.0	33.39372111986953
chr3	SLC25A38	39390460	39390507	0	48	0	2674	0	2626	0.0	0.0
chr3	RPSA	39406765	39406834	0	70	407	3419	407	3349	0.0	0.12152881457151389
chr3	RPSA	39408725	39408739	36	15	407	3419	371	3404	2.4	0.10898942420681551
chr3	RPSA	39406765	39407082	0	318	407	3419	407	3101	0.0	0.1312479845211222
chr3	RPSA	39406835	39407082	0	248	407	3419	407	3171	0.0	0.1283506780195522
chr3	MOBP	39502877	39502914	0	38	0	9245	0	9207	0.0	0.0
chr3	ENTPD3	40387262	40387391	0	130	5	3600	5	3470	0.0	0.001440922190201729
chr3	RPL14	40457364	40457474	0	111	153	8631	153	8520	0.0	0.01795774647887324
chr3	RPL14	40457475	40457747	0	273	153	8631	153	8358	0.0	0.01830581478822685
chr3	ZNF620	40506126	40506138	468	13	29332	3791	28864	3778	36.0	7.6400211752249865
chr3	ZNF621	40525039	40525274	204	236	52753	8951	52549	8715	0.864406779661017	6.029718875502008
chr3	CTNNB1	41199623	41199670	0	48	556	9254	556	9206	0.0	0.06039539430805996
chr3	CTNNB1	41224754	41224759	0	6	556	9254	556	9248	0.0	0.060121107266435984
chr3	CTNNB1	41199671	41199742	0	72	556	9254	556	9182	0.0	0.06055325637116097
chr3	CTNNB1	41199623	41199742	0	120	556	9254	556	9134	0.0	0.0608714692358222
chr3	CTNNB1	41199743	41199807	0	65	556	9254	556	9189	0.0	0.060507128087931225
chr3	VIPR1	42530913	42530932	0	20	51	7402	51	7382	0.0	0.006908696830127336
chr3	CCDC13-AS1	42743067	42743272	0	206	0	2374	0	2168	0.0	0.0
chr3	ZNF662	42906169	42906441	561	273	1275	5905	714	5632	2.0549450549450547	0.12677556818181818
chr3	GASK1A	42979365	42979645	0	281	0	4402	0	4121	0.0	0.0
chr3	ZKSCAN7	44555482	44555518	0	37	0	4213	0	4176	0.0	0.0
chr3	ZNF35	44648812	44648834	0	23	279	2653	279	2630	0.0	0.10608365019011406
chr3	ZNF502	44712741	44712744	0	4	9110	3260	9110	3256	0.0	2.7979115479115477
chr3	ZNF501	44729723	44730015	0	293	51	3914	51	3621	0.0	0.014084507042253521
chr3	EXOSC7	44975477	44975507	314	31	70541	3310	70227	3279	10.129032258064516	21.417200365965233
chr3	SACM1L	45689498	45690387	1420	890	79362	7303	77942	6413	1.595505617977528	12.153750194916576
chr3	SACM1L	45689546	45690387	1353	842	79362	7303	78009	6461	1.6068883610451306	12.073827580869834
chr3	SACM1L	45689498	45689545	67	48	79362	7303	79295	7255	1.3958333333333333	10.929703652653343
chr3	CCR3	46264447	46264455	0	9	0	2535	0	2526	0.0	0.0
chr3	CCRL2	46407642	46407694	0	53	0	2751	0	2698	0.0	0.0
chr3	PTH1R	46882267	46882464	0	198	0	2734	0	2536	0.0	0.0
chr3	ZNF589	48268161	48270969	102	2809	116	5529	14	2720	0.03631185475258099	0.005147058823529412
chr3	ATRIP	48446800	48447092	0	293	67106	5446	67106	5153	0.0	13.022705220260043
chr3	ARIH2	48924840	48924971	240	132	100980	7097	100740	6965	1.8181818181818181	14.463747307968413
chr3	P4HTM	49001563	49001628	0	66	138397	5894	138397	5828	0.0	23.74691146190803
chr3	WDR6	49008197	49008398	5546	202	160033	4997	154487	4795	27.455445544554454	32.21835245046924
chr3	KLHDC8B	49172802	49173145	0	344	1125	2082	1125	1738	0.0	0.6472957422324511
chr3	DAG1	49510456	49510819	51	364	4259	6735	4208	6371	0.1401098901098901	0.6604928582640088
chr3	DAG1	49470275	49470433	0	159	4259	6735	4259	6576	0.0	0.6476581508515815
chr3	DAG1	49476901	49476905	0	5	4259	6735	4259	6730	0.0	0.6328380386329866
chr3	DAG1	49470275	49470573	0	299	4259	6735	4259	6436	0.0	0.6617464263517713
chr3	DAG1	49470434	49470573	0	140	4259	6735	4259	6595	0.0	0.6457922668688401
chr3	RNF123	49705183	49705186	0	4	600657	6716	600657	6712	0.0	89.4900178784267
chr3	RNF123	49712657	49712892	64662	236	600657	6716	535995	6480	273.99152542372883	82.71527777777777
chr3	RNF123	49689607	49689822	306	216	600657	6716	600351	6500	1.4166666666666667	92.36169230769231
chr3	RBM5	50093784	50093875	0	92	69973	8339	69973	8247	0.0	8.484661088880806
chr3	RBM5	50089030	50089057	0	28	69973	8339	69973	8311	0.0	8.419323787751173
chr3	SEMA3F	50155565	50155843	24943	279	34547	4840	9604	4561	89.40143369175627	2.1056785792589343
chr3	U73166.1	50261317	50262535	0	1219	51	1848	51	629	0.0	0.08108108108108109
chr3	SEMA3B	50271178	50271181	0	4	47685	5099	47685	5095	0.0	9.359175662414131
chr3	SEMA3B	50273315	50273443	344	129	47685	5099	47341	4970	2.6666666666666665	9.525352112676057
chr3	CYB561D2	50350985	50350988	0	4	26695	1930	26695	1926	0.0	13.860332294911734
chr3	Z84492.1	50365839	50365940	0	102	154949	1207	154949	1105	0.0	140.22533936651584
chr3	Z84492.1	50365858	50365940	0	83	154949	1207	154949	1124	0.0	137.85498220640568
chr3	Z84492.1	50365839	50365857	0	19	154949	1207	154949	1188	0.0	130.42845117845118
chr3	HEMK1	50571295	50571332	0	38	10790	17946	10790	17908	0.0	0.6025240116149208
chr3	HEMK1	50569546	50569574	0	29	10790	17946	10790	17917	0.0	0.6022213540213205
chr3	HEMK1	50569575	50569811	0	237	10790	17946	10790	17709	0.0	0.6092947089050765
chr3	MAPKAPK3	50617227	50617241	377	15	18720	3892	18343	3877	25.133333333333333	4.731235491359298
chr3	TEX264	51671289	51672301	30404	1013	62004	2470	31600	1457	30.013820335636723	21.68840082361016
chr3	TEX264	51671548	51672301	12865	754	62004	2470	49139	1716	17.06233421750663	28.635780885780886
chr3	TEX264	51671332	51672301	25421	970	62004	2470	36583	1500	26.207216494845362	24.388666666666666
chr3	TEX264	51672084	51672301	12813	218	62004	2470	49191	2252	58.77522935779817	21.843250444049733
chr3	TEX264	51671289	51671547	17539	259	62004	2470	44465	2211	67.71814671814671	20.110809588421528
chr3	TEX264	51671332	51671547	12556	216	62004	2470	49448	2254	58.129629629629626	21.937888198757765
chr3	AC097636.1	51827315	51827347	0	33	0	3372	0	3339	0.0	0.0
chr3	ABHD14A-ACY1	51987062	51987453	784	392	7419	4173	6635	3781	2.0	1.7548267654059773
chr3	ABHD14A-ACY1	51987625	51988603	3445	979	7419	4173	3974	3194	3.5188968335035753	1.2442078897933626
chr3	ABHD14A-ACY1	51986662	51987196	51	535	7419	4173	7368	3638	0.09532710280373832	2.0252886201209455
chr3	GLYCTK	52293175	52293192	0	18	1199245	4647	1199245	4629	0.0	259.07215381291854
chr3	PHF7	52422837	52422881	175	45	4031	2348	3856	2303	3.888888888888889	1.6743378202344767
chr3	NISCH	52481038	52481109	0	72	82289	8309	82289	8237	0.0	9.9901663226903
chr3	SMIM4	52536774	52536906	0	133	274	2486	274	2353	0.0	0.11644708882277943
chr3	GNL3	52686106	52686202	0	97	83	3110	83	3013	0.0	0.027547295054762694
chr3	GNL3	52688193	52688206	0	14	83	3110	83	3096	0.0	0.026808785529715762
chr3	GNL3	52686203	52686425	51	223	83	3110	32	2887	0.22869955156950672	0.011084170419120194
chr3	ITIH1	52779595	52779877	0	283	5406	4407	5406	4124	0.0	1.3108632395732298
chr3	ITIH1	52779985	52780093	531	109	5406	4407	4875	4298	4.871559633027523	1.1342484876686831
chr3	PRKCD	53168812	53168820	0	9	48947	3643	48947	3634	0.0	13.469179966978537
chr3	LINC02030	55230854	55230857	0	4	0	2315	0	2311	0.0	0.0
chr3	CCDC66	56557235	56557253	0	19	5721	7437	5721	7418	0.0	0.771232138042599
chr3	CCDC66	56566741	56566759	0	19	5721	7437	5721	7418	0.0	0.771232138042599
chr3	SLMAP	57831531	57831536	0	6	104133	15102	104133	15096	0.0	6.898052464228935
chr3	FLNB	58141897	58141929	281	33	587413	14001	587132	13968	8.515151515151516	42.034077892325314
chr3	HTD2	58306418	58306651	971	234	12153	3707	11182	3473	4.14957264957265	3.2196947883674056
chr3	AC126121.3	59050288	59050352	0	65	183	3768	183	3703	0.0	0.049419389684039965
chr3	AC126121.3	59050207	59050352	0	146	183	3768	183	3622	0.0	0.05052457205963556
chr3	AC126121.3	59050207	59050287	0	81	183	3768	183	3687	0.0	0.04963384865744508
chr3	AC126121.3	59119090	59119841	0	752	183	3768	183	3016	0.0	0.0606763925729443
chr3	C3ORF14	62319056	62319232	97436	177	148612	4396	51176	4219	550.4858757062146	12.129888599194121
chr3	SYNPR	63443278	63443469	0	192	0	4059	0	3867	0.0	0.0
chr3	ATXN7	63864689	63864999	102	311	413321	14346	413219	14035	0.3279742765273312	29.442037762736017
chr3	PRICKLE2-DT	64448599	64448696	0	98	0	1807	0	1709	0.0	0.0
chr3	ADAMTS9-AS1	64568918	64569059	0	142	1880	6303	1880	6161	0.0	0.3051452686252232
chr3	ADAMTS9-AS1	64586938	64587251	0	314	1880	6303	1880	5989	0.0	0.3139088328602438
chr3	ADAMTS9-AS2	65008987	65009068	0	82	0	7987	0	7905	0.0	0.0
chr3	LINC02040	65189313	65189366	0	54	0	858	0	804	0.0	0.0
chr3	LINC02040	65191564	65191567	0	4	0	858	0	854	0.0	0.0
chr3	AC109587.1	69014061	69014201	0	141	11575	3711	11575	3570	0.0	3.242296918767507
chr3	AC109587.1	69048305	69048831	612	527	11575	3711	10963	3184	1.1612903225806452	3.443153266331658
chr3	MITF	69937882	69938049	0	168	1697	7172	1697	7004	0.0	0.24229011993146773
chr3	MITF	69939147	69939181	0	35	1697	7172	1697	7137	0.0	0.2377749754798935
chr3	SAMMSON	69999621	69999867	0	247	52998	15618	52998	15371	0.0	3.4479214104482465
chr3	LINC00870	72152919	72152998	0	80	154	8768	154	8688	0.0	0.0177255985267035
chr3	LINC02018	75435300	75435413	0	114	204	6501	204	6387	0.0	0.03193987787693753
chr3	ROBO2	77644896	77644904	0	9	0	13345	0	13336	0.0	0.0
chr3	LINC02025	84885046	84885123	0	78	0	477	0	399	0.0	0.0
chr3	CHMP2B	87245819	87245908	0	90	0	8249	0	8159	0.0	0.0
chr3	EPHA3	89472523	89472619	0	97	73	6594	73	6497	0.0	0.011235955056179775
chr3	LINC00879	94963007	94963096	0	90	102	6020	102	5930	0.0	0.017200674536256323
chr3	ST3GAL6	98763432	98763439	0	8	51	6312	51	6304	0.0	0.00809010152284264
chr3	NIT2	100339936	100339954	0	19	0	9224	0	9205	0.0	0.0
chr3	NIT2	100334799	100335112	0	314	0	9224	0	8910	0.0	0.0
chr3	NIT2	100335098	100335112	0	15	0	9224	0	9209	0.0	0.0
chr3	TFG	100736705	100736716	0	12	51	6506	51	6494	0.0	0.007853403141361256
chr3	TFG	100709432	100709588	0	157	51	6506	51	6349	0.0	0.008032761064734604
chr3	TFG	100709432	100709721	0	290	51	6506	51	6216	0.0	0.008204633204633204
chr3	TFG	100709589	100709721	0	133	51	6506	51	6373	0.0	0.008002510591558137
chr3	TFG	100709722	100709821	51	100	51	6506	0	6406	0.51	0.0
chr3	NXPE3	101779901	101779934	0	34	51	9079	51	9045	0.0	0.005638474295190713
chr3	AC106712.1	101994669	101994897	0	229	51	2160	51	1931	0.0	0.02641118591403418
chr3	AC106712.1	101960463	101960731	0	269	51	2160	51	1891	0.0	0.026969857218402962
chr3	DUBR	107240957	107241087	120	131	3354	13361	3234	13230	0.916030534351145	0.24444444444444444
chr3	DUBR	107246053	107246137	0	85	3354	13361	3354	13276	0.0	0.2526363362458572
chr3	DUBR	107246053	107247088	102	1036	3354	13361	3252	12325	0.09845559845559845	0.2638539553752535
chr3	DUBR	107246138	107247088	102	951	3354	13361	3252	12410	0.10725552050473186	0.2620467365028203
chr3	DUBR	107246210	107247088	102	879	3354	13361	3252	12482	0.11604095563139932	0.26053517064572984
chr3	DUBR	107246053	107246209	0	157	3354	13361	3354	13204	0.0	0.2540139351711603
chr3	DUBR	107246138	107246209	0	72	3354	13361	3354	13289	0.0	0.2523891940702837
chr3	DUBR	107285532	107286177	0	646	3354	13361	3354	12715	0.0	0.2637829335430594
chr3	BBX	107798712	107798720	0	9	167415	11767	167415	11758	0.0	14.238390882803198
chr3	BBX	107525488	107525490	54	3	167415	11767	167361	11764	18.0	14.226538592315539
chr3	BBX	107645910	107646087	0	178	167415	11767	167415	11589	0.0	14.446026404348952
chr3	DZIP3	108634959	108634972	0	14	51	6978	51	6964	0.0	0.0073233773693279726
chr3	C3ORF85	109148362	109148386	0	25	0	2477	0	2452	0.0	0.0
chr3	NECTIN3	111072178	111072510	0	333	0	7708	0	7375	0.0	0.0
chr3	CD96	111545329	111545402	0	74	18765	5571	18765	5497	0.0	3.413680189194106
chr3	AC112487.1	112327695	112327706	0	12	18072	1269	18072	1257	0.0	14.37708830548926
chr3	SLC35A5	112562240	112562273	0	34	0	4736	0	4702	0.0	0.0
chr3	BOC	113216275	113216278	0	4	102	8933	102	8929	0.0	0.011423451674319633
chr3	BOC	113216279	113216420	0	142	102	8933	102	8791	0.0	0.01160277556591969
chr3	BOC	113216275	113216420	0	146	102	8933	102	8787	0.0	0.011608057357459884
chr3	ATP6V1A	113747114	113747127	0	14	51365	5135	51365	5121	0.0	10.030267525873853
chr3	GRAMD1C	113890760	113891024	0	265	0	5906	0	5641	0.0	0.0
chr3	ZDHHC23	113948187	113948190	0	4	153	4793	153	4789	0.0	0.03194821465859261
chr3	QTRT2	114065279	114065457	0	179	408	8066	408	7887	0.0	0.051730696082160514
chr3	QTRT2	114057022	114057106	0	85	408	8066	408	7981	0.0	0.05112141335672222
chr3	ZBTB20-AS1	114366799	114366881	0	83	918	5834	918	5751	0.0	0.1596244131455399
chr3	ZBTB20-AS1	114367029	114367221	0	193	918	5834	918	5641	0.0	0.1627371033504698
chr3	TUSC7	116709877	116710060	0	184	0	2806	0	2622	0.0	0.0
chr3	TUSC7	116709877	116710421	0	545	0	2806	0	2261	0.0	0.0
chr3	TUSC7	116712508	116712857	0	350	0	2806	0	2456	0.0	0.0
chr3	TUSC7	116712600	116712857	0	258	0	2806	0	2548	0.0	0.0
chr3	TUSC7	116712508	116712599	0	92	0	2806	0	2714	0.0	0.0
chr3	POGLUT1	119469007	119469106	0	100	153	4635	153	4535	0.0	0.03373759647188534
chr3	POGLUT1	119486933	119487036	0	104	153	4635	153	4531	0.0	0.033767380269256235
chr3	POGLUT1	119469007	119469258	0	252	153	4635	153	4383	0.0	0.03490759753593429
chr3	POGLUT1	119469107	119469258	0	152	153	4635	153	4483	0.0	0.03412893151907205
chr3	TIMMDC1	119498928	119498942	0	15	0	2722	0	2707	0.0	0.0
chr3	TIMMDC1	119498928	119498933	0	6	0	2722	0	2716	0.0	0.0
chr3	ADPRH	119579852	119580636	51	785	37130	4454	37079	3669	0.06496815286624204	10.106023439629327
chr3	PLA1A	119608900	119608947	0	48	0	2183	0	2135	0.0	0.0
chr3	CFAP91	119703223	119703271	0	49	4853	6291	4853	6242	0.0	0.7774751682153156
chr3	NDUFB4	120596540	120596646	0	107	0	1312	0	1205	0.0	0.0
chr3	CD86	122077917	122078045	0	129	1734	3432	1734	3303	0.0	0.5249772933696639
chr3	PARP14	122720389	122721653	612	1265	612	9853	0	8588	0.48379446640316204	0.0
chr3	SEC22A	123204785	123204813	0	29	1071	4714	1071	4685	0.0	0.22860192102454643
chr3	SEC22A	123202135	123202178	0	44	1071	4714	1071	4670	0.0	0.22933618843683085
chr3	MYLK-AS1	123585795	123585801	0	7	255	4501	255	4494	0.0	0.056742323097463285
chr3	KALRN	124395305	124395343	0	39	62418	24411	62418	24372	0.0	2.5610536681437717
chr3	UMPS	124738240	124738443	11118	204	54657	7521	43539	7317	54.5	5.950389503895039
chr3	FAM86JP	125916720	125916817	0	98	0	2527	0	2429	0.0	0.0
chr3	ALDH1L1-AS2	126180366	126180544	33778	179	47017	2713	13239	2534	188.70391061452514	5.224546172059984
chr3	AC079848.2	126214115	126214861	0	747	0	3126	0	2379	0.0	0.0
chr3	AC079848.2	126214862	126215697	0	836	0	3126	0	2290	0.0	0.0
chr3	AC079848.2	126214115	126215697	0	1583	0	3126	0	1543	0.0	0.0
chr3	AC016924.1	126288124	126289853	0	1730	572	5692	572	3962	0.0	0.14437152953054014
chr3	ABTB1	127674419	127674453	0	35	0	3340	0	3305	0.0	0.0
chr3	KBTBD12	127923548	127924131	0	584	3468	5361	3468	4777	0.0	0.7259786476868327
chr3	KBTBD12	127927835	127928034	0	200	3468	5361	3468	5161	0.0	0.6719627979073823
chr3	GATA2-AS1	128489416	128489670	487	255	6273	2908	5786	2653	1.9098039215686275	2.1809272521673577
chr3	RAB7A	128806450	128806590	5464	141	23000	6281	17536	6140	38.751773049645394	2.856026058631922
chr3	ACAD9	128879842	128880017	10960	176	37713	4320	26753	4144	62.27272727272727	6.455839768339768
chr3	COPG1	129250735	129250894	0	160	1204	4374	1204	4214	0.0	0.2857142857142857
chr3	HMCES	129279044	129279203	114	160	2556	2754	2442	2594	0.7125	0.9414032382420972
chr3	HMCES	129279204	129279211	16	8	2556	2754	2540	2746	2.0	0.9249817916970139
chr3	HMCES	129279044	129279211	130	168	2556	2754	2426	2586	0.7738095238095238	0.9381283836040216
chr3	IFT122	129451973	129451998	0	26	906	9056	906	9030	0.0	0.10033222591362126
chr3	TMCC1-AS1	129893928	129894131	0	204	0	4285	0	4081	0.0	0.0
chr3	TRH	129976016	129976027	0	12	0	1595	0	1583	0.0	0.0
chr3	ALG1L2	130094468	130094513	0	46	0	1509	0	1463	0.0	0.0
chr3	COL6A6	130594344	130594419	0	76	24780	9757	24780	9681	0.0	2.5596529284164857
chr3	ATP2C1	131001315	131001344	0	30	1224	8544	1224	8514	0.0	0.14376321353065538
chr3	NUDT16P1	131362069	131362071	0	3	0	2312	0	2309	0.0	0.0
chr3	AC107027.1	131503003	131503084	0	82	0	1234	0	1152	0.0	0.0
chr3	AC107027.1	131503085	131503094	0	10	0	1234	0	1224	0.0	0.0
chr3	AC107027.1	131503003	131503094	0	92	0	1234	0	1142	0.0	0.0
chr3	AC107027.1	131503085	131503098	0	14	0	1234	0	1220	0.0	0.0
chr3	AC107027.1	131503095	131503098	0	4	0	1234	0	1230	0.0	0.0
chr3	DNAJC13	132484489	132484493	0	5	1188	9689	1188	9684	0.0	0.12267657992565056
chr3	UBA5	132660699	132661048	0	350	239	7275	239	6925	0.0	0.03451263537906137
chr3	CDV3	133574181	133574284	0	104	0	3245	0	3141	0.0	0.0
chr3	CDV3	133574552	133574592	0	41	0	3245	0	3204	0.0	0.0
chr3	CDV3	133574552	133574742	0	191	0	3245	0	3054	0.0	0.0
chr3	CDV3	133574593	133574742	0	150	0	3245	0	3095	0.0	0.0
chr3	CDV3	133574743	133574756	0	14	0	3245	0	3231	0.0	0.0
chr3	TF	133748585	133748669	720	85	4859	22311	4139	22226	8.470588235294118	0.1862233420318546
chr3	CEP63	134532901	134533030	0	130	0	8593	0	8463	0.0	0.0
chr3	CEP63	134537212	134537268	0	57	0	8593	0	8536	0.0	0.0
chr3	CEP63	134486053	134486202	0	150	0	8593	0	8443	0.0	0.0
chr3	CEP63	134486162	134486202	0	41	0	8593	0	8552	0.0	0.0
chr3	CEP63	134486053	134486161	0	109	0	8593	0	8484	0.0	0.0
chr3	CEP63	134559306	134559429	0	124	0	8593	0	8469	0.0	0.0
chr3	EPHB1	134951719	134952052	0	334	0	6987	0	6653	0.0	0.0
chr3	PCCB	136255385	136255533	0	149	969	7380	969	7231	0.0	0.13400636149910108
chr3	PCCB	136255418	136255533	0	116	969	7380	969	7264	0.0	0.13339757709251102
chr3	PCCB	136255385	136255417	0	33	969	7380	969	7347	0.0	0.1318905675786035
chr3	SLC35G2	136819215	136819628	0	414	204	3849	204	3435	0.0	0.059388646288209605
chr3	NCK1	136862320	136862353	0	34	0	5120	0	5086	0.0	0.0
chr3	LINC01210	137772131	137772282	0	152	8426	3221	8426	3069	0.0	2.7455197132616487
chr3	ESYT3	138468882	138468885	0	4	11841	9838	11841	9834	0.0	1.2040878584502746
chr3	FAIM	138622393	138622416	0	24	1468	4080	1468	4056	0.0	0.3619329388560158
chr3	FAIM	138621265	138621282	0	18	1468	4080	1468	4062	0.0	0.36139832594780896
chr3	AC046134.2	139389934	139390247	0	314	0	9175	0	8861	0.0	0.0
chr3	AC046134.2	139390238	139390247	0	10	0	9175	0	9165	0.0	0.0
chr3	AC046134.2	139389934	139390237	0	304	0	9175	0	8871	0.0	0.0
chr3	AC046134.2	139390248	139390429	0	182	0	9175	0	8993	0.0	0.0
chr3	AC046134.2	139390238	139390429	0	192	0	9175	0	8983	0.0	0.0
chr3	AC046134.2	139389934	139390429	0	496	0	9175	0	8679	0.0	0.0
chr3	RASA2	141487183	141487216	0	34	15549	6023	15549	5989	0.0	2.596259809651027
chr3	RNF7	141738510	141738516	0	7	4641	2786	4641	2779	0.0	1.6700251889168767
chr3	AC021074.3	142936334	142936646	0	313	51	5484	51	5171	0.0	0.009862695803519629
chr3	AC021074.3	142936286	142936333	0	48	51	5484	51	5436	0.0	0.009381898454746136
chr3	U2SURP	143021383	143021385	0	3	0	10970	0	10967	0.0	0.0
chr3	DIPK2A	143973256	143973562	0	307	0	5462	0	5155	0.0	0.0
chr3	ZIC1	147508048	147508052	0	5	0	6832	0	6827	0.0	0.0
chr3	AGTR1	148698128	148698149	0	22	132114	3461	132114	3439	0.0	38.41640011631288
chr3	AGTR1	148730238	148730509	178	272	132114	3461	131936	3189	0.6544117647058824	41.37221699592349
chr3	GYG1	148996428	148996476	0	49	0	7100	0	7051	0.0	0.0
chr3	GYG1	148996893	148996904	0	12	0	7100	0	7088	0.0	0.0
chr3	RNF13	149813175	149813353	0	179	1428	3524	1428	3345	0.0	0.42690582959641254
chr3	RNF13	149895561	149895570	0	10	1428	3524	1428	3514	0.0	0.4063745019920319
chr3	RNF13	149814027	149814331	0	305	1428	3524	1428	3219	0.0	0.44361602982292636
chr3	LINC01213	150238999	150239175	0	177	0	1723	0	1546	0.0	0.0
chr3	SELENOT	150618804	150618928	0	125	0	4144	0	4019	0.0	0.0
chr3	SELENOT	150603500	150603686	0	187	0	4144	0	3957	0.0	0.0
chr3	LINC02877	153486106	153486182	0	77	0	1290	0	1213	0.0	0.0
chr3	MME	155080296	155080466	0	171	51	9595	51	9424	0.0	0.0054117147707979625
chr3	MME	155080235	155080466	0	232	51	9595	51	9363	0.0	0.005446972124319128
chr3	MME	155080235	155080295	0	61	51	9595	51	9534	0.0	0.005349276274386407
chr3	LEKR1	156826377	156827109	0	733	51	5318	51	4585	0.0	0.011123227917121047
chr3	LEKR1	156826881	156827109	0	229	51	5318	51	5089	0.0	0.01002161524857536
chr3	LINC02029	157082580	157082918	0	339	0	2326	0	1987	0.0	0.0
chr3	LINC02029	157088012	157088016	0	5	0	2326	0	2321	0.0	0.0
chr3	RSRC1	158110198	158110211	0	14	52024	5081	52024	5067	0.0	10.267219261890665
chr3	RSRC1	158110212	158110223	0	12	52024	5081	52024	5069	0.0	10.263168277766818
chr3	RSRC1	158110198	158110223	0	26	52024	5081	52024	5055	0.0	10.291592482690406
chr3	MLF1	158571348	158571391	0	44	102	3749	102	3705	0.0	0.027530364372469637
chr3	MLF1	158593422	158593426	0	5	102	3749	102	3744	0.0	0.027243589743589744
chr3	GFM1	158644716	158644881	0	166	51	10963	51	10797	0.0	0.004723534315087524
chr3	MFSD1	158802285	158802315	0	31	182	3754	182	3723	0.0	0.04888530754767661
chr3	MFSD1	158802568	158802615	0	48	182	3754	182	3706	0.0	0.04910955207771182
chr3	IQCJ-SCHIP1	159765100	159765138	0	39	406	4426	406	4387	0.0	0.09254615910645088
chr3	IQCJ-SCHIP1	159252800	159252807	0	8	406	4426	406	4418	0.0	0.09189678587596198
chr3	IQCJ-SCHIP1	159764225	159764350	0	126	406	4426	406	4300	0.0	0.0944186046511628
chr3	SMC4	160399698	160399749	0	52	153	7681	153	7629	0.0	0.02005505308690523
chr3	SMC4	160411978	160412084	0	107	153	7681	153	7574	0.0	0.020200686559281752
chr3	SMC4	160399750	160400965	153	1216	153	7681	0	6465	0.12582236842105263	0.0
chr3	NMD3	161225019	161225064	0	46	0	4761	0	4715	0.0	0.0
chr3	NMD3	161221332	161221409	0	78	0	4761	0	4683	0.0	0.0
chr3	NMD3	161221332	161221724	0	393	0	4761	0	4368	0.0	0.0
chr3	NMD3	161221410	161221724	0	315	0	4761	0	4446	0.0	0.0
chr3	NMD3	161221725	161221735	0	11	0	4761	0	4750	0.0	0.0
chr3	LINC01322	165382908	165382959	0	52	0	14499	0	14447	0.0	0.0
chr3	LINC01322	165495267	165495290	0	24	0	14499	0	14475	0.0	0.0
chr3	LINC01322	165474238	165474241	0	4	0	14499	0	14495	0.0	0.0
chr3	SERPINI1	167735813	167735823	0	11	0	2135	0	2124	0.0	0.0
chr3	SERPINI1	167735824	167736135	0	312	0	2135	0	1823	0.0	0.0
chr3	SERPINI1	167735813	167736135	0	323	0	2135	0	1812	0.0	0.0
chr3	LRRC77P	167877724	167877735	0	12	0	5364	0	5352	0.0	0.0
chr3	LRRC77P	167905953	167906055	0	103	0	5364	0	5261	0.0	0.0
chr3	LRRC77P	167917469	167917496	0	28	0	5364	0	5336	0.0	0.0
chr3	LRRC77P	167915156	167915203	0	48	0	5364	0	5316	0.0	0.0
chr3	SAMD7	169915442	169915464	0	23	204	2522	204	2499	0.0	0.08163265306122448
chr3	GPR160	170077417	170077923	18851	507	25001	4391	6150	3884	37.18145956607495	1.5834191555097836
chr3	SKIL	170384628	170384765	0	138	1326	7601	1326	7463	0.0	0.1776765375854214
chr3	SLC7A14-AS1	170467292	170467396	0	105	7140	8751	7140	8646	0.0	0.8258154059680777
chr3	ECT2	172764414	172764500	0	87	0	5475	0	5388	0.0	0.0
chr3	ECT2	172752437	172752472	0	36	0	5475	0	5439	0.0	0.0
chr3	ECT2	172752273	172752472	0	200	0	5475	0	5275	0.0	0.0
chr3	ECT2	172752273	172752436	0	164	0	5475	0	5311	0.0	0.0
chr3	NLGN1	174275501	174275527	0	27	0	10163	0	10136	0.0	0.0
chr3	TBL1XR1-AS1	177044985	177044996	0	12	0	859	0	847	0.0	0.0
chr3	AC007953.1	177935337	177935484	0	148	0	3306	0	3158	0.0	0.0
chr3	AC007620.2	179397942	179397993	0	52	102	1943	102	1891	0.0	0.053939714436805924
chr3	ACTL6A	179562974	179563165	0	192	0	3491	0	3299	0.0	0.0
chr3	ACTL6A	179563118	179563165	0	48	0	3491	0	3443	0.0	0.0
chr3	ACTL6A	179562974	179563117	0	144	0	3491	0	3347	0.0	0.0
chr3	LINC02053	180414397	180414457	0	61	0	2746	0	2685	0.0	0.0
chr3	TTC14	180607766	180608271	0	506	99	5485	99	4979	0.0	0.019883510745129545
chr3	TTC14	180604310	180604338	0	29	99	5485	99	5456	0.0	0.018145161290322582
chr3	FXR1	180915529	180915631	61	103	139	11810	78	11707	0.5922330097087378	0.006662680447595455
chr3	SOX2-OT	180989841	180989852	0	12	51	31226	51	31214	0.0	0.001633882232331646
chr3	SOX2-OT	181175268	181175378	0	111	51	31226	51	31115	0.0	0.0016390808291820665
chr3	SOX2-OT	181778663	181778669	0	7	51	31226	51	31219	0.0	0.0016336205515871745
chr3	LINC01206	182000446	182000506	0	61	0	11383	0	11322	0.0	0.0
chr3	LINC01206	182000470	182000506	0	37	0	11383	0	11346	0.0	0.0
chr3	LINC01206	182001368	182001760	0	393	0	11383	0	10990	0.0	0.0
chr3	LINC01206	182001463	182001760	0	298	0	11383	0	11085	0.0	0.0
chr3	LINC01206	181971720	181971734	0	15	0	11383	0	11368	0.0	0.0
chr3	LINC01206	181984432	181984491	0	60	0	11383	0	11323	0.0	0.0
chr3	LINC01206	181953738	181953756	0	19	0	11383	0	11364	0.0	0.0
chr3	LINC01206	182000507	182000508	0	2	0	11383	0	11381	0.0	0.0
chr3	LINC01206	182000446	182000508	0	63	0	11383	0	11320	0.0	0.0
chr3	LINC01206	182000470	182000508	0	39	0	11383	0	11344	0.0	0.0
chr3	LINC01206	182000446	182000469	0	24	0	11383	0	11359	0.0	0.0
chr3	LINC01206	182001368	182001462	0	95	0	11383	0	11288	0.0	0.0
chr3	LINC01206	181952471	181952923	0	453	0	11383	0	10930	0.0	0.0
chr3	LINC01206	181967553	181967946	0	394	0	11383	0	10989	0.0	0.0
chr3	ATP11B	182880948	182880981	0	34	1149	9220	1149	9186	0.0	0.12508164598301763
chr3	B3GNT5	183253563	183253675	0	113	51	8058	51	7945	0.0	0.006419131529263688
chr3	B3GNT5	183265507	183265523	0	17	51	8058	51	8041	0.0	0.006342494714587738
chr3	LINC00888	183447766	183447947	0	182	8568	1843	8568	1661	0.0	5.158338350391331
chr3	KLHL24	183635783	183635793	0	11	72711	8653	72711	8642	0.0	8.413677389493174
chr3	KLHL24	183635748	183635793	0	46	72711	8653	72711	8607	0.0	8.447891251307075
chr3	KLHL24	183635748	183635782	0	35	72711	8653	72711	8618	0.0	8.437108377813878
chr3	HTR3D	184036506	184036544	0	39	827932	1963	827932	1924	0.0	430.3180873180873
chr3	HTR3E	184104292	184104369	0	78	224	2479	224	2401	0.0	0.09329446064139942
chr3	EIF2B5	184140158	184140221	0	64	255	6302	255	6238	0.0	0.04087848669445335
chr3	EIF2B5	184140616	184140730	0	115	255	6302	255	6187	0.0	0.041215451753677065
chr3	EIF2B5	184142379	184142394	0	16	255	6302	255	6286	0.0	0.0405663378937321
chr3	EIF2B5	184135581	184135916	0	336	255	6302	255	5966	0.0	0.04274220583305397
chr3	EIF2B5	184135749	184135916	0	168	255	6302	255	6134	0.0	0.04157156830779263
chr3	EIF2B5	184140731	184140740	0	10	255	6302	255	6292	0.0	0.0405276541640178
chr3	EIF2B5	184140616	184140740	0	125	255	6302	255	6177	0.0	0.0412821758135017
chr3	EIF2B5	184135581	184135748	0	168	255	6302	255	6134	0.0	0.04157156830779263
chr3	AP2M1	184174960	184175110	0	151	140	4554	140	4403	0.0	0.03179650238473768
chr3	AP2M1	184180651	184180741	0	91	140	4554	140	4463	0.0	0.03136903428187318
chr3	ABCF3	184186637	184186654	0	18	59	4985	59	4967	0.0	0.011878397422991745
chr3	ECE2	184276568	184276705	0	138	357	4745	357	4607	0.0	0.07749077490774908
chr3	PSMD2	184299402	184299633	277	232	459	4392	182	4160	1.1939655172413792	0.04375
chr3	EIF4G1	184317432	184317497	0	66	0	7868	0	7802	0.0	0.0
chr3	EIF4G1	184323219	184323241	0	23	0	7868	0	7845	0.0	0.0
chr3	EIF4G1	184319802	184320297	0	496	0	7868	0	7372	0.0	0.0
chr3	EIF4G1	184320502	184320537	0	36	0	7868	0	7832	0.0	0.0
chr3	EIF4G1	184325952	184325957	0	6	0	7868	0	7862	0.0	0.0
chr3	FAM131A	184337372	184337718	0	347	28	7862	28	7515	0.0	0.0037258815701929474
chr3	FAM131A	184344805	184344913	0	109	28	7862	28	7753	0.0	0.0036115052237843414
chr3	POLR2H	184363566	184363574	0	9	0	3089	0	3080	0.0	0.0
chr3	AC107294.2	184734101	184734240	561	140	778	3702	217	3562	4.007142857142857	0.06092083099382369
chr3	VPS8	184839753	184839758	0	6	1130	9433	1130	9427	0.0	0.11986846292563912
chr3	MAP3K13	185428947	185429056	0	110	79540	12248	79540	12138	0.0	6.552974130828802
chr3	MAP3K13	185283028	185283119	114	92	79540	12248	79426	12156	1.2391304347826086	6.53389272787101
chr3	NMRAL2P	185968650	185968708	0	59	0	2634	0	2575	0.0	0.0
chr3	NMRAL2P	185968650	185968717	0	68	0	2634	0	2566	0.0	0.0
chr3	NMRAL2P	185968709	185968717	0	9	0	2634	0	2625	0.0	0.0
chr3	LINC02020	186441122	186441179	0	58	51	3478	51	3420	0.0	0.014912280701754385
chr3	LINC02020	186440410	186440448	0	39	51	3478	51	3439	0.0	0.014829892410584472
chr3	LINC02020	186445250	186445953	0	704	51	3478	51	2774	0.0	0.018385003604902667
chr3	LINC02020	186445834	186445953	0	120	51	3478	51	3358	0.0	0.015187611673615247
chr3	LINC02020	186441180	186442081	51	902	51	3478	0	2576	0.0565410199556541	0.0
chr3	LINC02020	186441122	186442081	51	960	51	3478	0	2518	0.053125	0.0
chr3	LINC02020	186445250	186445833	0	584	51	3478	51	2894	0.0	0.017622667588113337
chr3	LINC02020	186440410	186440455	0	46	51	3478	51	3432	0.0	0.01486013986013986
chr3	LINC02020	186440449	186440455	0	7	51	3478	51	3471	0.0	0.014693171996542784
chr3	FETUB	186640686	186640689	0	4	204	2000	204	1996	0.0	0.10220440881763528
chr3	TP63	189868705	189868716	0	12	458	7496	458	7484	0.0	0.06119722073757349
chr3	AC073365.1	191559751	191559754	0	4	0	8311	0	8307	0.0	0.0
chr3	AC073365.1	191546112	191546115	0	4	0	8311	0	8307	0.0	0.0
chr3	AC073365.1	191557289	191557384	0	96	0	8311	0	8215	0.0	0.0
chr3	AC073365.1	191559755	191559969	0	215	0	8311	0	8096	0.0	0.0
chr3	AC073365.1	191559751	191559969	0	219	0	8311	0	8092	0.0	0.0
chr3	AC026320.1	192029907	192030039	0	133	0	906	0	773	0.0	0.0
chr3	OPA1	193655028	193655052	0	25	102	9079	102	9054	0.0	0.01126573889993373
chr3	AC024559.2	194078266	194078294	51	29	2577	1312	2526	1283	1.7586206896551724	1.9688230709275136
chr3	AC024559.2	194070276	194070326	0	51	2577	1312	2577	1261	0.0	2.043616177636796
chr3	LINC01968	194708539	194709147	0	609	1495	9041	1495	8432	0.0	0.17730075901328274
chr3	LINC01968	194708596	194709147	0	552	1495	9041	1495	8489	0.0	0.17611026033690658
chr3	LINC01968	194708539	194708595	0	57	1495	9041	1495	8984	0.0	0.16640694568121103
chr3	LINC01968	194769784	194769811	0	28	1495	9041	1495	9013	0.0	0.1658715189171197
chr3	MUC20-OT1	195663768	195663832	114	65	133092	13794	132978	13729	1.7538461538461538	9.685920314662393
chr3	MUC20-OT1	195701433	195701669	1563	237	133092	13794	131529	13557	6.594936708860759	9.701925204691303
chr3	MUC20-OT1	195701496	195701669	631	174	133092	13794	132461	13620	3.6264367816091956	9.725477239353891
chr3	MUC20-OT1	195686619	195686718	6731	100	133092	13794	126361	13694	67.31	9.227471885497298
chr3	MUC20-OT1	195699179	195699207	0	29	133092	13794	133092	13765	0.0	9.66887032328369
chr3	MUC20-OT1	195686348	195686389	587	42	133092	13794	132505	13752	13.976190476190476	9.635325770796975
chr3	MUC20-OT1	195685940	195685947	622	8	133092	13794	132470	13786	77.75	9.609023647178297
chr3	MUC20-OT1	195708269	195708435	2465	167	133092	13794	130627	13627	14.760479041916168	9.585895648345197
chr3	MUC20-OT1	195708388	195708435	1168	48	133092	13794	131924	13746	24.333333333333332	9.597264658809836
chr3	MUC20-OT1	195708329	195708435	1961	107	133092	13794	131131	13687	18.327102803738317	9.580697011762986
chr3	MUC20-OT1	195701433	195701495	932	63	133092	13794	132160	13731	14.793650793650794	9.624936275580803
chr3	MUC20-OT1	195708269	195708387	1297	119	133092	13794	131795	13675	10.899159663865547	9.63765996343693
chr3	MUC20-OT1	195708329	195708387	793	59	133092	13794	132299	13735	13.440677966101696	9.632253367309792
chr3	MUC20-OT1	195708436	195708513	620	78	133092	13794	132472	13716	7.948717948717949	9.658209390492855
chr3	MUC20-OT1	195689439	195689608	1334	170	133092	13794	131758	13624	7.847058823529411	9.671021726365238
chr3	MUC20-OT1	195708269	195708328	504	60	133092	13794	132588	13734	8.4	9.653997378768022
chr3	MUC20-OT1	195708269	195708513	3085	245	133092	13794	130007	13549	12.591836734693878	9.595320687873643
chr3	MUC20-OT1	195708388	195708513	1788	126	133092	13794	131304	13668	14.19047619047619	9.60667251975417
chr3	MUC20-OT1	195708329	195708513	2581	185	133092	13794	130511	13609	13.95135135135135	9.590050701741495
chr3	MUC20-OT1	195708436	195708555	905	120	133092	13794	132187	13674	7.541666666666667	9.667032324118766
chr3	MUC20-OT1	195708514	195708555	285	42	133092	13794	132807	13752	6.785714285714286	9.657286212914485
chr3	LINC00885	196143001	196143270	0	270	102	2164	102	1894	0.0	0.05385427666314678
chr3	LINC00885	196143001	196143409	0	409	102	2164	102	1755	0.0	0.05811965811965812
chr3	LINC00885	196143271	196143409	0	139	102	2164	102	2025	0.0	0.05037037037037037
chr3	AC069257.1	196250663	196250689	0	27	0	431	0	404	0.0	0.0
chr3	FBXO45	196568788	196569302	0	515	1326	5979	1326	5464	0.0	0.24267935578330893
chr3	DLG1-AS1	197298382	197298610	0	229	153	2141	153	1912	0.0	0.08002092050209204
chr3	DLG1-AS1	197299093	197299439	0	347	153	2141	153	1794	0.0	0.08528428093645485
chr3	LRCH3	197835739	197835822	0	84	255	12658	255	12574	0.0	0.02027994273898521
chr3	RPL35A	197950222	197950299	0	78	2297	2565	2297	2487	0.0	0.9236027342179333
chr3	RPL35A	197951312	197951328	0	17	2297	2565	2297	2548	0.0	0.9014913657770801
chr3	LMLN	197960225	197960319	0	95	0	8699	0	8604	0.0	0.0
chr3	LMLN	197960320	197960440	0	121	0	8699	0	8578	0.0	0.0
chr3	LMLN	197960225	197960440	0	216	0	8699	0	8483	0.0	0.0
chr3	IL5RA	3109944	3109998	0	55	72	6583	72	6528	0.0	0.011029411764705883
chr3	LMCD1-AS1	8494666	8494679	6	14	8888	11271	8882	11257	0.42857142857142855	0.7890201652305232
chr3	SSUH2	8626913	8627696	0	784	4953	6307	4953	5523	0.0	0.8967952199891364
chr3	SSUH2	8623448	8623547	0	100	4953	6307	4953	6207	0.0	0.7979700338327694
chr3	OXTR	8769230	8769252	0	23	102	4518	102	4495	0.0	0.022691879866518355
chr3	RAD18	8947219	8947241	0	23	4337	6999	4337	6976	0.0	0.6217029816513762
chr3	THUMPD3-AS1	9393987	9395504	306	1518	7555	6225	7249	4707	0.2015810276679842	1.5400467388995114
chr3	THUMPD3-AS1	9393987	9396558	1122	2572	7555	6225	6433	3653	0.43623639191290825	1.7610183410895155
chr3	THUMPD3-AS1	9390884	9391677	4607	794	7555	6225	2948	5431	5.802267002518891	0.54280979561775
chr3	THUMPD3-AS1	9390884	9391425	1537	542	7555	6225	6018	5683	2.8357933579335795	1.058947738870315
chr3	THUMPD3-AS1	9390884	9391703	4810	820	7555	6225	2745	5405	5.865853658536586	0.5078630897317299
chr3	THUMPD3-AS1	9390884	9391105	0	222	7555	6225	7555	6003	0.0	1.2585373979676828
chr3	THUMPD3-AS1	9390884	9391080	0	197	7555	6225	7555	6028	0.0	1.2533178500331785
chr3	THUMPD3-AS1	9391678	9391703	203	26	7555	6225	7352	6199	7.8076923076923075	1.185997741571221
chr3	THUMPD3-AS1	9390279	9390288	0	10	7555	6225	7555	6215	0.0	1.2156074014481093
chr3	THUMPD3-AS1	9391426	9391677	3070	252	7555	6225	4485	5973	12.182539682539682	0.7508789552988449
chr3	THUMPD3-AS1	9391426	9391703	3273	278	7555	6225	4282	5947	11.773381294964029	0.7200269043215066
chr3	THUMPD3-AS1	9394174	9396558	1122	2385	7555	6225	6433	3840	0.47044025157232705	1.6752604166666667
chr3	THUMPD3-AS1	9394174	9395504	306	1331	7555	6225	7249	4894	0.2299023290758828	1.4812014711892112
chr3	THUMPD3-AS1	9394174	9396546	1122	2373	7555	6225	6433	3852	0.47281921618204803	1.6700415368639667
chr3	THUMPD3-AS1	9391106	9391677	4607	572	7555	6225	2948	5653	8.054195804195805	0.5214930125597028
chr3	THUMPD3-AS1	9391106	9391425	1537	320	7555	6225	6018	5905	4.803125	1.0191363251481795
chr3	THUMPD3-AS1	9391106	9391703	4810	598	7555	6225	2745	5627	8.043478260869565	0.48782655055980095
chr3	THUMPD3-AS1	9396547	9396558	0	12	7555	6225	7555	6213	0.0	1.2159987123772735
chr3	THUMPD3-AS1	9391081	9391677	4607	597	7555	6225	2948	5628	7.716917922948074	0.5238095238095238
chr3	THUMPD3-AS1	9391081	9391425	1537	345	7555	6225	6018	5880	4.455072463768116	1.023469387755102
chr3	THUMPD3-AS1	9391081	9391703	4810	623	7555	6225	2745	5602	7.720706260032102	0.4900035701535166
chr3	THUMPD3-AS1	9391081	9391105	0	25	7555	6225	7555	6200	0.0	1.2185483870967742
chr3	RPUSD3	9838984	9839030	56	47	953267	5249	953211	5202	1.1914893617021276	183.23933102652825
chr3	RPUSD3	9843724	9843888	616	165	953267	5249	952651	5084	3.7333333333333334	187.38217938630999
chr3	CIDEC	9878743	9878777	0	35	18063	1418	18063	1383	0.0	13.060737527114968
chr3	AC022007.1	10010885	10011021	2612	137	410471	4728	407859	4591	19.065693430656935	88.83881507296886
chr3	CIDECP1	10023529	10023558	0	30	230752	3021	230752	2991	0.0	77.14877967235039
chr3	SEC13	10320508	10320869	188184	362	377315	4364	189131	4002	519.8453038674033	47.25912043978011
chr3	SEC13	10320508	10321048	297853	541	377315	4364	79462	3823	550.5600739371534	20.785247188072194
chr3	SEC13	10320610	10321048	226956	439	377315	4364	150359	3925	516.9840546697038	38.308025477707005
chr3	SEC13	10320508	10320609	70897	102	377315	4364	306418	4262	695.0686274509804	71.8953542937588
chr3	ATP2B2	10331910	10331981	534	72	625982	10290	625448	10218	7.416666666666667	61.21041299667254
chr3	LINC00606	10762763	10762830	0	68	0	3183	0	3115	0.0	0.0
chr3	VGLL4	11720393	11720686	0	294	26626	7253	26626	6959	0.0	3.8261244431671217
chr3	VGLL4	11719416	11719577	0	162	26626	7253	26626	7091	0.0	3.7549005781977156
chr3	XPC	14178465	14178482	399	18	47503	4652	47104	4634	22.166666666666668	10.164868364264136
chr3	GRIP2	14555893	14555898	0	6	199676	9751	199676	9745	0.0	20.4900974858902
chr3	FGD5-AS1	14947086	14947112	0	27	0	5148	0	5121	0.0	0.0
chr3	FGD5-AS1	14947086	14947108	0	23	0	5148	0	5125	0.0	0.0
chr3	FGD5-AS1	14947109	14947112	0	4	0	5148	0	5144	0.0	0.0
chr3	MRPS25	15053290	15053378	227	89	4595	4677	4368	4588	2.550561797752809	0.9520488230165649
chr3	RBSN	15099021	15099033	929	13	193240	7927	192311	7914	71.46153846153847	24.30010108668183
chr3	COL6A4P1	15169939	15169946	0	8	62	4580	62	4572	0.0	0.013560804899387576
chr3	EAF1-AS1	15440260	15440433	0	174	15915	4233	15915	4059	0.0	3.9209164818920916
chr3	EAF1-AS1	15439789	15440433	0	645	15915	4233	15915	3588	0.0	4.43561872909699
chr3	EAF1-AS1	15443070	15443401	0	332	15915	4233	15915	3901	0.0	4.0797231479107925
chr3	ANKRD28	15796395	15796403	0	9	140842	11300	140842	11291	0.0	12.473828713134354
chr3	SGO1	20174248	20175003	153	756	10761	3751	10608	2995	0.20238095238095238	3.541903171953255
chr3	SGO1	20183607	20183757	102	151	10761	3751	10659	3600	0.6754966887417219	2.9608333333333334
chr3	SGO1	20185947	20186057	51	111	10761	3751	10710	3640	0.4594594594594595	2.9423076923076925
chr3	UBE2E2-AS1	23202391	23202423	0	33	0	800	0	767	0.0	0.0
chr3	NKIRAS1	23916783	23916859	495	77	13810	2968	13315	2891	6.428571428571429	4.60567277758561
chr3	THRB	24494651	24494685	0	35	300	10954	300	10919	0.0	0.027475043502152213
chr3	THRB	24494651	24494793	0	143	300	10954	300	10811	0.0	0.027749514383498288
chr3	THRB	24494686	24494793	0	108	300	10954	300	10846	0.0	0.02765996680803983
chr3	NGLY1	25720013	25720128	0	116	5733	6316	5733	6200	0.0	0.9246774193548387
chr3	NGLY1	25782892	25783258	2295	367	5733	6316	3438	5949	6.253405994550409	0.5779122541603631
chr3	SLC4A7	27433915	27433953	35	39	83485	9251	83450	9212	0.8974358974358975	9.058836300477639
chr3	SLC4A7	27484066	27484077	0	12	83485	9251	83485	9239	0.0	9.036151098603746
chr3	EOMES	27721413	27722428	0	1016	0	3662	0	2646	0.0	0.0
chr3	RBMS3-AS3	29274281	29274321	0	41	1	5926	1	5885	0.0	0.0001699235344095157
chr3	AC116035.1	30525054	30525210	0	157	0	1107	0	950	0.0	0.0
chr3	CLASP2	33645281	33645342	0	62	29679	15265	29679	15203	0.0	1.9521804906926266
chr3	LRRFIP2	37175817	37176058	561	242	395946	10009	395385	9767	2.3181818181818183	40.48172417323641
chr3	ITGA9-AS1	37851423	37851445	0	23	8307	14074	8307	14051	0.0	0.5912034730624155
chr3	ITGA9-AS1	37818679	37818808	0	130	8307	14074	8307	13944	0.0	0.5957401032702238
chr3	ACAA1	38126161	38126508	0	348	661	6653	661	6305	0.0	0.10483743061062649
chr3	SCN5A	38554278	38554373	0	96	51437	10059	51437	9963	0.0	5.162802368764428
chr3	SCN11A	39051860	39051924	0	65	102	11921	102	11856	0.0	0.00860323886639676
chr3	GORASP1	39100746	39100786	0	41	24431	5965	24431	5924	0.0	4.12407157326131
chr3	GORASP1	39106987	39106991	0	5	24431	5965	24431	5960	0.0	4.0991610738255035
chr3	GORASP1	39102677	39102691	0	15	24431	5965	24431	5950	0.0	4.106050420168067
chr3	GORASP1	39106968	39106986	0	19	24431	5965	24431	5946	0.0	4.1088126471577535
chr3	GORASP1	39106968	39106991	0	24	24431	5965	24431	5941	0.0	4.112270661504797
chr3	EIF1B-AS1	40309322	40309326	5	5	15694	19255	15689	19250	1.0	0.815012987012987
chr3	ULK4	41937228	41937293	0	66	368509	6325	368509	6259	0.0	58.876657613037224
chr3	VIPR1-AS1	42530859	42530919	0	61	51	4487	51	4426	0.0	0.011522819701762313
chr3	VIPR1-AS1	42528548	42528601	0	54	51	4487	51	4433	0.0	0.011504624407850215
chr3	VIPR1-AS1	42519250	42519387	0	138	51	4487	51	4349	0.0	0.01172683375488618
chr3	HHATL	42701111	42701130	445	20	34955	2901	34510	2881	22.25	11.978479694550503
chr3	HHATL	42702578	42702615	277	38	34955	2901	34678	2863	7.2894736842105265	12.112469437652813
chr3	ZDHHC3	44959126	44959129	152	4	12673	12129	12521	12125	38.0	1.032659793814433
chr3	LIMD1-AS1	45688375	45689018	0	644	19475	4394	19475	3750	0.0	5.193333333333333
chr3	LINC02009	46421372	46421420	0	49	0	2956	0	2907	0.0	0.0
chr3	LTF	46448862	46448867	0	6	0	3990	0	3984	0.0	0.0
chr3	ALS2CL	46681499	46681502	0	4	0	7062	0	7058	0.0	0.0
chr3	ALS2CL	46683129	46683132	0	4	0	7062	0	7058	0.0	0.0
chr3	ALS2CL	46693488	46693641	0	154	0	7062	0	6908	0.0	0.0
chr3	PRSS45P	46743966	46743969	0	4	0	1296	0	1292	0.0	0.0
chr3	MYL3	46866389	46866506	0	118	0	2814	0	2696	0.0	0.0
chr3	KIF9	47282139	47282493	637	355	11408	5311	10771	4956	1.7943661971830986	2.173325262308313
chr3	ELP6	47510148	47510182	194	35	10124	3043	9930	3008	5.542857142857143	3.3011968085106385
chr3	ELP6	47512991	47513319	1501	329	10124	3043	8623	2714	4.562310030395137	3.17722918201916
chr3	ELP6	47512991	47513221	952	231	10124	3043	9172	2812	4.121212121212121	3.2617354196301567
chr3	ELP6	47512991	47513189	713	199	10124	3043	9411	2844	3.5829145728643215	3.309071729957806
chr3	ELP6	47513222	47513319	549	98	10124	3043	9575	2945	5.6020408163265305	3.2512733446519526
chr3	ELP6	47513190	47513319	788	130	10124	3043	9336	2913	6.061538461538461	3.204943357363543
chr3	ELP6	47513190	47513221	239	32	10124	3043	9885	3011	7.46875	3.282962470939887
chr3	CSPG5	47569070	47569150	0	81	0	3353	0	3272	0.0	0.0
chr3	CSPG5	47578596	47579888	204	1293	0	3353	-204	2060	0.15777262180974477	-0.09902912621359224
chr3	MAP4	47870812	47870856	0	45	920579	14847	920579	14802	0.0	62.192879340629645
chr3	MAP4	48088772	48088962	422	191	920579	14847	920157	14656	2.2094240837696337	62.78363810043668
chr3	NME6	48301295	48301351	0	57	19432	6219	19432	6162	0.0	3.153521583901331
chr3	NME6	48301278	48301351	0	74	19432	6219	19432	6145	0.0	3.162245728234337
chr3	NME6	48301278	48301294	0	17	19432	6219	19432	6202	0.0	3.1331828442437923
chr3	NME6	48300430	48300525	0	96	19432	6219	19432	6123	0.0	3.173607708639556
chr3	NME6	48301269	48301294	0	26	19432	6219	19432	6193	0.0	3.137736153721944
chr3	NME6	48301269	48301277	0	9	19432	6219	19432	6210	0.0	3.12914653784219
chr3	NME6	48301269	48301351	0	83	19432	6219	19432	6136	0.0	3.166883963494133
chr3	NME6	48300276	48300429	102	154	19432	6219	19330	6065	0.6623376623376623	3.1871393239901074
chr3	NME6	48300276	48300525	102	250	19432	6219	19330	5969	0.408	3.2383983916904002
chr3	PLXNB1	48415175	48415210	0	36	93	9551	93	9515	0.0	0.00977404098791382
chr3	CCDC51	48439987	48440094	0	108	1275	2415	1275	2307	0.0	0.552665799739922
chr3	SHISA5	48501136	48501156	320	21	40429	4383	40109	4362	15.238095238095237	9.195093993580926
chr3	SHISA5	48503720	48504017	664	298	40429	4383	39765	4085	2.228187919463087	9.734394124847002
chr3	SHISA5	48504018	48504421	8128	404	40429	4383	32301	3979	20.11881188118812	8.117868811259111
chr3	SHISA5	48504422	48504628	3191	207	40429	4383	37238	4176	15.415458937198068	8.917145593869732
chr3	PFKFB4	48535511	48535531	0	21	58304	6039	58304	6018	0.0	9.688268527750083
chr3	UQCRC1	48609496	48609550	0	55	5774	3165	5774	3110	0.0	1.8565916398713826
chr3	SLC26A6	48631223	48631251	0	29	15762	4986	15762	4957	0.0	3.1797458140004036
chr3	SLC26A6	48631648	48631761	0	114	15762	4986	15762	4872	0.0	3.2352216748768474
chr3	NCKIPSD	48678553	48678562	0	10	126445	3266	126445	3256	0.0	38.83445945945946
chr3	NCKIPSD	48682868	48682901	1682	34	126445	3266	124763	3232	49.470588235294116	38.602413366336634
chr3	IP6K2	48717057	48717155	29705	99	116050	5121	86345	5022	300.050505050505	17.193349263241736
chr3	IP6K2	48715314	48715387	2959	74	116050	5121	113091	5047	39.986486486486484	22.407568852783832
chr3	IP6K2	48694693	48695088	5269	396	116050	5121	110781	4725	13.305555555555555	23.445714285714285
chr3	IP6K2	48694693	48694700	164	8	116050	5121	115886	5113	20.5	22.664971640915315
chr3	DALRD3	49015803	49015817	90	15	364607	2755	364517	2740	6.0	133.035401459854
chr3	IMPDH2	49028198	49028246	54	49	53854	4064	53800	4015	1.1020408163265305	13.39975093399751
chr3	IMPDH2	49028721	49028756	1154	36	53854	4064	52700	4028	32.05555555555556	13.083416087388281
chr3	QRICH1	49093893	49093910	0	18	61691	3888	61691	3870	0.0	15.940826873385014
chr3	QARS1	49098352	49098371	0	20	1937	3938	1937	3918	0.0	0.4943848902501276
chr3	QARS1	49099329	49099342	0	14	1937	3938	1937	3924	0.0	0.4936289500509684
chr3	QARS1	49099960	49099992	0	33	1937	3938	1937	3905	0.0	0.49603072983354674
chr3	QARS1	49104323	49104371	0	49	1937	3938	1937	3889	0.0	0.4980714836718951
chr3	QARS1	49104323	49104355	0	33	1937	3938	1937	3905	0.0	0.49603072983354674
chr3	QARS1	49104616	49104651	0	36	1937	3938	1937	3902	0.0	0.4964120963608406
chr3	QARS1	49097109	49097132	0	24	1937	3938	1937	3914	0.0	0.4948901379662749
chr3	QARS1	49104356	49104371	0	16	1937	3938	1937	3922	0.0	0.4938806731259561
chr3	QARS1	49103555	49103629	0	75	1937	3938	1937	3863	0.0	0.5014237639140564
chr3	USP19	49117058	49117207	15	150	56009	5602	55994	5452	0.1	10.270359501100513
chr3	USP19	49117436	49117465	0	30	56009	5602	56009	5572	0.0	10.05186647523331
chr3	LAMB2	49125252	49125267	0	16	15419	6595	15419	6579	0.0	2.343669250645995
chr3	C3ORF62	49276426	49276574	0	149	51	3803	51	3654	0.0	0.013957307060755337
chr3	USP4	49302383	49302436	0	54	26610	7226	26610	7172	0.0	3.7102621305075294
chr3	GPX1	49358026	49358163	7154	138	31611	1047	24457	909	51.84057971014493	26.905390539053904
chr3	AMT	49417817	49417931	0	115	2780	4678	2780	4563	0.0	0.6092483015559939
chr3	AMT	49420210	49420213	0	4	2780	4678	2780	4674	0.0	0.5947796320068464
chr3	AC104452.1	49422981	49424225	5996	1245	7803	4975	1807	3730	4.8160642570281125	0.48445040214477214
chr3	AC104452.1	49422981	49423080	0	100	7803	4975	7803	4875	0.0	1.6006153846153846
chr3	AMT	49422360	49422437	0	78	2780	4678	2780	4600	0.0	0.6043478260869565
chr3	AMT	49417488	49417613	0	126	2780	4678	2780	4552	0.0	0.6107205623901582
chr3	AMT	49421959	49421980	0	22	2780	4678	2780	4656	0.0	0.5970790378006873
chr3	MST1	49686946	49686949	0	4	714	4051	714	4047	0.0	0.17642698295033357
chr3	MST1	49688597	49689043	0	447	714	4051	714	3604	0.0	0.19811320754716982
chr3	GMPPB	49721964	49721971	0	8	964203	6681	964203	6673	0.0	144.4931814775963
chr3	GMPPB	49722863	49722970	313	108	964203	6681	963890	6573	2.8981481481481484	146.64384603681728
chr3	IP6K1	49786353	49786478	357	126	10204	2590	9847	2464	2.8333333333333335	3.9963474025974026
chr3	TRAIP	49848136	49848141	6	6	2329	3275	2323	3269	1.0	0.7106148669317834
chr3	CAMKV	49862044	49862084	0	41	157	3414	157	3373	0.0	0.046546101393418325
chr3	CAMKV	49862293	49862330	0	38	157	3414	157	3376	0.0	0.04650473933649289
chr3	CAMKV	49861179	49861186	0	8	157	3414	157	3406	0.0	0.046095126247798004
chr3	MON1A	49929368	49929428	0	61	3378	6358	3378	6297	0.0	0.5364459266317294
chr3	IFRD2	50288408	50288425	0	18	611703	3353	611703	3335	0.0	183.4191904047976
chr3	IFRD2	50289446	50289710	13917	265	611703	3353	597786	3088	52.51698113207547	193.58354922279793
chr3	HYAL2	50321365	50321566	0	202	1148	3005	1148	2803	0.0	0.40956118444523726
chr3	HYAL2	50320881	50321036	0	156	1148	3005	1148	2849	0.0	0.40294840294840295
chr3	HYAL2	50320836	50320880	0	45	1148	3005	1148	2960	0.0	0.3878378378378378
chr3	TUSC2	50326356	50326383	23995	28	777192	2409	753197	2381	856.9642857142857	316.33641327173456
chr3	TUSC2	50327027	50327036	9391	10	777192	2409	767801	2399	939.1	320.05043768236766
chr3	ZMYND10	50345487	50345533	0	47	4584	2382	4584	2335	0.0	1.963169164882227
chr3	NPRL2	50348684	50348709	0	26	13677	2878	13677	2852	0.0	4.795582047685834
chr3	NPRL2	50349930	50349931	6	2	13677	2878	13671	2876	3.0	4.7534770514603615
chr3	NPRL2	50349912	50349929	125	18	13677	2878	13552	2860	6.944444444444445	4.7384615384615385
chr3	C3ORF18	50565465	50565524	0	60	65	3252	65	3192	0.0	0.020363408521303257
chr3	DCAF1	51466802	51466804	444	3	151587	6874	151143	6871	148.0	21.99723475476641
chr3	IQCF6	51779172	51779208	0	37	0	502	0	465	0.0	0.0
chr3	IQCF6	51779152	51779171	0	20	0	502	0	482	0.0	0.0
chr3	IQCF6	51779152	51779208	0	57	0	502	0	445	0.0	0.0
chr3	PCBP4	51961748	51961939	0	192	5471	3664	5471	3472	0.0	1.5757488479262673
chr3	PCBP4	51968309	51968342	842	34	5471	3664	4629	3630	24.764705882352942	1.2752066115702478
chr3	RPL29	51995662	51995729	1984	68	170076	1436	168092	1368	29.176470588235293	122.87426900584795
chr3	RPL29	51995662	51995767	2464	106	170076	1436	167612	1330	23.245283018867923	126.02406015037594
chr3	RPL29	51995662	51995738	2257	77	170076	1436	167819	1359	29.31168831168831	123.48712288447388
chr3	RPL29	51995662	51995777	2597	116	170076	1436	167479	1320	22.387931034482758	126.8780303030303
chr3	RPL29	51995662	51995763	2412	102	170076	1436	167664	1334	23.647058823529413	125.68515742128936
chr3	RPL29	51995730	51995855	2623	126	170076	1436	167453	1310	20.817460317460316	127.82671755725191
chr3	RPL29	51995730	51995767	480	38	170076	1436	169596	1398	12.631578947368421	121.31330472103004
chr3	RPL29	51995730	51995738	273	9	170076	1436	169803	1427	30.333333333333332	118.99299229152068
chr3	RPL29	51995730	51995777	613	48	170076	1436	169463	1388	12.770833333333334	122.0914985590778
chr3	RPL29	51995730	51995763	428	34	170076	1436	169648	1402	12.588235294117647	121.00427960057061
chr3	RPL29	51995768	51995777	133	10	170076	1436	169943	1426	13.3	119.17461430575035
chr3	RPL29	51995739	51995767	207	29	170076	1436	169869	1407	7.137931034482759	120.73134328358209
chr3	RPL29	51995739	51995777	340	39	170076	1436	169736	1397	8.717948717948717	121.50035790980672
chr3	RPL29	51995739	51995763	155	25	170076	1436	169921	1411	6.2	120.42593905031892
chr3	RPL29	51995764	51995767	52	4	170076	1436	170024	1432	13.0	118.73184357541899
chr3	RPL29	51995764	51995777	185	14	170076	1436	169891	1422	13.214285714285714	119.47327707454289
chr3	WDR82	52278139	52278199	160	61	16539	5730	16379	5669	2.622950819672131	2.8892220850238135
chr3	NT5DC2	52528445	52528510	0	66	178063	4574	178063	4508	0.0	39.49933451641526
chr3	NT5DC2	52534350	52534531	0	182	178063	4574	178063	4392	0.0	40.54257741347905
chr3	PBRM1	52563282	52563362	96174	81	271308	9463	175134	9382	1187.3333333333333	18.667021956938818
chr3	GLT8D1	52705446	52705697	0	252	8821	3420	8821	3168	0.0	2.7844065656565657
chr3	GLT8D1	52705446	52705701	0	256	8821	3420	8821	3164	0.0	2.7879266750948166
chr3	TKT	53231349	53231355	0	7	5756	8000	5756	7993	0.0	0.7201301138496184
chr3	DCP1A	53347382	53347420	0	39	11606	6113	11606	6074	0.0	1.9107672044781034
chr3	ARHGEF3	56774999	56775103	0	105	1120	6495	1120	6390	0.0	0.1752738654147105
chr3	PDHB	58428351	58428471	0	121	51	4248	51	4127	0.0	0.012357644778289314
chr3	ACOX2	58531250	58531291	0	42	693	3288	693	3246	0.0	0.2134935304990758
chr3	ACOX2	58534359	58534488	0	130	693	3288	693	3158	0.0	0.2194426852438252
chr3	ACOX2	58534489	58534574	0	86	693	3288	693	3202	0.0	0.21642723297938787
chr3	FAM107A	58626970	58627414	0	445	0	5329	0	4884	0.0	0.0
chr3	CFAP20DC	59049610	59049933	0	324	7335	9238	7335	8914	0.0	0.8228629122728293
chr3	CFAP20DC	58870161	58870171	275	11	7335	9238	7060	9227	25.0	0.7651457678552075
chr3	CFAP20DC	58913697	58913706	0	10	7335	9238	7335	9228	0.0	0.7948634590377113
chr3	PTPRG-AS1	62369191	62369304	0	114	40815	7308	40815	7194	0.0	5.6734778982485405
chr3	PTPRG-AS1	62318790	62318864	0	75	40815	7308	40815	7233	0.0	5.642886768975528
chr3	CADPS	62536444	62536494	0	51	0	14019	0	13968	0.0	0.0
chr3	THOC7	63839655	63839681	0	27	2144	1759	2144	1732	0.0	1.2378752886836029
chr3	PSMD6	64023274	64023390	0	117	51	8946	51	8829	0.0	0.0057764186204553175
chr3	PSMD6	64022642	64022737	0	96	51	8946	51	8850	0.0	0.00576271186440678
chr3	LRIG1	66383990	66384130	104	141	2842	7069	2738	6928	0.7375886524822695	0.3952078521939954
chr3	TAFA4	68932239	68932320	0	82	51	3265	51	3183	0.0	0.016022620169651274
chr3	EOGT	69012514	69012601	0	88	0	5372	0	5284	0.0	0.0
chr3	EOGT	69012367	69012513	0	147	0	5372	0	5225	0.0	0.0
chr3	EOGT	69012367	69012601	0	235	0	5372	0	5137	0.0	0.0
chr3	TMF1	69047348	69047356	99	9	118343	7929	118244	7920	11.0	14.92979797979798
chr3	FRMD4B	69200370	69200810	0	441	102	11238	102	10797	0.0	0.009447068630175049
chr3	FOXP1	70977642	70977645	0	4	30918	26565	30918	26561	0.0	1.1640374985881556
chr3	FOXP1	71581548	71581586	0	39	30918	26565	30918	26526	0.0	1.1655733996833295
chr3	FOXP1	71581398	71581547	0	150	30918	26565	30918	26415	0.0	1.1704713231118682
chr3	LINC00877	72060509	72060801	0	293	0	8637	0	8344	0.0	0.0
chr3	FAM86DP	75434724	75434916	0	193	0	3442	0	3249	0.0	0.0
chr3	FAM86DP	75434724	75435013	0	290	0	3442	0	3152	0.0	0.0
chr3	FAM86DP	75434917	75435013	0	97	0	3442	0	3345	0.0	0.0
chr3	ROBO1	78668471	78668482	0	12	15378	11098	15378	11086	0.0	1.387154970232726
chr3	PROS1	93905783	93905827	0	45	181	5212	181	5167	0.0	0.035029998064640994
chr3	DHFR2	94062745	94062867	0	123	0	3527	0	3404	0.0	0.0
chr3	RIOX2	97971913	97972379	0	467	0	6599	0	6132	0.0	0.0
chr3	CLDND1	98521132	98521328	568	197	1035661	4629	1035093	4432	2.883248730964467	233.54986462093862
chr3	CLDND1	98517051	98517156	57743	106	1035661	4629	977918	4523	544.7452830188679	216.21003758567323
chr3	CLDND1	98522541	98522847	2135	307	1035661	4629	1033526	4322	6.954397394136808	239.13142063859326
chr3	CLDND1	98522541	98522786	1536	246	1035661	4629	1034125	4383	6.2439024390243905	235.93999543691535
chr3	ST3GAL6-AS1	98718418	98718422	0	5	408	9394	408	9389	0.0	0.04345510704015337
chr3	CBLB	105868735	105868910	0	176	510	10339	510	10163	0.0	0.05018203286431172
chr3	CBLB	105671020	105671022	0	3	510	10339	510	10336	0.0	0.049342105263157895
chr3	CBLB	105681292	105681477	26	186	510	10339	484	10153	0.13978494623655913	0.047670639219934995
chr3	LINC00882	106913024	106913040	0	17	4552	18708	4552	18691	0.0	0.24353967149965225
chr3	LINC00882	107209461	107209645	0	185	4552	18708	4552	18523	0.0	0.24574852885601683
chr3	LINC00882	107240438	107240441	0	4	4552	18708	4552	18704	0.0	0.24337040205303678
chr3	AC063944.1	107322313	107322618	0	306	296	3050	296	2744	0.0	0.10787172011661808
chr3	LINC00635	107848905	107849032	0	128	738	7071	738	6943	0.0	0.10629410917470834
chr3	LINC00635	107841895	107842103	0	209	738	7071	738	6862	0.0	0.1075488195861265
chr3	LINC00635	107845308	107845420	0	113	738	7071	738	6958	0.0	0.1060649611957459
chr3	LINC00635	107876434	107876453	0	20	738	7071	738	7051	0.0	0.10466600482201106
chr3	LINC00635	107845101	107845307	0	207	738	7071	738	6864	0.0	0.10751748251748251
chr3	LINC00635	107845101	107845420	0	320	738	7071	738	6751	0.0	0.10931713820174789
chr3	LINC00635	107845101	107846456	0	1356	738	7071	738	5715	0.0	0.12913385826771653
chr3	LINC00635	107853872	107855128	0	1257	738	7071	738	5814	0.0	0.12693498452012383
chr3	IFT57	108222017	108222109	0	93	802	3544	802	3451	0.0	0.2323964068385975
chr3	GUCA1C	108916086	108916125	0	40	104	1168	104	1128	0.0	0.09219858156028368
chr3	ATG3	112561456	112561844	0	389	0	4249	0	3860	0.0	0.0
chr3	CCDC80	112640326	112640922	0	597	51	12973	51	12376	0.0	0.004120879120879121
chr3	CCDC80	112640326	112640562	0	237	51	12973	51	12736	0.0	0.004004396984924623
chr3	CCDC80	112640563	112640922	0	360	51	12973	51	12613	0.0	0.004043447236977722
chr3	NEPRO	113013948	113013951	0	4	7232	6041	7232	6037	0.0	1.1979459996687096
chr3	SPICE1	113514896	113515078	1491	183	127796	7709	126305	7526	8.147540983606557	16.782487377092746
chr3	SPICE1	113514657	113514795	3591	139	127796	7709	124205	7570	25.834532374100718	16.407529722589167
chr3	SPICE1	113514407	113514895	4144	489	127796	7709	123652	7220	8.474437627811861	17.126315789473683
chr3	SPICE1	113514407	113514795	3632	389	127796	7709	124164	7320	9.336760925449871	16.962295081967213
chr3	SPICE1	113514407	113514656	41	250	127796	7709	127755	7459	0.164	17.12763104973857
chr3	NAA50	113723958	113723979	0	22	390	1410	390	1388	0.0	0.28097982708933716
chr3	CCDC191	114004386	114004635	0	250	0	5304	0	5054	0.0	0.0
chr3	LINC02024	117688346	117688717	0	372	0	1048	0	676	0.0	0.0
chr3	IGSF11	118905595	118905666	0	72	1823	4915	1823	4843	0.0	0.3764195746438158
chr3	IGSF11	119112649	119112672	0	24	1823	4915	1823	4891	0.0	0.3727254140257616
chr3	B4GALT4	119218649	119218710	1516	62	200397	6991	198881	6929	24.451612903225808	28.70269880213595
chr3	B4GALT4	119240360	119240563	0	204	200397	6991	200397	6787	0.0	29.526594960954768
chr3	B4GALT4	119240764	119240848	24	85	200397	6991	200373	6906	0.2823529411764706	29.01433536055604
chr3	POPDC2	119648118	119648258	153	141	255	1450	102	1309	1.0851063829787233	0.07792207792207792
chr3	COX17	119676730	119676860	0	131	154	1920	154	1789	0.0	0.08608160983789827
chr3	GSK3B	119916039	119916042	0	4	6764	16821	6764	16817	0.0	0.4022120473330558
chr3	GPR156	120186657	120186668	0	12	32603	6196	32603	6184	0.0	5.272153945666235
chr3	AC072026.2	120907504	120908027	0	524	5	4443	5	3919	0.0	0.0012758356723653994
chr3	GOLGB1	121669196	121669210	0	15	51	11889	51	11874	0.0	0.004295098534613441
chr3	GOLGB1	121730847	121730874	0	28	51	11889	51	11861	0.0	0.00429980608717646
chr3	IQCB1	121834248	121834389	0	142	17	3066	17	2924	0.0	0.005813953488372093
chr3	CCDC58	122383147	122383172	0	26	0	1716	0	1690	0.0	0.0
chr3	KPNA1	122514756	122514873	0	118	42970	8433	42970	8315	0.0	5.1677690920024055
chr3	KPNA1	122514756	122514838	0	83	42970	8433	42970	8350	0.0	5.146107784431138
chr3	KPNA1	122514839	122514873	0	35	42970	8433	42970	8398	0.0	5.116694451059776
chr3	PARP9	122558328	122558432	0	105	34256	8949	34256	8844	0.0	3.873360470375396
chr3	SEMA5B	122912171	122912233	0	63	6618	8546	6618	8483	0.0	0.7801485323588353
chr3	SEMA5B	122913533	122913535	0	3	6618	8546	6618	8543	0.0	0.7746693199110383
chr3	SEMA5B	122911359	122911489	0	131	6618	8546	6618	8415	0.0	0.7864527629233512
chr3	ADCY5	123367899	123367903	385	5	13932	8233	13547	8228	77.0	1.6464511424404473
chr3	CCDC14	123946802	123947278	0	477	0	7677	0	7200	0.0	0.0
chr3	CCDC14	123952594	123955841	51	3248	0	7677	-51	4429	0.015701970443349755	-0.011515014675999097
chr3	CCDC14	123952594	123956044	51	3451	0	7677	-51	4226	0.014778325123152709	-0.012068149550402271
chr3	CCDC14	123955842	123956044	0	203	0	7677	0	7474	0.0	0.0
chr3	CCDC14	123949383	123949463	0	81	0	7677	0	7596	0.0	0.0
chr3	ROPN1	123991921	123992042	0	122	0	4526	0	4404	0.0	0.0
chr3	ZNF148	125323308	125323386	1	79	6477	3608	6476	3529	0.012658227848101266	1.8350807594219325
chr3	LINC02614	125888348	125888581	0	234	51	6139	51	5905	0.0	0.008636748518204911
chr3	SLC41A3	126026334	126026391	0	58	414	5485	414	5427	0.0	0.07628524046434494
chr3	SLC41A3	126050897	126050941	0	45	414	5485	414	5440	0.0	0.07610294117647058
chr3	SLC41A3	126084053	126084091	0	39	414	5485	414	5446	0.0	0.07601909658464928
chr3	ALDH1L1	126180475	126180798	54104	324	141123	13574	87019	13250	166.98765432098764	6.5674716981132075
chr3	ALDH1L1	126180311	126180474	22315	164	141123	13574	118808	13410	136.0670731707317	8.85965697240865
chr3	ALDH1L1	126180311	126180798	76419	488	141123	13574	64704	13086	156.59631147540983	4.944520861989913
chr3	ALDH1L1	126180799	126180960	24544	162	141123	13574	116579	13412	151.50617283950618	8.692141365940948
chr3	CCDC37-DT	126394298	126394687	0	390	0	912	0	522	0.0	0.0
chr3	CCDC37-DT	126394098	126394687	0	590	0	912	0	322	0.0	0.0
chr3	CCDC37-DT	126394098	126394297	0	200	0	912	0	712	0.0	0.0
chr3	LINC02016	127355864	127355888	0	25	22755	1615	22755	1590	0.0	14.31132075471698
chr3	LINC01471	127535185	127536482	0	1298	51	6875	51	5577	0.0	0.00914470145239376
chr3	LINC01471	127537644	127537671	0	28	51	6875	51	6847	0.0	0.007448517598948445
chr3	MGLL	127822308	127823082	612	775	217912	11869	217300	11094	0.7896774193548387	19.587164232918695
chr3	ISY1	129134827	129134830	0	4	15750	3885	15750	3881	0.0	4.058232414326205
chr3	CNBP	129171633	129171653	238	21	17455	3452	17217	3431	11.333333333333334	5.018070533372195
chr3	CNBP	129171633	129171650	238	18	17455	3452	17217	3434	13.222222222222221	5.013686662783925
chr3	CNBP	129171651	129171653	0	3	17455	3452	17455	3449	0.0	5.060887213685126
chr3	RPL32P3	129399007	129399379	0	373	373	4487	373	4114	0.0	0.09066601847350511
chr3	MBD4	129432502	129432554	0	53	0	3360	0	3307	0.0	0.0
chr3	MBD4	129437719	129437806	0	88	0	3360	0	3272	0.0	0.0
chr3	MBD4	129436442	129436459	0	18	0	3360	0	3342	0.0	0.0
chr3	PLXND1	129559612	129559618	7	7	23190	9501	23183	9494	1.0	2.441858015588793
chr3	PIK3R4	130723693	130723809	272	117	96633	5399	96361	5282	2.324786324786325	18.243279060961758
chr3	ASTE1	131026506	131026730	0	225	51	3157	51	2932	0.0	0.017394270122783082
chr3	ASTE1	131026187	131026505	0	319	51	3157	51	2838	0.0	0.017970401691331923
chr3	AC010210.1	131381281	131381331	0	51	0	6702	0	6651	0.0	0.0
chr3	MRPL3	131471170	131471171	0	2	0	2662	0	2660	0.0	0.0
chr3	MRPL3	131502729	131502847	0	119	0	2662	0	2543	0.0	0.0
chr3	MRPL3	131502729	131502781	0	53	0	2662	0	2609	0.0	0.0
chr3	MRPL3	131502729	131502793	0	65	0	2662	0	2597	0.0	0.0
chr3	MRPL3	131502782	131502847	0	66	0	2662	0	2596	0.0	0.0
chr3	CPNE4	132039524	132040189	0	666	0	5868	0	5202	0.0	0.0
chr3	NPHP3	132721962	132722255	0	294	51	9222	51	8928	0.0	0.00571236559139785
chr3	RAB6B	133885534	133885569	0	36	67754	5656	67754	5620	0.0	12.055871886120997
chr3	AMOTL2	134370699	134371311	0	613	0	6413	0	5800	0.0	0.0
chr3	AMOTL2	134370699	134371188	0	490	0	6413	0	5923	0.0	0.0
chr3	AMOTL2	134371189	134371311	0	123	0	6413	0	6290	0.0	0.0
chr3	AMOTL2	134373515	134373684	0	170	0	6413	0	6243	0.0	0.0
chr3	ANAPC13	134485319	134485950	0	632	0	2113	0	1481	0.0	0.0
chr3	ANAPC13	134485319	134485699	0	381	0	2113	0	1732	0.0	0.0
chr3	ANAPC13	134485700	134485950	0	251	0	2113	0	1862	0.0	0.0
chr3	KY	134650824	134650877	0	54	153	9018	153	8964	0.0	0.01706827309236948
chr3	AC092969.1	135379261	135379323	0	63	101	9666	101	9603	0.0	0.010517546600020827
chr3	MSL2	136194971	136196148	666	1178	9253	4238	8587	3060	0.565365025466893	2.806209150326797
chr3	NCK1-DT	136861572	136861745	51	174	51	5008	0	4834	0.29310344827586204	0.0
chr3	NCK1-DT	136861572	136861613	0	42	51	5008	51	4966	0.0	0.01026983487716472
chr3	NCK1-DT	136861614	136861745	51	132	51	5008	0	4876	0.38636363636363635	0.0
chr3	DZIP1L	138115327	138115458	0	132	7570	5033	7570	4901	0.0	1.5445827382166906
chr3	NME9	138329754	138329815	986	62	2884	3719	1898	3657	15.903225806451612	0.5190046486190867
chr3	LINC01391	138942320	138942382	0	63	0	3830	0	3767	0.0	0.0
chr3	COPB2	139389547	139389629	0	83	0	16215	0	16132	0.0	0.0
chr3	COPB2	139389468	139389546	0	79	0	16215	0	16136	0.0	0.0
chr3	COPB2	139389468	139389629	0	162	0	16215	0	16053	0.0	0.0
chr3	RBP1	139538320	139538779	51	460	178	3911	127	3451	0.1108695652173913	0.036800927267458705
chr3	GK5	142204216	142204693	530	478	24687	6036	24157	5558	1.108786610878661	4.346347607052897
chr3	XRN1	142356911	142356981	0	71	2555	12028	2555	11957	0.0	0.21368236179643724
chr3	ATR	142497012	142497132	56	121	93754	22010	93698	21889	0.4628099173553719	4.280597560418475
chr3	ATR	142453116	142453126	93	11	93754	22010	93661	21999	8.454545454545455	4.257511705077503
chr3	PLOD2	146160788	146160879	0	92	458	6735	458	6643	0.0	0.06894475387626073
chr3	PLSCR5	146600287	146600322	0	36	0	2149	0	2113	0.0	0.0
chr3	CP	149176237	149176248	0	12	846	6555	846	6543	0.0	0.12929848693259974
chr3	TM4SF1	149375442	149375678	6610	237	21594	3498	14984	3261	27.890295358649787	4.594909536951855
chr3	WWTR1	149657683	149657763	0	81	23283	8192	23283	8111	0.0	2.870546171865368
chr3	WWTR1	149657503	149657763	28	261	23283	8192	23255	7931	0.10727969348659004	2.9321649224561845
chr3	WWTR1	149657503	149657682	28	180	23283	8192	23255	8012	0.15555555555555556	2.902521218172741
chr3	COMMD2	149751322	149751401	20	80	51	4899	31	4819	0.25	0.006432869890018676
chr3	ANKUB1	149780238	149780319	0	82	0	4884	0	4802	0.0	0.0
chr3	PFN2	149968357	149968401	0	45	0	3425	0	3380	0.0	0.0
chr3	PFN2	149970724	149971050	0	327	0	3425	0	3098	0.0	0.0
chr3	PFN2	149968353	149968356	0	4	0	3425	0	3421	0.0	0.0
chr3	PFN2	149970618	149970723	0	106	0	3425	0	3319	0.0	0.0
chr3	PFN2	149971051	149971151	0	101	0	3425	0	3324	0.0	0.0
chr3	ERICH6	150703495	150703798	0	304	0	2089	0	1785	0.0	0.0
chr3	ERICH6	150703736	150703777	0	42	0	2089	0	2047	0.0	0.0
chr3	AC011317.1	150736341	150736349	0	9	0	1472	0	1463	0.0	0.0
chr3	MBNL1-AS1	152269427	152269437	0	11	51	3430	51	3419	0.0	0.014916642293068149
chr3	SLC33A1	155853222	155853369	0	148	0	4422	0	4274	0.0	0.0
chr3	SLC33A1	155833467	155833855	0	389	0	4422	0	4033	0.0	0.0
chr3	SLC33A1	155853107	155853221	0	115	0	4422	0	4307	0.0	0.0
chr3	SSR3	156548865	156548903	0	39	7956	5187	7956	5148	0.0	1.5454545454545454
chr3	SSR3	156544293	156544306	0	14	7956	5187	7956	5173	0.0	1.5379856949545718
chr3	CCNL1	157151728	157151915	0	188	3715	6386	3715	6198	0.0	0.5993868989996773
chr3	CCNL1	157156935	157157009	0	75	3715	6386	3715	6311	0.0	0.5886547298367929
chr3	CCNL1	157156935	157157005	0	71	3715	6386	3715	6315	0.0	0.5882818685669042
chr3	CCNL1	157149679	157149834	0	156	3715	6386	3715	6230	0.0	0.5963081861958266
chr3	CCNL1	157157006	157157009	0	4	3715	6386	3715	6382	0.0	0.5821059229081793
chr3	IFT80	160366042	160366091	0	50	4165	7073	4165	7023	0.0	0.5930514025345294
chr3	IFT80	160384563	160384587	0	25	4165	7073	4165	7048	0.0	0.5909477866061293
chr3	TRIM59	160449471	160449715	0	245	0	7827	0	7582	0.0	0.0
chr3	TRIM59	160449471	160449682	0	212	0	7827	0	7615	0.0	0.0
chr3	TRIM59	160449683	160449715	0	33	0	7827	0	7794	0.0	0.0
chr3	TRIM59	160449444	160449470	0	27	0	7827	0	7800	0.0	0.0
chr3	KPNA4	160564504	160564519	0	16	0	13663	0	13647	0.0	0.0
chr3	B3GALNT1	161089943	161089958	0	16	102	6044	102	6028	0.0	0.01692103516921035
chr3	B3GALNT1	161086593	161086652	0	60	102	6044	102	5984	0.0	0.017045454545454544
chr3	B3GALNT1	161104784	161105001	0	218	102	6044	102	5826	0.0	0.017507723995880537
chr3	B3GALNT1	161104784	161105233	0	450	102	6044	102	5594	0.0	0.018233821952091528
chr3	B3GALNT1	161086263	161086592	102	330	102	6044	0	5714	0.3090909090909091	0.0
chr3	B3GALNT1	161086263	161086652	102	390	102	6044	0	5654	0.26153846153846155	0.0
chr3	B3GALNT1	161105002	161105233	0	232	102	6044	102	5812	0.0	0.017549896765313145
chr3	LINC01192	163303195	163303236	0	42	97	7521	97	7479	0.0	0.012969648348709721
chr3	LINC01192	163304615	163304660	0	46	97	7521	97	7475	0.0	0.012976588628762541
chr3	LINC01192	163304553	163304614	0	62	97	7521	97	7459	0.0	0.013004424185547661
chr3	WDR49	167554649	167554681	0	33	0	3913	0	3880	0.0	0.0
chr3	PDCD10	167734661	167734804	714	144	1531	3179	817	3035	4.958333333333333	0.26919275123558484
chr3	PDCD10	167734431	167734457	0	27	1531	3179	1531	3152	0.0	0.4857233502538071
chr3	MECOM	169146476	169146494	0	19	0	9118	0	9099	0.0	0.0
chr3	MECOM	169144996	169146224	0	1229	0	9118	0	7889	0.0	0.0
chr3	MECOM	169145317	169146224	0	908	0	9118	0	8210	0.0	0.0
chr3	MECOM	169145317	169145752	0	436	0	9118	0	8682	0.0	0.0
chr3	MECOM	169145753	169146224	0	472	0	9118	0	8646	0.0	0.0
chr3	LRRC34	169812409	169812568	1664	160	17569	2712	15905	2552	10.4	6.2323667711598745
chr3	PHC3	170171372	170171388	0	17	24143	16850	24143	16833	0.0	1.4342660250698034
chr3	PHC3	170181686	170181700	0	15	24143	16850	24143	16835	0.0	1.4340956340956341
chr3	AC026316.5	170733682	170733845	0	164	0	1786	0	1622	0.0	0.0
chr3	NCEH1	172647861	172647884	0	24	0	4813	0	4789	0.0	0.0
chr3	LINC01209	176816173	176816824	9573	652	816	1750	-8757	1098	14.682515337423313	-7.975409836065574
chr3	KCNMB2-AS1	178749045	178749108	0	64	2835	4760	2835	4696	0.0	0.6037052810902896
chr3	KCNMB3	179242808	179243131	0	324	459	5833	459	5509	0.0	0.08331820657106553
chr3	DNAJC19	180986942	180986996	0	55	0	3243	0	3188	0.0	0.0
chr3	DNAJC19	180986942	180986946	0	5	0	3243	0	3238	0.0	0.0
chr3	DNAJC19	180986947	180986996	0	50	0	3243	0	3193	0.0	0.0
chr3	DCUN1D1	182965536	182965677	26	142	26	8289	0	8147	0.18309859154929578	0.0
chr3	DCUN1D1	182985791	182985819	0	29	26	8289	26	8260	0.0	0.0031476997578692495
chr3	PARL	183884721	183884881	20129	161	650517	2279	630388	2118	125.0248447204969	297.6336166194523
chr3	PARL	183884721	183884885	20144	165	650517	2279	630373	2114	122.08484848484848	298.18968779564807
chr3	PARL	183884882	183884885	15	4	650517	2279	650502	2275	3.75	285.93494505494505
chr3	PARL	183862696	183862751	11200	56	650517	2279	639317	2223	200.0	287.59199280251914
chr3	ALG3	184248744	184248780	0	37	51	3286	51	3249	0.0	0.01569713758079409
chr3	ALG3	184248989	184249224	51	236	51	3286	0	3050	0.21610169491525424	0.0
chr3	CLCN2	184356992	184357035	0	44	0	7330	0	7286	0.0	0.0
chr3	CLCN2	184354903	184355372	0	470	0	7330	0	6860	0.0	0.0
chr3	CLCN2	184353541	184353660	0	120	0	7330	0	7210	0.0	0.0
chr3	EHHADH	185253825	185253947	0	123	7020	4538	7020	4415	0.0	1.5900339750849377
chr3	LINC02052	186456916	186457339	0	424	102	3834	102	3410	0.0	0.029912023460410556
chr3	LINC02052	186455435	186455646	0	212	102	3834	102	3622	0.0	0.02816123688569851
chr3	LINC02052	186456163	186456395	0	233	102	3834	102	3601	0.0	0.02832546514856984
chr3	LINC02052	186492664	186492679	0	16	102	3834	102	3818	0.0	0.02671555788370875
chr3	AC068631.1	186665462	186665577	0	116	15112	10018	15112	9902	0.0	1.5261563320541305
chr3	AC068631.1	186743626	186743701	0	76	15112	10018	15112	9942	0.0	1.52001609334138
chr3	AC068631.1	186757016	186757607	6393	592	15112	10018	8719	9426	10.798986486486486	0.9249946955230214
chr3	AC068631.1	186745614	186745728	453	115	15112	10018	14659	9903	3.9391304347826086	1.4802585075229728
chr3	RFC4	186806289	186806423	0	135	3691	2909	3691	2774	0.0	1.3305695746214852
chr3	MASP1	187291627	187291687	0	61	255	9431	255	9370	0.0	0.027214514407684097
chr3	LINC02013	190698048	190698077	0	30	0	1667	0	1637	0.0	0.0
chr3	FGF12	192727180	192727482	0	303	0	7205	0	6902	0.0	0.0
chr3	ATP13A4	193435647	193435674	0	28	14585	9023	14585	8995	0.0	1.6214563646470261
chr3	ATP13A4	193466024	193466080	0	57	14585	9023	14585	8966	0.0	1.6267008699531564
chr3	ATP13A4	193440489	193440556	0	68	14585	9023	14585	8955	0.0	1.6286990508096035
chr3	LINC02028	194058353	194058409	0	57	1802	10141	1802	10084	0.0	0.17869892899643
chr3	LINC02028	194057632	194057635	0	4	1802	10141	1802	10137	0.0	0.17776462464239914
chr3	LINC02028	194058059	194058352	0	294	1802	10141	1802	9847	0.0	0.18299989844622727
chr3	LINC02028	194057636	194058058	0	423	1802	10141	1802	9718	0.0	0.18542910063799137
chr3	TMEM44	194604286	194604312	0	27	51	4577	51	4550	0.0	0.01120879120879121
chr3	MUC4	195778288	195778301	3529	14	821377	19948	817848	19934	252.07142857142858	41.02779171265175
chr3	MUC4	195769021	195769048	0	28	821377	19948	821377	19920	0.0	41.23378514056225
chr3	TNK2	195876603	195876609	0	7	366	8460	366	8453	0.0	0.043298237312196855
chr3	TNK2	195882050	195882284	0	235	366	8460	366	8225	0.0	0.044498480243161095
chr3	TNK2	195876457	195876602	0	146	366	8460	366	8314	0.0	0.04402213134471975
chr3	TNK2	195876457	195876609	0	153	366	8460	366	8307	0.0	0.04405922715781871
chr3	TNK2	195876457	195876575	0	119	366	8460	366	8341	0.0	0.043879630739719455
chr3	TNK2	195876576	195876602	0	27	366	8460	366	8433	0.0	0.04340092493774458
chr3	TNK2	195876576	195876609	0	34	366	8460	366	8426	0.0	0.043436980773795396
chr3	TNK2	195876443	195876456	0	14	366	8460	366	8446	0.0	0.04333412266161497
chr3	SDHAP1	195984491	195984592	0	102	144163	3371	144163	3269	0.0	44.10003059039462
chr3	TFRC	196081830	196082041	6629	212	29078	7608	22449	7396	31.2688679245283	3.035289345592212
chr3	PCYT1A	196287531	196287613	549	83	44728	7356	44179	7273	6.614457831325301	6.074384710573353
chr3	TCTEX1D2	196318035	196318038	0	4	10208	1253	10208	1249	0.0	8.172938350680544
chr3	TM4SF19	196324270	196324273	0	4	0	1901	0	1897	0.0	0.0
chr3	SMCO1	196515103	196515158	0	56	96688	1849	96688	1793	0.0	53.92526491912995
chr3	WDR53	196566876	196567189	51	314	14704	1801	14653	1487	0.1624203821656051	9.854068594485542
chr3	WDR53	196566876	196566888	0	13	14704	1801	14704	1788	0.0	8.223713646532438
chr3	WDR53	196566889	196567189	51	301	14704	1801	14653	1500	0.16943521594684385	9.768666666666666
chr3	WDR53	196568438	196568517	0	80	14704	1801	14704	1721	0.0	8.543869843114468
chr3	NCBP2	196942159	196942368	0	210	0	4358	0	4148	0.0	0.0
chr3	NCBP2	196942369	196942424	0	56	0	4358	0	4302	0.0	0.0
chr3	NCBP2	196941934	196942158	0	225	0	4358	0	4133	0.0	0.0
chr3	NCBP2	196941934	196942424	0	491	0	4358	0	3867	0.0	0.0
chr3	NCBP2	196941934	196942368	0	435	0	4358	0	3923	0.0	0.0
chr3	NCBP2	196941486	196941707	0	222	0	4358	0	4136	0.0	0.0
chr3	DLG1	197298417	197298534	0	118	47199	16100	47199	15982	0.0	2.953259917407083
chr3	DLG1	197138214	197138220	0	7	47199	16100	47199	16093	0.0	2.932890076430746
chr3	DLG1	197297543	197297671	0	129	47199	16100	47199	15971	0.0	2.955293970321207
chr3	DLG1	197085295	197085578	0	284	47199	16100	47199	15816	0.0	2.984256449165402
chr3	DLG1	197297672	197297887	0	216	47199	16100	47199	15884	0.0	2.9714807353311508
chr3	DLG1	197297672	197298071	0	400	47199	16100	47199	15700	0.0	3.0063057324840763
chr3	BDH1	197514152	197514262	102	111	365591	10256	365489	10145	0.918918918918919	36.026515524889106
chr3	AC132008.2	197627571	197627778	0	208	24973	2727	24973	2519	0.0	9.913854704247717
chr3	IQCG	197949540	197949837	153	298	7858	4487	7705	4189	0.5134228187919463	1.8393411315349726
chr4	DGKQ	965927	966062	0	136	24271	5008	24271	4872	0.0	4.981732348111659
chr4	TMED11P	1123114	1123116	0	3	0	758	0	755	0.0	0.0
chr4	SPON2	1201268	1201271	4	4	110474	5995	110470	5991	1.0	18.43932565514939
chr4	CTBP1	1214190	1214341	4083	152	90974	5959	86891	5807	26.861842105263158	14.963147924918202
chr4	FAM53A	1683693	1683956	298	264	855	3942	557	3678	1.128787878787879	0.1514410005437738
chr4	POLN	2072967	2072993	0	27	25609	5714	25609	5687	0.0	4.503077193599437
chr4	POLN	2170678	2170680	0	3	25609	5714	25609	5711	0.0	4.484153388198214
chr4	HAUS3	2231834	2231943	3436	110	152924	9687	149488	9577	31.236363636363638	15.60906338101702
chr4	HAUS3	2241519	2242049	26980	531	152924	9687	125944	9156	50.80979284369115	13.755351681957187
chr4	ZFYVE28	2364485	2364691	0	207	449	9633	449	9426	0.0	0.047634203267557816
chr4	TNIP2	2755948	2756012	0	65	15177	2658	15177	2593	0.0	5.853065946779791
chr4	TNIP2	2755948	2755974	0	27	15177	2658	15177	2631	0.0	5.768529076396807
chr4	TNIP2	2755975	2756012	0	38	15177	2658	15177	2620	0.0	5.792748091603054
chr4	NOP14	2939534	2939537	218	4	99452	3568	99234	3564	54.5	27.843434343434343
chr4	HTT-AS	3074356	3074424	0	69	298	2254	298	2185	0.0	0.13638443935926772
chr4	AC226119.1	3921623	3921626	0	4	204	688	204	684	0.0	0.2982456140350877
chr4	FAM86EP	3947143	3948088	867	946	2208	2974	1341	2028	0.9164904862579282	0.6612426035502958
chr4	FAM86EP	3946625	3946767	255	143	2208	2974	1953	2831	1.7832167832167831	0.6898622394913458
chr4	TMEM128	4247600	4248104	17180	505	27502	1753	10322	1248	34.01980198019802	8.270833333333334
chr4	LYAR	4289602	4290034	0	433	5047	1931	5047	1498	0.0	3.369158878504673
chr4	LYAR	4289602	4289984	0	383	5047	1931	5047	1548	0.0	3.2603359173126614
chr4	EVC2	5640513	5640520	0	8	3584	5527	3584	5519	0.0	0.6493930059793441
chr4	AC116317.1	6303861	6303913	7825	53	128972	2334	121147	2281	147.64150943396226	53.111354669004825
chr4	PPP2R2C	6380996	6381039	0	44	6842	8702	6842	8658	0.0	0.7902517902517903
chr4	FBXL5	15659726	15659739	0	14	14535	4396	14535	4382	0.0	3.3169785486079415
chr4	FBXL5	15681279	15681351	447	73	14535	4396	14088	4323	6.123287671232877	3.258848022206801
chr4	FBXL5	15681279	15681381	532	103	14535	4396	14003	4293	5.165048543689321	3.2618215699976707
chr4	PROM1	16083231	16083298	0	68	0	7501	0	7433	0.0	0.0
chr4	LDB2	16508534	16508539	0	6	0	5476	0	5470	0.0	0.0
chr4	LCORL	18021597	18021600	0	4	197422	16931	197422	16927	0.0	11.66314172623619
chr4	ADGRA3	22444972	22445039	0	68	65175	9289	65175	9221	0.0	7.068105411560568
chr4	SEPSECS	25159509	25159626	4	118	26618	6251	26614	6133	0.03389830508474576	4.33947497146584
chr4	SEL1L3	25863433	25863454	0	22	384	7498	384	7476	0.0	0.051364365971107544
chr4	SEL1L3	25863606	25863619	0	14	384	7498	384	7484	0.0	0.05130946018172101
chr4	STIM2-AS1	26860340	26860508	4482	169	15699	456	11217	287	26.5207100591716	39.08362369337979
chr4	ARAP2	36243608	36243689	0	82	16	12390	16	12308	0.0	0.0012999675008124798
chr4	LINC02505	36615417	36615452	0	36	0	2189	0	2153	0.0	0.0
chr4	LINC01258	38452572	38452575	0	4	0	2576	0	2572	0.0	0.0
chr4	TLR10	38775774	38776108	0	335	0	1194	0	859	0.0	0.0
chr4	TMEM156	38998639	38998722	0	84	0	2572	0	2488	0.0	0.0
chr4	RFC1	39351347	39351430	0	84	25020	6752	25020	6668	0.0	3.752249550089982
chr4	RPL9	39458393	39458889	23852	497	512155	4943	488303	4446	47.99195171026157	109.82973459289249
chr4	UGDH	39527232	39527281	0	50	10220	3990	10220	3940	0.0	2.5939086294416245
chr4	RBM47	40629977	40630106	0	130	485	8557	485	8427	0.0	0.05755310312092085
chr4	APBB2	40856984	40857024	0	41	26951	11681	26951	11640	0.0	2.3153780068728524
chr4	APBB2	40830457	40830461	0	5	26951	11681	26951	11676	0.0	2.3082391229873243
chr4	BEND4	42120053	42120123	0	71	153	8482	153	8411	0.0	0.018190464867435502
chr4	AC114757.1	43992592	43993011	0	420	51	9122	51	8702	0.0	0.00586072167317858
chr4	GABRA2	46389210	46389231	0	22	0	16399	0	16377	0.0	0.0
chr4	GABRA2	46389210	46389221	0	12	0	16399	0	16387	0.0	0.0
chr4	GABRA2	46389210	46389226	0	17	0	16399	0	16382	0.0	0.0
chr4	GABRA2	46389222	46389231	0	10	0	16399	0	16389	0.0	0.0
chr4	GABRA2	46389222	46389226	0	5	0	16399	0	16394	0.0	0.0
chr4	GABRA2	46389227	46389231	0	5	0	16399	0	16394	0.0	0.0
chr4	GABRA4	46993338	46993405	0	68	0	11246	0	11178	0.0	0.0
chr4	NFXL1	47914364	47914548	816	185	4294	4518	3478	4333	4.410810810810811	0.8026771290099238
chr4	NFXL1	47914549	47914611	0	63	4294	4518	4294	4455	0.0	0.9638608305274972
chr4	SGCB	52031851	52031863	0	13	0	4365	0	4352	0.0	0.0
chr4	USP46	52656295	52656451	0	157	0	8909	0	8752	0.0	0.0
chr4	USP46	52598568	52598626	0	59	0	8909	0	8850	0.0	0.0
chr4	CHIC2	54048954	54049037	0	84	102	1239	102	1155	0.0	0.08831168831168831
chr4	HOPX	56681254	56681651	0	398	0	3242	0	2844	0.0	0.0
chr4	HOPX	56656299	56656441	0	143	0	3242	0	3099	0.0	0.0
chr4	HOPX	56656299	56656342	0	44	0	3242	0	3198	0.0	0.0
chr4	HOPX	56656299	56656338	0	40	0	3242	0	3202	0.0	0.0
chr4	HOPX	56656343	56656441	0	99	0	3242	0	3143	0.0	0.0
chr4	HOPX	56656339	56656441	0	103	0	3242	0	3139	0.0	0.0
chr4	HOPX	56656339	56656342	0	4	0	3242	0	3238	0.0	0.0
chr4	SPINK2	56821457	56821606	0	150	78	732	78	582	0.0	0.13402061855670103
chr4	SPINK2	56821457	56821501	0	45	78	732	78	687	0.0	0.11353711790393013
chr4	SPINK2	56821502	56821606	0	105	78	732	78	627	0.0	0.12440191387559808
chr4	AC017091.1	58784035	58784133	0	99	51	2941	51	2842	0.0	0.017945109078114006
chr4	LINC02619	58988048	58988102	0	55	0	1391	0	1336	0.0	0.0
chr4	ADGRL3-AS1	62157322	62157367	0	46	0	958	0	912	0.0	0.0
chr4	AC104806.2	67419893	67420896	204	1004	0	2410	-204	1406	0.20318725099601595	-0.14509246088193456
chr4	CENPC	67492750	67492867	0	118	0	8516	0	8398	0.0	0.0
chr4	TMPRSS11A	67944509	67944517	0	9	0	3961	0	3952	0.0	0.0
chr4	UGT2B4	69495140	69495391	0	252	0	2514	0	2262	0.0	0.0
chr4	GRSF1	70839227	70839469	0	243	51	7579	51	7336	0.0	0.006952017448200654
chr4	GRSF1	70839176	70839226	0	51	51	7579	51	7528	0.0	0.00677470775770457
chr4	RCHY1	75508819	75508822	0	4	0	5692	0	5688	0.0	0.0
chr4	RCHY1	75514196	75514239	0	44	0	5692	0	5648	0.0	0.0
chr4	RCHY1	75514196	75514661	0	466	0	5692	0	5226	0.0	0.0
chr4	RCHY1	75491582	75491609	0	28	0	5692	0	5664	0.0	0.0
chr4	RCHY1	75514154	75514195	0	42	0	5692	0	5650	0.0	0.0
chr4	RCHY1	75514154	75514239	0	86	0	5692	0	5606	0.0	0.0
chr4	G3BP2	75672812	75672942	0	131	408	11241	408	11110	0.0	0.036723672367236726
chr4	G3BP2	75672943	75673017	0	75	408	11241	408	11166	0.0	0.03653949489521763
chr4	G3BP2	75673018	75673048	0	31	408	11241	408	11210	0.0	0.03639607493309545
chr4	G3BP2	75662212	75662380	0	169	408	11241	408	11072	0.0	0.03684971098265896
chr4	G3BP2	75673207	75673449	0	243	408	11241	408	10998	0.0	0.03709765411893071
chr4	G3BP2	75694792	75694796	0	5	408	11241	408	11236	0.0	0.03631185475258099
chr4	G3BP2	75662689	75662764	0	76	408	11241	408	11165	0.0	0.036542767577250335
chr4	G3BP2	75656918	75656922	0	5	408	11241	408	11236	0.0	0.03631185475258099
chr4	G3BP2	75656854	75656922	0	69	408	11241	408	11172	0.0	0.036519871106337275
chr4	G3BP2	75672505	75672588	0	84	408	11241	408	11157	0.0	0.03656897015326701
chr4	SDAD1	75990695	75990750	0	56	107	3458	107	3402	0.0	0.031452087007642564
chr4	SCARB2	76163224	76163285	0	62	153	15139	153	15077	0.0	0.01014790740863567
chr4	SCARB2	76166168	76166248	0	81	153	15139	153	15058	0.0	0.010160711913932793
chr4	CNOT6L	77726166	77726304	0	139	0	9382	0	9243	0.0	0.0
chr4	CNOT6L	77819232	77819302	0	71	0	9382	0	9311	0.0	0.0
chr4	PRKG2	81142793	81142879	0	87	2668	5137	2668	5050	0.0	0.5283168316831683
chr4	PRKG2	81214930	81214934	87	5	2668	5137	2581	5132	17.4	0.5029228371005456
chr4	TMEM150C	82496067	82496077	0	11	0	3507	0	3496	0.0	0.0
chr4	SEC31A	82842139	82842183	0	45	102	8631	102	8586	0.0	0.011879804332634521
chr4	SEC31A	82878729	82878856	0	128	102	8631	102	8503	0.0	0.011995766200164648
chr4	THAP9-AS1	82900333	82900370	0	38	0	4254	0	4216	0.0	0.0
chr4	SEC31A	82871367	82871942	0	576	102	8631	102	8055	0.0	0.01266294227188082
chr4	SEC31A	82890750	82891086	0	337	102	8631	102	8294	0.0	0.012298046780805401
chr4	SEC31A	82890694	82890749	0	56	102	8631	102	8575	0.0	0.011895043731778425
chr4	SEC31A	82890694	82890734	0	41	102	8631	102	8590	0.0	0.011874272409778813
chr4	SEC31A	82890735	82891086	0	352	102	8631	102	8279	0.0	0.012320328542094456
chr4	SEC31A	82890735	82890749	0	15	102	8631	102	8616	0.0	0.011838440111420613
chr4	LIN54	82984160	82984822	0	663	51	3486	51	2823	0.0	0.018065887353878853
chr4	LIN54	83010483	83010745	51	263	51	3486	0	3223	0.19391634980988592	0.0
chr4	HELQ	83455396	83455506	0	111	54	3602	54	3491	0.0	0.015468347178458894
chr4	ABRAXAS1	83484823	83484984	0	162	103	7552	103	7390	0.0	0.013937753721244926
chr4	MAPK10	86194308	86194334	0	27	153	36649	153	36622	0.0	0.004177816612964885
chr4	MAPK10	86194308	86194317	0	10	153	36649	153	36639	0.0	0.004175878162613608
chr4	MAPK10	86194318	86194334	0	17	153	36649	153	36632	0.0	0.004176676130159424
chr4	MAPK10	86358080	86358206	0	127	153	36649	153	36522	0.0	0.004189255791030064
chr4	MAPK10	86593732	86593908	0	177	153	36649	153	36472	0.0	0.004194998903268261
chr4	C4ORF36	86892182	86892280	0	99	259	1920	259	1821	0.0	0.14222954420647996
chr4	C4ORF36	86892182	86892208	0	27	259	1920	259	1893	0.0	0.13681986265187532
chr4	C4ORF36	86892182	86892197	0	16	259	1920	259	1904	0.0	0.13602941176470587
chr4	C4ORF36	86892062	86892181	0	120	259	1920	259	1800	0.0	0.1438888888888889
chr4	C4ORF36	86892062	86892280	0	219	259	1920	259	1701	0.0	0.1522633744855967
chr4	C4ORF36	86892062	86892208	0	147	259	1920	259	1773	0.0	0.1460800902425268
chr4	C4ORF36	86892062	86892197	0	136	259	1920	259	1784	0.0	0.14517937219730942
chr4	C4ORF36	86892209	86892280	0	72	259	1920	259	1848	0.0	0.14015151515151514
chr4	C4ORF36	86892198	86892280	0	83	259	1920	259	1837	0.0	0.14099074578116494
chr4	C4ORF36	86892198	86892208	0	11	259	1920	259	1909	0.0	0.1356731272917758
chr4	ABCG2	88158385	88158575	0	191	10523	5621	10523	5430	0.0	1.937937384898711
chr4	PPM1K	88278143	88278534	11038	392	83516	10583	72478	10191	28.158163265306122	7.111961534687469
chr4	SNCA	89836961	89837096	0	136	920	6216	920	6080	0.0	0.1513157894736842
chr4	SNCA	89836742	89836960	0	219	920	6216	920	5997	0.0	0.15341003835250958
chr4	SNCA	89836742	89837096	0	355	920	6216	920	5861	0.0	0.15696980037536257
chr4	TSPAN5	98484384	98484397	0	14	102	5216	102	5202	0.0	0.0196078431372549
chr4	TSPAN5	98657524	98657538	0	15	102	5216	102	5201	0.0	0.019611613151317056
chr4	ADH5	99081974	99082000	0	27	0	4877	0	4850	0.0	0.0
chr4	ADH4	99144196	99144203	0	8	103	2447	103	2439	0.0	0.04223042230422304
chr4	TRMT10A	99563367	99563556	0	190	0	4395	0	4205	0.0	0.0
chr4	H2AZ1	99950167	99950246	77	80	638	1512	561	1432	0.9625	0.39175977653631283
chr4	H2AZ1	99948810	99948812	0	3	638	1512	638	1509	0.0	0.4227965540092777
chr4	PPP3CA	101346738	101347478	0	741	0	5231	0	4490	0.0	0.0
chr4	MANBA	102671892	102672007	0	116	61	8306	61	8190	0.0	0.0074481074481074485
chr4	UBE2D3	102827591	102827942	0	352	51	9483	51	9131	0.0	0.005585368524805607
chr4	UBE2D3	102827591	102827733	0	143	51	9483	51	9340	0.0	0.005460385438972162
chr4	UBE2D3	102825721	102825736	0	16	51	9483	51	9467	0.0	0.005387134255836062
chr4	UBE2D3	102825238	102825476	0	239	51	9483	51	9244	0.0	0.005517092167892687
chr4	AC105460.1	103556946	103556964	0	19	93515	2274	93515	2255	0.0	41.470066518847005
chr4	AC105460.1	103552500	103552506	0	7	93515	2274	93515	2267	0.0	41.250551389501545
chr4	PPA2	105456680	105456694	0	15	0	4491	0	4476	0.0	0.0
chr4	INTS12	105707918	105708636	51	719	51	3907	0	3188	0.07093184979137691	0.0
chr4	INTS12	105707918	105708150	0	233	51	3907	51	3674	0.0	0.013881328252585737
chr4	INTS12	105708151	105708636	51	486	51	3907	0	3421	0.10493827160493827	0.0
chr4	TBCK	106251865	106251981	100	117	2156	10864	2056	10747	0.8547008547008547	0.19130920256815856
chr4	TBCK	106315926	106315929	0	4	2156	10864	2156	10860	0.0	0.1985267034990792
chr4	LEF1	108166271	108166656	0	386	0	5235	0	4849	0.0	0.0
chr4	ETNPPL	108762820	108762841	0	22	167	2934	167	2912	0.0	0.057348901098901096
chr4	ETNPPL	108762192	108762384	0	193	167	2934	167	2741	0.0	0.06092666909886903
chr4	COL25A1	108846138	108846181	0	44	14410	6485	14410	6441	0.0	2.2372302437509703
chr4	COL25A1	109302168	109302301	0	134	14410	6485	14410	6351	0.0	2.2689340261376163
chr4	COL25A1	109302168	109302495	0	328	14410	6485	14410	6157	0.0	2.3404255319148937
chr4	PLA2G12A	109718682	109718687	0	6	8466	5225	8466	5219	0.0	1.6221498371335505
chr4	ZGRF1	112636694	112636849	0	156	0	9135	0	8979	0.0	0.0
chr4	CAMK2D	113457290	113457333	36	44	1310	7387	1274	7343	0.8181818181818182	0.17349857006673022
chr4	LINC02262	117360543	117360562	0	20	0	2351	0	2331	0.0	0.0
chr4	METTL14-DT	118684838	118685303	0	466	204	7533	204	7067	0.0	0.02886656289797651
chr4	METTL14-DT	118678043	118680487	153	2445	204	7533	51	5088	0.06257668711656442	0.010023584905660377
chr4	NDNF	121071792	121071991	0	200	0	3580	0	3380	0.0	0.0
chr4	QRFPR	121332820	121332932	0	113	0	2837	0	2724	0.0	0.0
chr4	ANXA5	121678351	121678413	0	63	153	2700	153	2637	0.0	0.05802047781569966
chr4	CETN4P	122732286	122732417	318	132	67841	3670	67523	3538	2.409090909090909	19.085076314301865
chr4	NUDT6	122921928	122922333	0	406	0	1904	0	1498	0.0	0.0
chr4	NUDT6	122921928	122922022	0	95	0	1904	0	1809	0.0	0.0
chr4	NUDT6	122922023	122922333	0	311	0	1904	0	1593	0.0	0.0
chr4	MFSD8	127965071	127965241	0	171	0	7255	0	7084	0.0	0.0
chr4	MFSD8	127920456	127920555	0	100	0	7255	0	7155	0.0	0.0
chr4	MFSD8	127920452	127920555	0	104	0	7255	0	7151	0.0	0.0
chr4	MFSD8	127920452	127920455	0	4	0	7255	0	7251	0.0	0.0
chr4	PGRMC2	128287372	128288016	0	645	0	4427	0	3782	0.0	0.0
chr4	PGRMC2	128286668	128286714	0	47	0	4427	0	4380	0.0	0.0
chr4	SCLT1	129093069	129093141	0	73	12956	9011	12956	8938	0.0	1.4495412844036697
chr4	AC105383.1	133142605	133142709	0	105	0	11465	0	11360	0.0	0.0
chr4	AC015631.1	134307540	134307588	0	49	0	8668	0	8619	0.0	0.0
chr4	AC015631.1	134156377	134156425	0	49	0	8668	0	8619	0.0	0.0
chr4	AC015631.1	134255274	134255455	0	182	0	8668	0	8486	0.0	0.0
chr4	LINC00613	135867835	135867844	0	10	0	541	0	531	0.0	0.0
chr4	PCDH18	137529601	137532253	0	2653	51	6690	51	4037	0.0	0.012633143423334159
chr4	LINC00616	138130418	138130433	0	16	0	6060	0	6044	0.0	0.0
chr4	LINC00616	138130418	138130664	0	247	0	6060	0	5813	0.0	0.0
chr4	LINC00616	138130434	138130664	0	231	0	6060	0	5829	0.0	0.0
chr4	LINC00616	138097968	138098157	0	190	0	6060	0	5870	0.0	0.0
chr4	NDUFC1	139300601	139300962	0	362	0	2585	0	2223	0.0	0.0
chr4	NDUFC1	139300601	139302414	0	1814	0	2585	0	771	0.0	0.0
chr4	NDUFC1	139300601	139301290	0	690	0	2585	0	1895	0.0	0.0
chr4	MGAT4D	140456588	140456617	0	30	408	2816	408	2786	0.0	0.1464465183058148
chr4	RNF150	140967622	140967747	0	126	306	11023	306	10897	0.0	0.028081123244929798
chr4	INPP4B	142208424	142208445	0	22	899	14202	899	14180	0.0	0.06339915373765867
chr4	ANAPC10	145098119	145098129	0	11	8057	4412	8057	4401	0.0	1.8307202908429903
chr4	ANAPC10	145097244	145097255	0	12	8057	4412	8057	4400	0.0	1.8311363636363636
chr4	ANAPC10	145097886	145098118	0	233	8057	4412	8057	4179	0.0	1.9279731993299833
chr4	OTUD4	145165150	145165190	0	41	538	9541	538	9500	0.0	0.05663157894736842
chr4	LINC02266	145338964	145339043	0	80	0	1730	0	1650	0.0	0.0
chr4	LINC02266	145338775	145338963	0	189	0	1730	0	1541	0.0	0.0
chr4	LINC02266	145338775	145339043	0	269	0	1730	0	1461	0.0	0.0
chr4	LINC02266	145343434	145343448	0	15	0	1730	0	1715	0.0	0.0
chr4	LINC02266	145337090	145337199	0	110	0	1730	0	1620	0.0	0.0
chr4	ZNF827	145885677	145886031	0	355	5491	16799	5491	16444	0.0	0.3339211870591097
chr4	ZNF827	145764974	145764986	0	13	5491	16799	5491	16786	0.0	0.32711783629214825
chr4	ZNF827	145764974	145764977	0	4	5491	16799	5491	16795	0.0	0.32694254242334025
chr4	ZNF827	145764978	145764986	0	9	5491	16799	5491	16790	0.0	0.3270399047051817
chr4	LINC01095	146113946	146114290	0	345	1957	3553	1957	3208	0.0	0.6100374064837906
chr4	LINC01095	146113641	146114290	0	650	1957	3553	1957	2903	0.0	0.6741302101274543
chr4	LINC01095	146113641	146113945	0	305	1957	3553	1957	3248	0.0	0.6025246305418719
chr4	NR3C2	148259965	148259976	0	12	306	6620	306	6608	0.0	0.04630750605326876
chr4	AC002460.1	148941547	148941655	459	109	918	519	459	410	4.2110091743119265	1.1195121951219513
chr4	LRBA	150302624	150302626	0	3	178	16823	178	16820	0.0	0.010582639714625445
chr4	LRBA	150798076	150798079	0	4	178	16823	178	16819	0.0	0.010583268922052441
chr4	SH3D19	151176524	151176532	97	9	13664	7208	13567	7199	10.777777777777779	1.8845673010140298
chr4	FBXW7	152534940	152535125	0	186	12424	9870	12424	9684	0.0	1.2829409334985544
chr4	PLRG1	154547010	154547036	0	27	12171	4940	12171	4913	0.0	2.477305108894769
chr4	FGG	154612531	154612743	0	213	0	3404	0	3191	0.0	0.0
chr4	MAP9	155376375	155376769	992	395	992	8872	0	8477	2.511392405063291	0.0
chr4	PDGFC	156767772	156767960	0	189	0	6013	0	5824	0.0	0.0
chr4	MARCHF1	164383186	164383868	51	683	24	10135	-27	9452	0.0746705710102489	-0.0028565382987727466
chr4	DDX60	168318621	168318734	0	114	92	6563	92	6449	0.0	0.014265777639944178
chr4	DDX60L	168480376	168480389	0	14	981	12203	981	12189	0.0	0.08048240216588727
chr4	AADAT	170089611	170089622	0	12	612	2987	612	2975	0.0	0.2057142857142857
chr4	AADAT	170090143	170090160	0	18	612	2987	612	2969	0.0	0.20613001010441226
chr4	AADAT	170090161	170090223	0	63	612	2987	612	2924	0.0	0.20930232558139536
chr4	HMGB2	173334245	173334270	0	26	0	1802	0	1776	0.0	0.0
chr4	HMGB2	173334043	173334244	0	202	0	1802	0	1600	0.0	0.0
chr4	LINC02268	174120308	174120417	0	110	2257	3430	2257	3320	0.0	0.6798192771084337
chr4	HPGD	174522358	174522622	0	265	51	5539	51	5274	0.0	0.009670079635949944
chr4	GPM6A	175673679	175673690	0	12	51	7064	51	7052	0.0	0.007231990924560408
chr4	DCTD	182917287	182917309	0	23	0	3477	0	3454	0.0	0.0
chr4	DCTD	182916672	182916721	0	50	0	3477	0	3427	0.0	0.0
chr4	DCTD	182916285	182916417	0	133	0	3477	0	3344	0.0	0.0
chr4	AC107214.1	183503666	183504174	0	509	16	1781	16	1272	0.0	0.012578616352201259
chr4	LINC02362	184378498	184378963	0	466	108591	5072	108591	4606	0.0	23.575987841945288
chr4	IRF2	184473968	184473988	0	21	816	3036	816	3015	0.0	0.27064676616915423
chr4	CASP3	184648464	184648501	0	38	17803	2908	17803	2870	0.0	6.203135888501742
chr4	LINC01093	184897334	184897346	0	13	0	3158	0	3145	0.0	0.0
chr4	LINC01093	184898620	184898645	0	26	0	3158	0	3132	0.0	0.0
chr4	LINC01093	184897334	184898619	0	1286	0	3158	0	1872	0.0	0.0
chr4	LINC01093	184897334	184897668	0	335	0	3158	0	2823	0.0	0.0
chr4	LINC01093	184897347	184897668	0	322	0	3158	0	2836	0.0	0.0
chr4	CFAP97	185203784	185203896	0	113	51	6856	51	6743	0.0	0.007563399080527955
chr4	UFSP2	185418586	185418610	0	25	3417	2791	3417	2766	0.0	1.235357917570499
chr4	PDLIM3	185513556	185514268	0	713	102	9020	102	8307	0.0	0.012278801011195377
chr4	SORBS2	185646667	185646698	0	32	166990	11677	166990	11645	0.0	14.340060111635895
chr4	SORBS2	185775226	185775229	0	4	166990	11677	166990	11673	0.0	14.30566264028099
chr4	SORBS2	185733997	185734097	0	101	166990	11677	166990	11576	0.0	14.425535590877677
chr4	FAT1	186596539	186597032	0	494	348	16199	348	15705	0.0	0.0221585482330468
chr4	FAT1	186628144	186628152	0	9	348	16199	348	16190	0.0	0.021494749845583694
chr4	LINC02492	187592742	187592882	0	141	7373	2773	7373	2632	0.0	2.80129179331307
chr4	LINC02492	187558076	187558179	0	104	7373	2773	7373	2669	0.0	2.762457849381791
chr4	FRG1-DT	189939658	189940048	0	391	102	5113	102	4722	0.0	0.021601016518424398
chr4	FRG1-DT	189939658	189940168	0	511	102	5113	102	4602	0.0	0.02216427640156454
chr4	FRG1-DT	189940049	189940168	0	120	102	5113	102	4993	0.0	0.020428600040056078
chr4	ZNF718	124674	125296	23828	623	39083	5079	15255	4456	38.247191011235955	3.4234739676840213
chr4	PIGG	499299	499489	85	191	153216	8690	153131	8499	0.44502617801047123	18.017531474291093
chr4	PIGG	521228	521273	929	46	153216	8690	152287	8644	20.195652173913043	17.617653863951872
chr4	PIGG	521250	521273	731	24	153216	8690	152485	8666	30.458333333333332	17.595776598199862
chr4	PIGG	521228	521249	198	22	153216	8690	153018	8668	9.0	17.653207198892478
chr4	PIGG	499490	499725	49364	236	153216	8690	103852	8454	209.16949152542372	12.28436243198486
chr4	PIGG	499299	499725	49449	427	153216	8690	103767	8263	115.8056206088993	12.558029771269515
chr4	PIGG	499490	500047	50078	558	153216	8690	103138	8132	89.74551971326164	12.6829808165273
chr4	PIGG	499299	500047	50163	749	153216	8690	103053	7941	66.97329773030708	12.977332829618437
chr4	PIGG	499726	500047	714	322	153216	8690	152502	8368	2.217391304347826	18.22442638623327
chr4	PIGG	521853	521941	714	89	153216	8690	152502	8601	8.02247191011236	17.730728985001743
chr4	PIGG	525635	525837	2670	203	153216	8690	150546	8487	13.152709359605911	17.738423471191233
chr4	PDE6B	667942	668006	27448	65	37127	5076	9679	5011	422.2769230769231	1.9315505887048494
chr4	MYL5	675454	675854	2652	401	4834	3390	2182	2989	6.613466334164588	0.7300100368016059
chr4	MYL5	674684	675854	2851	1171	4834	3390	1983	2219	2.43467122117848	0.8936457863902659
chr4	MYL5	674684	675453	199	770	4834	3390	4635	2620	0.2584415584415584	1.7690839694656488
chr4	MYL5	679034	679173	0	140	4834	3390	4834	3250	0.0	1.4873846153846153
chr4	IDUA	987912	987949	69	38	10889	3973	10820	3935	1.8157894736842106	2.7496823379923763
chr4	FGFRL1	1012245	1012277	0	33	1275	4338	1275	4305	0.0	0.2961672473867596
chr4	MAEA	1312162	1312238	0	77	42338	6602	42338	6525	0.0	6.488582375478927
chr4	MAEA	1309596	1309712	66	117	42338	6602	42272	6485	0.5641025641025641	6.518427139552815
chr4	UVSSA	1345794	1346569	345	776	80182	15270	79837	14494	0.44458762886597936	5.5082792879812335
chr4	UVSSA	1347230	1347760	0	531	80182	15270	80182	14739	0.0	5.4401248388628805
chr4	UVSSA	1347610	1347760	0	151	80182	15270	80182	15119	0.0	5.303393081553013
chr4	UVSSA	1347761	1347887	255	127	80182	15270	79927	15143	2.0078740157480315	5.278148319355478
chr4	FGFR3	1799801	1799812	0	12	12294	4866	12294	4854	0.0	2.5327564894932015
chr4	FGFR3	1801924	1802025	0	102	12294	4866	12294	4764	0.0	2.5806045340050376
chr4	FGFR3	1801987	1802025	0	39	12294	4866	12294	4827	0.0	2.5469235550031075
chr4	NSD2	1942433	1942565	3104	133	957502	19329	954398	19196	23.338345864661655	49.718587205667845
chr4	C4ORF48	2042069	2042175	0	107	332	544	332	437	0.0	0.7597254004576659
chr4	RNF4	2490412	2490502	0	91	366296	7130	366296	7039	0.0	52.03807358999858
chr4	RNF4	2469230	2469258	29	29	366296	7130	366267	7101	1.0	51.579636670891425
chr4	FAM193A	2695083	2695129	105	47	17487	6976	17382	6929	2.234042553191489	2.5085870977052966
chr4	FAM193A	2695130	2695142	0	13	17487	6976	17487	6963	0.0	2.5114174924601467
chr4	FAM193A	2695083	2695142	105	60	17487	6976	17382	6916	1.75	2.5133024869866976
chr4	SH3BP2	2823570	2823573	0	4	95348	12298	95348	12294	0.0	7.755653164145111
chr4	ADD1	2905016	2905108	1700	93	337989	11643	336289	11550	18.27956989247312	29.115930735930736
chr4	NOP14-AS1	2935736	2936890	6798	1155	505610	7475	498812	6320	5.885714285714286	78.9259493670886
chr4	NOP14-AS1	2936602	2936890	735	289	505610	7475	504875	7186	2.5432525951557095	70.25814082939048
chr4	HTT	3130000	3130047	0	48	186437	18141	186437	18093	0.0	10.304371856519095
chr4	HTT	3173132	3173331	0	200	186437	18141	186437	17941	0.0	10.391672704977426
chr4	HTT	3173219	3173331	0	113	186437	18141	186437	18028	0.0	10.341524295540271
chr4	HTT	3173132	3173218	0	87	186437	18141	186437	18054	0.0	10.326631217458734
chr4	DOK7	3476532	3476542	0	11	0	4047	0	4036	0.0	0.0
chr4	ZBTB49	4290314	4290352	0	39	7101	2879	7101	2840	0.0	2.5003521126760564
chr4	NSG1	4386644	4387173	0	530	1530	4365	1530	3835	0.0	0.39895697522816165
chr4	STX18-AS1	4542476	4542625	612	150	12842	21284	12230	21134	4.08	0.5786883694520678
chr4	STX18-AS1	4542427	4542625	612	199	12842	21284	12230	21085	3.0753768844221105	0.5800331989566042
chr4	STX18-AS1	4542427	4542475	0	49	12842	21284	12842	21235	0.0	0.6047562985636921
chr4	LINC01396	4847432	4847509	0	78	0	1303	0	1225	0.0	0.0
chr4	STK32B	5139779	5139817	0	39	221	5226	221	5187	0.0	0.042606516290726815
chr4	MRFAP1	6640709	6640755	112	47	391764	2186	391652	2139	2.382978723404255	183.10051425899954
chr4	AC093323.1	6674638	6674706	0	69	72998	2965	72998	2896	0.0	25.206491712707184
chr4	S100P	6693913	6694070	0	158	0	473	0	315	0.0	0.0
chr4	TADA2B	7043625	7043849	2905	225	169619	4547	166714	4322	12.911111111111111	38.5733456732994
chr4	SORCS2	7737173	7737214	0	42	9625	6346	9625	6304	0.0	1.5268083756345177
chr4	SH3TC1	8219450	8219530	0	81	0	8635	0	8554	0.0	0.0
chr4	GPR78	8580705	8581650	0	946	51	10176	51	9230	0.0	0.00552546045503792
chr4	CPZ	8599486	8599582	0	97	0	3293	0	3196	0.0	0.0
chr4	AC005699.1	11770467	11770475	0	9	510	4472	510	4463	0.0	0.1142729105982523
chr4	AC005699.1	11770476	11770688	0	213	510	4472	510	4259	0.0	0.11974641934726461
chr4	CPEB2	15007587	15007595	0	9	127634	7383	127634	7374	0.0	17.308652020612964
chr4	CC2D2A	15576625	15577094	0	470	12919	12486	12919	12016	0.0	1.0751498002663116
chr4	FAM200B	15681785	15681901	2271	117	145204	3683	142933	3566	19.41025641025641	40.08216489063376
chr4	FAM200B	15681785	15681968	2776	184	145204	3683	142428	3499	15.08695652173913	40.70534438410974
chr4	FAM200B	15681902	15681968	505	67	145204	3683	144699	3616	7.537313432835821	40.01631637168141
chr4	CD38	15824999	15825016	0	18	3128	6865	3128	6847	0.0	0.4568424127355046
chr4	NCAPG	17825562	17825567	2	6	50489	4868	50487	4862	0.3333333333333333	10.38399835458659
chr4	PACRGL	20700612	20700787	0	176	77872	7747	77872	7571	0.0	10.28556333377361
chr4	PACRGL	20700748	20700787	0	40	77872	7747	77872	7707	0.0	10.104061243025821
chr4	PACRGL	20700579	20700787	0	209	77872	7747	77872	7538	0.0	10.330591668877686
chr4	PACRGL	20700707	20700787	0	81	77872	7747	77872	7666	0.0	10.15810070440908
chr4	PACRGL	20700618	20700787	0	170	77872	7747	77872	7577	0.0	10.277418503365448
chr4	PACRGL	20700579	20700617	0	39	77872	7747	77872	7708	0.0	10.102750389206019
chr4	PACRGL	20700579	20700706	0	128	77872	7747	77872	7619	0.0	10.220763879774248
chr4	PACRGL	20700579	20700611	0	33	77872	7747	77872	7714	0.0	10.09489240342235
chr4	PACRGL	20700612	20700747	0	136	77872	7747	77872	7611	0.0	10.231507029299697
chr4	PACRGL	20700579	20700747	0	169	77872	7747	77872	7578	0.0	10.276062285563473
chr4	PACRGL	20700707	20700747	0	41	77872	7747	77872	7706	0.0	10.10537243706203
chr4	PACRGL	20700618	20700747	0	130	77872	7747	77872	7617	0.0	10.223447551529473
chr4	PACRGL	20700618	20700706	0	89	77872	7747	77872	7658	0.0	10.168712457560721
chr4	PACRGL	20700612	20700706	0	95	77872	7747	77872	7652	0.0	10.17668583376895
chr4	PACRGL	20700612	20700617	0	6	77872	7747	77872	7741	0.0	10.059682211600569
chr4	AC097512.1	22997614	22997709	0	96	0	7737	0	7641	0.0	0.0
chr4	ZCCHC4	25365073	25365166	0	94	6506	4425	6506	4331	0.0	1.5021934888016624
chr4	ANAPC4	25380446	25380479	0	34	63488	6012	63488	5978	0.0	10.620274339243894
chr4	ANAPC4	25405620	25405622	0	3	63488	6012	63488	6009	0.0	10.56548510567482
chr4	AC105290.1	25608902	25608936	0	35	0	793	0	758	0.0	0.0
chr4	RBPJ	26320816	26321048	85	233	196733	9040	196648	8807	0.3648068669527897	22.32860224821165
chr4	TBC1D19	26576798	26576829	0	32	3712	3917	3712	3885	0.0	0.9554697554697554
chr4	TBC1D19	26576820	26576829	0	10	3712	3917	3712	3907	0.0	0.9500895828001024
chr4	TBC1D19	26576798	26576819	0	22	3712	3917	3712	3895	0.0	0.9530166880616174
chr4	STIM2	26857683	26857768	0	86	120838	8406	120838	8320	0.0	14.523798076923077
chr4	LINC02364	28996727	28996871	0	145	0	1744	0	1599	0.0	0.0
chr4	LINC02497	31196416	31196461	0	46	0	646	0	600	0.0	0.0
chr4	LINC02616	37018668	37018694	0	27	0	3588	0	3561	0.0	0.0
chr4	LIAS	39459163	39459241	8169	79	91228	9122	83059	9043	103.40506329113924	9.1848943934535
chr4	LIAS	39467647	39468427	1739	781	91228	9122	89489	8341	2.2266325224071704	10.728809495264358
chr4	AC108471.2	39639257	39639294	30	38	4764	3742	4734	3704	0.7894736842105263	1.2780777537796977
chr4	AC108471.2	39639295	39639549	480	255	4764	3742	4284	3487	1.8823529411764706	1.2285632348723832
chr4	AC108471.2	39639257	39639549	510	293	4764	3742	4254	3449	1.7406143344709897	1.2334009857929835
chr4	UBE2K	39698303	39698390	134	88	575999	5157	575865	5069	1.5227272727272727	113.60524758334978
chr4	RHOH	40242835	40242846	0	12	204	6620	204	6608	0.0	0.030871670702179176
chr4	UCHL1	41264162	41264190	435	29	15787	2218	15352	2189	15.0	7.013248058474189
chr4	UCHL1	41257010	41257020	0	11	15787	2218	15787	2207	0.0	7.153149071137291
chr4	LIMCH1	41613099	41613104	0	6	0	10455	0	10449	0.0	0.0
chr4	TMEM33	41935263	41935310	0	48	344307	7774	344307	7726	0.0	44.56471654154802
chr4	AC080132.1	43763549	43763775	0	227	0	10484	0	10257	0.0	0.0
chr4	LINC02475	44017063	44017370	0	308	0	2986	0	2678	0.0	0.0
chr4	GUF1	44678586	44678787	0	202	42241	4473	42241	4271	0.0	9.890189651135566
chr4	NIPAL1	48016852	48016885	0	34	3111	3240	3111	3206	0.0	0.9703680598877106
chr4	OCIAD1	48831399	48831496	0	98	232704	3485	232704	3387	0.0	68.70504871567759
chr4	OCIAD1	48831250	48831496	0	247	232704	3485	232704	3238	0.0	71.86658431130327
chr4	OCIAD1	48831434	48831496	0	63	232704	3485	232704	3422	0.0	68.00233781414377
chr4	OCIAD1	48831254	48831496	0	243	232704	3485	232704	3242	0.0	71.77791486736582
chr4	OCIAD1	48831053	48831141	0	89	232704	3485	232704	3396	0.0	68.52296819787986
chr4	OCIAD1	48831250	48831398	0	149	232704	3485	232704	3336	0.0	69.75539568345324
chr4	OCIAD1	48831254	48831398	0	145	232704	3485	232704	3340	0.0	69.67185628742514
chr4	OCIAD1	48831399	48831433	0	35	232704	3485	232704	3450	0.0	67.4504347826087
chr4	OCIAD1	48831250	48831433	0	184	232704	3485	232704	3301	0.0	70.49500151469252
chr4	OCIAD1	48831254	48831433	0	180	232704	3485	232704	3305	0.0	70.40968229954615
chr4	OCIAD1	48831142	48831249	0	108	232704	3485	232704	3377	0.0	68.90849866745633
chr4	OCIAD1	48851976	48852020	76794	45	232704	3485	155910	3440	1706.5333333333333	45.32267441860465
chr4	OCIAD1	48831142	48831398	0	257	232704	3485	232704	3228	0.0	72.08921933085502
chr4	OCIAD1	48831142	48831496	0	355	232704	3485	232704	3130	0.0	74.34632587859424
chr4	OCIAD1	48831250	48831253	0	4	232704	3485	232704	3481	0.0	66.84975581729388
chr4	OCIAD1	48831142	48831253	0	112	232704	3485	232704	3373	0.0	68.99021642454788
chr4	OCIAD1	48832683	48832761	0	79	232704	3485	232704	3406	0.0	68.32178508514386
chr4	OCIAD1	48831497	48831531	0	35	232704	3485	232704	3450	0.0	67.4504347826087
chr4	OCIAD1	48831399	48831531	0	133	232704	3485	232704	3352	0.0	69.42243436754177
chr4	OCIAD1	48831434	48831531	0	98	232704	3485	232704	3387	0.0	68.70504871567759
chr4	DCUN1D4	51886639	51887244	0	606	0	6539	0	5933	0.0	0.0
chr4	SPATA18	52082511	52082560	0	50	0	4988	0	4938	0.0	0.0
chr4	DANCR	52713543	52713702	0	160	7182	7739	7182	7579	0.0	0.9476184193165326
chr4	FIP1L1	53377836	53377923	12	88	13287	4818	13275	4730	0.13636363636363635	2.806553911205074
chr4	FIP1L1	53453134	53453142	0	9	13287	4818	13287	4809	0.0	2.762944479101684
chr4	GSX2	54100708	54100918	0	211	0	1780	0	1569	0.0	0.0
chr4	KIT	54726039	54726050	0	12	0	5584	0	5572	0.0	0.0
chr4	TMEM165	55417986	55418164	0	179	92	6798	92	6619	0.0	0.013899380571083246
chr4	EXOC1L	55820128	55820147	0	20	0	684	0	664	0.0	0.0
chr4	EXOC1	55853798	55853953	0	156	31	5360	31	5204	0.0	0.00595695618754804
chr4	PAICS	56435929	56435975	0	47	8008	7527	8008	7480	0.0	1.0705882352941176
chr4	REST	56911090	56911536	0	447	918	7466	918	7019	0.0	0.13078786151873487
chr4	POLR2B	56977792	56977808	0	17	73	5303	73	5286	0.0	0.013810064320847523
chr4	IGFBP7-AS1	57201216	57201820	86	605	6326	3695	6240	3090	0.14214876033057852	2.0194174757281553
chr4	UBA6-AS1	67720633	67721051	0	419	0	13708	0	13289	0.0	0.0
chr4	UGT2B10	68816486	68816737	0	252	0	2762	0	2510	0.0	0.0
chr4	DCK	70993927	70994017	0	91	0	2944	0	2853	0.0	0.0
chr4	ALB	73404337	73404406	0	70	1078	3401	1078	3331	0.0	0.3236265385770039
chr4	EPGN	74309156	74309182	0	27	1326	3305	1326	3278	0.0	0.4045149481391092
chr4	EPGN	74313045	74313170	0	126	1326	3305	1326	3179	0.0	0.41711229946524064
chr4	THAP6	75542487	75542552	0	66	102	7138	102	7072	0.0	0.014423076923076924
chr4	FAM47E	76268769	76268813	0	45	102	3721	102	3676	0.0	0.027747551686615888
chr4	LINC01094	78662973	78663011	0	39	5248	5306	5248	5267	0.0	0.9963926333776343
chr4	LINC00989	79492624	79492774	0	151	3315	6191	3315	6040	0.0	0.5488410596026491
chr4	ENOPH1	82430885	82430913	0	29	90	2031	90	2002	0.0	0.04495504495504495
chr4	THAP9	82904932	82904941	0	10	24	4341	24	4331	0.0	0.005541445393673516
chr4	PTPN13	86764725	86764739	0	15	2860	9546	2860	9531	0.0	0.30007344454936524
chr4	NUDT9	87422618	87423012	0	395	0	3188	0	2793	0.0	0.0
chr4	NUDT9	87422676	87423012	0	337	0	3188	0	2851	0.0	0.0
chr4	NUDT9	87422618	87422675	0	58	0	3188	0	3130	0.0	0.0
chr4	MEPE	87840033	87840054	0	22	11191	2485	11191	2463	0.0	4.5436459602111245
chr4	AC093866.1	89551460	89551570	0	111	2466	5989	2466	5878	0.0	0.4195304525348758
chr4	RAP1GDS1	98343262	98343319	0	58	1020	5439	1020	5381	0.0	0.18955584463854303
chr4	METAP1	99005867	99005870	0	4	102	3921	102	3917	0.0	0.026040336992596374
chr4	AP002026.1	99290949	99291005	0	57	4466	7378	4466	7321	0.0	0.6100259527386969
chr4	AP002026.1	99267765	99267836	0	72	4466	7378	4466	7306	0.0	0.6112784013139885
chr4	MTTP	99564238	99564426	1045	189	1759	5317	714	5128	5.529100529100529	0.1392355694227769
chr4	FLJ20021	101347836	101348009	0	174	0	780	0	606	0.0	0.0
chr4	AC004052.1	104230493	104230839	0	347	0	1642	0	1295	0.0	0.0
chr4	TET2	105190487	105190505	0	19	198	12501	198	12482	0.0	0.015862842493190196
chr4	GSTCD	105709017	105709206	0	190	120	6140	120	5950	0.0	0.020168067226890758
chr4	GSTCD	105717779	105718039	0	261	120	6140	120	5879	0.0	0.020411634631740092
chr4	GSTCD	105710864	105710869	0	6	120	6140	120	6134	0.0	0.019563090968373
chr4	GSTCD	105710864	105711040	18	177	120	6140	102	5963	0.1016949152542373	0.017105483816870704
chr4	GSTCD	105710870	105711040	18	171	120	6140	102	5969	0.10526315789473684	0.017088289495727927
chr4	AIMP1	106320890	106321451	1989	562	132800	8611	130811	8049	3.53914590747331	16.2518325257796
chr4	AIMP1	106316595	106316809	0	215	132800	8611	132800	8396	0.0	15.817055740828966
chr4	AIMP1	106316645	106316809	0	165	132800	8611	132800	8446	0.0	15.723419370116032
chr4	AIMP1	106316595	106320713	128267	4119	132800	8611	4533	4492	31.14032532168002	1.0091273374888692
chr4	AIMP1	106316810	106320713	128267	3904	132800	8611	4533	4707	32.85527663934426	0.9630337794773741
chr4	AIMP1	106316645	106320713	128267	4069	132800	8611	4533	4542	31.522978618825263	0.9980184940554822
chr4	AIMP1	106316595	106316644	0	50	132800	8611	132800	8561	0.0	15.512206517930148
chr4	AIMP1	106320714	106321451	2439	738	132800	8611	130361	7873	3.3048780487804876	16.557982979804393
chr4	AIMP1	106320714	106320889	450	176	132800	8611	132350	8435	2.5568181818181817	15.690574985180794
chr4	LINC02173	106433576	106434068	0	493	0	928	0	435	0.0	0.0
chr4	LINC02173	106433755	106434068	0	314	0	928	0	614	0.0	0.0
chr4	SGMS2	107893383	107893477	0	95	0	7647	0	7552	0.0	0.0
chr4	SGMS2	107893383	107893658	0	276	0	7647	0	7371	0.0	0.0
chr4	SGMS2	107893478	107893658	0	181	0	7647	0	7466	0.0	0.0
chr4	RPL34	108620601	108620712	0	112	16168	2419	16168	2307	0.0	7.008235804074555
chr4	LARP7	112644769	112644871	0	103	0	3712	0	3609	0.0	0.0
chr4	ANK2	113293098	113293299	0	202	20092	17468	20092	17266	0.0	1.163674273137959
chr4	LINC02263	117361364	117361506	0	143	0	12565	0	12422	0.0	0.0
chr4	LINC02263	117372472	117372541	0	70	0	12565	0	12495	0.0	0.0
chr4	LINC02263	117371279	117371420	0	142	0	12565	0	12423	0.0	0.0
chr4	SNHG8	118278793	118279137	0	345	0	6609	0	6264	0.0	0.0
chr4	METTL14	118689405	118689457	0	53	0	6850	0	6797	0.0	0.0
chr4	SYNPO2	119031854	119032027	0	174	51	14453	51	14279	0.0	0.0035716786889838223
chr4	USP53	119267436	119267482	0	47	613	9528	613	9481	0.0	0.0646556270435608
chr4	AC093752.1	119458078	119458170	663	93	13109	5140	12446	5047	7.129032258064516	2.466019417475728
chr4	AC093752.1	119460821	119460827	0	7	13109	5140	13109	5133	0.0	2.5538671342294954
chr4	AC093752.1	119512921	119512970	44	50	13109	5140	13065	5090	0.88	2.5667976424361494
chr4	EXOSC9	121810074	121810099	0	26	956	3262	956	3236	0.0	0.2954264524103832
chr4	KIAA1109	122209205	122209337	0	133	0	18530	0	18397	0.0	0.0
chr4	KIAA1109	122334441	122334545	0	105	0	18530	0	18425	0.0	0.0
chr4	ADAD1	122379446	122379684	0	239	0	2712	0	2473	0.0	0.0
chr4	ADAD1	122379586	122379684	0	99	0	2712	0	2613	0.0	0.0
chr4	ADAD1	122379446	122379585	0	140	0	2712	0	2572	0.0	0.0
chr4	IL21-AS1	122619485	122619492	0	8	64	3485	64	3477	0.0	0.018406672418751796
chr4	IL21-AS1	122624718	122624725	0	8	64	3485	64	3477	0.0	0.018406672418751796
chr4	LINC01091	123650330	123650332	0	3	13800	11515	13800	11512	0.0	1.198749131341209
chr4	LINC01091	123827220	123827330	0	111	13800	11515	13800	11404	0.0	1.2101017186951946
chr4	LINC01091	123894844	123895002	408	159	13800	11515	13392	11356	2.5660377358490565	1.1792884818598097
chr4	LINC02379	126067421	126067480	0	60	0	1913	0	1853	0.0	0.0
chr4	PLK4	127886627	127886728	0	102	0	4400	0	4298	0.0	0.0
chr4	PLK4	127891116	127891196	0	81	0	4400	0	4319	0.0	0.0
chr4	JADE1	128810089	128810291	0	203	42296	9067	42296	8864	0.0	4.771660649819495
chr4	JADE1	128811397	128811403	7	7	42296	9067	42289	9060	1.0	4.66766004415011
chr4	SNHG27	131773693	131774369	0	677	0	4138	0	3461	0.0	0.0
chr4	AC107463.1	135097095	135097106	0	12	0	1126	0	1114	0.0	0.0
chr4	LINC00499	138313325	138313401	0	77	50	20150	50	20073	0.0	0.002490908185124296
chr4	AC093766.1	138800108	138800155	0	48	51	2903	51	2855	0.0	0.01786339754816112
chr4	AC093766.1	138790463	138790610	0	148	51	2903	51	2755	0.0	0.018511796733212342
chr4	SCOC	140373545	140373717	0	173	479	6302	479	6129	0.0	0.07815304291075216
chr4	ELMOD2	140524281	140524661	384	381	690	5869	306	5488	1.0078740157480315	0.05575801749271137
chr4	ZNF330	141221055	141221108	0	54	0	2504	0	2450	0.0	0.0
chr4	ZNF330	141221078	141221108	0	31	0	2504	0	2473	0.0	0.0
chr4	ZNF330	141221017	141221108	0	92	0	2504	0	2412	0.0	0.0
chr4	ZNF330	141222478	141222491	0	14	0	2504	0	2490	0.0	0.0
chr4	ZNF330	141221017	141221054	0	38	0	2504	0	2466	0.0	0.0
chr4	ZNF330	141221055	141221077	0	23	0	2504	0	2481	0.0	0.0
chr4	ZNF330	141221017	141221077	0	61	0	2504	0	2443	0.0	0.0
chr4	IL15	141636749	141637224	0	476	0	7886	0	7410	0.0	0.0
chr4	AC107223.1	143978983	143979068	0	86	2211	15940	2211	15854	0.0	0.13946007316765485
chr4	AC107223.1	143912374	143912449	0	76	2211	15940	2211	15864	0.0	0.13937216338880484
chr4	AC107223.1	143970535	143970538	0	4	2211	15940	2211	15936	0.0	0.13874246987951808
chr4	AC107223.1	143977463	143977730	0	268	2211	15940	2211	15672	0.0	0.14107963246554364
chr4	SMAD1	145481315	145481400	0	86	0	5209	0	5123	0.0	0.0
chr4	SMAD1	145482821	145482868	0	48	0	5209	0	5161	0.0	0.0
chr4	SMAD1	145482821	145483176	0	356	0	5209	0	4853	0.0	0.0
chr4	SMAD1	145482869	145483176	0	308	0	5209	0	4901	0.0	0.0
chr4	MMAA	145599305	145599354	0	50	12963	8168	12963	8118	0.0	1.5968218773096823
chr4	MMAA	145639579	145639866	0	288	12963	8168	12963	7880	0.0	1.64505076142132
chr4	LSM6	146175812	146176437	51	626	102	3947	51	3321	0.08146964856230032	0.015356820234869015
chr4	AC097450.1	147071336	147071436	0	101	0	2638	0	2537	0.0	0.0
chr4	RPS3A	151103042	151103079	0	38	0	2240	0	2202	0.0	0.0
chr4	RPS3A	151099715	151099887	0	173	0	2240	0	2067	0.0	0.0
chr4	RPS3A	151099837	151099887	0	51	0	2240	0	2189	0.0	0.0
chr4	RPS3A	151099867	151099887	0	21	0	2240	0	2219	0.0	0.0
chr4	RPS3A	151099801	151099887	0	87	0	2240	0	2153	0.0	0.0
chr4	RPS3A	151099713	151099887	0	175	0	2240	0	2065	0.0	0.0
chr4	RPS3A	151101086	151101162	0	77	0	2240	0	2163	0.0	0.0
chr4	RPS3A	151101013	151101162	0	150	0	2240	0	2090	0.0	0.0
chr4	RPS3A	151099713	151099714	0	2	0	2240	0	2238	0.0	0.0
chr4	RPS3A	151101013	151101085	0	73	0	2240	0	2167	0.0	0.0
chr4	RPS3A	151099715	151099836	0	122	0	2240	0	2118	0.0	0.0
chr4	RPS3A	151099801	151099836	0	36	0	2240	0	2204	0.0	0.0
chr4	RPS3A	151099713	151099836	0	124	0	2240	0	2116	0.0	0.0
chr4	RPS3A	151099715	151099866	0	152	0	2240	0	2088	0.0	0.0
chr4	RPS3A	151099837	151099866	0	30	0	2240	0	2210	0.0	0.0
chr4	RPS3A	151099801	151099866	0	66	0	2240	0	2174	0.0	0.0
chr4	RPS3A	151099713	151099866	0	154	0	2240	0	2086	0.0	0.0
chr4	RPS3A	151099715	151099800	0	86	0	2240	0	2154	0.0	0.0
chr4	RPS3A	151099713	151099800	0	88	0	2240	0	2152	0.0	0.0
chr4	RPS3A	151099888	151099966	0	79	0	2240	0	2161	0.0	0.0
chr4	AC107074.1	151799498	151799617	0	120	0	2369	0	2249	0.0	0.0
chr4	AC097375.3	151956255	151956256	0	2	201	3120	201	3118	0.0	0.06446440025657472
chr4	ARFIP1	152780092	152780226	0	135	0	3791	0	3656	0.0	0.0
chr4	TRIM2	153294429	153294485	0	57	1268	14876	1268	14819	0.0	0.08556582765368784
chr4	TRIM2	153322779	153322816	0	38	1268	14876	1268	14838	0.0	0.08545626095161073
chr4	TRIM2	153152283	153152617	0	335	1268	14876	1268	14541	0.0	0.08720170552231621
chr4	TRIM2	153152613	153152617	0	5	1268	14876	1268	14871	0.0	0.0852666263196826
chr4	TRIM2	153322817	153322828	0	12	1268	14876	1268	14864	0.0	0.08530678148546825
chr4	TRIM2	153322779	153322828	0	50	1268	14876	1268	14826	0.0	0.08552542830163226
chr4	TRIM2	153322829	153324148	0	1320	1268	14876	1268	13556	0.0	0.09353791678961346
chr4	TRIM2	153322817	153324148	0	1332	1268	14876	1268	13544	0.0	0.09362079149438866
chr4	TRIM2	153222760	153223039	0	280	1268	14876	1268	14596	0.0	0.08687311592217045
chr4	TRIM2	153257608	153257766	74	159	1268	14876	1194	14717	0.46540880503144655	0.08113066521709587
chr4	TRIM2	153257741	153257766	52	26	1268	14876	1216	14850	2.0	0.08188552188552188
chr4	TRIM2	153257608	153257740	22	133	1268	14876	1246	14743	0.16541353383458646	0.0845146849352235
chr4	TLR2	153687989	153688047	0	59	1265	3469	1265	3410	0.0	0.3709677419354839
chr4	NPY2R	155209066	155209069	0	4	0	3524	0	3520	0.0	0.0
chr4	AC097467.3	155305092	155305151	0	60	48	5378	48	5318	0.0	0.009025949605114705
chr4	GUCY1A1	155666966	155667199	0	234	102	10473	102	10239	0.0	0.009961910342806914
chr4	GUCY1A1	155667200	155667220	0	21	102	10473	102	10452	0.0	0.00975889781859931
chr4	GUCY1B1	155772698	155772753	0	56	0	3961	0	3905	0.0	0.0
chr4	GRIA2	157221012	157221130	0	119	0	8804	0	8685	0.0	0.0
chr4	GRIA2	157362934	157363047	0	114	0	8804	0	8690	0.0	0.0
chr4	GRIA2	157220726	157221130	0	405	0	8804	0	8399	0.0	0.0
chr4	TMEM144	158211575	158212220	0	646	0	7537	0	6891	0.0	0.0
chr4	TMEM144	158210587	158212220	0	1634	0	7537	0	5903	0.0	0.0
chr4	RXFP1	158572836	158572859	0	24	80	5710	80	5686	0.0	0.014069644741470278
chr4	RAPGEF2	159351134	159351181	0	48	0	13313	0	13265	0.0	0.0
chr4	MSMO1	165327765	165327946	0	182	0	2856	0	2674	0.0	0.0
chr4	MSMO1	165327947	165328122	0	176	0	2856	0	2680	0.0	0.0
chr4	TLL1	165992885	165992922	152	38	3920	8130	3768	8092	4.0	0.4656450815620366
chr4	CLCN3	169620683	169621063	0	381	929	8113	929	7732	0.0	0.12015002586652872
chr4	LINC02431	171055393	171055417	0	25	162	1769	162	1744	0.0	0.09288990825688073
chr4	LINC02431	171040696	171040699	0	4	162	1769	162	1765	0.0	0.09178470254957508
chr4	HAND2-AS1	173530540	173530632	0	93	0	14033	0	13940	0.0	0.0
chr4	HAND2-AS1	173582879	173583162	0	284	0	14033	0	13749	0.0	0.0
chr4	HAND2-AS1	173531782	173534122	0	2341	0	14033	0	11692	0.0	0.0
chr4	LINC02269	173699198	173699238	0	41	0	3896	0	3855	0.0	0.0
chr4	LINC02269	173928618	173928644	0	27	0	3896	0	3869	0.0	0.0
chr4	CEP44	174283944	174284061	459	118	3707	6686	3248	6568	3.889830508474576	0.4945188794153471
chr4	CEP44	174283944	174284140	459	197	3707	6686	3248	6489	2.3299492385786804	0.5005393743257821
chr4	CEP44	174284062	174284140	0	79	3707	6686	3707	6607	0.0	0.561071590737097
chr4	LINC02509	176875803	176875853	0	51	0	1085	0	1034	0.0	0.0
chr4	WWC2	183261386	183261532	0	147	255	10028	255	9881	0.0	0.025807104544074488
chr4	WWC2	183280898	183280969	0	72	255	10028	255	9956	0.0	0.025612695861791886
chr4	CDKN2AIP	183445635	183445665	0	31	51	2937	51	2906	0.0	0.017549896765313145
chr4	AC084871.3	184844204	184844468	0	265	102	1579	102	1314	0.0	0.0776255707762557
chr4	HELT	185018956	185019087	0	132	0	1239	0	1107	0.0	0.0
chr4	LINC02436	185055238	185055341	0	104	0	7067	0	6963	0.0	0.0
chr4	LINC02436	185071721	185072073	0	353	0	7067	0	6714	0.0	0.0
chr4	LINC02436	185062592	185062816	0	225	0	7067	0	6842	0.0	0.0
chr4	LINC02436	185070031	185070049	0	19	0	7067	0	7048	0.0	0.0
chr4	LINC02436	185071680	185071720	0	41	0	7067	0	7026	0.0	0.0
chr4	LINC02436	185086347	185086726	0	380	0	7067	0	6687	0.0	0.0
chr4	SNX25	185264499	185264610	0	112	1001	5091	1001	4979	0.0	0.2010443864229765
chr4	SNX25	185332714	185332759	0	46	1001	5091	1001	5045	0.0	0.19841427155599603
chr4	C4ORF47	185426397	185426421	0	25	969	1374	969	1349	0.0	0.7183098591549296
chr4	FAM149A	186144273	186144332	0	60	724	5237	724	5177	0.0	0.13984933359088275
chr4	FAM149A	186144591	186144715	0	125	724	5237	724	5112	0.0	0.14162754303599373
chr4	AC097521.1	187650560	187650661	14	102	1468	6484	1454	6382	0.13725490196078433	0.22782826700094014
chr4	LINC02434	188160103	188160119	0	17	0	1294	0	1277	0.0	0.0
chr4	LINC02434	188160120	188160123	0	4	0	1294	0	1290	0.0	0.0
chr4	LINC02434	188160103	188160123	0	21	0	1294	0	1273	0.0	0.0
chr4	LINC02434	188160120	188160332	0	213	0	1294	0	1081	0.0	0.0
chr4	FRG1	189942001	189942004	0	4	0	1559	0	1555	0.0	0.0
chr4	DUX4	190174251	190175056	0	806	0	2042	0	1236	0.0	0.0
chr5	PDCD6	306755	306760	11908	6	1015817	9301	1003909	9295	1984.6666666666667	108.0052716514255
chr5	AHRR	343965	343969	0	5	1391570	8659	1391570	8654	0.0	160.80078576380865
chr5	EXOC3	462308	462529	37435	222	695878	8157	658443	7935	168.62612612612614	82.97958412098299
chr5	SLC9A3-AS1	477337	477465	2750	129	96645	3334	93895	3205	21.31782945736434	29.296411856474258
chr5	AC124852.1	2114394	2114537	91	144	714	14286	623	14142	0.6319444444444444	0.04405317493989535
chr5	LINC01020	5034538	5034836	0	299	0	4734	0	4435	0.0	0.0
chr5	LINC01020	5059682	5060555	0	874	0	4734	0	3860	0.0	0.0
chr5	LINC01020	5034608	5034836	0	229	0	4734	0	4505	0.0	0.0
chr5	LINC01020	5034538	5034607	0	70	0	4734	0	4664	0.0	0.0
chr5	LINC01018	6582559	6582601	0	43	139452	7086	139452	7043	0.0	19.800085190969757
chr5	LINC01018	6582712	6582798	0	87	139452	7086	139452	6999	0.0	19.924560651521645
chr5	LINC01018	6583802	6583848	0	47	139452	7086	139452	7039	0.0	19.81133683761898
chr5	TENT4A	6714700	6715119	11519	420	638835	6281	627316	5861	27.426190476190477	107.03224705681625
chr5	TENT4A	6714943	6715119	1215	177	638835	6281	637620	6104	6.864406779661017	104.45937090432503
chr5	MTRR	7869190	7869215	0	26	287337	6426	287337	6400	0.0	44.89640625
chr5	MTRR	7873513	7873526	532	14	287337	6426	286805	6412	38.0	44.72941359950094
chr5	MTRR	7869299	7869718	170	420	287337	6426	287167	6006	0.40476190476190477	47.81335331335331
chr5	MIR4458HG	8451645	8451657	0	13	50304	7223	50304	7210	0.0	6.976976421636616
chr5	AC016576.1	13860516	13860555	0	40	765	3915	765	3875	0.0	0.19741935483870968
chr5	TRIO	14487731	14488260	15743	530	1180599	17006	1164856	16476	29.70377358490566	70.7001699441612
chr5	OTULIN	14681608	14681624	4074	17	542706	8760	538632	8743	239.64705882352942	61.6072286400549
chr5	AC010491.2	14728973	14729015	0	43	204	4580	204	4537	0.0	0.0449636323561825
chr5	LINC02217	17404321	17404729	0	409	0	8721	0	8312	0.0	0.0
chr5	LINC02217	17404089	17404729	0	641	0	8721	0	8080	0.0	0.0
chr5	LINC02217	17404593	17404729	0	137	0	8721	0	8584	0.0	0.0
chr5	LINC02217	17404352	17404729	0	378	0	8721	0	8343	0.0	0.0
chr5	LINC02217	17404089	17404320	0	232	0	8721	0	8489	0.0	0.0
chr5	LINC02217	17404321	17404592	0	272	0	8721	0	8449	0.0	0.0
chr5	LINC02217	17404352	17404592	0	241	0	8721	0	8480	0.0	0.0
chr5	LINC02217	17404321	17404351	0	31	0	8721	0	8690	0.0	0.0
chr5	LINC02223	17807977	17808103	0	127	88	7967	88	7840	0.0	0.011224489795918367
chr5	LINC02241	20807866	20807913	0	48	518	9146	518	9098	0.0	0.0569355902396131
chr5	LINC02241	20936985	20937257	0	273	518	9146	518	8873	0.0	0.058379353093654905
chr5	LINC02241	20612874	20613033	0	160	518	9146	518	8986	0.0	0.05764522590696639
chr5	LINC02241	20737102	20737145	0	44	518	9146	518	9102	0.0	0.056910569105691054
chr5	PURPL	27218049	27218333	0	285	102	4915	102	4630	0.0	0.022030237580993522
chr5	PURPL	27475696	27475781	0	86	102	4915	102	4829	0.0	0.02112238558707807
chr5	PURPL	27472453	27472519	0	67	102	4915	102	4848	0.0	0.02103960396039604
chr5	LINC02109	29153734	29153800	0	67	0	5628	0	5561	0.0	0.0
chr5	LINC02109	29153621	29153800	0	180	0	5628	0	5448	0.0	0.0
chr5	LINC02109	29162569	29162589	0	21	0	5628	0	5607	0.0	0.0
chr5	LINC02109	29164985	29165046	0	62	0	5628	0	5566	0.0	0.0
chr5	LINC02109	29153621	29153733	0	113	0	5628	0	5515	0.0	0.0
chr5	LINC02109	29162590	29162590	0	1	0	5628	0	5627	0.0	0.0
chr5	LINC02109	29162569	29162590	0	22	0	5628	0	5606	0.0	0.0
chr5	C5ORF22	31534326	31534417	3898	92	363258	3849	359360	3757	42.369565217391305	95.65078520095821
chr5	TARS1	33440777	33440791	30	15	669723	4126	669693	4111	2.0	162.90270007297494
chr5	RAI14	34757583	34757598	1509	16	323911	7612	322402	7596	94.3125	42.443654555028964
chr5	RAI14	34757599	34757614	1766	16	323911	7612	322145	7596	110.375	42.40982095839916
chr5	RAI14	34757583	34757614	3275	32	323911	7612	320636	7580	102.34375	42.30026385224274
chr5	RAI14	34656476	34656696	1733	221	323911	7612	322178	7391	7.841628959276018	43.590583141658776
chr5	RAI14	34684716	34684775	0	60	323911	7612	323911	7552	0.0	42.890757415254235
chr5	TTC23L	34839197	34839259	105	63	957	2550	852	2487	1.6666666666666667	0.3425814234016888
chr5	TTC23L	34839260	34839363	48	104	957	2550	909	2446	0.46153846153846156	0.37162714636140637
chr5	SPEF2	35694349	35694363	0	15	17900	16187	17900	16172	0.0	1.1068513480089044
chr5	SKP2	36170443	36170453	5207	11	760021	10355	754814	10344	473.3636363636364	72.97119102861562
chr5	NIPBL	37063979	37064019	1780	41	115810	12568	114030	12527	43.41463414634146	9.102738085734813
chr5	EGFLAM	38448380	38448419	0	40	0	6208	0	6168	0.0	0.0
chr5	OSMR	38846127	38846387	30852	261	1244800	7196	1213948	6935	118.20689655172414	175.04657534246576
chr5	AC025171.3	43024098	43024109	0	12	7929	1782	7929	1770	0.0	4.479661016949152
chr5	AC025171.3	43019317	43020098	1590	782	7929	1782	6339	1000	2.0332480818414322	6.339
chr5	ZNF131	43161607	43161613	585	7	325812	8233	325227	8226	83.57142857142857	39.536469730124
chr5	NNT	43602750	43602753	0	4	578620	10606	578620	10602	0.0	54.57649500094322
chr5	NNT	43602750	43602890	5870	141	578620	10606	572750	10465	41.63120567375886	54.73005255613951
chr5	NNT	43602754	43602890	5870	137	578620	10606	572750	10469	42.846715328467155	54.70914127423823
chr5	NNT	43602891	43603004	10206	114	578620	10606	568414	10492	89.52631578947368	54.175943576057946
chr5	NNT	43648183	43648440	1428	258	578620	10606	577192	10348	5.534883720930233	55.77812137611133
chr5	NNT	43613138	43613481	21375	344	578620	10606	557245	10262	62.13662790697674	54.30179302280257
chr5	NNT	43603295	43603487	3368	193	578620	10606	575252	10413	17.45077720207254	55.243637760491694
chr5	NNT	43613138	43613650	21477	513	578620	10606	557143	10093	41.865497076023395	55.20093133855147
chr5	NNT	43613482	43613650	102	169	578620	10606	578518	10437	0.6035502958579881	55.42952955830219
chr5	AC008966.1	53110149	53110405	0	257	0	7567	0	7310	0.0	0.0
chr5	LINC01033	54313603	54313750	41	148	41	3578	0	3430	0.27702702702702703	0.0
chr5	LINC01033	54401866	54403788	0	1923	41	3578	41	1655	0.0	0.024773413897280966
chr5	LINC01033	54400533	54400598	0	66	41	3578	41	3512	0.0	0.011674259681093395
chr5	SNX18	54519574	54519726	125	153	13675	6656	13550	6503	0.8169934640522876	2.0836536982930953
chr5	GPX8	55160244	55160396	603	153	13126	3883	12523	3730	3.9411764705882355	3.357372654155496
chr5	DDX4	55738190	55738340	0	151	0	3844	0	3693	0.0	0.0
chr5	DDX4	55767941	55768089	0	149	0	3844	0	3695	0.0	0.0
chr5	IL31RA	55908397	55908411	0	15	0	6391	0	6376	0.0	0.0
chr5	SETD9	56911503	56911536	0	34	0	2601	0	2567	0.0	0.0
chr5	PART1	60521644	60522966	0	1323	51	12711	51	11388	0.0	0.004478398314014752
chr5	NDUFAF2	60945383	60945428	0	46	0	6915	0	6869	0.0	0.0
chr5	C5ORF64	61748696	61748719	0	24	51271	22226	51271	22202	0.0	2.3092964597783983
chr5	C5ORF64	61750545	61751770	0	1226	51271	22226	51271	21000	0.0	2.4414761904761906
chr5	KIF2A	62352654	62352710	0	57	102	12836	102	12779	0.0	0.007981845214805541
chr5	KIF2A	62306537	62306583	0	47	102	12836	102	12789	0.0	0.007975604034717336
chr5	IPO11	62404104	62404156	0	53	102	7579	102	7526	0.0	0.01355301621047037
chr5	SHISAL2B	64694183	64694199	0	17	1275	1241	1275	1224	0.0	1.0416666666666667
chr5	NLN	65792602	65792655	0	54	51	10957	51	10903	0.0	0.004677611666513803
chr5	ERBIN	66044299	66044310	0	12	153	10160	153	10148	0.0	0.01507686243594797
chr5	AC112206.2	67797493	67797507	0	15	140	5824	140	5809	0.0	0.02410053365467378
chr5	PIK3R1	68215950	68215953	0	4	192	10428	192	10424	0.0	0.01841903300076746
chr5	CCNB1	69167284	69167485	0	202	77	2442	77	2240	0.0	0.034375
chr5	CENPH	69195751	69195791	28	41	2657	2227	2629	2186	0.6829268292682927	1.2026532479414456
chr5	MRPS36	69218112	69218115	20	4	1901	1563	1881	1559	5.0	1.2065426555484284
chr5	MRPS36	69217872	69218111	1040	240	1901	1563	861	1323	4.333333333333333	0.6507936507936508
chr5	CDK7	69234908	69235041	0	134	3451	2383	3451	2249	0.0	1.5344597598932859
chr5	CDK7	69254668	69254669	0	2	3451	2383	3451	2381	0.0	1.4493910121797564
chr5	RAD17	69369934	69370284	3098	351	22970	4169	19872	3818	8.826210826210826	5.204819277108434
chr5	GTF2H2C	69560243	69560403	0	161	552	6782	552	6621	0.0	0.08337109198006344
chr5	PTCD2	72320510	72321179	0	670	23015	11876	23015	11206	0.0	2.0538104586828485
chr5	BTF3	73498559	73498799	0	241	0	5245	0	5004	0.0	0.0
chr5	UTP15	73565913	73566186	0	274	32	6337	32	6063	0.0	0.005277915223486722
chr5	IQGAP2	76609180	76609230	0	51	252	7905	252	7854	0.0	0.03208556149732621
chr5	AGGF1	77030608	77030976	0	369	3169	5041	3169	4672	0.0	0.6782962328767124
chr5	ZBED3-AS1	77098670	77098747	0	78	51	16340	51	16262	0.0	0.0031361456155454435
chr5	TENT2	79612692	79612735	0	44	156	5274	156	5230	0.0	0.02982791586998088
chr5	TENT2	79612736	79612769	0	34	156	5274	156	5240	0.0	0.029770992366412213
chr5	TENT2	79612692	79612769	0	78	156	5274	156	5196	0.0	0.03002309468822171
chr5	THBS4	79998376	79998427	0	52	450	4635	450	4583	0.0	0.09818895919703251
chr5	CKMT2	81233378	81233381	0	4	1019	2343	1019	2339	0.0	0.4356562633604104
chr5	ZCCHC9	81301671	81301698	0	28	0	5131	0	5103	0.0	0.0
chr5	ZCCHC9	81301671	81305141	0	3471	0	5131	0	1660	0.0	0.0
chr5	ZCCHC9	81301699	81305141	0	3443	0	5131	0	1688	0.0	0.0
chr5	ZCCHC9	81301699	81302055	0	357	0	5131	0	4774	0.0	0.0
chr5	ZCCHC9	81301671	81302055	0	385	0	5131	0	4746	0.0	0.0
chr5	ATG10	81972307	81972591	0	285	255	5459	255	5174	0.0	0.049284885968303056
chr5	XRCC4	83077616	83077662	0	47	901	2656	901	2609	0.0	0.34534304331161364
chr5	EDIL3-DT	84387937	84388163	0	227	0	8926	0	8699	0.0	0.0
chr5	COX7C	86619443	86619496	264	54	3926	1972	3662	1918	4.888888888888889	1.9092805005213764
chr5	COX7C	86618054	86618130	0	77	3926	1972	3926	1895	0.0	2.0717678100263854
chr5	COX7C	86619497	86619878	0	382	3926	1972	3926	1590	0.0	2.469182389937107
chr5	COX7C	86619443	86619878	264	436	3926	1972	3662	1536	0.6055045871559633	2.3841145833333335
chr5	LINC02059	86746952	86747067	0	116	0	885	0	769	0.0	0.0
chr5	RASA1	87268991	87269055	0	65	51	5265	51	5200	0.0	0.009807692307692307
chr5	TMEM161B-AS1	88269028	88269119	0	92	613	27299	613	27207	0.0	0.022530966295438673
chr5	TMEM161B-AS1	88269076	88269119	0	44	613	27299	613	27255	0.0	0.022491286002568337
chr5	TMEM161B-AS1	88269618	88269687	0	70	613	27299	613	27229	0.0	0.022512762128612876
chr5	TMEM161B-AS1	88270586	88270741	0	156	613	27299	613	27143	0.0	0.02258409166267546
chr5	MEF2C-AS1	88904161	88904203	0	43	0	7887	0	7844	0.0	0.0
chr5	POLR3G	90497707	90497735	0	29	0	4035	0	4006	0.0	0.0
chr5	ADGRV1	90690959	90691041	0	83	22464	33926	22464	33843	0.0	0.66377094229235
chr5	AC114316.1	92329361	92329371	0	11	10597	7357	10597	7346	0.0	1.442553770759597
chr5	RHOBTB3	95713591	95713711	0	121	102	7954	102	7833	0.0	0.013021830716200689
chr5	CAST	96722699	96722718	0	20	716	12297	716	12277	0.0	0.058320436588743176
chr5	CAST	96703373	96703424	0	52	716	12297	716	12245	0.0	0.05847284605961617
chr5	ERAP2	96900190	96900245	0	56	0	6815	0	6759	0.0	0.0
chr5	ERAP2	96909765	96909809	0	45	0	6815	0	6770	0.0	0.0
chr5	PAM	102755349	102755469	0	121	2306	8786	2306	8665	0.0	0.26612810155799194
chr5	EPB41L4A-AS1	112160992	112161295	0	304	9333	3497	9333	3193	0.0	2.922956467272158
chr5	APC	112707650	112707882	0	233	201	12460	201	12227	0.0	0.016439028379815163
chr5	COMMD10	116092696	116092700	0	5	66	2453	66	2448	0.0	0.02696078431372549
chr5	HSD17B4	119477493	119477501	0	9	0	10487	0	10478	0.0	0.0
chr5	HSD17B4	119452634	119452821	0	188	0	10487	0	10299	0.0	0.0
chr5	FAM170A	119634253	119634734	0	482	0	1383	0	901	0.0	0.0
chr5	ZNF474	122129684	122129704	0	21	37276	2086	37276	2065	0.0	18.051331719128328
chr5	SNCAIP	122311783	122311797	0	15	3883	7286	3883	7271	0.0	0.5340393343419062
chr5	SNCAIP	122311783	122311838	0	56	3883	7286	3883	7230	0.0	0.5370677731673582
chr5	SNCAIP	122311798	122311838	0	41	3883	7286	3883	7245	0.0	0.5359558316080055
chr5	SNX2	122775212	122775762	0	551	0	8164	0	7613	0.0	0.0
chr5	SNX24	123002005	123002080	0	76	97	3491	97	3415	0.0	0.028404099560761346
chr5	LMNB1	126777245	126777867	0	623	0	2990	0	2367	0.0	0.0
chr5	LMNB1	126777253	126777867	0	615	0	2990	0	2375	0.0	0.0
chr5	LMNB1	126777245	126777252	0	8	0	2990	0	2982	0.0	0.0
chr5	ISOC1	129095049	129095075	0	27	0	1945	0	1918	0.0	0.0
chr5	ADAMTS19	129526457	129526515	0	59	0	5416	0	5357	0.0	0.0
chr5	CDC42SE2	131359548	131359558	0	11	0	4667	0	4656	0.0	0.0
chr5	RAD50	132575864	132575928	0	65	51	9711	51	9646	0.0	0.005287165664524155
chr5	RAD50	132557010	132557453	0	444	51	9711	51	9267	0.0	0.005503399158303658
chr5	RAD50	132557454	132557745	0	292	51	9711	51	9419	0.0	0.00541458753583183
chr5	UQCRQ	132866688	132866691	0	4	0	2072	0	2068	0.0	0.0
chr5	UQCRQ	132866688	132867035	0	348	0	2072	0	1724	0.0	0.0
chr5	TCF7	134115631	134115674	82	44	64848	7296	64766	7252	1.8636363636363635	8.930777716492003
chr5	TCF7	134116034	134116086	0	53	64848	7296	64848	7243	0.0	8.953196189424272
chr5	TCF7	134138165	134138237	0	73	64848	7296	64848	7223	0.0	8.97798698601689
chr5	JADE2	134525743	134526011	0	269	0	9892	0	9623	0.0	0.0
chr5	JADE2	134525997	134526011	0	15	0	9892	0	9877	0.0	0.0
chr5	JADE2	134576897	134577038	0	142	0	9892	0	9750	0.0	0.0
chr5	DDX46	134816604	134816606	0	3	204	9230	204	9227	0.0	0.022109027853039993
chr5	C5ORF24	134855163	134855327	0	165	0	3870	0	3705	0.0	0.0
chr5	TXNDC15	134874484	134874530	0	47	0	4783	0	4736	0.0	0.0
chr5	AC114296.1	135821947	135822151	0	205	0	2718	0	2513	0.0	0.0
chr5	TGFBI	136046496	136046556	0	61	51	5453	51	5392	0.0	0.009458456973293769
chr5	SMAD5	136132963	136133959	0	997	9	8791	9	7794	0.0	0.0011547344110854503
chr5	SMAD5	136133474	136133959	0	486	9	8791	9	8305	0.0	0.0010836845273931367
chr5	AC109439.1	136753973	136753976	0	4	244	2609	244	2605	0.0	0.09366602687140115
chr5	MYOT	137870526	137871007	102	482	5169	2836	5067	2354	0.21161825726141079	2.15250637213254
chr5	FAM53C	138341265	138341413	24	149	3276	6668	3252	6519	0.1610738255033557	0.49884951679705475
chr5	CTNNA1	138875598	138875738	3927	141	21341	8697	17414	8556	27.851063829787233	2.035296867695185
chr5	CTNNA1	138875607	138875738	3927	132	21341	8697	17414	8565	29.75	2.033158201984822
chr5	CTNNA1	138875598	138875606	0	9	21341	8697	21341	8688	0.0	2.456376611418048
chr5	MATR3	139274162	139274165	0	4	255	12741	255	12737	0.0	0.020020412970087147
chr5	MATR3	139293773	139293805	0	33	255	12741	255	12708	0.0	0.020066100094428708
chr5	MATR3	139293773	139294028	0	256	255	12741	255	12485	0.0	0.02042450941129355
chr5	MATR3	139293806	139294028	0	223	255	12741	255	12518	0.0	0.020370666240613518
chr5	MATR3	139294029	139294100	0	72	255	12741	255	12669	0.0	0.020127871181624436
chr5	MATR3	139294617	139294842	0	226	255	12741	255	12515	0.0	0.02037554934079105
chr5	MATR3	139294843	139294997	0	155	255	12741	255	12586	0.0	0.020260607023677102
chr5	PAIP2	139342617	139343406	0	790	51	3154	51	2364	0.0	0.021573604060913704
chr5	CXXC5	139675534	139675538	0	5	693	3537	693	3532	0.0	0.1962061155152888
chr5	PSD2	139822785	139822787	0	3	17900	4547	17900	4544	0.0	3.9392605633802815
chr5	PURA	140108101	140108219	0	119	0	12523	0	12404	0.0	0.0
chr5	AC011379.2	140167474	140167477	0	4	110	897	110	893	0.0	0.12318029115341546
chr5	SLC4A9	140365570	140365578	0	9	3484	3662	3484	3653	0.0	0.9537366548042705
chr5	ANKHD1	140538235	140538261	0	27	4597	11160	4597	11133	0.0	0.4129165543878559
chr5	TMCO6	140639564	140639608	0	45	140	3038	140	2993	0.0	0.046775810223855664
chr5	TMCO6	140639564	140639612	0	49	140	3038	140	2989	0.0	0.0468384074941452
chr5	TMCO6	140639609	140639612	0	4	140	3038	140	3034	0.0	0.04614370468029005
chr5	TMCO6	140644189	140644194	0	6	140	3038	140	3032	0.0	0.04617414248021108
chr5	TMCO6	140639852	140639864	18	13	140	3038	122	3025	1.3846153846153846	0.04033057851239669
chr5	HARS2	140691516	140691756	0	241	448186	3423	448186	3182	0.0	140.85040854808295
chr5	HARS2	140691938	140692017	0	80	448186	3423	448186	3343	0.0	134.0670056835178
chr5	ZMAT2	140703992	140704004	0	13	86743	1716	86743	1703	0.0	50.93540810334704
chr5	PCDHA1	140787893	140788684	2733	792	134968	5444	132235	4652	3.4507575757575757	28.425408426483234
chr5	PCDHA6	140829694	140830485	0	792	129154	6033	129154	5241	0.0	24.643007059721427
chr5	PCDHA10	140857648	140858436	127565	789	1031264	6271	903699	5482	161.67934093789606	164.8484129879606
chr5	PCDHA10	140984150	140984249	136	100	1031264	6271	1031128	6171	1.36	167.092529573813
chr5	PCDHB12	141208943	141209072	0	130	0	3129	0	2999	0.0	0.0
chr5	PCDHGA11	141423106	141423660	34	555	160269	5633	160235	5078	0.06126126126126126	31.55474596297755
chr5	PCDHGC3	141476147	141478546	255	2400	161187	5020	160932	2620	0.10625	61.42442748091603
chr5	RELL2	141637749	141638409	0	661	408	2590	408	1929	0.0	0.2115085536547434
chr5	RNF14	141969168	141969234	0	67	8869	4992	8869	4925	0.0	1.8008121827411168
chr5	RNF14	141969386	141969617	0	232	8869	4992	8869	4760	0.0	1.863235294117647
chr5	LINC01844	142757904	142757934	0	31	2193	3613	2193	3582	0.0	0.6122278056951423
chr5	LINC01844	142745719	142745722	0	4	2193	3613	2193	3609	0.0	0.6076475477971738
chr5	ARHGAP26	143207309	143207473	0	165	2330	17199	2330	17034	0.0	0.13678525302336503
chr5	ARHGAP26	143214086	143214088	0	3	2330	17199	2330	17196	0.0	0.13549662712258664
chr5	AC008700.1	145429926	145430633	0	708	1479	2327	1479	1619	0.0	0.913526868437307
chr5	FBXO38	148427723	148427947	0	225	703	8747	703	8522	0.0	0.08249237268246891
chr5	PCYOX1L	149358157	149358172	30	16	50264	4004	50234	3988	1.875	12.5962888665998
chr5	CARMN	149420545	149421068	226	524	691350	14357	691124	13833	0.4312977099236641	49.961974987349095
chr5	CARMN	149423310	149423639	0	330	691350	14357	691350	14027	0.0	49.28708918514294
chr5	CARMN	149424245	149424397	217	153	691350	14357	691133	14204	1.4183006535947713	48.657631653055475
chr5	TCOF1	150391658	150391795	0	138	3897	10045	3897	9907	0.0	0.39335823155344707
chr5	NDST1	150497980	150498239	316	260	10529	9532	10213	9272	1.2153846153846153	1.10148835202761
chr5	GPX3	151020855	151021253	0	399	0	2903	0	2504	0.0	0.0
chr5	G3BP1	151771913	151771964	0	52	0	10115	0	10063	0.0	0.0
chr5	G3BP1	151771965	151771976	0	12	0	10115	0	10103	0.0	0.0
chr5	G3BP1	151771913	151771976	0	64	0	10115	0	10051	0.0	0.0
chr5	G3BP1	151795529	151795575	0	47	0	10115	0	10068	0.0	0.0
chr5	G3BP1	151800262	151800346	0	85	0	10115	0	10030	0.0	0.0
chr5	G3BP1	151771913	151772036	0	124	0	10115	0	9991	0.0	0.0
chr5	G3BP1	151772033	151772036	0	4	0	10115	0	10111	0.0	0.0
chr5	G3BP1	151803997	151804141	0	145	0	10115	0	9970	0.0	0.0
chr5	G3BP1	151771965	151772036	0	72	0	10115	0	10043	0.0	0.0
chr5	G3BP1	151771977	151772036	0	60	0	10115	0	10055	0.0	0.0
chr5	G3BP1	151804142	151804162	0	21	0	10115	0	10094	0.0	0.0
chr5	G3BP1	151803997	151804162	0	166	0	10115	0	9949	0.0	0.0
chr5	G3BP1	151771965	151772040	0	76	0	10115	0	10039	0.0	0.0
chr5	G3BP1	151771977	151772040	0	64	0	10115	0	10051	0.0	0.0
chr5	G3BP1	151772037	151772040	0	4	0	10115	0	10111	0.0	0.0
chr5	G3BP1	151772033	151772040	0	8	0	10115	0	10107	0.0	0.0
chr5	G3BP1	151800001	151800043	0	43	0	10115	0	10072	0.0	0.0
chr5	G3BP1	151771965	151772032	0	68	0	10115	0	10047	0.0	0.0
chr5	G3BP1	151771977	151772032	0	56	0	10115	0	10059	0.0	0.0
chr5	G3BP1	151772568	151772668	0	101	0	10115	0	10014	0.0	0.0
chr5	G3BP1	151790991	151791062	0	72	0	10115	0	10043	0.0	0.0
chr5	G3BP1	151804142	151804203	0	62	0	10115	0	10053	0.0	0.0
chr5	G3BP1	151804163	151804203	0	41	0	10115	0	10074	0.0	0.0
chr5	G3BP1	151803997	151804203	0	207	0	10115	0	9908	0.0	0.0
chr5	AC008571.2	152720629	152720650	0	22	0	4211	0	4189	0.0	0.0
chr5	MFAP3	154039012	154039308	0	297	14507	7808	14507	7511	0.0	1.9314338969511384
chr5	MFAP3	154039067	154039308	0	242	14507	7808	14507	7566	0.0	1.9173936029606133
chr5	MFAP3	154039303	154039308	0	6	14507	7808	14507	7802	0.0	1.8593950269161754
chr5	MFAP3	154039012	154039066	0	55	14507	7808	14507	7753	0.0	1.8711466529085514
chr5	MFAP3	154039012	154039302	0	291	14507	7808	14507	7517	0.0	1.9298922442463748
chr5	MFAP3	154039067	154039302	0	236	14507	7808	14507	7572	0.0	1.9158742736397254
chr5	LARP1	154793923	154794000	0	78	256	8718	256	8640	0.0	0.02962962962962963
chr5	CNOT8	154858769	154858816	0	48	38	3723	38	3675	0.0	0.010340136054421769
chr5	CNOT8	154858798	154858816	0	19	38	3723	38	3704	0.0	0.010259179265658747
chr5	CNOT8	154858802	154858816	0	15	38	3723	38	3708	0.0	0.010248112189859764
chr5	CNOT8	154858526	154858543	0	18	38	3723	38	3705	0.0	0.010256410256410256
chr5	CNOT8	154858769	154858797	0	29	38	3723	38	3694	0.0	0.01028695181375203
chr5	CNOT8	154858769	154858801	0	33	38	3723	38	3690	0.0	0.010298102981029811
chr5	CNOT8	154858798	154858801	0	4	38	3723	38	3719	0.0	0.010217800484001076
chr5	CNOT8	154859838	154859873	0	36	38	3723	38	3687	0.0	0.010306482234879306
chr5	CNOT8	154858769	154858833	0	65	38	3723	38	3658	0.0	0.01038819026790596
chr5	CNOT8	154858817	154858833	0	17	38	3723	38	3706	0.0	0.01025364274150027
chr5	CNOT8	154858798	154858833	0	36	38	3723	38	3687	0.0	0.010306482234879306
chr5	CNOT8	154858802	154858833	0	32	38	3723	38	3691	0.0	0.010295312923327011
chr5	CYFIP2	157266196	157266584	72	389	269	10488	197	10099	0.18508997429305912	0.019506881869492027
chr5	TTC1	160009191	160009193	0	3	0	1802	0	1799	0.0	0.0
chr5	GABRA6	161687524	161687561	0	38	51	3163	51	3125	0.0	0.01632
chr5	GABRA1	161847412	161847466	0	55	0	6688	0	6633	0.0	0.0
chr5	GABRA1	161847714	161847786	0	73	0	6688	0	6615	0.0	0.0
chr5	GABRA1	161848970	161849035	0	66	0	6688	0	6622	0.0	0.0
chr5	GABRA1	161850668	161850685	0	18	0	6688	0	6670	0.0	0.0
chr5	GABRA1	161850681	161850685	0	5	0	6688	0	6683	0.0	0.0
chr5	GABRA1	161850668	161850680	0	13	0	6688	0	6675	0.0	0.0
chr5	GABRG2	162067642	162068106	0	465	490	19638	490	19173	0.0	0.02555677254472435
chr5	GABRG2	162149314	162151753	0	2440	490	19638	490	17198	0.0	0.028491685079660427
chr5	CCNG1	163437751	163437804	0	54	0	2779	0	2725	0.0	0.0
chr5	HMMR	163460367	163460422	0	56	0	3950	0	3894	0.0	0.0
chr5	HMMR	163460423	163460738	0	316	0	3950	0	3634	0.0	0.0
chr5	WWC1	168408624	168408653	0	30	1911	9685	1911	9655	0.0	0.19792853443811498
chr5	RARS1	168492792	168492847	0	56	825	3434	825	3378	0.0	0.24422735346358793
chr5	SLIT3-AS1	169018495	169018641	882	147	50726	3135	49844	2988	6.0	16.681392235609103
chr5	SPDL1	169588491	169588575	0	85	8623	4769	8623	4684	0.0	1.8409479077711357
chr5	LINC01366	170331484	170331577	0	94	510	2997	510	2903	0.0	0.1756803306923872
chr5	LINC01366	170331555	170331577	0	23	510	2997	510	2974	0.0	0.1714862138533961
chr5	LINC01366	170331559	170331577	0	19	510	2997	510	2978	0.0	0.1712558764271323
chr5	LINC01366	170331484	170331554	0	71	510	2997	510	2926	0.0	0.17429938482570062
chr5	LINC01366	170331484	170331558	0	75	510	2997	510	2922	0.0	0.17453798767967146
chr5	LINC01366	170331555	170331558	0	4	510	2997	510	2993	0.0	0.17039759438690277
chr5	NPM1	171391425	171391609	0	185	7984	6517	7984	6332	0.0	1.260897030953885
chr5	NPM1	171392979	171392982	0	4	7984	6517	7984	6513	0.0	1.2258559803469984
chr5	RPL26L1	172959469	172959514	0	46	0	1071	0	1025	0.0	0.0
chr5	AC016573.1	173444161	173444294	139	134	3392	1709	3253	1575	1.037313432835821	2.0653968253968253
chr5	MSX2	174725039	174725067	0	29	51	2226	51	2197	0.0	0.02321347291761493
chr5	SFXN1	175478640	175478667	0	28	102	7421	102	7393	0.0	0.013796834843771135
chr5	CPLX2	175871706	175872199	0	494	22789	7033	22789	6539	0.0	3.485089463220676
chr5	CPLX2	175878281	175878571	0	291	22789	7033	22789	6742	0.0	3.3801542568970633
chr5	FAM153B	176061269	176061343	0	75	35646	5362	35646	5287	0.0	6.742197843767732
chr5	FAM153B	176087206	176087255	0	50	35646	5362	35646	5312	0.0	6.710466867469879
chr5	AC139491.5	176124106	176124120	0	15	0	4570	0	4555	0.0	0.0
chr5	EIF4E1B	176642166	176642177	0	12	2879	3096	2879	3084	0.0	0.9335278858625162
chr5	EIF4E1B	176631052	176631064	0	13	2879	3096	2879	3083	0.0	0.9338306843983133
chr5	TSPAN17	176656126	176656134	18	9	249	4684	231	4675	2.0	0.04941176470588235
chr5	TSPAN17	176656925	176656956	0	32	249	4684	249	4652	0.0	0.05352536543422184
chr5	TSPAN17	176647703	176647713	0	11	249	4684	249	4673	0.0	0.053284827733789855
chr5	FGFR4	177087019	177087033	0	15	2880	4774	2880	4759	0.0	0.6051691531834419
chr5	FGFR4	177093178	177093331	10	154	2880	4774	2870	4620	0.06493506493506493	0.6212121212121212
chr5	FGFR4	177093502	177093551	0	50	2880	4774	2880	4724	0.0	0.6096528365791702
chr5	FGFR4	177087019	177087077	0	59	2880	4774	2880	4715	0.0	0.6108165429480382
chr5	FGFR4	177087034	177087077	0	44	2880	4774	2880	4730	0.0	0.6088794926004228
chr5	NSD1	177169429	177169644	0	216	432	15548	432	15332	0.0	0.02817636316201409
chr5	NSD1	177266658	177266671	0	14	432	15548	432	15534	0.0	0.027809965237543453
chr5	NSD1	177266658	177266729	0	72	432	15548	432	15476	0.0	0.02791418971310416
chr5	NSD1	177266672	177266729	0	58	432	15548	432	15490	0.0	0.02788896061975468
chr5	TMED9	177593711	177593775	0	65	974	3066	974	3001	0.0	0.3245584805064978
chr5	AC106795.1	177882753	177882873	0	121	634	3867	634	3746	0.0	0.16924719701014415
chr5	FAM153CP	178006986	178007060	0	75	87124	18718	87124	18643	0.0	4.673282197071287
chr5	RMND5B	178138259	178138396	120	138	14189	6205	14069	6067	0.8695652173913043	2.318938519861546
chr5	RMND5B	178131055	178131376	0	322	14189	6205	14189	5883	0.0	2.4118646948835627
chr5	HNRNPAB	178209433	178209447	0	15	102	2125	102	2110	0.0	0.04834123222748815
chr5	HNRNPAB	178209442	178209447	0	6	102	2125	102	2119	0.0	0.04813591316658802
chr5	HNRNPAB	178209433	178209441	0	9	102	2125	102	2116	0.0	0.048204158790170135
chr5	ZNF454	178941387	178941444	0	58	1303	2668	1303	2610	0.0	0.4992337164750958
chr5	ZNF879	179023905	179023917	0	13	63010	3802	63010	3789	0.0	16.629717603589338
chr5	CANX	179698604	179698825	153	222	108795	6294	108642	6072	0.6891891891891891	17.892292490118578
chr5	CANX	179699006	179699049	31	44	108795	6294	108764	6250	0.7045454545454546	17.40224
chr5	CANX	179699050	179699102	0	53	108795	6294	108795	6241	0.0	17.432302515622496
chr5	CANX	179699006	179699102	31	97	108795	6294	108764	6197	0.31958762886597936	17.55107309988704
chr5	CNOT6	180564579	180564593	0	15	56	6531	56	6516	0.0	0.008594229588704727
chr5	LINC00847	180830830	180830867	0	38	213	5657	213	5619	0.0	0.037907100907634814
chr5	LINC00847	180831230	180831941	0	712	213	5657	213	4945	0.0	0.04307381193124368
chr5	LINC00847	180831807	180831941	0	135	213	5657	213	5522	0.0	0.0385729808040565
chr5	LINC00847	180835003	180835090	0	88	213	5657	213	5569	0.0	0.0382474411923146
chr5	BTNL8	180947626	180947755	0	130	2178	3933	2178	3803	0.0	0.5727057586116224
chr5	TRIM7-AS1	181198272	181198276	0	5	0	1489	0	1484	0.0	0.0
chr5	TRIM52-AS1	181263767	181263789	0	23	0	1413	0	1390	0.0	0.0
chr5	AC138035.1	181316487	181316497	0	11	0	1813	0	1802	0.0	0.0
chr5	ZDHHC11B	751132	751139	0	8	4955	5638	4955	5630	0.0	0.8801065719360568
chr5	ZDHHC11	843599	843606	0	8	26627	4756	26627	4748	0.0	5.60804549283909
chr5	BRD9	892086	892507	8342	422	772955	9010	764613	8588	19.767772511848342	89.03272007452259
chr5	BRD9	892086	892419	6119	334	772955	9010	766836	8676	18.320359281437124	88.38589211618257
chr5	BRD9	892420	892507	2223	88	772955	9010	770732	8922	25.261363636363637	86.38556377493835
chr5	SLC12A7	1075890	1076136	152	247	195195	6029	195043	5782	0.6153846153846154	33.73279142165341
chr5	CTD-3080P12.3	1175960	1175969	0	10	3	1766	3	1756	0.0	0.0017084282460136675
chr5	LINC01511	1379561	1379663	0	103	0	3376	0	3273	0.0	0.0
chr5	SDHAP3	1574171	1574180	9	10	28202	3085	28193	3075	0.9	9.168455284552845
chr5	AC026412.1	1632643	1632843	254	201	44766	3371	44512	3170	1.263681592039801	14.041640378548896
chr5	MRPL36	1799791	1799808	0	18	338907	1378	338907	1360	0.0	249.19632352941176
chr5	MRPL36	1799770	1799790	0	21	338907	1378	338907	1357	0.0	249.7472365512159
chr5	MRPL36	1799770	1799808	0	39	338907	1378	338907	1339	0.0	253.10455563853623
chr5	IRX4	1886861	1887060	0	200	51	2906	51	2706	0.0	0.018847006651884702
chr5	CTD-2297D10.2	5139118	5139249	0	132	134	6700	134	6568	0.0	0.020401948842874544
chr5	LINC02123	7347875	7347971	0	97	0	1581	0	1484	0.0	0.0
chr5	LINC02112	9903524	9903636	0	113	0	2631	0	2518	0.0	0.0
chr5	LINC02112	9870099	9870105	0	7	0	2631	0	2624	0.0	0.0
chr5	ATPSCKMT	10236477	10236520	139	44	131887	3292	131748	3248	3.159090909090909	40.5628078817734
chr5	ATPSCKMT	10239041	10239065	0	25	131887	3292	131887	3267	0.0	40.36945209672482
chr5	CTNND2	11588734	11588744	0	11	114	7298	114	7287	0.0	0.015644298065047343
chr5	MYO10	16711120	16711158	865	39	707994	13792	707129	13753	22.17948717948718	51.416345524612815
chr5	CDH18	19877993	19878030	0	38	7295	6506	7295	6468	0.0	1.1278602350030922
chr5	LINC02146	20615518	20616281	0	764	0	2293	0	1529	0.0	0.0
chr5	LINC02146	20615518	20616121	0	604	0	2293	0	1689	0.0	0.0
chr5	LINC02146	20616122	20616281	0	160	0	2293	0	2133	0.0	0.0
chr5	LINC02064	29384296	29384318	0	23	0	4274	0	4251	0.0	0.0
chr5	GOLPH3	32173745	32173808	72	64	1675897	2746	1675825	2682	1.125	624.8415361670395
chr5	AMACR	33993947	33994076	0	130	91296	2515	91296	2385	0.0	38.27924528301887
chr5	C1QTNF3	34042822	34043040	0	219	10659	4201	10659	3982	0.0	2.6767955801104972
chr5	UGT3A1	35954818	35955643	0	826	0	8317	0	7491	0.0	0.0
chr5	UGT3A1	35990964	35991145	0	182	0	8317	0	8135	0.0	0.0
chr5	NADK2	36241962	36242094	101	133	259915	5032	259814	4899	0.7593984962406015	53.034088589508066
chr5	AC008957.1	36705679	36705719	0	41	63	3903	63	3862	0.0	0.01631279129984464
chr5	NUP155	37370665	37370819	1461	155	551308	9160	549847	9005	9.425806451612903	61.060188784008886
chr5	GDNF	37834645	37834722	0	78	154622	4634	154622	4556	0.0	33.93810359964881
chr5	EGFLAM-AS2	38403234	38403397	0	164	0	1411	0	1247	0.0	0.0
chr5	FYB1	39125971	39125996	0	26	0	7176	0	7150	0.0	0.0
chr5	DAB2	39392203	39392363	0	161	294632	7579	294632	7418	0.0	39.718522512806686
chr5	OXCT1	41794421	41794539	0	119	602535	4120	602535	4001	0.0	150.5961009747563
chr5	AC008875.3	42990838	42991151	9061	314	60288	2687	51227	2373	28.856687898089174	21.587442056468603
chr5	PAIP1	43529785	43529795	0	11	210208	3400	210208	3389	0.0	62.02655650634406
chr5	PAIP1	43556581	43556817	4194	237	210208	3400	206014	3163	17.696202531645568	65.13246917483401
chr5	AC025180.1	52978251	52978266	0	16	51	2429	51	2413	0.0	0.021135515955242438
chr5	MOCS2	53109250	53109710	0	461	83	5555	83	5094	0.0	0.01629367883784845
chr5	AC034238.1	55023137	55023296	0	160	0	4159	0	3999	0.0	0.0
chr5	CDC20B	55119800	55119811	0	12	51	4537	51	4525	0.0	0.011270718232044199
chr5	MCIDAS	55227018	55227204	0	187	116	1961	116	1774	0.0	0.06538895152198422
chr5	MCIDAS	55222946	55222949	0	4	116	1961	116	1957	0.0	0.05927439959121104
chr5	CCNO	55232766	55233141	58837	376	157583	1740	98746	1364	156.48138297872342	72.39442815249267
chr5	SLC38A9	55633694	55633752	0	59	204	8550	204	8491	0.0	0.024025438699799787
chr5	SLC38A9	55711351	55711450	0	100	204	8550	204	8450	0.0	0.024142011834319528
chr5	IL6ST	55948101	55948896	0	796	0	10136	0	9340	0.0	0.0
chr5	LINC01948	56481527	56481551	0	25	2486	4731	2486	4706	0.0	0.5282617934551637
chr5	MIER3	56952093	56952109	0	17	0	5712	0	5695	0.0	0.0
chr5	LINC02101	58122074	58122317	0	244	0	2551	0	2307	0.0	0.0
chr5	ELOVL7	60771902	60771947	0	46	2507	4475	2507	4429	0.0	0.5660419959358771
chr5	ERCC8	60903566	60903646	0	81	51	13538	51	13457	0.0	0.0037898491491417108
chr5	DIMT1	62398428	62398509	0	82	0	6179	0	6097	0.0	0.0
chr5	ADAMTS6	65262803	65262815	10	13	54899	8581	54889	8568	0.7692307692307693	6.406279178338002
chr5	CENPK	65561462	65561495	0	34	0	3192	0	3158	0.0	0.0
chr5	TRIM23	65611602	65611755	0	154	8	3039	8	2885	0.0	0.0027729636048526864
chr5	TRIM23	65591842	65591870	0	29	8	3039	8	3010	0.0	0.0026578073089701
chr5	CCDC125	69332648	69332763	706	116	17679	7594	16973	7478	6.086206896551724	2.2697245252741376
chr5	TAF9	69369164	69369226	630	63	120394	2120	119764	2057	10.0	58.2226543509966
chr5	TAF9	69368824	69369226	2345	403	120394	2120	118049	1717	5.818858560794045	68.75305765870705
chr5	TAF9	69368824	69369163	1715	340	120394	2120	118679	1780	5.044117647058823	66.67359550561798
chr5	GTF2H2	71067493	71067653	0	161	0	5742	0	5581	0.0	0.0
chr5	GTF2H2	71067295	71067492	0	198	0	5742	0	5544	0.0	0.0
chr5	MRPS27	72320148	72320179	0	32	1049	5031	1049	4999	0.0	0.20984196839367875
chr5	MRPS27	72320148	72320232	0	85	1049	5031	1049	4946	0.0	0.2120905782450465
chr5	MRPS27	72320180	72320232	0	53	1049	5031	1049	4978	0.0	0.21072719967858577
chr5	AC063979.1	72770627	72770708	0	82	0	1828	0	1746	0.0	0.0
chr5	ENC1	74637493	74637563	0	71	59959	8243	59959	8172	0.0	7.337126774351444
chr5	FAM169A	74866750	74866818	0	69	1366	6891	1366	6822	0.0	0.20023453532688362
chr5	ANKRD31	75236365	75236581	0	217	102	6335	102	6118	0.0	0.016672115070284408
chr5	CERT1	75385901	75385946	0	46	0	10692	0	10646	0.0	0.0
chr5	CERT1	75511111	75511427	0	317	0	10692	0	10375	0.0	0.0
chr5	CERT1	75381071	75381143	0	73	0	10692	0	10619	0.0	0.0
chr5	CERT1	75425291	75425359	0	69	0	10692	0	10623	0.0	0.0
chr5	CERT1	75425269	75425359	0	91	0	10692	0	10601	0.0	0.0
chr5	CERT1	75425269	75425290	0	22	0	10692	0	10670	0.0	0.0
chr5	POC5	75712375	75712378	0	4	51	3430	51	3426	0.0	0.0148861646234676
chr5	F2RL2	76623166	76623295	0	130	0	3410	0	3280	0.0	0.0
chr5	WDR41	77432892	77433083	0	192	20263	5048	20263	4856	0.0	4.172775947281713
chr5	WDR41	77489456	77489549	0	94	20263	5048	20263	4954	0.0	4.09023011707711
chr5	WDR41	77459049	77459060	0	12	20263	5048	20263	5036	0.0	4.0236298649722
chr5	WDR41	77492158	77492168	0	11	20263	5048	20263	5037	0.0	4.0228310502283104
chr5	AP3B1	78294439	78294450	0	12	16168	5482	16168	5470	0.0	2.9557586837294334
chr5	AC008771.1	80487772	80487776	0	5	255	8624	255	8619	0.0	0.029585798816568046
chr5	CCNH	87412434	87412676	0	243	0	4875	0	4632	0.0	0.0
chr5	TMEM161B	88268720	88268786	0	67	4531	9091	4531	9024	0.0	0.5021054964539007
chr5	TMEM161B	88205800	88205812	0	13	4531	9091	4531	9078	0.0	0.49911874862304473
chr5	TMEM161B	88197668	88198974	969	1307	4531	9091	3562	7784	0.7413925019127774	0.45760534429599176
chr5	TMEM161B	88205753	88205812	0	60	4531	9091	4531	9031	0.0	0.5017163104861034
chr5	TMEM161B	88205753	88205799	0	47	4531	9091	4531	9044	0.0	0.5009951348960637
chr5	LINC00461	88672762	88672963	0	202	0	11943	0	11741	0.0	0.0
chr5	MEF2C	88751856	88751864	0	9	0	5849	0	5840	0.0	0.0
chr5	MEF2C	88882954	88883047	0	94	0	5849	0	5755	0.0	0.0
chr5	MEF2C	88877937	88877940	0	4	0	5849	0	5845	0.0	0.0
chr5	CETN3	90405684	90405687	0	4	0	3096	0	3092	0.0	0.0
chr5	CETN3	90399357	90399470	0	114	0	3096	0	2982	0.0	0.0
chr5	LUCAT1	91314079	91314163	0	85	0	15454	0	15369	0.0	0.0
chr5	LUCAT1	91313961	91314078	0	118	0	15454	0	15336	0.0	0.0
chr5	LUCAT1	91313961	91314163	0	203	0	15454	0	15251	0.0	0.0
chr5	LUCAT1	91311645	91312293	0	649	0	15454	0	14805	0.0	0.0
chr5	NR2F1-AS1	93581141	93581179	0	39	3564	22614	3564	22575	0.0	0.15787375415282393
chr5	NR2F1-AS1	93580466	93581179	0	714	3564	22614	3564	21900	0.0	0.16273972602739725
chr5	NR2F1-AS1	93580466	93581140	0	675	3564	22614	3564	21939	0.0	0.16245043073977847
chr5	NR2F1-AS1	93585328	93585382	0	55	3564	22614	3564	22559	0.0	0.15798572631765592
chr5	NR2F1-AS1	93422250	93422253	0	4	3564	22614	3564	22610	0.0	0.1576293675364883
chr5	NR2F1-AS1	93422250	93422308	0	59	3564	22614	3564	22555	0.0	0.15801374418089115
chr5	NR2F1-AS1	93422254	93422308	0	55	3564	22614	3564	22559	0.0	0.15798572631765592
chr5	NR2F1-AS1	93543616	93543687	0	72	3564	22614	3564	22542	0.0	0.15810487090763908
chr5	TTC37	95554880	95554934	0	55	550	10468	550	10413	0.0	0.052818592144434844
chr5	SPATA9	95682793	95682817	0	25	39	2937	39	2912	0.0	0.013392857142857142
chr5	RIOK2	97182800	97183124	0	325	0	4454	0	4129	0.0	0.0
chr5	LINC01846	98160946	98161146	0	201	0	1008	0	807	0.0	0.0
chr5	RGMB-AS1	98772621	98772965	0	345	0	963	0	618	0.0	0.0
chr5	SLCO6A1	102480176	102480343	0	168	51	2803	51	2635	0.0	0.01935483870967742
chr5	NUDT12	103560042	103560095	0	54	0	4307	0	4253	0.0	0.0
chr5	AC008505.1	103886340	103886373	0	34	0	4442	0	4408	0.0	0.0
chr5	AC099520.1	104773612	104773731	0	120	0	4954	0	4834	0.0	0.0
chr5	STARD4	111501001	111501084	0	84	205435	5691	205435	5607	0.0	36.6390226502586
chr5	STARD4	111512384	111512389	0	6	205435	5691	205435	5685	0.0	36.1363236587511
chr5	NREP	111757319	111757376	0	58	153	9126	153	9068	0.0	0.01687251874724305
chr5	NREP	111757319	111757327	0	9	153	9126	153	9117	0.0	0.01678183613030602
chr5	NREP	111757328	111757376	0	49	153	9126	153	9077	0.0	0.016855789357717307
chr5	NREP	111757931	111757943	0	13	153	9126	153	9113	0.0	0.0167892022385603
chr5	TMED7	115625600	115625856	0	257	3908	4059	3908	3802	0.0	1.0278800631246712
chr5	CDO1	115816227	115816582	0	356	0	1902	0	1546	0.0	0.0
chr5	ATG12	115840817	115841388	204	572	3202	7572	2998	7000	0.35664335664335667	0.42828571428571427
chr5	SEMA6A	116536297	116536381	0	85	29	10571	29	10486	0.0	0.0027655922181956897
chr5	AC010267.1	116825528	116825731	0	204	102	2512	102	2308	0.0	0.04419410745233969
chr5	LINC02208	118521171	118522725	438	1555	1866	5937	1428	4382	0.28167202572347266	0.3258785942492013
chr5	LOX	122076892	122077090	0	199	0	5516	0	5317	0.0	0.0
chr5	LINC02201	122705007	122705424	0	418	13136	3758	13136	3340	0.0	3.932934131736527
chr5	CEP120	123388303	123388430	0	128	0	13045	0	12917	0.0	0.0
chr5	CEP120	123422466	123422948	0	483	0	13045	0	12562	0.0	0.0
chr5	CEP120	123403216	123403254	0	39	0	13045	0	13006	0.0	0.0
chr5	LINC01170	124438388	124438393	0	6	45	3859	45	3853	0.0	0.011679211004412146
chr5	ZNF608	124744083	124744411	0	329	3	6892	3	6563	0.0	0.0004571080298643913
chr5	AC011416.3	127229683	127229713	0	31	566	1800	566	1769	0.0	0.31995477671000566
chr5	AC011416.3	127228850	127228859	0	10	566	1800	566	1790	0.0	0.31620111731843575
chr5	AC011416.4	127290577	127290612	0	36	1989	7226	1989	7190	0.0	0.27663421418636996
chr5	LINC01184	128082734	128082968	0	235	51	12548	51	12313	0.0	0.004141963778120685
chr5	LINC01184	128062369	128062372	0	4	51	12548	51	12544	0.0	0.004065688775510204
chr5	HINT1	131165059	131165093	0	35	147	6082	147	6047	0.0	0.02430957499586572
chr5	HINT1	131162028	131162062	0	35	147	6082	147	6047	0.0	0.02430957499586572
chr5	RAPGEF6	131479512	131479611	102	100	2245	11266	2143	11166	1.02	0.19192190578542004
chr5	ACSL6	131994030	131994134	0	105	64616	15803	64616	15698	0.0	4.1161931456236465
chr5	ACSL6	132011769	132011819	0	51	64616	15803	64616	15752	0.0	4.102082275266633
chr5	P4HA2	132226696	132227084	2803	389	35065	9992	32262	9603	7.205655526992288	3.3595751327710093
chr5	P4HA2	132226696	132226930	2185	235	35065	9992	32880	9757	9.297872340425531	3.3698882853336065
chr5	P4HA2	132227538	132227788	1290	251	35065	9992	33775	9741	5.139442231075697	3.467303151627143
chr5	P4HA2	132226931	132227084	618	154	35065	9992	34447	9838	4.012987012987013	3.5014230534661515
chr5	IRF1	132490001	132490048	0	48	255	5641	255	5593	0.0	0.04559270516717325
chr5	SEPTIN8	132777675	132777756	0	82	0	4865	0	4783	0.0	0.0
chr5	C5ORF15	133968445	133968524	46356	80	141397	2305	95041	2225	579.45	42.71505617977528
chr5	SKP1	134176685	134176853	0	169	122297	12086	122297	11917	0.0	10.262398254594277
chr5	SAR1B	134613009	134613074	0	66	183	10558	183	10492	0.0	0.01744186046511628
chr5	SAR1B	134613009	134613012	0	4	183	10558	183	10554	0.0	0.01733939738487777
chr5	SAR1B	134613013	134613074	0	62	183	10558	183	10496	0.0	0.017435213414634148
chr5	PITX1	135034501	135034567	0	67	0	3380	0	3313	0.0	0.0
chr5	PITX1	135034501	135034685	0	185	0	3380	0	3195	0.0	0.0
chr5	C5ORF66-AS1	135039595	135039599	0	5	0	840	0	835	0.0	0.0
chr5	MACROH2A1	135399748	135399784	182	37	1181264	10783	1181082	10746	4.918918918918919	109.90898939140145
chr5	MACROH2A1	135399748	135399803	289	56	1181264	10783	1180975	10727	5.160714285714286	110.09368882259719
chr5	MACROH2A1	135350822	135350825	0	4	1181264	10783	1181264	10779	0.0	109.5893867705724
chr5	MACROH2A1	135399785	135399803	107	19	1181264	10783	1181157	10764	5.631578947368421	109.73216276477146
chr5	TRPC7	136274656	136274671	0	16	51	3780	51	3764	0.0	0.01354941551540914
chr5	BRD8	138177565	138177569	0	5	128470	6939	128470	6934	0.0	18.5275454283242
chr5	BRD8	138171344	138171359	0	16	128470	6939	128470	6923	0.0	18.556983966488517
chr5	CDC25C	138289479	138289499	24	21	689	3355	665	3334	1.1428571428571428	0.19946010797840433
chr5	ETF1	138542633	138542831	0	199	2775	4549	2775	4350	0.0	0.6379310344827587
chr5	ETF1	138542633	138542703	0	71	2775	4549	2775	4478	0.0	0.619696292987941
chr5	ETF1	138542704	138542831	0	128	2775	4549	2775	4421	0.0	0.6276860438814748
chr5	HSPA9	138573762	138573775	0	14	649	5786	649	5772	0.0	0.11243936243936244
chr5	HSPA9	138574770	138574992	0	223	649	5786	649	5563	0.0	0.11666367068128708
chr5	SIL1	139293273	139293421	0	149	2097	3852	2097	3703	0.0	0.5662975965433432
chr5	SLC23A1	139380552	139380563	0	12	357	3085	357	3073	0.0	0.11617312072892938
chr5	DNAJC18	139443680	139443683	0	4	255	2652	255	2648	0.0	0.09629909365558913
chr5	STING1	139482549	139482608	0	60	51	4684	51	4624	0.0	0.011029411764705883
chr5	PSD2-AS1	139746193	139746199	0	7	2400	1258	2400	1251	0.0	1.9184652278177459
chr5	PSD2-AS1	139745906	139746192	0	287	2400	1258	2400	971	0.0	2.47167868177137
chr5	PSD2-AS1	139745906	139746199	0	294	2400	1258	2400	964	0.0	2.4896265560165975
chr5	MALINC1	140107098	140107407	0	310	14558	7192	14558	6882	0.0	2.115373437954083
chr5	APBB3	140564196	140564654	0	459	418	3183	418	2724	0.0	0.15345080763582966
chr5	AC116353.6	140591063	140591072	0	10	7168	2107	7168	2097	0.0	3.4182164997615643
chr5	CD14	140633530	140633550	0	21	1071	1651	1071	1630	0.0	0.6570552147239264
chr5	HARS1	140679001	140679060	60	60	6636	12088	6576	12028	1.0	0.5467243099434652
chr5	HARS1	140691214	140691300	102	87	6636	12088	6534	12001	1.1724137931034482	0.5444546287809349
chr5	HARS1	140674669	140674677	90	9	6636	12088	6546	12079	10.0	0.5419322791621823
chr5	AC244517.11	141241407	141241451	0	45	0	1533	0	1488	0.0	0.0
chr5	DIAPH1	141524618	141524674	175	57	178283	7015	178108	6958	3.0701754385964914	25.59758551307847
chr5	ARAP3	141671264	141671323	0	60	3687	6227	3687	6167	0.0	0.5978595751580995
chr5	AC005753.3	141825037	141825090	0	54	495	2037	495	1983	0.0	0.24962178517397882
chr5	PCDH1	141868501	141868567	0	67	0	5934	0	5867	0.0	0.0
chr5	GNPDA1	142011848	142011910	0	63	992	3613	992	3550	0.0	0.27943661971830985
chr5	GNPDA1	142012914	142012993	0	80	992	3613	992	3533	0.0	0.2807812057741296
chr5	GNPDA1	142012668	142012993	0	326	992	3613	992	3287	0.0	0.3017949498022513
chr5	SPRY4	142319732	142319742	0	11	709	6560	709	6549	0.0	0.10826080317605741
chr5	FGF1	142685498	142685512	0	15	2898	4780	2898	4765	0.0	0.6081846799580273
chr5	FGF1	142697621	142697911	0	291	2898	4780	2898	4489	0.0	0.6455780797505012
chr5	ARHGAP26-AS1	142860001	142860011	0	11	0	996	0	985	0.0	0.0
chr5	NR3C1	143313998	143314000	0	3	422	9176	422	9173	0.0	0.04600457865474763
chr5	YIPF5	144170283	144170533	0	251	0	3704	0	3453	0.0	0.0
chr5	LARS1	146144623	146144661	0	39	51	16674	51	16635	0.0	0.0030658250676284943
chr5	LARS1	146149621	146149656	0	36	51	16674	51	16638	0.0	0.0030652722683014787
chr5	LARS1	146182487	146182560	0	74	51	16674	51	16600	0.0	0.0030722891566265062
chr5	LARS1	146182487	146182620	0	134	51	16674	51	16540	0.0	0.003083434099153567
chr5	LARS1	146142855	146142870	0	16	51	16674	51	16658	0.0	0.0030615920278544845
chr5	LARS1	146149551	146149620	0	70	51	16674	51	16604	0.0	0.0030715490243314863
chr5	LARS1	146149551	146149656	0	106	51	16674	51	16568	0.0	0.0030782230806373732
chr5	LARS1	146182561	146182620	0	60	51	16674	51	16614	0.0	0.0030697002527988442
chr5	PPP2R2B	146878590	146878699	0	110	0	13227	0	13117	0.0	0.0
chr5	PPP2R2B	147081256	147081320	0	65	0	13227	0	13162	0.0	0.0
chr5	AC011346.1	148290251	148290919	0	669	765	13969	765	13300	0.0	0.057518796992481205
chr5	SH3TC2	149041415	149041472	0	58	2844	12652	2844	12594	0.0	0.22582181991424488
chr5	CSNK1A1	149505446	149505481	0	36	3009	8524	3009	8488	0.0	0.3545004712535344
chr5	TIGD6	149999927	150000472	0	546	0	3973	0	3427	0.0	0.0
chr5	CSF1R	150061490	150061594	0	105	120502	5174	120502	5069	0.0	23.772341684750444
chr5	PDGFRB	150134715	150134748	697	34	11482	6271	10785	6237	20.5	1.7291967291967292
chr5	CAMK2A	150222959	150222987	0	29	574	6094	574	6065	0.0	0.09464138499587799
chr5	ARSI	150339199	150339276	0	78	0	3224	0	3146	0.0	0.0
chr5	RPS14	150449485	150449490	0	6	51349	2968	51349	2962	0.0	17.335921674544227
chr5	DCTN4	150758115	150758304	0	190	204	6234	204	6044	0.0	0.033752481800132364
chr5	CCDC69	151185421	151185445	3943	25	826419	4952	822476	4927	157.72	166.93241323320478
chr5	FAM114A2	154038292	154038855	0	564	102	6540	102	5976	0.0	0.01706827309236948
chr5	FAM114A2	154038292	154038386	0	95	102	6540	102	6445	0.0	0.01582622187742436
chr5	FAM114A2	154038292	154038825	0	534	102	6540	102	6006	0.0	0.016983016983016984
chr5	FAM114A2	154038292	154038834	0	543	102	6540	102	5997	0.0	0.017008504252126064
chr5	FAM114A2	154038826	154038855	0	30	102	6540	102	6510	0.0	0.01566820276497696
chr5	FAM114A2	154038826	154038834	0	9	102	6540	102	6531	0.0	0.015617822691777675
chr5	FAM114A2	154038835	154038855	0	21	102	6540	102	6519	0.0	0.015646571560055222
chr5	FAM114A2	154038387	154038855	0	469	102	6540	102	6071	0.0	0.016801185966068194
chr5	FAM114A2	154038387	154038825	0	439	102	6540	102	6101	0.0	0.016718570726110472
chr5	FAM114A2	154038387	154038834	0	448	102	6540	102	6092	0.0	0.01674326986211425
chr5	SAP30L-AS1	154445595	154445736	0	142	612	9072	612	8930	0.0	0.06853303471444569
chr5	FAXDC2	154823307	154823385	0	79	0	6073	0	5994	0.0	0.0
chr5	FNDC9	157345380	157345539	0	160	0	2245	0	2085	0.0	0.0
chr5	ADAM19	157513423	157513432	0	10	152	7729	152	7719	0.0	0.019691669905428165
chr5	CLINT1	157858952	157859038	0	87	7752	6158	7752	6071	0.0	1.2768901334211826
chr5	CLINT1	157858929	157858951	0	23	7752	6158	7752	6135	0.0	1.2635696821515892
chr5	CLINT1	157858929	157859038	0	110	7752	6158	7752	6048	0.0	1.2817460317460319
chr5	EBF1	158823175	158823198	0	24	122992	6353	122992	6329	0.0	19.43308579554432
chr5	RNF145	159168872	159168990	0	119	0	4087	0	3968	0.0	0.0
chr5	RNF145	159207884	159207886	0	3	0	4087	0	4084	0.0	0.0
chr5	CCNJL	160254128	160255547	102	1420	204	9249	102	7829	0.07183098591549296	0.01302848384212543
chr5	SLU7	160418595	160419021	0	427	0	4786	0	4359	0.0	0.0
chr5	ATP10B	160785558	160785734	0	177	0	9107	0	8930	0.0	0.0
chr5	GABRB2	161547888	161548057	0	170	102	17158	102	16988	0.0	0.0060042382858488345
chr5	AC113414.1	162558852	162558935	0	84	255	8813	255	8729	0.0	0.029212968266697215
chr5	LINC01938	165241358	165241627	0	270	0	3198	0	2928	0.0	0.0
chr5	LINC01938	165241505	165241627	0	123	0	3198	0	3075	0.0	0.0
chr5	SLIT3	168685686	168685715	0	30	455	14307	455	14277	0.0	0.03186944035861876
chr5	INSYN2B	169980276	169980294	0	19	0	5700	0	5681	0.0	0.0
chr5	AC139493.2	176182619	176182683	0	65	0	3034	0	2969	0.0	0.0
chr5	KIAA1191	176359461	176359479	0	19	5348	3822	5348	3803	0.0	1.4062582171969498
chr5	SNCB	176629808	176629887	0	80	787	1869	787	1789	0.0	0.43991056456120736
chr5	UIMC1	176968554	176969051	865	498	304354	3988	303489	3490	1.7369477911646587	86.9595988538682
chr5	UIMC1	176969596	176969599	0	4	304354	3988	304354	3984	0.0	76.39407630522088
chr5	RAB24	177303406	177303409	0	4	84040	1931	84040	1927	0.0	43.61183186299948
chr5	DOK3	177509757	177509800	68	44	119	4236	51	4192	1.5454545454545454	0.012166030534351144
chr5	DOK3	177510149	177510258	0	110	119	4236	119	4126	0.0	0.028841492971400873
chr5	DDX41	177514553	177514699	0	147	225	3376	225	3229	0.0	0.06968101579436357
chr5	DDX41	177514553	177514592	0	40	225	3376	225	3336	0.0	0.06744604316546762
chr5	FAM193B	177531952	177532154	0	203	4817	5341	4817	5138	0.0	0.9375243285325029
chr5	FAM193B	177523158	177523161	0	4	4817	5341	4817	5337	0.0	0.9025669851976766
chr5	FAM153A	177750908	177750957	0	50	7931	8568	7931	8518	0.0	0.9310871096501526
chr5	FAM153A	177782742	177782816	0	75	7931	8568	7931	8493	0.0	0.9338278582361945
chr5	PHYKPL	178211760	178211888	0	129	0	7715	0	7586	0.0	0.0
chr5	HNRNPH1	179616868	179616897	0	30	276	5593	276	5563	0.0	0.049613517886032715
chr5	HNRNPH1	179617050	179617058	0	9	276	5593	276	5584	0.0	0.0494269340974212
chr5	HNRNPH1	179621241	179621369	0	129	276	5593	276	5464	0.0	0.050512445095168376
chr5	HNRNPH1	179623594	179623634	0	41	276	5593	276	5552	0.0	0.04971181556195965
chr5	HNRNPH1	179616859	179616867	0	9	276	5593	276	5584	0.0	0.0494269340974212
chr5	HNRNPH1	179616859	179616897	0	39	276	5593	276	5554	0.0	0.04969391429600288
chr5	HNRNPH1	179623635	179624095	0	461	276	5593	276	5132	0.0	0.05378020265003897
chr5	HNRNPH1	179623635	179624315	0	681	276	5593	276	4912	0.0	0.05618892508143322
chr5	HNRNPH1	179623635	179623976	0	342	276	5593	276	5251	0.0	0.05256141687297657
chr5	HNRNPH1	179624096	179624315	0	220	276	5593	276	5373	0.0	0.0513679508654383
chr5	HNRNPH1	179623280	179623593	0	314	276	5593	276	5279	0.0	0.05228262928584959
chr5	HNRNPH1	179623280	179623634	0	355	276	5593	276	5238	0.0	0.052691867124856816
chr5	HNRNPH1	179623977	179624095	0	119	276	5593	276	5474	0.0	0.05042016806722689
chr5	C5ORF60	179644798	179644943	0	146	22	2531	22	2385	0.0	0.009224318658280923
chr5	MGAT4B	179798927	179799063	0	137	24	5408	24	5271	0.0	0.004553215708594195
chr5	MRNIP	179853196	179853376	0	181	306	7454	306	7273	0.0	0.04207342224666575
chr5	MGAT1	180803601	180803811	0	211	204	11216	204	11005	0.0	0.018537028623353023
chr5	MGAT1	180815413	180815423	0	11	204	11216	204	11205	0.0	0.01820615796519411
chr5	MGAT1	180808501	180808646	0	146	204	11216	204	11070	0.0	0.01842818428184282
chr5	MGAT1	180795655	180795836	0	182	204	11216	204	11034	0.0	0.018488308863512777
chr5	ZFP62	180861214	180861217	0	4	0	3131	0	3127	0.0	0.0
chr5	TRIM7	181203744	181204020	0	277	0	7345	0	7068	0.0	0.0
chr5	TRIM7	181203476	181203543	0	68	0	7345	0	7277	0.0	0.0
chr5	RACK1	181242173	181242284	0	112	0	5102	0	4990	0.0	0.0
chr5	RACK1	181243679	181243690	0	12	0	5102	0	5090	0.0	0.0
chr5	RACK1	181242169	181242172	0	4	0	5102	0	5098	0.0	0.0
chr5	RACK1	181242169	181242284	0	116	0	5102	0	4986	0.0	0.0
chr5	RACK1	181242553	181243284	0	732	0	5102	0	4370	0.0	0.0
chr5	RACK1	181242553	181243252	0	700	0	5102	0	4402	0.0	0.0
chr5	RACK1	181243253	181243284	0	32	0	5102	0	5070	0.0	0.0
chr6	DUSP22	311915	311962	1351	48	143861	4077	142510	4029	28.145833333333332	35.371059816331595
chr6	BPHL	3118563	3118847	0	285	135586	5789	135586	5504	0.0	24.634084302325583
chr6	BPHL	3137423	3137493	149	71	135586	5789	135437	5718	2.0985915492957745	23.6860790486184
chr6	PRPF4B	4060645	4060686	939	42	422403	7279	421464	7237	22.357142857142858	58.23739118419235
chr6	PRPF4B	4062634	4062760	4089	127	422403	7279	418314	7152	32.196850393700785	58.48909395973154
chr6	RREB1	7181159	7181246	0	88	284743	16690	284743	16602	0.0	17.15112637031683
chr6	RREB1	7181247	7181289	0	43	284743	16690	284743	16647	0.0	17.104763621072866
chr6	RREB1	7181159	7181289	0	131	284743	16690	284743	16559	0.0	17.19566398937134
chr6	RREB1	7108061	7108064	0	4	284743	16690	284743	16686	0.0	17.064784849574494
chr6	DSP	7579773	7581569	10705	1797	96517	10072	85812	8275	5.95715080690039	10.370030211480362
chr6	HULC	8788947	8788964	0	18	13320	47611	13320	47593	0.0	0.27987309058054755
chr6	HULC	8785218	8785271	0	54	13320	47611	13320	47557	0.0	0.28008495069075007
chr6	HULC	8652391	8653136	0	746	13320	47611	13320	46865	0.0	0.28422063373519685
chr6	HULC	9091072	9091080	0	9	13320	47611	13320	47602	0.0	0.279820175622873
chr6	HULC	9041661	9042162	0	502	13320	47611	13320	47109	0.0	0.28274851939119916
chr6	HULC	9041696	9042162	0	467	13320	47611	13320	47144	0.0	0.28253860512472423
chr6	HULC	9041661	9041695	0	35	13320	47611	13320	47576	0.0	0.2799730956784934
chr6	GCNT2	10528842	10529836	57048	995	254611	8968	197563	7973	57.334673366834174	24.77900413896902
chr6	ELOVL2-AS1	11043761	11043825	0	65	5072	2521	5072	2456	0.0	2.0651465798045603
chr6	ELOVL2-AS1	11044769	11044814	0	46	5072	2521	5072	2475	0.0	2.049292929292929
chr6	ELOVL2-AS1	11044769	11044966	102	198	5072	2521	4970	2323	0.5151515151515151	2.139474817046922
chr6	ELOVL2-AS1	11044815	11044966	102	152	5072	2521	4970	2369	0.6710526315789473	2.097931616715914
chr6	AL445430.1	11417553	11417579	0	27	10	1436	10	1409	0.0	0.007097232079488999
chr6	AL445430.1	11417580	11417590	0	11	10	1436	10	1425	0.0	0.007017543859649123
chr6	AL445430.1	11417553	11417590	0	38	10	1436	10	1398	0.0	0.00715307582260372
chr6	PHACTR1	12717554	12717743	0	190	483	11593	483	11403	0.0	0.0423572744014733
chr6	PHACTR1	12957752	12958037	0	286	483	11593	483	11307	0.0	0.04271690103475723
chr6	SIRT5	13574625	13574744	0	120	109734	6538	109734	6418	0.0	17.097849797444688
chr6	KDM1B	18217881	18217885	0	5	257006	5642	257006	5637	0.0	45.592691147773635
chr6	E2F3	20402381	20402625	3502	245	755870	5150	752368	4905	14.293877551020408	153.38797145769624
chr6	CASC15	22110819	22110920	0	102	0	32553	0	32451	0.0	0.0
chr6	CASC15	21665014	21665138	0	125	0	32553	0	32428	0.0	0.0
chr6	CASC15	21977928	21977953	0	26	0	32553	0	32527	0.0	0.0
chr6	CASC15	22147071	22147156	0	86	0	32553	0	32467	0.0	0.0
chr6	CASC15	22147157	22147292	0	136	0	32553	0	32417	0.0	0.0
chr6	CASC15	22147071	22147292	0	222	0	32553	0	32331	0.0	0.0
chr6	CASC15	22147157	22147379	0	223	0	32553	0	32330	0.0	0.0
chr6	CASC15	22147293	22147379	0	87	0	32553	0	32466	0.0	0.0
chr6	CASC15	22147071	22147379	0	309	0	32553	0	32244	0.0	0.0
chr6	CASC15	22214409	22215702	0	1294	0	32553	0	31259	0.0	0.0
chr6	ALDH5A1	24502607	24502763	66	157	36420	7575	36354	7418	0.42038216560509556	4.900781881908871
chr6	GMNN	24775113	24775244	7258	132	189493	2484	182235	2352	54.984848484848484	77.48086734693878
chr6	GMNN	24775503	24775824	4110	322	189493	2484	185383	2162	12.763975155279503	85.74606845513414
chr6	SLC17A4	25776960	25777788	0	829	0	4570	0	3741	0.0	0.0
chr6	U91328.1	25998012	25998285	2657	274	67482	3639	64825	3365	9.697080291970803	19.26448736998514
chr6	U91328.1	25998286	25998290	150	5	67482	3639	67332	3634	30.0	18.528343423225095
chr6	U91328.1	25998012	25998290	2807	279	67482	3639	64675	3360	10.060931899641577	19.248511904761905
chr6	H2AC6	26124634	26124749	22355	116	157164	1612	134809	1496	192.7155172413793	90.1129679144385
chr6	BTN3A2	26365218	26365352	0	135	120376	5358	120376	5223	0.0	23.047290829025464
chr6	BTN2A2	26383182	26383299	0	118	147022	4365	147022	4247	0.0	34.61784789263009
chr6	BTN2A2	26383245	26383299	0	55	147022	4365	147022	4310	0.0	34.11183294663573
chr6	BTN2A2	26383182	26383244	0	63	147022	4365	147022	4302	0.0	34.17526731752673
chr6	BTN2A2	26383300	26383313	0	14	147022	4365	147022	4351	0.0	33.790393013100434
chr6	BTN2A2	26383245	26383313	0	69	147022	4365	147022	4296	0.0	34.222998137802605
chr6	BTN2A3P	26423278	26423759	10658	482	79889	4185	69231	3703	22.112033195020746	18.69592222522279
chr6	BTN3A3	26440649	26440719	0	71	34789	3974	34789	3903	0.0	8.913399948757366
chr6	LINC01012	27694227	27694506	0	280	51	3778	51	3498	0.0	0.014579759862778732
chr6	H2BC15	27839039	27839065	0	27	1071	4640	1071	4613	0.0	0.2321699544764795
chr6	ZKSCAN8	28148825	28148838	0	14	0	7588	0	7574	0.0	0.0
chr6	ZSCAN9	28225269	28225330	0	62	204	3599	204	3537	0.0	0.05767599660729432
chr6	ZSCAN9	28225331	28225366	0	36	204	3599	204	3563	0.0	0.05725512208812798
chr6	ZSCAN9	28227838	28228365	204	528	204	3599	0	3071	0.38636363636363635	0.0
chr6	ZSCAN26	28271935	28272339	0	405	2355	2938	2355	2533	0.0	0.929727595736281
chr6	ZSCAN26	28272337	28272339	0	3	2355	2938	2355	2935	0.0	0.8023850085178875
chr6	ZSCAN26	28271935	28272336	0	402	2355	2938	2355	2536	0.0	0.9286277602523659
chr6	OR2I1P	29550601	29550857	0	257	0	5367	0	5110	0.0	0.0
chr6	HLA-A	29944617	29944634	0	18	0	2718	0	2700	0.0	0.0
chr6	POLR1H	30061390	30061398	0	9	0	1070	0	1061	0.0	0.0
chr6	POLR1H	30061390	30061413	0	24	0	1070	0	1046	0.0	0.0
chr6	POLR1H	30061399	30061413	0	15	0	1070	0	1055	0.0	0.0
chr6	PPP1R11	30067626	30067664	0	39	0	2327	0	2288	0.0	0.0
chr6	TRIM39	30326888	30326995	0	108	51	4237	51	4129	0.0	0.012351658997335917
chr6	RPP21	30345229	30345398	0	170	51	1107	51	937	0.0	0.054429028815368194
chr6	RPP21	30346558	30346564	0	7	51	1107	51	1100	0.0	0.046363636363636364
chr6	ATAT1	30626993	30627274	12909	282	689283	3818	676374	3536	45.776595744680854	191.28223981900453
chr6	C6ORF136	30647304	30647846	6883	543	225863	2035	218980	1492	12.675874769797423	146.76943699731905
chr6	C6ORF136	30651083	30651100	115	18	225863	2035	225748	2017	6.388888888888889	111.92265741199802
chr6	C6ORF136	30652718	30652728	5538	11	225863	2035	220325	2024	503.45454545454544	108.85622529644269
chr6	TUBB	30721899	30722262	0	364	251	3213	251	2849	0.0	0.0881010881010881
chr6	TUBB	30722215	30722262	0	48	251	3213	251	3165	0.0	0.07930489731437598
chr6	TUBB	30721899	30722214	0	316	251	3213	251	2897	0.0	0.0866413531239213
chr6	DDR1	30888981	30889010	108	30	133998	8326	133890	8296	3.6	16.13910318225651
chr6	DDR1	30882984	30883165	5794	182	133998	8326	128204	8144	31.835164835164836	15.74214145383104
chr6	DDR1	30883242	30883323	510	82	133998	8326	133488	8244	6.219512195121951	16.192139737991265
chr6	DDR1	30883888	30883929	183	42	133998	8326	133815	8284	4.357142857142857	16.153428295509414
chr6	DDR1	30885232	30885354	459	123	133998	8326	133539	8203	3.731707317073171	16.279288065341948
chr6	DDR1	30885355	30885388	0	34	133998	8326	133998	8292	0.0	16.159913169319825
chr6	DDR1	30885764	30885811	3	48	133998	8326	133995	8278	0.0625	16.186880889103648
chr6	GTF2H4	30908379	30908403	0	25	0	2148	0	2123	0.0	0.0
chr6	VARS2	30914345	30915037	0	693	0	6416	0	5723	0.0	0.0
chr6	VARS2	30914345	30914469	0	125	0	6416	0	6291	0.0	0.0
chr6	MUC21	30984020	30984161	0	142	204	3796	204	3654	0.0	0.05582922824302135
chr6	HCG27	31197881	31197882	0	2	0	2520	0	2518	0.0	0.0
chr6	MICA	31400764	31400783	0	20	1194	3859	1194	3839	0.0	0.31101849439958323
chr6	NFKBIL1	31557805	31557849	0	45	537	1758	537	1713	0.0	0.3134851138353765
chr6	LTA	31572303	31572446	0	144	51	1740	51	1596	0.0	0.03195488721804511
chr6	AIF1	31615294	31615354	0	61	202433	994	202433	933	0.0	216.9699892818864
chr6	CSNK2B	31668655	31668692	710	38	52186	2558	51476	2520	18.68421052631579	20.426984126984127
chr6	CSNK2B	31666397	31666487	51	91	52186	2558	52135	2467	0.5604395604395604	21.13295500608026
chr6	MSH5	31740063	31740220	0	158	350463	5859	350463	5701	0.0	61.47395193825645
chr6	MSH5	31761866	31761955	6	90	350463	5859	350457	5769	0.06666666666666667	60.7483099323973
chr6	MSH5-SAPCD1	31762571	31763168	30963	598	289079	3610	258116	3012	51.77759197324415	85.69588313413014
chr6	SNHG32	31834769	31835200	0	432	0	1649	0	1217	0.0	0.0
chr6	SNHG32	31835058	31835200	0	143	0	1649	0	1506	0.0	0.0
chr6	SNHG32	31835452	31835455	0	4	0	1649	0	1645	0.0	0.0
chr6	C2	31928165	31928192	0	28	622662	5539	622662	5511	0.0	112.98530212302667
chr6	SKIV2L	31969317	31969420	536	104	4370	4787	3834	4683	5.153846153846154	0.8187059577194107
chr6	STK19	31978999	31979010	0	12	3796	3774	3796	3762	0.0	1.0090377458798512
chr6	STK19	31979009	31979010	0	2	3796	3774	3796	3772	0.0	1.0063626723223753
chr6	STK19	31978999	31979008	0	10	3796	3774	3796	3764	0.0	1.0085015940488842
chr6	C4B	32032248	32032298	0	51	45	6663	45	6612	0.0	0.006805807622504537
chr6	PPT2	32154395	32154404	74	10	158171	2809	158097	2799	7.4	56.48338692390139
chr6	PPT2	32154247	32154404	6447	158	158171	2809	151724	2651	40.80379746835443	57.23274236137307
chr6	EGFL8	32167626	32167656	0	31	51	1546	51	1515	0.0	0.033663366336633666
chr6	PPT2	32154247	32154394	6373	148	158171	2809	151798	2661	43.060810810810814	57.04547162720782
chr6	PPT2-EGFL8	32164658	32164681	0	24	174403	5532	174403	5508	0.0	31.66358024691358
chr6	PPT2-EGFL8	32166233	32166266	0	34	174403	5532	174403	5498	0.0	31.72117133503092
chr6	AL662789.1	32718148	32718440	0	293	0	1019	0	726	0.0	0.0
chr6	PSMB8-AS1	32844275	32844870	0	596	160	1878	160	1282	0.0	0.12480499219968799
chr6	BRD2	32970995	32971197	0	203	0	7303	0	7100	0.0	0.0
chr6	HLA-DPB1	33085890	33085906	0	17	0	5226	0	5209	0.0	0.0
chr6	SLC39A7	33200939	33201656	153	718	153	2852	0	2134	0.21309192200557103	0.0
chr6	PFDN6	33289621	33289628	2599	8	100354	2612	97755	2604	324.875	37.54032258064516
chr6	PHF1	33410888	33411215	34372	328	141982	3035	107610	2707	104.79268292682927	39.75249353527891
chr6	SYNGAP1	33447933	33447933	1	1	38016	8100	38015	8099	1.0	4.693789356710705
chr6	ZBTB9	33454632	33454775	0	144	133	2863	133	2719	0.0	0.04891504229496138
chr6	GGNBP1	33584071	33584074	0	4	376	1748	376	1744	0.0	0.21559633027522937
chr6	GGNBP1	33585722	33585780	0	59	376	1748	376	1689	0.0	0.22261693309650682
chr6	AL138889.1	33896084	33896487	0	404	51	14456	51	14052	0.0	0.003629376601195559
chr6	HMGA1	34236964	34237317	176	354	2286	2333	2110	1979	0.4971751412429379	1.0661950480040425
chr6	HMGA1	34240883	34240915	0	33	2286	2333	2286	2300	0.0	0.9939130434782608
chr6	ARMC12	35737272	35737352	0	81	17	1424	17	1343	0.0	0.012658227848101266
chr6	BRPF3	36197498	36197620	1777	123	42930	6627	41153	6504	14.447154471544716	6.327337023370234
chr6	PNPLA1	36291553	36291555	0	3	0	3044	0	3041	0.0	0.0
chr6	CDKN1A	36678799	36678939	0	141	0	3000	0	2859	0.0	0.0
chr6	PI16	36963034	36963612	0	579	6426	2259	6426	1680	0.0	3.825
chr6	FGD2	37009066	37009081	0	16	56308	9807	56308	9791	0.0	5.750995812480849
chr6	RNF8	37354119	37354275	2768	157	6644	6384	3876	6227	17.630573248407643	0.6224506182752529
chr6	CMTR1	37475413	37475916	0	504	5720	4978	5720	4474	0.0	1.2784979883772911
chr6	AL353597.1	37549184	37549215	10	32	65	1152	55	1120	0.3125	0.049107142857142856
chr6	TDRG1	40378513	40378572	0	60	0	2534	0	2474	0.0	0.0
chr6	TDRG1	40378896	40378897	0	2	0	2534	0	2532	0.0	0.0
chr6	TSPO2	41042779	41042808	8	30	1772	1079	1764	1049	0.26666666666666666	1.6816015252621543
chr6	ADCY10P1	41111322	41111356	0	35	2867	5583	2867	5548	0.0	0.5167627974044701
chr6	ADCY10P1	41140070	41140205	0	136	2867	5583	2867	5447	0.0	0.5263447769414357
chr6	MDFI	41638486	41638652	0	167	2722	2542	2722	2375	0.0	1.1461052631578947
chr6	AL096814.2	42155486	42155593	102	108	105783	2281	105681	2173	0.9444444444444444	48.633686148182235
chr6	AL096814.2	42163096	42163466	0	371	105783	2281	105783	1910	0.0	55.38376963350785
chr6	KLC4	43060187	43060238	0	52	8006	5760	8006	5708	0.0	1.4025928521373512
chr6	KLC4	43060183	43060238	0	56	8006	5760	8006	5704	0.0	1.4035764375876578
chr6	KLC4	43060160	43060238	0	79	8006	5760	8006	5681	0.0	1.4092589332863932
chr6	KLC4	43060183	43060186	0	4	8006	5760	8006	5756	0.0	1.3908964558721335
chr6	KLC4	43060160	43060186	0	27	8006	5760	8006	5733	0.0	1.3964765393336822
chr6	KLC4	43060160	43060182	0	23	8006	5760	8006	5737	0.0	1.3955028760676311
chr6	KLC4	43060239	43060605	0	367	8006	5760	8006	5393	0.0	1.4845169664379751
chr6	KLC4	43060187	43060605	0	419	8006	5760	8006	5341	0.0	1.4989702302939525
chr6	KLC4	43060183	43060605	0	423	8006	5760	8006	5337	0.0	1.5000936855911562
chr6	KLC4	43060160	43060605	0	446	8006	5760	8006	5314	0.0	1.506586375611592
chr6	PTK7	43132688	43132765	0	78	574235	8336	574235	8258	0.0	69.5368127875999
chr6	PTK7	43142499	43142502	0	4	574235	8336	574235	8332	0.0	68.91922707633222
chr6	CUL9	43216386	43216503	0	118	38655	10593	38655	10475	0.0	3.690214797136038
chr6	SLC22A7	43299782	43299790	0	9	87740	3540	87740	3531	0.0	24.848484848484848
chr6	SLC22A7	43299098	43299274	82	177	87740	3540	87658	3363	0.4632768361581921	26.065417781742493
chr6	ABCC10	43427700	43427757	184	58	31697	7712	31513	7654	3.1724137931034484	4.117193624248759
chr6	TJAP1	43477629	43477632	4	4	236395	6659	236391	6655	1.0	35.52081141998497
chr6	TJAP1	43503707	43504667	1223	961	236395	6659	235172	5698	1.2726326742976066	41.27272727272727
chr6	POLR1C	43519839	43519905	0	67	107381	5100	107381	5033	0.0	21.335386449433738
chr6	VEGFA	43782053	43782087	0	35	0	7921	0	7886	0.0	0.0
chr6	VEGFA	43780786	43780854	0	69	0	7921	0	7852	0.0	0.0
chr6	VEGFA	43780804	43780854	0	51	0	7921	0	7870	0.0	0.0
chr6	VEGFA	43780786	43780803	0	18	0	7921	0	7903	0.0	0.0
chr6	C6ORF223	44000701	44001143	51	443	2091	5569	2040	5126	0.11512415349887133	0.3979711275848615
chr6	MYMX	44216969	44216994	484	26	2851250	856	2850766	830	18.615384615384617	3434.6578313253012
chr6	SLC29A1	44223926	44223955	998	30	679626	4176	678628	4146	33.266666666666666	163.6825856246985
chr6	SPATS1	44342761	44342768	0	8	27006	4590	27006	4582	0.0	5.893932780445221
chr6	RUNX2	45328461	45328495	0	35	3805	8204	3805	8169	0.0	0.4657852858366997
chr6	AL035670.1	46492128	46492245	0	118	0	5437	0	5319	0.0	0.0
chr6	ADGRF4	47698707	47698794	0	88	0	3403	0	3315	0.0	0.0
chr6	AL121974.1	49803058	49803073	0	16	0	1303	0	1287	0.0	0.0
chr6	AL121974.1	49803058	49803105	0	48	0	1303	0	1255	0.0	0.0
chr6	AL121974.1	49803074	49803105	0	32	0	1303	0	1271	0.0	0.0
chr6	AL121974.1	49817492	49817524	0	33	0	1303	0	1270	0.0	0.0
chr6	AL121974.1	49817497	49817524	0	28	0	1303	0	1275	0.0	0.0
chr6	AL121974.1	49817492	49817496	0	5	0	1303	0	1298	0.0	0.0
chr6	EFHC1	52424082	52424167	0	86	15377	16238	15377	16152	0.0	0.9520183259039128
chr6	EFHC1	52438455	52438591	0	137	15377	16238	15377	16101	0.0	0.9550338488292652
chr6	EFHC1	52423815	52423828	0	14	15377	16238	15377	16224	0.0	0.947793392504931
chr6	TRAM2-AS1	52577612	52577651	0	40	864	8437	864	8397	0.0	0.10289389067524116
chr6	TRAM2-AS1	52578394	52578594	0	201	864	8437	864	8236	0.0	0.10490529383195726
chr6	AL109918.1	52666519	52666548	0	30	0	3559	0	3529	0.0	0.0
chr6	AL445250.1	57961743	57962248	0	506	1020	10037	1020	9531	0.0	0.10701920050361977
chr6	AL445250.1	58038490	58038556	0	67	1020	10037	1020	9970	0.0	0.10230692076228685
chr6	LINC01626	71453095	71453688	0	594	0	1157	0	563	0.0	0.0
chr6	MTO1	73461795	73462071	0	277	2538	11827	2538	11550	0.0	0.21974025974025974
chr6	MTO1	73462072	73462173	0	102	2538	11827	2538	11725	0.0	0.21646055437100215
chr6	MTO1	73461795	73462173	0	379	2538	11827	2538	11448	0.0	0.22169811320754718
chr6	CD109	73811097	73811147	116	51	4605	9817	4489	9766	2.2745098039215685	0.4596559492115503
chr6	MYO6	75892691	75892693	0	3	6089	9887	6089	9884	0.0	0.6160461351679482
chr6	MYO6	75844978	75844982	0	5	6089	9887	6089	9882	0.0	0.6161708156243675
chr6	TTK	80004714	80004831	0	118	0	4604	0	4486	0.0	0.0
chr6	TBX18-AS1	84689562	84689736	0	175	0	2085	0	1910	0.0	0.0
chr6	TBX18-AS1	84689596	84689736	0	141	0	2085	0	1944	0.0	0.0
chr6	TBX18-AS1	84689562	84689595	0	34	0	2085	0	2051	0.0	0.0
chr6	SMIM8	87330713	87330950	0	238	153	7986	153	7748	0.0	0.019747031491997934
chr6	SMIM8	87391836	87391877	0	42	153	7986	153	7944	0.0	0.019259818731117824
chr6	PNRC1	89080974	89081434	0	461	0	2995	0	2534	0.0	0.0
chr6	ANKRD6	89629224	89629238	0	15	102	8004	102	7989	0.0	0.012767555388659407
chr6	ANKRD6	89562899	89562923	0	25	102	8004	102	7979	0.0	0.012783556836696328
chr6	CASP8AP2	89829935	89830067	0	133	208457	8157	208457	8024	0.0	25.97918743768694
chr6	CASP8AP2	89830068	89830106	0	39	208457	8157	208457	8118	0.0	25.678369056417836
chr6	AL132996.1	90346088	90346121	13294	34	247916	8959	234622	8925	391.0	26.28817927170868
chr6	AL589740.1	97423567	97423662	0	96	16623	12047	16623	11951	0.0	1.3909296293197222
chr6	AL589740.1	97769699	97769702	0	4	16623	12047	16623	12043	0.0	1.3803039109856348
chr6	PRDM13	99607179	99607206	0	28	0	3177	0	3149	0.0	0.0
chr6	MCHR2-AS1	99994002	99994061	0	60	2162	1443	2162	1383	0.0	1.5632682574114245
chr6	MCHR2-AS1	99994062	99994204	0	143	2162	1443	2162	1300	0.0	1.6630769230769231
chr6	BVES-AS1	105137312	105137332	0	21	1989	6708	1989	6687	0.0	0.297442799461642
chr6	BVES-AS1	105137333	105137478	0	146	1989	6708	1989	6562	0.0	0.30310880829015546
chr6	BVES-AS1	105137312	105137478	0	167	1989	6708	1989	6541	0.0	0.3040819446567803
chr6	PRDM1	106086474	106086595	0	122	0	6762	0	6640	0.0	0.0
chr6	PRDM1	106087908	106087930	0	23	0	6762	0	6739	0.0	0.0
chr6	MTRES1	107028272	107028797	0	526	15290	2300	15290	1774	0.0	8.618940248027057
chr6	OSTM1-AS1	108123735	108123775	0	41	0	3512	0	3471	0.0	0.0
chr6	CEP57L1	109095252	109095575	0	324	14299	16746	14299	16422	0.0	0.870722201924248
chr6	CEP57L1	109160717	109160730	0	14	14299	16746	14299	16732	0.0	0.8545900071718862
chr6	CEP57L1	109159103	109159153	0	51	14299	16746	14299	16695	0.0	0.8564839772386942
chr6	FIG4	109788914	109788956	2234	43	394464	19865	392230	19822	51.95348837209303	19.78760972656644
chr6	FIG4	109786450	109788956	116339	2507	394464	19865	278125	17358	46.40566414040686	16.022871298536696
chr6	MFSD4B	111259551	111259727	0	177	65496	13087	65496	12910	0.0	5.073276529821843
chr6	MFSD4B	111273423	111273429	0	7	65496	13087	65496	13080	0.0	5.007339449541284
chr6	TRAF3IP2-AS1	111574659	111574802	0	144	20556	4826	20556	4682	0.0	4.390431439555745
chr6	CCN6	112054135	112054161	0	27	0	1796	0	1769	0.0	0.0
chr6	CCN6	112054162	112054170	0	9	0	1796	0	1787	0.0	0.0
chr6	CCN6	112054135	112054170	0	36	0	1796	0	1760	0.0	0.0
chr6	CCN6	112061289	112061395	0	107	0	1796	0	1689	0.0	0.0
chr6	FAM229B	112087710	112087720	0	11	1643	2508	1643	2497	0.0	0.657989587505006
chr6	LAMA4-AS1	112283168	112283192	0	25	0	4143	0	4118	0.0	0.0
chr6	HDAC2-AS2	113992015	113992018	0	4	54590	8080	54590	8076	0.0	6.759534422981674
chr6	HDAC2-AS2	113992019	113992120	0	102	54590	8080	54590	7978	0.0	6.842567059413387
chr6	HDAC2-AS2	113992015	113992120	0	106	54590	8080	54590	7974	0.0	6.845999498369702
chr6	HDAC2-AS2	113970279	113970323	0	45	54590	8080	54590	8035	0.0	6.794026135656503
chr6	HDAC2-AS2	113971616	113971775	0	160	54590	8080	54590	7920	0.0	6.892676767676767
chr6	HDAC2-AS2	113992019	113992187	0	169	54590	8080	54590	7911	0.0	6.900518265705979
chr6	HDAC2-AS2	113992015	113992187	0	173	54590	8080	54590	7907	0.0	6.904009105855571
chr6	HDAC2-AS2	113992121	113992187	0	67	54590	8080	54590	8013	0.0	6.81267939598153
chr6	HDAC2-AS2	113995252	113995495	0	244	54590	8080	54590	7836	0.0	6.966564573762123
chr6	HDAC2-AS2	114230324	114230346	0	23	54590	8080	54590	8057	0.0	6.775474742459973
chr6	DSE	116254296	116254383	0	88	21712	19215	21712	19127	0.0	1.1351492654362942
chr6	CALHM4	116529136	116529190	0	55	12606	1903	12606	1848	0.0	6.821428571428571
chr6	GJA1	121435661	121435832	0	172	351	3399	351	3227	0.0	0.10876975519057949
chr6	TPD52L1	125257159	125257180	0	22	78	4105	78	4083	0.0	0.019103600293901544
chr6	TRMT11	126021266	126021280	0	15	3787	5422	3787	5407	0.0	0.7003883854262992
chr6	TRMT11	125986623	125986773	0	151	3787	5422	3787	5271	0.0	0.7184594953519257
chr6	TRMT11	125986691	125986773	0	83	3787	5422	3787	5339	0.0	0.7093088593369545
chr6	TRMT11	125986623	125986690	0	68	3787	5422	3787	5354	0.0	0.7073216286888308
chr6	CENPW	126340400	126340444	0	45	51	857	51	812	0.0	0.06280788177339902
chr6	RNF146	127266926	127267095	0	170	0	3139	0	2969	0.0	0.0
chr6	RNF146	127267045	127267095	0	51	0	3139	0	3088	0.0	0.0
chr6	RNF146	127266926	127267044	0	119	0	3139	0	3020	0.0	0.0
chr6	ENPP3	131674282	131674410	0	129	0	3912	0	3783	0.0	0.0
chr6	LINC01013	132154710	132154777	0	68	177	6796	177	6728	0.0	0.026307966706302022
chr6	LINC01013	132160915	132161006	0	92	177	6796	177	6704	0.0	0.026402147971360382
chr6	LINC00326	132954518	132954600	0	83	1416	6021	1416	5938	0.0	0.23846412933647693
chr6	LINC00326	133088932	133090069	0	1138	1416	6021	1416	4883	0.0	0.28998566455048125
chr6	LINC00326	133098319	133098369	0	51	1416	6021	1416	5970	0.0	0.2371859296482412
chr6	LINC00326	133098319	133098520	0	202	1416	6021	1416	5819	0.0	0.243340780202784
chr6	LINC00326	133098370	133098520	0	151	1416	6021	1416	5870	0.0	0.24122657580919932
chr6	LINC00326	133098383	133098520	0	138	1416	6021	1416	5883	0.0	0.24069352371239164
chr6	LINC00326	133098375	133098520	0	146	1416	6021	1416	5875	0.0	0.24102127659574468
chr6	LINC00326	133098319	133098382	0	64	1416	6021	1416	5957	0.0	0.23770354205136815
chr6	LINC00326	133098370	133098382	0	13	1416	6021	1416	6008	0.0	0.23568575233022637
chr6	LINC00326	133098375	133098382	0	8	1416	6021	1416	6013	0.0	0.2354897721603193
chr6	LINC00326	133098319	133098374	0	56	1416	6021	1416	5965	0.0	0.23738474434199497
chr6	LINC00326	133098370	133098374	0	5	1416	6021	1416	6016	0.0	0.23537234042553193
chr6	EYA4	133468732	133468749	0	18	0	7266	0	7248	0.0	0.0
chr6	LINC01010	134475669	134475726	0	58	2339	4158	2339	4100	0.0	0.5704878048780487
chr6	MYB	135194452	135194460	0	9	1466	5517	1466	5508	0.0	0.26615831517792304
chr6	MYB	135195918	135196002	0	85	1466	5517	1466	5432	0.0	0.2698821796759941
chr6	MYB	135195955	135196002	0	48	1466	5517	1466	5469	0.0	0.26805631742548913
chr6	MYB	135202670	135202673	0	4	1466	5517	1466	5513	0.0	0.26591692363504443
chr6	MYB	135200416	135200674	0	259	1466	5517	1466	5258	0.0	0.2788132369722328
chr6	MYB	135200558	135200674	0	117	1466	5517	1466	5400	0.0	0.2714814814814815
chr6	MYB	135196909	135197323	0	415	1466	5517	1466	5102	0.0	0.28733829870638966
chr6	MYB	135195918	135195954	0	37	1466	5517	1466	5480	0.0	0.2675182481751825
chr6	MYB	135200416	135200557	0	142	1466	5517	1466	5375	0.0	0.2727441860465116
chr6	LINC00271	135518643	135518830	0	188	23374	13702	23374	13514	0.0	1.7296137339055795
chr6	TNFAIP3	137867519	137867542	0	24	51	4800	51	4776	0.0	0.010678391959798994
chr6	TNFAIP3	137867495	137867542	0	48	51	4800	51	4752	0.0	0.010732323232323232
chr6	TNFAIP3	137867495	137867518	0	24	51	4800	51	4776	0.0	0.010678391959798994
chr6	HEBP2	138406034	138406151	0	118	234574	10358	234574	10240	0.0	22.9076171875
chr6	FILNC1	139854952	139854977	0	26	0	1857	0	1831	0.0	0.0
chr6	AL357146.1	140083229	140083257	0	29	0	2548	0	2519	0.0	0.0
chr6	AL357146.1	140087990	140088007	0	18	0	2548	0	2530	0.0	0.0
chr6	AL357146.1	140086757	140086761	0	5	0	2548	0	2543	0.0	0.0
chr6	ADGRG6	142370229	142370793	0	565	102	8466	102	7901	0.0	0.012909758258448298
chr6	FBXO30-DT	145828421	145828456	0	36	0	8517	0	8481	0.0	0.0
chr6	GRM1	146027793	146027828	0	36	0	7383	0	7347	0.0	0.0
chr6	ADGB	146784674	146784794	0	121	0	7809	0	7688	0.0	0.0
chr6	SASH1	148519894	148520382	0	489	0	10733	0	10244	0.0	0.0
chr6	PCMT1	149802370	149802416	0	47	426	2845	426	2798	0.0	0.1522516082916369
chr6	IYD	150389476	150389543	0	68	153	9466	153	9398	0.0	0.016280059587146203
chr6	IYD	150395455	150395566	0	112	153	9466	153	9354	0.0	0.0163566388710712
chr6	AL080276.2	152988015	152988022	0	8	0	3400	0	3392	0.0	0.0
chr6	AL080276.2	152983806	152984250	0	445	0	3400	0	2955	0.0	0.0
chr6	OPRM1	154010560	154011018	0	459	408	20919	408	20460	0.0	0.01994134897360704
chr6	OPRM1	154087786	154087804	0	19	408	20919	408	20900	0.0	0.019521531100478468
chr6	SCAF8	154733504	154733550	0	47	12292	5450	12292	5403	0.0	2.275032389413289
chr6	ZDHHC14	157628375	157628486	0	112	621	11143	621	11031	0.0	0.056295893391351645
chr6	C6ORF99	158869966	158870310	9269	345	10605	1833	1336	1488	26.866666666666667	0.8978494623655914
chr6	C6ORF99	158869978	158870310	9269	333	10605	1833	1336	1500	27.834834834834833	0.8906666666666667
chr6	C6ORF99	158869970	158870310	9269	341	10605	1833	1336	1492	27.181818181818183	0.8954423592493298
chr6	C6ORF99	158869966	158869977	0	12	10605	1833	10605	1821	0.0	5.823723228995058
chr6	C6ORF99	158869970	158869977	0	8	10605	1833	10605	1825	0.0	5.810958904109589
chr6	C6ORF99	158869966	158869969	0	4	10605	1833	10605	1829	0.0	5.798250410060142
chr6	WTAP	159748370	159750010	0	1641	0	6422	0	4781	0.0	0.0
chr6	PNLDC1	159803311	159803388	0	78	0	2094	0	2016	0.0	0.0
chr6	PNLDC1	159800380	159800383	0	4	0	2094	0	2090	0.0	0.0
chr6	AL109933.1	160698501	160698535	0	35	0	329	0	294	0.0	0.0
chr6	PLG	160741369	160741417	0	49	2021	6148	2021	6099	0.0	0.33136579767174945
chr6	PLG	160706543	160706593	0	51	2021	6148	2021	6097	0.0	0.33147449565360015
chr6	AL139393.2	160928017	160928093	0	77	0	1292	0	1215	0.0	0.0
chr6	MAP3K4	161093840	161093851	0	12	25	7415	25	7403	0.0	0.0033770093205457248
chr6	QKI	163423214	163423592	0	379	97	12507	97	12128	0.0	0.00799802110817942
chr6	AL078602.1	163759366	163759429	0	64	102	6195	102	6131	0.0	0.016636763986299135
chr6	AL078602.1	163759389	163759429	0	41	102	6195	102	6154	0.0	0.016574585635359115
chr6	AL078602.1	163759366	163759388	0	23	102	6195	102	6172	0.0	0.016526247569669476
chr6	AL078602.1	163671697	163671893	0	197	102	6195	102	5998	0.0	0.017005668556185394
chr6	AL450345.1	164829982	164830071	0	90	0	2884	0	2794	0.0	0.0
chr6	AL450345.1	164827964	164828019	0	56	0	2884	0	2828	0.0	0.0
chr6	LNCDAT	166168704	166168770	0	67	51	2158	51	2091	0.0	0.024390243902439025
chr6	AL022069.3	166342727	166343147	0	421	0	3906	0	3485	0.0	0.0
chr6	AFDN	167943192	167943194	0	3	51	13403	51	13400	0.0	0.0038059701492537314
chr6	AFDN	167965854	167966045	0	192	51	13403	51	13211	0.0	0.003860419347513436
chr6	AFDN	167966046	167966270	0	225	51	13403	51	13178	0.0	0.003870086507816057
chr6	AFDN	167966271	167966276	0	6	51	13403	51	13397	0.0	0.0038068224229305067
chr6	AL109924.2	169067983	169068299	0	317	0	772	0	455	0.0	0.0
chr6	AL596442.1	170160640	170160696	0	57	9133	765	9133	708	0.0	12.899717514124294
chr6	TBP	170569741	170569779	18	39	153	2328	135	2289	0.46153846153846156	0.05897771952817824
chr6	LINC01600	2633573	2633603	0	31	2551	3082	2551	3051	0.0	0.8361193051458539
chr6	SERPINB6	2971490	2971531	4775	42	416205	6054	411430	6012	113.69047619047619	68.43479707252162
chr6	SERPINB6	2971247	2971531	15847	285	416205	6054	400358	5769	55.603508771929825	69.3981625931704
chr6	SERPINB6	2971247	2971489	11072	243	416205	6054	405133	5811	45.56378600823045	69.71829289278953
chr6	SERPINB6	2971247	2971590	16456	344	416205	6054	399749	5710	47.83720930232558	70.00858143607705
chr6	SERPINB6	2966399	2968777	43911	2379	416205	6054	372294	3675	18.457755359394703	101.30448979591837
chr6	SERPINB6	2966399	2970694	106794	4296	416205	6054	309411	1758	24.858938547486034	176.00170648464163
chr6	SERPINB6	2968778	2968797	283	20	416205	6054	415922	6034	14.15	68.92973152137886
chr6	SERPINB6	2971116	2971246	1226	131	416205	6054	414979	5923	9.358778625954198	70.06229951038326
chr6	SERPINB6	2970695	2970756	1513	62	416205	6054	414692	5992	24.403225806451612	69.20761014686248
chr6	SLC22A23	3323833	3323885	165	53	77444	6133	77279	6080	3.1132075471698113	12.710361842105263
chr6	AL033523.1	3653220	3653599	0	380	4735	14663	4735	14283	0.0	0.33151298746761887
chr6	AL033523.1	3631925	3632027	0	103	4735	14663	4735	14560	0.0	0.32520604395604397
chr6	PXDC1	3738056	3738060	15	5	396423	2168	396408	2163	3.0	183.26768377253813
chr6	ECI2	4135311	4135509	1452	199	209016	4584	207564	4385	7.296482412060302	47.335005701254275
chr6	ECI2	4135114	4135310	1392	197	209016	4584	207624	4387	7.065989847715736	47.32710280373832
chr6	SSR1	7295384	7295390	0	7	250941	2851	250941	2844	0.0	88.23523206751055
chr6	CAGE1	7368687	7368752	0	66	112	3526	112	3460	0.0	0.03236994219653179
chr6	CAGE1	7378616	7378620	0	5	112	3526	112	3521	0.0	0.03180914512922465
chr6	CAGE1	7389201	7389281	0	81	112	3526	112	3445	0.0	0.03251088534107402
chr6	SLC35B3	8435076	8435341	2364	266	70179	3823	67815	3557	8.887218045112782	19.065223502951927
chr6	SLC35B3	8435076	8435226	1304	151	70179	3823	68875	3672	8.635761589403973	18.7568082788671
chr6	SLC35B3	8435227	8435341	1060	115	70179	3823	69119	3708	9.217391304347826	18.640507011866234
chr6	MAK	10838341	10838480	0	140	24054	4411	24054	4271	0.0	5.631936314680403
chr6	MAK	10838481	10838501	0	21	24054	4411	24054	4390	0.0	5.4792710706150345
chr6	TBC1D7	13328295	13328454	0	160	20248	6125	20248	5965	0.0	3.3944677284157585
chr6	TBC1D7	13328295	13328314	0	20	20248	6125	20248	6105	0.0	3.3166257166257167
chr6	TBC1D7	13307595	13307598	4	4	20248	6125	20244	6121	1.0	3.3073027283123673
chr6	TBC1D7	13328315	13328454	0	140	20248	6125	20248	5985	0.0	3.38312447786132
chr6	TBC1D7	13327832	13328294	0	463	20248	6125	20248	5662	0.0	3.5761215118332745
chr6	TBC1D7	13327832	13328314	0	483	20248	6125	20248	5642	0.0	3.5887982984757176
chr6	LNC-LBCS	19534886	19534906	0	21	11739	12676	11739	12655	0.0	0.9276175424733307
chr6	LNC-LBCS	19538327	19538361	0	35	11739	12676	11739	12641	0.0	0.9286448856894233
chr6	LNC-LBCS	19538312	19538361	0	50	11739	12676	11739	12626	0.0	0.9297481387612863
chr6	LNC-LBCS	19538312	19538326	0	15	11739	12676	11739	12661	0.0	0.9271779480293816
chr6	LNC-LBCS	19804170	19804673	662	504	11739	12676	11077	12172	1.3134920634920635	0.9100394347683207
chr6	TDP2	24666118	24666524	3683	407	284123	2852	280440	2445	9.04914004914005	114.69938650306749
chr6	CMAHP	25261123	25261408	0	286	317	7466	317	7180	0.0	0.04415041782729805
chr6	SLC17A2	25914544	25914578	0	35	0	2580	0	2545	0.0	0.0
chr6	AL031777.2	26198858	26198947	459	90	17197	1606	16738	1516	5.1	11.04089709762533
chr6	H2BC11	27132366	27132523	0	158	0	839	0	681	0.0	0.0
chr6	ZSCAN31	28335829	28336080	2005	252	12071	3678	10066	3426	7.9563492063492065	2.938120256859311
chr6	ZSCAN31	28337755	28337797	0	43	12071	3678	12071	3635	0.0	3.3207702888583217
chr6	GABBR1	29630457	29630520	0	64	191017	8494	191017	8430	0.0	22.659193357058125
chr6	ZNRD1ASP	30060740	30060960	0	221	38940	9881	38940	9660	0.0	4.031055900621118
chr6	ZNRD1ASP	30060740	30061077	0	338	38940	9881	38940	9543	0.0	4.080477837158126
chr6	ZNRD1ASP	30060961	30061077	0	117	38940	9881	38940	9764	0.0	3.988119623105285
chr6	HCG18	30294470	30294851	2947	382	134925	15541	131978	15159	7.714659685863874	8.70624711392572
chr6	HCG18	30326353	30326858	0	506	134925	15541	134925	15035	0.0	8.974060525440638
chr6	HCG18	30326150	30326352	0	203	134925	15541	134925	15338	0.0	8.796779241100534
chr6	HCG18	30291536	30294469	28730	2934	134925	15541	106195	12607	9.792092706203135	8.423494883794717
chr6	HCG18	30326008	30326149	0	142	134925	15541	134925	15399	0.0	8.761932593025522
chr6	HCG18	30326008	30326352	0	345	134925	15541	134925	15196	0.0	8.878981310871282
chr6	DHX16	30672634	30672954	85929	321	338027	3677	252098	3356	267.69158878504675	75.11859356376638
chr6	PPP1R18	30684407	30687112	9584	2706	30258	4135	20674	1429	3.541759053954176	14.467459762071378
chr6	MDC1	30717244	30717247	0	4	598719	7574	598719	7570	0.0	79.09101717305153
chr6	MDC1	30716881	30717082	0	202	598719	7574	598719	7372	0.0	81.21527400976669
chr6	FLOT1	30741613	30741660	0	48	151	3108	151	3060	0.0	0.04934640522875817
chr6	FLOT1	30742383	30742465	0	83	151	3108	151	3025	0.0	0.049917355371900826
chr6	CCHCR1	31145165	31145186	66	22	13501	4266	13435	4244	3.0	3.16564561734213
chr6	CCHCR1	31158166	31158169	0	4	13501	4266	13501	4262	0.0	3.167761614265603
chr6	CCHCR1	31157998	31158009	0	12	13501	4266	13501	4254	0.0	3.173718852844382
chr6	CCHCR1	31157357	31157383	0	27	13501	4266	13501	4239	0.0	3.184949280490682
chr6	CCHCR1	31157884	31157997	0	114	13501	4266	13501	4152	0.0	3.251685934489403
chr6	CCHCR1	31157884	31158009	0	126	13501	4266	13501	4140	0.0	3.261111111111111
chr6	ATP6V1G2	31546477	31546630	0	154	712	2151	712	1997	0.0	0.35653480220330497
chr6	NCR3	31592678	31592855	357	178	68640	1155	68283	977	2.00561797752809	69.89048106448311
chr6	BAG6	31652423	31652511	0	89	87466	5364	87466	5275	0.0	16.58123222748815
chr6	BAG6	31652234	31652245	0	12	87466	5364	87466	5352	0.0	16.34267563527653
chr6	BAG6	31651901	31652078	0	178	87466	5364	87466	5186	0.0	16.86579251831855
chr6	BAG6	31651901	31652059	0	159	87466	5364	87466	5205	0.0	16.80422670509126
chr6	BAG6	31652399	31652422	0	24	87466	5364	87466	5340	0.0	16.37940074906367
chr6	BAG6	31652399	31652511	0	113	87466	5364	87466	5251	0.0	16.657017710912207
chr6	BAG6	31651865	31651900	54	36	87466	5364	87412	5328	1.5	16.406156156156158
chr6	BAG6	31652060	31652078	0	19	87466	5364	87466	5345	0.0	16.364078578110384
chr6	GPANK1	31665558	31665572	9	15	4857	3249	4848	3234	0.6	1.4990723562152133
chr6	LY6G5C	31680158	31680251	0	94	0	2627	0	2533	0.0	0.0
chr6	VWA7	31775963	31776162	0	200	133149	3689	133149	3489	0.0	38.16251074806535
chr6	VARS1	31782284	31782400	0	117	1161565	5586	1161565	5469	0.0	212.39074785152678
chr6	NEU1	31860041	31860045	0	5	93965	4728	93965	4723	0.0	19.89519373279695
chr6	NELFE	31958307	31958370	0	64	1512	2493	1512	2429	0.0	0.622478386167147
chr6	NELFE	31958579	31958669	0	91	1512	2493	1512	2402	0.0	0.6294754371357202
chr6	DXO	31971319	31971927	0	609	1082	1879	1082	1270	0.0	0.8519685039370078
chr6	ATF6B	32128116	32128124	0	9	17427	3646	17427	3637	0.0	4.791586472367336
chr6	AL662884.3	32154237	32154287	1697	51	230672	1064	228975	1013	33.27450980392157	226.03652517275418
chr6	AL662884.3	32154168	32154236	3932	69	230672	1064	226740	995	56.98550724637681	227.87939698492463
chr6	AL662884.3	32154168	32154287	5629	120	230672	1064	225043	944	46.90833333333333	238.39300847457628
chr6	AGER	32183275	32183322	0	48	0	1715	0	1667	0.0	0.0
chr6	AGER	32183554	32183566	0	13	0	1715	0	1702	0.0	0.0
chr6	TSBP1	32323590	32323591	0	2	34062	2235	34062	2233	0.0	15.253918495297805
chr6	BTNL2	32396038	32396041	0	4	0	1377	0	1373	0.0	0.0
chr6	BTNL2	32405174	32405178	0	5	0	1377	0	1372	0.0	0.0
chr6	HLA-DRB6	32554618	32554688	0	71	0	1332	0	1261	0.0	0.0
chr6	HLA-DMA	32949270	32949272	179	3	60930	2526	60751	2523	59.666666666666664	24.078874355925485
chr6	HLA-DOA	33007310	33007352	0	43	0	3854	0	3811	0.0	0.0
chr6	VPS52	33263771	33263781	50	11	1362698	3958	1362648	3947	4.545454545454546	345.23638206232584
chr6	VPS52	33271136	33271584	55009	449	1362698	3958	1307689	3509	122.51447661469933	372.66714163579366
chr6	VPS52	33271136	33271689	72355	554	1362698	3958	1290343	3404	130.6046931407942	379.06668625146887
chr6	VPS52	33271585	33271689	17346	105	1362698	3958	1345352	3853	165.2	349.1699974046198
chr6	WDR46	33280673	33280813	0	141	1190979	2584	1190979	2443	0.0	487.5067539909947
chr6	CUTA	33417958	33418085	3325	128	88350	1281	85025	1153	25.9765625	73.74241110147442
chr6	CUTA	33417868	33417957	6432	90	88350	1281	81918	1191	71.46666666666667	68.7808564231738
chr6	CUTA	33417868	33418085	9757	218	88350	1281	78593	1063	44.75688073394495	73.93508936970838
chr6	CUTA	33417246	33417249	268	4	88350	1281	88082	1277	67.0	68.97572435395458
chr6	LEMD2	33788380	33788773	0	394	663	6568	663	6174	0.0	0.10738581146744412
chr6	MLN	33795502	33795522	0	21	70	536	70	515	0.0	0.13592233009708737
chr6	LINC01016	33892695	33892706	0	12	0	1879	0	1867	0.0	0.0
chr6	LINC01016	33892316	33892694	0	379	0	1879	0	1500	0.0	0.0
chr6	LINC01016	33896585	33896817	0	233	0	1879	0	1646	0.0	0.0
chr6	SMIM29	34247680	34247739	7907	60	173291	1694	165384	1634	131.78333333333333	101.2141982864137
chr6	SMIM29	34248726	34248977	59402	252	173291	1694	113889	1442	235.72222222222223	78.97988904299584
chr6	RPS10	34425515	34425556	0	42	0	2123	0	2081	0.0	0.0
chr6	RPS10	34425557	34425581	0	25	0	2123	0	2098	0.0	0.0
chr6	TCP11	35140746	35140813	0	68	0	3084	0	3016	0.0	0.0
chr6	FKBP5	35688731	35688802	0	72	204	10641	204	10569	0.0	0.01930173147885325
chr6	SRPK1	35920986	35921042	0	57	20384	6252	20384	6195	0.0	3.2903954802259885
chr6	SRPK1	35920064	35920466	0	403	20384	6252	20384	5849	0.0	3.4850401778081723
chr6	SLC26A8	36024329	36024418	0	90	102	5043	102	4953	0.0	0.02059357964869776
chr6	SLC26A8	36024419	36024502	0	84	102	5043	102	4959	0.0	0.0205686630369026
chr6	SLC26A8	35954819	35955150	0	332	102	5043	102	4711	0.0	0.021651454043727446
chr6	ETV7	36375829	36375869	35	41	35	2383	0	2342	0.8536585365853658	0.0
chr6	MTCH1	36972651	36972701	0	51	0	3138	0	3087	0.0	0.0
chr6	TMEM217	37218425	37218473	0	49	727	2617	727	2568	0.0	0.28309968847352024
chr6	TMEM217	37257562	37257566	60	5	727	2617	667	2612	12.0	0.2553598774885146
chr6	MDGA1	37646197	37646266	0	70	2144	12747	2144	12677	0.0	0.16912518734716417
chr6	MOCS1	39909039	39909053	0	15	0	5101	0	5086	0.0	0.0
chr6	MOCS1	39927183	39927327	0	145	0	5101	0	4956	0.0	0.0
chr6	AL033380.1	40517303	40517410	0	108	0	1346	0	1238	0.0	0.0
chr6	OARD1	41072235	41072317	377	83	556209	6234	555832	6151	4.542168674698795	90.36449357827995
chr6	OARD1	41072235	41072333	471	99	556209	6234	555738	6135	4.757575757575758	90.58484107579461
chr6	OARD1	41072318	41072333	94	16	556209	6234	556115	6218	5.875	89.43631392730782
chr6	TFEB	41732648	41733662	0	1015	512	5743	512	4728	0.0	0.10829103214890017
chr6	TFEB	41732648	41734083	0	1436	512	5743	512	4307	0.0	0.1188762479684235
chr6	USP49	41798723	41798873	0	151	33673	10934	33673	10783	0.0	3.1227858666419364
chr6	MED20	41909268	41909343	25989	76	97447	3286	71458	3210	341.9605263157895	22.26105919003115
chr6	CCND3	41940951	41941450	0	500	42639	5772	42639	5272	0.0	8.087822458270105
chr6	TRERF1	42263259	42263318	0	60	56006	7750	56006	7690	0.0	7.28296488946684
chr6	TRERF1	42362946	42362995	0	50	56006	7750	56006	7700	0.0	7.273506493506494
chr6	MEA1	43013785	43013896	5456	112	67608	2648	62152	2536	48.714285714285715	24.50788643533123
chr6	MEA1	43016419	43016793	57	375	67608	2648	67551	2273	0.152	29.71887373515178
chr6	CUL7	43053621	43053709	0	89	14404	6126	14404	6037	0.0	2.385953288056982
chr6	CUL7	43052112	43052207	51	96	14404	6126	14353	6030	0.53125	2.3802653399668325
chr6	MRPL2	43059179	43059284	110	106	1088	1897	978	1791	1.0377358490566038	0.5460636515912898
chr6	DNPH1	43229050	43229259	0	210	51	1250	51	1040	0.0	0.04903846153846154
chr6	DLK2	43453004	43453021	432	18	4173	2243	3741	2225	24.0	1.6813483146067416
chr6	YIPF3	43515594	43515604	0	11	97145	2603	97145	2592	0.0	37.47878086419753
chr6	XPO5	43527633	43527669	0	37	125777	7753	125777	7716	0.0	16.300803525142562
chr6	XPO5	43573397	43573478	255	82	125777	7753	125522	7671	3.1097560975609757	16.363186025290055
chr6	MRPS18A	43675201	43675492	0	292	0	1390	0	1098	0.0	0.0
chr6	LINC02537	43852069	43852175	0	107	0	2071	0	1964	0.0	0.0
chr6	AL035701.1	46129503	46129588	0	86	646	1897	646	1811	0.0	0.35670900055218113
chr6	AL591242.1	46687599	46687673	0	75	0	578	0	503	0.0	0.0
chr6	RHAG	49606728	49606846	0	119	0	2083	0	1964	0.0	0.0
chr6	CRISP2	49713474	49713499	0	26	51	1529	51	1503	0.0	0.033932135728542916
chr6	CILK1	53013640	53013660	0	21	0	6317	0	6296	0.0	0.0
chr6	AL033397.1	53569422	53569478	0	57	0	3858	0	3801	0.0	0.0
chr6	MLIP-AS1	54047291	54047488	0	198	0	4048	0	3850	0.0	0.0
chr6	DST	56573678	56573730	0	53	32143	43263	32143	43210	0.0	0.743878731775052
chr6	LINC00680	57948872	57948916	0	45	0	2185	0	2140	0.0	0.0
chr6	AL713998.1	67886967	67886985	0	19	51	5335	51	5316	0.0	0.009593679458239277
chr6	AL713998.1	67883603	67883704	0	102	51	5335	51	5233	0.0	0.009745843684311103
chr6	LMBRD1	69796413	69796489	0	77	0	8302	0	8225	0.0	0.0
chr6	LMBRD1	69708849	69709155	0	307	0	8302	0	7995	0.0	0.0
chr6	LMBRD1	69796378	69796412	0	35	0	8302	0	8267	0.0	0.0
chr6	LMBRD1	69796378	69796489	0	112	0	8302	0	8190	0.0	0.0
chr6	LMBRD1	69755472	69755556	0	85	0	8302	0	8217	0.0	0.0
chr6	B3GAT2	70955838	70956053	0	216	0	6375	0	6159	0.0	0.0
chr6	LINC00472	71346164	71346172	0	9	23316	11340	23316	11331	0.0	2.057717765422293
chr6	FO393414.3	72619438	72619978	0	541	0	4482	0	3941	0.0	0.0
chr6	KHDC1	73262773	73262932	0	160	0	2448	0	2288	0.0	0.0
chr6	EEF1A1	73519882	73519890	0	9	4478	6341	4478	6332	0.0	0.7072015161086544
chr6	EEF1A1	73520999	73521505	0	507	4478	6341	4478	5834	0.0	0.7675694206376414
chr6	EEF1A1	73521506	73521730	0	225	4478	6341	4478	6116	0.0	0.7321778940483976
chr6	EEF1A1	73523446	73523723	0	278	4478	6341	4478	6063	0.0	0.7385782615866733
chr6	EEF1A1	73520361	73520998	0	638	4478	6341	4478	5703	0.0	0.7852007715237594
chr6	EEF1A1	73520361	73520908	0	548	4478	6341	4478	5793	0.0	0.7730018988434317
chr6	COX7A2	75241122	75241174	0	53	0	1928	0	1875	0.0	0.0
chr6	COX7A2	75240276	75240299	0	24	0	1928	0	1904	0.0	0.0
chr6	TMEM30A	75284401	75284495	0	95	101	5513	101	5418	0.0	0.01864156515319306
chr6	HMGN3	79202275	79202315	0	41	0	1021	0	980	0.0	0.0
chr6	LCA5	79537164	79537241	0	78	0	5972	0	5894	0.0	0.0
chr6	LINC01621	79805252	79805894	0	643	0	1477	0	834	0.0	0.0
chr6	TENT5A	81752430	81752567	0	138	0	1863	0	1725	0.0	0.0
chr6	TENT5A	81752375	81752429	0	55	0	1863	0	1808	0.0	0.0
chr6	TENT5A	81752375	81752567	0	193	0	1863	0	1670	0.0	0.0
chr6	LINC02542	82101559	82101643	0	85	333	2815	333	2730	0.0	0.12197802197802197
chr6	IBTK	82227163	82227190	0	28	2552	7325	2552	7297	0.0	0.3497327668905029
chr6	UBE3D	83022452	83022477	0	26	6514	6416	6514	6390	0.0	1.0194053208137714
chr6	UBE3D	83065641	83065678	0	38	6514	6416	6514	6378	0.0	1.0213232988397616
chr6	PGM3	83170300	83170303	0	4	153	5939	153	5935	0.0	0.025779275484414492
chr6	PGM3	83192961	83193177	0	217	153	5939	153	5722	0.0	0.026738902481649774
chr6	PGM3	83193104	83193177	0	74	153	5939	153	5865	0.0	0.02608695652173913
chr6	SNAP91	83708844	83709120	990	277	4795	6360	3805	6083	3.5740072202166067	0.6255137267795495
chr6	SNAP91	83708844	83709042	737	199	4795	6360	4058	6161	3.7035175879396984	0.6586593085538062
chr6	SNAP91	83709121	83709324	35	204	4795	6360	4760	6156	0.1715686274509804	0.7732293697205977
chr6	SNAP91	83709043	83709120	253	78	4795	6360	4542	6282	3.2435897435897436	0.723018147086915
chr6	SNAP91	83708664	83708843	1152	180	4795	6360	3643	6180	6.4	0.5894822006472492
chr6	SNAP91	83708345	83708361	0	17	4795	6360	4795	6343	0.0	0.7559514425350781
chr6	SNAP91	83708362	83708663	1020	302	4795	6360	3775	6058	3.377483443708609	0.6231429514691317
chr6	SNAP91	83708362	83708415	0	54	4795	6360	4795	6306	0.0	0.7603869330796067
chr6	SNAP91	83708416	83708663	1020	248	4795	6360	3775	6112	4.112903225806452	0.6176374345549738
chr6	SNX14	85547111	85547114	0	4	100	7137	100	7133	0.0	0.014019346698443853
chr6	SNX14	85593578	85593832	0	255	100	7137	100	6882	0.0	0.014530659691950014
chr6	SYNCRIP	85614980	85615017	0	38	0	9811	0	9773	0.0	0.0
chr6	SYNCRIP	85622481	85622585	0	105	0	9811	0	9706	0.0	0.0
chr6	SYNCRIP	85637242	85637267	0	26	0	9811	0	9785	0.0	0.0
chr6	SNHG5	85663673	85663685	0	13	0	7815	0	7802	0.0	0.0
chr6	SNHG5	85663475	85663672	0	198	0	7815	0	7617	0.0	0.0
chr6	SNHG5	85663475	85663685	0	211	0	7815	0	7604	0.0	0.0
chr6	SNHG5	85678693	85678696	0	4	0	7815	0	7811	0.0	0.0
chr6	SNHG5	85676984	85677091	0	108	0	7815	0	7707	0.0	0.0
chr6	SNHG5	85677423	85677793	0	371	0	7815	0	7444	0.0	0.0
chr6	SNHG5	85677423	85677952	0	530	0	7815	0	7285	0.0	0.0
chr6	SNHG5	85677423	85678134	0	712	0	7815	0	7103	0.0	0.0
chr6	SNHG5	85677794	85677952	0	159	0	7815	0	7656	0.0	0.0
chr6	SNHG5	85677794	85678134	0	341	0	7815	0	7474	0.0	0.0
chr6	SNHG5	85677790	85677793	0	4	0	7815	0	7811	0.0	0.0
chr6	SNHG5	85677953	85678134	0	182	0	7815	0	7633	0.0	0.0
chr6	SNHG5	85678402	85678692	0	291	0	7815	0	7524	0.0	0.0
chr6	SNHG5	85678402	85678696	0	295	0	7815	0	7520	0.0	0.0
chr6	SNHG5	85678402	85678496	0	95	0	7815	0	7720	0.0	0.0
chr6	SNHG5	85678497	85678692	0	196	0	7815	0	7619	0.0	0.0
chr6	SNHG5	85678497	85678696	0	200	0	7815	0	7615	0.0	0.0
chr6	SNHG5	85677790	85677952	0	163	0	7815	0	7652	0.0	0.0
chr6	CGA	87088093	87088111	0	19	0	1990	0	1971	0.0	0.0
chr6	AL353135.2	89145633	89145691	15	59	15	1763	0	1704	0.2542372881355932	0.0
chr6	AL353135.2	89143665	89143745	0	81	15	1763	15	1682	0.0	0.0089179548156956
chr6	LYRM2	89637724	89637740	0	17	12517	8685	12517	8668	0.0	1.4440470696815875
chr6	UFL1-AS1	96398908	96398913	0	6	0	6546	0	6540	0.0	0.0
chr6	UFL1-AS1	96460439	96460484	0	46	0	6546	0	6500	0.0	0.0
chr6	MMS22L	97282986	97283043	0	58	1305	18577	1305	18519	0.0	0.07046816782763649
chr6	MMS22L	97282986	97283076	0	91	1305	18577	1305	18486	0.0	0.07059396299902629
chr6	MMS22L	97282986	97283094	0	109	1305	18577	1305	18468	0.0	0.07066276803118908
chr6	MMS22L	97283044	97283076	0	33	1305	18577	1305	18544	0.0	0.07037316652286454
chr6	MMS22L	97283044	97283094	0	51	1305	18577	1305	18526	0.0	0.07044154161718666
chr6	MMS22L	97283077	97283094	0	18	1305	18577	1305	18559	0.0	0.0703162885931354
chr6	PNISR	99403828	99404601	0	774	0	5565	0	4791	0.0	0.0
chr6	CCNC	99558496	99558499	0	4	0	5627	0	5623	0.0	0.0
chr6	CCNC	99544178	99544204	0	27	0	5627	0	5600	0.0	0.0
chr6	CCNC	99568495	99568716	0	222	0	5627	0	5405	0.0	0.0
chr6	MCHR2	99993935	99994173	153	239	3762	3789	3609	3550	0.6401673640167364	1.016619718309859
chr6	LIN28B-AS1	104940837	104940978	0	142	51	5056	51	4914	0.0	0.010378510378510378
chr6	POPDC3	105161424	105161794	51	371	459	2285	408	1914	0.13746630727762804	0.21316614420062696
chr6	LINC02532	106787258	106787281	0	24	14827	11311	14827	11287	0.0	1.3136351554886152
chr6	LINC02532	106787258	106787481	0	224	14827	11311	14827	11087	0.0	1.337332010462704
chr6	LINC02532	106787282	106787481	0	200	14827	11311	14827	11111	0.0	1.3344433444334443
chr6	CD24	106975133	106975367	1514	235	1596	1798	82	1563	6.4425531914893615	0.052463211772232884
chr6	SNX3	108260759	108260824	0	66	11556	1833	11556	1767	0.0	6.539898132427844
chr6	CD164	109381503	109381708	0	206	667	6868	667	6662	0.0	0.1001200840588412
chr6	MICAL1	109455610	109455717	51	108	13100	5222	13049	5114	0.4722222222222222	2.5516229956980836
chr6	WASF1	110179438	110179839	1326	402	51	3135	-1275	2733	3.298507462686567	-0.4665203073545554
chr6	SLC22A16	110456537	110456898	195	362	16922	2809	16727	2447	0.5386740331491713	6.835717204740498
chr6	SLC22A16	110476257	110476314	0	58	16922	2809	16922	2751	0.0	6.151217739003998
chr6	TRAF3IP2	111566997	111567048	0	52	21938	7884	21938	7832	0.0	2.8010725229826354
chr6	TRAF3IP2	111566997	111567110	0	114	21938	7884	21938	7770	0.0	2.8234234234234235
chr6	TRAF3IP2	111567049	111567214	0	166	21938	7884	21938	7718	0.0	2.842446229593159
chr6	TRAF3IP2	111567049	111567110	0	62	21938	7884	21938	7822	0.0	2.8046535412937867
chr6	TRAF3IP2	111567111	111567214	0	104	21938	7884	21938	7780	0.0	2.819794344473008
chr6	FYN	111719804	111719854	0	51	11800	6971	11800	6920	0.0	1.7052023121387283
chr6	FYN	111758833	111759038	0	206	11800	6971	11800	6765	0.0	1.7442719881744273
chr6	LINC02527	111908925	111908948	182	24	1071	1146	889	1122	7.583333333333333	0.7923351158645277
chr6	LAMA4	112189109	112189129	0	21	476	11935	476	11914	0.0	0.0399529964747356
chr6	LAMA4	112254441	112254457	0	17	476	11935	476	11918	0.0	0.039939587179056886
chr6	LAMA4	112254441	112254594	0	154	476	11935	476	11781	0.0	0.04040404040404041
chr6	LAMA4	112150435	112150509	102	75	476	11935	374	11860	1.36	0.03153456998313659
chr6	LAMA4	112254401	112254457	0	57	476	11935	476	11878	0.0	0.040074086546556656
chr6	LAMA4	112254401	112254440	0	40	476	11935	476	11895	0.0	0.040016813787305594
chr6	LINC02541	113627469	113627519	0	51	0	2418	0	2367	0.0	0.0
chr6	HDAC2	113970254	113970478	0	225	357	12521	357	12296	0.0	0.029033832140533507
chr6	GPRC6A	116806369	116806893	0	525	0	2914	0	2389	0.0	0.0
chr6	FAM184A	118961760	118961927	0	168	2462	7735	2462	7567	0.0	0.32536011629443634
chr6	RNF217-AS1	124648252	124648582	0	331	0	11186	0	10855	0.0	0.0
chr6	ECHDC1	127342960	127343334	0	375	0	5138	0	4763	0.0	0.0
chr6	ECHDC1	127326997	127327000	0	4	0	5138	0	5134	0.0	0.0
chr6	KIAA0408	127446407	127446870	0	464	1376	8707	1376	8243	0.0	0.16692951595292976
chr6	AL096711.2	127475292	127475300	0	9	2243	11476	2243	11467	0.0	0.19560477893084505
chr6	SOGA3	127518533	127518577	0	45	1842	4333	1842	4288	0.0	0.4295708955223881
chr6	AL355581.1	130142683	130142750	0	68	0	3172	0	3104	0.0	0.0
chr6	AL355581.1	130137635	130137943	0	309	0	3172	0	2863	0.0	0.0
chr6	SAMD3	130215796	130215882	0	87	16	6681	16	6594	0.0	0.002426448286320898
chr6	EPB41L2	130858130	130858134	0	5	0	10058	0	10053	0.0	0.0
chr6	EPB41L2	131063141	131063153	0	13	0	10058	0	10045	0.0	0.0
chr6	EPB41L2	130869562	130869810	0	249	0	10058	0	9809	0.0	0.0
chr6	VNN2	132752460	132752671	0	212	0	2606	0	2394	0.0	0.0
chr6	TARID	133568189	133568192	0	4	300	8097	300	8093	0.0	0.03706907203756333
chr6	SGK1	134317391	134317813	0	423	0	6257	0	5834	0.0	0.0
chr6	CT69	134447933	134447934	0	2	51	3481	51	3479	0.0	0.01465938488071285
chr6	AL078590.2	134539898	134540087	0	190	213	3122	213	2932	0.0	0.07264665757162346
chr6	ALDH8A1	134929053	134929094	0	42	0	2824	0	2782	0.0	0.0
chr6	HBS1L	135026853	135027065	0	213	30	10065	30	9852	0.0	0.0030450669914738123
chr6	AHI1	135495312	135495537	0	226	42520	8731	42520	8505	0.0	4.999412110523221
chr6	MTFR2	136249975	136250262	0	288	0	2171	0	1883	0.0	0.0
chr6	NHEG1	136990053	136990060	0	8	0	1360	0	1352	0.0	0.0
chr6	IFNGR1	137218671	137218982	0	312	6407	2945	6407	2633	0.0	2.433345993163692
chr6	IFNGR1	137218671	137219241	612	571	6407	2945	5795	2374	1.0718038528896672	2.441027801179444
chr6	IFNGR1	137218671	137219092	168	422	6407	2945	6239	2523	0.3981042654028436	2.472849782005549
chr6	REPS1	138926400	138929975	0	3576	1767	6039	1767	2463	0.0	0.7174177831912302
chr6	LINC01625	139474501	139474564	0	64	0	7136	0	7072	0.0	0.0
chr6	PHACTR2-AS1	143561166	143561828	0	663	0	2119	0	1456	0.0	0.0
chr6	PLAGL1	143960468	143960471	0	4	0	8363	0	8359	0.0	0.0
chr6	PLAGL1	143964786	143966156	0	1371	0	8363	0	6992	0.0	0.0
chr6	PLAGL1	143965849	143966156	0	308	0	8363	0	8055	0.0	0.0
chr6	PLAGL1	143965107	143965178	0	72	0	8363	0	8291	0.0	0.0
chr6	PLAGL1	144064450	144064466	0	17	0	8363	0	8346	0.0	0.0
chr6	EPM2A	145735197	145735243	0	47	0	17587	0	17540	0.0	0.0
chr6	EPM2A	145671238	145671263	0	26	0	17587	0	17561	0.0	0.0
chr6	EPM2A	145686899	145686919	0	21	0	17587	0	17566	0.0	0.0
chr6	EPM2A	145686843	145686898	0	56	0	17587	0	17531	0.0	0.0
chr6	EPM2A	145686843	145686919	0	77	0	17587	0	17510	0.0	0.0
chr6	SHPRH	145963730	145964155	0	426	1607	17722	1607	17296	0.0	0.09291165587419056
chr6	SHPRH	145933049	145933055	0	7	1607	17722	1607	17715	0.0	0.09071408410951172
chr6	SHPRH	145934905	145934905	0	1	1607	17722	1607	17721	0.0	0.09068337001297895
chr6	STXBP5-AS1	146844282	146844317	0	36	1218	11664	1218	11628	0.0	0.10474716202270382
chr6	RAET1E	149889884	149889989	0	106	1940	3011	1940	2905	0.0	0.6678141135972461
chr6	RMND1	151436419	151436444	0	26	1059757	4190	1059757	4164	0.0	254.50456292026897
chr6	SYNE1	152354658	152354723	0	66	780	42788	780	42722	0.0	0.018257572211038808
chr6	SYNE1	152352026	152352166	30	141	780	42788	750	42647	0.2127659574468085	0.01758623115342228
chr6	SYNE1	152135025	152135102	0	78	780	42788	780	42710	0.0	0.018262701943338795
chr6	LINC02840	152759979	152759980	0	2	0	8955	0	8953	0.0	0.0
chr6	MTRF1L	152995243	152995261	0	19	0	4304	0	4285	0.0	0.0
chr6	MTRF1L	152995135	152995242	0	108	0	4304	0	4196	0.0	0.0
chr6	MTRF1L	152995135	152995261	0	127	0	4304	0	4177	0.0	0.0
chr6	IPCEF1	154247069	154247189	0	121	153	3968	153	3847	0.0	0.039771250324928516
chr6	SOD2	159692530	159692659	2217	130	8459	6793	6242	6663	17.053846153846155	0.9368152483866127
chr6	SOD2	159727128	159727264	0	137	8459	6793	8459	6656	0.0	1.2708834134615385
chr6	LPAL2	160482661	160482686	6097	26	492398	4767	486301	4741	234.5	102.57350769879773
chr6	LPAL2	160477128	160477128	0	1	492398	4767	492398	4766	0.0	103.31472933277381
chr6	AL391361.2	160918401	160918435	0	35	37	897	37	862	0.0	0.042923433874709975
chr6	PACRG-AS3	163187672	163190906	0	3235	51	8368	51	5133	0.0	0.009935710111046173
chr6	PACRG-AS3	163191880	163191948	0	69	51	8368	51	8299	0.0	0.006145318713097964
chr6	AL031121.2	163346352	163346377	0	26	0	7004	0	6978	0.0	0.0
chr6	AL031121.2	163340754	163343106	0	2353	0	7004	0	4651	0.0	0.0
chr6	TBXT	166168327	166168581	0	255	0	2612	0	2357	0.0	0.0
chr6	RNASET2	166948565	166948568	0	4	714	14460	714	14456	0.0	0.0493912562257886
chr6	RNASET2	166956948	166957124	0	177	714	14460	714	14283	0.0	0.04998949800462088
chr6	TCP10L3	167376970	167377953	2401	984	26551	8397	24150	7413	2.440040650406504	3.2577903682719547
chr6	TCP10L3	167384165	167384379	0	215	26551	8397	26551	8182	0.0	3.2450501099975555
chr6	TCP10L3	167376545	167377953	3005	1409	26551	8397	23546	6988	2.132718239886444	3.36949055523755
chr6	KIF25-AS1	167996205	167996236	0	32	0	3093	0	3061	0.0	0.0
chr6	FRMD1	168064870	168064903	0	34	0	7718	0	7684	0.0	0.0
chr6	THBS2	169248416	169248455	0	40	51	5550	51	5510	0.0	0.009255898366606171
chr6	THBS2	169237609	169237623	0	15	51	5550	51	5535	0.0	0.00921409214092141
chr6	THBS2	169221419	169221428	0	10	51	5550	51	5540	0.0	0.0092057761732852
chr7	AC093627.4	150133	152547	4666	2415	40697	3520	36031	1105	1.9320910973084886	32.607239819004526
chr7	HRAT92	522704	523316	0	613	0	1853	0	1240	0.0	0.0
chr7	ZFAND2A-DT	1160624	1163495	696	2872	1551	2348	855	-524	0.24233983286908078	-1.631679389312977
chr7	ZFAND2A-DT	1163208	1163217	0	10	1551	2348	1551	2338	0.0	0.6633875106928999
chr7	PSMG3-AS1	1570280	1570533	2190	254	6661	5168	4471	4914	8.622047244094489	0.9098494098494099
chr7	NUDT1	2242976	2243048	0	73	764	2013	764	1940	0.0	0.3938144329896907
chr7	CHST12	2403646	2403673	0	28	197554	3713	197554	3685	0.0	53.61031207598372
chr7	RNF216P1	4985076	4985130	0	55	2505	3552	2505	3497	0.0	0.7163282813840435
chr7	RNF216P1	4993814	4995582	0	1769	2505	3552	2505	1783	0.0	1.4049355019629837
chr7	OR10AH1P	5116773	5116783	0	11	6544	3539	6544	3528	0.0	1.854875283446712
chr7	WIPI2	5229706	5229738	0	33	14338	7716	14338	7683	0.0	1.8661980997006378
chr7	FSCN1	5594821	5594896	0	76	329	3567	329	3491	0.0	0.09424233743912919
chr7	ZDHHC4	6577499	6577720	0	222	102	3565	102	3343	0.0	0.03051151660185462
chr7	ZDHHC4	6578721	6578746	0	26	102	3565	102	3539	0.0	0.028821701045493076
chr7	RSPH10B2	6754175	6754509	0	335	34372	4899	34372	4564	0.0	7.531113058720421
chr7	RSPH10B2	6764085	6764101	0	17	34372	4899	34372	4882	0.0	7.040557148709545
chr7	RSPH10B2	6781477	6781574	1267	98	34372	4899	33105	4801	12.928571428571429	6.89543845032285
chr7	MIOS	7567073	7567484	0	412	23603	6728	23603	6316	0.0	3.737017099430019
chr7	UMAD1	7868534	7868608	0	75	1877	3764	1877	3689	0.0	0.5088099756031444
chr7	GLCCI1	8060110	8060248	0	139	459	6051	459	5912	0.0	0.07763870094722598
chr7	AC007128.2	8303797	8304155	714	359	765	919	51	560	1.988857938718663	0.09107142857142857
chr7	TMEM106B	12211426	12211547	0	122	51	13848	51	13726	0.0	0.0037155762785953663
chr7	AC011287.1	13717897	13718235	0	339	98	12535	98	12196	0.0	0.008035421449655624
chr7	AC011287.1	13718236	13719907	0	1672	98	12535	98	10863	0.0	0.009021448955168923
chr7	AC011287.1	13717897	13719907	0	2011	98	12535	98	10524	0.0	0.009312048650703154
chr7	CRPPA-AS1	16237353	16237410	98	58	105	2784	7	2726	1.6896551724137931	0.0025678650036683784
chr7	BZW2	16646289	16646304	0	16	6580	3675	6580	3659	0.0	1.7983055479639245
chr7	HDAC9	18591637	18591642	0	6	3825	16740	3825	16734	0.0	0.22857655073503047
chr7	HDAC9	18495855	18496023	0	169	3825	16740	3825	16571	0.0	0.2308249351276326
chr7	AC099342.1	20296760	20296818	0	59	5	2149	5	2090	0.0	0.0023923444976076554
chr7	AC099342.1	20298398	20298466	0	69	5	2149	5	2080	0.0	0.002403846153846154
chr7	DNAH11	21616293	21616307	0	15	273	16261	273	16246	0.0	0.016804136402806844
chr7	SNHG26	22858796	22858830	628	35	131681	5723	131053	5688	17.942857142857143	23.040260196905766
chr7	SNHG26	22858831	22858976	1915	146	131681	5723	129766	5577	13.116438356164384	23.268065268065268
chr7	SNHG26	22858796	22858976	2543	181	131681	5723	129138	5542	14.049723756906078	23.30169613857813
chr7	NUP42	23197231	23197247	0	17	7818	3660	7818	3643	0.0	2.146033488882789
chr7	GPNMB	23236759	23236823	1574	65	7250	5924	5676	5859	24.215384615384615	0.9687660010240655
chr7	FAM221A	23688324	23688987	0	664	1663	5529	1663	4865	0.0	0.3418293936279548
chr7	STK31	23710336	23710770	0	435	10875	5113	10875	4678	0.0	2.324711415134673
chr7	STK31	23710743	23710770	0	28	10875	5113	10875	5085	0.0	2.1386430678466075
chr7	STK31	23710739	23710770	0	32	10875	5113	10875	5081	0.0	2.1403267073410746
chr7	STK31	23710336	23710742	0	407	10875	5113	10875	4706	0.0	2.3108797280067996
chr7	STK31	23710739	23710742	0	4	10875	5113	10875	5109	0.0	2.1285965942454492
chr7	CBX3	26201827	26202609	204	783	17053	4587	16849	3804	0.26053639846743293	4.429284963196635
chr7	SNX10	26292087	26292133	0	47	0	3619	0	3572	0.0	0.0
chr7	AC004540.1	26398739	26399021	0	283	46	6357	46	6074	0.0	0.007573263088574251
chr7	HOXA-AS2	27115572	27116343	0	772	102	4914	102	4142	0.0	0.024625784645098986
chr7	HOXA-AS2	27123639	27124610	0	972	102	4914	102	3942	0.0	0.0258751902587519
chr7	HOXA11-AS	27185604	27185632	0	29	1991	3018	1991	2989	0.0	0.6661090665774506
chr7	HOXA11-AS	27185633	27186263	0	631	1991	3018	1991	2387	0.0	0.8341013824884793
chr7	EVX1	27243403	27243457	0	55	0	3173	0	3118	0.0	0.0
chr7	TAX1BP1	27816395	27816520	0	126	25225	9188	25225	9062	0.0	2.7836018538953873
chr7	JAZF1-AS1	28217345	28217349	0	5	0	4249	0	4244	0.0	0.0
chr7	CHN2	29480222	29480356	0	135	0	6384	0	6249	0.0	0.0
chr7	AC006978.2	30411955	30412073	3008	119	5627	670	2619	551	25.277310924369747	4.753176043557168
chr7	LINC01176	30403023	30403180	190	158	3525	981	3335	823	1.2025316455696202	4.05224787363305
chr7	GARS1	30594953	30595143	1455	191	76999	11228	75544	11037	7.617801047120419	6.8446135725287665
chr7	GARS1	30631542	30631559	108	18	76999	11228	76891	11210	6.0	6.85914362176628
chr7	GARS1	30601201	30601224	742	24	76999	11228	76257	11204	30.916666666666668	6.806229917886469
chr7	GARS1	30594940	30594952	190	13	76999	11228	76809	11215	14.615384615384615	6.848773963441819
chr7	AQP1	30923609	30923653	0	45	23899	3284	23899	3239	0.0	7.378511886384687
chr7	AQP1	30921625	30921838	2263	214	23899	3284	21636	3070	10.574766355140186	7.047557003257329
chr7	GHRHR	30972096	30972141	0	46	1395	3152	1395	3106	0.0	0.4491307147456536
chr7	ITPRID1	31577991	31578434	0	444	421	7265	421	6821	0.0	0.06172115525582759
chr7	ITPRID1	31514121	31514205	0	85	421	7265	421	7180	0.0	0.05863509749303621
chr7	BBS9	33152852	33152855	0	4	717	8800	717	8796	0.0	0.08151432469304229
chr7	BBS9	33129553	33130041	0	489	717	8800	717	8311	0.0	0.08627120683431597
chr7	BBS9	33129682	33130041	0	360	717	8800	717	8440	0.0	0.08495260663507109
chr7	AC018647.1	35716869	35717128	0	260	13228	6731	13228	6471	0.0	2.0441971874517075
chr7	SEPTIN7	35832894	35832900	0	7	30313	11676	30313	11669	0.0	2.5977375953380752
chr7	AC083864.2	36001448	36001701	0	254	0	1141	0	887	0.0	0.0
chr7	AC083864.3	36095377	36095498	0	122	0	2590	0	2468	0.0	0.0
chr7	ANLN	36406567	36406570	50	4	15960	5237	15910	5233	12.5	3.0403210395566598
chr7	NME8	37849057	37849123	46	67	85	2400	39	2333	0.6865671641791045	0.016716673810544362
chr7	LINC00265	39781886	39781896	0	11	4475	6805	4475	6794	0.0	0.6586694141889903
chr7	MRPL32	42935137	42937241	7752	2105	20781	3362	13029	1257	3.682660332541568	10.365155131264917
chr7	UBE2D4	43943032	43943103	1691	72	21405	4694	19714	4622	23.48611111111111	4.265253137170056
chr7	DBNL	44052942	44052951	58	10	31858	12166	31800	12156	5.8	2.6159921026653503
chr7	DBNL	44044821	44044866	698	46	31858	12166	31160	12120	15.173913043478262	2.570957095709571
chr7	DBNL	44044843	44044866	394	24	31858	12166	31464	12142	16.416666666666668	2.591335859001812
chr7	DBNL	44044821	44044842	304	22	31858	12166	31554	12144	13.818181818181818	2.5983201581027666
chr7	AEBP1	44111631	44111772	1593	142	104425	4990	102832	4848	11.21830985915493	21.21122112211221
chr7	ZMIZ2	44761906	44761918	0	13	7424	6855	7424	6842	0.0	1.0850628471207249
chr7	PPIA	44798815	44798904	4553	90	572968	5460	568415	5370	50.58888888888889	105.85009310986965
chr7	PPIA	44797622	44798006	8374	385	572968	5460	564594	5075	21.75064935064935	111.25004926108375
chr7	CCM2	45027267	45027797	148	531	5771	7220	5623	6689	0.2787193973634652	0.8406338765136792
chr7	RAMP3	45183409	45183420	0	12	0	1431	0	1419	0.0	0.0
chr7	UPP1	48101871	48101982	51	112	254	4559	203	4447	0.45535714285714285	0.04564875196761862
chr7	ABCA13	48234152	48234227	0	76	51	19141	51	19065	0.0	0.0026750590086546027
chr7	ABCA13	48507957	48508049	0	93	51	19141	51	19048	0.0	0.0026774464510709787
chr7	IKZF1	50304115	50304359	0	245	0	10578	0	10333	0.0	0.0
chr7	NIPSNAP2	55965151	55965209	0	59	4762	3190	4762	3131	0.0	1.5209198339188759
chr7	SUMF2	56074640	56074736	0	97	73001	3936	73001	3839	0.0	19.015629070070332
chr7	SUMF2	56068639	56068647	0	9	73001	3936	73001	3927	0.0	18.589508530685002
chr7	AC237221.1	57404370	57404434	0	65	0	4007	0	3942	0.0	0.0
chr7	AC237221.1	57407551	57407558	0	8	0	4007	0	3999	0.0	0.0
chr7	AC006455.5	63349549	63351014	0	1466	0	2294	0	828	0.0	0.0
chr7	ZNF273	64903367	64903419	0	53	159	8661	159	8608	0.0	0.018471189591078067
chr7	AC073210.3	64947858	64947955	0	98	51	1180	51	1082	0.0	0.04713493530499076
chr7	CRCP	66114915	66114970	394	56	25620	3326	25226	3270	7.035714285714286	7.714373088685015
chr7	GS1-124K5.4	66494022	66494025	0	4	1735	1212	1735	1208	0.0	1.4362582781456954
chr7	GS1-124K5.4	66494026	66494364	0	339	1735	1212	1735	873	0.0	1.9873997709049256
chr7	GS1-124K5.4	66494022	66494364	0	343	1735	1212	1735	869	0.0	1.9965477560414269
chr7	GS1-124K5.4	66494213	66494364	0	152	1735	1212	1735	1060	0.0	1.6367924528301887
chr7	GS1-124K5.4	66494026	66494212	0	187	1735	1212	1735	1025	0.0	1.6926829268292682
chr7	GS1-124K5.4	66494022	66494212	0	191	1735	1212	1735	1021	0.0	1.6993143976493634
chr7	KCTD7	66638392	66638431	0	40	6560	3297	6560	3257	0.0	2.0141234264660732
chr7	KCTD7	66638930	66639228	0	299	6560	3297	6560	2998	0.0	2.18812541694463
chr7	TMEM248	66930715	66930868	0	154	0	5095	0	4941	0.0	0.0
chr7	AUTS2	70766335	70766355	0	21	2998	24173	2998	24152	0.0	0.12413050679032793
chr7	AUTS2	70777175	70777217	0	43	2998	24173	2998	24130	0.0	0.1242436800663075
chr7	SBDSP1	72829784	72829976	8000	193	15117	1244	7117	1051	41.45077720207254	6.771646051379639
chr7	FKBP6	73328315	73328485	0	171	34	4736	34	4565	0.0	0.007447973713033954
chr7	FKBP6	73329450	73329834	0	385	34	4736	34	4351	0.0	0.007814295564238107
chr7	BUD23	73683805	73683923	0	119	1476	5292	1476	5173	0.0	0.2853276628648753
chr7	BUD23	73683902	73683923	0	22	1476	5292	1476	5270	0.0	0.28007590132827326
chr7	BUD23	73683805	73683901	0	97	1476	5292	1476	5195	0.0	0.2841193455245428
chr7	BUD23	73683924	73684000	0	77	1476	5292	1476	5215	0.0	0.28302972195589643
chr7	BUD23	73683805	73684000	0	196	1476	5292	1476	5096	0.0	0.28963893249607536
chr7	BUD23	73683902	73684000	0	99	1476	5292	1476	5193	0.0	0.28422876949740034
chr7	ELN	74056358	74056435	0	78	293	6338	293	6260	0.0	0.046805111821086265
chr7	ELN	74035415	74035688	0	274	293	6338	293	6064	0.0	0.0483179419525066
chr7	ELN	74060502	74060600	0	99	293	6338	293	6239	0.0	0.04696265427151787
chr7	EIF4H	74194879	74195059	0	181	57550	4839	57550	4658	0.0	12.355088020609704
chr7	LAT2	74214918	74215010	30	93	922	4561	892	4468	0.3225806451612903	0.19964189794091317
chr7	LAT2	74214941	74215010	30	70	922	4561	892	4491	0.42857142857142855	0.19861946114451123
chr7	LAT2	74216835	74216864	0	30	922	4561	922	4531	0.0	0.20348708894283823
chr7	LAT2	74215011	74215099	283	89	922	4561	639	4472	3.1797752808988764	0.14288908765652952
chr7	LAT2	74214918	74215099	313	182	922	4561	609	4379	1.7197802197802199	0.1390728476821192
chr7	LAT2	74214941	74215099	313	159	922	4561	609	4402	1.9685534591194969	0.13834620626987734
chr7	LAT2	74214918	74214940	0	23	922	4561	922	4538	0.0	0.20317320405464961
chr7	CLIP2	74386598	74386604	7	7	1808	6823	1801	6816	1.0	0.264231220657277
chr7	NCF1	74785262	74785299	38	38	53877	3153	53839	3115	1.0	17.28378812199037
chr7	GTF2IRD2B	75143979	75143993	1375	15	27018	6408	25643	6393	91.66666666666667	4.011105897074926
chr7	NSUN5P1	75410727	75410834	0	108	0	2136	0	2028	0.0	0.0
chr7	NSUN5P1	75410727	75411574	0	848	0	2136	0	1288	0.0	0.0
chr7	NSUN5P1	75415771	75415778	0	8	0	2136	0	2128	0.0	0.0
chr7	POR	75972462	75972764	354	303	43524	5746	43170	5443	1.1683168316831682	7.931287892706228
chr7	POR	75915180	75915666	16674	487	43524	5746	26850	5259	34.238193018480494	5.105533371363377
chr7	POR	75915210	75915666	16674	457	43524	5746	26850	5289	36.48577680525164	5.076574021554169
chr7	POR	75915667	75915767	1022	101	43524	5746	42502	5645	10.118811881188119	7.529140832595217
chr7	POR	75980489	75980722	388	234	43524	5746	43136	5512	1.6581196581196582	7.825834542815675
chr7	POR	75968129	75968277	265	149	43524	5746	43259	5597	1.778523489932886	7.728961943898517
chr7	HSPB1	76303845	76303865	0	21	0	1152	0	1131	0.0	0.0
chr7	HSPB1	76303866	76303888	0	23	0	1152	0	1129	0.0	0.0
chr7	HSPB1	76303845	76303888	0	44	0	1152	0	1108	0.0	0.0
chr7	HSPB1	76303883	76303888	0	6	0	1152	0	1146	0.0	0.0
chr7	HSPB1	76303077	76303080	0	4	0	1152	0	1148	0.0	0.0
chr7	HSPB1	76303077	76303111	0	35	0	1152	0	1117	0.0	0.0
chr7	HSPB1	76303866	76303882	0	17	0	1152	0	1135	0.0	0.0
chr7	HSPB1	76303845	76303882	0	38	0	1152	0	1114	0.0	0.0
chr7	HSPB1	76303657	76303727	0	71	0	1152	0	1081	0.0	0.0
chr7	CCDC146	77286856	77286926	0	71	36252	4481	36252	4410	0.0	8.220408163265306
chr7	MAGI2-AS3	79454245	79455007	0	763	153	16832	153	16069	0.0	0.009521438795195718
chr7	MAGI2-AS3	79455008	79458730	0	3723	153	16832	153	13109	0.0	0.011671370813944619
chr7	MAGI2-AS3	79456181	79458730	0	2550	153	16832	153	14282	0.0	0.010712785324184288
chr7	MAGI2-AS3	79455375	79458730	0	3356	153	16832	153	13476	0.0	0.011353517364203028
chr7	MAGI2-AS3	79455008	79455374	0	367	153	16832	153	16465	0.0	0.009292438505921652
chr7	MAGI2-AS3	79454245	79455374	0	1130	153	16832	153	15702	0.0	0.009743981658387467
chr7	GNAI1	80135274	80135278	0	5	714	23932	714	23927	0.0	0.029840765662222594
chr7	GNAI1	80134569	80134588	0	20	714	23932	714	23912	0.0	0.029859484777517563
chr7	GNAI1	80134049	80134068	0	20	714	23932	714	23912	0.0	0.029859484777517563
chr7	GRM3	86644873	86644971	0	99	7171	4481	7171	4382	0.0	1.6364673664993155
chr7	DMTF1	87163287	87163332	0	46	0	7275	0	7229	0.0	0.0
chr7	DMTF1	87152556	87152795	0	240	0	7275	0	7035	0.0	0.0
chr7	DBF4	87878134	87878225	0	92	153	4607	153	4515	0.0	0.03388704318936877
chr7	ADAM22	88179043	88179129	0	87	51	12235	51	12148	0.0	0.004198221929535726
chr7	CFAP69	90262051	90262056	0	6	35	4519	35	4513	0.0	0.007755373365832041
chr7	CFAP69	90268331	90268384	0	54	35	4519	35	4465	0.0	0.007838745800671893
chr7	CLDN12	90412050	90412061	0	12	51	6484	51	6472	0.0	0.00788009888751545
chr7	CLDN12	90405609	90405612	0	4	51	6484	51	6480	0.0	0.00787037037037037
chr7	CLDN12	90469932	90469953	0	22	51	6484	51	6462	0.0	0.007892293407613741
chr7	CDK14	90709396	90709610	0	215	206	6964	206	6749	0.0	0.030523040450437102
chr7	CDK14	90709611	90709957	0	347	206	6964	206	6617	0.0	0.03113193290010579
chr7	AC079760.2	91496602	91496646	0	45	1468	2663	1468	2618	0.0	0.5607333842627961
chr7	AKAP9	92070183	92070206	0	24	102767	18331	102767	18307	0.0	5.613535805975856
chr7	RBM48	92528925	92529183	0	259	561	6833	561	6574	0.0	0.08533617280194707
chr7	CDK6-AS1	92854954	92854999	0	46	0	671	0	625	0.0	0.0
chr7	VPS50	93239935	93239950	0	16	2191	9328	2191	9312	0.0	0.23528780068728522
chr7	PEG10	94656581	94656591	0	11	561	3432	561	3421	0.0	0.1639871382636656
chr7	PPP1R9A	95284217	95284330	0	114	102	11218	102	11104	0.0	0.009185878962536023
chr7	DYNC1I1	95804363	95804374	0	12	21777	4540	21777	4528	0.0	4.8094081272084805
chr7	TRRAP	98983460	98983492	49	33	1139865	20054	1139816	20021	1.4848484848484849	56.93102242645222
chr7	ARPC1B	99377440	99377455	0	16	0	3642	0	3626	0.0	0.0
chr7	BUD31	99409005	99409245	0	241	1	2378	1	2137	0.0	0.0004679457182966776
chr7	ZNF655	99559008	99559017	0	10	1091	7216	1091	7206	0.0	0.1514016097696364
chr7	ZNF655	99559018	99559021	0	4	1091	7216	1091	7212	0.0	0.15127565169162507
chr7	ZNF655	99559008	99559021	0	14	1091	7216	1091	7202	0.0	0.15148569841710635
chr7	TMEM225B	99598373	99598381	0	9	0	1436	0	1427	0.0	0.0
chr7	ZSCAN25	99616990	99617016	0	27	156354	5715	156354	5688	0.0	27.488396624472575
chr7	ZSCAN25	99619994	99619997	72	4	156354	5715	156282	5711	18.0	27.3650849238312
chr7	CYP3A43	99847602	99847659	0	58	62	2652	62	2594	0.0	0.023901310717039322
chr7	CYP3A43	99847615	99847659	0	45	62	2652	62	2607	0.0	0.023782125047947834
chr7	CYP3A43	99847602	99847614	0	13	62	2652	62	2639	0.0	0.023493747631678667
chr7	COPS6	100089054	100089066	0	13	704	2424	704	2411	0.0	0.29199502281211115
chr7	COPS6	100091308	100091330	0	23	704	2424	704	2401	0.0	0.29321116201582675
chr7	AP4M1	100102747	100102781	0	35	51	4601	51	4566	0.0	0.011169513797634692
chr7	AP4M1	100101969	100101989	0	21	51	4601	51	4580	0.0	0.0111353711790393
chr7	MBLAC1	100127065	100127133	0	69	0	1297	0	1228	0.0	0.0
chr7	LAMTOR4	100149566	100149579	0	14	626	1452	626	1438	0.0	0.43532684283727396
chr7	STAG3	100177906	100177972	0	67	40472	8611	40472	8544	0.0	4.73689138576779
chr7	STAG3	100177906	100178005	19	100	40472	8611	40453	8511	0.19	4.753025496416402
chr7	STAG3	100177973	100178005	19	33	40472	8611	40453	8578	0.5757575757575758	4.715901142457449
chr7	STAG3	100177973	100178062	171	90	40472	8611	40301	8521	1.9	4.729609200798029
chr7	STAG3	100178006	100178062	152	57	40472	8611	40320	8554	2.6666666666666665	4.713584288052373
chr7	STAG3L5P	100336221	100336337	0	117	196	2779	196	2662	0.0	0.07362885048835462
chr7	PILRB	100353484	100354012	0	529	0	3977	0	3448	0.0	0.0
chr7	PILRB	100356884	100356938	0	55	0	3977	0	3922	0.0	0.0
chr7	FBXO24	100590316	100590357	0	42	0	3344	0	3302	0.0	0.0
chr7	FBXO24	100592861	100593017	0	157	0	3344	0	3187	0.0	0.0
chr7	FBXO24	100589644	100589793	0	150	0	3344	0	3194	0.0	0.0
chr7	PCOLCE	100604189	100604217	0	29	0	2816	0	2787	0.0	0.0
chr7	ZAN	100792480	100792544	0	65	204236	8919	204236	8854	0.0	23.067088321662524
chr7	SLC12A9	100852836	100852839	40	4	1183977	7409	1183937	7405	10.0	159.88345712356517
chr7	SRRT	100885763	100885774	0	12	432881	4638	432881	4626	0.0	93.57565931690445
chr7	PRKRIP1	102364207	102364411	0	205	8005	3465	8005	3260	0.0	2.455521472392638
chr7	LRWD1	102465161	102465178	0	18	2318	2902	2318	2884	0.0	0.8037447988904299
chr7	FAM185A	102749637	102749658	0	22	2101	2732	2101	2710	0.0	0.7752767527675277
chr7	FAM185A	102749044	102749658	0	615	2101	2732	2101	2117	0.0	0.9924421350968351
chr7	FAM185A	102749418	102749658	0	241	2101	2732	2101	2491	0.0	0.8434363709353673
chr7	FAM185A	102749044	102749636	0	593	2101	2732	2101	2139	0.0	0.9822346891070594
chr7	FAM185A	102749418	102749636	0	219	2101	2732	2101	2513	0.0	0.8360525268603263
chr7	FAM185A	102749044	102749417	0	374	2101	2732	2101	2358	0.0	0.8910093299406276
chr7	ARMC10	103083831	103084062	0	232	0	4585	0	4353	0.0	0.0
chr7	PMPCB	103299530	103299533	0	4	0	5146	0	5142	0.0	0.0
chr7	PMPCB	103297559	103297953	0	395	0	5146	0	4751	0.0	0.0
chr7	PSMC2	103344343	103344525	0	183	0	7122	0	6939	0.0	0.0
chr7	AC007384.1	104941671	104941745	55	75	6094	2440	6039	2365	0.7333333333333333	2.5534883720930233
chr7	RINT1	105536613	105536749	0	137	7433	3420	7433	3283	0.0	2.2640877246420956
chr7	CDHR3	106001583	106001610	0	28	86249	9741	86249	9713	0.0	8.879748790281067
chr7	PIK3CG	106865351	106865426	0	76	2574	7778	2574	7702	0.0	0.3341989093741885
chr7	HBP1	107169028	107169185	0	158	153	6030	153	5872	0.0	0.026055858310626703
chr7	DUS4L-BCAP29	107564060	107564209	0	150	272938	7282	272938	7132	0.0	38.269489624228825
chr7	DUS4L-BCAP29	107564210	107564676	100908	467	272938	7282	172030	6815	216.07708779443254	25.242846661775495
chr7	DUS4L-BCAP29	107573822	107573883	484	62	272938	7282	272454	7220	7.806451612903226	37.73601108033241
chr7	DUS4L-BCAP29	107564210	107564247	562	38	272938	7282	272376	7244	14.789473684210526	37.600220872446165
chr7	DUS4L-BCAP29	107564060	107564247	562	188	272938	7282	272376	7094	2.9893617021276597	38.395263603044825
chr7	BCAP29	107580578	107580645	28770	68	352856	5519	324086	5451	423.0882352941176	59.45441203448908
chr7	ZNF277	112340918	112341046	0	129	0	4755	0	4626	0.0	0.0
chr7	AC002463.1	112622408	112622619	0	212	104220	5157	104220	4945	0.0	21.075834175935288
chr7	AC002463.1	112622589	112622619	0	31	104220	5157	104220	5126	0.0	20.331642606320717
chr7	AC002463.1	112622408	112622588	0	181	104220	5157	104220	4976	0.0	20.944533762057876
chr7	AC002463.1	112635923	112635992	0	70	104220	5157	104220	5087	0.0	20.487517200707686
chr7	CAV1	116525784	116525805	0	22	79752	3435	79752	3413	0.0	23.367125695868737
chr7	CAV1	116525093	116525805	0	713	79752	3435	79752	2722	0.0	29.299044819985305
chr7	ST7	117209923	117209937	0	15	0	6497	0	6482	0.0	0.0
chr7	CFTR	117627571	117627770	0	200	703	9870	703	9670	0.0	0.07269906928645295
chr7	PTPRZ1	122011310	122013889	0	2580	0	8512	0	5932	0.0	0.0
chr7	PTPRZ1	122012822	122013889	0	1068	0	8512	0	7444	0.0	0.0
chr7	AC004594.1	122328509	122328565	0	57	0	3479	0	3422	0.0	0.0
chr7	SPAM1	123925353	123925531	0	179	33	3041	33	2862	0.0	0.011530398322851153
chr7	AC006148.1	124360199	124360252	0	54	225	17199	225	17145	0.0	0.013123359580052493
chr7	AC006148.1	124376390	124376396	0	7	225	17199	225	17192	0.0	0.013087482550023267
chr7	AC006148.1	124389557	124389560	0	4	225	17199	225	17195	0.0	0.013085199185809828
chr7	AC006148.1	124334391	124334431	0	41	225	17199	225	17158	0.0	0.013113416482107471
chr7	FSCN3	127593753	127593997	0	245	364	3131	364	2886	0.0	0.12612612612612611
chr7	HILPDA	128455910	128456023	679	114	3417	2072	2738	1958	5.956140350877193	1.3983656792645556
chr7	FAM71F2	128683256	128683309	0	54	2651	3056	2651	3002	0.0	0.8830779480346436
chr7	FAM71F1	128714075	128714132	0	58	10	2436	10	2378	0.0	0.004205214465937763
chr7	FAM71F1	128714010	128714132	0	123	10	2436	10	2313	0.0	0.00432338953739732
chr7	FAM71F1	128714010	128714074	0	65	10	2436	10	2371	0.0	0.004217629692113032
chr7	CCDC136	128801474	128801509	0	36	28934	6127	28934	6091	0.0	4.75028730914464
chr7	IRF5	128937695	128937834	0	140	1446	4365	1446	4225	0.0	0.3422485207100592
chr7	IRF5	128946007	128946034	0	28	1446	4365	1446	4337	0.0	0.33341019137652755
chr7	IRF5	128941392	128941424	0	33	1446	4365	1446	4332	0.0	0.3337950138504155
chr7	CPA4	130304567	130304579	0	13	204	3971	204	3958	0.0	0.05154118241536129
chr7	CPA5	130345206	130345330	0	125	4759	2962	4759	2837	0.0	1.6774762072611915
chr7	CPA5	130345897	130345909	0	13	4759	2962	4759	2949	0.0	1.6137673787724653
chr7	CPA5	130345206	130345896	0	691	4759	2962	4759	2271	0.0	2.095552619991193
chr7	MEST	130486396	130486519	0	124	559	4491	559	4367	0.0	0.12800549576368217
chr7	CALD1	134933391	134934077	0	687	1660	9452	1660	8765	0.0	0.18938961779806046
chr7	STRA8	135245330	135245527	0	198	28449	1267	28449	1069	0.0	26.61272217025257
chr7	NUP205	135606211	135606226	0	16	279137	7667	279137	7651	0.0	36.48372761730493
chr7	CHRM2	136869118	136869173	0	56	408	8329	408	8273	0.0	0.04931705548168742
chr7	TRIM24	138554865	138554966	102	102	44429	9323	44327	9221	1.0	4.807179264721831
chr7	TTC26	139134722	139134792	29	71	683	5017	654	4946	0.4084507042253521	0.1322280630812778
chr7	FMC1	139340600	139340619	0	20	5813	1292	5813	1272	0.0	4.56996855345912
chr7	TBXAS1	139875638	139875666	0	29	1504	6297	1504	6268	0.0	0.23994894703254627
chr7	AGK	141614179	141614582	0	404	369	9243	369	8839	0.0	0.041746803937096955
chr7	AGK	141551435	141551499	0	65	369	9243	369	9178	0.0	0.04020483765526259
chr7	SSBP1	141738411	141738593	0	183	0	4961	0	4778	0.0	0.0
chr7	SSBP1	141738504	141738593	0	90	0	4961	0	4871	0.0	0.0
chr7	SSBP1	141738576	141738593	0	18	0	4961	0	4943	0.0	0.0
chr7	SSBP1	141738411	141738503	0	93	0	4961	0	4868	0.0	0.0
chr7	SSBP1	141738411	141738575	0	165	0	4961	0	4796	0.0	0.0
chr7	SSBP1	141738504	141738575	0	72	0	4961	0	4889	0.0	0.0
chr7	SSBP1	141738679	141738944	0	266	0	4961	0	4695	0.0	0.0
chr7	SSBP1	141738679	141738998	0	320	0	4961	0	4641	0.0	0.0
chr7	SSBP1	141738945	141738998	0	54	0	4961	0	4907	0.0	0.0
chr7	PRSS1	142752551	142752567	0	17	0	1218	0	1201	0.0	0.0
chr7	PRSS2	142774039	142774055	0	17	0	1266	0	1249	0.0	0.0
chr7	GSTK1	143265093	143265296	0	204	1667	3842	1667	3638	0.0	0.45821880153930733
chr7	TMEM139	143284975	143284998	0	24	0	2569	0	2545	0.0	0.0
chr7	TMEM139	143284975	143285445	0	471	0	2569	0	2098	0.0	0.0
chr7	ZYX	143381410	143381779	0	370	0	3134	0	2764	0.0	0.0
chr7	EPHA1-AS1	143407887	143407890	0	4	969	5322	969	5318	0.0	0.1822113576532531
chr7	ARHGEF5	144362854	144365823	0	2970	380	5833	380	2863	0.0	0.13272790778903248
chr7	CUL1	148698260	148698278	0	19	14536	4022	14536	4003	0.0	3.631276542593055
chr7	CUL1	148698713	148698763	0	51	14536	4022	14536	3971	0.0	3.6605389070763032
chr7	ZNF398	149154318	149154340	0	23	73676	6316	73676	6293	0.0	11.707611631972032
chr7	ZNF212	149239803	149240056	3173	254	29836	3185	26663	2931	12.492125984251969	9.096895257591266
chr7	ZNF783	149293843	149294016	365	174	4655	6739	4290	6565	2.0977011494252875	0.6534653465346535
chr7	ZNF783	149294902	149295183	0	282	4655	6739	4655	6457	0.0	0.7209230292705591
chr7	AC004890.2	149290039	149290083	0	45	4906	4299	4906	4254	0.0	1.153267512929008
chr7	KRBA1	149730569	149730713	0	145	0	5309	0	5164	0.0	0.0
chr7	ZNF862	149838462	149838635	0	174	1275	8432	1275	8258	0.0	0.15439573746669896
chr7	ATP6V0E2	149878747	149878790	0	44	0	6761	0	6717	0.0	0.0
chr7	AC092666.1	150040655	150040715	0	61	2485	5281	2485	5220	0.0	0.4760536398467433
chr7	AC092666.1	150040655	150040910	0	256	2485	5281	2485	5025	0.0	0.4945273631840796
chr7	AC092666.1	150040716	150040910	0	195	2485	5281	2485	5086	0.0	0.4885961462839166
chr7	AC092666.1	150042623	150043239	0	617	2485	5281	2485	4664	0.0	0.5328044596912521
chr7	REPIN1	150368942	150369033	0	92	0	4590	0	4498	0.0	0.0
chr7	REPIN1	150369014	150369033	0	20	0	4590	0	4570	0.0	0.0
chr7	REPIN1	150368942	150369013	0	72	0	4590	0	4518	0.0	0.0
chr7	AC073111.3	150407864	150408488	0	625	186	4340	186	3715	0.0	0.05006729475100942
chr7	GIMAP4	150569960	150570001	0	42	0	2102	0	2060	0.0	0.0
chr7	GIMAP4	150567438	150567520	0	83	0	2102	0	2019	0.0	0.0
chr7	TMEM176A	150800829	150800968	1140	140	11310	2191	10170	2051	8.142857142857142	4.958556801560214
chr7	TMEM176A	150801567	150801724	1896	158	11310	2191	9414	2033	12.0	4.630595179537629
chr7	TMEM176A	150804473	150804485	0	13	11310	2191	11310	2178	0.0	5.192837465564739
chr7	ABCB8	151044147	151044221	0	75	177864	9139	177864	9064	0.0	19.623124448367168
chr7	ABCB8	151028853	151028911	23	59	177864	9139	177841	9080	0.3898305084745763	19.58601321585903
chr7	ABCB8	151040635	151040644	110	10	177864	9139	177754	9129	11.0	19.47135502245591
chr7	ASIC3	151052238	151052474	561	237	37959	2756	37398	2519	2.367088607594937	14.846367606192933
chr7	SLC4A2	151058712	151059188	402	477	99404	6826	99002	6349	0.8427672955974843	15.593321782957947
chr7	SLC4A2	151074100	151074293	9889	194	99404	6826	89515	6632	50.97422680412371	13.497436670687575
chr7	SLC4A2	151061271	151061521	0	251	99404	6826	99404	6575	0.0	15.11847908745247
chr7	SLC4A2	151062664	151063189	0	526	99404	6826	99404	6300	0.0	15.778412698412698
chr7	AGAP3	151087073	151087204	0	132	306	10457	306	10325	0.0	0.02963680387409201
chr7	AGAP3	151120568	151120745	0	178	306	10457	306	10279	0.0	0.02976943282420469
chr7	CHPF2	151232815	151234274	102	1460	102	4210	0	2750	0.06986301369863014	0.0
chr7	NUB1	151374202	151374243	0	42	2460	5427	2460	5385	0.0	0.4568245125348189
chr7	NUB1	151341847	151341965	610	119	2460	5427	1850	5308	5.126050420168068	0.34853051996985684
chr7	GALNTL5	151956457	151956609	0	153	1066	3335	1066	3182	0.0	0.33500942803268385
chr7	FABP5P3	152437029	152437124	0	96	51	1353	51	1257	0.0	0.0405727923627685
chr7	PAXIP1-AS2	154944399	154944620	0	222	0	6944	0	6722	0.0	0.0
chr7	INSIG1	155297960	155298027	0	68	0	3328	0	3260	0.0	0.0
chr7	RNF32	156640956	156641004	0	49	4899	4235	4899	4186	0.0	1.1703296703296704
chr7	RNF32	156640812	156641004	0	193	4899	4235	4899	4042	0.0	1.2120237506185056
chr7	RNF32	156640812	156640955	0	144	4899	4235	4899	4091	0.0	1.1975067220728428
chr7	DNAJB6	157337145	157337150	0	6	0	10917	0	10911	0.0	0.0
chr7	DNAJB6	157410002	157415529	0	5528	0	10917	0	5389	0.0	0.0
chr7	DNAJB6	157337629	157337811	0	183	0	10917	0	10734	0.0	0.0
chr7	AC006372.1	157501516	157501936	0	421	0	1692	0	1271	0.0	0.0
chr7	AC093627.5	149306	149327	84	22	76251	4819	76167	4797	3.8181818181818183	15.878048780487806
chr7	PRKAR1B	712847	712920	0	74	1111	4510	1111	4436	0.0	0.2504508566275924
chr7	PRKAR1B	712921	713053	0	133	1111	4510	1111	4377	0.0	0.2538268220242175
chr7	C7ORF50	1138188	1138216	84	29	1889	4970	1805	4941	2.896551724137931	0.36531066585711397
chr7	C7ORF50	1137314	1138187	987	874	1889	4970	902	4096	1.1292906178489703	0.22021484375
chr7	C7ORF50	1137314	1138216	1071	903	1889	4970	818	4067	1.186046511627907	0.20113105483157118
chr7	INTS1	1472242	1472271	90	30	53759	8865	53669	8835	3.0	6.074589700056593
chr7	TMEM184A	1555956	1556112	51	157	6520	4053	6469	3896	0.3248407643312102	1.6604209445585216
chr7	AC074389.1	1694178	1694258	0	81	0	1217	0	1136	0.0	0.0
chr7	GNA12	2762591	2763074	10995	484	16060	5912	5065	5428	22.71694214876033	0.9331245394252027
chr7	RSPH10B	5943225	5943322	481	98	29702	5015	29221	4917	4.908163265306122	5.942851332113077
chr7	RSPH10B	5960690	5960706	56	17	29702	5015	29646	4998	3.2941176470588234	5.931572629051621
chr7	RSPH10B	5970282	5970616	510	335	29702	5015	29192	4680	1.5223880597014925	6.237606837606838
chr7	CYTH3	6170531	6170533	0	3	5167	5824	5167	5821	0.0	0.887648170417454
chr7	FAM220A	6348572	6348824	0	253	51	2397	51	2144	0.0	0.02378731343283582
chr7	DAGLB	6416258	6416625	102	368	14599	5365	14497	4997	0.27717391304347827	2.901140684410646
chr7	ZNF12	6697684	6697687	28	4	89693	5328	89665	5324	7.0	16.84166040570999
chr7	RPA3	7640319	7640721	51	403	2306	3101	2255	2698	0.12655086848635236	0.8358042994810971
chr7	ICA1	8138839	8138841	0	3	9846	4842	9846	4839	0.0	2.0347179169249845
chr7	ICA1	8236805	8236808	0	4	9846	4842	9846	4838	0.0	2.03513848697809
chr7	AC004852.2	9189559	9189575	0	17	0	3367	0	3350	0.0	0.0
chr7	VWDE	12353814	12354348	0	535	0	6744	0	6209	0.0	0.0
chr7	ETV1	13989267	13989561	0	295	888	9310	888	9015	0.0	0.09850249584026623
chr7	DGKB	14757654	14757688	0	35	13	9521	13	9486	0.0	0.0013704406493780308
chr7	ANKMY2	16644625	16644683	0	59	2345	2863	2345	2804	0.0	0.8363052781740371
chr7	AGR2	16804934	16804951	0	18	0	2720	0	2702	0.0	0.0
chr7	AGR2	16794850	16794934	0	85	0	2720	0	2635	0.0	0.0
chr7	AC019117.1	17457339	17457457	0	119	121	3525	121	3406	0.0	0.035525543159130944
chr7	AC019117.1	17457333	17457457	0	125	121	3525	121	3400	0.0	0.03558823529411765
chr7	AC019117.1	17457333	17457338	0	6	121	3525	121	3519	0.0	0.03438476840011367
chr7	AC019117.1	17456677	17456680	0	4	121	3525	121	3521	0.0	0.03436523714853735
chr7	AC019117.1	17457319	17457457	0	139	121	3525	121	3386	0.0	0.03573538098050797
chr7	AC019117.1	17457319	17457338	0	20	121	3525	121	3505	0.0	0.03452211126961484
chr7	AC019117.1	17457319	17457332	0	14	121	3525	121	3511	0.0	0.03446311592138992
chr7	TMEM196	19772549	19773565	0	1017	38	3555	38	2538	0.0	0.014972419227738377
chr7	TMEM196	19772549	19773100	0	552	38	3555	38	3003	0.0	0.012654012654012654
chr7	AC005062.1	19968136	19968152	0	17	0	3126	0	3109	0.0	0.0
chr7	FAM126A	22946951	22947031	0	81	78537	7672	78537	7591	0.0	10.346067711763931
chr7	KLHL7-DT	23105552	23105557	0	6	51	3587	51	3581	0.0	0.014241831890533371
chr7	IGF2BP3	23347599	23347647	1480	49	97474	8233	95994	8184	30.20408163265306	11.729472140762462
chr7	TRA2A	23522131	23522352	51	222	14758	3350	14707	3128	0.22972972972972974	4.701726342710997
chr7	OSBPL3	24834086	24834484	0	399	6074	8114	6074	7715	0.0	0.787297472456254
chr7	OSBPL3	24917956	24918045	0	90	6074	8114	6074	8024	0.0	0.7569790628115654
chr7	CYCS	25124995	25125198	49	204	510	5795	461	5591	0.24019607843137256	0.08245394383831157
chr7	C7ORF31	25179661	25180068	102	408	3845	3683	3743	3275	0.25	1.1429007633587787
chr7	C7ORF31	25179661	25179969	62	309	3845	3683	3783	3374	0.20064724919093851	1.1212211025489034
chr7	C7ORF31	25179970	25180068	40	99	3845	3683	3805	3584	0.40404040404040403	1.0616629464285714
chr7	HNRNPA2B1	26193574	26193597	0	24	2234	8930	2234	8906	0.0	0.2508421289018639
chr7	HNRNPA2B1	26190992	26192493	874	1502	2234	8930	1360	7428	0.5818908122503329	0.1830910070005385
chr7	HNRNPA2B1	26173593	26174669	0	1077	2234	8930	2234	7853	0.0	0.2844772698331848
chr7	HNRNPA2B1	26190992	26191054	46	63	2234	8930	2188	8867	0.7301587301587301	0.24675764069019962
chr7	HNRNPA2B1	26191421	26192299	612	879	2234	8930	1622	8051	0.6962457337883959	0.20146565644019376
chr7	HOXA9	27165140	27165143	0	4	311	2899	311	2895	0.0	0.107426597582038
chr7	HOXA9	27165108	27165139	0	32	311	2899	311	2867	0.0	0.10847575863271712
chr7	HOXA9	27165108	27165143	0	36	311	2899	311	2863	0.0	0.10862731400628711
chr7	EVX1-AS	27242467	27242628	0	162	0	1205	0	1043	0.0	0.0
chr7	CPVL	29146340	29146427	0	88	0	3356	0	3268	0.0	0.0
chr7	SCRN1	29989942	29990180	870	239	1815	6059	945	5820	3.6401673640167362	0.16237113402061856
chr7	NOD1	30446966	30447013	264	48	8437	6096	8173	6048	5.5	1.35135582010582
chr7	GARS1-DT	30563722	30563729	0	8	32726	12139	32726	12131	0.0	2.697716593850466
chr7	PDE1C	32070978	32071204	1020	227	54769	14157	53749	13930	4.493392070484582	3.8585068198133525
chr7	LSM5	32490130	32490318	0	189	0	4281	0	4092	0.0	0.0
chr7	LSM5	32490024	32490318	0	295	0	4281	0	3986	0.0	0.0
chr7	LSM5	32490024	32490129	0	106	0	4281	0	4175	0.0	0.0
chr7	LSM5	32494990	32495228	0	239	0	4281	0	4042	0.0	0.0
chr7	KBTBD2	32879434	32879699	3193	266	4243	2943	1050	2677	12.003759398496241	0.3922301083302204
chr7	DPY19L2P1	35106040	35106042	0	3	14536	7663	14536	7660	0.0	1.897650130548303
chr7	DPY19L2P1	35141023	35141031	0	9	14536	7663	14536	7654	0.0	1.8991377057747583
chr7	DPY19L2P1	35141848	35141880	9	33	14536	7663	14527	7630	0.2727272727272727	1.9039318479685452
chr7	SEPTIN7-DT	35800485	35800516	0	32	204	4118	204	4086	0.0	0.049926578560939794
chr7	KIAA0895	36366915	36367109	0	195	7697	4862	7697	4667	0.0	1.6492393400471395
chr7	KIAA0895	36366703	36366914	0	212	7697	4862	7697	4650	0.0	1.655268817204301
chr7	KIAA0895	36366703	36367109	0	407	7697	4862	7697	4455	0.0	1.7277216610549944
chr7	ELMO1	37448674	37448858	0	185	51	9599	51	9414	0.0	0.005417463352453792
chr7	GLI3	42151234	42152351	255	1118	2933	13825	2678	12707	0.22808586762075134	0.21074998032580466
chr7	AC010132.3	42911914	42912096	0	183	1497	3926	1497	3743	0.0	0.3999465669249265
chr7	AC010132.3	42911914	42912057	0	144	1497	3926	1497	3782	0.0	0.3958223162347964
chr7	AC010132.3	42912097	42912222	153	126	1497	3926	1344	3800	1.2142857142857142	0.35368421052631577
chr7	AC010132.3	42912058	42912096	0	39	1497	3926	1497	3887	0.0	0.3851299202469771
chr7	AC010132.3	42912058	42912222	153	165	1497	3926	1344	3761	0.9272727272727272	0.3573517681467695
chr7	AC010132.3	42911914	42912222	153	309	1497	3926	1344	3617	0.49514563106796117	0.37157865634503734
chr7	COA1	43650492	43650610	138	119	140225	11833	140087	11714	1.1596638655462186	11.958938022878607
chr7	RASA4CP	44033932	44034010	51	79	56544	4067	56493	3988	0.6455696202531646	14.165747241725176
chr7	RASA4CP	44033932	44034174	153	243	56544	4067	56391	3824	0.6296296296296297	14.746600418410042
chr7	RASA4CP	44034011	44034174	102	164	56544	4067	56442	3903	0.6219512195121951	14.461183704842428
chr7	POLM	44078739	44078754	0	16	5301	4453	5301	4437	0.0	1.1947261663286004
chr7	POLM	44074130	44074396	0	267	5301	4453	5301	4186	0.0	1.2663640707118968
chr7	POLM	44078553	44078738	266	186	5301	4453	5035	4267	1.4301075268817205	1.179985938598547
chr7	POLM	44078553	44078754	266	202	5301	4453	5035	4251	1.316831683168317	1.1844271936015056
chr7	MYL7	44139421	44139519	0	99	0	1463	0	1364	0.0	0.0
chr7	DDX56	44572562	44572572	0	11	0	3948	0	3937	0.0	0.0
chr7	DDX56	44569983	44570013	0	31	0	3948	0	3917	0.0	0.0
chr7	MYO1G	44968919	44969411	0	493	250	8668	250	8175	0.0	0.03058103975535168
chr7	MYO1G	44975475	44975482	0	8	250	8668	250	8660	0.0	0.028868360277136258
chr7	SNHG15	44985881	44986019	0	139	102	3016	102	2877	0.0	0.035453597497393116
chr7	SNHG15	44984356	44986019	0	1664	102	3016	102	1352	0.0	0.07544378698224852
chr7	TBRG4	45108826	45108930	14	105	72036	5038	72022	4933	0.13333333333333333	14.60004054327995
chr7	TBRG4	45111642	45111662	489	21	72036	5038	71547	5017	23.285714285714285	14.26091289615308
chr7	TBRG4	45111663	45111875	1538	213	72036	5038	70498	4825	7.220657276995305	14.61098445595855
chr7	TBRG4	45102280	45102345	0	66	72036	5038	72036	4972	0.0	14.488334674175382
chr7	IGFBP3	45920719	45920736	0	18	0	4277	0	4259	0.0	0.0
chr7	HUS1	47979409	47979466	0	58	0	2928	0	2870	0.0	0.0
chr7	HUS1	47979409	47979419	0	11	0	2928	0	2917	0.0	0.0
chr7	HUS1	47979420	47979466	0	47	0	2928	0	2881	0.0	0.0
chr7	SUN3	48007152	48007163	0	12	7450	1742	7450	1730	0.0	4.30635838150289
chr7	ZPBP	50092862	50093066	0	205	0	2640	0	2435	0.0	0.0
chr7	FIGNL1	50449555	50449561	0	7	0	1093	0	1086	0.0	0.0
chr7	FIGNL1	50449555	50449577	0	23	0	1093	0	1070	0.0	0.0
chr7	FIGNL1	50449562	50449577	0	16	0	1093	0	1077	0.0	0.0
chr7	FIGNL1	50449117	50449554	0	438	0	1093	0	655	0.0	0.0
chr7	FIGNL1	50449117	50449561	0	445	0	1093	0	648	0.0	0.0
chr7	FIGNL1	50449117	50449577	0	461	0	1093	0	632	0.0	0.0
chr7	FIGNL1	50449117	50449543	0	427	0	1093	0	666	0.0	0.0
chr7	FIGNL1	50449117	50449498	0	382	0	1093	0	711	0.0	0.0
chr7	FIGNL1	50449544	50449554	0	11	0	1093	0	1082	0.0	0.0
chr7	FIGNL1	50449544	50449561	0	18	0	1093	0	1075	0.0	0.0
chr7	FIGNL1	50449544	50449577	0	34	0	1093	0	1059	0.0	0.0
chr7	FIGNL1	50449499	50449554	0	56	0	1093	0	1037	0.0	0.0
chr7	FIGNL1	50449499	50449561	0	63	0	1093	0	1030	0.0	0.0
chr7	FIGNL1	50449499	50449577	0	79	0	1093	0	1014	0.0	0.0
chr7	FIGNL1	50449499	50449543	0	45	0	1093	0	1048	0.0	0.0
chr7	LINC01446	53811507	53811658	0	152	0	7300	0	7148	0.0	0.0
chr7	SEC61G	54759157	54759160	0	4	0	1847	0	1843	0.0	0.0
chr7	SEC61G	54759037	54759160	0	124	0	1847	0	1723	0.0	0.0
chr7	SEC61G	54759037	54759156	0	120	0	1847	0	1727	0.0	0.0
chr7	VOPP1	55537500	55537557	451	58	120273	5361	119822	5303	7.775862068965517	22.59513482934188
chr7	PSPH	56051137	56051312	225	176	146029	2748	145804	2572	1.2784090909090908	56.68895800933126
chr7	AC092447.4	56482094	56482282	0	189	0	2681	0	2492	0.0	0.0
chr7	AC092447.4	56482974	56483711	0	738	0	2681	0	1943	0.0	0.0
chr7	AC092447.5	56537856	56538047	0	192	51	4893	51	4701	0.0	0.010848755583918315
chr7	GUSB	65979726	65979832	0	107	3632	3830	3632	3723	0.0	0.9755573462261617
chr7	GUSB	65979385	65979397	12	13	3632	3830	3620	3817	0.9230769230769231	0.9483887870055017
chr7	AC006001.3	66573384	66573387	8	4	14349	5901	14341	5897	2.0	2.4319145328132947
chr7	AC006001.3	66542085	66542501	0	417	14349	5901	14349	5484	0.0	2.6165207877461705
chr7	GTF2IRD1P1	66832269	66832398	0	130	1183	3191	1183	3061	0.0	0.3864750081672656
chr7	GTF2IRD1P1	66844589	66844674	0	86	1183	3191	1183	3105	0.0	0.3809983896940419
chr7	SBDS	66994211	66994218	0	8	0	1720	0	1712	0.0	0.0
chr7	STAG3L3	73005575	73005691	0	117	783	3267	783	3150	0.0	0.24857142857142858
chr7	TBL2	73573937	73573959	0	23	51	4171	51	4148	0.0	0.012295081967213115
chr7	TBL2	73577972	73578244	0	273	51	4171	51	3898	0.0	0.013083632632119035
chr7	TBL2	73578245	73578288	0	44	51	4171	51	4127	0.0	0.012357644778289314
chr7	TBL2	73578245	73578283	0	39	51	4171	51	4132	0.0	0.012342691190706679
chr7	TBL2	73578284	73578288	0	5	51	4171	51	4166	0.0	0.012241958713394143
chr7	TBL2	73577972	73578288	0	317	51	4171	51	3854	0.0	0.013233004670472236
chr7	TBL2	73577972	73578283	0	312	51	4171	51	3859	0.0	0.013215859030837005
chr7	MLXIPL	73607135	73607329	10045	195	73577	4671	63532	4476	51.51282051282051	14.193923145665773
chr7	STX1A	73702729	73702843	0	115	1012	3703	1012	3588	0.0	0.28205128205128205
chr7	ABHD11	73738327	73738331	0	5	102	2293	102	2288	0.0	0.044580419580419584
chr7	RFC2	74237288	74237360	900	73	2195	2224	1295	2151	12.32876712328767	0.602045560204556
chr7	STAG3L2	74890270	74890386	0	117	570	2335	570	2218	0.0	0.2569882777276826
chr7	PMS2P3	75527564	75527769	0	206	7889	1455	7889	1249	0.0	6.316253002401922
chr7	PMS2P3	75527564	75528104	51	541	7889	1455	7838	914	0.09426987060998152	8.575492341356673
chr7	STYXL1	76047661	76047810	0	150	1105	1888	1105	1738	0.0	0.6357882623705409
chr7	APTR	77695895	77696170	0	276	153	5920	153	5644	0.0	0.02710843373493976
chr7	MAGI2	78194873	78194878	0	6	204	25254	204	25248	0.0	0.008079847908745247
chr7	AC004862.1	80373811	80373814	401	4	72847	3489	72446	3485	100.25	20.787948350071737
chr7	AC004862.1	80383902	80384046	176	145	72847	3489	72671	3344	1.2137931034482758	21.731758373205743
chr7	AC008163.1	81586879	81586945	0	67	22090	5496	22090	5429	0.0	4.068889298213299
chr7	PCLO	82847138	82847145	0	8	459	21068	459	21060	0.0	0.021794871794871794
chr7	ELAPOR2	86965808	86965812	0	5	69	7850	69	7845	0.0	0.008795411089866157
chr7	AC005076.1	87151749	87152300	0	552	0	910	0	358	0.0	0.0
chr7	TMEM243	87220216	87220359	0	144	0	3277	0	3133	0.0	0.0
chr7	TP53TG1	87345042	87345303	0	262	0	5876	0	5614	0.0	0.0
chr7	TP53TG1	87345042	87345232	0	191	0	5876	0	5685	0.0	0.0
chr7	TP53TG1	87341354	87341521	0	168	0	5876	0	5708	0.0	0.0
chr7	TP53TG1	87345233	87345303	0	71	0	5876	0	5805	0.0	0.0
chr7	AC002456.1	90595727	90595731	0	5	0	620	0	615	0.0	0.0
chr7	MTERF1	91880642	91880655	0	14	64911	4878	64911	4864	0.0	13.345189144736842
chr7	MTERF1	91880054	91880655	255	602	64911	4878	64656	4276	0.42358803986710963	15.12067352666043
chr7	KRIT1	92235402	92235532	21283	131	269252	5947	247969	5816	162.46564885496184	42.635660247592845
chr7	KRIT1	92245789	92245904	0	116	269252	5947	269252	5831	0.0	46.175956096724406
chr7	LRRD1	92178971	92179005	0	35	96886	4457	96886	4422	0.0	21.909995477159658
chr7	KRIT1	92245426	92245463	0	38	269252	5947	269252	5909	0.0	45.56642409883229
chr7	KRIT1	92245789	92245842	0	54	269252	5947	269252	5893	0.0	45.690140845070424
chr7	KRIT1	92245789	92245820	0	32	269252	5947	269252	5915	0.0	45.520202874049026
chr7	KRIT1	92245464	92245788	0	325	269252	5947	269252	5622	0.0	47.89256492351476
chr7	KRIT1	92245464	92245904	0	441	269252	5947	269252	5506	0.0	48.90156193243734
chr7	KRIT1	92245426	92245788	0	363	269252	5947	269252	5584	0.0	48.21848137535817
chr7	KRIT1	92245843	92245904	0	62	269252	5947	269252	5885	0.0	45.75225148683093
chr7	KRIT1	92245821	92245842	0	22	269252	5947	269252	5925	0.0	45.44337552742616
chr7	KRIT1	92245821	92245904	0	84	269252	5947	269252	5863	0.0	45.92392972880778
chr7	KRIT1	92245464	92245842	0	379	269252	5947	269252	5568	0.0	48.35704022988506
chr7	KRIT1	92245464	92245820	0	357	269252	5947	269252	5590	0.0	48.166726296958856
chr7	PEX1	92489713	92489717	0	5	255	7210	255	7205	0.0	0.03539208882720333
chr7	FAM133B	92566009	92566012	0	4	0	4492	0	4488	0.0	0.0
chr7	FAM133B	92589859	92589874	0	16	0	4492	0	4476	0.0	0.0
chr7	SAMD9L	93146882	93147086	0	205	0	2461	0	2256	0.0	0.0
chr7	TFPI2	93889016	93889033	0	18	204	2212	204	2194	0.0	0.09298085688240657
chr7	SGCE	94587777	94588687	0	911	162	11980	162	11069	0.0	0.014635468425332008
chr7	SGCE	94597748	94597928	78	181	162	11980	84	11799	0.430939226519337	0.007119247393846936
chr7	SGCE	94597748	94597922	78	175	162	11980	84	11805	0.44571428571428573	0.0071156289707750954
chr7	SGCE	94622515	94622544	0	30	162	11980	162	11950	0.0	0.013556485355648535
chr7	SGCE	94597923	94597928	0	6	162	11980	162	11974	0.0	0.013529313512610656
chr7	PON2	95409900	95409952	0	53	51	3559	51	3506	0.0	0.014546491728465488
chr7	PON2	95416171	95416240	0	70	51	3559	51	3489	0.0	0.014617368873602751
chr7	DLX6-AS1	96978346	96979488	0	1143	306	16178	306	15035	0.0	0.0203525108081144
chr7	DLX6-AS1	96978346	96979082	0	737	306	16178	306	15441	0.0	0.0198173693413639
chr7	DLX6-AS1	97003276	97003507	0	232	306	16178	306	15946	0.0	0.019189765458422176
chr7	DLX6-AS1	97011824	97012179	0	356	306	16178	306	15822	0.0	0.019340159271899887
chr7	DLX6-AS1	96979083	96979488	0	406	306	16178	306	15772	0.0	0.019401470961197056
chr7	ASNS	97871718	97872039	0	322	12062	4867	12062	4545	0.0	2.653905390539054
chr7	ASNS	97871680	97871717	0	38	12062	4867	12062	4829	0.0	2.497825636777801
chr7	TECPR1	98251393	98251417	0	25	102	8184	102	8159	0.0	0.012501532050496384
chr7	TECPR1	98251789	98251899	0	111	102	8184	102	8073	0.0	0.0126347082868822
chr7	PTCD1	99438550	99438565	0	16	0	5697	0	5681	0.0	0.0
chr7	PTCD1	99438566	99438690	0	125	0	5697	0	5572	0.0	0.0
chr7	ATP5MF	99466110	99466127	0	18	204	2117	204	2099	0.0	0.09718913768461172
chr7	ZNF3	100077228	100077301	0	74	184638	5432	184638	5358	0.0	34.4602463605823
chr7	TAF6	100113615	100113678	0	64	133	3852	133	3788	0.0	0.035110876451953536
chr7	TAF6	100114053	100114082	0	30	133	3852	133	3822	0.0	0.0347985347985348
chr7	TAF6	100119203	100119327	0	125	133	3852	133	3727	0.0	0.03568553796619265
chr7	TAF6	100118879	100119202	0	324	133	3852	133	3528	0.0	0.037698412698412696
chr7	TAF6	100118879	100119327	0	449	133	3852	133	3403	0.0	0.03908316191595651
chr7	TAF6	100119203	100119230	0	28	133	3852	133	3824	0.0	0.03478033472803347
chr7	MAP11	100158088	100158587	717	500	2699	2975	1982	2475	1.434	0.8008080808080809
chr7	MAP11	100157292	100157371	0	80	2699	2975	2699	2895	0.0	0.9322970639032815
chr7	CASTOR3	100212952	100213045	718	94	27956	4870	27238	4776	7.638297872340425	5.703098827470686
chr7	PMS2P1	100335674	100335836	51	163	153	5373	102	5210	0.3128834355828221	0.019577735124760076
chr7	PMS2P1	100335656	100335673	0	18	153	5373	153	5355	0.0	0.02857142857142857
chr7	PMS2P1	100335656	100335836	51	181	153	5373	102	5192	0.281767955801105	0.019645608628659477
chr7	PMS2P1	100334971	100335204	0	234	153	5373	153	5139	0.0	0.0297723292469352
chr7	ZCWPW1	100419001	100419109	0	109	204280	3336	204280	3227	0.0	63.303377750232414
chr7	PCOLCE-AS1	100603837	100604002	0	166	0	3274	0	3108	0.0	0.0
chr7	EPHB4	100817191	100817260	0	70	457036	6454	457036	6384	0.0	71.59085213032581
chr7	ACHE	100892333	100892685	140	353	15872	3736	15732	3383	0.39660056657223797	4.650310375406444
chr7	PLOD3	101216162	101216195	0	34	0	5401	0	5367	0.0	0.0
chr7	PLOD3	101211540	101211589	0	50	0	5401	0	5351	0.0	0.0
chr7	FIS1	101244897	101244958	0	62	0	1800	0	1738	0.0	0.0
chr7	POLR2J	102478807	102478809	0	3	0	1356	0	1353	0.0	0.0
chr7	RASA4B	102517543	102517644	102	102	2687	7327	2585	7225	1.0	0.35778546712802767
chr7	RASA4	102594446	102594490	0	45	547	8099	547	8054	0.0	0.06791656319841073
chr7	RASA4	102616522	102616623	0	102	547	8099	547	7997	0.0	0.06840065024384144
chr7	NAPEPLD	103148810	103149042	0	233	103	6140	103	5907	0.0	0.017436939224648722
chr7	NAPEPLD	103148810	103148921	0	112	103	6140	103	6028	0.0	0.017086927670869275
chr7	NAPEPLD	103148922	103149042	0	121	103	6140	103	6019	0.0	0.0171124771556737
chr7	DPY19L2P2	103274069	103275538	0	1470	0	5606	0	4136	0.0	0.0
chr7	DPY19L2P2	103279832	103280136	0	305	0	5606	0	5301	0.0	0.0
chr7	ORC5	104202376	104202409	0	34	126	3741	126	3707	0.0	0.03398974912328028
chr7	PUS7	105470687	105470759	0	73	1610	4451	1610	4378	0.0	0.3677478300593878
chr7	SYPL1	106092547	106092562	0	16	0	2483	0	2467	0.0	0.0
chr7	AC004917.1	106572947	106572962	0	16	217	2096	217	2080	0.0	0.10432692307692308
chr7	SLC26A4-AS1	107654610	107654642	0	33	51	8534	51	8501	0.0	0.0059992942006822725
chr7	AC002467.1	107743932	107744057	0	126	0	3959	0	3833	0.0	0.0
chr7	SLC26A3	107803110	107803120	0	11	0	3403	0	3392	0.0	0.0
chr7	LAMB1	108001998	108002125	0	128	0	15924	0	15796	0.0	0.0
chr7	LAMB1	108001946	108001997	0	52	0	15924	0	15872	0.0	0.0
chr7	LAMB1	108001946	108002125	0	180	0	15924	0	15744	0.0	0.0
chr7	LAMB1	107975229	107975232	0	4	0	15924	0	15920	0.0	0.0
chr7	PNPLA8	108487758	108487943	0	186	0	5688	0	5502	0.0	0.0
chr7	PNPLA8	108526028	108526048	0	21	0	5688	0	5667	0.0	0.0
chr7	THAP5	108565829	108565950	0	122	0	5062	0	4940	0.0	0.0
chr7	IMMP2L	111562443	111562462	0	20	612	3465	612	3445	0.0	0.1776487663280116
chr7	SMIM30	113118439	113118526	0	88	0	1844	0	1756	0.0	0.0
chr7	AC073130.2	116243841	116243876	0	36	0	922	0	886	0.0	0.0
chr7	COMETT	116573440	116573545	0	106	575	1698	575	1592	0.0	0.3611809045226131
chr7	CTTNBP2	117791127	117791289	0	163	0	6668	0	6505	0.0	0.0
chr7	TSPAN12	120858203	120858232	30	30	38	3274	8	3244	1.0	0.002466091245376079
chr7	TSPAN12	120857038	120857084	0	47	38	3274	38	3227	0.0	0.011775643012085528
chr7	FAM3C	121396161	121396297	0	137	102	3406	102	3269	0.0	0.03120220250841236
chr7	AASS	122098744	122098747	0	4	0	6223	0	6219	0.0	0.0
chr7	IQUB	123532375	123532787	0	413	0	4300	0	3887	0.0	0.0
chr7	NDUFA5	123557624	123557773	0	150	663	7705	663	7555	0.0	0.08775645268034414
chr7	NDUFA5	123557403	123557623	0	221	663	7705	663	7484	0.0	0.08858898984500267
chr7	NDUFA5	123546582	123546656	0	75	663	7705	663	7630	0.0	0.08689384010484928
chr7	NDUFA5	123544729	123544733	0	5	663	7705	663	7700	0.0	0.0861038961038961
chr7	POT1	124858956	124859044	0	89	0	8237	0	8148	0.0	0.0
chr7	POT1	124823796	124823969	0	174	0	8237	0	8063	0.0	0.0
chr7	POT1	124929558	124929792	0	235	0	8237	0	8002	0.0	0.0
chr7	POT1	124929457	124929792	0	336	0	8237	0	7901	0.0	0.0
chr7	POT1	124929457	124929557	0	101	0	8237	0	8136	0.0	0.0
chr7	POT1	124827200	124827212	0	13	0	8237	0	8224	0.0	0.0
chr7	GRM8	126446070	126446124	0	55	0	6186	0	6131	0.0	0.0
chr7	ZNF800	127392157	127392257	0	101	140943	5296	140943	5195	0.0	27.13051010587103
chr7	ZNF800	127392157	127392546	0	390	140943	5296	140943	4906	0.0	28.728699551569505
chr7	ZNF800	127392059	127392156	0	98	140943	5296	140943	5198	0.0	27.11485186610235
chr7	ZNF800	127392059	127392257	0	199	140943	5296	140943	5097	0.0	27.652148322542672
chr7	ZNF800	127392059	127392546	0	488	140943	5296	140943	4808	0.0	29.31426788685524
chr7	ZNF800	127392059	127392063	0	5	140943	5296	140943	5291	0.0	26.638253638253637
chr7	PRRT4	128361305	128361559	0	255	153	3551	153	3296	0.0	0.04641990291262136
chr7	IMPDH1	128400816	128400830	0	15	1729486	3677	1729486	3662	0.0	472.2790824685964
chr7	KCP	128874295	128874314	0	20	5806	12575	5806	12555	0.0	0.4624452409398646
chr7	KCP	128869622	128869954	867	333	5806	12575	4939	12242	2.6036036036036037	0.4034471491586342
chr7	UBE2H	129880878	129880893	0	16	54072	6527	54072	6511	0.0	8.30471509752726
chr7	TMEM209	130204966	130205371	0	406	0	4570	0	4164	0.0	0.0
chr7	TMEM209	130204966	130205081	0	116	0	4570	0	4454	0.0	0.0
chr7	CEP41	130404563	130404638	0	76	1002	12794	1002	12718	0.0	0.0787859726372071
chr7	CEP41	130440933	130441031	0	99	1002	12794	1002	12695	0.0	0.07892871209137456
chr7	CEP41	130400697	130400705	0	9	1002	12794	1002	12785	0.0	0.07837309346890887
chr7	CEP41	130426628	130426644	0	17	1002	12794	1002	12777	0.0	0.07842216482742428
chr7	CEP41	130440533	130440932	0	400	1002	12794	1002	12394	0.0	0.08084557043730838
chr7	COPG2	130508561	130508567	0	7	10408	4163	10408	4156	0.0	2.5043310875842155
chr7	TSGA13	130686261	130686442	0	182	1793	2204	1793	2022	0.0	0.8867457962413452
chr7	MKLN1-AS	131324251	131324301	0	51	0	7684	0	7633	0.0	0.0
chr7	MKLN1-AS	131324251	131324299	0	49	0	7684	0	7635	0.0	0.0
chr7	MKLN1-AS	131324300	131324301	0	2	0	7684	0	7682	0.0	0.0
chr7	AKR1B1	134447460	134447978	0	519	0	3065	0	2546	0.0	0.0
chr7	AKR1B1	134458996	134459120	0	125	0	3065	0	2940	0.0	0.0
chr7	CYREN	135168930	135168967	0	38	2744	5206	2744	5168	0.0	0.5309597523219814
chr7	CYREN	135168748	135168929	0	182	2744	5206	2744	5024	0.0	0.5461783439490446
chr7	CYREN	135168748	135168784	0	37	2744	5206	2744	5169	0.0	0.53085703230799
chr7	CYREN	135168748	135168967	0	220	2744	5206	2744	4986	0.0	0.5503409546730846
chr7	CYREN	135170275	135170397	0	123	2744	5206	2744	5083	0.0	0.5398386779460949
chr7	CYREN	135170398	135170650	204	253	2744	5206	2540	4953	0.8063241106719368	0.5128205128205128
chr7	CYREN	135168785	135168929	0	145	2744	5206	2744	5061	0.0	0.5421853388658368
chr7	CYREN	135168785	135168967	0	183	2744	5206	2744	5023	0.0	0.5462870794346009
chr7	CYREN	135168744	135168929	0	186	2744	5206	2744	5020	0.0	0.546613545816733
chr7	CYREN	135168744	135168747	0	4	2744	5206	2744	5202	0.0	0.5274894271434064
chr7	CYREN	135168744	135168784	0	41	2744	5206	2744	5165	0.0	0.531268151016457
chr7	CYREN	135168744	135168967	0	224	2744	5206	2744	4982	0.0	0.5507828181453231
chr7	CNOT4	135410514	135410522	0	9	8494	5584	8494	5575	0.0	1.5235874439461883
chr7	FAM180A	135733645	135733675	0	31	0	2505	0	2474	0.0	0.0
chr7	AC078842.1	137354274	137354360	0	87	0	2157	0	2070	0.0	0.0
chr7	SVOPL	138659863	138663072	969	3210	7359	3244	6390	34	0.3018691588785047	187.94117647058823
chr7	ZC3HAV1	139079103	139079468	95	366	176543	8254	176448	7888	0.25956284153005466	22.36916835699797
chr7	MKRN1	140455789	140455855	0	67	4876	5678	4876	5611	0.0	0.8690073070753876
chr7	MKRN1	140478599	140478835	0	237	4876	5678	4876	5441	0.0	0.8961587943392759
chr7	WEE2-AS1	141727496	141727552	0	57	0	5092	0	5035	0.0	0.0
chr7	KEL	142962114	142962202	48747	89	82791	3546	34044	3457	547.7191011235955	9.847844952270755
chr7	FAM131B	143358826	143358841	0	16	0	6306	0	6290	0.0	0.0
chr7	FAM131B	143362575	143362633	0	59	0	6306	0	6247	0.0	0.0
chr7	AC099548.2	143833246	143833727	0	482	0	3634	0	3152	0.0	0.0
chr7	TCAF1	143901960	143902025	0	66	398	6256	398	6190	0.0	0.064297253634895
chr7	TCAF1	143901960	143902072	6	113	398	6256	392	6143	0.05309734513274336	0.06381246947745402
chr7	TCAF1	143857073	143857098	0	26	398	6256	398	6230	0.0	0.063884430176565
chr7	TCAF1	143902026	143902072	6	47	398	6256	392	6209	0.1276595744680851	0.06313416009019165
chr7	AC074386.1	144254433	144254602	0	170	0	2197	0	2027	0.0	0.0
chr7	NOBOX	144400109	144400204	0	96	8	2124	8	2028	0.0	0.0039447731755424065
chr7	EZH2	148846469	148846495	0	27	5922	4102	5922	4075	0.0	1.4532515337423313
chr7	EZH2	148826453	148826467	150	15	5922	4102	5772	4087	10.0	1.412282848054808
chr7	ZNF425	149126129	149126194	0	66	0	3551	0	3485	0.0	0.0
chr7	ZNF767P	149551573	149551653	0	81	43621	4017	43621	3936	0.0	11.082571138211382
chr7	RARRES2	150341577	150341608	0	32	0	736	0	704	0.0	0.0
chr7	ATG9B	151015359	151015416	0	58	55	5653	55	5595	0.0	0.009830205540661306
chr7	FASTK	151078841	151078921	0	81	0	3292	0	3211	0.0	0.0
chr7	TMUB1	151082763	151083081	0	319	296	1960	296	1641	0.0	0.18037781840341255
chr7	TMUB1	151082763	151082916	0	154	296	1960	296	1806	0.0	0.1638981173864895
chr7	IQCA1L	151193196	151193289	51	94	17237	2846	17186	2752	0.5425531914893617	6.244912790697675
chr7	SMARCD3	151242704	151242719	0	16	14119	4505	14119	4489	0.0	3.145243929605703
chr7	CRYGN	151437838	151437994	0	157	102	3188	102	3031	0.0	0.03365225998020455
chr7	PRKAG2	151781125	151781150	7	26	21836	14143	21829	14117	0.2692307692307692	1.5462917050364808
chr7	KMT2C	152145152	152145163	0	12	21420	18723	21420	18711	0.0	1.1447811447811447
chr7	KMT2C	152180710	152182155	0	1446	21420	18723	21420	17277	0.0	1.2397985761416912
chr7	LINC01287	153411581	153411584	0	4	0	9603	0	9599	0.0	0.0
chr7	AC009403.2	155482716	155482833	3	118	3085	7213	3082	7095	0.025423728813559324	0.43439041578576465
chr7	AC009403.1	155644213	155644360	0	148	0	2036	0	1888	0.0	0.0
chr7	LINC01006	156480664	156481375	67751	712	85089	11122	17338	10410	95.15589887640449	1.6655139289145053
chr7	LMBR1	156833738	156833751	0	14	34687	8530	34687	8516	0.0	4.07315641146078
chr7	LMBR1	156836808	156836811	0	4	34687	8530	34687	8526	0.0	4.068379075768238
chr7	MNX1	157008527	157008996	3264	470	28313	2760	25049	2290	6.94468085106383	10.938427947598253
chr7	VIPR2	159144297	159144719	0	423	37	4724	37	4301	0.0	0.008602650546384562
chr8	MCPH1-AS1	6621344	6621421	0	78	43200	9929	43200	9851	0.0	4.385341589686326
chr8	MCPH1-AS1	6620991	6621343	0	353	43200	9929	43200	9576	0.0	4.511278195488722
chr8	MCPH1-AS1	6620991	6621421	0	431	43200	9929	43200	9498	0.0	4.548325963360708
chr8	FAM66B	7348972	7349081	0	110	0	6754	0	6644	0.0	0.0
chr8	MIR124-1HG	9900544	9900553	0	10	0	4885	0	4875	0.0	0.0
chr8	PRSS51	10498615	10498726	0	112	0	3044	0	2932	0.0	0.0
chr8	PRSS51	10496599	10496633	0	35	0	3044	0	3009	0.0	0.0
chr8	PINX1	10839707	10839736	0	30	51	2814	51	2784	0.0	0.018318965517241378
chr8	CTSB	11867969	11867999	0	31	0	8249	0	8218	0.0	0.0
chr8	CTSB	11861299	11861404	0	106	0	8249	0	8143	0.0	0.0
chr8	CTSB	11861299	11861359	0	61	0	8249	0	8188	0.0	0.0
chr8	CTSB	11868646	11868669	0	24	0	8249	0	8225	0.0	0.0
chr8	CTSB	11867253	11867968	0	716	0	8249	0	7533	0.0	0.0
chr8	CTSB	11867253	11867999	0	747	0	8249	0	7502	0.0	0.0
chr8	CTSB	11868876	11868920	0	45	0	8249	0	8204	0.0	0.0
chr8	CTSB	11861360	11861404	0	45	0	8249	0	8204	0.0	0.0
chr8	FAM86B1	12193579	12193609	0	31	0	4142	0	4111	0.0	0.0
chr8	FAM86B1	12193876	12193973	0	98	0	4142	0	4044	0.0	0.0
chr8	FAM86B1	12185233	12185374	0	142	0	4142	0	4000	0.0	0.0
chr8	FAM86B1	12186351	12186698	0	348	0	4142	0	3794	0.0	0.0
chr8	FAM86B2	12436149	12436246	23	98	23	1374	0	1276	0.23469387755102042	0.0
chr8	MTUS1	17722420	17722567	0	148	187	12042	187	11894	0.0	0.015722212880443922
chr8	ASAH1	18067219	18067248	0	30	2982	9281	2982	9251	0.0	0.3223435304291428
chr8	ASAH1	18071299	18071329	0	31	2982	9281	2982	9250	0.0	0.3223783783783784
chr8	ASAH1	18084586	18084674	0	89	2982	9281	2982	9192	0.0	0.3244125326370757
chr8	ASAH1	18084586	18084670	0	85	2982	9281	2982	9196	0.0	0.32427142235754675
chr8	ASAH1	18083980	18084674	0	695	2982	9281	2982	8586	0.0	0.3473095737246681
chr8	ASAH1	18083980	18084585	0	606	2982	9281	2982	8675	0.0	0.3437463976945245
chr8	ASAH1	18083980	18084285	0	306	2982	9281	2982	8975	0.0	0.33225626740947073
chr8	ASAH1	18083980	18084460	0	481	2982	9281	2982	8800	0.0	0.33886363636363637
chr8	ASAH1	18083980	18084670	0	691	2982	9281	2982	8590	0.0	0.34714784633294526
chr8	ASAH1	18084286	18084674	0	389	2982	9281	2982	8892	0.0	0.33535762483130904
chr8	ASAH1	18084286	18084585	0	300	2982	9281	2982	8981	0.0	0.33203429462197975
chr8	ASAH1	18084286	18084460	0	175	2982	9281	2982	9106	0.0	0.32747638919393807
chr8	ASAH1	18084286	18084670	0	385	2982	9281	2982	8896	0.0	0.3352068345323741
chr8	ASAH1	18084461	18084674	0	214	2982	9281	2982	9067	0.0	0.32888496746443147
chr8	ASAH1	18084461	18084585	0	125	2982	9281	2982	9156	0.0	0.3256880733944954
chr8	ASAH1	18084461	18084670	0	210	2982	9281	2982	9071	0.0	0.3287399404696285
chr8	ASAH1	18083916	18083979	0	64	2982	9281	2982	9217	0.0	0.32353260279917545
chr8	ASAH1	18083916	18083939	0	24	2982	9281	2982	9257	0.0	0.3221346008426056
chr8	ASAH1	18083940	18083979	0	40	2982	9281	2982	9241	0.0	0.3226923493128449
chr8	ASAH1	18083898	18083979	0	82	2982	9281	2982	9199	0.0	0.32416567018154147
chr8	ASAH1	18083898	18083939	0	42	2982	9281	2982	9239	0.0	0.32276220370169934
chr8	ASAH1	18083898	18083915	0	18	2982	9281	2982	9263	0.0	0.32192594191946455
chr8	ASAH1	18084671	18084674	0	4	2982	9281	2982	9277	0.0	0.32144012072868383
chr8	CSGALNACT1	19601991	19602400	0	410	12205	6602	12205	6192	0.0	1.9710917312661498
chr8	GFRA2	21788119	21788632	0	514	201	5482	201	4968	0.0	0.04045893719806763
chr8	REEP4	22140606	22140623	0	18	0	2273	0	2255	0.0	0.0
chr8	ENTPD4	23441568	23441591	15	24	2184763	7070	2184748	7046	0.625	310.06925915413
chr8	AC024958.1	24514407	24514573	0	167	105	1151	105	984	0.0	0.10670731707317073
chr8	KCTD9	25446079	25446127	0	49	0	4398	0	4349	0.0	0.0
chr8	SDAD1P1	26382310	26382386	0	77	240	3781	240	3704	0.0	0.06479481641468683
chr8	PNMA2	26509547	26509599	655	53	627330	5265	626675	5212	12.358490566037736	120.23695318495778
chr8	CHRNA2	27469760	27469804	342	45	332217	5067	331875	5022	7.6	66.084229390681
chr8	CHRNA2	27469528	27469759	663	232	332217	5067	331554	4835	2.8577586206896552	68.57373319544985
chr8	CHRNA2	27469528	27469804	1005	277	332217	5067	331212	4790	3.628158844765343	69.14655532359082
chr8	CLU	27611109	27611144	0	36	28475	5788	28475	5752	0.0	4.950452016689847
chr8	CLU	27611074	27611144	0	71	28475	5788	28475	5717	0.0	4.9807591394087805
chr8	CLU	27611074	27611108	0	35	28475	5788	28475	5753	0.0	4.9495915174691465
chr8	CLU	27613577	27614171	0	595	28475	5788	28475	5193	0.0	5.483342961679184
chr8	PBK	27837651	27837708	0	58	168	2156	168	2098	0.0	0.08007626310772165
chr8	PBK	27833041	27833054	0	14	168	2156	168	2142	0.0	0.0784313725490196
chr8	EXTL3-AS1	28699440	28699904	0	465	763	2726	763	2261	0.0	0.33746130030959753
chr8	EXTL3-AS1	28699440	28699903	0	464	763	2726	763	2262	0.0	0.33731211317418214
chr8	EXTL3-AS1	28699904	28699904	0	1	763	2726	763	2725	0.0	0.28
chr8	INTS9	28889841	28889872	0	32	1928	4789	1928	4757	0.0	0.4052974563800715
chr8	SARAF	30065987	30066026	0	40	1122	1698	1122	1658	0.0	0.6767189384800965
chr8	FUT10	33461371	33461486	0	116	102	4267	102	4151	0.0	0.02457239219465189
chr8	FUT10	33461371	33461410	0	40	102	4267	102	4227	0.0	0.0241305890702626
chr8	FUT10	33461411	33461486	0	76	102	4267	102	4191	0.0	0.024337866857551897
chr8	TTI2	33512959	33513080	0	122	0	3568	0	3446	0.0	0.0
chr8	AC091182.1	37331766	37331792	0	27	232	4222	232	4195	0.0	0.05530393325387366
chr8	BRF2	37847273	37847301	0	29	102	2723	102	2694	0.0	0.0378619153674833
chr8	RAB11FIP1	37899070	37899302	306	233	153	8656	-153	8423	1.3133047210300428	-0.018164549447940163
chr8	LSM1	38176274	38176551	3985	278	4766	1222	781	944	14.33453237410072	0.8273305084745762
chr8	PLPP5	38268822	38268880	2575	59	84980	3045	82405	2986	43.644067796610166	27.59711989283322
chr8	PLPP5	38269081	38269124	4967	44	84980	3045	80013	3001	112.88636363636364	26.662112629123627
chr8	NSD3	38281466	38281498	30	33	1338735	15273	1338705	15240	0.9090909090909091	87.84153543307086
chr8	FGFR1	38419532	38419537	0	6	323	11651	323	11645	0.0	0.027737226277372264
chr8	FGFR1	38428345	38428350	0	6	323	11651	323	11645	0.0	0.027737226277372264
chr8	AC069120.1	38552620	38552957	0	338	51	2688	51	2350	0.0	0.02170212765957447
chr8	TM2D2	38996212	38996417	51	206	3162	4042	3111	3836	0.24757281553398058	0.8110010427528676
chr8	ADAM3A	39465844	39465847	0	4	0	3023	0	3019	0.0	0.0
chr8	ANK1	41661800	41661874	0	75	52607	10404	52607	10329	0.0	5.093135831155
chr8	KAT6A	41942786	41942791	0	6	600	16866	600	16860	0.0	0.03558718861209965
chr8	KAT6A	42049575	42049618	0	44	600	16866	600	16822	0.0	0.03566757817144216
chr8	KAT6A	41978620	41978640	0	21	600	16866	600	16845	0.0	0.03561887800534283
chr8	SLC20A2	42501030	42501185	0	156	313	6168	313	6012	0.0	0.05206254158349967
chr8	RNF170	42887727	42887847	443	121	32700	5835	32257	5714	3.6611570247933884	5.645257262863143
chr8	RNF170	42896253	42896482	80	230	32700	5835	32620	5605	0.34782608695652173	5.819803746654773
chr8	ST18	52180121	52180124	0	4	256	12096	256	12092	0.0	0.02117102216341383
chr8	ST18	52217745	52217811	0	67	256	12096	256	12029	0.0	0.021281902069997506
chr8	ST18	52217741	52217744	0	4	256	12096	256	12092	0.0	0.02117102216341383
chr8	ST18	52217741	52217811	0	71	256	12096	256	12025	0.0	0.02128898128898129
chr8	RB1CC1	52628031	52628039	0	9	0	6657	0	6648	0.0	0.0
chr8	ATP6V1H	53832983	53833059	0	77	0	3871	0	3794	0.0	0.0
chr8	ATP6V1H	53842870	53843032	0	163	0	3871	0	3708	0.0	0.0
chr8	ATP6V1H	53842870	53842954	0	85	0	3871	0	3786	0.0	0.0
chr8	ATP6V1H	53842503	53842869	0	367	0	3871	0	3504	0.0	0.0
chr8	TCEA1	54022062	54022264	0	203	51	4334	51	4131	0.0	0.012345679012345678
chr8	TMEM68	55773226	55773267	0	42	0	6607	0	6565	0.0	0.0
chr8	TMEM68	55763421	55763635	0	215	0	6607	0	6392	0.0	0.0
chr8	RPS20	56074059	56074379	0	321	0	6105	0	5784	0.0	0.0
chr8	RPS20	56074253	56074379	0	127	0	6105	0	5978	0.0	0.0
chr8	SDR16C6P	56381941	56381953	0	13	0	1094	0	1081	0.0	0.0
chr8	LINC00968	56559452	56559556	0	105	0	3316	0	3211	0.0	0.0
chr8	AC092819.1	58259747	58259946	0	200	0	2277	0	2077	0.0	0.0
chr8	AC092819.1	58271869	58272002	0	134	0	2277	0	2143	0.0	0.0
chr8	AC092819.1	58259743	58259746	0	4	0	2277	0	2273	0.0	0.0
chr8	AC092819.1	58259743	58259946	0	204	0	2277	0	2073	0.0	0.0
chr8	LINC01301	60412493	60412592	0	100	102	9536	102	9436	0.0	0.010809665112335736
chr8	AC023866.1	61300819	61300919	0	101	612	682	612	581	0.0	1.0533562822719449
chr8	AC011124.1	63469978	63469981	0	4	204	3217	204	3213	0.0	0.06349206349206349
chr8	ARMC1	65633718	65633996	0	279	0	3427	0	3148	0.0	0.0
chr8	PDE7A	65841848	65842080	0	233	102	10619	102	10386	0.0	0.009820912767186597
chr8	PPP1R42	66970980	66971092	0	113	0	2092	0	1979	0.0	0.0
chr8	COPS5	67060320	67060495	0	176	0	6172	0	5996	0.0	0.0
chr8	LINC01603	69447586	69447816	0	231	0	1560	0	1329	0.0	0.0
chr8	NCOA2	70141178	70141182	0	5	51	9572	51	9567	0.0	0.00533082470994042
chr8	TRAM1	70608076	70608261	0	186	0	4144	0	3958	0.0	0.0
chr8	C8ORF89	73256972	73257039	0	68	0	662	0	594	0.0	0.0
chr8	AC111149.1	73369456	73369488	0	33	0	1738	0	1705	0.0	0.0
chr8	ELOC	73972041	73972075	9	35	42046	4943	42037	4908	0.2571428571428571	8.564995925020375
chr8	JPH1	74320908	74321272	0	365	15467	2128	15467	1763	0.0	8.77311401020987
chr8	CASC9	75324220	75324563	0	344	10073	3373	10073	3029	0.0	3.325519973588643
chr8	ZFHX4-AS1	76614792	76615151	0	360	153	5260	153	4900	0.0	0.031224489795918367
chr8	IL7	78798071	78798126	0	56	0	3129	0	3073	0.0	0.0
chr8	HEY1	79767390	79767417	0	28	306	4811	306	4783	0.0	0.06397658373405812
chr8	HEY1	79767574	79767602	0	29	306	4811	306	4782	0.0	0.06398996235884567
chr8	HEY1	79766202	79766365	0	164	306	4811	306	4647	0.0	0.065848934796643
chr8	HEY1	79766996	79767007	0	12	306	4811	306	4799	0.0	0.06376328401750364
chr8	HEY1	79767418	79767602	0	185	306	4811	306	4626	0.0	0.06614785992217899
chr8	HEY1	79767418	79767573	0	156	306	4811	306	4655	0.0	0.0657357679914071
chr8	HEY1	79766992	79767007	0	16	306	4811	306	4795	0.0	0.06381647549530761
chr8	HEY1	79766992	79766995	0	4	306	4811	306	4807	0.0	0.06365716663199501
chr8	MRPS28	80029760	80029903	60	144	60	1805	0	1661	0.4166666666666667	0.0
chr8	FABP4	81483094	81483097	0	4	654	1373	654	1369	0.0	0.4777209642074507
chr8	FABP12	81529375	81529436	0	62	0	617	0	555	0.0	0.0
chr8	IMPA1P1	81626883	81626885	0	3	0	986	0	983	0.0	0.0
chr8	ZFAND1	81721226	81721247	0	22	0	2569	0	2547	0.0	0.0
chr8	ZFAND1	81721069	81721225	0	157	0	2569	0	2412	0.0	0.0
chr8	ZFAND1	81721065	81721225	0	161	0	2569	0	2408	0.0	0.0
chr8	ZFAND1	81721065	81721247	0	183	0	2569	0	2386	0.0	0.0
chr8	ZFAND1	81721065	81721068	0	4	0	2569	0	2565	0.0	0.0
chr8	SNX16	81841697	81841927	0	231	0	4619	0	4388	0.0	0.0
chr8	LINC02839	82160416	82160528	0	113	0	1168	0	1055	0.0	0.0
chr8	RBIS	85219235	85219321	0	87	0	2119	0	2032	0.0	0.0
chr8	RBIS	85218706	85219234	0	529	0	2119	0	1590	0.0	0.0
chr8	CA3-AS1	85462931	85463176	0	246	0	3418	0	3172	0.0	0.0
chr8	SLC7A13	86229592	86229618	0	27	0	2215	0	2188	0.0	0.0
chr8	AF117829.1	89725505	89725516	0	12	2449	13611	2449	13599	0.0	0.18008677108610927
chr8	OTUD6B-AS1	91068935	91069577	51	643	2397	9837	2346	9194	0.07931570762052877	0.2551664128779639
chr8	AC091096.1	92653937	92653940	0	4	0	2349	0	2345	0.0	0.0
chr8	TRIQK	92965807	92966005	0	199	622	4946	622	4747	0.0	0.13103012428902464
chr8	RBM12B	93740862	93740879	0	18	0	5969	0	5951	0.0	0.0
chr8	GEM	94262089	94262203	0	115	0	2654	0	2539	0.0	0.0
chr8	UQCRB	96231225	96231377	0	153	102	9892	102	9739	0.0	0.010473354553855632
chr8	RPL30	98044826	98044941	0	116	656	3856	656	3740	0.0	0.1754010695187166
chr8	VPS13B-DT	99012868	99012889	0	22	4554	3622	4554	3600	0.0	1.265
chr8	COX6C	99893318	99893441	0	124	37	2597	37	2473	0.0	0.014961585119288313
chr8	RGS22	100071368	100071403	0	36	19329	6401	19329	6365	0.0	3.036763550667714
chr8	FBXO43	100145006	100145049	0	44	5289	3937	5289	3893	0.0	1.3585923452350372
chr8	ANKRD46	100559037	100559384	0	348	16	5482	16	5134	0.0	0.0031164783794312427
chr8	ANKRD46	100559037	100559530	0	494	16	5482	16	4988	0.0	0.0032076984763432237
chr8	ANKRD46	100559531	100559709	0	179	16	5482	16	5303	0.0	0.003017160098057703
chr8	PABPC1	100715461	100715469	0	9	1532	8827	1532	8818	0.0	0.17373554093898844
chr8	PABPC1	100718086	100718181	0	96	1532	8827	1532	8731	0.0	0.1754667277516894
chr8	PABPC1	100718086	100718229	0	144	1532	8827	1532	8683	0.0	0.17643671542093747
chr8	PABPC1	100721029	100721111	0	83	1532	8827	1532	8744	0.0	0.17520585544373285
chr8	PABPC1	100720804	100721111	0	308	1532	8827	1532	8519	0.0	0.17983331376922174
chr8	PABPC1	100720804	100721028	0	225	1532	8827	1532	8602	0.0	0.17809811671704254
chr8	PABPC1	100720804	100721389	0	586	1532	8827	1532	8241	0.0	0.18589976944545564
chr8	PABPC1	100720804	100721727	0	924	1532	8827	1532	7903	0.0	0.1938504365430849
chr8	PABPC1	100721390	100721727	0	338	1532	8827	1532	8489	0.0	0.18046884203086347
chr8	PABPC1	100721728	100721732	0	5	1532	8827	1532	8822	0.0	0.17365676717297665
chr8	PABPC1	100704279	100704295	0	17	1532	8827	1532	8810	0.0	0.17389330306469922
chr8	PABPC1	100718182	100718229	0	48	1532	8827	1532	8779	0.0	0.17450734707825494
chr8	PABPC1	100721712	100721727	0	16	1532	8827	1532	8811	0.0	0.1738735671319941
chr8	PABPC1	100721712	100721732	0	21	1532	8827	1532	8806	0.0	0.17397229161935043
chr8	YWHAZ	100951185	100951233	0	49	51	5869	51	5820	0.0	0.008762886597938144
chr8	ZNF706	101202332	101204648	6509	2317	11580	4818	5071	2501	2.8092360811394044	2.0275889644142344
chr8	UBR5	102289452	102289527	0	76	0	13803	0	13727	0.0	0.0
chr8	ZFPM2-AS1	105927641	105927649	0	9	255	2451	255	2442	0.0	0.10442260442260443
chr8	ANGPT1	107321895	107321897	0	3	55530	7136	55530	7133	0.0	7.784943221645872
chr8	RSPO2	108082923	108083195	0	273	0	4366	0	4093	0.0	0.0
chr8	RSPO2	108083196	108083472	0	277	0	4366	0	4089	0.0	0.0
chr8	EIF3E	108236160	108236161	0	2	102	27596	102	27594	0.0	0.0036964557512502716
chr8	EIF3E	108241798	108241884	0	87	102	27596	102	27509	0.0	0.0037078774219346396
chr8	EIF3E	108202982	108202988	0	7	102	27596	102	27589	0.0	0.0036971256660263147
chr8	EIF3E	108443364	108443368	0	5	102	27596	102	27591	0.0	0.0036968576709796672
chr8	SYBU	109642727	109643235	0	509	51	6757	51	6248	0.0	0.008162612035851472
chr8	SYBU	109586016	109586058	0	43	51	6757	51	6714	0.0	0.007596067917783735
chr8	RAD21	116874309	116874361	0	53	51	4938	51	4885	0.0	0.010440122824974411
chr8	RAD21	116874249	116874308	0	60	51	4938	51	4878	0.0	0.010455104551045511
chr8	RAD21	116874205	116874308	0	104	51	4938	51	4834	0.0	0.010550268928423666
chr8	RAD21	116874205	116874248	0	44	51	4938	51	4894	0.0	0.010420923579893748
chr8	SAMD12	118439831	118439860	0	30	413	15396	413	15366	0.0	0.02687752180137967
chr8	SAMD12	118621803	118621937	0	135	413	15396	413	15261	0.0	0.027062446759714306
chr8	ENPP2	119582417	119582428	0	12	98	6760	98	6748	0.0	0.014522821576763486
chr8	ENPP2	119626564	119626617	0	54	98	6760	98	6706	0.0	0.014613778705636743
chr8	MRPL13	120444947	120445066	0	120	0	4217	0	4097	0.0	0.0
chr8	C8ORF76	123231299	123231720	0	422	0	2444	0	2022	0.0	0.0
chr8	ZHX1	123274121	123274215	0	95	51	6740	51	6645	0.0	0.007674943566591422
chr8	ATAD2	123348182	123348185	0	4	102	7131	102	7127	0.0	0.014311772134137786
chr8	ATAD2	123396182	123396185	0	4	102	7131	102	7127	0.0	0.014311772134137786
chr8	TATDN1	124504270	124504273	0	4	91964	4793	91964	4789	0.0	19.203173940279807
chr8	TATDN1	124538927	124539023	62	97	91964	4793	91902	4696	0.6391752577319587	19.570272572402043
chr8	TATDN1	124518741	124518816	23343	76	91964	4793	68621	4717	307.14473684210526	14.547593809624761
chr8	WASHC5	125083712	125083833	0	122	0	4792	0	4670	0.0	0.0
chr8	LINC00861	125950913	125951184	0	272	384	8777	384	8505	0.0	0.045149911816578486
chr8	CASC19	127187784	127187795	0	12	180	18096	180	18084	0.0	0.009953550099535502
chr8	CASC19	127218809	127218813	0	5	180	18096	180	18091	0.0	0.009949698745232436
chr8	CASC19	127187780	127187783	0	4	180	18096	180	18092	0.0	0.009949148795047534
chr8	CASC19	127191661	127191664	0	4	180	18096	180	18092	0.0	0.009949148795047534
chr8	CASC19	127227398	127227517	0	120	180	18096	180	17976	0.0	0.010013351134846462
chr8	CCDC26	128965906	128965941	165	36	28720	49644	28555	49608	4.583333333333333	0.5756128043863893
chr8	CCDC26	129574638	129574880	0	243	28720	49644	28720	49401	0.0	0.581364749701423
chr8	CCDC26	129399513	129399529	0	17	28720	49644	28720	49627	0.0	0.5787172305398272
chr8	CCDC26	129402166	129402214	0	49	28720	49644	28720	49595	0.0	0.5790906341365057
chr8	CCDC26	129360173	129360661	0	489	28720	49644	28720	49155	0.0	0.5842742345641339
chr8	CCDC26	129554803	129554908	0	106	28720	49644	28720	49538	0.0	0.5797569542573378
chr8	CCDC26	129554667	129554908	0	242	28720	49644	28720	49402	0.0	0.5813529816606615
chr8	CCDC26	129554667	129554802	0	136	28720	49644	28720	49508	0.0	0.5801082653308556
chr8	CYRIB	129896671	129896747	0	77	102	7461	102	7384	0.0	0.0138136511375948
chr8	ADCY8	130990392	130990437	0	46	68097	4463	68097	4417	0.0	15.417025130178855
chr8	KCNQ3	132134289	132134324	0	36	153	11790	153	11754	0.0	0.013016845329249618
chr8	SLA	133074852	133074861	0	10	0	7510	0	7500	0.0	0.0
chr8	NDRG1	133296736	133297132	0	397	51	10313	51	9916	0.0	0.0051432029043969344
chr8	NDRG1	133296736	133297002	0	267	51	10313	51	10046	0.0	0.005076647421859447
chr8	NDRG1	133296736	133297023	0	288	51	10313	51	10025	0.0	0.005087281795511222
chr8	NDRG1	133246595	133246614	0	20	51	10313	51	10293	0.0	0.004954823666569514
chr8	NDRG1	133256725	133256775	0	51	51	10313	51	10262	0.0	0.00496979146365231
chr8	NDRG1	133297003	133297023	0	21	51	10313	51	10292	0.0	0.004955305091333074
chr8	NDRG1	133288259	133288365	0	107	51	10313	51	10206	0.0	0.0049970605526161085
chr8	NDRG1	133279965	133280230	0	266	51	10313	51	10047	0.0	0.005076142131979695
chr8	KCNK9	139616385	139618256	0	1872	0	6793	0	4921	0.0	0.0
chr8	PTK2	140675429	140675458	0	30	4068	12062	4068	12032	0.0	0.3380984042553192
chr8	PTK2	140925561	140925659	0	99	4068	12062	4068	11963	0.0	0.3400484828220346
chr8	SLC45A4	141212196	141212202	0	7	1332	8610	1332	8603	0.0	0.1548297105660816
chr8	MROH5	141479138	141479205	82	68	1061	4795	979	4727	1.2058823529411764	0.20710810239052252
chr8	MROH5	141474001	141474130	0	130	1061	4795	1061	4665	0.0	0.22743837084673096
chr8	JRK	142669931	142669939	0	9	0	6936	0	6927	0.0	0.0
chr8	AC083841.3	142834647	142834675	0	29	0	380	0	351	0.0	0.0
chr8	NAPRT	143575190	143575228	0	39	0	2597	0	2558	0.0	0.0
chr8	NAPRT	143577815	143577859	0	45	0	2597	0	2552	0.0	0.0
chr8	EEF1D	143581228	143581284	0	57	0	8812	0	8755	0.0	0.0
chr8	EEF1D	143596878	143597346	0	469	0	8812	0	8343	0.0	0.0
chr8	EEF1D	143596878	143596911	0	34	0	8812	0	8778	0.0	0.0
chr8	EEF1D	143590607	143590643	0	37	0	8812	0	8775	0.0	0.0
chr8	EEF1D	143593874	143593891	0	18	0	8812	0	8794	0.0	0.0
chr8	EEF1D	143592646	143592713	0	68	0	8812	0	8744	0.0	0.0
chr8	EEF1D	143596854	143597346	0	493	0	8812	0	8319	0.0	0.0
chr8	EEF1D	143596912	143597346	0	435	0	8812	0	8377	0.0	0.0
chr8	GFUS	143617427	143617472	0	46	0	3184	0	3138	0.0	0.0
chr8	GFUS	143617421	143617426	0	6	0	3184	0	3178	0.0	0.0
chr8	SCRIB	143804933	143804953	0	21	119039	6452	119039	6431	0.0	18.510185041206654
chr8	PLEC	143935010	143935021	0	12	0	17036	0	17024	0.0	0.0
chr8	PLEC	143946349	143946383	0	35	0	17036	0	17001	0.0	0.0
chr8	PARP10	143983166	143983310	0	145	0	5815	0	5670	0.0	0.0
chr8	PARP10	143984007	143984033	0	27	0	5815	0	5788	0.0	0.0
chr8	PARP10	143986054	143986356	0	303	0	5815	0	5512	0.0	0.0
chr8	PARP10	143987078	143987134	0	57	0	5815	0	5758	0.0	0.0
chr8	PARP10	143986914	143987077	0	164	0	5815	0	5651	0.0	0.0
chr8	PARP10	143990605	143991031	0	427	0	5815	0	5388	0.0	0.0
chr8	PARP10	143986754	143986913	0	160	0	5815	0	5655	0.0	0.0
chr8	SHARPIN	144103552	144104023	134671	472	530591	2512	395920	2040	285.3199152542373	194.07843137254903
chr8	SHARPIN	144103552	144103845	134671	294	530591	2512	395920	2218	458.0646258503401	178.50315599639313
chr8	SHARPIN	144103846	144104023	0	178	530591	2512	530591	2334	0.0	227.3311910882605
chr8	FBXL6	144357438	144357455	157	18	89659	3250	89502	3232	8.722222222222221	27.692450495049506
chr8	VPS28	144425874	144426024	0	151	0	3187	0	3036	0.0	0.0
chr8	VPS28	144425874	144425920	0	47	0	3187	0	3140	0.0	0.0
chr8	VPS28	144425921	144426024	0	104	0	3187	0	3083	0.0	0.0
chr8	CYHR1	144465352	144465408	318	57	53352	9265	53034	9208	5.578947368421052	5.759556907037359
chr8	CYHR1	144465207	144465351	1868	145	53352	9265	51484	9120	12.882758620689655	5.645175438596492
chr8	CYHR1	144465207	144465408	2186	202	53352	9265	51166	9063	10.821782178217822	5.645591967339733
chr8	CYHR1	144465409	144465569	1864	161	53352	9265	51488	9104	11.577639751552795	5.655536028119508
chr8	AC084125.2	144498751	144498898	0	148	2966	3372	2966	3224	0.0	0.9199751861042184
chr8	RECQL4	144513217	144513414	0	198	183	4192	183	3994	0.0	0.04581872809213821
chr8	RECQL4	144511901	144511909	0	9	183	4192	183	4183	0.0	0.043748505857040404
chr8	ZNF34	144780227	144780230	8	4	44707	3115	44699	3111	2.0	14.368048858887818
chr8	RPL8	144792244	144792364	408	121	408	1672	0	1551	3.371900826446281	0.0
chr8	RPL8	144792244	144792264	0	21	408	1672	408	1651	0.0	0.2471229557843731
chr8	RPL8	144792265	144792364	408	100	408	1672	0	1572	4.08	0.0
chr8	COMMD5	144852725	144852991	0	267	153	2540	153	2273	0.0	0.06731192256929168
chr8	COMMD5	144852725	144852837	0	113	153	2540	153	2427	0.0	0.0630407911001236
chr8	COMMD5	144852838	144852991	0	154	153	2540	153	2386	0.0	0.06412405699916178
chr8	ZNF250	144901336	144901397	272	62	57585	3889	57313	3827	4.387096774193548	14.975960282205383
chr8	ZNF16	144947939	144947955	0	17	1281	5242	1281	5225	0.0	0.24516746411483253
chr8	AC144568.2	72674	72701	0	28	0	974	0	946	0.0	0.0
chr8	ZNF596	232268	232415	0	148	0	4549	0	4401	0.0	0.0
chr8	ZNF596	243806	243858	0	53	0	4549	0	4496	0.0	0.0
chr8	ZNF596	232416	232624	0	209	0	4549	0	4340	0.0	0.0
chr8	ZNF596	232625	232694	0	70	0	4549	0	4479	0.0	0.0
chr8	CLN8	1763812	1763941	123	130	14265	8418	14142	8288	0.9461538461538461	1.706322393822394
chr8	CLN8	1763886	1763941	0	56	14265	8418	14265	8362	0.0	1.7059315953121263
chr8	CLN8	1763926	1763941	0	16	14265	8418	14265	8402	0.0	1.6978100452273268
chr8	CLN8	1763812	1763885	123	74	14265	8418	14142	8344	1.662162162162162	1.6948705656759349
chr8	CLN8	1763812	1763925	123	114	14265	8418	14142	8304	1.0789473684210527	1.7030346820809248
chr8	CLN8	1763886	1763925	0	40	14265	8418	14265	8378	0.0	1.7026736691334448
chr8	FAM86B3P	8228701	8228797	0	97	7276	3972	7276	3875	0.0	1.8776774193548387
chr8	FAM86B3P	8241681	8242432	624	752	7276	3972	6652	3220	0.8297872340425532	2.0658385093167704
chr8	FAM86B3P	8241963	8242432	471	470	7276	3972	6805	3502	1.0021276595744681	1.9431753283837807
chr8	FAM86B3P	8241681	8241962	153	282	7276	3972	7123	3690	0.5425531914893617	1.9303523035230352
chr8	AC022784.1	9189587	9189597	0	11	9095	16960	9095	16949	0.0	0.5366098294884654
chr8	AC022784.1	9155077	9155149	0	73	9095	16960	9095	16887	0.0	0.5385799727601114
chr8	LINCR-0001	10477284	10477294	0	11	0	2704	0	2693	0.0	0.0
chr8	PRSS55	10531546	10531712	0	167	0	3158	0	2991	0.0	0.0
chr8	NEIL2	11771586	11771590	0	5	0	3371	0	3366	0.0	0.0
chr8	NEIL2	11769792	11770335	0	544	0	3371	0	2827	0.0	0.0
chr8	FDFT1	11802911	11802931	0	21	0	4998	0	4977	0.0	0.0
chr8	FDFT1	11803226	11803518	0	293	0	4998	0	4705	0.0	0.0
chr8	FAM66D	12115902	12116325	0	424	24	7125	24	6701	0.0	0.0035815549917922697
chr8	FAM66D	12122051	12122160	0	110	24	7125	24	7015	0.0	0.003421240199572345
chr8	TRMT9B	12991001	12991031	0	31	790	12257	790	12226	0.0	0.0646163912972354
chr8	TRMT9B	13012794	13012857	0	64	790	12257	790	12193	0.0	0.0647912736816206
chr8	PDGFRL	17576757	17576760	0	4	0	2178	0	2174	0.0	0.0
chr8	PCM1	17991677	17991700	0	24	198695	12520	198695	12496	0.0	15.900688220230474
chr8	AC124242.1	18084940	18085485	0	546	0	3569	0	3023	0.0	0.0
chr8	AC124242.1	18085198	18085485	0	288	0	3569	0	3281	0.0	0.0
chr8	INTS10	19818343	19818473	0	131	0	6356	0	6225	0.0	0.0
chr8	INTS10	19823982	19824044	0	63	0	6356	0	6293	0.0	0.0
chr8	AC015468.1	20954076	20954079	0	4	0	1056	0	1052	0.0	0.0
chr8	LINC02153	20974523	20974653	0	131	86	2753	86	2622	0.0	0.03279938977879481
chr8	LINC02153	20974523	20974712	0	190	86	2753	86	2563	0.0	0.03355442840421381
chr8	LINC02153	20974654	20974712	0	59	86	2753	86	2694	0.0	0.03192279138827023
chr8	AC103719.1	21027289	21027297	0	9	51	1919	51	1910	0.0	0.026701570680628273
chr8	XPO7	21971942	21971968	0	27	74506	6949	74506	6922	0.0	10.76365212366368
chr8	NPM2	22024831	22025306	0	476	14242	1896	14242	1420	0.0	10.029577464788732
chr8	NPM2	22024258	22024623	180	366	14242	1896	14062	1530	0.4918032786885246	9.190849673202614
chr8	SFTPC	22158826	22159081	0	256	18	2654	18	2398	0.0	0.007506255212677231
chr8	SFTPC	22164052	22164059	0	8	18	2654	18	2646	0.0	0.006802721088435374
chr8	POLR3D	22245184	22245220	21	37	11649	5592	11628	5555	0.5675675675675675	2.093249324932493
chr8	SLC39A14	22367370	22367408	0	39	15725	6745	15725	6706	0.0	2.3449150014912017
chr8	PDLIM2	22579210	22579527	0	318	102	7319	102	7001	0.0	0.014569347236109127
chr8	PDLIM2	22579225	22579527	0	303	102	7319	102	7016	0.0	0.014538198403648802
chr8	PDLIM2	22579210	22579224	0	15	102	7319	102	7304	0.0	0.013964950711938665
chr8	PDLIM2	22580267	22580411	0	145	102	7319	102	7174	0.0	0.014218009478672985
chr8	AC037441.1	22878152	22878166	3417	15	408987	4016	405570	4001	227.8	101.36715821044739
chr8	CHMP7	23246825	23246994	2047	170	236340	3469	234293	3299	12.041176470588235	71.0193998181267
chr8	SLC25A37	23566337	23566813	0	477	51	7785	51	7308	0.0	0.0069786535303776685
chr8	ADAM28	24343585	24343588	0	4	0	9346	0	9342	0.0	0.0
chr8	DOCK5	25368688	25368725	364	38	193218	16044	192854	16006	9.578947368421053	12.048856678745471
chr8	AC009623.1	25670685	25671686	0	1002	0	3660	0	2658	0.0	0.0
chr8	AC009623.1	25688095	25688109	0	15	0	3660	0	3645	0.0	0.0
chr8	PPP2R2A	26293741	26293860	0	120	119842	7726	119842	7606	0.0	15.75624506968183
chr8	BNIP3L	26383479	26383496	0	18	12404	4159	12404	4141	0.0	2.9954117362955808
chr8	PTK2B	27433514	27433552	0	39	7384	7538	7384	7499	0.0	0.9846646219495933
chr8	ELP3	28093234	28093360	0	127	51	5184	51	5057	0.0	0.01008503065058335
chr8	AC025871.1	28449032	28449106	0	75	41	736	41	661	0.0	0.06202723146747353
chr8	EXTL3	28716898	28718207	14219	1310	50627	7671	36408	6361	10.854198473282443	5.7236283603207045
chr8	LINC02099	29791383	29791881	0	499	0	5547	0	5048	0.0	0.0
chr8	RBPMS	30545221	30545465	0	245	105963	8416	105963	8171	0.0	12.96818014930853
chr8	UBXN8	30754750	30754787	0	38	0	4037	0	3999	0.0	0.0
chr8	UBXN8	30744278	30744460	0	183	0	4037	0	3854	0.0	0.0
chr8	NRG1	32648315	32648384	0	70	27390	19683	27390	19613	0.0	1.3965227145260797
chr8	AC090204.1	33041744	33041771	0	28	0	1787	0	1759	0.0	0.0
chr8	AC090204.1	32996317	32996355	0	39	0	1787	0	1748	0.0	0.0
chr8	AC090204.1	32928315	32928349	0	35	0	1787	0	1752	0.0	0.0
chr8	UNC5D	35722357	35722395	0	39	51	10818	51	10779	0.0	0.004731422209852491
chr8	AC124067.3	37560602	37560626	0	25	72	3546	72	3521	0.0	0.020448736154501563
chr8	AC138356.3	37717778	37717996	5274	219	11018	1216	5744	997	24.08219178082192	5.761283851554664
chr8	ERLIN2	37737008	37737262	0	255	6958	8103	6958	7848	0.0	0.8865953109072375
chr8	ERLIN2	37737115	37737262	0	148	6958	8103	6958	7955	0.0	0.8746700188560653
chr8	PLPBP	37762701	37762758	0	58	153	2899	153	2841	0.0	0.05385427666314678
chr8	DDHD2	38234511	38234584	0	74	284229	7507	284229	7433	0.0	38.23879994618593
chr8	DDHD2	38231747	38231859	0	113	284229	7507	284229	7394	0.0	38.440492291046795
chr8	LETM2	38386381	38386568	0	188	0	5024	0	4836	0.0	0.0
chr8	LETM2	38386569	38387182	0	614	0	5024	0	4410	0.0	0.0
chr8	LETM2	38387183	38387234	0	52	0	5024	0	4972	0.0	0.0
chr8	TACC1	38827289	38827375	2849	87	1380521	12557	1377672	12470	32.747126436781606	110.47890938251804
chr8	TACC1	38788247	38788291	0	45	1380521	12557	1380521	12512	0.0	110.33575767263427
chr8	PLEKHA2	38901893	38902069	216	177	9292	5592	9076	5415	1.2203389830508475	1.676084949215143
chr8	ADAM9	39018882	39018918	0	37	19580	17281	19580	17244	0.0	1.135467408953839
chr8	ADAM9	39071404	39071413	9	10	19580	17281	19571	17271	0.9	1.133171211858028
chr8	IDO1	39923587	39923590	0	4	0	3502	0	3498	0.0	0.0
chr8	GOLGA7	41490567	41490617	0	51	11124	2480	11124	2429	0.0	4.579662412515439
chr8	GINS4	41529389	41529396	0	8	32079	5344	32079	5336	0.0	6.011806596701649
chr8	IKBKB	42293513	42293568	0	56	43858	8552	43858	8496	0.0	5.162193973634651
chr8	IKBKB	42271470	42272205	0	736	43858	8552	43858	7816	0.0	5.611310133060389
chr8	SMIM19	42541706	42542373	0	668	103	3977	103	3309	0.0	0.031127228770021154
chr8	SMIM19	42542156	42542373	0	218	103	3977	103	3759	0.0	0.027400904495876562
chr8	FNTA	43077365	43080441	0	3077	139504	8702	139504	5625	0.0	24.80071111111111
chr8	FNTA	43056508	43056546	12059	39	139504	8702	127445	8663	309.20512820512823	14.711416368463581
chr8	POMK	43103789	43103830	0	42	31920	8233	31920	8191	0.0	3.896960078134538
chr8	POMK	43102555	43102600	0	46	31920	8233	31920	8187	0.0	3.898864052766581
chr8	LINC00293	46836799	46836819	0	21	0	8452	0	8431	0.0	0.0
chr8	LINC00293	46848902	46848968	0	67	0	8452	0	8385	0.0	0.0
chr8	LINC00293	46850527	46850560	0	34	0	8452	0	8418	0.0	0.0
chr8	LINC00293	46848902	46849530	0	629	0	8452	0	7823	0.0	0.0
chr8	LINC00293	46848969	46849530	0	562	0	8452	0	7890	0.0	0.0
chr8	LINC00293	46840936	46840940	0	5	0	8452	0	8447	0.0	0.0
chr8	LINC00293	46848902	46849035	0	134	0	8452	0	8318	0.0	0.0
chr8	LINC00293	46848969	46849035	0	67	0	8452	0	8385	0.0	0.0
chr8	LINC00293	46849531	46850560	0	1030	0	8452	0	7422	0.0	0.0
chr8	LINC00293	46849531	46850526	0	996	0	8452	0	7456	0.0	0.0
chr8	LINC00293	46853105	46853161	0	57	0	8452	0	8395	0.0	0.0
chr8	SPIDR	47279981	47280017	0	37	117	7208	117	7171	0.0	0.01631571607865012
chr8	MCM4	47966276	47966407	0	132	0	6523	0	6391	0.0	0.0
chr8	MCM4	47961015	47961214	0	200	0	6523	0	6323	0.0	0.0
chr8	MCM4	47961215	47961426	0	212	0	6523	0	6311	0.0	0.0
chr8	UBE2V2	48008471	48008571	0	101	21	6598	21	6497	0.0	0.0032322610435585653
chr8	AC044893.1	49193196	49193257	0	62	51	2165	51	2103	0.0	0.024251069900142655
chr8	SNTG1	50402325	50402344	0	20	17	9266	17	9246	0.0	0.0018386329223447977
chr8	SNTG1	49911045	49912231	51	1187	17	9266	-34	8079	0.04296545914069082	-0.004208441638816686
chr8	AC064807.1	51899847	51900207	51	361	102	4817	51	4456	0.14127423822714683	0.01144524236983842
chr8	AC009646.2	53178004	53178050	0	47	0	845	0	798	0.0	0.0
chr8	LYN	55941929	55941991	0	63	0	6179	0	6116	0.0	0.0
chr8	CHCHD7	56216507	56216531	0	25	187	3872	187	3847	0.0	0.04860930595269041
chr8	CHCHD7	56212890	56212909	0	20	187	3872	187	3852	0.0	0.048546209761163035
chr8	CHCHD7	56211838	56212174	0	337	187	3872	187	3535	0.0	0.0528995756718529
chr8	LINC01606	57219524	57219623	0	100	2	8839	2	8739	0.0	0.00022885913720105275
chr8	LINC01606	57226608	57226625	2	18	2	8839	0	8821	0.1111111111111111	0.0
chr8	LINC01606	57193690	57193716	0	27	2	8839	2	8812	0.0	0.00022696323195642307
chr8	AC068075.1	57347395	57347408	0	14	0	3224	0	3210	0.0	0.0
chr8	SDCBP	58565067	58565084	0	18	51	4744	51	4726	0.0	0.01079136690647482
chr8	AC087664.2	59619739	59619829	0	91	0	1743	0	1652	0.0	0.0
chr8	CHD7	60781051	60781430	0	380	305	15978	305	15598	0.0	0.019553788947300935
chr8	CLVS1	61300279	61300282	0	4	4641	7405	4641	7401	0.0	0.627077421970004
chr8	CLVS1	61288139	61288234	0	96	4641	7405	4641	7309	0.0	0.6349705842112464
chr8	YTHDF3	63169009	63169111	0	103	321	6172	321	6069	0.0	0.052891744933267426
chr8	YTHDF3	63169106	63169111	0	6	321	6172	321	6166	0.0	0.0520596821277976
chr8	MIR124-2HG	64378234	64378489	0	256	0	3786	0	3530	0.0	0.0
chr8	MIR124-2HG	64378383	64378489	0	107	0	3786	0	3679	0.0	0.0
chr8	MIR124-2HG	64378234	64378382	0	149	0	3786	0	3637	0.0	0.0
chr8	MIR124-2HG	64377482	64377528	0	47	0	3786	0	3739	0.0	0.0
chr8	AC084082.1	66112900	66113096	0	197	0	2787	0	2590	0.0	0.0
chr8	AC084082.1	66112900	66113107	0	208	0	2787	0	2579	0.0	0.0
chr8	AC084082.1	66113097	66113107	0	11	0	2787	0	2776	0.0	0.0
chr8	CSPP1	67064497	67064538	0	42	204	22998	204	22956	0.0	0.008886565603763722
chr8	CSPP1	67064527	67064538	0	12	204	22998	204	22986	0.0	0.008874967371443488
chr8	CSPP1	67112066	67112075	0	10	204	22998	204	22988	0.0	0.00887419523229511
chr8	CSPP1	67064497	67064526	0	30	204	22998	204	22968	0.0	0.008881922675026124
chr8	CSPP1	67113863	67115264	0	1402	204	22998	204	21596	0.0	0.009446193739581403
chr8	CSPP1	67114371	67115264	0	894	204	22998	204	22104	0.0	0.009229098805646038
chr8	CSPP1	67118370	67118385	0	16	204	22998	204	22982	0.0	0.008876512052910974
chr8	AC079089.1	69834194	69834206	0	13	0	1954	0	1941	0.0	0.0
chr8	XKR9	70669475	70669538	0	64	463	3941	463	3877	0.0	0.11942223368583957
chr8	AC111149.2	73358828	73359227	0	400	0	2366	0	1966	0.0	0.0
chr8	AC111149.2	73359046	73359227	0	182	0	2366	0	2184	0.0	0.0
chr8	TMEM70	73972622	73972993	2622	372	79567	2988	76945	2616	7.048387096774194	29.41322629969419
chr8	TMEM70	73978862	73978875	2325	14	79567	2988	77242	2974	166.07142857142858	25.9724277067922
chr8	GDAP1	74320919	74320961	0	43	31532	20769	31532	20726	0.0	1.5213741194634758
chr8	GDAP1	74360150	74360310	50	161	31532	20769	31482	20608	0.3105590062111801	1.5276591614906831
chr8	GDAP1	74351322	74351466	0	145	31532	20769	31532	20624	0.0	1.528898370830101
chr8	GDAP1	74351419	74351466	0	48	31532	20769	31532	20721	0.0	1.5217412287051784
chr8	GDAP1	74350531	74350578	0	48	31532	20769	31532	20721	0.0	1.5217412287051784
chr8	GDAP1	74351322	74351418	0	97	31532	20769	31532	20672	0.0	1.5253482972136223
chr8	CRISPLD1	74986118	74986245	0	128	0	4446	0	4318	0.0	0.0
chr8	LINC02235	81842672	81842890	0	219	6561	4148	6561	3929	0.0	1.6698905573937388
chr8	RALYL	84183579	84184424	0	846	153	4551	153	3705	0.0	0.04129554655870445
chr8	RALYL	84185015	84185233	51	219	153	4551	102	4332	0.2328767123287671	0.023545706371191136
chr8	LRRCC1	85107400	85107718	0	319	0	5020	0	4701	0.0	0.0
chr8	E2F5	85206221	85206224	0	4	0	2856	0	2852	0.0	0.0
chr8	CPNE3	86514542	86514573	0	32	50	6676	50	6644	0.0	0.007525586995785672
chr8	CPNE3	86514574	86514722	0	149	50	6676	50	6527	0.0	0.007660487206986364
chr8	AC090578.1	88328997	88329052	0	56	561	9713	561	9657	0.0	0.05809257533395464
chr8	AC090578.1	88542760	88542830	0	71	561	9713	561	9642	0.0	0.058182949595519604
chr8	AC090578.1	88542811	88542830	0	20	561	9713	561	9693	0.0	0.05787681832250077
chr8	OSGIN2	89901912	89902125	0	214	0	4662	0	4448	0.0	0.0
chr8	DECR1	90005732	90005845	0	114	0	4418	0	4304	0.0	0.0
chr8	AC106038.1	90646634	90646883	0	250	51	1936	51	1686	0.0	0.030249110320284697
chr8	CIBAR1	93700674	93700723	0	50	0	6800	0	6750	0.0	0.0
chr8	CIBAR1	93700674	93701057	0	384	0	6800	0	6416	0.0	0.0
chr8	CIBAR1	93700724	93701057	0	334	0	6800	0	6466	0.0	0.0
chr8	TMEM67	93755867	93755908	0	42	0	7387	0	7345	0.0	0.0
chr8	PDP1	93916937	93917079	0	143	757	5612	757	5469	0.0	0.13841652953007863
chr8	PDP1	93917080	93917218	0	139	757	5612	757	5473	0.0	0.1383153663438699
chr8	AC023632.2	94568536	94568621	0	86	0	2479	0	2393	0.0	0.0
chr8	ESRP1	94674495	94674506	0	12	672	4621	672	4609	0.0	0.14580169234107182
chr8	INTS8	94823302	94823561	2931	260	7002	7694	4071	7434	11.273076923076923	0.5476190476190477
chr8	INTS8	94865691	94865700	0	10	7002	7694	7002	7684	0.0	0.9112441436751691
chr8	INTS8	94866352	94866353	0	2	7002	7694	7002	7692	0.0	0.9102964118564743
chr8	NDUFAF6	95032095	95032098	0	4	2914	6433	2914	6429	0.0	0.4532586716441126
chr8	C8ORF37-AS1	95800555	95800655	100	101	94278	4839	94178	4738	0.9900990099009901	19.877163360067538
chr8	SDC2	96494044	96494331	0	288	102	4095	102	3807	0.0	0.026792750197005517
chr8	POP1	98117331	98117390	0	60	1029	4870	1029	4810	0.0	0.21392931392931394
chr8	OSR2	98948309	98948421	0	113	105	2479	105	2366	0.0	0.04437869822485207
chr8	OSR2	98948422	98948686	0	265	105	2479	105	2214	0.0	0.04742547425474255
chr8	AP001205.1	100618646	100618764	0	119	0	451	0	332	0.0	0.0
chr8	FLJ42969	101052422	101052836	0	415	0	3136	0	2721	0.0	0.0
chr8	GRHL2	101492790	101492849	0	60	1020	6069	1020	6009	0.0	0.16974538192710933
chr8	GASAL1	102807714	102808553	0	840	0	2294	0	1454	0.0	0.0
chr8	GASAL1	102808554	102808799	0	246	0	2294	0	2048	0.0	0.0
chr8	ATP6V1C1	103021183	103021225	0	43	0	5864	0	5821	0.0	0.0
chr8	OXR1	106658086	106658185	0	100	0	6705	0	6605	0.0	0.0
chr8	OXR1	106726258	106726309	0	52	0	6705	0	6653	0.0	0.0
chr8	ENY2	109334403	109334474	0	72	0	6789	0	6717	0.0	0.0
chr8	ENY2	109334407	109334474	0	68	0	6789	0	6721	0.0	0.0
chr8	ENY2	109334403	109334406	0	4	0	6789	0	6785	0.0	0.0
chr8	AC064802.1	114284515	114284533	0	19	75	1196	75	1177	0.0	0.0637213254035684
chr8	AC023590.1	118282161	118282330	0	170	0	2885	0	2715	0.0	0.0
chr8	HAS2-AS1	121641364	121641446	0	83	0	5667	0	5584	0.0	0.0
chr8	HAS2-AS1	121641447	121641454	0	8	0	5667	0	5659	0.0	0.0
chr8	HAS2-AS1	121641364	121641454	0	91	0	5667	0	5576	0.0	0.0
chr8	HAS2-AS1	121639386	121640168	0	783	0	5667	0	4884	0.0	0.0
chr8	NTAQ1	123441350	123441497	0	148	0	4939	0	4791	0.0	0.0
chr8	NTAQ1	123416857	123416932	0	76	0	4939	0	4863	0.0	0.0
chr8	FAM91A1	123780076	123780082	0	7	630	7289	630	7282	0.0	0.08651469376544905
chr8	AC090192.2	124276237	124276394	0	158	4121	2469	4121	2311	0.0	1.783210731285158
chr8	NDUFB9	124549834	124550501	75	668	450568	14277	450493	13609	0.1122754491017964	33.10257917554559
chr8	LINC00964	124847783	124848172	0	390	1897	10517	1897	10127	0.0	0.18732102300780093
chr8	LINC00964	124940547	124940634	0	88	1897	10517	1897	10429	0.0	0.1818966343848883
chr8	LINC00964	124944798	124945051	0	254	1897	10517	1897	10263	0.0	0.18483874110883758
chr8	LINC00964	124942725	124943269	0	545	1897	10517	1897	9972	0.0	0.19023265142398715
chr8	LINC00964	124942891	124943269	0	379	1897	10517	1897	10138	0.0	0.18711777470901558
chr8	LINC00964	124942725	124942890	0	166	1897	10517	1897	10351	0.0	0.18326731716742345
chr8	LINC00964	124943384	124943501	0	118	1897	10517	1897	10399	0.0	0.18242138667179536
chr8	LINC00964	124943502	124945051	0	1550	1897	10517	1897	8967	0.0	0.21155347384855583
chr8	LINC00964	124943384	124945051	0	1668	1897	10517	1897	8849	0.0	0.2143745055938524
chr8	LINC00964	124942725	124943383	0	659	1897	10517	1897	9858	0.0	0.1924325420977886
chr8	LINC00964	124943270	124943383	0	114	1897	10517	1897	10403	0.0	0.18235124483322118
chr8	LINC00964	124942891	124943383	0	493	1897	10517	1897	10024	0.0	0.1892458100558659
chr8	LINC00964	124944798	124945746	0	949	1897	10517	1897	9568	0.0	0.1982650501672241
chr8	LINC00964	124945052	124945746	0	695	1897	10517	1897	9822	0.0	0.19313785379759724
chr8	LINC00964	124945052	124945281	0	230	1897	10517	1897	10287	0.0	0.18440750461747837
chr8	LINC00964	124944798	124945281	0	484	1897	10517	1897	10033	0.0	0.18907604903817402
chr8	LINC00964	124943270	124943501	0	232	1897	10517	1897	10285	0.0	0.1844433641225085
chr8	SQLE	124998606	124999694	0	1089	0	4200	0	3111	0.0	0.0
chr8	NSMCE2	125091901	125091958	0	58	79	3005	79	2947	0.0	0.02680692229385816
chr8	TRIB1	125433610	125433768	0	159	0	4104	0	3945	0.0	0.0
chr8	AC087667.1	126325522	126325557	374	36	425	899	51	863	10.38888888888889	0.05909617612977984
chr8	PCAT1	126713675	126713806	0	132	0	16754	0	16622	0.0	0.0
chr8	PVT1	127796009	127796071	0	63	55393	23370	55393	23307	0.0	2.3766679538336124
chr8	PVT1	128070273	128070361	0	89	55393	23370	55393	23281	0.0	2.3793221940638287
chr8	PVT1	127795163	127795294	0	132	55393	23370	55393	23238	0.0	2.383724933298907
chr8	PVT1	127854796	127855319	0	524	55393	23370	55393	22846	0.0	2.4246257550555894
chr8	PVT1	128049442	128049748	0	307	55393	23370	55393	23063	0.0	2.4018124268308547
chr8	AC104257.1	131312730	131312748	0	19	150	989	150	970	0.0	0.15463917525773196
chr8	EFR3A	131940576	131940644	0	69	0	6184	0	6115	0.0	0.0
chr8	EFR3A	131939945	131940219	0	275	0	6184	0	5909	0.0	0.0
chr8	TG	132868224	132868254	0	31	7853	11185	7853	11154	0.0	0.7040523578985117
chr8	TG	133017867	133017997	115	131	7853	11185	7738	11054	0.8778625954198473	0.7000180929980098
chr8	LINC01591	135234515	135234589	0	75	0	1348	0	1273	0.0	0.0
chr8	AC138647.1	141514764	141514775	0	12	6601	662	6601	650	0.0	10.155384615384616
chr8	ZFP41	143247143	143247749	0	607	0	6806	0	6199	0.0	0.0
chr8	ZNF696	143291611	143291767	0	157	0	5403	0	5246	0.0	0.0
chr8	ZNF707	143691200	143691232	0	33	204	6052	204	6019	0.0	0.03389267320152849
chr8	ZNF707	143684756	143685067	0	312	204	6052	204	5740	0.0	0.03554006968641115
chr8	GRINA	143991950	143992078	0	129	0	2462	0	2333	0.0	0.0
chr8	GRINA	143990200	143990311	0	112	0	2462	0	2350	0.0	0.0
chr8	EXOSC4	144080022	144080149	0	128	424	869	424	741	0.0	0.5721997300944669
chr8	GPAA1	144083425	144083500	0	76	155	2761	155	2685	0.0	0.05772811918063315
chr8	MAF1	144105150	144105460	71	311	1376	2299	1305	1988	0.2282958199356913	0.6564386317907445
chr8	SLC52A2	144359321	144359423	0	103	61401	3711	61401	3608	0.0	17.018015521064303
chr8	SLC52A2	144358611	144358900	33014	290	61401	3711	28387	3421	113.84137931034483	8.297866121017247
chr8	SLC52A2	144358784	144358900	14695	117	61401	3711	46706	3594	125.5982905982906	12.995548135781858
chr8	SLC52A2	144358659	144358900	26089	242	61401	3711	35312	3469	107.80578512396694	10.179302392620352
chr8	SLC52A2	144358611	144358783	18319	173	61401	3711	43082	3538	105.89017341040463	12.176936122102884
chr8	SLC52A2	144358659	144358783	11394	125	61401	3711	50007	3586	91.152	13.945064138315672
chr8	SLC52A2	144358659	144359065	30052	407	61401	3711	31349	3304	73.83783783783784	9.48819612590799
chr8	SLC52A2	144358901	144359065	3963	165	61401	3711	57438	3546	24.01818181818182	16.19796954314721
chr8	SLC52A2	144358611	144359065	36977	455	61401	3711	24424	3256	81.26813186813187	7.501228501228502
chr8	SLC52A2	144358784	144359065	18658	282	61401	3711	42743	3429	66.16312056737588	12.465150189559639
chr8	SLC52A2	144359727	144359747	0	21	61401	3711	61401	3690	0.0	16.639837398373984
chr8	SLC52A2	144359424	144359521	0	98	61401	3711	61401	3613	0.0	16.994464433988377
chr8	SLC52A2	144359321	144359521	0	201	61401	3711	61401	3510	0.0	17.493162393162393
chr9	DOCK8	368136	368300	0	165	102	12921	102	12756	0.0	0.00799623706491063
chr9	DMRT2	1050483	1050775	0	293	0	3147	0	2854	0.0	0.0
chr9	SMARCA2	2086898	2087071	20384	174	516675	15566	496291	15392	117.14942528735632	32.24343814968815
chr9	SMARCA2	2016144	2016213	0	70	516675	15566	516675	15496	0.0	33.34247547754259
chr9	SMARCA2	2017498	2017502	21	5	516675	15566	516654	15561	4.2	33.201850780798146
chr9	SMARCA2	2017498	2017799	569	302	516675	15566	516106	15264	1.8841059602649006	33.81197589098532
chr9	SMARCA2	2017503	2017799	548	297	516675	15566	516127	15269	1.8451178451178452	33.80227912764425
chr9	SMARCA2	2159905	2159909	45	5	516675	15566	516630	15561	9.0	33.20030846346636
chr9	SMARCA2	2158554	2158594	424	41	516675	15566	516251	15525	10.341463414634147	33.25288244766506
chr9	SMARCA2	2158588	2158594	0	7	516675	15566	516675	15559	0.0	33.207468346294746
chr9	SMARCA2	2158497	2158594	1023	98	516675	15566	515652	15468	10.438775510204081	33.336695112490304
chr9	SMARCA2	2158497	2158553	599	57	516675	15566	516076	15509	10.508771929824562	33.275904313624345
chr9	SMARCA2	2158554	2158587	424	34	516675	15566	516251	15532	12.470588235294118	33.237895956734484
chr9	SMARCA2	2158497	2158587	1023	91	516675	15566	515652	15475	11.241758241758241	33.3216155088853
chr9	SMARCA2	2158595	2158978	457	384	516675	15566	516218	15182	1.1901041666666667	34.001976024239234
chr9	SMARCA2	2158554	2158978	881	425	516675	15566	515794	15141	2.072941176470588	34.06604583581005
chr9	SMARCA2	2158588	2158978	457	391	516675	15566	516218	15175	1.1687979539641944	34.01766062602965
chr9	SMARCA2	2158497	2158978	1480	482	516675	15566	515195	15084	3.070539419087137	34.15506496950411
chr9	SMARCA2	2160620	2161035	45	416	516675	15566	516630	15150	0.10817307692307693	34.1009900990099
chr9	LINC01231	3181890	3182447	0	558	0	5272	0	4714	0.0	0.0
chr9	CD274	5465540	5465606	236	67	49657	4115	49421	4048	3.5223880597014925	12.208745059288537
chr9	MLANA	5890937	5891302	0	366	962	2885	962	2519	0.0	0.38189757840412863
chr9	MLANA	5891200	5891302	0	103	962	2885	962	2782	0.0	0.34579439252336447
chr9	UHRF2	6497269	6497360	14853	92	591186	9898	576333	9806	161.44565217391303	58.773506016724454
chr9	LINC02851	6704344	6704366	0	23	204	540	204	517	0.0	0.3945841392649903
chr9	CCDC171	16042887	16042920	0	34	17471	12235	17471	12201	0.0	1.4319318088681257
chr9	CNTLN	17457629	17457715	540	87	169046	11092	168506	11005	6.206896551724138	15.311767378464335
chr9	FOCAD	20821062	20821071	486	10	195785	9254	195299	9244	48.6	21.127109476417136
chr9	MTAP	21802782	21802950	477	169	942425	13923	941948	13754	2.8224852071005917	68.48538606950706
chr9	MTAP	21815520	21815544	0	25	942425	13923	942425	13898	0.0	67.81011656353432
chr9	TEK	27205063	27205065	0	3	4396	4828	4396	4825	0.0	0.9110880829015544
chr9	ACO1	32386439	32386442	23	4	748796	7577	748773	7573	5.75	98.87402614551696
chr9	AL356218.2	33401720	33401822	0	103	918	1471	918	1368	0.0	0.6710526315789473
chr9	CYP4F26P	33603551	33604403	0	853	612	3903	612	3050	0.0	0.20065573770491804
chr9	CYP4F26P	33604404	33604570	0	167	612	3903	612	3736	0.0	0.16381156316916487
chr9	CNTFR-AS1	34569617	34569746	0	130	0	2607	0	2477	0.0	0.0
chr9	IL11RA	34654000	34654019	0	20	212587	4224	212587	4204	0.0	50.56779257849667
chr9	DNAJB5	34990612	34990812	244	201	144946	3656	144702	3455	1.2139303482587065	41.88191027496382
chr9	C9ORF131	35041157	35041440	2397	284	10341	3828	7944	3544	8.440140845070422	2.2415349887133185
chr9	C9ORF131	35042381	35042485	723	105	10341	3828	9618	3723	6.885714285714286	2.5834004834810638
chr9	C9ORF131	35042486	35042565	1718	80	10341	3828	8623	3748	21.475	2.3006937033084314
chr9	ATP8B5P	35433766	35433799	0	34	33642	6309	33642	6275	0.0	5.361274900398406
chr9	ATP8B5P	35409004	35409007	0	4	33642	6309	33642	6305	0.0	5.335765265662173
chr9	ATP8B5P	35471105	35471228	0	124	33642	6309	33642	6185	0.0	5.439288601455133
chr9	AL133410.1	35786776	35788036	102	1261	12200	3404	12098	2143	0.08088818398096749	5.645356976201587
chr9	TMEM8B	35829320	35829391	92	72	70552	16232	70460	16160	1.2777777777777777	4.360148514851486
chr9	AL450267.2	36781894	36781897	0	4	0	5670	0	5666	0.0	0.0
chr9	EBLN3P	37080035	37080536	29267	502	617447	7939	588180	7437	58.300796812749006	79.0883420734167
chr9	EBLN3P	37080031	37080536	29380	506	617447	7939	588067	7433	58.06324110671937	79.11570025561684
chr9	EBLN3P	37080039	37080536	29239	498	617447	7939	588208	7441	58.71285140562249	79.04959010885634
chr9	EBLN3P	37080031	37080034	113	4	617447	7939	617334	7935	28.25	77.79886578449906
chr9	EBLN3P	37080035	37080038	28	4	617447	7939	617419	7935	7.0	77.80957781978576
chr9	EBLN3P	37080031	37080038	141	8	617447	7939	617306	7931	17.625	77.8345731937965
chr9	EBLN3P	37080537	37084292	22795	3756	617447	7939	594652	4183	6.068956336528221	142.1592158737748
chr9	EBLN3P	37080035	37084292	52062	4258	617447	7939	565385	3681	12.226867073743541	153.59549035588157
chr9	EBLN3P	37080031	37084292	52175	4262	617447	7939	565272	3677	12.24190520882215	153.73184661408757
chr9	EBLN3P	37080039	37084292	52034	4254	617447	7939	565413	3685	12.231781852374237	153.43636363636364
chr9	EBLN3P	37081866	37084292	12829	2427	617447	7939	604618	5512	5.285949732179645	109.69121915820028
chr9	ZCCHC7	37120624	37120894	937	271	163983	3974	163046	3703	3.4575645756457565	44.03078584931137
chr9	GRHPR	37422806	37422833	17602	28	2123936	5783	2106334	5755	628.6428571428571	366.0006950477845
chr9	TRMT10B	37763754	37763865	3036	112	224466	2875	221430	2763	27.107142857142858	80.14115092290989
chr9	BX664727.3	40284478	40284613	0	136	35	5288	35	5152	0.0	0.006793478260869565
chr9	FAM95B1	40324086	40324182	0	97	949	2302	949	2205	0.0	0.43038548752834466
chr9	FRG1HP	40992480	40992775	0	296	0	1712	0	1416	0.0	0.0
chr9	BX255923.1	41073854	41073973	0	120	0	658	0	538	0.0	0.0
chr9	ANKRD20A7P	42834196	42834260	0	65	68	7916	68	7851	0.0	0.008661317029677748
chr9	ANKRD20A7P	42917413	42917416	0	4	68	7916	68	7912	0.0	0.008594539939332659
chr9	FAM27C	62073111	62073117	0	7	0	12969	0	12962	0.0	0.0
chr9	FAM27C	62075752	62075755	0	4	0	12969	0	12965	0.0	0.0
chr9	FAM27C	61972564	61972670	0	107	0	12969	0	12862	0.0	0.0
chr9	BX005266.2	62532933	62533113	0	181	0	1733	0	1552	0.0	0.0
chr9	CBWD5	65695045	65695049	0	5	435	10606	435	10601	0.0	0.04103386472974248
chr9	CBWD5	65704415	65704547	0	133	435	10606	435	10473	0.0	0.04153537668289888
chr9	ZNF658	66900837	66901079	0	243	0	4852	0	4609	0.0	0.0
chr9	CBWD3	68260997	68261001	0	5	15465	10070	15465	10065	0.0	1.5365126676602086
chr9	TJP2	69205110	69205233	0	124	21732	10925	21732	10801	0.0	2.0120359225997593
chr9	TJP2	69205234	69205314	0	81	21732	10925	21732	10844	0.0	2.0040575433419403
chr9	TJP2	69205234	69206261	7650	1028	21732	10925	14082	9897	7.441634241245136	1.4228554107305245
chr9	TJP2	69205315	69206261	7650	947	21732	10925	14082	9978	8.078141499472016	1.4113048707155742
chr9	GDA	72248339	72248406	0	68	51	5582	51	5514	0.0	0.009249183895538629
chr9	ANXA1	73154341	73154342	0	2	0	4467	0	4465	0.0	0.0
chr9	VPS13A	77407608	77407659	0	52	0	20179	0	20127	0.0	0.0
chr9	CEP78	78236604	78236659	0	56	0	12902	0	12846	0.0	0.0
chr9	TLE4	79652795	79652798	0	4	102	8082	102	8078	0.0	0.012626887843525626
chr9	AL354733.2	83859326	83859335	0	10	47	3124	47	3114	0.0	0.015093127809890815
chr9	AL354733.1	83837144	83837299	51	156	227	2486	176	2330	0.3269230769230769	0.07553648068669527
chr9	RMI1	83980892	83981004	0	113	0	3416	0	3303	0.0	0.0
chr9	DAPK1	87497773	87498107	0	335	0	8937	0	8602	0.0	0.0
chr9	CTSL	87726254	87726308	0	55	0	5954	0	5899	0.0	0.0
chr9	CTSL	87725838	87726308	0	471	0	5954	0	5483	0.0	0.0
chr9	CTSL	87726250	87726308	0	59	0	5954	0	5895	0.0	0.0
chr9	CTSL	87725838	87726253	0	416	0	5954	0	5538	0.0	0.0
chr9	CTSL	87726250	87726253	0	4	0	5954	0	5950	0.0	0.0
chr9	CTSL	87725838	87726249	0	412	0	5954	0	5542	0.0	0.0
chr9	CTSL	87726254	87727729	0	1476	0	5954	0	4478	0.0	0.0
chr9	CTSL	87726254	87726398	0	145	0	5954	0	5809	0.0	0.0
chr9	CTSL	87726309	87726398	0	90	0	5954	0	5864	0.0	0.0
chr9	CTSL	87727396	87727468	0	73	0	5954	0	5881	0.0	0.0
chr9	CTSL	87726250	87726398	0	149	0	5954	0	5805	0.0	0.0
chr9	CTSL	87729736	87730498	0	763	0	5954	0	5191	0.0	0.0
chr9	CTSL	87726309	87727395	0	1087	0	5954	0	4867	0.0	0.0
chr9	CTSL	87726254	87727395	0	1142	0	5954	0	4812	0.0	0.0
chr9	CTSL	87726399	87727395	0	997	0	5954	0	4957	0.0	0.0
chr9	CTSL	87728810	87729085	0	276	0	5954	0	5678	0.0	0.0
chr9	CTSL3P	87772999	87773004	0	6	0	962	0	956	0.0	0.0
chr9	AL772337.3	87864229	87864349	0	121	0	689	0	568	0.0	0.0
chr9	S1PR3	88991185	88991241	0	57	51	13705	51	13648	0.0	0.0037368112543962485
chr9	AL355607.2	90997121	90997124	0	4	2680	1533	2680	1529	0.0	1.7527795945062132
chr9	PTPDC1	94084769	94084774	0	6	1698	6381	1698	6375	0.0	0.26635294117647057
chr9	PCAT7	94555311	94555345	0	35	0	5914	0	5879	0.0	0.0
chr9	AL449403.1	96093096	96093162	0	67	0	2230	0	2163	0.0	0.0
chr9	AL589843.1	96687146	96687324	0	179	0	2839	0	2660	0.0	0.0
chr9	STRA6LP	97313337	97313345	0	9	430	7167	430	7158	0.0	0.06007264599050014
chr9	STRA6LP	97323904	97323938	0	35	430	7167	430	7132	0.0	0.060291643297812676
chr9	STRA6LP	97307372	97307551	0	180	430	7167	430	6987	0.0	0.06154286532131101
chr9	STX17	99907298	99907393	0	96	2999	8893	2999	8797	0.0	0.3409116744344663
chr9	STX17	99907099	99907393	64	295	2999	8893	2935	8598	0.21694915254237288	0.3413584554547569
chr9	STX17	99907099	99907297	64	199	2999	8893	2935	8694	0.32160804020100503	0.33758914193696804
chr9	RNF20	101533915	101533968	0	54	68550	4712	68550	4658	0.0	14.716616573636754
chr9	FKTN	105574279	105574332	0	54	204	17148	204	17094	0.0	0.011934011934011933
chr9	FKTN	105620062	105620092	0	31	204	17148	204	17117	0.0	0.011917976280890342
chr9	LINC01505	106588941	106589013	0	73	0	12891	0	12818	0.0	0.0
chr9	LINC01505	106500506	106500637	0	132	0	12891	0	12759	0.0	0.0
chr9	ZNF462	106924193	106929759	102	5567	51	9293	-51	3726	0.01832225615232621	-0.013687600644122383
chr9	ZNF462	106927165	106929759	51	2595	51	9293	0	6698	0.019653179190751446	0.0
chr9	C9ORF43	113411002	113411138	0	137	0	2250	0	2113	0.0	0.0
chr9	COL27A1	114231859	114231866	0	8	26787	14073	26787	14065	0.0	1.904514752932812
chr9	COL27A1	114252647	114252653	0	7	26787	14073	26787	14066	0.0	1.904379354471776
chr9	ATP6V1G1	114592653	114592657	0	5	897	3459	897	3454	0.0	0.25969889982628835
chr9	ATP6V1G1	114587921	114588118	1	198	897	3459	896	3261	0.005050505050505051	0.27476234283961976
chr9	CUTALP	120845474	120845620	44115	147	2176427	7206	2132312	7059	300.1020408163265	302.0699815837937
chr9	CUTALP	120845474	120845887	44296	414	2176427	7206	2132131	6792	106.9951690821256	313.9179917550059
chr9	CUTALP	120845621	120845887	181	267	2176427	7206	2176246	6939	0.6779026217228464	313.62530624009224
chr9	CUTALP	120845827	120845887	0	61	2176427	7206	2176427	7145	0.0	304.6083974807558
chr9	CUTALP	120846804	120846861	0	58	2176427	7206	2176427	7148	0.0	304.4805540011192
chr9	CNTRL	121150306	121150483	0	178	0	9472	0	9294	0.0	0.0
chr9	GSN	121326683	121326792	0	110	0	7205	0	7095	0.0	0.0
chr9	MRRF	122265546	122265780	0	235	102	11044	102	10809	0.0	0.009436580627255066
chr9	PTGS1	122386622	122386732	0	111	77	5785	77	5674	0.0	0.013570673246387029
chr9	RABGAP1	123065462	123065601	0	140	44	7090	44	6950	0.0	0.006330935251798561
chr9	NEK6	124261580	124261583	0	4	37	4451	37	4447	0.0	0.008320215875871374
chr9	ADGRD2	124455098	124455127	0	30	984	4523	984	4493	0.0	0.21900734475851324
chr9	ADGRD2	124452155	124452158	0	4	984	4523	984	4519	0.0	0.2177472892232795
chr9	GAPVD1	125321500	125321562	0	63	153	13657	153	13594	0.0	0.011254965425923202
chr9	GAPVD1	125332018	125332060	0	43	153	13657	153	13614	0.0	0.01123843102688409
chr9	GAPVD1	125346942	125346995	0	54	153	13657	153	13603	0.0	0.011247518929647872
chr9	LMX1B	126693813	126693845	0	33	2084	6353	2084	6320	0.0	0.32974683544303796
chr9	LMX1B	126695983	126696003	0	21	2084	6353	2084	6332	0.0	0.32912192040429566
chr9	RALGPS1	126914976	126915012	0	37	143733	10527	143733	10490	0.0	13.701906577693041
chr9	RALGPS1	126914998	126915012	0	15	143733	10527	143733	10512	0.0	13.673230593607306
chr9	RALGPS1	126914976	126914997	0	22	143733	10527	143733	10505	0.0	13.682341742027607
chr9	GARNL3	127224639	127224691	0	53	1369	6297	1369	6244	0.0	0.2192504804612428
chr9	GARNL3	127243250	127243253	0	4	1369	6297	1369	6293	0.0	0.21754330208167805
chr9	ZNF79	127424804	127424910	0	107	1104	2308	1104	2201	0.0	0.5015901862789641
chr9	LRSAM1	127455041	127455054	18	14	12203	8123	12185	8109	1.2857142857142858	1.502651375015415
chr9	LRSAM1	127495415	127495418	0	4	12203	8123	12203	8119	0.0	1.5030176130065278
chr9	LRSAM1	127497335	127497362	0	28	12203	8123	12203	8095	0.0	1.5074737492279184
chr9	LRSAM1	127485836	127485840	10	5	12203	8123	12193	8118	2.0	1.501970928800197
chr9	STXBP1	127611857	127612047	0	191	131172	8749	131172	8558	0.0	15.327412946950222
chr9	CFAP157	127711931	127711950	60	20	24993	3233	24933	3213	3.0	7.760037348272642
chr9	AL162586.1	127818386	127818389	0	4	7515	2158	7515	2154	0.0	3.488857938718663
chr9	AL157935.1	127938125	127938274	0	150	3459	2525	3459	2375	0.0	1.4564210526315788
chr9	AL157935.1	127938125	127938213	0	89	3459	2525	3459	2436	0.0	1.4199507389162562
chr9	AL157935.1	127938275	127938662	102	388	3459	2525	3357	2137	0.26288659793814434	1.5708937763219466
chr9	DNM1	128226087	128226173	0	87	7596	9109	7596	9022	0.0	0.8419419197517181
chr9	ODF2	128455229	128455336	0	108	30955	6418	30955	6310	0.0	4.905705229793978
chr9	ODF2	128461011	128461067	0	57	30955	6418	30955	6361	0.0	4.866373211759157
chr9	ODF2	128496142	128496297	0	156	30955	6418	30955	6262	0.0	4.943308847013734
chr9	SPTAN1	128553363	128553382	0	20	11571	15464	11571	15444	0.0	0.7492229992229992
chr9	SPTAN1	128624488	128624824	0	337	11571	15464	11571	15127	0.0	0.7649236464599722
chr9	PHYHD1	128921602	128921668	0	67	0	2479	0	2412	0.0	0.0
chr9	PHYHD1	128937779	128937944	0	166	0	2479	0	2313	0.0	0.0
chr9	MIGA2	129068333	129068975	0	643	102	6138	102	5495	0.0	0.01856232939035487
chr9	PTPA	129120611	129120628	0	18	4202	5645	4202	5627	0.0	0.7467567087257864
chr9	PTPA	129142083	129142117	0	35	4202	5645	4202	5610	0.0	0.7490196078431373
chr9	PTPA	129142083	129142177	0	95	4202	5645	4202	5550	0.0	0.7571171171171172
chr9	PTPA	129142118	129142177	0	60	4202	5645	4202	5585	0.0	0.7523724261414503
chr9	LINC00963	129502520	129503139	0	620	102	11349	102	10729	0.0	0.009506943797185198
chr9	LINC00963	129503140	129503672	0	533	102	11349	102	10816	0.0	0.009430473372781065
chr9	NTMT1	129632802	129632865	0	64	2997	3032	2997	2968	0.0	1.0097708894878705
chr9	NTMT1	129634222	129634306	0	85	2997	3032	2997	2947	0.0	1.0169664065151
chr9	NTMT1	129626296	129626321	0	26	2997	3032	2997	3006	0.0	0.9970059880239521
chr9	USP20	129835500	129835597	0	98	46	5449	46	5351	0.0	0.008596524014202953
chr9	GPR107	130077375	130077378	0	4	8214	8332	8214	8328	0.0	0.9863112391930836
chr9	HMCN2	130393303	130393309	0	7	83412	18709	83412	18702	0.0	4.4600577478344565
chr9	ASS1	130444996	130445198	620	203	46029	2714	45409	2511	3.0541871921182264	18.084030266825966
chr9	LAMC3	131085700	131085723	2383	24	353485	8969	351102	8945	99.29166666666667	39.25120178870878
chr9	AIF1L	131114595	131114618	0	24	188475	4638	188475	4614	0.0	40.84850455136541
chr9	AIF1L	131117848	131117918	0	71	188475	4638	188475	4567	0.0	41.26888548281148
chr9	NUP214	131197417	131199015	19404	1599	271524	12057	252120	10458	12.135084427767355	24.107860011474468
chr9	NUP214	131190173	131190480	51	308	271524	12057	271473	11749	0.16558441558441558	23.106051578857777
chr9	POMT1	131509997	131510062	408	66	45660	6345	45252	6279	6.181818181818182	7.206880076445294
chr9	POMT1	131503074	131503313	11849	240	45660	6345	33811	6105	49.37083333333333	5.538247338247338
chr9	POMT1	131511468	131511472	0	5	45660	6345	45660	6340	0.0	7.201892744479495
chr9	POMT1	131504341	131504649	1086	309	45660	6345	44574	6036	3.5145631067961167	7.38469184890656
chr9	RPL7A	133348389	133348573	0	185	0	1678	0	1493	0.0	0.0
chr9	RPL7A	133348574	133348817	0	244	0	1678	0	1434	0.0	0.0
chr9	RPL7A	133348389	133348817	0	429	0	1678	0	1249	0.0	0.0
chr9	ADAMTS13	133455436	133455603	618	168	6958	5712	6340	5544	3.6785714285714284	1.1435786435786435
chr9	ADAMTS13	133430102	133430181	0	80	6958	5712	6958	5632	0.0	1.2354403409090908
chr9	AL353611.1	134937191	134937433	0	243	231	1323	231	1080	0.0	0.21388888888888888
chr9	OLFM1	135087728	135088139	0	412	0	6137	0	5725	0.0	0.0
chr9	AL353615.1	135353309	135353328	0	20	0	515	0	495	0.0	0.0
chr9	AL353615.1	135352718	135352755	0	38	0	515	0	477	0.0	0.0
chr9	PAEP	135565802	135565830	6186	29	105280	1461	99094	1432	213.31034482758622	69.19972067039106
chr9	PTGDS	136979300	136979401	0	102	623	2391	623	2289	0.0	0.27217125382262997
chr9	MAN1B1	137087219	137087363	0	145	0	7364	0	7219	0.0	0.0
chr9	GRIN1	137164216	137164987	0	772	51	9609	51	8837	0.0	0.005771189317641734
chr9	SSNA1	137189152	137189265	0	114	0	1156	0	1042	0.0	0.0
chr9	NDOR1	137216167	137216188	0	22	0	2822	0	2800	0.0	0.0
chr9	SLC34A3	137230939	137231044	0	106	0	2317	0	2211	0.0	0.0
chr9	SLC34A3	137230939	137231079	0	141	0	2317	0	2176	0.0	0.0
chr9	SLC34A3	137231045	137231079	0	35	0	2317	0	2282	0.0	0.0
chr9	STPG3	137252056	137252135	0	80	0	1512	0	1432	0.0	0.0
chr9	ARRDC1	137614899	137615000	0	102	2629	2585	2629	2483	0.0	1.058799838904551
chr9	ARRDC1	137613007	137613510	918	504	2629	2585	1711	2081	1.8214285714285714	0.822200864968765
chr9	EHMT1	137728530	137728593	0	64	73955	18118	73955	18054	0.0	4.09632214467708
chr9	EHMT1	137717183	137717273	0	91	73955	18118	73955	18027	0.0	4.10245742497365
chr9	TUBBP5	138175712	138175901	0	190	0	2496	0	2306	0.0	0.0
chr9	CBWD1	150508	150640	32	133	152803	10402	152771	10269	0.24060150375939848	14.876911091635018
chr9	AL161725.1	454438	454505	0	68	0	4028	0	3960	0.0	0.0
chr9	AL161725.1	466687	466898	0	212	0	4028	0	3816	0.0	0.0
chr9	VLDLR-AS1	2493074	2493238	0	165	30234	6797	30234	6632	0.0	4.558805790108565
chr9	VLDLR-AS1	2506358	2506417	0	60	30234	6797	30234	6737	0.0	4.487754193261096
chr9	SPATA6L	4625216	4625325	79	110	16117	5395	16038	5285	0.7181818181818181	3.0346263008514662
chr9	ERMP1	5832453	5832688	0	236	489701	6309	489701	6073	0.0	80.63576486085954
chr9	RANBP6	6015412	6015470	1448	59	22932	1015	21484	956	24.54237288135593	22.472803347280333
chr9	GLDC	6622784	6622917	360	134	392959	8660	392599	8526	2.6865671641791047	46.04726718273516
chr9	AL589678.1	12159029	12159115	0	87	0	566	0	479	0.0	0.0
chr9	MPDZ	13219558	13219654	1837	97	127719	9138	125882	9041	18.938144329896907	13.923459794270546
chr9	MPDZ	13139904	13139985	0	82	127719	9138	127719	9056	0.0	14.103246466431095
chr9	LINC01235	13416299	13416397	0	99	0	3029	0	2930	0.0	0.0
chr9	NFIB	14306988	14307212	10752	225	480871	12775	470119	12550	47.78666666666667	37.4596812749004
chr9	NFIB	14116180	14116206	89	27	480871	12775	480782	12748	3.2962962962962963	37.71430812676498
chr9	NFIB	14307907	14307918	0	12	480871	12775	480871	12763	0.0	37.676956828331896
chr9	TTC39B	15224339	15224358	0	20	32442	12232	32442	12212	0.0	2.656567310841795
chr9	RPS6	19380087	19380188	8756	102	10069149	2232	10060393	2130	85.84313725490196	4723.1892018779345
chr9	MIR31HG	21559488	21559746	1265	259	156659	2820	155394	2561	4.884169884169884	60.67707926591175
chr9	CDKN2A	21970901	21970974	443682	74	3154250	3894	2710568	3820	5995.7027027027025	709.5727748691099
chr9	CDKN2A	21974403	21974676	2202	274	3154250	3894	3152048	3620	8.036496350364963	870.7314917127072
chr9	CDKN2A	21971328	21971333	6	6	3154250	3894	3154244	3888	1.0	811.2767489711935
chr9	CDKN2B	22008674	22008796	1879	123	332854	4002	330975	3879	15.276422764227643	85.32482598607889
chr9	CAAP1	26892258	26892411	4880	154	338516	3168	333636	3014	31.68831168831169	110.6954213669542
chr9	C9ORF72	27573708	27573785	0	78	47900	5415	47900	5337	0.0	8.975079632752482
chr9	C9ORF72	27573708	27573722	0	15	47900	5415	47900	5400	0.0	8.87037037037037
chr9	APTX	32988082	32988090	2674	9	678291	14598	675617	14589	297.1111111111111	46.310028103365546
chr9	APTX	32987543	32987758	68233	216	678291	14598	610058	14382	315.89351851851853	42.41816159087749
chr9	APTX	33001515	33001565	3076	51	678291	14598	675215	14547	60.31372549019608	46.41609953942394
chr9	APTX	33024803	33025021	1420	219	678291	14598	676871	14379	6.4840182648401825	47.0735795256972
chr9	APTX	33024803	33024998	1216	196	678291	14598	677075	14402	6.204081632653061	47.0125676989307
chr9	APTX	33001332	33001514	2337	183	678291	14598	675954	14415	12.770491803278688	46.89240374609781
chr9	APTX	33001332	33001565	5413	234	678291	14598	672878	14364	23.132478632478634	46.8447507658034
chr9	APTX	33024999	33025021	204	23	678291	14598	678087	14575	8.869565217391305	46.5239794168096
chr9	BAG1	33264223	33264274	16904	52	514780	7084	497876	7032	325.0769230769231	70.80147895335608
chr9	BAG1	33264205	33264222	503	18	514780	7084	514277	7066	27.944444444444443	72.78191338805547
chr9	BAG1	33264205	33264274	17407	70	514780	7084	497373	7014	248.67142857142858	70.91146278870829
chr9	AQP7	33393796	33394125	0	330	0	3491	0	3161	0.0	0.0
chr9	AQP3	33443178	33443319	0	142	918	2489	918	2347	0.0	0.39113762249680445
chr9	UBAP2	34048824	34048876	5224	53	1051334	8530	1046110	8477	98.56603773584905	123.40568597381149
chr9	C9ORF24	34380896	34381054	945	159	2860	1424	1915	1265	5.943396226415095	1.5138339920948616
chr9	C9ORF24	34380896	34380900	0	5	2860	1424	2860	1419	0.0	2.0155038759689923
chr9	C9ORF24	34380901	34381054	945	154	2860	1424	1915	1270	6.136363636363637	1.5078740157480315
chr9	FAM219A	34405864	34405914	4818	51	589887	3788	585069	3737	94.47058823529412	156.56114530371957
chr9	FAM219A	34458203	34458235	10246	33	589887	3788	579641	3755	310.4848484848485	154.36511318242344
chr9	RPP25L	34611859	34612062	19517	204	248072	890	228555	686	95.67156862745098	333.1705539358601
chr9	SIGMAR1	34637219	34637265	63986	47	2520996	1897	2457010	1850	1361.404255319149	1328.1135135135135
chr9	FAM205C	34892658	34893048	0	391	0	1362	0	971	0.0	0.0
chr9	VCP	35072276	35072335	4748	60	8048840	8455	8044092	8395	79.13333333333334	958.2003573555688
chr9	PIGO	35096154	35096559	330	406	588556	4627	588226	4221	0.812807881773399	139.35702440180052
chr9	FAM214B	35115670	35115803	1052	134	359004	3855	357952	3721	7.850746268656716	96.19779629131953
chr9	CD72	35618221	35618270	0	50	13157	2901	13157	2851	0.0	4.614871974745704
chr9	SPAG8	35812103	35812108	0	6	36576	2480	36576	2474	0.0	14.78415521422797
chr9	SPAG8	35811181	35811922	3622	742	36576	2480	32954	1738	4.881401617250674	18.960874568469507
chr9	SPAG8	35811181	35811755	3622	575	36576	2480	32954	1905	6.299130434782609	17.298687664041996
chr9	SPAG8	35809403	35810245	27568	843	36576	2480	9008	1637	32.70225385527877	5.502748930971289
chr9	SPAG8	35811756	35811922	0	167	36576	2480	36576	2313	0.0	15.813229571984436
chr9	HINT2	35814898	35815005	3655	108	269337	1114	265682	1006	33.842592592592595	264.09741550695827
chr9	FAM221B	35819196	35819373	0	178	0	3950	0	3772	0.0	0.0
chr9	AL512604.2	37114544	37114883	357	340	175	1825	-182	1485	1.05	-0.12255892255892256
chr9	TOMM5	37588752	37588809	254366	58	2656132	3610	2401766	3552	4385.620689655172	676.1728603603603
chr9	TOMM5	37592309	37592410	37688	102	2656132	3610	2618444	3508	369.4901960784314	746.4207525655644
chr9	TOMM5	37592252	37592308	3977	57	2656132	3610	2652155	3553	69.7719298245614	746.4551083591331
chr9	TOMM5	37592252	37592410	41665	159	2656132	3610	2614467	3451	262.0440251572327	757.5969284265431
chr9	TOMM5	37592252	37592289	694	38	2656132	3610	2655438	3572	18.263157894736842	743.4036954087346
chr9	TOMM5	37592290	37592308	3283	19	2656132	3610	2652849	3591	172.78947368421052	738.749373433584
chr9	TOMM5	37592290	37592410	40971	121	2656132	3610	2615161	3489	338.60330578512395	749.5445686443107
chr9	SLC25A51	37903530	37904066	10067	537	369697	3402	359630	2865	18.746741154562383	125.52530541012216
chr9	FAM95C	38541288	38541454	391	167	47876	3767	47485	3600	2.341317365269461	13.190277777777778
chr9	CNTNAP3	39103713	39103742	1387	30	253992	8468	252605	8438	46.233333333333334	29.936596349845935
chr9	AQP7P5	40491214	40491225	0	12	0	1056	0	1044	0.0	0.0
chr9	AQP7P5	40497565	40497567	0	3	0	1056	0	1053	0.0	0.0
chr9	BX255923.2	41103684	41104466	153	783	204	4157	51	3374	0.19540229885057472	0.015115589804386485
chr9	CBWD6	41160804	41160936	0	133	0	9106	0	8973	0.0	0.0
chr9	CBWD6	41170278	41170282	0	5	0	9106	0	9101	0.0	0.0
chr9	CNTNAP3B	41908556	41908608	0	53	7770	11751	7770	11698	0.0	0.6642161053171483
chr9	LERFS	62897418	62897527	0	110	0	5599	0	5489	0.0	0.0
chr9	LERFS	62869076	62869188	0	113	0	5599	0	5486	0.0	0.0
chr9	LERFS	62869096	62869188	0	93	0	5599	0	5506	0.0	0.0
chr9	LERFS	62869076	62869095	0	20	0	5599	0	5579	0.0	0.0
chr9	PGM5-AS1	68357602	68357721	0	120	0	2358	0	2238	0.0	0.0
chr9	C9ORF135-DT	69820552	69820648	0	97	0	2093	0	1996	0.0	0.0
chr9	C9ORF135-DT	69820556	69820648	0	93	0	2093	0	2000	0.0	0.0
chr9	TRPM3	70590994	70591029	0	36	6112	14073	6112	14037	0.0	0.4354206739331766
chr9	CEMIP2	71730704	71730737	70	34	16873	9281	16803	9247	2.0588235294117645	1.8171298799610685
chr9	LINC01474	72874015	72874066	1090	52	3261	1268	2171	1216	20.96153846153846	1.785361842105263
chr9	AL512634.1	79136626	79137030	0	405	4	2916	4	2511	0.0	0.0015929908403026682
chr9	LNCARSR	79567627	79567630	0	4	306	4277	306	4273	0.0	0.07161245026913175
chr9	TLE1	81613376	81613420	0	45	0	5206	0	5161	0.0	0.0
chr9	TLE1	81615981	81616019	0	39	0	5206	0	5167	0.0	0.0
chr9	TLE1	81652183	81652212	0	30	0	5206	0	5176	0.0	0.0
chr9	AL158154.3	81973940	81974080	0	141	0	2213	0	2072	0.0	0.0
chr9	AL583827.1	85401454	85402545	0	1092	51	4823	51	3731	0.0	0.013669257571696597
chr9	AL583827.1	85401454	85401683	0	230	51	4823	51	4593	0.0	0.011103853690398433
chr9	AL353743.2	85803437	85804573	0	1137	561	7271	561	6134	0.0	0.09145745027714379
chr9	AL353743.2	85787825	85787882	0	58	561	7271	561	7213	0.0	0.07777623734923056
chr9	AL353743.2	85803269	85803436	0	168	561	7271	561	7103	0.0	0.07898071237505279
chr9	AL353743.2	85804256	85804573	0	318	561	7271	561	6953	0.0	0.08068459657701711
chr9	AL353743.2	85786283	85786436	0	154	561	7271	561	7117	0.0	0.07882534775888717
chr9	AL353743.2	85791482	85791485	0	4	561	7271	561	7267	0.0	0.0771982936562543
chr9	AL353743.2	85803269	85804573	0	1305	561	7271	561	5966	0.0	0.09403285283271874
chr9	C9ORF153	86227543	86227853	0	311	927	2935	927	2624	0.0	0.35327743902439024
chr9	LINC02843	88647222	88647345	0	124	3966	1616	3966	1492	0.0	2.658176943699732
chr9	LINC02843	88647214	88647221	0	8	3966	1616	3966	1608	0.0	2.466417910447761
chr9	LINC02843	88647214	88647345	0	132	3966	1616	3966	1484	0.0	2.6725067385444743
chr9	LINC01501	90501591	90501637	0	47	20337	4017	20337	3970	0.0	5.122670025188917
chr9	DIRAS2	90625875	90626056	0	182	255	4446	255	4264	0.0	0.05980300187617261
chr9	ROR2	91757271	91757427	0	157	480	5898	480	5741	0.0	0.0836091273297335
chr9	IARS1	92293440	92293609	0	170	33	7080	33	6910	0.0	0.004775687409551374
chr9	NOL8	92325305	92325316	0	12	51	7731	51	7719	0.0	0.006607073455110766
chr9	NOL8	92325317	92325567	0	251	51	7731	51	7480	0.0	0.006818181818181818
chr9	NOL8	92324905	92325304	0	400	51	7731	51	7331	0.0	0.006956758968762788
chr9	NOL8	92324905	92325316	0	412	51	7731	51	7319	0.0	0.006968165049870201
chr9	NOL8	92324905	92325178	0	274	51	7731	51	7457	0.0	0.00683921147914711
chr9	NOL8	92324022	92324607	0	586	51	7731	51	7145	0.0	0.007137858642407278
chr9	NOL8	92325179	92325304	0	126	51	7731	51	7605	0.0	0.0067061143984220905
chr9	NOL8	92325179	92325316	0	138	51	7731	51	7593	0.0	0.006716712761754247
chr9	ZNF484	92877819	92877888	0	70	0	4816	0	4746	0.0	0.0
chr9	FAM120AOS	93452146	93452738	153	593	306	9563	153	8970	0.2580101180438449	0.01705685618729097
chr9	FAM120AOS	93450741	93450943	0	203	306	9563	306	9360	0.0	0.032692307692307694
chr9	FANCC	95316795	95316830	0	36	21008	11365	21008	11329	0.0	1.8543560773236827
chr9	PTCH1	95507933	95507949	0	17	134377	17222	134377	17205	0.0	7.810345829700668
chr9	PTCH1	95516468	95516621	0	154	134377	17222	134377	17068	0.0	7.873037262713851
chr9	PTCH1	95507228	95507230	15	3	134377	17222	134362	17219	5.0	7.803124455543295
chr9	LINC00476	95874979	95875863	45259	885	80796	6299	35537	5414	51.14011299435028	6.56390838566679
chr9	LINC00476	95874508	95874978	8796	471	80796	6299	72000	5828	18.67515923566879	12.354152367879204
chr9	LINC00092	96027664	96027872	0	209	102	4626	102	4417	0.0	0.02309259678514829
chr9	PRXL2C	96655089	96655250	0	162	0	2942	0	2780	0.0	0.0
chr9	ZNF510	96777581	96778032	0	452	0	5475	0	5023	0.0	0.0
chr9	TSTD2	97627305	97627396	0	92	339	5679	339	5587	0.0	0.06067657061034545
chr9	XPA	97697120	97697222	554	103	1890	1824	1336	1721	5.378640776699029	0.7762928529924462
chr9	PTCSC2	97805361	97805486	432	126	494	2293	62	2167	3.4285714285714284	0.02861098292570374
chr9	PTCSC2	97805361	97805838	432	478	494	2293	62	1815	0.9037656903765691	0.03415977961432507
chr9	TRMO	97910917	97912871	15411	1955	16533	4155	1122	2200	7.882864450127877	0.51
chr9	ANKS6	98736495	98736525	0	31	28077	8688	28077	8657	0.0	3.2432713411112393
chr9	AL136084.1	98870802	98870889	0	88	0	4560	0	4472	0.0	0.0
chr9	AL136084.1	98869964	98869979	0	16	0	4560	0	4544	0.0	0.0
chr9	AL136084.1	98872062	98872187	0	126	0	4560	0	4434	0.0	0.0
chr9	AL136084.1	98871957	98872187	0	231	0	4560	0	4329	0.0	0.0
chr9	NAMA	99360387	99360388	0	2	6568	5398	6568	5396	0.0	1.2171979243884359
chr9	NAMA	99370853	99371011	459	159	6568	5398	6109	5239	2.8867924528301887	1.1660622256155755
chr9	TEX10	100346693	100347165	0	473	158	6807	158	6334	0.0	0.02494474265866751
chr9	BAAT	101362880	101362921	0	42	9815	4742	9815	4700	0.0	2.0882978723404255
chr9	CT70	104990811	104990815	0	5	0	2692	0	2687	0.0	0.0
chr9	CT70	104991683	104991684	0	2	0	2692	0	2690	0.0	0.0
chr9	CT70	104991653	104991684	0	32	0	2692	0	2660	0.0	0.0
chr9	CT70	104991653	104991682	0	30	0	2692	0	2662	0.0	0.0
chr9	ELP1	108896890	108896951	0	62	612	16260	612	16198	0.0	0.0377824422768243
chr9	ELP1	108881662	108881703	0	42	612	16260	612	16218	0.0	0.03773584905660377
chr9	TMEM245	109073247	109073354	0	108	0	9521	0	9413	0.0	0.0
chr9	PTPN3	109383306	109383421	0	116	32	7175	32	7059	0.0	0.004533220002833262
chr9	ECPAS	111483984	111484114	0	131	0	7307	0	7176	0.0	0.0
chr9	LRRC37A5P	111612997	111613512	0	516	33466	2329	33466	1813	0.0	18.458907887479317
chr9	AL138756.1	112036650	112036681	0	32	644	7126	644	7094	0.0	0.09078094164082323
chr9	PTBP3	112297831	112297839	0	9	4225	8252	4225	8243	0.0	0.5125561082130292
chr9	SLC46A2	112889552	112889723	0	172	255	2297	255	2125	0.0	0.12
chr9	WDR31	113331906	113331976	0	71	0	4343	0	4272	0.0	0.0
chr9	AL691420.1	115742814	115742951	0	138	3607	2999	3607	2861	0.0	1.2607479902132122
chr9	ASTN2	116686696	116687064	0	369	41143	8314	41143	7945	0.0	5.178477029578351
chr9	ASTN2	116425854	116425874	0	21	41143	8314	41143	8293	0.0	4.961172072832509
chr9	CDK5RAP2	120571973	120571975	0	3	0	9012	0	9009	0.0	0.0
chr9	PHF19	120862587	120862611	0	25	0	6613	0	6588	0.0	0.0
chr9	LHX6	122227799	122228305	0	507	153	5315	153	4808	0.0	0.03182196339434276
chr9	RC3H2	122851080	122851098	0	19	102	11585	102	11566	0.0	0.008818952100985648
chr9	RPL35	124858275	124858456	0	182	0	1186	0	1004	0.0	0.0
chr9	MAPKAP1	125672315	125672398	904	84	5583	6398	4679	6314	10.761904761904763	0.7410516312955338
chr9	TOR2A	127732563	127733383	0	821	174	2500	174	1679	0.0	0.10363311494937463
chr9	SH2D3C	127778590	127778594	0	5	1589	4525	1589	4520	0.0	0.3515486725663717
chr9	SH2D3C	127755078	127755083	6	6	1589	4525	1583	4519	1.0	0.35029873865899536
chr9	SH2D3C	127762120	127762390	765	271	1589	4525	824	4254	2.822878228782288	0.19370004701457452
chr9	SH2D3C	127762120	127762130	0	11	1589	4525	1589	4514	0.0	0.3520159503766061
chr9	ST6GALNAC6	127890636	127890654	0	19	4953	5316	4953	5297	0.0	0.9350575797621296
chr9	PIP5KL1	127921221	127921371	0	151	2394	2806	2394	2655	0.0	0.9016949152542373
chr9	PIP5KL1	127925866	127925956	0	91	2394	2806	2394	2715	0.0	0.881767955801105
chr9	PTGES2	128123701	128123724	120	24	124196	4049	124076	4025	5.0	30.82633540372671
chr9	PTGES2	128125895	128126228	14271	334	124196	4049	109925	3715	42.72754491017964	29.58950201884253
chr9	CIZ1	128169051	128169074	0	24	70028	7924	70028	7900	0.0	8.864303797468354
chr9	CIZ1	128179072	128179242	0	171	70028	7924	70028	7753	0.0	9.032374564684638
chr9	CIZ1	128178988	128179071	0	84	70028	7924	70028	7840	0.0	8.932142857142857
chr9	CIZ1	128178988	128179242	0	255	70028	7924	70028	7669	0.0	9.131307862824357
chr9	CIZ1	128204067	128204184	1136	118	70028	7924	68892	7806	9.627118644067796	8.825518831667948
chr9	CIZ1	128191279	128191430	0	152	70028	7924	70028	7772	0.0	9.010293360782295
chr9	ZDHHC12	128723951	128723992	0	42	5797	1337	5797	1295	0.0	4.476447876447876
chr9	ZER1	128771580	128771813	0	234	1182	4387	1182	4153	0.0	0.28461353238622683
chr9	CRAT	129095997	129096068	0	72	612	3826	612	3754	0.0	0.16302610548748003
chr9	FAM78A	131270275	131270458	102	184	407429	4484	407327	4300	0.5543478260869565	94.72720930232558
chr9	UCK1	131531066	131531092	0	27	4284	2576	4284	2549	0.0	1.6806590819929383
chr9	TSC1	132897422	132897426	1286	5	614065	16580	612779	16575	257.2	36.9700754147813
chr9	TSC1	132901588	132901629	4924	42	614065	16580	609141	16538	117.23809523809524	36.83280928770105
chr9	TSC1	132944542	132944570	4	29	614065	16580	614061	16551	0.13793103448275862	37.101141924959215
chr9	TSC1	132944542	132944545	4	4	614065	16580	614061	16576	1.0	37.045185810810814
chr9	TSC1	132944546	132944570	0	25	614065	16580	614065	16555	0.0	37.09241920869828
chr9	TSC1	132911409	132911451	0	43	614065	16580	614065	16537	0.0	37.132793130555726
chr9	MED22	133345171	133345188	0	18	3176	7240	3176	7222	0.0	0.43976737745776795
chr9	MED22	133347921	133347940	0	20	3176	7240	3176	7220	0.0	0.43988919667590026
chr9	MED22	133347921	133348033	0	113	3176	7240	3176	7127	0.0	0.44562929703942755
chr9	MED22	133347159	133347562	0	404	3176	7240	3176	6836	0.0	0.46459918080748974
chr9	MED22	133347941	133348033	0	93	3176	7240	3176	7147	0.0	0.4443822582901917
chr9	MED22	133347913	133347920	0	8	3176	7240	3176	7232	0.0	0.4391592920353982
chr9	MED22	133347913	133347940	0	28	3176	7240	3176	7212	0.0	0.4403771491957848
chr9	SLC2A6	133476232	133476235	0	4	16598	2985	16598	2981	0.0	5.567930224756793
chr9	TMEM250	136117865	136118070	0	206	204	3403	204	3197	0.0	0.06380982170785111
chr9	ENTR1	136405090	136405116	0	27	0	2733	0	2706	0.0	0.0
chr9	ENTR1	136409873	136410088	0	216	0	2733	0	2517	0.0	0.0
chr9	SEC16A	136463462	136463584	0	123	0	10006	0	9883	0.0	0.0
chr9	LINC01451	136614123	136615093	0	971	0	1669	0	698	0.0	0.0
chr9	AL590226.1	136660320	136660323	0	4	5937	1360	5937	1356	0.0	4.378318584070796
chr9	LCN10	136741655	136741879	153	225	2040	3360	1887	3135	0.68	0.6019138755980862
chr9	FBXW5	136941754	136942044	0	291	209388	3222	209388	2931	0.0	71.43909928352099
chr9	FBXW5	136941754	136942098	0	345	209388	3222	209388	2877	0.0	72.77997914494264
chr9	FBXW5	136942045	136942098	0	54	209388	3222	209388	3168	0.0	66.09469696969697
chr9	ABCA2	137010192	137010618	339	427	835073	10294	834734	9867	0.7939110070257611	84.59856085943042
chr9	DPP7	137111872	137111939	0	68	51	2550	51	2482	0.0	0.02054794520547945
chr9	TMEM210	137171881	137171938	0	58	0	790	0	732	0.0	0.0
chr9	EXD3	137354566	137354698	0	133	7338	7522	7338	7389	0.0	0.9930978481526593
chr9	DPH7	137577469	137577575	898	107	2991	4023	2093	3916	8.392523364485982	0.5344739530132788
chr10	TUBB8	48614	48717	0	104	0	2879	0	2775	0.0	0.0
chr10	TUBB8	48718	48802	0	85	0	2879	0	2794	0.0	0.0
chr10	TUBB8	48424	48613	0	190	0	2879	0	2689	0.0	0.0
chr10	TUBB8	48424	48717	0	294	0	2879	0	2585	0.0	0.0
chr10	TUBB8	48614	48802	0	189	0	2879	0	2690	0.0	0.0
chr10	LARP4B	814636	814740	0	105	81305	8723	81305	8618	0.0	9.434323508934787
chr10	IDI1	1048263	1048862	112	600	23613	4349	23501	3749	0.18666666666666668	6.268604961323019
chr10	LINC02645	2447286	2447293	0	8	102	5534	102	5526	0.0	0.018458197611292075
chr10	PITRM1	3147149	3147161	26	13	1244093	11641	1244067	11628	2.0	106.98890608875129
chr10	PITRM1	3158039	3158043	127	5	1244093	11641	1243966	11636	25.4	106.90666895840495
chr10	PITRM1	3166935	3166976	947	42	1244093	11641	1243146	11599	22.547619047619047	107.17699801707043
chr10	PITRM1	3148167	3148169	0	3	1244093	11641	1244093	11638	0.0	106.89920948616601
chr10	PITRM1	3172181	3172715	17066	535	1244093	11641	1227027	11106	31.89906542056075	110.48325229605618
chr10	PITRM1	3170733	3170776	541	44	1244093	11641	1243552	11597	12.295454545454545	107.2304906441321
chr10	PITRM1	3171760	3172715	231895	956	1244093	11641	1012198	10685	242.56799163179917	94.73074403369209
chr10	PITRM1	3171760	3172180	214829	421	1244093	11641	1029264	11220	510.2826603325416	91.73475935828877
chr10	KLF6	3781640	3781793	42	154	9	4846	-33	4692	0.2727272727272727	-0.007033248081841432
chr10	AL732437.3	5550643	5550999	0	357	0	1372	0	1015	0.0	0.0
chr10	LASTR	5610107	5610312	0	206	0	4818	0	4612	0.0	0.0
chr10	IL2RA	6021477	6021503	0	27	0	3971	0	3944	0.0	0.0
chr10	GATA3-AS1	8051248	8051272	3877	25	11361	1741	7484	1716	155.08	4.361305361305361
chr10	GATA3-AS1	8053122	8053184	45	63	11361	1741	11316	1678	0.7142857142857143	6.743742550655543
chr10	LINC00708	8260645	8260778	0	134	0	824	0	690	0.0	0.0
chr10	LINC00708	8260635	8260778	0	144	0	824	0	680	0.0	0.0
chr10	LINC00708	8260635	8260644	0	10	0	824	0	814	0.0	0.0
chr10	SFTA1P	10794838	10794875	0	38	0	1202	0	1164	0.0	0.0
chr10	SFTA1P	10794697	10794837	0	141	0	1202	0	1061	0.0	0.0
chr10	SFTA1P	10794697	10794875	0	179	0	1202	0	1023	0.0	0.0
chr10	LINC00710	10935052	10935232	0	181	0	6504	0	6323	0.0	0.0
chr10	LINC00710	10946785	10947444	0	660	0	6504	0	5844	0.0	0.0
chr10	LINC00710	10951893	10951936	0	44	0	6504	0	6460	0.0	0.0
chr10	LINC00710	10951893	10951923	0	31	0	6504	0	6473	0.0	0.0
chr10	LINC00710	10951924	10951936	0	13	0	6504	0	6491	0.0	0.0
chr10	LINC00710	10951795	10951936	0	142	0	6504	0	6362	0.0	0.0
chr10	LINC00710	10951795	10951892	0	98	0	6504	0	6406	0.0	0.0
chr10	LINC00710	10951795	10951923	0	129	0	6504	0	6375	0.0	0.0
chr10	LINC00710	10936623	10937436	0	814	0	6504	0	5690	0.0	0.0
chr10	LINC00710	10948240	10948251	0	12	0	6504	0	6492	0.0	0.0
chr10	CELF2-AS2	11105449	11105467	0	19	0	4185	0	4166	0.0	0.0
chr10	NUDT5	12179028	12179081	0	54	26597	4491	26597	4437	0.0	5.99436556231688
chr10	PHYH	13291824	13291829	0	6	510	3388	510	3382	0.0	0.15079834417504434
chr10	BEND7	13499738	13499776	0	39	0	5715	0	5676	0.0	0.0
chr10	FRMD4A	13707275	13707344	306	70	49822	13266	49516	13196	4.371428571428571	3.7523491967262808
chr10	FAM107B	14571762	14571922	0	161	720	6879	720	6718	0.0	0.10717475439118786
chr10	FAM107B	14571762	14571989	0	228	720	6879	720	6651	0.0	0.10825439783491204
chr10	FAM107B	14571923	14571989	0	67	720	6879	720	6812	0.0	0.10569583088667057
chr10	CDNF	14825478	14825492	15	15	252	1710	237	1695	1.0	0.13982300884955753
chr10	RSU1	16816972	16817313	0	342	1424	4135	1424	3793	0.0	0.37542842077511207
chr10	CUBN	16907507	16907678	0	172	60817	13334	60817	13162	0.0	4.620650357088588
chr10	AC069549.2	20099449	20099486	0	38	0	2430	0	2392	0.0	0.0
chr10	NEBL	20817597	20817598	0	2	175	16049	175	16047	0.0	0.010905465195986789
chr10	ARHGAP21	24590205	24590452	0	248	1048	9962	1048	9714	0.0	0.10788552604488368
chr10	ACBD5	27210813	27210920	0	108	724	11777	724	11669	0.0	0.062044733910360785
chr10	MPP7	28059515	28059648	0	134	0	6190	0	6056	0.0	0.0
chr10	WAC-AS1	28525867	28525946	0	80	0	3391	0	3311	0.0	0.0
chr10	LINC00837	28795772	28795892	0	121	918	4864	918	4743	0.0	0.1935483870967742
chr10	LINC00837	28795661	28795771	0	111	918	4864	918	4753	0.0	0.19314117399537134
chr10	LINC00837	28795661	28795892	0	232	918	4864	918	4632	0.0	0.19818652849740934
chr10	SVIL	29735750	29735753	0	4	277	12477	277	12473	0.0	0.022207969213501162
chr10	SVIL	29634419	29634525	0	107	277	12477	277	12370	0.0	0.022392886014551333
chr10	MTPAP	30369045	30369071	0	27	294	8335	294	8308	0.0	0.03538757823784304
chr10	ITGB1	32957010	32957224	0	215	150	12473	150	12258	0.0	0.012236906510034264
chr10	ITGB1	32957225	32957757	51	533	150	12473	99	11940	0.09568480300187618	0.008291457286432161
chr10	ITGB1	32936241	32936348	0	108	150	12473	150	12365	0.0	0.01213101496158512
chr10	ITGB1	32932505	32932513	0	9	150	12473	150	12464	0.0	0.012034659820282413
chr10	ITGB1	32932505	32932509	0	5	150	12473	150	12468	0.0	0.01203079884504331
chr10	ITGB1	32933350	32933480	0	131	150	12473	150	12342	0.0	0.012153621779290228
chr10	ITGB1	32932510	32932513	0	4	150	12473	150	12469	0.0	0.012029833988290961
chr10	NRP1	33202890	33202910	231	21	320899	9558	320668	9537	11.0	33.62357135367516
chr10	LINC00838	33772182	33772611	0	430	408	3582	408	3152	0.0	0.12944162436548223
chr10	PARD3	34337274	34337363	0	90	2709	6541	2709	6451	0.0	0.4199348938149124
chr10	PARD3	34337274	34337276	0	3	2709	6541	2709	6538	0.0	0.4143468950749465
chr10	PARD3	34347955	34347963	0	9	2709	6541	2709	6532	0.0	0.414727495407226
chr10	PARD3	34337277	34337363	0	87	2709	6541	2709	6454	0.0	0.4197396963123644
chr10	CUL2	35090178	35090428	306	251	1053	5181	747	4930	1.2191235059760956	0.15152129817444218
chr10	CUL2	35074078	35074190	153	113	1053	5181	900	5068	1.3539823008849559	0.17758484609313338
chr10	ZNF248	37857764	37858003	0	240	459	6037	459	5797	0.0	0.07917888563049853
chr10	CCNYL2	42471804	42472192	0	389	0	3845	0	3456	0.0	0.0
chr10	ZNF37BP	42551572	42551575	0	4	0	2664	0	2660	0.0	0.0
chr10	RSU1P2	45106996	45106999	0	4	0	2552	0	2548	0.0	0.0
chr10	ZFAND4	45672249	45672677	0	429	0	6248	0	5819	0.0	0.0
chr10	ZFAND4	45672249	45672270	0	22	0	6248	0	6226	0.0	0.0
chr10	ZFAND4	45672271	45672677	0	407	0	6248	0	5841	0.0	0.0
chr10	AL591684.2	47553328	47553477	0	150	0	1637	0	1487	0.0	0.0
chr10	LINC02675	47590138	47590164	0	27	0	2441	0	2414	0.0	0.0
chr10	ARHGAP22	48455001	48455052	0	52	0	6564	0	6512	0.0	0.0
chr10	ARHGAP22	48479587	48479634	0	48	0	6564	0	6516	0.0	0.0
chr10	TMEM273	49166444	49166867	0	424	0	3704	0	3280	0.0	0.0
chr10	SGMS1	50341216	50341298	0	83	0	6440	0	6357	0.0	0.0
chr10	LNCAROD	52755305	52755308	0	4	102	2115	102	2111	0.0	0.04831833254381809
chr10	LINC02672	53029891	53029909	0	19	51	1620	51	1601	0.0	0.03185509056839475
chr10	PCDH15	53810546	53810554	0	9	404	15436	404	15427	0.0	0.026187852466454917
chr10	ZWINT	56360017	56360178	0	162	0	2184	0	2022	0.0	0.0
chr10	ZWINT	56358804	56358907	0	104	0	2184	0	2080	0.0	0.0
chr10	ANK3	60068636	60073870	97	5235	87829	22486	87732	17251	0.018529130850047756	5.085618225030433
chr10	ANK3	60068636	60069976	97	1341	87829	22486	87732	21145	0.07233407904548844	4.149065973043273
chr10	ANK3	60068636	60068647	12	12	87829	22486	87817	22474	1.0	3.907493103141408
chr10	ANK3	60080536	60080571	0	36	87829	22486	87829	22450	0.0	3.912204899777283
chr10	RUFY2	68345701	68345829	0	129	322	8004	322	7875	0.0	0.04088888888888889
chr10	RUFY2	68406753	68406904	0	152	322	8004	322	7852	0.0	0.04100866021395823
chr10	RUFY2	68406753	68407184	0	432	322	8004	322	7572	0.0	0.042525092445853147
chr10	DNA2	68416706	68416707	0	2	11	4023	11	4021	0.0	0.002735637901019647
chr10	TYSND1	70145420	70146531	9850	1112	48691	4625	38841	3513	8.857913669064748	11.056362083689155
chr10	LRRC20	70382493	70382547	0	55	0	3632	0	3577	0.0	0.0
chr10	ASCC1	72215781	72215834	0	54	17435	5932	17435	5878	0.0	2.966144947260973
chr10	ASCC1	72215776	72215834	0	59	17435	5932	17435	5873	0.0	2.968670185595096
chr10	ASCC1	72215776	72215780	0	5	17435	5932	17435	5927	0.0	2.941623080816602
chr10	ASCC1	72215781	72216205	0	425	17435	5932	17435	5507	0.0	3.1659705828944977
chr10	DNAJB12	72335779	72335832	20	54	5426	5577	5406	5523	0.37037037037037035	0.9788158609451385
chr10	MRPS16	73252469	73252530	0	62	0	2703	0	2641	0.0	0.0
chr10	CFAP70	73291225	73291348	0	124	0	3807	0	3683	0.0	0.0
chr10	USP54	73505307	73505321	0	15	307959	9532	307959	9517	0.0	32.35883156456867
chr10	AC022400.4	73713197	73713202	0	6	102	1195	102	1189	0.0	0.08578637510513036
chr10	BMS1P4	73730438	73730457	0	20	1133	2675	1133	2655	0.0	0.42674199623352166
chr10	BMS1P4	73730315	73730437	0	123	1133	2675	1133	2552	0.0	0.44396551724137934
chr10	BMS1P4	73730315	73730457	0	143	1133	2675	1133	2532	0.0	0.44747235387045814
chr10	NDST2	73802971	73803007	0	37	17	4670	17	4633	0.0	0.003669328728685517
chr10	CAMK2G	73825278	73825319	0	42	838	6806	838	6764	0.0	0.12389118864577173
chr10	DUSP13	75095574	75095726	0	153	0	2053	0	1900	0.0	0.0
chr10	DUSP13	75103893	75103991	0	99	0	2053	0	1954	0.0	0.0
chr10	DUSP13	75099030	75099427	0	398	0	2053	0	1655	0.0	0.0
chr10	COMTD1	75235615	75235618	48	4	28299	1822	28251	1818	12.0	15.53960396039604
chr10	NUTM2B-AS1	79808758	79808761	12	4	1780319	19359	1780307	19355	3.0	91.9817618186515
chr10	DYDC1	80356352	80356710	0	359	0	1245	0	886	0.0	0.0
chr10	ADIRF-AS1	86967768	86969040	0	1273	102	4083	102	2810	0.0	0.036298932384341634
chr10	NUTM2A-AS1	87330891	87330894	0	4	51	19888	51	19884	0.0	0.0025648762824381412
chr10	FAM245A	87398019	87398045	0	27	0	2032	0	2005	0.0	0.0
chr10	ACTA2	88990938	88991020	43	83	14927	2903	14884	2820	0.5180722891566265	5.278014184397163
chr10	HTR7	90748833	90748837	0	5	279	3476	279	3471	0.0	0.08038029386343994
chr10	TNKS2-AS1	91797812	91798235	0	424	0	961	0	537	0.0	0.0
chr10	CPEB3	92192476	92192544	0	69	0	7930	0	7861	0.0	0.0
chr10	PLCE1-AS2	94107710	94107730	15	21	56408	4224	56393	4203	0.7142857142857143	13.417320961218177
chr10	PLCE1-AS2	94105574	94106019	408	446	56408	4224	56000	3778	0.9147982062780269	14.822657490735839
chr10	PLCE1-AS2	94108357	94108716	102	360	56408	4224	56306	3864	0.2833333333333333	14.571946169772257
chr10	CYP2C8	95069196	95069233	456	38	1159	2543	703	2505	12.0	0.2806387225548902
chr10	SORBS1	95351208	95351214	0	7	1829	10991	1829	10984	0.0	0.16651493080844865
chr10	ALDH18A1	95633490	95633495	0	6	330	3778	330	3772	0.0	0.08748674443266172
chr10	ENTPD1-AS1	95907662	95907776	0	115	35357	22304	35357	22189	0.0	1.5934472035693361
chr10	SLIT1	97002157	97002280	0	124	53289	8050	53289	7926	0.0	6.72331566994701
chr10	ARHGAP19	97265859	97266077	0	219	102	6182	102	5963	0.0	0.017105483816870704
chr10	EXOSC1	97438662	97438668	49	7	13919	1956	13870	1949	7.0	7.116469984607491
chr10	MMS19	97480894	97480940	0	47	0	4976	0	4929	0.0	0.0
chr10	ERLIN1	100185903	100185960	270	58	17155	3502	16885	3444	4.655172413793103	4.902729384436702
chr10	CHUK	100193297	100193387	384	91	246953	5240	246569	5149	4.21978021978022	47.886774130899205
chr10	PKD2L1	100329868	100329907	0	40	51	2864	51	2824	0.0	0.018059490084985835
chr10	NDUFB8	100529766	100529856	0	91	0	2005	0	1914	0.0	0.0
chr10	NDUFB8	100529365	100529378	0	14	0	2005	0	1991	0.0	0.0
chr10	MRPL43	100983947	100984032	0	86	51	2672	51	2586	0.0	0.019721577726218097
chr10	MRPL43	100986686	100986747	0	62	51	2672	51	2610	0.0	0.01954022988505747
chr10	TLX1NB	101130756	101130784	0	29	918	1894	918	1865	0.0	0.49222520107238604
chr10	POLL	101584601	101584876	19	276	5033	5429	5014	5153	0.06884057971014493	0.9730254220842228
chr10	POLL	101587884	101588202	0	319	5033	5429	5033	5110	0.0	0.9849315068493151
chr10	POLL	101587821	101587883	0	63	5033	5429	5033	5366	0.0	0.9379426015654119
chr10	POLL	101587821	101588202	0	382	5033	5429	5033	5047	0.0	0.9972260748959778
chr10	FBXW4	101694380	101695238	612	859	5480	5048	4868	4189	0.7124563445867288	1.162091191215087
chr10	AC010789.1	101729716	101729751	0	36	2437	918	2437	882	0.0	2.7630385487528346
chr10	FGF8	101775541	101775738	32	198	816	1427	784	1229	0.16161616161616163	0.6379170056956875
chr10	LDB1	102109028	102109033	36	6	286747	3788	286711	3782	6.0	75.80936012691697
chr10	NT5C2	103111692	103111743	0	52	2680	8572	2680	8520	0.0	0.3145539906103286
chr10	XPNPEP1	109915010	109915021	0	12	369	6715	369	6703	0.0	0.055049977621960317
chr10	ADD3-AS1	109951843	109953754	0	1912	0	7304	0	5392	0.0	0.0
chr10	GPAM	112183673	112183691	0	19	34	7897	34	7878	0.0	0.004315816197004316
chr10	GUCY2GP	112327186	112327188	0	3	20364	3290	20364	3287	0.0	6.195314876787344
chr10	AL157786.1	112409013	112409405	0	393	0	2873	0	2480	0.0	0.0
chr10	AL157786.1	112409013	112409210	0	198	0	2873	0	2675	0.0	0.0
chr10	AL157786.1	112409013	112409481	0	469	0	2873	0	2404	0.0	0.0
chr10	AL157786.1	112409211	112409405	0	195	0	2873	0	2678	0.0	0.0
chr10	AL157786.1	112409211	112409481	0	271	0	2873	0	2602	0.0	0.0
chr10	ZDHHC6	112446586	112446703	0	118	0	3644	0	3526	0.0	0.0
chr10	AFAP1L2	114297219	114297230	0	12	732	5809	732	5797	0.0	0.12627220976367087
chr10	ABLIM1	114526638	114526658	0	21	7103	10244	7103	10223	0.0	0.6948058299911963
chr10	HSPA12A	116683790	116683830	0	41	22311	21134	22311	21093	0.0	1.0577442753520125
chr10	EMX2OS	117476356	117476454	0	99	918	4904	918	4805	0.0	0.19105098855359
chr10	SFXN4	119165201	119165535	0	335	0	1930	0	1595	0.0	0.0
chr10	MCMBP	119843247	119843252	0	6	4244	6013	4244	6007	0.0	0.7065090727484601
chr10	WDR11-AS1	120850693	120851105	0	413	37440	6721	37440	6308	0.0	5.935320228281547
chr10	FGFR2	121515116	121515121	0	6	137099	7609	137099	7603	0.0	18.032224122057084
chr10	FGFR2	121565437	121565635	0	199	137099	7609	137099	7410	0.0	18.501889338731445
chr10	AC063960.2	122152481	122152508	0	28	0	4404	0	4376	0.0	0.0
chr10	EEF1AKMT2	124789038	124789041	0	4	10370	5827	10370	5823	0.0	1.7808689678859695
chr10	CTBP2	125026081	125027956	51	1876	2193	9202	2142	7326	0.027185501066098083	0.29238329238329236
chr10	EDRF1-AS1	125751943	125751983	0	41	0	1922	0	1881	0.0	0.0
chr10	EDRF1-AS1	125751915	125751983	0	69	0	1922	0	1853	0.0	0.0
chr10	EDRF1-AS1	125751915	125751942	0	28	0	1922	0	1894	0.0	0.0
chr10	UROS	125802949	125802987	0	39	284	8118	284	8079	0.0	0.03515286545364525
chr10	ADAM12	126155217	126155225	0	9	87035	9886	87035	9877	0.0	8.811886200263238
chr10	EBF3	129873451	129873477	0	27	6674	5469	6674	5442	0.0	1.2263873575891215
chr10	AL451069.1	132518093	132518115	0	23	0	2470	0	2447	0.0	0.0
chr10	ZMYND11	134787	134892	0	106	1405	5345	1405	5239	0.0	0.26818095056308455
chr10	IDI2-AS1	1035423	1035506	48	84	70418	3053	70370	2969	0.5714285714285714	23.701583024587404
chr10	WDR37	1056565	1056968	3145	404	102509	6299	99364	5895	7.784653465346534	16.855640373197627
chr10	PFKP	3109481	3109609	0	129	4246	6142	4246	6013	0.0	0.7061367038084151
chr10	PFKP	3068649	3068742	0	94	4246	6142	4246	6048	0.0	0.7020502645502645
chr10	PFKP	3068743	3068921	19	179	4246	6142	4227	5963	0.10614525139664804	0.70887137346973
chr10	LINC02660	3912047	3912176	0	130	0	1114	0	984	0.0	0.0
chr10	LINC02660	3934628	3934974	0	347	0	1114	0	767	0.0	0.0
chr10	AC025822.1	4025357	4025457	0	101	0	3739	0	3638	0.0	0.0
chr10	AKR1E2	4841841	4841857	0	17	0	2430	0	2413	0.0	0.0
chr10	AKR1E2	4847231	4847299	0	69	0	2430	0	2361	0.0	0.0
chr10	AKR1E2	4826278	4826363	0	86	0	2430	0	2344	0.0	0.0
chr10	AKR1E2	4833467	4833476	0	10	0	2430	0	2420	0.0	0.0
chr10	LINC02649	6331604	6331834	0	231	3958	5103	3958	4872	0.0	0.8123973727422004
chr10	LINC02649	6331307	6331834	10	528	3958	5103	3948	4575	0.01893939393939394	0.8629508196721312
chr10	PRKCQ-AS1	6583919	6584195	0	277	0	5311	0	5034	0.0	0.0
chr10	LINC00707	6838009	6838652	0	644	0	9845	0	9201	0.0	0.0
chr10	LINC00707	6812369	6812556	0	188	0	9845	0	9657	0.0	0.0
chr10	CELF2	11314259	11314270	0	12	0	9833	0	9821	0.0	0.0
chr10	ECHDC3	11742747	11742905	0	159	0	2128	0	1969	0.0	0.0
chr10	AL157392.3	13645075	13645136	0	62	13373	9029	13373	8967	0.0	1.4913571986171519
chr10	AL157392.3	13631364	13631484	0	121	13373	9029	13373	8908	0.0	1.5012348450830715
chr10	AL157392.3	13631821	13631973	0	153	13373	9029	13373	8876	0.0	1.5066471383506084
chr10	AL157392.3	13637095	13637187	0	93	13373	9029	13373	8936	0.0	1.4965308863025963
chr10	AL157392.3	13646687	13646780	0	94	13373	9029	13373	8935	0.0	1.4966983771684388
chr10	AL157392.3	13652883	13652929	0	47	13373	9029	13373	8982	0.0	1.4888666221331552
chr10	AL157392.3	13649335	13649637	0	303	13373	9029	13373	8726	0.0	1.5325464130185653
chr10	AL157392.3	13652883	13653148	0	266	13373	9029	13373	8763	0.0	1.526075544904713
chr10	AL157392.3	13652930	13653148	0	219	13373	9029	13373	8810	0.0	1.5179341657207719
chr10	AL158168.1	14652752	14652833	0	82	0	1254	0	1172	0.0	0.0
chr10	SUV39H2	14896978	14897517	0	540	3990	3572	3990	3032	0.0	1.3159630606860158
chr10	SUV39H2	14878920	14878960	240	41	3990	3572	3750	3531	5.853658536585366	1.0620220900594732
chr10	SUV39H2	14878920	14879127	1190	208	3990	3572	2800	3364	5.721153846153846	0.8323424494649228
chr10	SUV39H2	14878961	14879127	950	167	3990	3572	3040	3405	5.688622754491018	0.8928046989720999
chr10	OLAH	15047321	15047383	0	63	52	2300	52	2237	0.0	0.0232454179704962
chr10	RPP38	15097410	15097766	0	357	4263	1880	4263	1523	0.0	2.799080761654629
chr10	LINC02654	16277697	16278093	0	397	0	2554	0	2157	0.0	0.0
chr10	VIM	17228525	17228676	0	152	72	4730	72	4578	0.0	0.015727391874180863
chr10	CACNB2	18140857	18141215	0	359	1326	11186	1326	10827	0.0	0.12247159878082571
chr10	MLLT10	21534495	21534520	0	26	51	8958	51	8932	0.0	0.005709807433945365
chr10	SPAG6	22345819	22346046	0	228	468	3848	468	3620	0.0	0.1292817679558011
chr10	PTF1A	23192678	23193314	0	637	0	1388	0	751	0.0	0.0
chr10	THNSL1	25016693	25016789	0	97	102	3837	102	3740	0.0	0.02727272727272727
chr10	FAM238B	26650658	26650791	0	134	0	1292	0	1158	0.0	0.0
chr10	RAB18	27504413	27504437	0	25	4897	6111	4897	6086	0.0	0.8046335852776865
chr10	WAC	28534035	28534182	0	148	51	10128	51	9980	0.0	0.005110220440881764
chr10	WAC	28533583	28533620	0	38	51	10128	51	10090	0.0	0.005054509415262636
chr10	SVIL-AS1	29409659	29409683	0	25	1734	5005	1734	4980	0.0	0.3481927710843373
chr10	SVIL2P	30693669	30693799	0	131	34	3253	34	3122	0.0	0.010890454836643177
chr10	ZEB1	31319134	31319292	0	159	651	8673	651	8514	0.0	0.07646229739252995
chr10	CCDC7	32446398	32446631	51	234	5648	8667	5597	8433	0.21794871794871795	0.663702122613542
chr10	ITGB1-DT	32958904	32958971	0	68	510	3238	510	3170	0.0	0.1608832807570978
chr10	LINC02635	34969955	34969966	0	12	2111	1177	2111	1165	0.0	1.8120171673819743
chr10	CREM	35196100	35196142	0	43	186	5551	186	5508	0.0	0.03376906318082789
chr10	ZNF33A	38017016	38017020	0	5	1581	7554	1581	7549	0.0	0.20943171280964365
chr10	ZNF37A	38095630	38095633	0	4	100204	13019	100204	13015	0.0	7.699116404149059
chr10	LINC00839	42475881	42475964	0	84	51	8183	51	8099	0.0	0.0062970737128040495
chr10	LINC00839	42476489	42476530	0	42	51	8183	51	8141	0.0	0.006264586660115465
chr10	ZNF487	43436936	43437155	0	220	0	3028	0	2808	0.0	0.0
chr10	ZNF487	43437156	43437262	0	107	0	3028	0	2921	0.0	0.0
chr10	ZNF485	43606542	43606546	0	5	0	2391	0	2386	0.0	0.0
chr10	ZNF485	43606547	43606563	0	17	0	2391	0	2374	0.0	0.0
chr10	ZNF485	43606542	43606563	0	22	0	2391	0	2369	0.0	0.0
chr10	LINC00840	43845408	43845602	0	195	34681	7297	34681	7102	0.0	4.883272317656998
chr10	LINC00840	43846686	43846882	0	197	34681	7297	34681	7100	0.0	4.884647887323943
chr10	FAM245B	46750223	46750253	23	31	5645	1278	5622	1247	0.7419354838709677	4.508420208500401
chr10	BMS1P1	46795946	46795953	0	8	0	4572	0	4564	0.0	0.0
chr10	ASAH2B	50739984	50740002	0	19	153	5888	153	5869	0.0	0.026069177031862328
chr10	LINC00844	59001315	59001349	0	35	0	6009	0	5974	0.0	0.0
chr10	LINC00844	59000504	59000512	0	9	0	6009	0	6000	0.0	0.0
chr10	LINC00844	59000246	59000512	0	267	0	6009	0	5742	0.0	0.0
chr10	CDK1	60778460	60778570	0	111	0	3548	0	3437	0.0	0.0
chr10	CDK1	60778571	60778668	0	98	0	3548	0	3450	0.0	0.0
chr10	LINC01515	65585568	65585802	0	235	510	17753	510	17518	0.0	0.029112912432926134
chr10	LINC01515	65570546	65570759	300	214	510	17753	210	17539	1.4018691588785046	0.01197331660870061
chr10	LINC01515	65570546	65571579	510	1034	510	17753	0	16719	0.4932301740812379	0.0
chr10	HNRNPH3	68331855	68332216	0	362	0	3045	0	2683	0.0	0.0
chr10	HNRNPH3	68338643	68338687	0	45	0	3045	0	3000	0.0	0.0
chr10	CCAR1	68721157	68721282	0	126	0	6086	0	5960	0.0	0.0
chr10	CCAR1	68721283	68721406	0	124	0	6086	0	5962	0.0	0.0
chr10	CCAR1	68721289	68721406	0	118	0	6086	0	5968	0.0	0.0
chr10	CCAR1	68721283	68721288	0	6	0	6086	0	6080	0.0	0.0
chr10	CCAR1	68721283	68721663	0	381	0	6086	0	5705	0.0	0.0
chr10	CCAR1	68721407	68721663	0	257	0	6086	0	5829	0.0	0.0
chr10	CCAR1	68721289	68721663	0	375	0	6086	0	5711	0.0	0.0
chr10	STOX1	68884460	68886618	51	2159	51	3919	0	1760	0.023622047244094488	0.0
chr10	STOX1	68827934	68828269	0	336	51	3919	51	3583	0.0	0.014233882221602009
chr10	KIFBP	68989213	68989258	0	46	0	6370	0	6324	0.0	0.0
chr10	KIFBP	68989743	68989859	0	117	0	6370	0	6253	0.0	0.0
chr10	HK1	69282651	69282704	0	54	102	6322	102	6268	0.0	0.016273133375877474
chr10	HK1	69319011	69319177	0	167	102	6322	102	6155	0.0	0.016571892770105606
chr10	COL13A1	69919702	69919727	286	26	54222	9922	53936	9896	11.0	5.450282942603072
chr10	MACROH2A2	70091842	70091954	31566	113	1154095	11836	1122529	11723	279.34513274336285	95.75441439904462
chr10	MACROH2A2	70083071	70083179	0	109	1154095	11836	1154095	11727	0.0	98.41349023620704
chr10	ADAMTS14	70730250	70730258	0	9	144299	5588	144299	5579	0.0	25.864671088008603
chr10	SLC29A3	71319311	71319731	0	421	306	5448	306	5027	0.0	0.0608712950069624
chr10	ANAPC16	72216073	72216138	0	66	104	4329	104	4263	0.0	0.02439596528266479
chr10	MCU	72834429	72834432	0	4	0	4536	0	4532	0.0	0.0
chr10	FAM149B1	73228161	73228184	0	24	51	6573	51	6549	0.0	0.007787448465414567
chr10	FAM149B1	73233164	73233197	0	34	51	6573	51	6539	0.0	0.007799357699954121
chr10	PPP3CB-AS1	73496484	73496906	0	423	0	5347	0	4924	0.0	0.0
chr10	SEC24C	73767932	73768007	5998	76	471877	5320	465879	5244	78.92105263157895	88.8403890160183
chr10	ZSWIM8	73793699	73793719	0	21	51	7868	51	7847	0.0	0.006499299095195616
chr10	ZSWIM8	73800171	73800194	0	24	51	7868	51	7844	0.0	0.006501784803671596
chr10	ZSWIM8	73797606	73797609	0	4	51	7868	51	7864	0.0	0.006485249237029501
chr10	PLAU	73911613	73911925	0	313	162	2962	162	2649	0.0	0.061155152887882216
chr10	KAT6B	74825357	74825360	0	4	65073	24867	65073	24863	0.0	2.6172625990427543
chr10	KAT6B	74975455	74976330	47	876	65073	24867	65026	23991	0.05365296803652968	2.7104330790713185
chr10	KAT6B	74975782	74976330	47	549	65073	24867	65026	24318	0.08561020036429873	2.673986347561477
chr10	KAT6B	74838753	74838783	0	31	65073	24867	65073	24836	0.0	2.6201079078756644
chr10	KAT6B	74825536	74825674	0	139	65073	24867	65073	24728	0.0	2.6315512779035912
chr10	KAT6B	74975455	74975781	0	327	65073	24867	65073	24540	0.0	2.651711491442543
chr10	KAT6B	74825675	74825766	0	92	65073	24867	65073	24775	0.0	2.6265590312815337
chr10	KAT6B	74826470	74826785	160	316	65073	24867	64913	24551	0.5063291139240507	2.644006354119995
chr10	SAMD8	75111723	75111778	0	56	292516	7145	292516	7089	0.0	41.26336577796586
chr10	ZNF503-AS1	75358708	75359049	0	342	16636	5296	16636	4954	0.0	3.358094469115866
chr10	ZNF503-AS1	75343331	75343340	0	10	16636	5296	16636	5286	0.0	3.1471812334468408
chr10	ZNF503-AS2	75403084	75403351	0	268	0	3233	0	2965	0.0	0.0
chr10	ZNF503-AS2	75403947	75404057	0	111	0	3233	0	3122	0.0	0.0
chr10	RPS24	78037983	78037993	0	11	0	7223	0	7212	0.0	0.0
chr10	LINC00595	78301789	78302121	0	333	0	10323	0	9990	0.0	0.0
chr10	ZMIZ1	79299189	79299191	0	3	10319	6896	10319	6893	0.0	1.4970259683737124
chr10	PPIF	79351584	79351714	232	131	1511	2677	1279	2546	1.7709923664122138	0.502356637863315
chr10	TMEM254	80081735	80081741	0	7	0	3006	0	2999	0.0	0.0
chr10	LINC00857	80208232	80208241	0	10	0	2511	0	2501	0.0	0.0
chr10	NRG3	81878021	81878095	0	75	102	5209	102	5134	0.0	0.019867549668874173
chr10	CDHR1	84212293	84212407	0	115	51	7747	51	7632	0.0	0.0066823899371069185
chr10	LINC00858	84280066	84280109	0	44	0	4591	0	4547	0.0	0.0
chr10	LINC00858	84288672	84288696	0	25	0	4591	0	4566	0.0	0.0
chr10	LINC01520	85450177	85450206	0	30	0	1531	0	1501	0.0	0.0
chr10	LINC00863	87343138	87343405	0	268	0	5495	0	5227	0.0	0.0
chr10	AL157400.2	89645458	89645499	0	42	612	2086	612	2044	0.0	0.299412915851272
chr10	AL157400.2	89648999	89649021	0	23	612	2086	612	2063	0.0	0.29665535627726614
chr10	KIF20B	89701681	89701717	0	37	28466	6904	28466	6867	0.0	4.145332750837338
chr10	RPP30	90872069	90872134	0	66	0	4432	0	4366	0.0	0.0
chr10	LGI1	93758360	93758368	0	9	85940	8705	85940	8696	0.0	9.882704691812327
chr10	LGI1	93758365	93758368	0	4	85940	8705	85940	8701	0.0	9.877025629238018
chr10	LGI1	93758009	93758368	84	360	85940	8705	85856	8345	0.23333333333333334	10.28831635710006
chr10	LGI1	93758277	93758368	0	92	85940	8705	85940	8613	0.0	9.977940322767909
chr10	LGI1	93790171	93790233	165	63	85940	8705	85775	8642	2.619047619047619	9.925364498958574
chr10	LGI1	93758009	93758359	84	351	85940	8705	85856	8354	0.23931623931623933	10.277232463490543
chr10	LGI1	93758277	93758359	0	83	85940	8705	85940	8622	0.0	9.967524936209696
chr10	LGI1	93758360	93758364	0	5	85940	8705	85940	8700	0.0	9.87816091954023
chr10	LGI1	93758009	93758364	84	356	85940	8705	85856	8349	0.23595505617977527	10.283387232003832
chr10	LGI1	93758277	93758364	0	88	85940	8705	85940	8617	0.0	9.973308576070558
chr10	LGI1	93758009	93758276	84	268	85940	8705	85856	8437	0.31343283582089554	10.176128955789972
chr10	LGI1	93758832	93759291	714	460	85940	8705	85226	8245	1.5521739130434782	10.33668890236507
chr10	SLC35G1	93894161	93894211	36	51	1246	5890	1210	5839	0.7058823529411765	0.20722726494262717
chr10	PLCE1	94089146	94089376	147	231	39279	13715	39132	13484	0.6363636363636364	2.9021061999406705
chr10	PLCE1	94282833	94282940	408	108	39279	13715	38871	13607	3.7777777777777777	2.8566914088336883
chr10	HELLS	94545908	94545952	0	45	1071	8582	1071	8537	0.0	0.12545390652454025
chr10	ACSM6	95202186	95202195	72	10	30918	2819	30846	2809	7.2	10.981132075471699
chr10	LCOR	96832396	96832399	0	4	3745	26377	3745	26373	0.0	0.1420012891972851
chr10	LCOR	96955455	96955834	0	380	3745	26377	3745	25997	0.0	0.14405508327883987
chr10	LCOR	96955672	96955834	0	163	3745	26377	3745	26214	0.0	0.14286259250782024
chr10	LCOR	96955835	96955957	0	123	3745	26377	3745	26254	0.0	0.1426449302963358
chr10	LCOR	96955455	96955957	0	503	3745	26377	3745	25874	0.0	0.14473989332921078
chr10	LCOR	96955672	96955957	0	286	3745	26377	3745	26091	0.0	0.14353608524012113
chr10	LCOR	96833115	96833122	0	8	3745	26377	3745	26369	0.0	0.14202282983806744
chr10	LCOR	96833119	96833122	0	4	3745	26377	3745	26373	0.0	0.1420012891972851
chr10	LCOR	96833115	96833479	0	365	3745	26377	3745	26012	0.0	0.14397201291711517
chr10	LCOR	96833123	96833479	0	357	3745	26377	3745	26020	0.0	0.14392774788624135
chr10	LCOR	96833119	96833479	0	361	3745	26377	3745	26016	0.0	0.14394987699877
chr10	LCOR	96955455	96955671	0	217	3745	26377	3745	26160	0.0	0.14315749235474007
chr10	LCOR	96833115	96833118	0	4	3745	26377	3745	26373	0.0	0.1420012891972851
chr10	ZFYVE27	97737322	97737325	0	4	255	3913	255	3909	0.0	0.06523407521105141
chr10	CUTC	99732410	99732560	0	151	51	1803	51	1652	0.0	0.030871670702179176
chr10	ABCC2	99794000	99794109	0	110	133	7721	133	7611	0.0	0.017474707659965838
chr10	OLMALINC	100374013	100374134	0	122	51	12654	51	12532	0.0	0.004069581870411746
chr10	OLMALINC	100374081	100374134	0	54	51	12654	51	12600	0.0	0.004047619047619047
chr10	OLMALINC	100381449	100381452	0	4	51	12654	51	12650	0.0	0.004031620553359684
chr10	OLMALINC	100374013	100374083	0	71	51	12654	51	12583	0.0	0.004053087499006596
chr10	OLMALINC	100374081	100374083	0	3	51	12654	51	12651	0.0	0.004031301873369694
chr10	OLMALINC	100374013	100374080	0	68	51	12654	51	12586	0.0	0.00405212140473542
chr10	HIF1AN	100536051	100536135	0	85	204	13903	204	13818	0.0	0.014763352149370386
chr10	PAX2	100781342	100781365	0	24	102	6389	102	6365	0.0	0.016025137470542027
chr10	SEMA4G	100969592	100969924	51	333	51	4726	0	4393	0.15315315315315314	0.0
chr10	SEMA4G	100983809	100984357	0	549	51	4726	51	4177	0.0	0.01220971989466124
chr10	SEMA4G	100980983	100980997	0	15	51	4726	51	4711	0.0	0.010825727021863723
chr10	TWNK	100991011	100991054	0	44	0	3960	0	3916	0.0	0.0
chr10	TWNK	100987614	100989453	0	1840	0	3960	0	2120	0.0	0.0
chr10	TWNK	100987881	100989453	0	1573	0	3960	0	2387	0.0	0.0
chr10	TWNK	100990544	100990663	0	120	0	3960	0	3840	0.0	0.0
chr10	NOLC1	102159309	102159338	0	30	51	3983	51	3953	0.0	0.012901593726283835
chr10	GBF1	102245782	102245880	0	99	16712	19267	16712	19168	0.0	0.8718697829716193
chr10	GBF1	102358695	102358729	0	35	16712	19267	16712	19232	0.0	0.8689683860232945
chr10	GBF1	102362629	102362664	0	36	16712	19267	16712	19231	0.0	0.8690135718371379
chr10	GBF1	102365556	102365599	0	44	16712	19267	16712	19223	0.0	0.8693752275919472
chr10	GBF1	102375480	102375584	0	105	16712	19267	16712	19162	0.0	0.8721427825905438
chr10	GBF1	102376426	102376432	0	7	16712	19267	16712	19260	0.0	0.8677050882658359
chr10	GBF1	102376422	102376432	0	11	16712	19267	16712	19256	0.0	0.8678853344412131
chr10	GBF1	102376785	102376800	0	16	16712	19267	16712	19251	0.0	0.8681107474936367
chr10	GBF1	102376789	102376800	0	12	16712	19267	16712	19255	0.0	0.8679304076863152
chr10	GBF1	102377129	102377140	0	12	16712	19267	16712	19255	0.0	0.8679304076863152
chr10	GBF1	102379430	102379434	0	5	16712	19267	16712	19262	0.0	0.8676149932509605
chr10	GBF1	102379652	102379729	0	78	16712	19267	16712	19189	0.0	0.8709156287456356
chr10	GBF1	102354445	102354468	0	24	16712	19267	16712	19243	0.0	0.8684716520293093
chr10	GBF1	102376422	102376425	0	4	16712	19267	16712	19263	0.0	0.8675699527591756
chr10	GBF1	102376785	102376788	0	4	16712	19267	16712	19263	0.0	0.8675699527591756
chr10	GBF1	102376801	102376804	0	4	16712	19267	16712	19263	0.0	0.8675699527591756
chr10	GBF1	102376785	102376804	0	20	16712	19267	16712	19247	0.0	0.8682911622590533
chr10	GBF1	102376789	102376804	0	16	16712	19267	16712	19251	0.0	0.8681107474936367
chr10	GBF1	102379556	102379651	0	96	16712	19267	16712	19171	0.0	0.8717333472432319
chr10	NFKB2	102394556	102394600	0	45	0	4681	0	4636	0.0	0.0
chr10	NFKB2	102394556	102394774	0	219	0	4681	0	4462	0.0	0.0
chr10	NFKB2	102394601	102394774	0	174	0	4681	0	4507	0.0	0.0
chr10	RPARP-AS1	102450331	102450360	0	30	357	4289	357	4259	0.0	0.08382249354308523
chr10	SFXN2	102726778	102726797	0	20	139483	7940	139483	7920	0.0	17.6114898989899
chr10	SFXN2	102714682	102714995	48	314	139483	7940	139435	7626	0.15286624203821655	18.28415945449777
chr10	ADD3	110125925	110125945	0	21	0	6311	0	6290	0.0	0.0
chr10	MXI1	110244858	110244873	0	16	121	5912	121	5896	0.0	0.020522388059701493
chr10	MXI1	110226284	110226386	0	103	121	5912	121	5809	0.0	0.020829746944396627
chr10	MXI1	110226351	110226386	0	36	121	5912	121	5876	0.0	0.02059223961878829
chr10	MXI1	110226284	110226350	0	67	121	5912	121	5845	0.0	0.020701454234388367
chr10	MXI1	110226819	110226852	0	34	121	5912	121	5878	0.0	0.02058523307247363
chr10	MXI1	110226831	110226852	0	22	121	5912	121	5890	0.0	0.020543293718166385
chr10	MXI1	110226835	110226852	0	18	121	5912	121	5894	0.0	0.020529351883271124
chr10	MXI1	110226819	110226830	0	12	121	5912	121	5900	0.0	0.020508474576271186
chr10	MXI1	110226819	110226834	0	16	121	5912	121	5896	0.0	0.020522388059701493
chr10	MXI1	110226831	110226834	0	4	121	5912	121	5908	0.0	0.02048070412999323
chr10	MXI1	110226853	110226885	0	33	121	5912	121	5879	0.0	0.020581731587004593
chr10	MXI1	110226875	110226885	0	11	121	5912	121	5901	0.0	0.020504999152685985
chr10	MXI1	110227101	110227118	0	18	121	5912	121	5894	0.0	0.020529351883271124
chr10	MXI1	110227143	110227162	0	20	121	5912	121	5892	0.0	0.02053632043448744
chr10	MXI1	110227203	110227213	0	11	121	5912	121	5901	0.0	0.020504999152685985
chr10	MXI1	110227338	110227354	0	17	121	5912	121	5895	0.0	0.020525869380831212
chr10	MXI1	110227355	110227398	0	44	121	5912	121	5868	0.0	0.02062031356509884
chr10	MXI1	110227338	110227398	0	61	121	5912	121	5851	0.0	0.02068022560246112
chr10	MXI1	110227378	110227398	0	21	121	5912	121	5891	0.0	0.02053980648446783
chr10	MXI1	110227387	110227398	0	12	121	5912	121	5900	0.0	0.020508474576271186
chr10	MXI1	110227355	110227406	0	52	121	5912	121	5860	0.0	0.020648464163822527
chr10	MXI1	110227399	110227406	0	8	121	5912	121	5904	0.0	0.02049457994579946
chr10	MXI1	110227378	110227406	0	29	121	5912	121	5883	0.0	0.020567737548869626
chr10	MXI1	110227387	110227406	0	20	121	5912	121	5892	0.0	0.02053632043448744
chr10	MXI1	110227355	110227377	0	23	121	5912	121	5889	0.0	0.02054678213618611
chr10	MXI1	110227378	110227386	0	9	121	5912	121	5903	0.0	0.02049805183804845
chr10	MXI1	110227543	110227785	0	243	121	5912	121	5669	0.0	0.02134415240783207
chr10	MXI1	110227786	110227882	0	97	121	5912	121	5815	0.0	0.020808254514187448
chr10	MXI1	110280086	110280147	0	62	121	5912	121	5850	0.0	0.020683760683760682
chr10	TCF7L2	113144014	113144025	0	12	0	6478	0	6466	0.0	0.0
chr10	TCF7L2	113129373	113129987	0	615	0	6478	0	5863	0.0	0.0
chr10	TCF7L2	113129815	113129987	0	173	0	6478	0	6305	0.0	0.0
chr10	PLEKHS1	113774994	113775035	0	42	0	5610	0	5568	0.0	0.0
chr10	PLEKHS1	113755306	113755405	0	100	0	5610	0	5510	0.0	0.0
chr10	VWA2	114284971	114284974	0	4	918	6367	918	6363	0.0	0.14427157001414428
chr10	AL137025.1	114764969	114764992	0	24	714	2927	714	2903	0.0	0.24595246296934206
chr10	AL137025.1	114776162	114776165	0	4	714	2927	714	2923	0.0	0.24426958604173793
chr10	AL137025.1	114776162	114776292	0	131	714	2927	714	2796	0.0	0.2553648068669528
chr10	AL137025.1	114776166	114776292	0	127	714	2927	714	2800	0.0	0.255
chr10	ATRNL1	115093637	115094043	0	407	256	9992	256	9585	0.0	0.026708398539384455
chr10	PNLIPRP1	116590996	116591039	0	44	22506	4644	22506	4600	0.0	4.892608695652174
chr10	LINC02674	117735094	117735122	0	29	0	1050	0	1021	0.0	0.0
chr10	AL354863.1	118241683	118241745	0	63	714	3474	714	3411	0.0	0.20932277924362358
chr10	AL354863.1	118241887	118242093	0	207	714	3474	714	3267	0.0	0.21854912764003673
chr10	DENND10	119105007	119105022	0	16	18635	5796	18635	5780	0.0	3.2240484429065743
chr10	INPP5F	119792212	119792213	0	2	4090	7441	4090	7439	0.0	0.5498050813281355
chr10	INPP5F	119819540	119819834	0	295	4090	7441	4090	7146	0.0	0.572348166806605
chr10	AC023282.1	120819829	120821102	56932	1274	173255	6283	116323	5009	44.687598116169546	23.222798961868637
chr10	WDR11	120851507	120851527	0	21	9454	7675	9454	7654	0.0	1.2351711523386464
chr10	WDR11	120851528	120851591	0	64	9454	7675	9454	7611	0.0	1.2421495204309552
chr10	WDR11	120851507	120851591	0	85	9454	7675	9454	7590	0.0	1.2455862977602108
chr10	TACC2	122211423	122211708	0	286	18255	18193	18255	17907	0.0	1.0194337409951415
chr10	TACC2	122088592	122088738	0	147	18255	18193	18255	18046	0.0	1.0115815139088995
chr10	TACC2	122216829	122216921	6406	93	18255	18193	11849	18100	68.88172043010752	0.6546408839779005
chr10	PLEKHA1	122374807	122374847	0	41	3050	22851	3050	22810	0.0	0.13371328364752302
chr10	PLEKHA1	122428317	122428420	0	104	3050	22851	3050	22747	0.0	0.13408361542181388
chr10	DMBT1L1	122820396	122820550	46	155	1249	8183	1203	8028	0.2967741935483871	0.14985052316890882
chr10	C10ORF88B	122880757	122880873	0	117	51	2143	51	2026	0.0	0.025172754195459033
chr10	ACADSB	123009068	123009071	0	4	418	6246	418	6242	0.0	0.06696571611662928
chr10	LINC02641	123489011	123489045	0	35	2193	5335	2193	5300	0.0	0.41377358490566035
chr10	FANK1	125973594	125973767	0	174	0	3163	0	2989	0.0	0.0
chr10	PTPRE	128070902	128071741	0	840	23724	9038	23724	8198	0.0	2.8938765552573797
chr10	LINC01163	128181157	128181212	0	56	0	3197	0	3141	0.0	0.0
chr10	LINC02667	128912918	128912982	23	65	125	1874	102	1809	0.35384615384615387	0.05638474295190713
chr10	JAKMIP3	132142043	132142048	0	6	0	12408	0	12402	0.0	0.0
chr10	JAKMIP3	132150036	132150041	0	6	0	12408	0	12402	0.0	0.0
chr10	JAKMIP3	132065290	132066061	0	772	0	12408	0	11636	0.0	0.0
chr10	JAKMIP3	132169933	132171255	0	1323	0	12408	0	11085	0.0	0.0
chr10	JAKMIP3	132170253	132171255	0	1003	0	12408	0	11405	0.0	0.0
chr10	JAKMIP3	132170916	132171255	0	340	0	12408	0	12068	0.0	0.0
chr10	JAKMIP3	132169933	132170252	0	320	0	12408	0	12088	0.0	0.0
chr10	JAKMIP3	132169933	132170915	0	983	0	12408	0	11425	0.0	0.0
chr10	JAKMIP3	132170253	132170915	0	663	0	12408	0	11745	0.0	0.0
chr10	PWWP2B	132405987	132406289	0	303	0	2650	0	2347	0.0	0.0
chr10	INPP5A	132781898	132781948	0	51	0	3756	0	3705	0.0	0.0
chr10	ADGRA1	133127329	133127331	0	3	0	6521	0	6518	0.0	0.0
chr10	PRAP1	133352114	133352140	0	27	0	754	0	727	0.0	0.0
chr10	PAOX	133391429	133391491	0	63	0	2260	0	2197	0.0	0.0
chr11	PSMD13	244706	244761	113194	56	1526979	2848	1413785	2792	2021.3214285714287	506.36998567335246
chr11	PSMD13	251937	251945	54	9	1526979	2848	1526925	2839	6.0	537.8390278266995
chr11	AC136475.3	288800	288811	0	12	612	738	612	726	0.0	0.8429752066115702
chr11	PKP3	393518	393534	0	17	37195	3762	37195	3745	0.0	9.931909212283044
chr11	LMNTD2-AS1	559477	559683	77	207	599	1123	522	916	0.3719806763285024	0.5698689956331878
chr11	RASSF7	561034	561477	1326	444	88742	2441	87416	1997	2.9864864864864864	43.773660490736106
chr11	RASSF7	563318	563478	6500	161	88742	2441	82242	2280	40.37267080745342	36.07105263157895
chr11	PHRF1	581598	581606	670	9	573985	5803	573315	5794	74.44444444444444	98.94977562996203
chr11	TMEM80	695823	695846	1077	24	126061	2241	124984	2217	44.875	56.37528191249436
chr11	EPS8L2	721188	721206	107	19	16540	4588	16433	4569	5.631578947368421	3.5966294594003063
chr11	EPS8L2	706802	706813	60	12	16540	4588	16480	4576	5.0	3.6013986013986012
chr11	TALDO1	763941	763944	2788	4	1162017	2916	1159229	2912	697.0	398.08688186813185
chr11	RPLP2	810322	810357	198265	36	2817198	1421	2618933	1385	5507.361111111111	1890.9263537906138
chr11	RPLP2	810049	810357	514489	309	2817198	1421	2302709	1112	1665.0129449838187	2070.781474820144
chr11	CRACR2B	827319	827459	0	141	22384	3193	22384	3052	0.0	7.334207077326344
chr11	CD151	837613	837618	17942	6	1581008	3539	1563066	3533	2990.3333333333335	442.4189074440985
chr11	CD151	833023	833026	5302	4	1581008	3539	1575706	3535	1325.5	445.7442715700141
chr11	CD151	834592	834745	440	154	1581008	3539	1580568	3385	2.857142857142857	466.93293943870015
chr11	CD151	834592	834803	491	212	1581008	3539	1580517	3327	2.3160377358490565	475.0577096483318
chr11	CD151	834746	834803	51	58	1581008	3539	1580957	3481	0.8793103448275862	454.1674806090204
chr11	BRSK2	1459237	1459239	0	3	1862	6414	1862	6411	0.0	0.2904383091561379
chr11	SYT8	1834602	1834617	0	16	0	3521	0	3505	0.0	0.0
chr11	LSP1	1870566	1871412	0	847	0	6021	0	5174	0.0	0.0
chr11	LSP1	1870662	1871412	0	751	0	6021	0	5270	0.0	0.0
chr11	LSP1	1870974	1871412	0	439	0	6021	0	5582	0.0	0.0
chr11	LSP1	1870566	1870661	0	96	0	6021	0	5925	0.0	0.0
chr11	MRPL23	1955718	1955781	0	64	34	2986	34	2922	0.0	0.01163586584531143
chr11	TSPAN32	2302216	2302222	0	7	0	2972	0	2965	0.0	0.0
chr11	TSPAN32	2313709	2313755	0	47	0	2972	0	2925	0.0	0.0
chr11	TSSC4	2401980	2402147	117	168	1326	2556	1209	2388	0.6964285714285714	0.5062814070351759
chr11	TSSC2	3406611	3406715	51	105	9692	3680	9641	3575	0.4857142857142857	2.6967832167832166
chr11	TRPC2	3636237	3636240	0	4	0	3280	0	3276	0.0	0.0
chr11	PGAP2	3824365	3824376	0	12	752	3571	752	3559	0.0	0.21129530767069402
chr11	PGAP2	3824377	3824455	0	79	752	3571	752	3492	0.0	0.21534936998854526
chr11	PGAP2	3824365	3824455	0	91	752	3571	752	3480	0.0	0.2160919540229885
chr11	PGAP2	3824450	3824455	0	6	752	3571	752	3565	0.0	0.21093969144460029
chr11	PGAP2	3797983	3798100	0	118	752	3571	752	3453	0.0	0.21778163915435853
chr11	PGAP2	3824377	3824449	0	73	752	3571	752	3498	0.0	0.21497998856489423
chr11	PGAP2	3824365	3824449	0	85	752	3571	752	3486	0.0	0.2157200229489386
chr11	STIM1	4086544	4086861	0	318	27738	6805	27738	6487	0.0	4.275936488361338
chr11	STIM1	3947668	3947724	0	57	27738	6805	27738	6748	0.0	4.110551274451689
chr11	RRM1	4119929	4119970	0	42	131814	4257	131814	4215	0.0	31.272597864768684
chr11	TRIM6	5604630	5604797	0	168	153	3973	153	3805	0.0	0.040210249671484885
chr11	CCKBR	6270804	6270818	0	15	0	2398	0	2383	0.0	0.0
chr11	SMPD1	6392157	6392196	0	40	0	2455	0	2415	0.0	0.0
chr11	SMPD1	6391504	6392196	0	693	0	2455	0	1762	0.0	0.0
chr11	SMPD1	6391504	6392156	0	653	0	2455	0	1802	0.0	0.0
chr11	DNHD1	6534174	6534229	296	56	283334	18420	283038	18364	5.285714285714286	15.412655194946634
chr11	DNHD1	6563132	6563255	2078	124	283334	18420	281256	18296	16.758064516129032	15.372540445999125
chr11	ZNF215	6926686	6926861	51	176	51	5918	0	5742	0.2897727272727273	0.0
chr11	ZNF215	6926729	6926861	35	133	51	5918	16	5785	0.2631578947368421	0.002765773552290406
chr11	ZNF215	6926686	6926728	16	43	51	5918	35	5875	0.37209302325581395	0.005957446808510639
chr11	OLFML1	7488151	7488415	0	265	0	3439	0	3174	0.0	0.0
chr11	PPFIBP2	7655449	7655498	0	50	0	8897	0	8847	0.0	0.0
chr11	PPFIBP2	7641066	7641083	0	18	0	8897	0	8879	0.0	0.0
chr11	EIF3F	7991852	7991971	0	120	306	8989	306	8869	0.0	0.03450219866952306
chr11	AMPD3	10493544	10493702	0	159	765	6622	765	6463	0.0	0.11836608386198359
chr11	ZBED5-AS1	10858352	10858366	0	15	18091	4558	18091	4543	0.0	3.9821703720008803
chr11	ZBED5-AS1	10858280	10858366	0	87	18091	4558	18091	4471	0.0	4.046298367255647
chr11	ZBED5-AS1	10858280	10858351	0	72	18091	4558	18091	4486	0.0	4.0327686134641105
chr11	ZBED5-AS1	10858367	10858942	714	576	18091	4558	17377	3982	1.2395833333333333	4.363887493721748
chr11	ZBED5-AS1	10858352	10858942	714	591	18091	4558	17377	3967	1.2081218274111676	4.380388202672044
chr11	ZBED5-AS1	10858280	10858942	714	663	18091	4558	17377	3895	1.0769230769230769	4.461360718870346
chr11	ZBED5-AS1	10858943	10859112	0	170	18091	4558	18091	4388	0.0	4.122835004557885
chr11	MICAL2	12138461	12138464	0	4	29104	16154	29104	16150	0.0	1.8021052631578947
chr11	MICAL2	12161533	12161576	0	44	29104	16154	29104	16110	0.0	1.8065797641216637
chr11	MICAL2	12262538	12262635	58	98	29104	16154	29046	16056	0.5918367346938775	1.8090433482810164
chr11	LINC02548	13845096	13845186	0	91	0	2483	0	2392	0.0	0.0
chr11	PDE3B	14786533	14786685	0	153	549	11644	549	11491	0.0	0.04777652075537377
chr11	LINC02682	15922652	15922655	0	4	0	3435	0	3431	0.0	0.0
chr11	NUCB2	17276829	17276848	0	20	191245	9053	191245	9033	0.0	21.171814458098083
chr11	SAA1	18269334	18269364	0	31	0	714	0	683	0.0	0.0
chr11	SAA1	18266297	18266443	0	147	0	714	0	567	0.0	0.0
chr11	GTF2H1	18326020	18326153	0	134	17124	6442	17124	6308	0.0	2.7146480659480026
chr11	LDHA	18394637	18394641	0	5	408	4566	408	4561	0.0	0.08945406709055032
chr11	LDHA	18394642	18394886	0	245	408	4566	408	4321	0.0	0.09442258736403611
chr11	LDHA	18394637	18394886	0	250	408	4566	408	4316	0.0	0.09453197405004633
chr11	LDHC	18412409	18412462	0	54	2392	2097	2392	2043	0.0	1.1708272148800782
chr11	SPTY2D1OS	18601165	18601180	0	16	10741	2291	10741	2275	0.0	4.721318681318682
chr11	HTATIP2	20363750	20363798	0	49	0	2801	0	2752	0.0	0.0
chr11	HTATIP2	20363750	20363912	0	163	0	2801	0	2638	0.0	0.0
chr11	HTATIP2	20363799	20363912	0	114	0	2801	0	2687	0.0	0.0
chr11	PRMT3	20387775	20388154	0	380	3154	5499	3154	5119	0.0	0.6161359640554795
chr11	BBOX1	27041020	27041028	0	9	0	2152	0	2143	0.0	0.0
chr11	BDNF-AS	27658463	27658544	0	82	122520	12372	122520	12290	0.0	9.969080553295361
chr11	BDNF-AS	27658463	27658620	0	158	122520	12372	122520	12214	0.0	10.031111838873423
chr11	BDNF-AS	27658545	27658620	0	76	122520	12372	122520	12296	0.0	9.964216005204944
chr11	LINC02546	29594407	29594441	0	35	0	2969	0	2934	0.0	0.0
chr11	LINC02546	29622914	29623076	0	163	0	2969	0	2806	0.0	0.0
chr11	LINC02546	29618860	29619001	0	142	0	2969	0	2827	0.0	0.0
chr11	FSHB	30231049	30231078	0	30	0	1956	0	1926	0.0	0.0
chr11	DNAJC24	31426356	31426480	0	125	1173	6529	1173	6404	0.0	0.18316677076826984
chr11	ELP4	31594902	31594905	0	4	19299	23173	19299	23169	0.0	0.8329664638094005
chr11	TCP11L1	33039793	33041316	51	1524	4539	5147	4488	3623	0.03346456692913386	1.2387524151255864
chr11	TCP11L1	33040203	33041316	51	1114	4539	5147	4488	4033	0.04578096947935368	1.1128192412596083
chr11	TCP11L1	33040207	33041316	51	1110	4539	5147	4488	4037	0.04594594594594595	1.111716621253406
chr11	TCP11L1	33040388	33041316	51	929	4539	5147	4488	4218	0.05489773950484392	1.0640113798008535
chr11	TCP11L1	33040203	33040206	0	4	4539	5147	4539	5143	0.0	0.8825588178106164
chr11	TCP11L1	33040203	33040387	0	185	4539	5147	4539	4962	0.0	0.914752116082225
chr11	TCP11L1	33040207	33040387	0	181	4539	5147	4539	4966	0.0	0.9140153040676601
chr11	KIAA1549L	33542147	33544336	102	2190	18319	13519	18217	11329	0.04657534246575343	1.6079971753905906
chr11	KIAA1549L	33544337	33544354	0	18	18319	13519	18319	13501	0.0	1.3568624546329902
chr11	CD44	35189973	35190065	0	93	2183374	9710	2183374	9617	0.0	227.03275449724447
chr11	IFTAP	36594593	36594761	0	169	1173	10397	1173	10228	0.0	0.11468517794290184
chr11	IFTAP	36594642	36594761	0	120	1173	10397	1173	10277	0.0	0.11413836722779021
chr11	IFTAP	36594593	36594915	0	323	1173	10397	1173	10074	0.0	0.11643835616438356
chr11	IFTAP	36594762	36594915	0	154	1173	10397	1173	10243	0.0	0.11451723127989846
chr11	IFTAP	36594642	36594915	0	274	1173	10397	1173	10123	0.0	0.11587474068951892
chr11	IFTAP	36594593	36594641	0	49	1173	10397	1173	10348	0.0	0.11335523772709702
chr11	LINC01493	38648841	38648934	0	94	0	2429	0	2335	0.0	0.0
chr11	HSD17B12	43680805	43680987	0	183	1275	4696	1275	4513	0.0	0.2825171726124529
chr11	HSD17B12	43680805	43681183	0	379	1275	4696	1275	4317	0.0	0.2953439888811675
chr11	HSD17B12	43680988	43681183	0	196	1275	4696	1275	4500	0.0	0.2833333333333333
chr11	ALKBH3	43881180	43881446	11389	267	60763	2155	49374	1888	42.655430711610485	26.151483050847457
chr11	ACCS	44067775	44067778	0	4	63	4458	63	4454	0.0	0.01414458913336327
chr11	ACCS	44067779	44067915	0	137	63	4458	63	4321	0.0	0.014579958342976164
chr11	ACCS	44067775	44067915	0	141	63	4458	63	4317	0.0	0.014593467685892982
chr11	ACCS	44066323	44066701	0	379	63	4458	63	4079	0.0	0.015444962000490316
chr11	CD82	44565737	44566000	0	264	1762	3641	1762	3377	0.0	0.521764880071069
chr11	AC044839.1	45722379	45722457	0	79	0	6744	0	6665	0.0	0.0
chr11	AC044839.1	45723573	45723582	0	10	0	6744	0	6734	0.0	0.0
chr11	AC044839.1	45722458	45722833	0	376	0	6744	0	6368	0.0	0.0
chr11	AC044839.1	45722532	45722833	0	302	0	6744	0	6442	0.0	0.0
chr11	AC044839.1	45722458	45722531	0	74	0	6744	0	6670	0.0	0.0
chr11	SLC35C1	45804421	45804517	0	97	51	3372	51	3275	0.0	0.015572519083969465
chr11	AC024475.3	46171989	46172024	0	36	140	1637	140	1601	0.0	0.08744534665833854
chr11	DGKZ	46366527	46366984	0	458	20198	8820	20198	8362	0.0	2.4154508490791677
chr11	MDK	46381184	46381328	0	145	4089	2201	4089	2056	0.0	1.9888132295719845
chr11	MDK	46381289	46381328	0	40	4089	2201	4089	2161	0.0	1.8921795465062472
chr11	MDK	46381184	46381288	0	105	4089	2201	4089	2096	0.0	1.9508587786259541
chr11	MDK	46381759	46382133	612	375	4089	2201	3477	1826	1.632	1.9041621029572837
chr11	MDK	46381759	46381885	612	127	4089	2201	3477	2074	4.818897637795276	1.6764705882352942
chr11	MDK	46382749	46383193	153	445	4089	2201	3936	1756	0.3438202247191011	2.2414578587699316
chr11	ATG13	46668577	46668690	0	114	8037	5435	8037	5321	0.0	1.5104303702311594
chr11	F2	46728721	46728837	0	117	54994	2547	54994	2430	0.0	22.63127572016461
chr11	F2	46719315	46719415	0	101	54994	2547	54994	2446	0.0	22.48323793949305
chr11	DDB2	47215264	47215272	0	9	11485	4822	11485	4813	0.0	2.386245584874299
chr11	NR1H3	47257636	47257735	1177	100	281701	4063	280524	3963	11.77	70.78576835730507
chr11	NR1H3	47258130	47258165	261	36	281701	4063	281440	4027	7.25	69.8882542835858
chr11	NR1H3	47258130	47259259	33296	1130	281701	4063	248405	2933	29.465486725663716	84.69314694851688
chr11	MADD	47285066	47285194	0	129	75005	8408	75005	8279	0.0	9.05966904215485
chr11	MADD	47295568	47295579	0	12	75005	8408	75005	8396	0.0	8.933420676512625
chr11	MADD	47295577	47295579	0	3	75005	8408	75005	8405	0.0	8.92385484830458
chr11	MADD	47269751	47269906	0	156	75005	8408	75005	8252	0.0	9.089311682016481
chr11	MADD	47295568	47295576	0	9	75005	8408	75005	8399	0.0	8.930229789260625
chr11	SLC39A13	47414906	47414909	0	4	0	3873	0	3869	0.0	0.0
chr11	NDUFS3	47579335	47579338	0	4	2995	4322	2995	4318	0.0	0.6936081519221862
chr11	P2RX3	57368101	57368102	0	2	291	4446	291	4444	0.0	0.06548154815481548
chr11	P2RX3	57348264	57348354	0	91	291	4446	291	4355	0.0	0.06681974741676235
chr11	SMTNL1	57543342	57543374	150	33	6276	1577	6126	1544	4.545454545454546	3.9676165803108807
chr11	CLP1	57659891	57660082	0	192	0	2176	0	1984	0.0	0.0
chr11	SELENOH	57742228	57742247	0	20	0	1851	0	1831	0.0	0.0
chr11	CTNND1	57762047	57762119	0	73	720	9351	720	9278	0.0	0.0776029316663074
chr11	CTNND1	57762069	57762119	0	51	720	9351	720	9300	0.0	0.07741935483870968
chr11	CTNND1	57762047	57762068	0	22	720	9351	720	9329	0.0	0.0771786901061207
chr11	CTNND1	57762120	57762318	51	199	720	9351	669	9152	0.2562814070351759	0.07309877622377622
chr11	GLYATL1	58947069	58947165	0	97	7038	4761	7038	4664	0.0	1.5090051457975986
chr11	FAM111A	59144897	59145856	0	960	107	6384	107	5424	0.0	0.019727138643067847
chr11	FAM111A	59142947	59142969	0	23	107	6384	107	6361	0.0	0.016821254519729604
chr11	FAM111A	59144897	59144900	0	4	107	6384	107	6380	0.0	0.01677115987460815
chr11	OR5AN1	59359273	59360093	3322	821	152607	8504	149285	7683	4.046285018270402	19.430560978784328
chr11	AP000442.1	59635533	59635536	0	4	2208	1810	2208	1806	0.0	1.2225913621262459
chr11	MS4A7	60378617	60378664	0	48	357	3914	357	3866	0.0	0.09234350750129333
chr11	MS4A14	60397981	60398171	0	191	26	4014	26	3823	0.0	0.006800941668846455
chr11	MS4A12	60492829	60493032	134	204	204	1846	70	1642	0.6568627450980392	0.04263093788063337
chr11	MS4A8	60708729	60708781	405	53	50013	2227	49608	2174	7.6415094339622645	22.818767249310028
chr11	MS4A18	60729787	60729792	0	6	0	1427	0	1421	0.0	0.0
chr11	TMEM132A	60924544	60924733	442	190	3761	5092	3319	4902	2.3263157894736843	0.6770705834353326
chr11	TKFC	61333313	61333329	0	17	0	7716	0	7699	0.0	0.0
chr11	TMEM138	61364316	61364518	0	203	51	4888	51	4685	0.0	0.010885805763073639
chr11	TMEM216	61392666	61392679	0	14	40	1687	40	1673	0.0	0.023909145248057383
chr11	SDHAF2	61438114	61438120	0	7	4	1702	4	1695	0.0	0.002359882005899705
chr11	AP003108.1	61499328	61499333	0	6	2910	1619	2910	1613	0.0	1.8040917544947304
chr11	AP003108.1	61499836	61499896	25	61	2910	1619	2885	1558	0.4098360655737705	1.8517329910141207
chr11	AP002754.1	61588475	61588615	703	141	4817	2760	4114	2619	4.98581560283688	1.5708285605192822
chr11	DAGLA	61720868	61720890	0	23	2014240	5819	2014240	5796	0.0	347.5224292615597
chr11	MYRF	61783926	61784027	51	102	1453	9103	1402	9001	0.5	0.15576047105877125
chr11	FEN1	61793029	61793210	0	182	102	1594	102	1412	0.0	0.07223796033994334
chr11	FADS2	61816427	61816696	0	270	36	8306	36	8036	0.0	0.004479840716774514
chr11	BEST1	61958299	61958501	0	203	306	5587	306	5384	0.0	0.056835066864784546
chr11	INCENP	62124056	62124163	0	108	6824	3753	6824	3645	0.0	1.8721536351165982
chr11	ROM1	62611921	62612091	0	171	0	1647	0	1476	0.0	0.0
chr11	ROM1	62613776	62613871	0	96	0	1647	0	1551	0.0	0.0
chr11	TTC9C	62728228	62728736	0	509	0	2634	0	2125	0.0	0.0
chr11	POLR2G	62761615	62761660	0	46	0	1552	0	1506	0.0	0.0
chr11	POLR2G	62761905	62762184	0	280	0	1552	0	1272	0.0	0.0
chr11	POLR2G	62762867	62763026	0	160	0	1552	0	1392	0.0	0.0
chr11	SLC3A2	62881316	62881447	0	132	0	3522	0	3390	0.0	0.0
chr11	SLC22A10	63302405	63302543	0	139	78	3299	78	3160	0.0	0.024683544303797468
chr11	MARK2	63904148	63904354	0	207	7176	8854	7176	8647	0.0	0.8298831964843298
chr11	MARK2	63906115	63907567	286	1453	7176	8854	6890	7401	0.19683413626978666	0.9309552763140116
chr11	OTUB1	63986951	63987038	0	88	195007	4956	195007	4868	0.0	40.058956450287596
chr11	NUDT22	64226298	64226427	0	130	0	3038	0	2908	0.0	0.0
chr11	FKBP2	64241748	64241994	0	247	0	1259	0	1012	0.0	0.0
chr11	PPP1R14B-AS1	64246090	64246248	0	159	0	849	0	690	0.0	0.0
chr11	GPR137	64285263	64285380	0	118	51	3606	51	3488	0.0	0.014621559633027524
chr11	GPR137	64285565	64285607	0	43	51	3606	51	3563	0.0	0.014313780522031996
chr11	ESRRA	64306449	64306846	0	398	42	3109	42	2711	0.0	0.01549243821468093
chr11	CCDC88B	64354029	64354170	0	142	51	6744	51	6602	0.0	0.007724931838836716
chr11	RPS6KA4	64359404	64359449	0	46	0	3824	0	3778	0.0	0.0
chr11	SLC22A12	64593458	64593559	0	102	1245	2982	1245	2880	0.0	0.4322916666666667
chr11	SNX15	65027625	65027636	0	12	59900	4844	59900	4832	0.0	12.396523178807946
chr11	SNX15	65032204	65032271	0	68	59900	4844	59900	4776	0.0	12.541876046901173
chr11	SAC3D1	65041867	65041928	0	62	3057	1673	3057	1611	0.0	1.8975791433891993
chr11	ZFPL1	65084783	65084800	0	18	18328	2401	18328	2383	0.0	7.691145614771297
chr11	ZFPL1	65084361	65084378	0	18	18328	2401	18328	2383	0.0	7.691145614771297
chr11	ZFPL1	65085227	65085314	8	88	18328	2401	18320	2313	0.09090909090909091	7.92044963251189
chr11	VPS51	65109496	65109591	0	96	200815	4595	200815	4499	0.0	44.635474549899975
chr11	TM7SF2	65111891	65112067	2437	177	139494	2460	137057	2283	13.768361581920903	60.033727551467365
chr11	TM7SF2	65111982	65112067	730	86	139494	2460	138764	2374	8.488372093023257	58.45155855096883
chr11	TM7SF2	65111891	65111981	1707	91	139494	2460	137787	2369	18.75824175824176	58.162515829463906
chr11	TM7SF2	65112866	65112894	454	29	139494	2460	139040	2431	15.655172413793103	57.19457013574661
chr11	MRPL49	65122341	65122424	42	84	4174	2385	4132	2301	0.5	1.7957409821816601
chr11	MRPL49	65122425	65122464	12	40	4174	2385	4162	2345	0.3	1.7748400852878465
chr11	CAPN1	65181783	65181786	0	4	83832	5821	83832	5817	0.0	14.411552346570398
chr11	CAPN1	65181783	65181806	0	24	83832	5821	83832	5797	0.0	14.461273072278765
chr11	CAPN1	65181787	65181806	0	20	83832	5821	83832	5801	0.0	14.451301499741424
chr11	CAPN1	65181783	65181843	0	61	83832	5821	83832	5760	0.0	14.554166666666667
chr11	CAPN1	65181787	65181843	0	57	83832	5821	83832	5764	0.0	14.544066620402498
chr11	CAPN1	65181807	65181843	0	37	83832	5821	83832	5784	0.0	14.493775933609959
chr11	CAPN1	65182014	65182308	51	295	83832	5821	83781	5526	0.17288135593220338	15.161237785016286
chr11	CAPN1	65182481	65182562	0	82	83832	5821	83832	5739	0.0	14.607422895974908
chr11	CAPN1	65182542	65182562	0	21	83832	5821	83832	5800	0.0	14.453793103448277
chr11	CAPN1	65182481	65182541	0	61	83832	5821	83832	5760	0.0	14.554166666666667
chr11	CAPN1	65182481	65182579	0	99	83832	5821	83832	5722	0.0	14.650821391121985
chr11	CAPN1	65182563	65182579	0	17	83832	5821	83832	5804	0.0	14.443831840110269
chr11	CAPN1	65182542	65182579	0	38	83832	5821	83832	5783	0.0	14.496282206467232
chr11	NEAT1	65423114	65423212	39171	99	729272	21017	690101	20918	395.6666666666667	32.99077349651018
chr11	NEAT1	65423213	65423219	4535	7	729272	21017	724737	21010	647.8571428571429	34.49485959067111
chr11	NEAT1	65423658	65423678	84	21	729272	21017	729188	20996	4.0	34.7298533053915
chr11	ZNRD2	65570740	65570755	0	16	2076	1874	2076	1858	0.0	1.1173304628632938
chr11	EHBP1L1	65582017	65583765	6520	1749	10558	5816	4038	4067	3.727844482561464	0.9928694369313991
chr11	SIPA1	65638183	65638420	5650	238	40736	4641	35086	4403	23.73949579831933	7.9686577333636155
chr11	KAT5	65713056	65713058	0	3	102	3659	102	3656	0.0	0.027899343544857767
chr11	KAT5	65718750	65718775	0	26	102	3659	102	3633	0.0	0.028075970272502065
chr11	SNX32	65834074	65834101	366	28	70062	3148	69696	3120	13.071428571428571	22.338461538461537
chr11	SNX32	65849541	65849582	0	42	70062	3148	70062	3106	0.0	22.556986477784932
chr11	SNX32	65834084	65834101	206	18	70062	3148	69856	3130	11.444444444444445	22.318210862619807
chr11	MUS81	65863658	65863721	0	64	1573	4721	1573	4657	0.0	0.3377710972729225
chr11	TSGA10IP	65945823	65945866	0	44	173	2069	173	2025	0.0	0.0854320987654321
chr11	BANF1	66003330	66003373	1377	44	47359	1298	45982	1254	31.295454545454547	36.6682615629984
chr11	BANF1	66003040	66003070	0	31	47359	1298	47359	1267	0.0	37.37884767166535
chr11	BANF1	66002514	66002570	0	57	47359	1298	47359	1241	0.0	38.16196615632554
chr11	KLC2	66257731	66257871	704	141	48687	3969	47983	3828	4.99290780141844	12.534743991640543
chr11	CNIH2	66282328	66282353	0	26	22171	1769	22171	1743	0.0	12.720022948938611
chr11	RBM4	66638753	66638893	3612	141	16039	6217	12427	6076	25.617021276595743	2.045260039499671
chr11	C11ORF80	66788270	66788273	4	4	2853	3974	2849	3970	1.0	0.717632241813602
chr11	C11ORF80	66801103	66801161	0	59	2853	3974	2853	3915	0.0	0.728735632183908
chr11	KDM2A	67250347	67250798	46038	452	659011	10408	612973	9956	101.85398230088495	61.568200080353556
chr11	ANKRD13D	67300124	67300499	0	376	0	4350	0	3974	0.0	0.0
chr11	RAD9A	67396172	67396175	0	4	118048	3780	118048	3776	0.0	31.26271186440678
chr11	TBC1D10C	67406693	67406738	0	46	964	4302	964	4256	0.0	0.22650375939849623
chr11	RPS6KB2	67433195	67433216	0	22	22	2864	22	2842	0.0	0.007741027445460943
chr11	CABP4	67456418	67456442	0	25	51	5137	51	5112	0.0	0.009976525821596244
chr11	GSTP1	67586212	67586273	0	62	0	1247	0	1185	0.0	0.0
chr11	AP003385.3	67605793	67606044	0	252	0	557	0	305	0.0	0.0
chr11	NDUFV1	67607050	67607076	0	27	0	3785	0	3758	0.0	0.0
chr11	NDUFV1	67607056	67607076	0	21	0	3785	0	3764	0.0	0.0
chr11	NDUFV1	67608458	67608478	0	21	0	3785	0	3764	0.0	0.0
chr11	NDUFV1	67607050	67607055	0	6	0	3785	0	3779	0.0	0.0
chr11	NDUFS8	68032337	68032523	18	187	32031	3779	32013	3592	0.0962566844919786	8.912305122494432
chr11	NDUFS8	68030878	68030961	798	84	32031	3779	31233	3695	9.5	8.45277401894452
chr11	TCIRG1	68041347	68041388	0	42	2776	4293	2776	4251	0.0	0.6530228181604328
chr11	TCIRG1	68043032	68043497	882	466	2776	4293	1894	3827	1.8927038626609443	0.49490462503266264
chr11	PPP6R3	68505250	68505271	81	22	257968	8173	257887	8151	3.6818181818181817	31.638694638694638
chr11	IGHMBP2	68906136	68906238	0	103	3517	8643	3517	8540	0.0	0.41182669789227166
chr11	IGHMBP2	68906201	68906238	0	38	3517	8643	3517	8605	0.0	0.40871586287042416
chr11	IGHMBP2	68915018	68915023	0	6	3517	8643	3517	8637	0.0	0.4072015746208174
chr11	IGHMBP2	68906239	68906242	0	4	3517	8643	3517	8639	0.0	0.40710730408612106
chr11	IGHMBP2	68906136	68906242	0	107	3517	8643	3517	8536	0.0	0.4120196813495783
chr11	IGHMBP2	68906201	68906242	0	42	3517	8643	3517	8601	0.0	0.4089059411696314
chr11	IGHMBP2	68906239	68906384	0	146	3517	8643	3517	8497	0.0	0.4139107920442509
chr11	IGHMBP2	68906243	68906384	0	142	3517	8643	3517	8501	0.0	0.41371603340783436
chr11	IGHMBP2	68906136	68906384	0	249	3517	8643	3517	8394	0.0	0.4189897545866095
chr11	IGHMBP2	68906201	68906384	0	184	3517	8643	3517	8459	0.0	0.4157701856011349
chr11	IGHMBP2	68911604	68911992	24	389	3517	8643	3493	8254	0.061696658097686374	0.42318875696631936
chr11	IGHMBP2	68911604	68912169	24	566	3517	8643	3493	8077	0.04240282685512368	0.4324625479757336
chr11	IGHMBP2	68911993	68912169	0	177	3517	8643	3517	8466	0.0	0.4154264115284668
chr11	IGHMBP2	68906136	68906200	0	65	3517	8643	3517	8578	0.0	0.4100023315458149
chr11	IGHMBP2	68936784	68936823	0	40	3517	8643	3517	8603	0.0	0.40881087992560733
chr11	ANO1	70085543	70085670	0	128	14658	6051	14658	5923	0.0	2.474759412459902
chr11	PPFIA1	70338435	70338453	0	19	17259	10724	17259	10705	0.0	1.6122372723026623
chr11	PPFIA1	70339307	70339311	0	5	17259	10724	17259	10719	0.0	1.6101315421214666
chr11	CTTN	70435556	70435744	0	189	64	5771	64	5582	0.0	0.01146542457900394
chr11	NADSYN1	71458545	71458556	0	12	8915	14232	8915	14220	0.0	0.6269338959212377
chr11	UNC93B6	71605466	71605467	0	2	3249	1146	3249	1144	0.0	2.840034965034965
chr11	ENPP7P8	71722309	71722311	3	3	82443	1440	82440	1437	1.0	57.36951983298539
chr11	FAM86C1P	71796167	71796308	192	142	26749	3381	26557	3239	1.352112676056338	8.199135535659154
chr11	IL18BP	72001425	72001552	11354	128	235124	3492	223770	3364	88.703125	66.51902497027348
chr11	IL18BP	71999371	71999662	2943	292	235124	3492	232181	3200	10.07876712328767	72.5565625
chr11	LRTOMT	72080763	72080885	0	123	673	3353	673	3230	0.0	0.208359133126935
chr11	FOLR2	72216920	72216925	0	6	0	1197	0	1191	0.0	0.0
chr11	FOLR2	72216897	72216925	0	29	0	1197	0	1168	0.0	0.0
chr11	FOLR2	72216897	72216919	0	23	0	1197	0	1174	0.0	0.0
chr11	ATG16L2	72822962	72823797	0	836	1810	7660	1810	6824	0.0	0.2652403282532239
chr11	PLEKHB1	73647739	73647895	0	157	2054	3884	2054	3727	0.0	0.5511134961094715
chr11	PLEKHB1	73647867	73647895	0	29	2054	3884	2054	3855	0.0	0.5328145265888456
chr11	PLEKHB1	73647739	73647866	0	128	2054	3884	2054	3756	0.0	0.5468583599574015
chr11	PAAF1	73877069	73877306	51	238	10023	5654	9972	5416	0.21428571428571427	1.841211225997046
chr11	POLD3	74592719	74593037	51	319	4754	5517	4703	5198	0.15987460815047022	0.9047710657945364
chr11	POLD3	74592932	74593037	0	106	4754	5517	4754	5411	0.0	0.8785806690075771
chr11	POLD3	74592719	74592931	51	213	4754	5517	4703	5304	0.23943661971830985	0.8866892911010558
chr11	SLCO2B1	75159873	75159929	0	57	346	6153	346	6096	0.0	0.056758530183727035
chr11	SLCO2B1	75159905	75159929	0	25	346	6153	346	6128	0.0	0.0564621409921671
chr11	SLCO2B1	75159873	75159904	0	32	346	6153	346	6121	0.0	0.05652671132167946
chr11	RPS3	75400778	75400824	0	47	0	4632	0	4585	0.0	0.0
chr11	RPS3	75401706	75401725	0	20	0	4632	0	4612	0.0	0.0
chr11	RPS3	75402380	75402446	0	67	0	4632	0	4565	0.0	0.0
chr11	SERPINH1	75569172	75570797	2909	1626	8991	5453	6082	3827	1.7890528905289054	1.5892343872484975
chr11	SERPINH1	75562320	75562341	0	22	8991	5453	8991	5431	0.0	1.6554962253728596
chr11	SERPINH1	75562320	75562378	0	59	8991	5453	8991	5394	0.0	1.6668520578420467
chr11	SERPINH1	75562342	75562378	0	37	8991	5453	8991	5416	0.0	1.6600812407680945
chr11	SERPINH1	75562379	75563770	5422	1392	8991	5453	3569	4061	3.8951149425287355	0.8788475744890422
chr11	SERPINH1	75562885	75563770	5422	886	8991	5453	3569	4567	6.119638826185102	0.7814758046857894
chr11	SERPINH1	75562885	75563016	3412	132	8991	5453	5579	5321	25.848484848484848	1.0484871264799849
chr11	GVQW3	76382211	76382293	0	83	0	20105	0	20022	0.0	0.0
chr11	GVQW3	76381375	76382904	0	1530	0	20105	0	18575	0.0	0.0
chr11	GVQW3	76382294	76382904	0	611	0	20105	0	19494	0.0	0.0
chr11	GVQW3	76382211	76382904	0	694	0	20105	0	19411	0.0	0.0
chr11	GVQW3	76381375	76382293	0	919	0	20105	0	19186	0.0	0.0
chr11	GVQW3	76381375	76382210	0	836	0	20105	0	19269	0.0	0.0
chr11	ACER3	76861063	76861079	0	17	49148	8264	49148	8247	0.0	5.95950042439675
chr11	ACER3	76868157	76868267	0	111	49148	8264	49148	8153	0.0	6.0282104746719
chr11	MYO7A	77211932	77211937	0	6	153	9808	153	9802	0.0	0.015609059375637625
chr11	AAMDC	77821181	77821241	88	61	8578	1874	8490	1813	1.4426229508196722	4.68284611141754
chr11	AAMDC	77821238	77821241	16	4	8578	1874	8562	1870	4.0	4.578609625668449
chr11	USP35	78206036	78206039	0	4	154	5765	154	5761	0.0	0.026731470230862697
chr11	LINC02734	82791696	82791724	226	29	2042	1211	1816	1182	7.793103448275862	1.5363790186125212
chr11	DDIAS	82914032	82914170	226	139	19164	5351	18938	5212	1.6258992805755397	3.633537989255564
chr11	RAB30-DT	83072703	83072804	0	102	0	6987	0	6885	0.0	0.0
chr11	RAB30-DT	83072147	83072181	0	35	0	6987	0	6952	0.0	0.0
chr11	PCF11	83167506	83167898	0	393	102	9968	102	9575	0.0	0.010652741514360313
chr11	ANKRD42	83194035	83194728	0	694	0	6726	0	6032	0.0	0.0
chr11	ANKRD42	83198559	83198642	0	84	0	6726	0	6642	0.0	0.0
chr11	ANKRD42	83210417	83210419	0	3	0	6726	0	6723	0.0	0.0
chr11	TMEM126B	85634177	85634279	0	103	11	2156	11	2053	0.0	0.00535801266439357
chr11	TMEM126B	85629204	85629262	0	59	11	2156	11	2097	0.0	0.005245588936576061
chr11	TMEM126A	85654235	85654256	0	22	0	976	0	954	0.0	0.0
chr11	NAALAD2	90134837	90134840	0	4	263	6651	263	6647	0.0	0.03956672182939672
chr11	DISC1FP1	90844950	90844957	0	8	566	3223	566	3215	0.0	0.176049766718507
chr11	LINC02756	91795413	91795461	0	49	0	2679	0	2630	0.0	0.0
chr11	DEUP1	93408408	93408427	0	20	1093	4161	1093	4141	0.0	0.26394590678580054
chr11	DEUP1	93330093	93330241	0	149	1093	4161	1093	4012	0.0	0.27243270189431706
chr11	DEUP1	93330773	93330778	0	6	1093	4161	1093	4155	0.0	0.26305655836341757
chr11	CEP295	93696855	93700186	51	3332	285	8943	234	5611	0.015306122448979591	0.04170379611477455
chr11	CEP295	93695635	93695673	0	39	285	8943	285	8904	0.0	0.032008086253369275
chr11	C11ORF54	93742067	93742094	0	28	204	5944	204	5916	0.0	0.034482758620689655
chr11	C11ORF54	93742067	93742141	0	75	204	5944	204	5869	0.0	0.03475890270914977
chr11	C11ORF54	93742095	93742141	0	47	204	5944	204	5897	0.0	0.034593861285399354
chr11	MED17	93807636	93809876	0	2241	0	8731	0	6490	0.0	0.0
chr11	MED17	93784764	93784933	0	170	0	8731	0	8561	0.0	0.0
chr11	AP002784.1	94214209	94214251	0	43	82607	5352	82607	5309	0.0	15.559804106234695
chr11	IZUMO1R	94306702	94306722	0	21	0	831	0	810	0.0	0.0
chr11	ANKRD49	94496952	94497077	90	126	204	3004	114	2878	0.7142857142857143	0.03961084086170952
chr11	ANKRD49	94496829	94497077	90	249	204	3004	114	2755	0.3614457831325301	0.041379310344827586
chr11	ANKRD49	94497057	94497077	42	21	204	3004	162	2983	2.0	0.05430774388199799
chr11	ANKRD49	94497078	94497118	12	41	204	3004	192	2963	0.2926829268292683	0.06479919001012488
chr11	ANKRD49	94496952	94497118	102	167	204	3004	102	2837	0.6107784431137725	0.035953471977440955
chr11	ANKRD49	94496829	94497118	102	290	204	3004	102	2714	0.35172413793103446	0.03758290346352248
chr11	ANKRD49	94497057	94497118	54	62	204	3004	150	2942	0.8709677419354839	0.05098572399728076
chr11	ANKRD49	94496829	94496951	0	123	204	3004	204	2881	0.0	0.07080874696286012
chr11	ANKRD49	94496952	94497056	48	105	204	3004	156	2899	0.45714285714285713	0.053811659192825115
chr11	ANKRD49	94496829	94497056	48	228	204	3004	156	2776	0.21052631578947367	0.056195965417867436
chr11	ANKRD49	94494036	94494170	0	135	204	3004	204	2869	0.0	0.07110491460439178
chr11	ANKRD49	94497078	94497261	114	184	204	3004	90	2820	0.6195652173913043	0.031914893617021274
chr11	ANKRD49	94497119	94497261	102	143	204	3004	102	2861	0.7132867132867133	0.03565186997553303
chr11	ANKRD49	94496952	94497261	204	310	204	3004	0	2694	0.6580645161290323	0.0
chr11	ANKRD49	94496829	94497261	204	433	204	3004	0	2571	0.47113163972286376	0.0
chr11	ANKRD49	94497057	94497261	156	205	204	3004	48	2799	0.7609756097560976	0.01714898177920686
chr11	LINC02700	94648103	94648108	0	6	2382	3099	2382	3093	0.0	0.7701260911736179
chr11	LINC02700	94644135	94644153	0	19	2382	3099	2382	3080	0.0	0.7733766233766234
chr11	AP000787.1	95151503	95151748	0	246	0	6723	0	6477	0.0	0.0
chr11	AP000787.1	95151749	95152024	0	276	0	6723	0	6447	0.0	0.0
chr11	AP000787.1	95151749	95152255	0	507	0	6723	0	6216	0.0	0.0
chr11	AP000787.1	95152025	95152255	0	231	0	6723	0	6492	0.0	0.0
chr11	YAP1	102206075	102206086	0	12	6829	6322	6829	6310	0.0	1.0822503961965135
chr11	BIRC2	102347377	102347845	0	469	153	3556	153	3087	0.0	0.04956268221574344
chr11	WTAPP1	102747121	102747205	0	85	1951	3131	1951	3046	0.0	0.6405121470781353
chr11	DYNC2H1	103321238	103321241	0	4	4092	15101	4092	15097	0.0	0.27104722792607805
chr11	GRIA4	105974445	105974557	0	113	1236	10106	1236	9993	0.0	0.1236865806064245
chr11	ACAT1	108134297	108134316	20	20	10524	5827	10504	5807	1.0	1.8088513862579645
chr11	LINC02732	110366535	110366538	0	4	102	2329	102	2325	0.0	0.04387096774193548
chr11	COLCA2	111299891	111300017	0	127	0	2014	0	1887	0.0	0.0
chr11	AP002008.2	111457222	111457398	0	177	12019	5357	12019	5180	0.0	2.3202702702702704
chr11	LAYN	111557644	111557647	0	4	808	3154	808	3150	0.0	0.2565079365079365
chr11	DLAT	112025625	112025751	0	127	393	4265	393	4138	0.0	0.09497341710971484
chr11	NKAPD1	112074359	112074916	0	558	2919	4338	2919	3780	0.0	0.7722222222222223
chr11	NKAPD1	112075644	112075684	0	41	2919	4338	2919	4297	0.0	0.6793111473120782
chr11	NKAPD1	112075651	112075684	0	34	2919	4338	2919	4304	0.0	0.6782063197026023
chr11	NKAPD1	112075644	112075650	0	7	2919	4338	2919	4331	0.0	0.6739782960055415
chr11	SDHD	112089005	112089011	52	7	6674	2799	6622	2792	7.428571428571429	2.371776504297994
chr11	BCO2	112214927	112214944	0	18	51	6492	51	6474	0.0	0.007877664504170528
chr11	BCO2	112214860	112214944	0	85	51	6492	51	6407	0.0	0.007960043702200718
chr11	BCO2	112193686	112193697	0	12	51	6492	51	6480	0.0	0.00787037037037037
chr11	BCO2	112199770	112199827	0	58	51	6492	51	6434	0.0	0.007926639726453218
chr11	BCO2	112179483	112179569	0	87	51	6492	51	6405	0.0	0.007962529274004685
chr11	BCO2	112214860	112214926	0	67	51	6492	51	6425	0.0	0.007937743190661479
chr11	NCAM1	113273049	113273748	0	700	2349	12494	2349	11794	0.0	0.19916906901814482
chr11	TTC12	113314619	113315200	0	582	0	4931	0	4349	0.0	0.0
chr11	TTC12	113315167	113315200	0	34	0	4931	0	4897	0.0	0.0
chr11	NNMT	114298136	114298158	0	23	28142	2458	28142	2435	0.0	11.557289527720739
chr11	LINC02702	116653054	116653375	0	322	210120	1108	210120	786	0.0	267.32824427480915
chr11	SIDT2	117181515	117181537	0	23	30453	6733	30453	6710	0.0	4.538450074515648
chr11	TAGLN	117203173	117203193	0	21	50922	4328	50922	4307	0.0	11.823078709078244
chr11	TAGLN	117199433	117199829	2747	397	50922	4328	48175	3931	6.919395465994962	12.25515136097685
chr11	RNF214	117238647	117239111	996	465	68990	4317	67994	3852	2.141935483870968	17.651609553478714
chr11	CEP164	117382905	117382942	0	38	153	12616	153	12578	0.0	0.012164096040705995
chr11	CEP164	117409005	117409028	0	24	153	12616	153	12592	0.0	0.012150571791613723
chr11	TMPRSS4	118099035	118099098	0	64	51	7122	51	7058	0.0	0.007225843015018419
chr11	TMPRSS4	118094856	118094865	0	10	51	7122	51	7112	0.0	0.007170978627671541
chr11	CD3G	118349051	118349171	0	121	19016	3315	19016	3194	0.0	5.953663118346901
chr11	UBE4A	118372667	118372687	0	21	138399	6582	138399	6561	0.0	21.09419295839049
chr11	ATP5MG	118406977	118407097	192	121	64969	2122	64777	2001	1.5867768595041323	32.37231384307846
chr11	KMT2A	118491310	118491318	0	9	497670	22794	497670	22785	0.0	21.842001316655693
chr11	TMEM25	118531527	118531601	0	75	0	4816	0	4741	0.0	0.0
chr11	PHLDB1	118644175	118644691	0	517	251388	19655	251388	19138	0.0	13.135541853903229
chr11	UPK2	118957315	118957346	202	32	119855	1131	119653	1099	6.3125	108.8744313011829
chr11	CENATAC	119011284	119011311	0	28	9498	4795	9498	4767	0.0	1.9924480805538074
chr11	TRAPPC4	119019189	119019317	0	129	2682	4642	2682	4513	0.0	0.594283181918901
chr11	TRAPPC4	119019318	119019424	0	107	2682	4642	2682	4535	0.0	0.5914002205071665
chr11	TRAPPC4	119019189	119019424	0	236	2682	4642	2682	4406	0.0	0.6087153881071267
chr11	HMBS	119088708	119088848	0	141	597	3568	597	3427	0.0	0.17420484388678145
chr11	HMBS	119085067	119085157	0	91	597	3568	597	3477	0.0	0.17169974115616912
chr11	HMBS	119085540	119085893	0	354	597	3568	597	3214	0.0	0.18574984443061607
chr11	HMBS	119092164	119092523	0	360	597	3568	597	3208	0.0	0.18609725685785536
chr11	C2CD2L	119106775	119106878	109	104	5229	8904	5120	8800	1.0480769230769231	0.5818181818181818
chr11	ABCG4	119149281	119149363	12959	83	41933	5345	28974	5262	156.13253012048193	5.506271379703535
chr11	NLRX1	119168434	119168447	126	14	644490	4706	644364	4692	9.0	137.33248081841433
chr11	NLRX1	119168448	119168522	342	75	644490	4706	644148	4631	4.56	139.09479594040164
chr11	NLRX1	119168434	119168522	468	89	644490	4706	644022	4617	5.258426966292135	139.48927875243666
chr11	NLRX1	119168895	119169042	306	148	644490	4706	644184	4558	2.0675675675675675	141.33040807371654
chr11	NLRX1	119168922	119169042	304	121	644490	4706	644186	4585	2.512396694214876	140.49858233369685
chr11	NLRX1	119169043	119169302	27918	260	644490	4706	616572	4446	107.37692307692308	138.68016194331983
chr11	NLRX1	119168895	119169302	28224	408	644490	4706	616266	4298	69.17647058823529	143.3843648208469
chr11	NLRX1	119168922	119169302	28222	381	644490	4706	616268	4325	74.07349081364829	142.48971098265895
chr11	NLRX1	119168895	119168921	2	27	644490	4706	644488	4679	0.07407407407407407	137.74054285103654
chr11	PDZD3	119186166	119186241	144	76	62557	3455	62413	3379	1.894736842105263	18.470849363717075
chr11	PDZD3	119187659	119187700	0	42	62557	3455	62557	3413	0.0	18.329036038675653
chr11	PDZD3	119185511	119185628	10291	118	62557	3455	52266	3337	87.21186440677967	15.662571171711118
chr11	TBCEL	121024155	121024291	0	137	51	6539	51	6402	0.0	0.007966260543580132
chr11	TBCEL	121035945	121036314	0	370	51	6539	51	6169	0.0	0.008267142162425028
chr11	TECTA	121189881	121190108	0	228	576	8334	576	8106	0.0	0.07105847520355292
chr11	SORL1	121577039	121577138	0	100	51	17061	51	16961	0.0	0.003006898178173457
chr11	GRAMD1B	123560528	123560652	0	125	31401	14786	31401	14661	0.0	2.141804788213628
chr11	AP000866.1	124800895	124801045	0	151	1836	5561	1836	5410	0.0	0.33937153419593347
chr11	AP000866.1	124800719	124801045	0	327	1836	5561	1836	5234	0.0	0.3507833397019488
chr11	AP000866.1	124800942	124801045	0	104	1836	5561	1836	5457	0.0	0.3364485981308411
chr11	AP000866.1	124800719	124800894	0	176	1836	5561	1836	5385	0.0	0.34094707520891365
chr11	AP000866.1	124801046	124801256	0	211	1836	5561	1836	5350	0.0	0.34317757009345795
chr11	AP000866.1	124800895	124801256	0	362	1836	5561	1836	5199	0.0	0.3531448355452972
chr11	AP000866.1	124800719	124801256	0	538	1836	5561	1836	5023	0.0	0.36551861437388017
chr11	AP000866.1	124800942	124801256	0	315	1836	5561	1836	5246	0.0	0.3499809378574152
chr11	AP000866.1	124800719	124800941	0	223	1836	5561	1836	5338	0.0	0.34394904458598724
chr11	AP000866.1	124800895	124800941	0	47	1836	5561	1836	5514	0.0	0.33297062023939067
chr11	SLC37A2	125063352	125063426	0	75	0	6174	0	6099	0.0	0.0
chr11	EI24	125569515	125569573	0	59	130	3327	130	3268	0.0	0.0397796817625459
chr11	STT3A	125608244	125608289	0	46	425	7052	425	7006	0.0	0.06066228946617185
chr11	CHEK1	125626821	125626833	0	13	0	4401	0	4388	0.0	0.0
chr11	CHEK1	125626013	125626029	0	17	0	4401	0	4384	0.0	0.0
chr11	CHEK1	125626013	125626034	0	22	0	4401	0	4379	0.0	0.0
chr11	CHEK1	125626030	125626034	0	5	0	4401	0	4396	0.0	0.0
chr11	CHEK1	125626576	125626642	0	67	0	4401	0	4334	0.0	0.0
chr11	FAM118B	126229294	126229336	0	43	7194	3544	7194	3501	0.0	2.05484147386461
chr11	FOXRED1	126269292	126269415	0	124	124337	4405	124337	4281	0.0	29.043914973137117
chr11	TIRAP	126289818	126289833	0	16	3754	3600	3754	3584	0.0	1.0474330357142858
chr11	ST3GAL4	126406546	126406557	0	12	0	5834	0	5822	0.0	0.0
chr11	ST3GAL4	126403428	126403486	0	59	0	5834	0	5775	0.0	0.0
chr11	AP001993.1	127073269	127073296	0	28	0	9479	0	9451	0.0	0.0
chr11	AP001993.1	127080568	127080589	0	22	0	9479	0	9457	0.0	0.0
chr11	AP001993.1	127021908	127022046	0	139	0	9479	0	9340	0.0	0.0
chr11	APLP2	130070015	130070082	0	68	16012	7164	16012	7096	0.0	2.256482525366404
chr11	APLP2	130070038	130070082	0	45	16012	7164	16012	7119	0.0	2.2491923022896474
chr11	APLP2	130070015	130070037	0	23	16012	7164	16012	7141	0.0	2.242262988376978
chr11	LINC02730	134027035	134027066	32	32	222168	2090	222136	2058	1.0	107.93780369290573
chr11	LINC02730	134027280	134027366	9	87	222168	2090	222159	2003	0.10344827586206896	110.91313030454319
chr11	LINC02706	134712778	134713214	0	437	0	2836	0	2399	0.0	0.0
chr11	LINC02706	134712778	134714780	0	2003	0	2836	0	833	0.0	0.0
chr11	LINC02706	134713215	134714780	0	1566	0	2836	0	1270	0.0	0.0
chr11	LINC02706	134714781	134714828	0	48	0	2836	0	2788	0.0	0.0
chr11	SIRT3	236047	236192	4054	146	177198	5564	173144	5418	27.767123287671232	31.95717977113326
chr11	SIRT3	218777	218830	816	54	177198	5564	176382	5510	15.11111111111111	32.01125226860254
chr11	SIGIRR	406141	406347	3362	207	126442	2873	123080	2666	16.241545893719806	46.166541635408855
chr11	SIGIRR	407816	407850	0	35	126442	2873	126442	2838	0.0	44.55320648343904
chr11	SIGIRR	417293	417323	0	31	126442	2873	126442	2842	0.0	44.49049964813511
chr11	MIR210HG	568330	568350	0	21	33252	2323	33252	2302	0.0	14.444830582102519
chr11	CDHR5	624817	624916	40	100	2710	3877	2670	3777	0.4	0.7069102462271644
chr11	CDHR5	624817	624968	612	152	2710	3877	2098	3725	4.026315789473684	0.5632214765100672
chr11	DEAF1	694678	694757	399	80	256240	4162	255841	4082	4.9875	62.67540421362077
chr11	GATD1	773427	773520	175	94	428922	5390	428747	5296	1.8617021276595744	80.95675981873111
chr11	SLC25A22	794457	794468	2416	12	300554	4564	298138	4552	201.33333333333334	65.49604569420035
chr11	SLC25A22	796042	796202	1620	161	300554	4564	298934	4403	10.062111801242237	67.89325459913695
chr11	SLC25A22	796042	796085	175	44	300554	4564	300379	4520	3.977272727272727	66.45553097345133
chr11	SLC25A22	796042	796106	548	65	300554	4564	300006	4499	8.430769230769231	66.6828184040898
chr11	SLC25A22	796042	796112	668	71	300554	4564	299886	4493	9.408450704225352	66.74515913643445
chr11	SLC25A22	797611	797890	1553	280	300554	4564	299001	4284	5.546428571428572	69.79481792717087
chr11	SLC25A22	794452	794456	0	5	300554	4564	300554	4559	0.0	65.92542224171967
chr11	SLC25A22	794452	794468	2416	17	300554	4564	298138	4547	142.11764705882354	65.56806685726853
chr11	SLC25A22	796086	796106	373	21	300554	4564	300181	4543	17.761904761904763	66.07550077041603
chr11	SLC25A22	796086	796112	493	27	300554	4564	300061	4537	18.25925925925926	66.13643376680626
chr11	SLC25A22	795263	795338	612	76	300554	4564	299942	4488	8.052631578947368	66.83199643493761
chr11	SLC25A22	795339	795407	0	69	300554	4564	300554	4495	0.0	66.86407119021135
chr11	SLC25A22	796107	796112	120	6	300554	4564	300434	4558	20.0	65.91355857832383
chr11	SLC25A22	796113	796202	952	90	300554	4564	299602	4474	10.577777777777778	66.96513187304426
chr11	PIDD1	800332	800382	1294	51	106080	4982	104786	4931	25.372549019607842	21.25045629689718
chr11	PIDD1	800984	801016	1678	33	106080	4982	104402	4949	50.84848484848485	21.09557486360881
chr11	PIDD1	800984	801000	778	17	106080	4982	105302	4965	45.76470588235294	21.20886203423968
chr11	PIDD1	801001	801016	900	16	106080	4982	105180	4966	56.25	21.18002416431736
chr11	CHID1	883147	883198	20867	52	707943	4078	687076	4026	401.28846153846155	170.65971187282662
chr11	CHID1	869213	869856	20775	644	707943	4078	687168	3434	32.25931677018634	200.10716365754223
chr11	CHID1	902147	902196	314	50	707943	4078	707629	4028	6.28	175.67750744786494
chr11	CHID1	903655	903702	0	48	707943	4078	707943	4030	0.0	175.6682382133995
chr11	CHID1	910640	910773	411	134	707943	4078	707532	3944	3.0671641791044775	179.394523326572
chr11	CHID1	914522	914743	0	222	707943	4078	707943	3856	0.0	183.5951763485477
chr11	CHID1	914303	914743	0	441	707943	4078	707943	3637	0.0	194.65026120428925
chr11	CHID1	914303	914521	0	219	707943	4078	707943	3859	0.0	183.45244882093806
chr11	IFITM10	1747666	1747755	0	90	51	4795	51	4705	0.0	0.010839532412327312
chr11	IFITM10	1749014	1749017	0	4	51	4795	51	4791	0.0	0.010644959298685034
chr11	CTSD	1754905	1754922	0	18	1773	3467	1773	3449	0.0	0.5140620469701362
chr11	CTSD	1761308	1761328	0	21	1773	3467	1773	3446	0.0	0.5145095763203714
chr11	H19	1995875	1996077	0	203	0	2821	0	2618	0.0	0.0
chr11	IGF2	2137187	2137190	0	4	102	6266	102	6262	0.0	0.016288725646758224
chr11	INS	2161141	2161166	0	26	0	654	0	628	0.0	0.0
chr11	TH	2171684	2171695	0	12	0	3044	0	3032	0.0	0.0
chr11	TRPM5	2421025	2421030	0	6	732943	3986	732943	3980	0.0	184.1565326633166
chr11	CDKN1C	2884669	2885200	0	532	0	2316	0	1784	0.0	0.0
chr11	NAP1L4	2992228	2992252	75	25	9882	5136	9807	5111	3.0	1.9188025826648405
chr11	CARS1	3001961	3001968	96	8	105140	7131	105044	7123	12.0	14.747157096728907
chr11	OSBPL5	3120420	3120542	0	123	8309	7227	8309	7104	0.0	1.1696227477477477
chr11	OSBPL5	3165215	3165221	35	7	8309	7227	8274	7220	5.0	1.145983379501385
chr11	ZNF195	3370942	3370973	0	32	5428	7243	5428	7211	0.0	0.7527388711690473
chr11	ART5	3639641	3639844	0	204	0	1502	0	1298	0.0	0.0
chr11	CHRNA10	3669733	3669794	6	62	204	2708	198	2646	0.0967741935483871	0.07482993197278912
chr11	NUP98	3685972	3686062	0	91	217375	9424	217375	9333	0.0	23.29101039322833
chr11	NUP98	3702462	3702770	510	309	217375	9424	216865	9115	1.6504854368932038	23.7921009325288
chr11	NUP98	3760487	3760537	0	51	217375	9424	217375	9373	0.0	23.191614211031688
chr11	NUP98	3760487	3760561	0	75	217375	9424	217375	9349	0.0	23.25114985559953
chr11	NUP98	3778872	3778982	0	111	217375	9424	217375	9313	0.0	23.34102866960163
chr11	NUP98	3760538	3760561	0	24	217375	9424	217375	9400	0.0	23.125
chr11	NUP98	3760387	3760486	0	100	217375	9424	217375	9324	0.0	23.313492063492063
chr11	NUP98	3760387	3760537	0	151	217375	9424	217375	9273	0.0	23.441712498652
chr11	NUP98	3760387	3760561	0	175	217375	9424	217375	9249	0.0	23.502540815223266
chr11	HBB	5226929	5226944	0	16	0	1309	0	1293	0.0	0.0
chr11	HBG1	5249712	5249749	0	38	0	1431	0	1393	0.0	0.0
chr11	HBG2	5254636	5254673	0	38	0	807	0	769	0.0	0.0
chr11	TRIM5	5684867	5685014	3492	148	16953	4811	13461	4663	23.594594594594593	2.886768174994639
chr11	FAM160A2	6218557	6218598	0	42	3285	4696	3285	4654	0.0	0.7058444348947143
chr11	APBB1	6405132	6405385	0	254	1509	5258	1509	5004	0.0	0.30155875299760193
chr11	TRIM3	6456296	6456574	0	279	4384	6639	4384	6360	0.0	0.6893081761006289
chr11	TRIM3	6458064	6458068	0	5	4384	6639	4384	6634	0.0	0.6608381067229424
chr11	ARFIP2	6478737	6478857	0	121	44516	5066	44516	4945	0.0	9.002224469160769
chr11	TPP1	6617300	6617352	1568	53	38502	5275	36934	5222	29.58490566037736	7.072769054002298
chr11	TPP1	6617300	6617357	1803	58	38502	5275	36699	5217	31.086206896551722	7.034502587694077
chr11	TPP1	6617353	6617357	235	5	38502	5275	38267	5270	47.0	7.2612903225806456
chr11	TPP1	6618775	6619194	1390	420	38502	5275	37112	4855	3.3095238095238093	7.644078269824923
chr11	AC107884.1	7427872	7428007	0	136	0	5841	0	5705	0.0	0.0
chr11	AC107884.1	7461232	7461237	0	6	0	5841	0	5835	0.0	0.0
chr11	CYB5R2	7673717	7673950	0	234	867	5718	867	5484	0.0	0.15809628008752735
chr11	CYB5R2	7673717	7674110	0	394	867	5718	867	5324	0.0	0.16284748309541697
chr11	CYB5R2	7673951	7674110	0	160	867	5718	867	5558	0.0	0.15599136379992803
chr11	CYB5R2	7673951	7674224	0	274	867	5718	867	5444	0.0	0.15925789860396766
chr11	CYB5R2	7673606	7673716	0	111	867	5718	867	5607	0.0	0.15462814339218833
chr11	OR10A6	7930808	7930859	0	52	816	2982	816	2930	0.0	0.2784982935153584
chr11	LMO1	8263337	8263670	0	334	0	1428	0	1094	0.0	0.0
chr11	STK33	8480482	8480532	0	51	1086	7588	1086	7537	0.0	0.1440891601432931
chr11	DENND2B	8810516	8810611	0	96	208720	10617	208720	10521	0.0	19.838418401292653
chr11	DENND2B	8718358	8718426	13	69	208720	10617	208707	10548	0.18840579710144928	19.786405005688284
chr11	DENND2B	8835603	8835622	0	20	208720	10617	208720	10597	0.0	19.69614041709918
chr11	DENND2B	8870953	8871332	0	380	208720	10617	208720	10237	0.0	20.38878577708313
chr11	DENND5A	9141939	9141972	0	34	92880	7876	92880	7842	0.0	11.843917368018362
chr11	IRAG1	10693461	10693534	0	74	0	7711	0	7637	0.0	0.0
chr11	EIF4G2	10800089	10800242	96	154	31748	7294	31652	7140	0.6233766233766234	4.433053221288516
chr11	EIF4G2	10807548	10807743	0	196	31748	7294	31748	7098	0.0	4.472809242040011
chr11	EIF4G2	10807533	10807547	0	15	31748	7294	31748	7279	0.0	4.36158813023767
chr11	EIF4G2	10807533	10807743	0	211	31748	7294	31748	7083	0.0	4.482281519130312
chr11	EIF4G2	10808173	10808275	0	103	31748	7294	31748	7191	0.0	4.414963148379919
chr11	ZBED5	10857222	10857594	0	373	516494	7125	516494	6752	0.0	76.4949644549763
chr11	DKK3	12008869	12009037	0	169	38821	4948	38821	4779	0.0	8.123247541326638
chr11	DKK3	12009038	12009170	0	133	38821	4948	38821	4815	0.0	8.06251298026999
chr11	LINC00958	12984225	12984228	0	4	131401	5127	131401	5123	0.0	25.649228967401914
chr11	BTBD10	13417157	13417245	0	89	14985	3285	14985	3196	0.0	4.688673341677096
chr11	BTBD10	13439883	13440097	0	215	14985	3285	14985	3070	0.0	4.881107491856677
chr11	BTBD10	13463091	13463098	0	8	14985	3285	14985	3277	0.0	4.57277998169057
chr11	RRAS2	14358237	14358255	0	19	3052	3469	3052	3450	0.0	0.8846376811594203
chr11	COPB1	14499608	14499705	590	98	21313	5086	20723	4988	6.020408163265306	4.154570970328789
chr11	COPB1	14499608	14499740	927	133	21313	5086	20386	4953	6.969924812030075	4.115889359983848
chr11	COPB1	14499706	14499740	337	35	21313	5086	20976	5051	9.628571428571428	4.152841021579885
chr11	COPB1	14499602	14499607	0	6	21313	5086	21313	5080	0.0	4.195472440944882
chr11	COPB1	14499602	14499705	590	104	21313	5086	20723	4982	5.673076923076923	4.159574468085107
chr11	COPB1	14499602	14499740	927	139	21313	5086	20386	4947	6.669064748201439	4.120881342227612
chr11	PSMA1	14519904	14520295	5743	392	15416	2912	9673	2520	14.650510204081632	3.8384920634920636
chr11	PSMA1	14519904	14520191	4257	288	15416	2912	11159	2624	14.78125	4.2526676829268295
chr11	PSMA1	14520192	14520295	1486	104	15416	2912	13930	2808	14.288461538461538	4.960826210826211
chr11	PSMA1	14519872	14520295	6117	424	15416	2912	9299	2488	14.42688679245283	3.737540192926045
chr11	PSMA1	14519872	14519903	374	32	15416	2912	15042	2880	11.6875	5.222916666666666
chr11	PSMA1	14519872	14520191	4631	320	15416	2912	10785	2592	14.471875	4.16087962962963
chr11	CYP2R1	14891152	14891362	2064	211	1209	4037	-855	3826	9.781990521327014	-0.2234709879769995
chr11	CYP2R1	14890899	14891362	3468	464	1209	4037	-2259	3573	7.474137931034483	-0.6322418136020151
chr11	CALCA	14972220	14972243	0	24	0	2106	0	2082	0.0	0.0
chr11	SOX6	16049712	16049753	0	42	0	19677	0	19635	0.0	0.0
chr11	SOX6	16402658	16402798	0	141	0	19677	0	19536	0.0	0.0
chr11	ABCC8	17461582	17461584	0	3	51038	9821	51038	9818	0.0	5.1984110816866975
chr11	ABCC8	17463437	17463457	0	21	51038	9821	51038	9800	0.0	5.207959183673469
chr11	ABCC8	17396877	17396914	1590	38	51038	9821	49448	9783	41.8421052631579	5.054482265153839
chr11	ABCC8	17413393	17413477	0	85	51038	9821	51038	9736	0.0	5.242193919474117
chr11	ABCC8	17443163	17443176	0	14	51038	9821	51038	9807	0.0	5.2042418680534315
chr11	SERGEF	18012850	18012949	0	100	9464	3044	9464	2944	0.0	3.214673913043478
chr11	SERGEF	18012501	18012849	0	349	9464	3044	9464	2695	0.0	3.5116883116883115
chr11	SERGEF	18010070	18010073	0	4	9464	3044	9464	3040	0.0	3.113157894736842
chr11	SAAL1	18086861	18086864	0	4	1518	2752	1518	2748	0.0	0.5524017467248908
chr11	SAAL1	18086856	18086864	0	9	1518	2752	1518	2743	0.0	0.5534086766314255
chr11	SAAL1	18086856	18086860	0	5	1518	2752	1518	2747	0.0	0.5526028394612305
chr11	SAA2	18248455	18248601	0	147	0	2249	0	2102	0.0	0.0
chr11	HPS5	18321945	18322131	0	187	26850	6458	26850	6271	0.0	4.281613777706905
chr11	HPS5	18321945	18322075	0	131	26850	6458	26850	6327	0.0	4.243717401612138
chr11	HPS5	18322076	18322131	0	56	26850	6458	26850	6402	0.0	4.194001874414246
chr11	E2F8	19241406	19241495	0	90	102	4148	102	4058	0.0	0.025135534746180386
chr11	SLC5A12	26692484	26692487	0	4	0	7588	0	7584	0.0	0.0
chr11	BBOX1-AS1	27219686	27220045	0	360	0	1350	0	990	0.0	0.0
chr11	BDNF	27699381	27699481	477	101	77118	7518	76641	7417	4.7227722772277225	10.333153566131859
chr11	BDNF	27700163	27700180	0	18	77118	7518	77118	7500	0.0	10.2824
chr11	BDNF	27720428	27720642	255	215	77118	7518	76863	7303	1.186046511627907	10.524852800219088
chr11	BDNF	27720345	27720427	850	83	77118	7518	76268	7435	10.240963855421686	10.257969065232011
chr11	BDNF	27720345	27720642	1105	298	77118	7518	76013	7220	3.708053691275168	10.528116343490305
chr11	DCDC1	30903481	30903489	0	9	0	12605	0	12596	0.0	0.0
chr11	DCDC1	31103643	31103646	0	4	0	12605	0	12601	0.0	0.0
chr11	IMMP1L	31469739	31469756	0	18	12906	3848	12906	3830	0.0	3.3697127937336813
chr11	PAX6	31801560	31801667	0	108	62146	17695	62146	17587	0.0	3.5336327969522943
chr11	PAX6	31801560	31801760	0	201	62146	17695	62146	17494	0.0	3.552417971876072
chr11	PAX6	31811114	31811211	2394	98	62146	17695	59752	17597	24.428571428571427	3.395578791839518
chr11	PAX6	31812092	31812147	0	56	62146	17695	62146	17639	0.0	3.5232156017914846
chr11	PAX6	31801229	31801559	0	331	62146	17695	62146	17364	0.0	3.579014052061737
chr11	PAX6	31801229	31801667	0	439	62146	17695	62146	17256	0.0	3.6014140009272135
chr11	PAX6	31801229	31801760	0	532	62146	17695	62146	17163	0.0	3.620928742061411
chr11	PAX6	31801668	31801760	0	93	62146	17695	62146	17602	0.0	3.530621520281786
chr11	PAX6	31812092	31812570	8732	479	62146	17695	53414	17216	18.22964509394572	3.102578996282528
chr11	PAX6	31803397	31803582	836	186	62146	17695	61310	17509	4.494623655913978	3.50162773430807
chr11	PAX6	31803583	31803950	1163	368	62146	17695	60983	17327	3.160326086956522	3.5195359843019567
chr11	PAX6	31811112	31811211	2460	100	62146	17695	59686	17595	24.6	3.392213697073032
chr11	PAX6	31811112	31811113	66	2	62146	17695	62080	17693	33.0	3.5087322669982477
chr11	WT1	32391971	32391979	0	9	0	6874	0	6865	0.0	0.0
chr11	WT1	32417423	32417575	0	153	0	6874	0	6721	0.0	0.0
chr11	CD59	33709905	33710204	0	300	113802	10567	113802	10267	0.0	11.084250511347035
chr11	CD59	33722570	33722634	0	65	113802	10567	113802	10502	0.0	10.836221672062464
chr11	FBXO3	33753110	33753341	0	232	6402	5200	6402	4968	0.0	1.288647342995169
chr11	LMO2	33869709	33869823	0	115	0	2903	0	2788	0.0	0.0
chr11	SLC1A2	35419907	35419934	0	28	7793529	13109	7793529	13081	0.0	595.7900007644675
chr11	SLC1A2	35419907	35419918	0	12	7793529	13109	7793529	13097	0.0	595.0621516377796
chr11	SLC1A2	35419919	35419934	0	16	7793529	13109	7793529	13093	0.0	595.2439471473307
chr11	SLC1A2	35360042	35360046	0	5	7793529	13109	7793529	13104	0.0	594.7442765567765
chr11	TP53I11	44936802	44936878	0	77	0	7153	0	7076	0.0	0.0
chr11	TP53I11	44950676	44950875	0	200	0	7153	0	6953	0.0	0.0
chr11	TP53I11	44939113	44939164	0	52	0	7153	0	7101	0.0	0.0
chr11	TP53I11	44937108	44937302	0	195	0	7153	0	6958	0.0	0.0
chr11	AC103855.2	45532648	45532990	0	343	51	4073	51	3730	0.0	0.013672922252010724
chr11	PEX16	45917699	45917772	0	74	0	2915	0	2841	0.0	0.0
chr11	PEX16	45917587	45917698	0	112	0	2915	0	2803	0.0	0.0
chr11	PEX16	45917587	45917772	0	186	0	2915	0	2729	0.0	0.0
chr11	ARFGAP2	47167908	47167974	4	67	45245	5269	45241	5202	0.05970149253731343	8.69684736639754
chr11	ARFGAP2	47171425	47171451	237	27	45245	5269	45008	5242	8.777777777777779	8.58603586417398
chr11	ARFGAP2	47175850	47175870	252	21	45245	5269	44993	5248	12.0	8.573361280487806
chr11	ARFGAP2	47176515	47176780	13177	266	45245	5269	32068	5003	49.537593984962406	6.409754147511493
chr11	PSMC3	47424045	47424107	0	63	0	1859	0	1796	0.0	0.0
chr11	PSMC3	47426116	47426131	0	16	0	1859	0	1843	0.0	0.0
chr11	PSMC3	47426116	47426203	0	88	0	1859	0	1771	0.0	0.0
chr11	PSMC3	47426132	47426203	0	72	0	1859	0	1787	0.0	0.0
chr11	CELF1	47523247	47523598	3070	352	37678	9012	34608	8660	8.721590909090908	3.9963048498845266
chr11	KBTBD4	47578827	47578931	0	105	9702	2798	9702	2693	0.0	3.602673598217601
chr11	KBTBD4	47578827	47578910	0	84	9702	2798	9702	2714	0.0	3.5747973470891674
chr11	KBTBD4	47578540	47578683	0	144	9702	2798	9702	2654	0.0	3.6556141672946496
chr11	KBTBD4	47578911	47578931	0	21	9702	2798	9702	2777	0.0	3.4936982355059416
chr11	MTCH2	47642378	47642399	0	22	9654	2894	9654	2872	0.0	3.3614206128133706
chr11	AGBL2	47714841	47715173	0	333	213849	5082	213849	4749	0.0	45.03032217308907
chr11	AGBL2	47714841	47715106	0	266	213849	5082	213849	4816	0.0	44.40386212624585
chr11	AGBL2	47715107	47715173	0	67	213849	5082	213849	5015	0.0	42.64187437686939
chr11	FOLH1	49207763	49207866	0	104	0	5358	0	5254	0.0	0.0
chr11	TNKS1BP1	57320064	57320077	0	14	84050	7163	84050	7149	0.0	11.75688907539516
chr11	PRG2	57389009	57389041	0	33	0	1737	0	1704	0.0	0.0
chr11	PRG2	57390482	57390594	0	113	0	1737	0	1624	0.0	0.0
chr11	SLC43A3	57427371	57427406	1450	36	69264	4537	67814	4501	40.27777777777778	15.066429682292824
chr11	TIMM10	57530657	57530725	27	69	2201	779	2174	710	0.391304347826087	3.0619718309859154
chr11	UBE2L6	57567009	57567025	0	17	6781	2068	6781	2051	0.0	3.3061921014139446
chr11	YPEL4	57647383	57647471	0	89	0	2700	0	2611	0.0	0.0
chr11	OR9I1	58125273	58125429	0	157	0	3187	0	3030	0.0	0.0
chr11	LPXN	58577985	58578017	0	33	9	2445	9	2412	0.0	0.0037313432835820895
chr11	CBLIF	59845260	59845373	0	114	102	2390	102	2276	0.0	0.04481546572934974
chr11	MS4A6A	60175401	60175504	0	104	102	3986	102	3882	0.0	0.02627511591962906
chr11	MS4A6A	60182977	60183134	0	158	102	3986	102	3828	0.0	0.02664576802507837
chr11	MS4A6A	60184319	60184540	0	222	102	3986	102	3764	0.0	0.02709883103081828
chr11	MS4A6A	60184272	60184318	0	47	102	3986	102	3939	0.0	0.025894897182025894
chr11	MS4A6A	60184272	60184302	0	31	102	3986	102	3955	0.0	0.02579013906447535
chr11	MS4A6A	60184303	60184318	0	16	102	3986	102	3970	0.0	0.025692695214105794
chr11	VWCE	61282788	61282791	0	4	510	4782	510	4778	0.0	0.10673922143156132
chr11	CYB561A3	61357202	61357310	0	109	102	8318	102	8209	0.0	0.012425386770617615
chr11	CYB561A3	61352955	61352983	0	29	102	8318	102	8289	0.0	0.012305465074194716
chr11	CPSF7	61419921	61419947	0	27	1321	4905	1321	4878	0.0	0.27080770807708077
chr11	CPSF7	61420469	61420545	0	77	1321	4905	1321	4828	0.0	0.2736122618061309
chr11	CPSF7	61429756	61429885	0	130	1321	4905	1321	4775	0.0	0.27664921465968584
chr11	CPSF7	61429756	61429839	0	84	1321	4905	1321	4821	0.0	0.27400954158888197
chr11	CPSF7	61429886	61429912	0	27	1321	4905	1321	4878	0.0	0.27080770807708077
chr11	CPSF7	61429840	61429912	0	73	1321	4905	1321	4832	0.0	0.273385761589404
chr11	CPSF7	61429840	61429885	0	46	1321	4905	1321	4859	0.0	0.2718666392261782
chr11	TMEM258	61790374	61790421	0	48	0	1996	0	1948	0.0	0.0
chr11	TMEM258	61789715	61789783	0	69	0	1996	0	1927	0.0	0.0
chr11	TMEM258	61791462	61792554	102	1093	0	1996	-102	903	0.09332113449222323	-0.11295681063122924
chr11	FADS1	61812470	61812475	0	6	1071	9399	1071	9393	0.0	0.11402107952730757
chr11	FADS1	61816554	61816990	0	437	1071	9399	1071	8962	0.0	0.11950457487168042
chr11	FADS1	61814795	61814962	0	168	1071	9399	1071	9231	0.0	0.11602209944751381
chr11	FADS1	61814795	61815072	0	278	1071	9399	1071	9121	0.0	0.11742133537989255
chr11	FADS1	61814795	61814855	0	61	1071	9399	1071	9338	0.0	0.11469265367316342
chr11	FADS1	61814963	61815072	0	110	1071	9399	1071	9289	0.0	0.11529766390354182
chr11	FADS1	61815926	61815941	0	16	1071	9399	1071	9383	0.0	0.11414259831610359
chr11	FADS1	61814856	61814962	0	107	1071	9399	1071	9292	0.0	0.11526043908738699
chr11	FADS1	61814856	61815072	0	217	1071	9399	1071	9182	0.0	0.11664125462862121
chr11	FADS3	61876358	61876369	0	12	10353	5230	10353	5218	0.0	1.9840935224223841
chr11	FADS3	61879311	61879394	0	84	10353	5230	10353	5146	0.0	2.011853867081228
chr11	FTH1	61967311	61967400	0	90	0	1914	0	1824	0.0	0.0
chr11	EEF1G	62571539	62571622	1071	84	206133	2649	205062	2565	12.75	79.94619883040936
chr11	TUT1	62591403	62591518	1488	116	34785	3550	33297	3434	12.827586206896552	9.696272568433313
chr11	EML3	62612435	62612572	0	138	162148	4849	162148	4711	0.0	34.41901931649331
chr11	EML3	62612164	62612223	0	60	162148	4849	162148	4789	0.0	33.858425558571724
chr11	GANAB	62639626	62639629	0	4	18778	5054	18778	5050	0.0	3.7184158415841586
chr11	LBHD1	62669640	62671562	562	1923	562	2716	0	793	0.2922516900676027	0.0
chr11	LBHD1	62669640	62669880	0	241	562	2716	562	2475	0.0	0.22707070707070706
chr11	UBXN1	62677926	62677937	0	12	258	1724	258	1712	0.0	0.15070093457943926
chr11	BSCL2	62705300	62705466	18	167	166	3676	148	3509	0.10778443113772455	0.04217725847819892
chr11	BSCL2	62709146	62709262	0	117	166	3676	166	3559	0.0	0.04664231525709469
chr11	BSCL2	62706202	62706257	0	56	166	3676	166	3620	0.0	0.04585635359116022
chr11	BSCL2	62705915	62706201	51	287	166	3676	115	3389	0.17770034843205576	0.03393331366184715
chr11	BSCL2	62705915	62706001	36	87	166	3676	130	3589	0.41379310344827586	0.03622178879910839
chr11	BSCL2	62706002	62706201	15	200	166	3676	151	3476	0.075	0.04344073647871116
chr11	ZBTB3	62753963	62754124	0	162	0	2168	0	2006	0.0	0.0
chr11	NXF1	62798538	62800375	0	1838	1207	5978	1207	4140	0.0	0.29154589371980677
chr11	NXF1	62803791	62803798	0	8	1207	5978	1207	5970	0.0	0.20217755443886098
chr11	STX5	62825024	62825034	0	11	51	2433	51	2422	0.0	0.021056977704376548
chr11	WDR74	62839506	62839539	0	34	153	4116	153	4082	0.0	0.03748162665360118
chr11	SNHG1	62852810	62853073	0	264	0	3736	0	3472	0.0	0.0
chr11	SNHG1	62854887	62855131	0	245	0	3736	0	3491	0.0	0.0
chr11	SNHG1	62855423	62855863	0	441	0	3736	0	3295	0.0	0.0
chr11	SNHG1	62855132	62855422	0	291	0	3736	0	3445	0.0	0.0
chr11	SNHG1	62854017	62854517	0	501	0	3736	0	3235	0.0	0.0
chr11	SNHG1	62854518	62855131	0	614	0	3736	0	3122	0.0	0.0
chr11	SLC22A6	62977144	62977182	0	39	51	2403	51	2364	0.0	0.021573604060913704
chr11	PLAAT5	63466109	63466158	96	50	4762	3274	4666	3224	1.92	1.4472704714640199
chr11	TRPT1	64224794	64224799	0	6	51	1812	51	1806	0.0	0.02823920265780731
chr11	TRPT1	64226049	64226189	0	141	51	1812	51	1671	0.0	0.03052064631956912
chr11	NRXN2	64676992	64677012	0	21	158895	9747	158895	9726	0.0	16.337137569401605
chr11	RASGRP2	64744002	64744028	0	27	255	5724	255	5697	0.0	0.04476040021063718
chr11	SF1	64777986	64778360	0	375	135	5987	135	5612	0.0	0.02405559515324305
chr11	SF1	64767566	64767569	0	4	135	5987	135	5983	0.0	0.022563931138224972
chr11	SF1	64777498	64777519	0	22	135	5987	135	5965	0.0	0.022632020117351215
chr11	MEN1	64807890	64807994	17484	105	168530	4392	151046	4287	166.5142857142857	35.23349661768136
chr11	MEN1	64809649	64809663	8	15	168530	4392	168522	4377	0.5333333333333333	38.5017135023989
chr11	MEN1	64810267	64810512	1639	246	168530	4392	166891	4146	6.662601626016261	40.25349734684033
chr11	MEN1	64810267	64810524	1949	258	168530	4392	166581	4134	7.554263565891473	40.295355587808416
chr11	MEN1	64810267	64810456	999	190	168530	4392	167531	4202	5.257894736842105	39.86934792955736
chr11	MEN1	64810513	64810524	310	12	168530	4392	168220	4380	25.833333333333332	38.406392694063925
chr11	MEN1	64810267	64810628	4974	362	168530	4392	163556	4030	13.740331491712707	40.58461538461538
chr11	MEN1	64806082	64806230	19597	149	168530	4392	148933	4243	131.5234899328859	35.100872024510956
chr11	MEN1	64810457	64810512	640	56	168530	4392	167890	4336	11.428571428571429	38.720018450184504
chr11	EHD1	64879601	64879610	0	10	897331	6786	897331	6776	0.0	132.42783353010626
chr11	ATG2A	64902509	64902514	0	6	761500	7297	761500	7291	0.0	104.44383486490193
chr11	MAJIN	64954042	64954755	28138	714	59397	2337	31259	1623	39.40896358543417	19.260012322858902
chr11	BATF2	64990073	64990191	0	119	0	898	0	779	0.0	0.0
chr11	TMEM262	65088650	65088681	229	32	17216	697	16987	665	7.15625	25.54436090225564
chr11	FAU	65122035	65122088	0	54	645	821	645	767	0.0	0.8409387222946545
chr11	FAU	65121940	65122088	18	149	645	821	627	672	0.12080536912751678	0.9330357142857143
chr11	FAU	65121940	65122034	18	95	645	821	627	726	0.18947368421052632	0.8636363636363636
chr11	SLC25A45	65381874	65381913	108	40	320273	4923	320165	4883	2.7	65.56727421667009
chr11	LINC02736	65487885	65487888	730	4	190324	1397	189594	1393	182.5	136.10480976310123
chr11	LTBP3	65557628	65557631	0	4	366713	10116	366713	10112	0.0	36.265130537974684
chr11	MAP3K11	65613017	65614008	6239	992	16025	6397	9786	5405	6.289314516129032	1.81054579093432
chr11	RELA	65662664	65662708	1809	45	1911399	4483	1909590	4438	40.2	430.2816584046868
chr11	RELA	65662378	65662663	10130	286	1911399	4483	1901269	4197	35.41958041958042	453.00667143197524
chr11	RELA	65662378	65662708	11939	331	1911399	4483	1899460	4152	36.06948640483384	457.480732177264
chr11	RNASEH2C	65717244	65719679	102	2436	867	4492	765	2056	0.04187192118226601	0.3720817120622568
chr11	RNASEH2C	65717244	65717661	51	418	867	4492	816	4074	0.12200956937799043	0.20029455081001474
chr11	CFL1	65856884	65856929	0	46	591844	5673	591844	5627	0.0	105.17931402168118
chr11	CFL1	65861256	65861369	19	114	591844	5673	591825	5559	0.16666666666666666	106.4624932541824
chr11	EFEMP2	65866809	65866843	0	35	4023	4066	4023	4031	0.0	0.9980153807988092
chr11	EFEMP2	65866809	65867019	0	211	4023	4066	4023	3855	0.0	1.043579766536965
chr11	EFEMP2	65866809	65866864	0	56	4023	4066	4023	4010	0.0	1.0032418952618454
chr11	EFEMP2	65868294	65868304	36	11	4023	4066	3987	4055	3.272727272727273	0.9832305795314427
chr11	EFEMP2	65866844	65867019	0	176	4023	4066	4023	3890	0.0	1.0341902313624678
chr11	EFEMP2	65866844	65866864	0	21	4023	4066	4023	4045	0.0	0.9945611866501854
chr11	EFEMP2	65866865	65867019	0	155	4023	4066	4023	3911	0.0	1.0286371771925338
chr11	FIBP	65888333	65888341	0	9	3824	3155	3824	3146	0.0	1.2155117609663064
chr11	FIBP	65885508	65885528	0	21	3824	3155	3824	3134	0.0	1.2201659221442247
chr11	FIBP	65884310	65884390	0	81	3824	3155	3824	3074	0.0	1.2439817826935589
chr11	EIF1AD	66000052	66000097	0	46	113060	3333	113060	3287	0.0	34.396105871615454
chr11	EIF1AD	66001909	66002038	0	130	113060	3333	113060	3203	0.0	35.29815797689666
chr11	YIF1A	66284868	66284871	0	4	13169	2353	13169	2349	0.0	5.606215410813112
chr11	BRMS1	66341205	66341211	0	7	0	2375	0	2368	0.0	0.0
chr11	MRPL11	66438631	66438708	133	78	68365	2546	68232	2468	1.705128205128205	27.646677471636952
chr11	MRPL11	66436801	66436814	56	14	68365	2546	68309	2532	4.0	26.97827804107425
chr11	CTSF	66564087	66564094	0	8	24341	3628	24341	3620	0.0	6.72403314917127
chr11	CTSF	66567890	66567982	459	93	24341	3628	23882	3535	4.935483870967742	6.755869872701556
chr11	PC	66852742	66852745	0	4	7868	7336	7868	7332	0.0	1.0731042007637752
chr11	PC	66957739	66957867	0	129	7868	7336	7868	7207	0.0	1.091716386846122
chr11	POLD4	67353302	67353537	1990	236	1383863	2477	1381873	2241	8.432203389830509	616.632307005801
chr11	POLD4	67353302	67353362	459	61	1383863	2477	1383404	2416	7.524590163934426	572.6009933774834
chr11	POLD4	67353293	67353301	45	9	1383863	2477	1383818	2468	5.0	560.7042139384116
chr11	POLD4	67353293	67353362	504	70	1383863	2477	1383359	2407	7.2	574.7233070211882
chr11	POLD4	67353293	67353537	2035	245	1383863	2477	1381828	2232	8.306122448979592	619.0985663082437
chr11	PPP1CA	67419407	67419442	0	36	0	3928	0	3892	0.0	0.0
chr11	CORO1B	67440117	67440139	0	23	51	5227	51	5204	0.0	0.009800153727901615
chr11	TMEM134	67467164	67467310	0	147	0	1799	0	1652	0.0	0.0
chr11	TMEM134	67468016	67468026	0	11	0	1799	0	1788	0.0	0.0
chr11	CDK2AP2	67507859	67507999	0	141	0	2022	0	1881	0.0	0.0
chr11	CABP2	67522541	67522544	0	4	174	1496	174	1492	0.0	0.11662198391420911
chr11	ALDH3B2	67674435	67674435	0	1	151	3617	151	3616	0.0	0.041758849557522126
chr11	ALDH3B2	67674435	67674691	100	257	151	3617	51	3360	0.38910505836575876	0.015178571428571428
chr11	CHKA	68061492	68061598	0	107	345	3785	345	3678	0.0	0.09380097879282219
chr11	C11ORF24	68271645	68271855	206	211	3438	3139	3232	2928	0.976303317535545	1.1038251366120218
chr11	MRPL21	68900534	68900546	0	13	1410	2831	1410	2818	0.0	0.5003548616039745
chr11	MRPL21	68893321	68893401	0	81	1410	2831	1410	2750	0.0	0.5127272727272727
chr11	MRPL21	68896468	68896513	261	46	1410	2831	1149	2785	5.673913043478261	0.4125673249551167
chr11	LINC02753	70063682	70063921	0	240	510	1997	510	1757	0.0	0.29026750142287994
chr11	DHCR7	71448289	71448311	14	23	189	3448	175	3425	0.6086956521739131	0.051094890510948905
chr11	DHCR7	71448276	71448288	13	13	189	3448	176	3435	1.0	0.0512372634643377
chr11	DHCR7	71448276	71448311	27	36	189	3448	162	3412	0.75	0.047479484173505275
chr11	AP002495.1	71928364	71928447	2	84	53	3091	51	3007	0.023809523809523808	0.016960425673428665
chr11	NUMA1	72080319	72080456	0	138	248740	15188	248740	15050	0.0	16.527574750830563
chr11	NUMA1	72068078	72068103	26	26	248740	15188	248714	15162	1.0	16.403772589368156
chr11	ANAPC15	72111411	72111440	0	30	306	2872	306	2842	0.0	0.10767065446868403
chr11	ANAPC15	72112649	72112732	0	84	306	2872	306	2788	0.0	0.10975609756097561
chr11	ANAPC15	72112215	72112272	41	58	306	2872	265	2814	0.7068965517241379	0.09417199715707178
chr11	ANAPC15	72111923	72112214	10	292	306	2872	296	2580	0.03424657534246575	0.11472868217054263
chr11	CLPB	72434071	72434382	0	312	10858	12455	10858	12143	0.0	0.8941777155562876
chr11	PDE2A	72605137	72605197	0	61	22969	7220	22969	7159	0.0	3.208408995669786
chr11	ARAP1	72686041	72686093	0	53	20402	8718	20402	8665	0.0	2.354529717253318
chr11	ARAP1	72710384	72710432	0	49	20402	8718	20402	8669	0.0	2.35344330372592
chr11	STARD10	72780974	72781111	0	138	51	2748	51	2610	0.0	0.01954022988505747
chr11	STARD10	72780974	72781060	0	87	51	2748	51	2661	0.0	0.019165727170236752
chr11	STARD10	72781061	72781111	0	51	51	2748	51	2697	0.0	0.018909899888765295
chr11	P4HA3	74304269	74304302	635	34	1020	3632	385	3598	18.676470588235293	0.10700389105058365
chr11	LIPT2	74493237	74493465	306	229	354	2223	48	1994	1.3362445414847162	0.024072216649949848
chr11	LIPT2	74493199	74493236	0	38	354	2223	354	2185	0.0	0.16201372997711672
chr11	XRRA1	74933800	74933823	0	24	153	8801	153	8777	0.0	0.017431924347727015
chr11	MAP6	75667464	75668528	0	1065	6054	6344	6054	5279	0.0	1.1468081075961356
chr11	AP002360.1	76444204	76444276	0	73	0	986	0	913	0.0	0.0
chr11	LINC02757	76630190	76630193	0	4	0	1768	0	1764	0.0	0.0
chr11	AP003119.2	76782990	76783001	0	12	0	350	0	338	0.0	0.0
chr11	AP003119.2	76782984	76783001	0	18	0	350	0	332	0.0	0.0
chr11	AP003119.2	76782984	76782989	0	6	0	350	0	344	0.0	0.0
chr11	RSF1	77700720	77700728	0	9	165239	15757	165239	15748	0.0	10.49269748539497
chr11	INTS4	77924749	77924778	1941	30	30387	5755	28446	5725	64.7	4.968733624454148
chr11	INTS4	77924705	77924748	1969	44	30387	5755	28418	5711	44.75	4.976011206443705
chr11	INTS4	77924705	77924778	3910	74	30387	5755	26477	5681	52.83783783783784	4.6606231297306815
chr11	INTS4	77987528	77987602	0	75	30387	5755	30387	5680	0.0	5.3498239436619714
chr11	ALG8	78139493	78139527	0	35	1326	3191	1326	3156	0.0	0.42015209125475284
chr11	KCTD21	78188523	78188571	0	49	10529	3974	10529	3925	0.0	2.682547770700637
chr11	NARS2	78574347	78574827	0	481	0	3161	0	2680	0.0	0.0
chr11	MIR4300HG	82717581	82717787	68	207	34	4311	-34	4104	0.3285024154589372	-0.008284600389863547
chr11	PRCP	82901570	82901591	933	22	15247	13162	14314	13140	42.40909090909091	1.089345509893455
chr11	PRCP	82901458	82901591	7166	134	15247	13162	8081	13028	53.47761194029851	0.6202793982192202
chr11	PRCP	82900650	82900780	0	131	15247	13162	15247	13031	0.0	1.1700560202593815
chr11	PRCP	82901458	82901487	1824	30	15247	13162	13423	13132	60.8	1.0221596101127017
chr11	RAB30	82987586	82987589	0	4	71094	11843	71094	11839	0.0	6.005067995607737
chr11	RAB30	83034126	83034170	0	45	71094	11843	71094	11798	0.0	6.025936599423631
chr11	CCDC90B	83285872	83286098	0	227	51	5909	51	5682	0.0	0.00897571277719113
chr11	CCDC90B	83285552	83285871	0	320	51	5909	51	5589	0.0	0.00912506709608159
chr11	CCDC90B	83285552	83286098	0	547	51	5909	51	5362	0.0	0.009511376352107423
chr11	CCDC90B	83285126	83285871	0	746	51	5909	51	5163	0.0	0.009877977919814061
chr11	CCDC90B	83285126	83285551	0	426	51	5909	51	5483	0.0	0.009301477293452489
chr11	DLG2	85626586	85626597	0	12	226	16296	226	16284	0.0	0.013878653893392287
chr11	DLG2	85627217	85627687	0	471	226	16296	226	15825	0.0	0.014281200631911533
chr11	CREBZF	85663697	85663813	19	117	1457	4015	1438	3898	0.1623931623931624	0.3689071318624936
chr11	SYTL2	85724031	85727894	52016	3864	205524	11277	153508	7413	13.461697722567287	20.707945501146636
chr11	SYTL2	85718989	85719059	165	71	205524	11277	205359	11206	2.323943661971831	18.325807603069784
chr11	SYTL2	85719060	85719185	147	126	205524	11277	205377	11151	1.1666666666666667	18.41781006187786
chr11	ME3	86672297	86672322	0	26	1941	3801	1941	3775	0.0	0.5141721854304636
chr11	ME3	86672273	86672322	0	50	1941	3801	1941	3751	0.0	0.5174620101306319
chr11	ME3	86672273	86672296	0	24	1941	3801	1941	3777	0.0	0.5138999205718825
chr11	RAB38	88175182	88175236	8	55	153	1435	145	1380	0.14545454545454545	0.10507246376811594
chr11	CTSC	88312387	88312448	0	62	51	15798	51	15736	0.0	0.003240976105744789
chr11	CTSC	88312387	88312425	0	39	51	15798	51	15759	0.0	0.003236245954692557
chr11	CTSC	88337500	88337706	0	207	51	15798	51	15591	0.0	0.003271117952664999
chr11	CTSC	88337500	88337545	0	46	51	15798	51	15752	0.0	0.0032376841036058914
chr11	CTSC	88337546	88337706	0	161	51	15798	51	15637	0.0	0.0032614951717081283
chr11	CTSC	88312426	88312448	0	23	51	15798	51	15775	0.0	0.0032329635499207606
chr11	CTSC	88337172	88337499	0	328	51	15798	51	15470	0.0	0.0032967032967032967
chr11	CTSC	88337172	88337706	0	535	51	15798	51	15263	0.0	0.003341413876695276
chr11	CTSC	88337172	88337545	0	374	51	15798	51	15424	0.0	0.0033065352697095435
chr11	NOX4	89340062	89340124	0	63	0	6122	0	6059	0.0	0.0
chr11	CHORDC1	90222528	90222889	0	362	0	7182	0	6820	0.0	0.0
chr11	SLC36A4	93182805	93182833	0	29	153	9722	153	9693	0.0	0.015784586815227482
chr11	TAF1D	93736140	93736288	0	149	188	5700	188	5551	0.0	0.03386777157268961
chr11	MRE11	94492641	94492780	0	140	1931	7556	1931	7416	0.0	0.26038295577130527
chr11	MRE11	94493683	94493789	0	107	1931	7556	1931	7449	0.0	0.25922942676869376
chr11	MRE11	94493683	94493719	0	37	1931	7556	1931	7519	0.0	0.2568160659662189
chr11	MRE11	94493720	94493789	0	70	1931	7556	1931	7486	0.0	0.2579481699171787
chr11	SESN3	95232156	95232411	0	256	408	10592	408	10336	0.0	0.039473684210526314
chr11	FAM76B	95789391	95789681	0	291	828	5340	828	5049	0.0	0.16399286987522282
chr11	FAM76B	95788858	95788867	0	10	828	5340	828	5330	0.0	0.1553470919324578
chr11	MTMR2	95857551	95857554	0	4	3022	10675	3022	10671	0.0	0.2831974510355168
chr11	MTMR2	95865439	95865599	0	161	3022	10675	3022	10514	0.0	0.2874262887578467
chr11	MTMR2	95865439	95865589	0	151	3022	10675	3022	10524	0.0	0.2871531736982136
chr11	MTMR2	95923620	95923690	0	71	3022	10675	3022	10604	0.0	0.2849867974349302
chr11	MTMR2	95923691	95923873	459	183	3022	10675	2563	10492	2.5081967213114753	0.24428135722455205
chr11	MTMR2	95865590	95865599	0	10	3022	10675	3022	10665	0.0	0.283356774496015
chr11	MTMR2	95850207	95850598	0	392	3022	10675	3022	10283	0.0	0.2938831080424001
chr11	MTMR2	95866383	95866401	0	19	3022	10675	3022	10656	0.0	0.2835960960960961
chr11	CCDC82	96364979	96365125	0	147	0	14215	0	14068	0.0	0.0
chr11	CCDC82	96388382	96389363	0	982	0	14215	0	13233	0.0	0.0
chr11	CCDC82	96388382	96388693	0	312	0	14215	0	13903	0.0	0.0
chr11	LINC02713	97918837	97918840	0	4	0	1903	0	1899	0.0	0.0
chr11	PGR	101127433	101129426	0	1994	208	14342	208	12348	0.0	0.016844833171363784
chr11	MMP3	102843441	102843469	0	29	0	1836	0	1807	0.0	0.0
chr11	DCUN1D5	103091515	103091785	1408	271	3904	12866	2496	12595	5.195571955719557	0.1981738785232235
chr11	DCUN1D5	103091515	103091682	928	168	3904	12866	2976	12698	5.523809523809524	0.2343676169475508
chr11	DCUN1D5	103091683	103091785	480	103	3904	12866	3424	12763	4.660194174757281	0.2682754838204184
chr11	LINC02552	104566859	104568864	0	2006	0	15741	0	13735	0.0	0.0
chr11	LINC02552	104572075	104572555	0	481	0	15741	0	15260	0.0	0.0
chr11	CASP12	104891169	104891196	0	28	17	1795	17	1767	0.0	0.009620826259196379
chr11	CASP4LP	104906449	104906975	0	527	0	3314	0	2787	0.0	0.0
chr11	CASP4LP	104906449	104906958	0	510	0	3314	0	2804	0.0	0.0
chr11	CASP4LP	104906959	104906975	0	17	0	3314	0	3297	0.0	0.0
chr11	CASP1	105034207	105034422	0	216	0	3706	0	3490	0.0	0.0
chr11	MSANTD4	106020961	106022193	0	1233	0	3428	0	2195	0.0	0.0
chr11	MSANTD4	106020961	106022120	0	1160	0	3428	0	2268	0.0	0.0
chr11	MSANTD4	106020961	106021834	0	874	0	3428	0	2554	0.0	0.0
chr11	MSANTD4	106022121	106022193	0	73	0	3428	0	3355	0.0	0.0
chr11	MSANTD4	106021835	106022193	0	359	0	3428	0	3069	0.0	0.0
chr11	MSANTD4	106021835	106022120	0	286	0	3428	0	3142	0.0	0.0
chr11	ALKBH8	107565600	107565628	0	29	0	4215	0	4186	0.0	0.0
chr11	NPAT	108160879	108161319	0	441	13280	7108	13280	6667	0.0	1.991900404979751
chr11	LINC02715	109823619	109823754	0	136	0	1299	0	1163	0.0	0.0
chr11	ALG9	111870774	111870939	0	166	4268	7995	4268	7829	0.0	0.5451526376293269
chr11	ALG9	111870227	111870230	0	4	4268	7995	4268	7991	0.0	0.5341008634714053
chr11	CRYAB	111910633	111910694	306	62	67289	3377	66983	3315	4.935483870967742	20.20603318250377
chr11	CRYAB	111910633	111910669	156	37	67289	3377	67133	3340	4.216216216216216	20.099700598802396
chr11	CRYAB	111913104	111913137	0	34	67289	3377	67289	3343	0.0	20.128327849237213
chr11	CRYAB	111910695	111910831	194	137	67289	3377	67095	3240	1.416058394160584	20.708333333333332
chr11	CRYAB	111911907	111911917	0	11	67289	3377	67289	3366	0.0	19.990790255496137
chr11	CRYAB	111913597	111913704	0	108	67289	3377	67289	3269	0.0	20.583970633221167
chr11	CRYAB	111910670	111910694	150	25	67289	3377	67139	3352	6.0	20.02953460620525
chr11	PIH1D2	112073929	112073978	0	50	2913	3232	2913	3182	0.0	0.9154619736015085
chr11	AP000802.1	112961258	112961365	0	108	0	2957	0	2849	0.0	0.0
chr11	TMPRSS5	113699961	113700064	15174	104	27126	2681	11952	2577	145.90384615384616	4.6379511059371366
chr11	TMPRSS5	113696835	113696856	0	22	27126	2681	27126	2659	0.0	10.201579541180894
chr11	NXPE1	114553687	114554312	0	626	0	4399	0	3773	0.0	0.0
chr11	NXPE4	114582287	114582750	0	464	0	2193	0	1729	0.0	0.0
chr11	LINC00900	115759992	115760028	0	37	0	5016	0	4979	0.0	0.0
chr11	BUD13	116762552	116762953	1127	402	4112	2205	2985	1803	2.8034825870646767	1.6555740432612314
chr11	ZPR1	116787819	116787846	0	28	276	5417	276	5389	0.0	0.051215438856930785
chr11	APOA1	116837527	116837557	0	31	0	980	0	949	0.0	0.0
chr11	APOA1	116837558	116837603	0	46	0	980	0	934	0.0	0.0
chr11	PCSK7	117231786	117232025	51	240	126985	20140	126934	19900	0.2125	6.37859296482412
chr11	BACE1	117295130	117295261	0	132	1224	7202	1224	7070	0.0	0.17312588401697313
chr11	BACE1	117295130	117295317	0	188	1224	7202	1224	7014	0.0	0.174508126603935
chr11	BACE1	117295262	117295317	0	56	1224	7202	1224	7146	0.0	0.1712846347607053
chr11	FXYD6	117840318	117840342	0	25	0	4097	0	4072	0.0	0.0
chr11	FXYD6	117840236	117840317	0	82	0	4097	0	4015	0.0	0.0
chr11	FXYD6	117840236	117840342	0	107	0	4097	0	3990	0.0	0.0
chr11	SCN4B	118143832	118143985	0	154	0	5655	0	5501	0.0	0.0
chr11	JAML	118205881	118205913	0	33	153	6176	153	6143	0.0	0.02490639752563894
chr11	JAML	118212904	118212913	0	10	153	6176	153	6166	0.0	0.0248134933506325
chr11	JAML	118197967	118197996	0	30	153	6176	153	6146	0.0	0.024894240156199152
chr11	AP001267.3	118521245	118521264	1170	20	5520	2698	4350	2678	58.5	1.6243465272591486
chr11	RPS25	119017924	119017956	33	33	16	944	-17	911	1.0	-0.018660812294182216
chr11	SLC37A4	119030231	119030546	0	316	2425	4259	2425	3943	0.0	0.6150139487699721
chr11	SLC37A4	119029221	119029390	626	170	2425	4259	1799	4089	3.6823529411764704	0.4399608706285155
chr11	HYOU1	119057019	119057151	0	133	43386	6178	43386	6045	0.0	7.177171215880893
chr11	HYOU1	119057019	119057073	0	55	43386	6178	43386	6123	0.0	7.085742283194513
chr11	HYOU1	119057019	119057025	0	7	43386	6178	43386	6171	0.0	7.030627126883811
chr11	HYOU1	119056804	119057018	0	215	43386	6178	43386	5963	0.0	7.275867851752474
chr11	HYOU1	119056804	119056999	0	196	43386	6178	43386	5982	0.0	7.252758274824473
chr11	HYOU1	119057026	119057073	0	48	43386	6178	43386	6130	0.0	7.077650897226754
chr11	HYOU1	119057000	119057018	0	19	43386	6178	43386	6159	0.0	7.044325377496347
chr11	HYOU1	119057000	119057151	0	152	43386	6178	43386	6026	0.0	7.199800862927315
chr11	HYOU1	119057000	119057073	0	74	43386	6178	43386	6104	0.0	7.1077981651376145
chr11	HYOU1	119057000	119057025	0	26	43386	6178	43386	6152	0.0	7.052340702210663
chr11	DPAGT1	119097444	119097462	0	19	1117	3974	1117	3955	0.0	0.2824273072060683
chr11	C1QTNF5	119340183	119340290	0	108	1256	1540	1256	1432	0.0	0.8770949720670391
chr11	MFRP	119342854	119342871	0	18	318	4110	318	4092	0.0	0.07771260997067449
chr11	TRIM29	120185209	120185248	0	40	0	7755	0	7715	0.0	0.0
chr11	MIR100HG	122064954	122066134	0	1181	1420	24445	1420	23264	0.0	0.061038514442916095
chr11	MIR100HG	122101446	122101985	0	540	1420	24445	1420	23905	0.0	0.05940179878686467
chr11	MIR100HG	122453615	122453619	0	5	1420	24445	1420	24440	0.0	0.05810147299509002
chr11	HSPA8	123062063	123062311	2608	249	17786	4221	15178	3972	10.473895582329318	3.821248741188318
chr11	HSPA8	123062312	123062345	238	34	17786	4221	17548	4187	7.0	4.191067590160019
chr11	HSPA8	123061868	123061911	48	44	17786	4221	17738	4177	1.0909090909090908	4.2465884606176685
chr11	HSPA8	123061587	123061673	1230	87	17786	4221	16556	4134	14.137931034482758	4.004837929366231
chr11	LINC02727	123314320	123314501	51	182	0	1067	-51	885	0.2802197802197802	-0.0576271186440678
chr11	ZNF202	123740392	123740415	0	24	428	4708	428	4684	0.0	0.09137489325362938
chr11	TMEM225	123885244	123885393	0	150	0	995	0	845	0.0	0.0
chr11	ESAM	124754629	124754639	538	11	27441	2750	26903	2739	48.90909090909091	9.822197882438847
chr11	CCDC15-DT	124950719	124951337	0	619	268	2722	268	2103	0.0	0.1274369947693771
chr11	CCDC15-DT	124950719	124950900	0	182	268	2722	268	2540	0.0	0.10551181102362205
chr11	CCDC15-DT	124950901	124951337	0	437	268	2722	268	2285	0.0	0.11728665207877462
chr11	TMEM218	125102636	125102728	0	93	0	4681	0	4588	0.0	0.0
chr11	TMEM218	125102636	125102732	0	97	0	4681	0	4584	0.0	0.0
chr11	TMEM218	125111538	125111585	0	48	0	4681	0	4633	0.0	0.0
chr11	TMEM218	125111538	125111583	0	46	0	4681	0	4635	0.0	0.0
chr11	TMEM218	125102729	125102732	0	4	0	4681	0	4677	0.0	0.0
chr11	TMEM218	125102131	125102732	0	602	0	4681	0	4079	0.0	0.0
chr11	TMEM218	125111584	125111585	0	2	0	4681	0	4679	0.0	0.0
chr11	FEZ1	125495835	125496119	3360	285	1524623	9010	1521263	8725	11.789473684210526	174.35679083094556
chr11	ACRV1	125677796	125677852	0	57	663	1967	663	1910	0.0	0.3471204188481675
chr11	CDON	125961654	125961722	0	69	604	10623	604	10554	0.0	0.05722948645063483
chr11	CDON	126063225	126063270	96	46	604	10623	508	10577	2.0869565217391304	0.04802874160915193
chr11	AP001122.1	128686056	128686225	0	170	2514	4311	2514	4141	0.0	0.6070997343636803
chr11	TP53AIP1	128936761	128937676	87	916	5428	1377	5341	461	0.09497816593886463	11.585683297180044
chr11	NFRKB	129878308	129878309	0	2	6409	6363	6409	6361	0.0	1.0075459833359535
chr11	PRDM10	129912084	129912122	0	39	3983	6649	3983	6610	0.0	0.602571860816944
chr11	ZBTB44	130236792	130237008	0	217	153	9568	153	9351	0.0	0.016361886429258902
chr11	SNX19	130907952	130907967	0	16	51	15366	51	15350	0.0	0.0033224755700325733
chr11	SNX19	130914265	130916278	0	2014	51	15366	51	13352	0.0	0.0038196524865188736
chr11	SNX19	130914265	130914692	0	428	51	15366	51	14938	0.0	0.003414111661534342
chr11	THYN1	134253226	134253297	0	72	0	1816	0	1744	0.0	0.0
chr11	B3GAT1	134387826	134387842	0	17	0	11757	0	11740	0.0	0.0
chr12	NINJ2-AS1	643718	643837	0	120	51	4365	51	4245	0.0	0.012014134275618375
chr12	WNK1	890511	890513	0	3	12640	16067	12640	16064	0.0	0.7868525896414342
chr12	ERC1	991323	991487	0	165	28231	12243	28231	12078	0.0	2.33739029640669
chr12	LRTM2	1827595	1827630	0	36	1836	4285	1836	4249	0.0	0.4321016709814074
chr12	CACNA1C	2634375	2634380	6	6	41248	19162	41242	19156	1.0	2.1529546878262686
chr12	ITFG2	2818278	2818353	0	76	177	6111	177	6035	0.0	0.02932891466445733
chr12	ITFG2	2823944	2824013	0	70	177	6111	177	6041	0.0	0.029299784803840424
chr12	RHNO1	2885493	2885534	0	42	0	2529	0	2487	0.0	0.0
chr12	TEAD4	2960041	2960353	24	313	16150	2289	16126	1976	0.07667731629392971	8.160931174089068
chr12	TEAD4	2960197	2960353	0	157	16150	2289	16150	2132	0.0	7.575046904315197
chr12	TEAD4	2960041	2960196	24	156	16150	2289	16126	2133	0.15384615384615385	7.560243788091889
chr12	RAD51AP1	4543905	4543911	0	7	0	2491	0	2484	0.0	0.0
chr12	RAD51AP1	4556503	4556550	0	48	0	2491	0	2443	0.0	0.0
chr12	RAD51AP1	4553090	4553147	0	58	0	2491	0	2433	0.0	0.0
chr12	AC005906.2	5021769	5021842	0	74	0	7869	0	7795	0.0	0.0
chr12	CD9	6226361	6226440	0	80	0	4900	0	4820	0.0	0.0
chr12	TAPBPL	6452151	6452312	0	162	51	3198	51	3036	0.0	0.016798418972332016
chr12	GAPDH	6536791	6536817	0	27	9	2031	9	2004	0.0	0.004491017964071856
chr12	GAPDH	6534570	6534661	0	92	9	2031	9	1939	0.0	0.0046415678184631255
chr12	COPS7A	6724153	6724179	0	27	255	2633	255	2606	0.0	0.09785111281657713
chr12	COPS7A	6724153	6724250	0	98	255	2633	255	2535	0.0	0.10059171597633136
chr12	COPS7A	6724180	6724250	0	71	255	2633	255	2562	0.0	0.09953161592505855
chr12	COPS7A	6724153	6724266	0	114	255	2633	255	2519	0.0	0.10123064708217547
chr12	COPS7A	6724180	6724266	0	87	255	2633	255	2546	0.0	0.10015710919088766
chr12	COPS7A	6724251	6724266	0	16	255	2633	255	2617	0.0	0.09743981658387467
chr12	COPS7A	6724331	6724378	0	48	255	2633	255	2585	0.0	0.09864603481624758
chr12	COPS7A	6724369	6724378	0	10	255	2633	255	2623	0.0	0.09721692718261532
chr12	COPS7A	6724331	6724368	0	38	255	2633	255	2595	0.0	0.09826589595375723
chr12	GPR162	6823764	6824765	0	1002	69	2902	69	1900	0.0	0.03631578947368421
chr12	GPR162	6824715	6824765	0	51	69	2902	69	2851	0.0	0.024202034373903895
chr12	GNB3	6843696	6843698	0	3	344104	2973	344104	2970	0.0	115.85993265993265
chr12	USP5	6863309	6863377	0	69	416410	3612	416410	3543	0.0	117.53034151848716
chr12	TPI1	6868256	6868509	0	254	102	2535	102	2281	0.0	0.04471722928540114
chr12	TPI1	6868324	6868509	0	186	102	2535	102	2349	0.0	0.04342273307790549
chr12	TPI1	6868256	6868323	0	68	102	2535	102	2467	0.0	0.041345764085934336
chr12	LRRC23	6904904	6905075	0	172	644	3064	644	2892	0.0	0.22268326417704012
chr12	LRRC23	6904904	6905250	0	347	644	3064	644	2717	0.0	0.23702613176297388
chr12	LRRC23	6905076	6905250	0	175	644	3064	644	2889	0.0	0.22291450328833506
chr12	ENO2	6922093	6922164	0	72	50	3883	50	3811	0.0	0.013119916032537392
chr12	C12ORF57	6944566	6944652	4	87	39744	1715	39740	1628	0.04597701149425287	24.41031941031941
chr12	PTPN6	6951516	6951520	0	5	435502	4799	435502	4794	0.0	90.84313725490196
chr12	C1S	7061792	7061917	0	126	66899	5258	66899	5132	0.0	13.035658612626657
chr12	CLSTN3	7157692	7157746	0	55	153	6619	153	6564	0.0	0.02330895795246801
chr12	PEX5	7190525	7190569	0	45	2178	5387	2178	5342	0.0	0.4077124672407338
chr12	PEX5	7189751	7190216	31	466	2178	5387	2147	4921	0.06652360515021459	0.4362934362934363
chr12	PEX5	7189981	7190216	0	236	2178	5387	2178	5151	0.0	0.42283051834595226
chr12	NECAP1	8093044	8093055	0	12	1348	8370	1348	8358	0.0	0.16128260349365878
chr12	NECAP1	8090300	8090343	0	44	1348	8370	1348	8326	0.0	0.161902474177276
chr12	FAM66C	8188536	8188645	626	110	68343	4631	67717	4521	5.6909090909090905	14.978323379783234
chr12	RIMKLB	8697741	8697778	0	38	272	7829	272	7791	0.0	0.03491207803876267
chr12	AC092490.1	8788761	8788786	0	26	228	2265	228	2239	0.0	0.10183117463153193
chr12	A2ML1	8845175	8845306	0	132	1837	7146	1837	7014	0.0	0.2619047619047619
chr12	A2ML1	8845307	8845311	0	5	1837	7146	1837	7141	0.0	0.2572468841898894
chr12	PHC1	8932832	8933350	43833	519	72809	5613	28976	5094	84.45664739884393	5.688260698861406
chr12	PHC1	8919867	8919917	0	51	72809	5613	72809	5562	0.0	13.090435095289465
chr12	AC092821.3	9648377	9648933	0	557	35540	5997	35540	5440	0.0	6.533088235294118
chr12	AC092821.3	9648329	9648933	0	605	35540	5997	35540	5392	0.0	6.591246290801187
chr12	AC092821.3	9648329	9648376	0	48	35540	5997	35540	5949	0.0	5.9741132963523285
chr12	AC092821.3	9656650	9656697	0	48	35540	5997	35540	5949	0.0	5.9741132963523285
chr12	CLEC2D	9688087	9688161	0	75	102	6863	102	6788	0.0	0.015026517383618149
chr12	CLEC2D	9693116	9693948	102	833	102	6863	0	6030	0.12244897959183673	0.0
chr12	CLEC2D	9692932	9693948	102	1017	102	6863	0	5846	0.10029498525073746	0.0
chr12	CLEC12B	10015728	10015874	0	147	0	3850	0	3703	0.0	0.0
chr12	GABARAPL1	10214000	10214187	0	188	0	3148	0	2960	0.0	0.0
chr12	GABARAPL1	10214188	10214779	0	592	0	3148	0	2556	0.0	0.0
chr12	GABARAPL1	10213220	10214779	0	1560	0	3148	0	1588	0.0	0.0
chr12	GABARAPL1	10213618	10214779	0	1162	0	3148	0	1986	0.0	0.0
chr12	GABARAPL1	10214000	10214779	0	780	0	3148	0	2368	0.0	0.0
chr12	GABARAPL1	10213618	10214187	0	570	0	3148	0	2578	0.0	0.0
chr12	KLRD1	10311616	10311619	0	4	204	15814	204	15810	0.0	0.012903225806451613
chr12	LINC02366	10750301	10750459	0	159	349	966	349	807	0.0	0.43246592317224286
chr12	LINC01252	11559383	11559465	0	83	0	3605	0	3522	0.0	0.0
chr12	BORCS5	12357119	12357509	0	391	51	6525	51	6134	0.0	0.008314313661558527
chr12	CDKN1B	12718054	12718314	0	261	2901	2077	2901	1816	0.0	1.597466960352423
chr12	GPRC5A	12912143	12912300	765	158	26318	7667	25553	7509	4.841772151898734	3.402983086962312
chr12	ATF7IP	14419191	14419361	0	171	162	12643	162	12472	0.0	0.012989095574085953
chr12	ATF7IP	14419219	14419361	0	143	162	12643	162	12500	0.0	0.01296
chr12	H2AJ	14774913	14774976	373	64	22228	3322	21855	3258	5.828125	6.708103130755064
chr12	PTPRO	15595058	15595640	0	583	51	18862	51	18279	0.0	0.0027900869850648285
chr12	MGST1	16354271	16354378	0	108	51	6231	51	6123	0.0	0.008329250367466928
chr12	AEBP2	19404125	19404216	0	92	1948	6279	1948	6187	0.0	0.3148537255535801
chr12	SLCO1C1	20750793	20750895	0	103	67590	4794	67590	4691	0.0	14.40844169686634
chr12	PYROXD1	21462121	21462125	0	5	0	5425	0	5420	0.0	0.0
chr12	AC084816.1	22787721	22787725	0	5	34	6101	34	6096	0.0	0.00557742782152231
chr12	AC084816.1	22859546	22860095	0	550	34	6101	34	5551	0.0	0.006125022518465141
chr12	AC084816.1	23054155	23054323	0	169	34	6101	34	5932	0.0	0.0057316250842886045
chr12	AC084816.1	23185543	23185594	0	52	34	6101	34	6049	0.0	0.005620763762605389
chr12	SOX5-AS1	24254936	24255042	0	107	0	3161	0	3054	0.0	0.0
chr12	ETFRF1	25195338	25195341	0	4	94	2377	94	2373	0.0	0.03961230509903076
chr12	ETFRF1	25203824	25203832	0	9	94	2377	94	2368	0.0	0.03969594594594594
chr12	RASSF8	26052603	26052996	0	394	1275	5419	1275	5025	0.0	0.2537313432835821
chr12	MED21	27022622	27022871	0	250	867	2970	867	2720	0.0	0.31875
chr12	STK38L	27302189	27302255	0	67	1680	6882	1680	6815	0.0	0.24651504035216434
chr12	ARNTL2	27333104	27333136	0	33	1734	7001	1734	6968	0.0	0.24885189437428243
chr12	PPFIBP1	27664438	27664446	0	9	33707	11261	33707	11252	0.0	2.9956452186277995
chr12	KLHL42	27780382	27781202	102	821	78045	7360	77943	6539	0.12423873325213154	11.919712494265179
chr12	CCDC91	28305780	28305806	0	27	0	7033	0	7006	0.0	0.0
chr12	AC010198.2	30795812	30796216	1377	405	97577	18419	96200	18014	3.4	5.340290884867326
chr12	AC010198.2	30796030	30796216	663	187	97577	18419	96914	18232	3.5454545454545454	5.315598946906538
chr12	DDX11	31073970	31074091	0	122	102	7413	102	7291	0.0	0.013989850500617199
chr12	DDX11	31102312	31102335	0	24	102	7413	102	7389	0.0	0.013804303694681283
chr12	ETFBKMT	31659790	31659935	0	146	2084	6875	2084	6729	0.0	0.30970426512111754
chr12	BICD1	32337707	32337816	0	110	3892	12614	3892	12504	0.0	0.3112603966730646
chr12	DNM1L	32701473	32701562	0	90	684	7139	684	7049	0.0	0.09703504043126684
chr12	ALG10	34022745	34022770	0	26	102	4200	102	4174	0.0	0.024436990896023
chr12	AC046130.2	34037628	34037648	0	21	0	2566	0	2545	0.0	0.0
chr12	ALG10B	38317039	38317064	0	26	0	8599	0	8573	0.0	0.0
chr12	LRRK2	40367060	40367077	0	18	120	11039	120	11021	0.0	0.010888304146629163
chr12	LINC02400	41764258	41764265	0	8	0	1273	0	1265	0.0	0.0
chr12	LINC02400	41764260	41764265	0	6	0	1273	0	1267	0.0	0.0
chr12	LINC02400	41764258	41764259	0	2	0	1273	0	1271	0.0	0.0
chr12	LINC02400	41764258	41765050	0	793	0	1273	0	480	0.0	0.0
chr12	LINC02400	41764266	41765050	0	785	0	1273	0	488	0.0	0.0
chr12	LINC02400	41764260	41765050	0	791	0	1273	0	482	0.0	0.0
chr12	LINC02400	41764807	41765050	0	244	0	1273	0	1029	0.0	0.0
chr12	LINC02400	41764266	41764281	0	16	0	1273	0	1257	0.0	0.0
chr12	LINC02400	41764260	41764281	0	22	0	1273	0	1251	0.0	0.0
chr12	LINC02450	42692277	42692513	0	237	1421	1477	1421	1240	0.0	1.145967741935484
chr12	IRAK4	43772987	43773072	0	86	51	5626	51	5540	0.0	0.0092057761732852
chr12	IRAK4	43759017	43759592	0	576	51	5626	51	5050	0.0	0.0100990099009901
chr12	AC008014.1	46383696	46383713	0	18	11101	4863	11101	4845	0.0	2.2912280701754386
chr12	SLC48A1	47773437	47773440	0	4	306	4924	306	4920	0.0	0.06219512195121951
chr12	TMEM106C	47966173	47966229	0	57	357	3201	357	3144	0.0	0.11354961832061068
chr12	TMEM106C	47963634	47963704	0	71	357	3201	357	3130	0.0	0.11405750798722045
chr12	PFKM	48105718	48105810	0	93	1671	6825	1671	6732	0.0	0.2482174688057041
chr12	PFKM	48135039	48135383	0	345	1671	6825	1671	6480	0.0	0.25787037037037036
chr12	PFKM	48106138	48106311	0	174	1671	6825	1671	6651	0.0	0.25124041497519173
chr12	PFKM	48106182	48106311	0	130	1671	6825	1671	6695	0.0	0.24958924570575056
chr12	PFKM	48106253	48106311	0	59	1671	6825	1671	6766	0.0	0.24697014484185634
chr12	PFKM	48106138	48106181	0	44	1671	6825	1671	6781	0.0	0.24642383129331957
chr12	PFKM	48106138	48106252	0	115	1671	6825	1671	6710	0.0	0.24903129657228018
chr12	PFKM	48106182	48106252	0	71	1671	6825	1671	6754	0.0	0.24740894284868226
chr12	PFKM	48119407	48119462	0	56	1671	6825	1671	6769	0.0	0.2468606884325602
chr12	PFKM	48122654	48122677	0	24	1671	6825	1671	6801	0.0	0.24569916188795765
chr12	PFKM	48139350	48139504	0	155	1671	6825	1671	6670	0.0	0.25052473763118444
chr12	CACNB3	48818523	48818558	0	36	102	6342	102	6306	0.0	0.016175071360608945
chr12	CACNB3	48818523	48818974	0	452	102	6342	102	5890	0.0	0.01731748726655348
chr12	CACNB3	48818559	48818974	0	416	102	6342	102	5926	0.0	0.01721228484643942
chr12	TROAP	49323947	49324037	10608	91	1269930	3637	1259322	3546	116.57142857142857	355.13874788494076
chr12	TROAP	49325561	49325658	5609	98	1269930	3637	1264321	3539	57.234693877551024	357.25374399547894
chr12	SPATS2	49366920	49367021	0	102	27818	6730	27818	6628	0.0	4.197042848521424
chr12	SPATS2	49366920	49367587	0	668	27818	6730	27818	6062	0.0	4.5889145496535795
chr12	SPATS2	49367022	49367587	0	566	27818	6730	27818	6164	0.0	4.512978585334198
chr12	PRPF40B	49642979	49643016	0	38	696	8412	696	8374	0.0	0.08311440171960831
chr12	TMBIM6	49742116	49742280	0	165	2757	5925	2757	5760	0.0	0.4786458333333333
chr12	TMBIM6	49741612	49741768	0	157	2757	5925	2757	5768	0.0	0.47798196948682387
chr12	BCDIN3D-AS1	49828745	49828748	0	4	612	4668	612	4664	0.0	0.1312178387650086
chr12	LINC02395	49923878	49924000	0	123	85306	6673	85306	6550	0.0	13.023816793893129
chr12	LINC02395	49926138	49926145	0	8	85306	6673	85306	6665	0.0	12.799099774943736
chr12	LINC02395	49923878	49924513	153	636	85306	6673	85153	6037	0.24056603773584906	14.105184694384628
chr12	LINC02395	49924001	49924513	153	513	85306	6673	85153	6160	0.2982456140350877	13.823538961038961
chr12	AQP2	49954320	49954445	1224	126	85417	2403	84193	2277	9.714285714285714	36.9754062362758
chr12	ASIC1	50080590	50080727	0	138	8646	4848	8646	4710	0.0	1.8356687898089172
chr12	ASIC1	50077050	50077060	0	11	8646	4848	8646	4837	0.0	1.7874715732892288
chr12	COX14	50112302	50112497	0	196	0	974	0	778	0.0	0.0
chr12	LARP4	50474108	50474167	0	60	97448	8113	97448	8053	0.0	12.100831988078976
chr12	LETMD1	51048372	51048478	0	107	564	3857	564	3750	0.0	0.1504
chr12	LETMD1	51048479	51048518	0	40	564	3857	564	3817	0.0	0.14776002095886823
chr12	LETMD1	51048372	51048518	0	147	564	3857	564	3710	0.0	0.15202156334231806
chr12	LETMD1	51052208	51052246	0	39	564	3857	564	3818	0.0	0.14772132006286012
chr12	DAZAP2	51241040	51241116	0	77	84	3807	84	3730	0.0	0.022520107238605896
chr12	SCN8A	51688850	51690019	55	1170	6609	16021	6554	14851	0.04700854700854701	0.4413170830247121
chr12	SCN8A	51689097	51690019	43	923	6609	16021	6566	15098	0.04658721560130011	0.43489203868061993
chr12	SCN8A	51721909	51721941	0	33	6609	16021	6609	15988	0.0	0.41337252939704777
chr12	ANKRD33	51889483	51889512	0	30	2064	2094	2064	2064	0.0	1.0
chr12	TAMALIN	52011142	52011207	0	66	0	2831	0	2765	0.0	0.0
chr12	NR4A1	52054652	52055204	0	553	1734	6100	1734	5547	0.0	0.31260140616549487
chr12	ATG101	52070072	52070242	0	171	0	3130	0	2959	0.0	0.0
chr12	ATG101	52070049	52070242	0	194	0	3130	0	2936	0.0	0.0
chr12	ATG101	52070049	52070071	0	23	0	3130	0	3107	0.0	0.0
chr12	LINC00592	52210936	52211020	0	85	328	2261	328	2176	0.0	0.15073529411764705
chr12	LINC00592	52222944	52223074	0	131	328	2261	328	2130	0.0	0.1539906103286385
chr12	EIF4B	53034710	53034724	0	15	0	5369	0	5354	0.0	0.0
chr12	TNS2	53059968	53060258	0	291	0	7370	0	7079	0.0	0.0
chr12	TNS2	53062692	53062697	0	6	0	7370	0	7364	0.0	0.0
chr12	TNS2	53058828	53058854	0	27	0	7370	0	7343	0.0	0.0
chr12	ESPL1	53268848	53268928	0	81	2923	7320	2923	7239	0.0	0.40378505318414143
chr12	ESPL1	53268378	53268406	0	29	2923	7320	2923	7291	0.0	0.4009052256206282
chr12	MYG1	53303173	53303193	0	21	192	2506	192	2485	0.0	0.0772635814889336
chr12	PFDN5	53296468	53296551	0	84	9874	2927	9874	2843	0.0	3.473091804431938
chr12	AMHR2	53425488	53425573	2251	86	62865	3292	60614	3206	26.174418604651162	18.90642545227698
chr12	PRR13	53441793	53441800	0	8	1471	2774	1471	2766	0.0	0.5318148951554591
chr12	PRR13	53441801	53441817	117	17	1471	2774	1354	2757	6.882352941176471	0.49111352919840406
chr12	PRR13	53441793	53441817	117	25	1471	2774	1354	2749	4.68	0.4925427428155693
chr12	PRR13	53441801	53441840	416	40	1471	2774	1055	2734	10.4	0.3858814923189466
chr12	PRR13	53441793	53441840	416	48	1471	2774	1055	2726	8.666666666666666	0.38701393983859134
chr12	PRR13	53441818	53441840	299	23	1471	2774	1172	2751	13.0	0.42602689930934207
chr12	PCBP2	53452976	53453283	260	308	60444	6885	60184	6577	0.8441558441558441	9.15067660027368
chr12	TARBP2	53503130	53503212	0	83	51	3979	51	3896	0.0	0.013090349075975359
chr12	HOXC11	53973924	53973927	0	4	0	3267	0	3263	0.0	0.0
chr12	HNRNPA1	54282663	54282665	0	3	0	4239	0	4236	0.0	0.0
chr12	HNRNPA1	54282666	54282874	0	209	0	4239	0	4030	0.0	0.0
chr12	HNRNPA1	54281095	54281295	0	201	0	4239	0	4038	0.0	0.0
chr12	HNRNPA1	54281942	54281945	0	4	0	4239	0	4235	0.0	0.0
chr12	HNRNPA1	54281897	54281908	0	12	0	4239	0	4227	0.0	0.0
chr12	HNRNPA1	54282597	54282665	0	69	0	4239	0	4170	0.0	0.0
chr12	HNRNPA1	54282612	54282665	0	54	0	4239	0	4185	0.0	0.0
chr12	HNRNPA1	54282642	54282665	0	24	0	4239	0	4215	0.0	0.0
chr12	HNRNPA1	54282597	54282611	0	15	0	4239	0	4224	0.0	0.0
chr12	HNRNPA1	54282597	54282662	0	66	0	4239	0	4173	0.0	0.0
chr12	HNRNPA1	54282612	54282662	0	51	0	4239	0	4188	0.0	0.0
chr12	HNRNPA1	54282642	54282662	0	21	0	4239	0	4218	0.0	0.0
chr12	HNRNPA1	54282597	54282641	0	45	0	4239	0	4194	0.0	0.0
chr12	HNRNPA1	54282612	54282641	0	30	0	4239	0	4209	0.0	0.0
chr12	HNRNPA1	54282821	54282823	0	3	0	4239	0	4236	0.0	0.0
chr12	HNRNPA1	54282875	54282932	0	58	0	4239	0	4181	0.0	0.0
chr12	HNRNPA1	54282824	54282841	0	18	0	4239	0	4221	0.0	0.0
chr12	HNRNPA1	54282821	54282841	0	21	0	4239	0	4218	0.0	0.0
chr12	HNRNPA1	54283133	54283225	0	93	0	4239	0	4146	0.0	0.0
chr12	HNRNPA1	54283133	54283228	0	96	0	4239	0	4143	0.0	0.0
chr12	HNRNPA1	54283226	54283228	0	3	0	4239	0	4236	0.0	0.0
chr12	HNRNPA1	54283133	54283234	0	102	0	4239	0	4137	0.0	0.0
chr12	HNRNPA1	54283226	54283234	0	9	0	4239	0	4230	0.0	0.0
chr12	HNRNPA1	54283229	54283234	0	6	0	4239	0	4233	0.0	0.0
chr12	HNRNPA1	54283163	54283234	0	72	0	4239	0	4167	0.0	0.0
chr12	HNRNPA1	54284318	54284321	0	4	0	4239	0	4235	0.0	0.0
chr12	HNRNPA1	54286283	54286286	0	4	0	4239	0	4235	0.0	0.0
chr12	OR6C4	55549967	55550118	0	152	51	5153	51	5001	0.0	0.010197960407918417
chr12	TMEM198B	55833015	55833038	0	24	0	4040	0	4016	0.0	0.0
chr12	TMEM198B	55831084	55831349	0	266	0	4040	0	3774	0.0	0.0
chr12	TMEM198B	55833015	55833125	0	111	0	4040	0	3929	0.0	0.0
chr12	TMEM198B	55833039	55833125	0	87	0	4040	0	3953	0.0	0.0
chr12	DGKA	55940169	55940170	0	2	93	7520	93	7518	0.0	0.012370311252992818
chr12	DGKA	55932124	55932255	0	132	93	7520	93	7388	0.0	0.012587980508933406
chr12	DGKA	55932181	55932255	0	75	93	7520	93	7445	0.0	0.01249160510409671
chr12	DGKA	55932124	55932180	0	57	93	7520	93	7463	0.0	0.012461476617982045
chr12	CDK2	55967125	55967934	0	810	102	3698	102	2888	0.0	0.035318559556786706
chr12	CDK2	55967403	55967416	0	14	102	3698	102	3684	0.0	0.02768729641693811
chr12	SUOX	55999459	55999590	0	132	51	4350	51	4218	0.0	0.01209103840682788
chr12	IKZF4	56021451	56021580	0	130	0	6273	0	6143	0.0	0.0
chr12	MYL6B	56155494	56155592	682	99	4182	2943	3500	2844	6.888888888888889	1.230661040787623
chr12	MYL6	56159623	56159730	186	108	2762	3310	2576	3202	1.7222222222222223	0.8044971892567145
chr12	NABP2	56224442	56224521	1248	80	106498	2114	105250	2034	15.6	51.74532940019666
chr12	SLC39A5	56230874	56230900	0	27	306	2914	306	2887	0.0	0.10599237963283685
chr12	COQ10A	56269109	56269251	0	143	51	2553	51	2410	0.0	0.02116182572614108
chr12	IL23A	56334220	56334260	0	41	4002	1184	4002	1143	0.0	3.5013123359580054
chr12	RBMS2	56587660	56587664	0	5	91014	8931	91014	8926	0.0	10.196504593322876
chr12	LRP1	57201906	57201947	0	42	15218	20587	15218	20545	0.0	0.7407155025553662
chr12	SHMT2	57231914	57231917	0	4	0	3713	0	3709	0.0	0.0
chr12	SHMT2	57230201	57230244	0	44	0	3713	0	3669	0.0	0.0
chr12	SHMT2	57230236	57230244	0	9	0	3713	0	3704	0.0	0.0
chr12	SHMT2	57230245	57230256	0	12	0	3713	0	3701	0.0	0.0
chr12	SHMT2	57230201	57230256	0	56	0	3713	0	3657	0.0	0.0
chr12	SHMT2	57230236	57230256	0	21	0	3713	0	3692	0.0	0.0
chr12	SHMT2	57230201	57230235	0	35	0	3713	0	3678	0.0	0.0
chr12	SHMT2	57230342	57230420	0	79	0	3713	0	3634	0.0	0.0
chr12	SHMT2	57230421	57230474	0	54	0	3713	0	3659	0.0	0.0
chr12	SHMT2	57230463	57230474	0	12	0	3713	0	3701	0.0	0.0
chr12	SHMT2	57230421	57230462	0	42	0	3713	0	3671	0.0	0.0
chr12	SHMT2	57230421	57230660	0	240	0	3713	0	3473	0.0	0.0
chr12	SHMT2	57230475	57230660	0	186	0	3713	0	3527	0.0	0.0
chr12	SHMT2	57230463	57230660	0	198	0	3713	0	3515	0.0	0.0
chr12	SHMT2	57230421	57230666	0	246	0	3713	0	3467	0.0	0.0
chr12	SHMT2	57230475	57230666	0	192	0	3713	0	3521	0.0	0.0
chr12	SHMT2	57230463	57230666	0	204	0	3713	0	3509	0.0	0.0
chr12	SHMT2	57230661	57230666	0	6	0	3713	0	3707	0.0	0.0
chr12	MARS1	57488103	57488199	204	97	247514	6060	247310	5963	2.1030927835051547	41.47409022304209
chr12	MARS1	57515992	57516158	0	167	247514	6060	247514	5893	0.0	42.001357542847444
chr12	KIF5A	57572625	57572726	2509	102	105466	8616	102957	8514	24.598039215686274	12.092670894996477
chr12	KIF5A	57550401	57550791	6127	391	105466	8616	99339	8225	15.67007672634271	12.077689969604863
chr12	KIF5A	57578331	57578342	108	12	105466	8616	105358	8604	9.0	12.245234774523478
chr12	KIF5A	57582630	57583215	0	586	105466	8616	105466	8030	0.0	13.133997509339975
chr12	PIP4K2C	57591401	57591463	3211	63	92982	3262	89771	3199	50.96825396825397	28.062206939668645
chr12	PIP4K2C	57591435	57591463	944	29	92982	3262	92038	3233	32.55172413793103	28.46829570058769
chr12	PIP4K2C	57591401	57591434	2267	34	92982	3262	90715	3228	66.67647058823529	28.102540272614622
chr12	SLC26A10	57621054	57621092	0	39	237533	3092	237533	3053	0.0	77.80314444808386
chr12	SLC26A10	57625689	57625752	3808	64	237533	3092	233725	3028	59.5	77.18791281373844
chr12	SLC26A10	57621792	57621842	0	51	237533	3092	237533	3041	0.0	78.11016113120684
chr12	SLC26A10	57625319	57625330	3903	12	237533	3092	233630	3080	325.25	75.8538961038961
chr12	OS9	57695977	57696038	0	62	7815	4766	7815	4704	0.0	1.6613520408163265
chr12	OS9	57718377	57718421	0	45	7815	4766	7815	4721	0.0	1.6553696250794323
chr12	OS9	57695982	57696038	0	57	7815	4766	7815	4709	0.0	1.6595880229348057
chr12	TSPAN31	57745218	57745231	0	14	51	4546	51	4532	0.0	0.011253309796999117
chr12	EEF1AKMT3	57773074	57773128	34	55	3322	3164	3288	3109	0.6181818181818182	1.0575747828883886
chr12	TSFM	57782859	57782877	0	19	1745	3221	1745	3202	0.0	0.5449718925671455
chr12	TSFM	57783653	57784170	1401	518	1745	3221	344	2703	2.7046332046332044	0.12726600073991862
chr12	TSFM	57782859	57782907	0	49	1745	3221	1745	3172	0.0	0.550126103404792
chr12	TSFM	57782878	57782907	0	30	1745	3221	1745	3191	0.0	0.5468505170792854
chr12	AC020637.1	58805983	58806059	0	77	0	1739	0	1662	0.0	0.0
chr12	SLC16A7	59689391	59689470	0	80	0	13706	0	13626	0.0	0.0
chr12	MON2	62535641	62535709	0	69	1012	15990	1012	15921	0.0	0.06356384649205452
chr12	RXYLT1	63780130	63780462	0	333	0	4507	0	4174	0.0	0.0
chr12	XPOT	64425139	64425182	0	44	366	7345	366	7301	0.0	0.05013011916175866
chr12	TBK1	64464460	64464463	0	4	23165	12697	23165	12693	0.0	1.825021665484913
chr12	TBK1	64481957	64482021	692	65	23165	12697	22473	12632	10.646153846153846	1.7790531982267257
chr12	TBK1	64495773	64495775	0	3	23165	12697	23165	12694	0.0	1.8248778950685363
chr12	TBK1	64499145	64499280	0	136	23165	12697	23165	12561	0.0	1.8442003025236844
chr12	TBK1	64495605	64495608	0	4	23165	12697	23165	12693	0.0	1.825021665484913
chr12	LEMD3	65170419	65171118	0	700	0	5221	0	4521	0.0	0.0
chr12	MSRB3	65279050	65279071	0	22	0	7420	0	7398	0.0	0.0
chr12	AC090023.1	65558672	65558763	0	92	88	1031	88	939	0.0	0.09371671991480299
chr12	CAND1	67305313	67306597	0	1285	3162	13597	3162	12312	0.0	0.25682261208577
chr12	RAP1B	68611044	68611052	0	9	51	16213	51	16204	0.0	0.0031473710195013575
chr12	RAP1B	68611029	68611052	0	24	51	16213	51	16189	0.0	0.0031502872320711595
chr12	RAP1B	68611029	68611043	0	15	51	16213	51	16198	0.0	0.0031485368564020248
chr12	RAP1B	68611044	68611056	0	13	51	16213	51	16200	0.0	0.003148148148148148
chr12	RAP1B	68611053	68611056	0	4	51	16213	51	16209	0.0	0.003146400148065889
chr12	MDM2	68835844	68835984	0	141	0	10870	0	10729	0.0	0.0
chr12	RAB3IP	69800333	69800337	0	5	24835	10469	24835	10464	0.0	2.373375382262997
chr12	RAB3IP	69779097	69779181	0	85	24835	10469	24835	10384	0.0	2.391660246533128
chr12	CNOT2	70244190	70244322	204	133	1946	10263	1742	10130	1.5338345864661653	0.171964461994077
chr12	CNOT2	70344229	70344239	0	11	1946	10263	1946	10252	0.0	0.18981662114709325
chr12	TMEM19	71700879	71701025	0	147	102	3519	102	3372	0.0	0.030249110320284697
chr12	AC128707.1	78477490	78477511	0	22	663	3254	663	3232	0.0	0.20513613861386137
chr12	AC027288.1	79542392	79542410	0	19	51	1296	51	1277	0.0	0.039937353171495694
chr12	LINC01490	80763215	80763228	0	14	0	1770	0	1756	0.0	0.0
chr12	LINC01490	80763618	80763704	0	87	0	1770	0	1683	0.0	0.0
chr12	LINC01490	80763649	80763704	0	56	0	1770	0	1714	0.0	0.0
chr12	LINC01490	80763618	80763648	0	31	0	1770	0	1739	0.0	0.0
chr12	ACSS3	81078429	81078431	0	3	102	16849	102	16846	0.0	0.0060548498159800545
chr12	LINC02426	81953880	81954155	0	276	0	1337	0	1061	0.0	0.0
chr12	TMTC3	88142397	88142487	75	91	75	7342	0	7251	0.8241758241758241	0.0
chr12	LINC02822	90676613	90676651	0	39	153	12517	153	12478	0.0	0.01226158038147139
chr12	AC025164.1	92146244	92146254	0	11	102	9025	102	9014	0.0	0.011315731084978922
chr12	LINC02412	93176015	93176029	0	15	7039	2726	7039	2711	0.0	2.5964588712652157
chr12	NUDT4	93378694	93378790	0	97	51	10086	51	9989	0.0	0.0051056161777955755
chr12	MRPL42	93470506	93470590	0	85	0	15816	0	15731	0.0	0.0
chr12	SOCS2	93571427	93571914	0	488	204	4478	204	3990	0.0	0.05112781954887218
chr12	SOCS2	93571915	93572186	0	272	204	4478	204	4206	0.0	0.04850213980028531
chr12	SOCS2	93572187	93572375	0	189	204	4478	204	4289	0.0	0.04756353462345535
chr12	VEZT	95258283	95258287	0	5	959	7893	959	7888	0.0	0.12157707910750506
chr12	VEZT	95282360	95282644	816	285	959	7893	143	7608	2.863157894736842	0.018796004206098844
chr12	VEZT	95218278	95218345	0	68	959	7893	959	7825	0.0	0.12255591054313099
chr12	NEDD1	96907301	96907322	0	22	153	4482	153	4460	0.0	0.03430493273542601
chr12	NEDD1	96907625	96907856	0	232	153	4482	153	4250	0.0	0.036
chr12	RMST	97541309	97541357	0	49	65	10114	65	10065	0.0	0.006458022851465474
chr12	SLC25A3	98593741	98593744	0	4	306	7682	306	7678	0.0	0.03985412867934358
chr12	SLC25A3	98595558	98595661	0	104	306	7682	306	7578	0.0	0.040380047505938245
chr12	APAF1	98648783	98648815	0	33	112	7025	112	6992	0.0	0.016018306636155607
chr12	ACTR6	100205745	100205757	0	13	927	3828	927	3815	0.0	0.24298820445609437
chr12	ACTR6	100200920	100201060	0	141	927	3828	927	3687	0.0	0.25142392188771356
chr12	SCYL2	100267397	100267792	0	396	0	6940	0	6544	0.0	0.0
chr12	NR1H4	100532599	100532610	0	12	8695	3643	8695	3631	0.0	2.394657119250895
chr12	HSP90B1	103930339	103930564	0	226	0	4445	0	4219	0.0	0.0
chr12	TXNRD1	104287110	104287346	0	237	195270	6737	195270	6500	0.0	30.04153846153846
chr12	TXNRD1	104287110	104287431	0	322	195270	6737	195270	6415	0.0	30.439594699922058
chr12	TXNRD1	104287347	104287431	0	85	195270	6737	195270	6652	0.0	29.355081178592904
chr12	TXNRD1	104309951	104310099	0	149	195270	6737	195270	6588	0.0	29.640255009107467
chr12	CHST11	104457515	104457529	74	15	3059	6497	2985	6482	4.933333333333334	0.46050601666152424
chr12	WASHC4	105133897	105133899	0	3	12354	7697	12354	7694	0.0	1.6056667533142708
chr12	AC007622.2	107736695	107736947	0	253	0	1917	0	1664	0.0	0.0
chr12	ISCU	108567744	108567757	0	14	0	2718	0	2704	0.0	0.0
chr12	AC007569.1	108634423	108634629	0	207	0	2121	0	1914	0.0	0.0
chr12	UBE3B	109477765	109478109	0	345	135155	11625	135155	11280	0.0	11.981826241134751
chr12	UBE3B	109477777	109478109	0	333	135155	11625	135155	11292	0.0	11.969093163301453
chr12	UBE3B	109477765	109477776	0	12	135155	11625	135155	11613	0.0	11.638250236803582
chr12	TCHP	109900732	109901059	561	328	27084	8836	26523	8508	1.7103658536585367	3.1174188998589565
chr12	IFT81	110124444	110124861	0	418	1108	6495	1108	6077	0.0	0.18232680598979759
chr12	ATP2A2	110346322	110347791	13187	1470	46604	7473	33417	6003	8.970748299319729	5.56671664167916
chr12	ATP2A2	110347454	110347791	196	338	46604	7473	46408	7135	0.5798816568047337	6.504274702172389
chr12	FAM216A	110468526	110469018	9085	493	25711	2675	16626	2182	18.427991886409735	7.61961503208066
chr12	RAD9B	110502355	110502383	0	29	0	3723	0	3694	0.0	0.0
chr12	RAD9B	110502377	110502383	0	7	0	3723	0	3716	0.0	0.0
chr12	RAD9B	110502355	110502376	0	22	0	3723	0	3701	0.0	0.0
chr12	TCTN1	110626435	110626492	0	58	6981	5815	6981	5757	0.0	1.2126107347576862
chr12	TCTN1	110614403	110614463	114	61	6981	5815	6867	5754	1.8688524590163935	1.1934306569343065
chr12	MAPKAPK5	111889001	111889006	1479	6	106850	8890	105371	8884	246.5	11.860760918505179
chr12	TRAFD1	112125619	112126149	269	531	4657	3776	4388	3245	0.5065913370998116	1.3522342064714945
chr12	TRAFD1	112140981	112141224	0	244	4657	3776	4657	3532	0.0	1.3185164212910532
chr12	RPH3A	112791985	112792012	0	28	103767	9716	103767	9688	0.0	10.710879438480594
chr12	OAS1	112911236	112911258	0	23	12345	4920	12345	4897	0.0	2.520931182356545
chr12	OAS2	112987084	112987308	240	225	306	5140	66	4915	1.0666666666666667	0.013428280773143439
chr12	TPCN1	113221237	113221378	0	142	102	8434	102	8292	0.0	0.012301013024602027
chr12	TPCN1	113221584	113221626	0	43	102	8434	102	8391	0.0	0.01215588130139435
chr12	SDSL	113422478	113422887	0	410	1415	2082	1415	1672	0.0	0.8462918660287081
chr12	TBX5-AS1	114408286	114408437	0	152	0	4185	0	4033	0.0	0.0
chr12	FBXW8	116911158	116911355	0	198	36	5207	36	5009	0.0	0.007187063286085047
chr12	RFC5	118017816	118018053	0	238	0	3264	0	3026	0.0	0.0
chr12	RFC5	118017816	118017852	0	37	0	3264	0	3227	0.0	0.0
chr12	PXN-AS1	120206622	120206712	0	91	1224	4119	1224	4028	0.0	0.3038728897715988
chr12	HNF1A	120978693	120978840	0	148	191671	4197	191671	4049	0.0	47.337861200296366
chr12	P2RX4	121222963	121223043	0	81	1351	2757	1351	2676	0.0	0.5048579970104634
chr12	RNF34	121409677	121409777	0	101	153	4729	153	4628	0.0	0.03305963699222126
chr12	SETD1B	121817654	121817704	0	51	663	8500	663	8449	0.0	0.07847082494969819
chr12	PSMD9	121899846	121899889	0	44	9381	8780	9381	8736	0.0	1.0738324175824177
chr12	BCL7A	122054927	122054989	0	63	8676	6571	8676	6508	0.0	1.3331284572833435
chr12	OGFOD2	122978058	122978091	0	34	44735	3734	44735	3700	0.0	12.090540540540541
chr12	OGFOD2	122974729	122975121	26651	393	44735	3734	18084	3341	67.81424936386769	5.412750673451063
chr12	OGFOD2	122978092	122978199	0	108	44735	3734	44735	3626	0.0	12.337286265857694
chr12	OGFOD2	122978058	122978199	0	142	44735	3734	44735	3592	0.0	12.454064587973274
chr12	OGFOD2	122976964	122977166	1038	203	44735	3734	43697	3531	5.113300492610837	12.375247805154347
chr12	ARL6IP4	122980386	122980745	965	360	2579	2195	1614	1835	2.6805555555555554	0.8795640326975477
chr12	ARL6IP4	122981267	122981299	0	33	2579	2195	2579	2162	0.0	1.192876965772433
chr12	ARL6IP4	122980746	122980887	840	142	2579	2195	1739	2053	5.915492957746479	0.8470530930345835
chr12	ARL6IP4	122980813	122980887	544	75	2579	2195	2035	2120	7.253333333333333	0.9599056603773585
chr12	ARL6IP4	122980746	122980812	296	67	2579	2195	2283	2128	4.417910447761194	1.0728383458646618
chr12	C12ORF65	123233532	123233924	306	393	565267	6318	564961	5925	0.7786259541984732	95.35206751054852
chr12	TCTN2	123671323	123671348	7	26	8478	3823	8471	3797	0.2692307692307692	2.2309718198577824
chr12	ZNF664	123973304	123973352	0	49	23395	6130	23395	6081	0.0	3.8472290741654334
chr12	LINC02826	126027314	126027717	0	404	0	3943	0	3539	0.0	0.0
chr12	AC007368.1	126405049	126405310	0	262	51	5841	51	5579	0.0	0.00914142319412081
chr12	LINC02347	126442589	126442663	0	75	0	5846	0	5771	0.0	0.0
chr12	LINC02347	126458131	126458541	0	411	0	5846	0	5435	0.0	0.0
chr12	LINC02347	126466728	126467321	0	594	0	5846	0	5252	0.0	0.0
chr12	LINC02824	126690589	126690698	0	110	0	1543	0	1433	0.0	0.0
chr12	LINC00943	126744889	126744919	0	31	0	8509	0	8478	0.0	0.0
chr12	LINC00943	126745333	126745881	0	549	0	8509	0	7960	0.0	0.0
chr12	LINC00943	126734970	126735249	0	280	0	8509	0	8229	0.0	0.0
chr12	LINC00943	126737157	126737186	0	30	0	8509	0	8479	0.0	0.0
chr12	LINC00507	127944788	127944799	0	12	0	6567	0	6555	0.0	0.0
chr12	LINC00507	127948923	127948958	0	36	0	6567	0	6531	0.0	0.0
chr12	LINC02368	128118635	128118777	0	143	0	2377	0	2234	0.0	0.0
chr12	LINC02368	128118635	128118867	0	233	0	2377	0	2144	0.0	0.0
chr12	LINC02368	128118778	128118867	0	90	0	2377	0	2287	0.0	0.0
chr12	TMEM132D-AS1	129111140	129111669	0	530	0	696	0	166	0.0	0.0
chr12	TMEM132D-AS1	129109758	129111669	0	1912	0	696	0	-1216	0.0	-0.0
chr12	TMEM132D-AS1	129111516	129111669	0	154	0	696	0	542	0.0	0.0
chr12	PIWIL1	130338147	130338171	0	25	0	5303	0	5278	0.0	0.0
chr12	PIWIL1	130338147	130338223	0	77	0	5303	0	5226	0.0	0.0
chr12	PIWIL1	130338172	130338223	0	52	0	5303	0	5251	0.0	0.0
chr12	PIWIL1	130339544	130339700	0	157	0	5303	0	5146	0.0	0.0
chr12	AC095350.1	130667673	130667682	0	10	0	3131	0	3121	0.0	0.0
chr12	AC095350.1	130668503	130668546	0	44	0	3131	0	3087	0.0	0.0
chr12	RAN	130872913	130872920	0	8	0	3779	0	3771	0.0	0.0
chr12	RAN	130872618	130872629	0	12	0	3779	0	3767	0.0	0.0
chr12	RAN	130872127	130872629	0	503	0	3779	0	3276	0.0	0.0
chr12	SFSWAP	131714194	131714240	0	47	204	8562	204	8515	0.0	0.023957721667645333
chr12	PUS1	131929286	131929380	0	95	0	5331	0	5236	0.0	0.0
chr12	PUS1	131929381	131929796	0	416	0	5331	0	4915	0.0	0.0
chr12	PUS1	131929286	131929796	0	511	0	5331	0	4820	0.0	0.0
chr12	PUS1	131929405	131929796	0	392	0	5331	0	4939	0.0	0.0
chr12	PUS1	131929381	131929404	0	24	0	5331	0	5307	0.0	0.0
chr12	EP400P1	132125397	132125408	0	12	0	11921	0	11909	0.0	0.0
chr12	FBRSL1	132572339	132572344	0	6	69289	9402	69289	9396	0.0	7.374308216262239
chr12	P2RX2	132618922	132618989	202	68	35491	1867	35289	1799	2.9705882352941178	19.615897720956088
chr12	P2RX2	132620584	132620588	35	5	35491	1867	35456	1862	7.0	19.04189044038668
chr12	P2RX2	132621346	132621364	829	19	35491	1867	34662	1848	43.63157894736842	18.756493506493506
chr12	ZNF84	133037546	133037554	0	9	306	8823	306	8814	0.0	0.03471749489448604
chr12	ZNF10	133130755	133131014	2291	260	40038	5508	37747	5248	8.811538461538461	7.1926448170731705
chr12	ZNF268	133181628	133181686	0	59	564660	14004	564660	13945	0.0	40.491932592327
chr12	AC026369.1	147757	149077	0	1321	0	5449	0	4128	0.0	0.0
chr12	SLC6A12	209772	209889	0	118	0	5131	0	5013	0.0	0.0
chr12	RAD52	949601	949604	0	4	10810	4296	10810	4292	0.0	2.5186393289841567
chr12	RAD52	929763	929817	47	55	10810	4296	10763	4241	0.8545454545454545	2.537844847913228
chr12	RAD52	929972	930049	0	78	10810	4296	10810	4218	0.0	2.5628259838786156
chr12	RAD52	949402	949600	0	199	10810	4296	10810	4097	0.0	2.638515987307786
chr12	RAD52	949402	949604	0	203	10810	4296	10810	4093	0.0	2.641094551673589
chr12	CACNA2D4	1801042	1801047	0	6	41714	7501	41714	7495	0.0	5.565577051367578
chr12	CRACR2A	3648359	3648540	0	182	0	12489	0	12307	0.0	0.0
chr12	CCND2-AS1	4252366	4252533	0	168	51	2768	51	2600	0.0	0.019615384615384614
chr12	AKAP3	4648744	4648765	0	22	6262	3678	6262	3656	0.0	1.7128008752735229
chr12	LINC02443	5239887	5239978	0	92	89	3988	89	3896	0.0	0.02284394250513347
chr12	LINC02443	5242542	5243066	0	525	89	3988	89	3463	0.0	0.025700259890268553
chr12	LINC02443	5242531	5243066	0	536	89	3988	89	3452	0.0	0.025782155272305908
chr12	LINC02443	5242531	5242541	0	11	89	3988	89	3977	0.0	0.022378677395021373
chr12	SCNN1A	6362050	6362066	0	17	767827	5671	767827	5654	0.0	135.80244074991157
chr12	CD27-AS1	6450340	6450868	127	529	421931	3028	421804	2499	0.24007561436672967	168.7891156462585
chr12	CD27-AS1	6450340	6450472	0	133	421931	3028	421931	2895	0.0	145.7447322970639
chr12	CD27-AS1	6443542	6443544	78	3	421931	3028	421853	3025	26.0	139.45553719008265
chr12	CD27-AS1	6443539	6443544	156	6	421931	3028	421775	3022	26.0	139.5681667769689
chr12	CD27-AS1	6443539	6443541	78	3	421931	3028	421853	3025	26.0	139.45553719008265
chr12	MRPL51	6493057	6493249	476	193	42363	1177	41887	984	2.466321243523316	42.56808943089431
chr12	MRPL51	6493458	6493715	17151	258	42363	1177	25212	919	66.47674418604652	27.4341675734494
chr12	MRPL51	6493458	6493672	17151	215	42363	1177	25212	962	79.77209302325582	26.20790020790021
chr12	MRPL51	6493673	6493715	0	43	42363	1177	42363	1134	0.0	37.357142857142854
chr12	NOP2	6568138	6568205	307	68	30073	4122	29766	4054	4.514705882352941	7.3423778983719785
chr12	CHD4	6573070	6573072	417	3	844242	11254	843825	11251	139.0	75.0
chr12	CHD4	6581037	6581042	0	6	844242	11254	844242	11248	0.0	75.05707681365575
chr12	CHD4	6583195	6583196	0	2	844242	11254	844242	11252	0.0	75.03039459651617
chr12	CHD4	6578337	6578407	0	71	844242	11254	844242	11183	0.0	75.49333810247697
chr12	CHD4	6587660	6587710	0	51	844242	11254	844242	11203	0.0	75.35856467017763
chr12	CHD4	6587660	6587705	0	46	844242	11254	844242	11208	0.0	75.32494646680942
chr12	CHD4	6587706	6587710	0	5	844242	11254	844242	11249	0.0	75.05040448039826
chr12	ING4	6652935	6652943	9	9	435	2186	426	2177	1.0	0.1956821313734497
chr12	ZNF384	6689097	6689366	1214	270	143357	3521	142143	3251	4.496296296296296	43.72285450630575
chr12	ZNF384	6688702	6688835	0	134	143357	3521	143357	3387	0.0	42.32565692353115
chr12	MLF2	6750144	6750175	0	32	102	3274	102	3242	0.0	0.03146206045650833
chr12	CDCA3	6850832	6851220	102	389	2011	4204	1909	3815	0.2622107969151671	0.5003931847968546
chr12	PHB2	6967891	6967894	0	4	427344	2236	427344	2232	0.0	191.46236559139786
chr12	PHB2	6969497	6969505	0	9	427344	2236	427344	2227	0.0	191.89223170184104
chr12	C1R	7091772	7091797	193	26	241510	4719	241317	4693	7.423076923076923	51.420626464947794
chr12	CD163L1	7433343	7433372	0	30	2207	5555	2207	5525	0.0	0.3994570135746606
chr12	CD163L1	7368057	7368085	224	29	2207	5555	1983	5526	7.724137931034483	0.35884907709011943
chr12	CLEC4C	7730780	7730795	0	16	0	1574	0	1558	0.0	0.0
chr12	SLC2A14	7872806	7872858	0	53	64	5594	64	5541	0.0	0.011550261685616315
chr12	SLC2A14	7872859	7873017	0	159	64	5594	64	5435	0.0	0.011775528978840846
chr12	C3AR1	8066220	8066276	0	57	105	3493	105	3436	0.0	0.030558789289871945
chr12	FAM86FP	8236970	8236971	0	2	5345	931	5345	929	0.0	5.7534983853606025
chr12	FAM86FP	8238666	8238670	0	5	5345	931	5345	926	0.0	5.772138228941684
chr12	FAM86FP	8240641	8240644	0	4	5345	931	5345	927	0.0	5.765911542610572
chr12	CLEC4E	8539141	8539198	0	58	29	2107	29	2049	0.0	0.014153245485602733
chr12	A2MP1	9233385	9233467	0	83	102	4692	102	4609	0.0	0.022130614016055542
chr12	MAGOHB	10613438	10613539	0	102	0	3788	0	3686	0.0	0.0
chr12	MAGOHB	10612639	10612813	0	175	0	3788	0	3613	0.0	0.0
chr12	STYK1	10629474	10629491	0	18	0	3454	0	3436	0.0	0.0
chr12	YBX3	10704050	10704058	0	9	85	7024	85	7015	0.0	0.012116892373485389
chr12	YBX3	10710533	10710652	0	120	85	7024	85	6904	0.0	0.0123117033603708
chr12	AC078950.1	11434991	11435124	0	134	0	1264	0	1130	0.0	0.0
chr12	GSG1	13088737	13088860	0	124	918	3041	918	2917	0.0	0.3147068906410696
chr12	ART4	14840444	14841080	1734	637	1887	5248	153	4611	2.7221350078492934	0.03318152244632401
chr12	ARHGDIB	14950916	14951004	0	89	92362	1780	92362	1691	0.0	54.61975162625665
chr12	EPS8	15881779	15882261	0	483	3754	8578	3754	8095	0.0	0.46374305126621373
chr12	EPS8	15684168	15684195	0	28	3754	8578	3754	8550	0.0	0.4390643274853801
chr12	LMO3	16600654	16600712	0	59	51	6936	51	6877	0.0	0.007416024429256944
chr12	LMO3	16600600	16600653	0	54	51	6936	51	6882	0.0	0.0074106364428945075
chr12	LMO3	16600600	16600712	0	113	51	6936	51	6823	0.0	0.007474717866041331
chr12	LMO3	16606816	16606999	0	184	51	6936	51	6752	0.0	0.007553317535545024
chr12	LMO3	16607000	16607045	0	46	51	6936	51	6890	0.0	0.007402031930333817
chr12	LMO3	16607290	16607303	0	14	51	6936	51	6922	0.0	0.00736781277087547
chr12	LMO3	16605624	16605766	0	143	51	6936	51	6793	0.0	0.007507728544089504
chr12	LMO3	16606816	16607045	0	230	51	6936	51	6706	0.0	0.00760512973456606
chr12	LMO3	16601854	16602016	0	163	51	6936	51	6773	0.0	0.0075298981249077215
chr12	PLCZ1	18694909	18694934	0	26	0	2968	0	2942	0.0	0.0
chr12	PLCZ1	18737931	18737933	0	3	0	2968	0	2965	0.0	0.0
chr12	LINC02468	20125726	20125737	0	12	50	1350	50	1338	0.0	0.03736920777279522
chr12	SLCO1A2	21394905	21395268	0	364	0	11312	0	10948	0.0	0.0
chr12	RECQL	21501169	21501461	0	293	0	3755	0	3462	0.0	0.0
chr12	RECQL	21501169	21501411	0	243	0	3755	0	3512	0.0	0.0
chr12	RECQL	21501412	21501461	0	50	0	3755	0	3705	0.0	0.0
chr12	RECQL	21501412	21501479	0	68	0	3755	0	3687	0.0	0.0
chr12	RECQL	21501462	21501479	0	18	0	3755	0	3737	0.0	0.0
chr12	LDHB	21657467	21657749	2387	283	11324	2807	8937	2524	8.434628975265017	3.5408082408874804
chr12	SOX5	23895792	23895896	0	105	468	11064	468	10959	0.0	0.042704626334519574
chr12	SOX5	24562332	24562336	0	5	468	11064	468	11059	0.0	0.042318473641378064
chr12	C12ORF77	24997231	24997432	0	202	1887	2689	1887	2487	0.0	0.758745476477684
chr12	CFAP94	25119144	25119157	0	14	68	3013	68	2999	0.0	0.022674224741580526
chr12	CFAP94	25194885	25195074	0	190	68	3013	68	2823	0.0	0.024087849805171802
chr12	CFAP94	25195057	25195074	0	18	68	3013	68	2995	0.0	0.02270450751252087
chr12	KRAS	25250750	25250762	0	13	51	6852	51	6839	0.0	0.0074572305892674365
chr12	LMNTD1	25553068	25553163	0	96	63	3102	63	3006	0.0	0.020958083832335328
chr12	RASSF8-AS1	25952757	25955136	12	2380	26179	9597	26167	7217	0.005042016806722689	3.625744769294721
chr12	RASSF8-AS1	25957875	25958017	0	143	26179	9597	26179	9454	0.0	2.76909244764121
chr12	INTS13	26937657	26937794	36	138	81	3078	45	2940	0.2608695652173913	0.015306122448979591
chr12	TM7SF3	27014077	27014307	0	231	217	5517	217	5286	0.0	0.041051835035944
chr12	AC009509.1	27710598	27710661	0	64	940	1560	940	1496	0.0	0.6283422459893048
chr12	PTHLH	27970024	27970068	0	45	51	3412	51	3367	0.0	0.015147015147015146
chr12	PTHLH	27969680	27970023	0	344	51	3412	51	3068	0.0	0.016623207301173403
chr12	PTHLH	27969680	27970007	0	328	51	3412	51	3084	0.0	0.016536964980544747
chr12	PTHLH	27970008	27970023	0	16	51	3412	51	3396	0.0	0.015017667844522967
chr12	PTHLH	27970008	27970068	0	61	51	3412	51	3351	0.0	0.01521933751119069
chr12	ERGIC2	29343119	29343161	0	43	663	5842	663	5799	0.0	0.11433005690636316
chr12	ERGIC2	29380574	29381113	0	540	663	5842	663	5302	0.0	0.12504715201810637
chr12	TMTC1	29518471	29518479	0	9	62696	14707	62696	14698	0.0	4.265614369301946
chr12	IPO8	30676895	30677044	0	150	153	6688	153	6538	0.0	0.023401651881309268
chr12	IPO8	30688359	30688691	0	333	153	6688	153	6355	0.0	0.024075531077891423
chr12	CAPRIN2	30719078	30720809	0	1732	204	8052	204	6320	0.0	0.032278481012658226
chr12	CAPRIN2	30741015	30741018	0	4	204	8052	204	8048	0.0	0.025347912524850896
chr12	CAPRIN2	30754725	30754749	0	25	204	8052	204	8027	0.0	0.025414226983929238
chr12	CAPRIN2	30754680	30754749	0	70	204	8052	204	7982	0.0	0.02555750438486595
chr12	CAPRIN2	30754680	30754687	0	8	204	8052	204	8044	0.0	0.02536051715564396
chr12	CAPRIN2	30754688	30754749	0	62	204	8052	204	7990	0.0	0.02553191489361702
chr12	AMN1	31728970	31728989	20	20	134	3144	114	3124	1.0	0.03649167733674776
chr12	KIF21A	39311414	39311415	0	2	12	10156	12	10154	0.0	0.0011818002757533978
chr12	KIF21A	39321347	39322666	0	1320	12	10156	12	8836	0.0	0.001358080579447714
chr12	AC006197.2	42023809	42023833	0	25	0	2089	0	2064	0.0	0.0
chr12	ZCRB1	42324018	42324066	0	49	102	8686	102	8637	0.0	0.011809656130600903
chr12	ZCRB1	42324588	42325922	0	1335	102	8686	102	7351	0.0	0.013875663175078221
chr12	PRICKLE1	42589464	42589596	0	133	2753	8022	2753	7889	0.0	0.34896691595893015
chr12	PRICKLE1	42484053	42484272	0	220	2753	8022	2753	7802	0.0	0.3528582414765445
chr12	LINC02402	42645352	42646268	0	917	1378	1549	1378	632	0.0	2.180379746835443
chr12	PUS7L	43754335	43755215	0	881	0	14023	0	13142	0.0	0.0
chr12	PUS7L	43758285	43758728	0	444	0	14023	0	13579	0.0	0.0
chr12	PUS7L	43758285	43758699	0	415	0	14023	0	13608	0.0	0.0
chr12	PUS7L	43758700	43758728	0	29	0	14023	0	13994	0.0	0.0
chr12	TWF1	43805830	43806219	0	390	0	3656	0	3266	0.0	0.0
chr12	NELL2	44774746	44774760	0	15	22	6365	22	6350	0.0	0.0034645669291338585
chr12	SCAF11	45922935	45922982	0	48	0	14007	0	13959	0.0	0.0
chr12	SLC38A1	46268525	46268863	0	339	1080	10037	1080	9698	0.0	0.11136316766343576
chr12	AMIGO2	47079141	47079145	0	5	0	3967	0	3962	0.0	0.0
chr12	PCED1B-AS1	47209280	47210638	0	1359	0	1838	0	479	0.0	0.0
chr12	HDAC7	47796206	47796213	0	8	51	7662	51	7654	0.0	0.006663182649594983
chr12	HDAC7	47785710	47785750	0	41	51	7662	51	7621	0.0	0.006692035165988716
chr12	HDAC7	47820482	47820552	0	71	51	7662	51	7591	0.0	0.006718482413384271
chr12	VDR	47904563	47904953	0	391	153	5295	153	4904	0.0	0.031199021207177813
chr12	VDR	47878815	47878966	0	152	153	5295	153	5143	0.0	0.02974917363406572
chr12	SENP1	48105401	48105455	0	55	1493	5824	1493	5769	0.0	0.25879701854740855
chr12	ASB8	48151564	48151608	0	45	31	4093	31	4048	0.0	0.007658102766798419
chr12	ASB8	48157409	48157457	0	49	31	4093	31	4044	0.0	0.007665677546983185
chr12	ZNF641	48350045	48350117	0	73	0	8510	0	8437	0.0	0.0
chr12	KANSL2	48654940	48654951	0	12	0	3188	0	3176	0.0	0.0
chr12	KANSL2	48660365	48660466	0	102	0	3188	0	3086	0.0	0.0
chr12	KANSL2	48681381	48681569	0	189	0	3188	0	2999	0.0	0.0
chr12	KANSL2	48681857	48681970	0	114	0	3188	0	3074	0.0	0.0
chr12	DDX23	48832421	48832449	0	29	51	4903	51	4874	0.0	0.0104636848584325
chr12	RND1	48865362	48865646	0	285	0	3952	0	3667	0.0	0.0
chr12	WNT10B	48968148	48968201	0	54	51	2607	51	2553	0.0	0.0199764982373678
chr12	PRKAG1	49018523	49018730	0	208	51	3614	51	3406	0.0	0.014973576042278332
chr12	KMT2D	49044190	49044198	0	9	47391	20387	47391	20378	0.0	2.3255962312297576
chr12	RHEBL1	49066955	49066966	0	12	306	1307	306	1295	0.0	0.2362934362934363
chr12	LMBR1L	49106544	49106652	0	109	5090	4888	5090	4779	0.0	1.065076375810839
chr12	LMBR1L	49101168	49101248	0	81	5090	4888	5090	4807	0.0	1.0588724776367797
chr12	LMBR1L	49104718	49104744	15	27	5090	4888	5075	4861	0.5555555555555556	1.044023863402592
chr12	LMBR1L	49106510	49106543	0	34	5090	4888	5090	4854	0.0	1.0486196950968274
chr12	LMBR1L	49106510	49106652	0	143	5090	4888	5090	4745	0.0	1.0727081138040042
chr12	TUBA1A	49188416	49188887	0	472	255	3106	255	2634	0.0	0.09681093394077449
chr12	TUBA1A	49188888	49188975	0	88	255	3106	255	3018	0.0	0.08449304174950298
chr12	MCRS1	49567646	49567682	0	37	486	3102	486	3065	0.0	0.15856443719412724
chr12	MCRS1	49567646	49567746	0	101	486	3102	486	3001	0.0	0.161946017994002
chr12	MCRS1	49567683	49567746	0	64	486	3102	486	3038	0.0	0.15997366688610928
chr12	FAM186B	49605201	49605380	0	180	1038	4585	1038	4405	0.0	0.23564131668558455
chr12	RACGAP1	50016630	50016633	0	4	20521	4511	20521	4507	0.0	4.553139560683381
chr12	RACGAP1	50025397	50025449	0	53	20521	4511	20521	4458	0.0	4.603185284881112
chr12	RACGAP1	50025327	50025396	29	70	20521	4511	20492	4441	0.4142857142857143	4.614276063949561
chr12	RACGAP1	50025327	50025449	29	123	20521	4511	20492	4388	0.23577235772357724	4.6700091157702825
chr12	RACGAP1	50025372	50025396	0	25	20521	4511	20521	4486	0.0	4.574453856442265
chr12	RACGAP1	50025327	50025371	29	45	20521	4511	20492	4466	0.6444444444444445	4.588446036721899
chr12	SLC11A2	51008475	51008584	0	110	2170	9310	2170	9200	0.0	0.2358695652173913
chr12	SLC11A2	51026309	51026313	0	5	2170	9310	2170	9305	0.0	0.23320795271359485
chr12	SLC11A2	50988299	50988380	0	82	2170	9310	2170	9228	0.0	0.2351538794971825
chr12	SLC11A2	50991486	50991597	0	112	2170	9310	2170	9198	0.0	0.2359208523592085
chr12	SLC11A2	51000562	51000596	0	35	2170	9310	2170	9275	0.0	0.2339622641509434
chr12	SLC11A2	51005599	51005651	0	53	2170	9310	2170	9257	0.0	0.2344171977962623
chr12	SLC11A2	51026293	51026308	0	16	2170	9310	2170	9294	0.0	0.23348396815149558
chr12	SLC11A2	51026293	51026313	0	21	2170	9310	2170	9289	0.0	0.23360964581763377
chr12	SLC11A2	51025672	51025773	0	102	2170	9310	2170	9208	0.0	0.23566463944396177
chr12	CSRNP2	51083228	51083337	0	110	6462	5233	6462	5123	0.0	1.2613702908452078
chr12	TFCP2	51172300	51172599	0	300	2265	2120	2265	1820	0.0	1.2445054945054945
chr12	GALNT6	51391286	51391353	0	68	8114	7363	8114	7295	0.0	1.112268677176148
chr12	GALNT6	51391081	51391285	0	205	8114	7363	8114	7158	0.0	1.133556859457949
chr12	GALNT6	51383460	51383490	147	31	8114	7363	7967	7332	4.741935483870968	1.086606655755592
chr12	GALNT6	51391081	51391353	0	273	8114	7363	8114	7090	0.0	1.144428772919605
chr12	KRT85	52364305	52364365	0	61	0	2722	0	2661	0.0	0.0
chr12	KRT4	52813596	52813846	0	251	0	2886	0	2635	0.0	0.0
chr12	KRT8	52949455	52949713	0	259	0	6121	0	5862	0.0	0.0
chr12	AC068888.1	53045599	53045959	0	361	0	5374	0	5013	0.0	0.0
chr12	AC068888.1	53045586	53045598	0	13	0	5374	0	5361	0.0	0.0
chr12	CSAD	53171272	53171324	0	53	0	4328	0	4275	0.0	0.0
chr12	CSAD	53159621	53159621	0	1	0	4328	0	4327	0.0	0.0
chr12	CSAD	53171877	53171880	0	4	0	4328	0	4324	0.0	0.0
chr12	ITGB7	53201071	53201116	0	46	0	4220	0	4174	0.0	0.0
chr12	ITGB7	53201071	53201145	0	75	0	4220	0	4145	0.0	0.0
chr12	ITGB7	53201117	53201145	0	29	0	4220	0	4191	0.0	0.0
chr12	RARG	53232510	53232762	0	253	0	4962	0	4709	0.0	0.0
chr12	AAAS	53321342	53321469	0	128	2530	4055	2530	3927	0.0	0.6442577030812325
chr12	AAAS	53324561	53324690	0	130	2530	4055	2530	3925	0.0	0.6445859872611465
chr12	AAAS	53307844	53308050	0	207	2530	4055	2530	3848	0.0	0.6574844074844075
chr12	MAP3K12	53484245	53484255	0	11	408	7186	408	7175	0.0	0.05686411149825784
chr12	ATF7	53543296	53543328	0	33	1502	4276	1502	4243	0.0	0.3539948149893943
chr12	ATP5MC2	53676175	53676240	10388	66	74800	2796	64412	2730	157.3939393939394	23.594139194139196
chr12	CALCOCO1	53724584	53724643	0	60	142072	7583	142072	7523	0.0	18.88501927422571
chr12	CALCOCO1	53726199	53726242	0	44	142072	7583	142072	7539	0.0	18.844939647168058
chr12	SMUG1	54183655	54183763	0	109	0	4520	0	4411	0.0	0.0
chr12	SMUG1	54188510	54188513	0	4	0	4520	0	4516	0.0	0.0
chr12	SMUG1	54188725	54188949	0	225	0	4520	0	4295	0.0	0.0
chr12	SMUG1	54188725	54188824	0	100	0	4520	0	4420	0.0	0.0
chr12	CBX5	54259269	54259507	0	239	153	15046	153	14807	0.0	0.010332950631458095
chr12	GTSF1	54471759	54472142	0	384	370	2536	370	2152	0.0	0.17193308550185873
chr12	GLYCAM1	54608618	54608651	0	34	0	529	0	495	0.0	0.0
chr12	GLYCAM1	54609605	54609631	0	27	0	529	0	502	0.0	0.0
chr12	GLYCAM1	54610171	54610178	0	8	0	529	0	521	0.0	0.0
chr12	LACRT	54631721	54631736	1366	16	145037	887	143671	871	85.375	164.94948335246843
chr12	CD63	55728795	55728951	0	157	1301	2254	1301	2097	0.0	0.6204101096804959
chr12	DNAJC14	55829140	55829487	0	348	51	4199	51	3851	0.0	0.013243313425084394
chr12	MMP19	55842743	55842925	0	183	0	4340	0	4157	0.0	0.0
chr12	MMP19	55838499	55838604	0	106	0	4340	0	4234	0.0	0.0
chr12	PMEL	55966292	55966610	0	319	180	3339	180	3020	0.0	0.059602649006622516
chr12	SMARCC2	56164302	56164646	1989	345	18364	7617	16375	7272	5.765217391304348	2.2517876787678768
chr12	RNF41	56221759	56221901	19747	143	81660	6543	61913	6400	138.0909090909091	9.67390625
chr12	CS	56299827	56299924	0	98	198	5231	198	5133	0.0	0.0385739333722969
chr12	CS	56286496	56286593	0	98	198	5231	198	5133	0.0	0.0385739333722969
chr12	CNPY2	56315820	56315905	0	86	5335	2842	5335	2756	0.0	1.9357764876632801
chr12	PAN2	56324036	56324047	0	12	14046	6864	14046	6852	0.0	2.049912434325744
chr12	STAT2	56354989	56355274	186	286	8810	4706	8624	4420	0.6503496503496503	1.951131221719457
chr12	STAT2	56354989	56355087	33	99	8810	4706	8777	4607	0.3333333333333333	1.9051443455611026
chr12	STAT2	56349344	56349424	0	81	8810	4706	8810	4625	0.0	1.904864864864865
chr12	STAT2	56354458	56354464	0	7	8810	4706	8810	4699	0.0	1.8748669929772293
chr12	STAT2	56354418	56354464	0	47	8810	4706	8810	4659	0.0	1.8909637261214853
chr12	STAT2	56354418	56354457	0	40	8810	4706	8810	4666	0.0	1.8881268752678955
chr12	STAT2	56355088	56355274	153	187	8810	4706	8657	4519	0.8181818181818182	1.9156893117946447
chr12	TIMELESS	56423583	56423623	60	41	19763	5661	19703	5620	1.4634146341463414	3.5058718861209965
chr12	BAZ2A	56601179	56601244	61	66	302825	10465	302764	10399	0.9242424242424242	29.114722569477834
chr12	BAZ2A	56629972	56630123	0	152	302825	10465	302825	10313	0.0	29.363424803645884
chr12	NACA	56724961	56725261	510	301	95495	7785	94985	7484	1.6943521594684385	12.691742383752004
chr12	NACA	56715870	56719535	91925	3666	95495	7785	3570	4119	25.075013638843426	0.8667152221412965
chr12	PRIM1	56752186	56752194	0	9	16988	2848	16988	2839	0.0	5.983797111659035
chr12	MYO1A	57050717	57050721	0	5	1335020	4229	1335020	4224	0.0	316.0558712121212
chr12	NEMP1	57070673	57070818	753	146	2256038	5740	2255285	5594	5.157534246575342	403.1614229531641
chr12	STAT6	57107604	57107657	1067	54	416367	7192	415300	7138	19.75925925925926	58.181563463154944
chr12	STAT6	57111109	57111127	19	19	416367	7192	416348	7173	1.0	58.04377526836749
chr12	STAT6	57110042	57110075	151	34	416367	7192	416216	7158	4.4411764705882355	58.1469684269349
chr12	STAT6	57109940	57110075	1751	136	416367	7192	414616	7056	12.875	58.76077097505669
chr12	STAT6	57109940	57110041	1600	102	416367	7192	414767	7090	15.686274509803921	58.50028208744711
chr12	ARHGAP9	57475775	57475831	0	57	36177	4871	36177	4814	0.0	7.51495637723307
chr12	ARHGAP9	57477784	57477999	0	216	36177	4871	36177	4655	0.0	7.771643394199785
chr12	ARHGAP9	57478398	57478538	208	141	36177	4871	35969	4730	1.475177304964539	7.604439746300211
chr12	DCTN2	57532732	57532782	0	51	34174	6940	34174	6889	0.0	4.960661924807664
chr12	DCTN2	57547023	57547026	0	4	34174	6940	34174	6936	0.0	4.927047289504037
chr12	DCTN2	57538482	57538517	0	36	34174	6940	34174	6904	0.0	4.949884125144844
chr12	CTDSP2	57827533	57827550	0	18	10324	5441	10324	5423	0.0	1.9037433155080214
chr12	AC083805.1	57872348	57872851	0	504	165128	5555	165128	5051	0.0	32.692140170263315
chr12	GIHCG	57935469	57935837	1605	369	47654	3815	46049	3446	4.349593495934959	13.363029599535693
chr12	GIHCG	57935394	57935468	1205	75	47654	3815	46449	3740	16.066666666666666	12.41951871657754
chr12	GIHCG	57935297	57935468	2063	172	47654	3815	45591	3643	11.994186046511627	12.514685698600054
chr12	GIHCG	57935297	57935393	858	97	47654	3815	46796	3718	8.845360824742269	12.586336740182894
chr12	TAFA2	62260009	62260013	0	5	91	8739	91	8734	0.0	0.010419051980764827
chr12	C12ORF66	64222002	64222160	0	159	7854	5906	7854	5747	0.0	1.366626065773447
chr12	WIF1	65056030	65056071	0	42	459	2117	459	2075	0.0	0.22120481927710844
chr12	TMBIM4	66168914	66169288	0	375	153	2161	153	1786	0.0	0.0856662933930571
chr12	AC090061.1	68685858	68685861	0	4	0	2849	0	2845	0.0	0.0
chr12	CPM	68933141	68933158	0	18	0	2730	0	2712	0.0	0.0
chr12	CPM	68933141	68933168	0	28	0	2730	0	2702	0.0	0.0
chr12	CPM	68933159	68933168	0	10	0	2730	0	2720	0.0	0.0
chr12	CPM	68933129	68933140	0	12	0	2730	0	2718	0.0	0.0
chr12	CPM	68933129	68933158	0	30	0	2730	0	2700	0.0	0.0
chr12	CPM	68933129	68933168	0	40	0	2730	0	2690	0.0	0.0
chr12	BEST3	69693673	69693727	0	55	126531	6878	126531	6823	0.0	18.54477502564854
chr12	PRANCR	70243065	70243310	0	246	1341	5036	1341	4790	0.0	0.2799582463465553
chr12	PRANCR	70242796	70242822	0	27	1341	5036	1341	5009	0.0	0.267718107406668
chr12	PTPRR	70754415	70754583	0	169	94	5055	94	4886	0.0	0.019238641015145313
chr12	TRHDE-AS1	72261197	72264480	612	3284	591	8148	-21	4864	0.18635809987819732	-0.004317434210526316
chr12	LINC02882	74402468	74402499	0	32	4	8438	4	8406	0.0	0.0004758505829169641
chr12	CAPS2	75316283	75316310	0	28	21	6680	21	6652	0.0	0.0031569452796151535
chr12	CAPS2	75329831	75329865	30	35	21	6680	-9	6645	0.8571428571428571	-0.0013544018058690745
chr12	NAP1L1	76048392	76048419	0	28	0	4739	0	4711	0.0	0.0
chr12	NAP1L1	76059776	76059796	0	21	0	4739	0	4718	0.0	0.0
chr12	CSRP2	76878937	76878961	25	25	1351	3237	1326	3212	1.0	0.412826899128269
chr12	PPP1R12A	79779320	79779337	0	18	7802	10162	7802	10144	0.0	0.7691246056782335
chr12	PPFIA2	81369289	81369292	0	4	0	7396	0	7392	0.0	0.0
chr12	PPFIA2	81347532	81347662	0	131	0	7396	0	7265	0.0	0.0
chr12	PPFIA2	81375732	81375794	0	63	0	7396	0	7333	0.0	0.0
chr12	PPFIA2	81759213	81759278	0	66	0	7396	0	7330	0.0	0.0
chr12	MGAT4C	86028087	86028102	0	16	0	3695	0	3679	0.0	0.0
chr12	CEP290	88120113	88120116	0	4	102	21189	102	21185	0.0	0.0048147274014633
chr12	CEP290	88136642	88136645	0	4	102	21189	102	21185	0.0	0.0048147274014633
chr12	KITLG	88580088	88580262	0	175	1316	6217	1316	6042	0.0	0.21780867262495862
chr12	POC1B	89497038	89497169	0	132	0	8786	0	8654	0.0	0.0
chr12	ATP2B1	89598589	89598655	0	67	0	9425	0	9358	0.0	0.0
chr12	LINC01619	91987555	91987642	0	88	0	4212	0	4124	0.0	0.0
chr12	LINC01619	91987532	91987554	0	23	0	4212	0	4189	0.0	0.0
chr12	LINC01619	91990283	91990286	0	4	0	4212	0	4208	0.0	0.0
chr12	UBE2N	93411052	93411124	0	73	51	4147	51	4074	0.0	0.012518409425625921
chr12	NR2C1	95058309	95058346	0	38	0	5319	0	5281	0.0	0.0
chr12	AC084879.1	95380853	95380856	0	4	15392	3186	15392	3182	0.0	4.837209302325581
chr12	AC084879.1	95436558	95436561	0	4	15392	3186	15392	3182	0.0	4.837209302325581
chr12	USP44	95548525	95548769	0	245	2247	5382	2247	5137	0.0	0.43741483356044386
chr12	CCDC38	95872254	95872360	72	107	45448	4874	45376	4767	0.6728971962616822	9.518774910845396
chr12	CCDC38	95919438	95919552	0	115	45448	4874	45448	4759	0.0	9.549905442319815
chr12	HAL	95980797	95980813	0	17	104	5065	104	5048	0.0	0.020602218700475437
chr12	AC008149.2	96234036	96234348	51	313	1127	4709	1076	4396	0.16293929712460065	0.24476797088262056
chr12	CDK17	96399333	96399343	11	11	32716	6488	32705	6477	1.0	5.0494055890072564
chr12	CDK17	96399092	96399343	81	252	32716	6488	32635	6236	0.32142857142857145	5.233322642719692
chr12	CDK17	96399092	96399332	70	241	32716	6488	32646	6247	0.29045643153526973	5.2258684168400835
chr12	ANKS1B	99244341	99244352	0	12	630	9547	630	9535	0.0	0.06607236497115888
chr12	UHRF1BP1L	100092902	100092907	0	6	102	6666	102	6660	0.0	0.015315315315315315
chr12	GOLGA2P5	100159557	100159770	0	214	177	6935	177	6721	0.0	0.026335366760898676
chr12	GOLGA2P5	100158678	100158796	0	119	177	6935	177	6816	0.0	0.02596830985915493
chr12	GOLGA2P5	100168451	100168458	0	8	177	6935	177	6927	0.0	0.025552187093980078
chr12	ARL1	101407277	101407376	0	100	0	4578	0	4478	0.0	0.0
chr12	ARL1	101407010	101407376	0	367	0	4578	0	4211	0.0	0.0
chr12	ARL1	101407010	101407276	0	267	0	4578	0	4311	0.0	0.0
chr12	SYCP3	101739350	101739360	0	11	10976	3161	10976	3150	0.0	3.4844444444444442
chr12	AC068643.1	103178331	103178427	0	97	0	2941	0	2844	0.0	0.0
chr12	AC068643.1	103178331	103178577	0	247	0	2941	0	2694	0.0	0.0
chr12	C12ORF42	103495766	103495900	0	135	0	4757	0	4622	0.0	0.0
chr12	C12ORF73	103957068	103957138	0	71	0	2983	0	2912	0.0	0.0
chr12	SLC41A2	104958087	104958188	204	102	327	5166	123	5064	2.0	0.02428909952606635
chr12	MTERF2	106985114	106986967	0	1854	0	1176	0	-678	0.0	-0.0
chr12	PRDM4	107751414	107751645	0	232	0	4785	0	4553	0.0	0.0
chr12	PRDM4	107760956	107761129	0	174	0	4785	0	4611	0.0	0.0
chr12	SART3	108538933	108538943	0	11	51	7034	51	7023	0.0	0.007261853908586074
chr12	SART3	108549087	108549135	0	49	51	7034	51	6985	0.0	0.007301360057265569
chr12	TMEM119	108594163	108594335	0	173	0	3188	0	3015	0.0	0.0
chr12	CORO1C	108730561	108730621	0	61	51	4794	51	4733	0.0	0.010775406718783014
chr12	ALKBH2	109093246	109093348	0	103	138	1630	138	1527	0.0	0.09037328094302555
chr12	TRPV4	109793484	109793525	0	42	0	3893	0	3851	0.0	0.0
chr12	GLTP	109857525	109857581	0	57	91	2752	91	2695	0.0	0.033766233766233764
chr12	GLTP	109857854	109858138	0	285	91	2752	91	2467	0.0	0.03688690717470612
chr12	ARPC3	110436556	110436663	0	108	4117	2641	4117	2533	0.0	1.6253454401894987
chr12	GPN3	110468155	110468194	0	40	34280	2573	34280	2533	0.0	13.533359652585867
chr12	GPN3	110468125	110468154	0	30	34280	2573	34280	2543	0.0	13.480141565080613
chr12	GPN3	110468125	110468194	0	70	34280	2573	34280	2503	0.0	13.695565321614064
chr12	VPS29	110499456	110499533	246	78	502	3202	256	3124	3.1538461538461537	0.08194622279129321
chr12	HVCN1	110661163	110661278	0	116	275	3009	275	2893	0.0	0.09505703422053231
chr12	HVCN1	110687974	110688623	306	650	275	3009	-31	2359	0.4707692307692308	-0.01314116150911403
chr12	PHETA1	111363644	111363686	0	43	0	813	0	770	0.0	0.0
chr12	ATXN2	111485264	111485269	0	6	0	13978	0	13972	0.0	0.0
chr12	ATXN2	111598783	111599573	0	791	0	13978	0	13187	0.0	0.0
chr12	ATXN2	111519831	111519877	0	47	0	13978	0	13931	0.0	0.0
chr12	BRAP	111685587	111685709	0	123	0	4668	0	4545	0.0	0.0
chr12	MAPKAPK5-AS1	111841326	111841682	0	357	1380	2732	1380	2375	0.0	0.5810526315789474
chr12	MAPKAPK5-AS1	111840133	111840331	0	199	1380	2732	1380	2533	0.0	0.5448085274378207
chr12	TMEM116	111936691	111936740	0	50	2696	5425	2696	5375	0.0	0.5015813953488372
chr12	TMEM116	112005943	112005947	0	5	2696	5425	2696	5420	0.0	0.4974169741697417
chr12	TMEM116	112005601	112005947	357	347	2696	5425	2339	5078	1.0288184438040346	0.4606144151240646
chr12	TMEM116	112005601	112005942	357	342	2696	5425	2339	5083	1.043859649122807	0.4601613220539052
chr12	HECTD4	112264083	112264088	0	6	90497	19857	90497	19851	0.0	4.558813158027303
chr12	RPL6	112409410	112409585	0	176	425	3049	425	2873	0.0	0.14792899408284024
chr12	RPL6	112409410	112409491	0	82	425	3049	425	2967	0.0	0.14324233232221098
chr12	RPL6	112409040	112409409	0	370	425	3049	425	2679	0.0	0.15864128406121686
chr12	RPL6	112409040	112409201	0	162	425	3049	425	2887	0.0	0.14721163837894008
chr12	RPL6	112409040	112409491	0	452	425	3049	425	2597	0.0	0.16365036580670003
chr12	RASAL1	113136060	113136074	0	15	12	4715	12	4700	0.0	0.002553191489361702
chr12	DDX54	113180928	113180979	0	52	51	5086	51	5034	0.0	0.010131108462455305
chr12	SLC8B1	113332722	113332747	0	26	0	6033	0	6007	0.0	0.0
chr12	TESC	117046771	117046775	0	5	21	1937	21	1932	0.0	0.010869565217391304
chr12	FBXO21	117174650	117174653	0	4	100148	6901	100148	6897	0.0	14.52051616644918
chr12	WSB2	118036337	118036383	0	47	255	3937	255	3890	0.0	0.06555269922879177
chr12	VSIG10	118082126	118082150	0	25	408	7227	408	7202	0.0	0.05665093029713968
chr12	TAOK3	118359505	118359519	0	15	551	9442	551	9427	0.0	0.05844913546197093
chr12	TAOK3	118190182	118190242	0	61	551	9442	551	9381	0.0	0.05873574245816011
chr12	LINC02439	118833386	118833452	0	67	2987	611	2987	544	0.0	5.490808823529412
chr12	CIT	119784188	119784958	0	771	51	25017	51	24246	0.0	0.002103439742637961
chr12	CIT	119804096	119804161	0	66	51	25017	51	24951	0.0	0.002044006252254419
chr12	CIT	119775774	119775784	0	11	51	25017	51	25006	0.0	0.0020395105174758057
chr12	RPLP0	120198853	120198893	322	41	5008	2408	4686	2367	7.853658536585366	1.979721166032953
chr12	RPLP0	120200718	120200728	0	11	5008	2408	5008	2397	0.0	2.0892782644972883
chr12	PXN	120226361	120226837	0	477	16239	7481	16239	7004	0.0	2.318532267275842
chr12	PXN	120226352	120226360	0	9	16239	7481	16239	7472	0.0	2.173313704496788
chr12	SRSF9	120465626	120465754	0	129	306	3090	306	2961	0.0	0.1033434650455927
chr12	C12ORF43	121011010	121011102	141	93	346834	6147	346693	6054	1.5161290322580645	57.26676577469442
chr12	C12ORF43	121016258	121016328	0	71	346834	6147	346834	6076	0.0	57.08262014483213
chr12	CAMKK2	121274055	121274062	0	8	8580	7180	8580	7172	0.0	1.196319018404908
chr12	CAMKK2	121297434	121297537	0	104	8580	7180	8580	7076	0.0	1.2125494629734312
chr12	ANAPC5	121331226	121331345	0	120	3586	10333	3586	10213	0.0	0.3511211201409968
chr12	KDM2B	121430276	121430340	0	65	81393	13372	81393	13307	0.0	6.116555196513113
chr12	KDM2B	121536010	121536018	0	9	81393	13372	81393	13363	0.0	6.0909226969991765
chr12	LINC01089	121801571	121801705	0	135	77	3882	77	3747	0.0	0.020549773151854817
chr12	LINC01089	121802878	121803205	0	328	77	3882	77	3554	0.0	0.021665728756330896
chr12	LINC01089	121802630	121802877	0	248	77	3882	77	3634	0.0	0.021188772702256466
chr12	DIABLO	122224511	122224643	612	133	88805	5932	88193	5799	4.601503759398496	15.20831177789274
chr12	DIABLO	122225825	122225963	0	139	88805	5932	88805	5793	0.0	15.329708268600035
chr12	DIABLO	122209696	122209771	9	76	88805	5932	88796	5856	0.11842105263157894	15.16325136612022
chr12	DIABLO	122225786	122225963	0	178	88805	5932	88805	5754	0.0	15.433611400764686
chr12	DIABLO	122225786	122225824	0	39	88805	5932	88805	5893	0.0	15.069574070931614
chr12	VPS33A	122250958	122250981	0	24	23099	5708	23099	5684	0.0	4.063863476425053
chr12	CLIP1	122340752	122340979	25978	228	128133	17314	102155	17086	113.93859649122807	5.978871590776074
chr12	CLIP1	122360815	122360957	0	143	128133	17314	128133	17171	0.0	7.462174596703744
chr12	ZCCHC8	122498826	122499971	40783	1146	33165	7908	-7618	6762	35.58726003490401	-1.1265897663413191
chr12	RSRC2	122517226	122517229	0	4	2176	7431	2176	7427	0.0	0.2929850545307661
chr12	MPHOSPH9	123202623	123202689	0	67	13302	8436	13302	8369	0.0	1.5894372087465647
chr12	MPHOSPH9	123218375	123218397	0	23	13302	8436	13302	8413	0.0	1.5811244502555568
chr12	MPHOSPH9	123227462	123227544	0	83	13302	8436	13302	8353	0.0	1.5924817430863163
chr12	NCOR2	124327408	124327545	0	138	7711	12472	7711	12334	0.0	0.6251824225717528
chr12	NCOR2	124326179	124326189	0	11	7711	12472	7711	12461	0.0	0.6188106893507744
chr12	SCARB1	124786356	124786439	42	84	22253	4213	22211	4129	0.5	5.379268588035844
chr12	SCARB1	124786106	124786355	519	250	22253	4213	21734	3963	2.076	5.4842291193540245
chr12	UBC	124914004	124914039	0	36	37362	2504	37362	2468	0.0	15.138573743922205
chr12	UBC	124914004	124914092	0	89	37362	2504	37362	2415	0.0	15.47080745341615
chr12	UBC	124914040	124914092	0	53	37362	2504	37362	2451	0.0	15.243574051407588
chr12	UBC	124913968	124914003	0	36	37362	2504	37362	2468	0.0	15.138573743922205
chr12	UBC	124913968	124914039	0	72	37362	2504	37362	2432	0.0	15.36266447368421
chr12	UBC	124914297	124914368	0	72	37362	2504	37362	2432	0.0	15.36266447368421
chr12	UBC	124914369	124914585	204	217	37362	2504	37158	2287	0.9400921658986175	16.24748578924355
chr12	UBC	124914093	124914296	8167	204	37362	2504	29195	2300	40.03431372549019	12.693478260869565
chr12	LINC00939	125983203	125983235	0	33	255	6810	255	6777	0.0	0.03762726870296591
chr12	LINC00944	126735144	126736664	0	1521	0	4790	0	3269	0.0	0.0
chr12	LINC00944	126732310	126732341	0	32	0	4790	0	4758	0.0	0.0
chr12	LINC00944	126735144	126736782	0	1639	0	4790	0	3151	0.0	0.0
chr12	LINC00944	126736665	126736782	0	118	0	4790	0	4672	0.0	0.0
chr12	LINC02372	126873325	126873332	0	8	0	1883	0	1875	0.0	0.0
chr12	LINC02372	126873325	126873388	0	64	0	1883	0	1819	0.0	0.0
chr12	LINC02372	126874285	126874455	0	171	0	1883	0	1712	0.0	0.0
chr12	LINC02375	127339909	127339967	0	59	0	954	0	895	0.0	0.0
chr12	LINC02375	127339909	127339912	0	4	0	954	0	950	0.0	0.0
chr12	LINC02375	127339913	127339967	0	55	0	954	0	899	0.0	0.0
chr12	LINC02411	127636350	127636400	0	51	0	2406	0	2355	0.0	0.0
chr12	LINC02411	127636202	127636400	0	199	0	2406	0	2207	0.0	0.0
chr12	LINC02411	127636202	127636349	0	148	0	2406	0	2258	0.0	0.0
chr12	LINC02411	127632373	127632573	0	201	0	2406	0	2205	0.0	0.0
chr12	LINC02369	128112704	128112709	0	6	0	2394	0	2388	0.0	0.0
chr12	AC061709.2	128191177	128191310	0	134	0	1439	0	1305	0.0	0.0
chr12	RIMBP2	130469019	130469147	0	129	0	9642	0	9513	0.0	0.0
chr12	AC073578.1	131492347	131492755	0	409	24	1513	24	1104	0.0	0.021739130434782608
chr12	AC073578.1	131529690	131529773	0	84	24	1513	24	1429	0.0	0.016794961511546535
chr12	GALNT9	132205362	132205559	0	198	35802	4904	35802	4706	0.0	7.607734806629834
chr12	LRCOL1	132604700	132604704	0	5	25397	1775	25397	1770	0.0	14.348587570621469
chr12	POLE	132641017	132641645	1895	629	210011	15952	208116	15323	3.012718600953895	13.581935652287411
chr12	POLE	132676085	132676092	0	8	210011	15952	210011	15944	0.0	13.171788760662318
chr12	GOLGA3	132828326	132828801	0	476	0	10572	0	10096	0.0	0.0
chr12	GOLGA3	132775065	132775139	0	75	0	10572	0	10497	0.0	0.0
chr12	CHFR	132848084	132848180	0	97	0	16627	0	16530	0.0	0.0
chr13	ANKRD26P3	19296634	19296634	0	1	0	4491	0	4490	0.0	0.0
chr13	ANKRD26P3	19314710	19314712	0	3	0	4491	0	4488	0.0	0.0
chr13	GJB6	20230697	20230740	0	44	24488	3279	24488	3235	0.0	7.5697063369397215
chr13	AL590096.1	20566460	20566674	59	215	153	791	94	576	0.2744186046511628	0.16319444444444445
chr13	SKA3	21176347	21176373	0	27	2703	2980	2703	2953	0.0	0.9153403318658991
chr13	LINC00539	21312145	21312277	0	133	82789	4251	82789	4118	0.0	20.104176784847013
chr13	LINC00539	21312145	21312149	0	5	82789	4251	82789	4246	0.0	19.498115873763542
chr13	LINC00539	21312150	21312277	0	128	82789	4251	82789	4123	0.0	20.079796264855688
chr13	CENPJ	24886233	24886233	0	1	720	5689	720	5688	0.0	0.12658227848101267
chr13	RNF6	26221781	26221833	0	53	306	4449	306	4396	0.0	0.06960873521383075
chr13	KATNAL1	30306712	30306938	0	227	51	8051	51	7824	0.0	0.00651840490797546
chr13	KATNAL1	30306712	30306762	0	51	51	8051	51	8000	0.0	0.006375
chr13	TEX26-AS1	30932108	30932274	0	167	1281	6332	1281	6165	0.0	0.2077858880778589
chr13	N4BP2L1	32402907	32403148	0	242	0	5266	0	5024	0.0	0.0
chr13	N4BP2L1	32416498	32416549	0	52	0	5266	0	5214	0.0	0.0
chr13	N4BP2L2	32538617	32538681	0	65	102	10496	102	10431	0.0	0.009778544722461893
chr13	N4BP2L2	32527407	32527456	0	50	102	10496	102	10446	0.0	0.009764503159103963
chr13	N4BP2L2	32535768	32537004	0	1237	102	10496	102	9259	0.0	0.011016308456636786
chr13	N4BP2L2	32535768	32536931	0	1164	102	10496	102	9332	0.0	0.01093013287612516
chr13	N4BP2L2	32538617	32538776	0	160	102	10496	102	10336	0.0	0.009868421052631578
chr13	N4BP2L2	32538617	32538748	0	132	102	10496	102	10364	0.0	0.00984175993824778
chr13	N4BP2L2	32536932	32537004	0	73	102	10496	102	10423	0.0	0.009786050081550417
chr13	N4BP2L2	32538749	32538776	0	28	102	10496	102	10468	0.0	0.009743981658387467
chr13	N4BP2L2	32538682	32538776	0	95	102	10496	102	10401	0.0	0.00980674935102394
chr13	N4BP2L2	32538682	32538748	0	67	102	10496	102	10429	0.0	0.009780419982740436
chr13	SUPT20H	37059479	37059557	0	79	23892	10212	23892	10133	0.0	2.357840718444686
chr13	SUPT20H	37059194	37059360	0	167	23892	10212	23892	10045	0.0	2.378496764559482
chr13	TRPC4	37651249	37651263	0	15	364	3351	364	3336	0.0	0.1091127098321343
chr13	EPSTI1	42926335	42926389	0	55	11511	4643	11511	4588	0.0	2.5089363557105493
chr13	TPT1	45341037	45341040	0	4	102	6154	102	6150	0.0	0.016585365853658537
chr13	TPT1	45340711	45341040	0	330	102	6154	102	5824	0.0	0.017513736263736264
chr13	ZC3H13	46052403	46052696	510	294	404826	10286	404316	9992	1.7346938775510203	40.463971176941556
chr13	LINC01198	46460944	46460988	0	45	51	5378	51	5333	0.0	0.009563097693605851
chr13	LINC01198	46464674	46464739	0	66	51	5378	51	5312	0.0	0.009600903614457831
chr13	LINC01198	46464674	46464734	0	61	51	5378	51	5317	0.0	0.009591875117547489
chr13	LINC01198	46465842	46465907	0	66	51	5378	51	5312	0.0	0.009600903614457831
chr13	LINC01198	46465842	46465902	0	61	51	5378	51	5317	0.0	0.009591875117547489
chr13	LINC01198	46465903	46465907	0	5	51	5378	51	5373	0.0	0.009491903964265773
chr13	LINC01198	46467733	46467737	0	5	51	5378	51	5373	0.0	0.009491903964265773
chr13	LINC01198	46467672	46467737	0	66	51	5378	51	5312	0.0	0.009600903614457831
chr13	LINC01198	46467672	46467732	0	61	51	5378	51	5317	0.0	0.009591875117547489
chr13	LINC01198	46464735	46464739	0	5	51	5378	51	5373	0.0	0.009491903964265773
chr13	LINC01198	46469654	46469833	0	180	51	5378	51	5198	0.0	0.009811465948441709
chr13	LINC01198	46486280	46486321	0	42	51	5378	51	5336	0.0	0.009557721139430285
chr13	LINC01198	46467660	46467737	0	78	51	5378	51	5300	0.0	0.009622641509433962
chr13	LINC01198	46467660	46467671	0	12	51	5378	51	5366	0.0	0.009504286246738726
chr13	LINC01198	46467660	46467732	0	73	51	5378	51	5305	0.0	0.009613572101790764
chr13	MED4	48094953	48095058	0	106	0	2599	0	2493	0.0	0.0
chr13	RB1-DT	48303290	48303484	0	195	0	1836	0	1641	0.0	0.0
chr13	CAB39L	49401132	49401393	0	262	0	4839	0	4577	0.0	0.0
chr13	DLEU2	50044639	50044649	0	11	20270	11660	20270	11649	0.0	1.7400635247660743
chr13	INTS6	51451421	51451495	0	75	255	25534	255	25459	0.0	0.010016104324600338
chr13	ATP7B	51949661	51949714	51	54	102820	13652	102769	13598	0.9444444444444444	7.5576555375790555
chr13	NEK3	52143914	52143914	0	1	103	4289	103	4288	0.0	0.0240205223880597
chr13	TPTE2P2	52235152	52235218	37	67	60337	4148	60300	4081	0.5522388059701493	14.775790247488361
chr13	TPTE2P2	52323796	52323828	0	33	60337	4148	60337	4115	0.0	14.66269744835966
chr13	PCDH8	52845805	52846095	22	291	255	5153	233	4862	0.07560137457044673	0.047922665569724396
chr13	COMMD6	75537381	75537497	0	117	0	2499	0	2382	0.0	0.0
chr13	FBXL3	77021512	77021655	0	144	102	7083	102	6939	0.0	0.014699524427150886
chr13	MYCBP2	77076750	77076758	0	9	252	15782	252	15773	0.0	0.01597666899131427
chr13	MYCBP2	77095357	77095529	0	173	252	15782	252	15609	0.0	0.016144532000768787
chr13	EDNRB	77919006	77919064	0	59	1123	4631	1123	4572	0.0	0.24562554680664916
chr13	LINC01069	77997723	77997814	0	92	51	3687	51	3595	0.0	0.014186369958275382
chr13	AL158064.1	80054669	80054730	0	62	52322	10299	52322	10237	0.0	5.11106769561395
chr13	LINC00559	90106582	90107852	0	1271	0	2089	0	818	0.0	0.0
chr13	LINC00559	90118772	90119424	102	653	0	2089	-102	1436	0.1562021439509954	-0.07103064066852367
chr13	ABCC4	95266098	95266110	24	13	33188	8667	33164	8654	1.8461538461538463	3.8322163161543794
chr13	OXGR1	96992421	96992506	0	86	26	1637	26	1551	0.0	0.016763378465506126
chr13	UBAC2-AS1	99200365	99200636	0	272	294	2596	294	2324	0.0	0.12650602409638553
chr13	UBAC2-AS1	99200329	99200364	0	36	294	2596	294	2560	0.0	0.11484375
chr13	UBAC2-AS1	99200329	99200636	0	308	294	2596	294	2288	0.0	0.1284965034965035
chr13	LINC01232	99496697	99496707	0	11	2238	6199	2238	6188	0.0	0.3616677440206852
chr13	CLYBL-AS1	99727194	99727228	0	35	0	712	0	677	0.0	0.0
chr13	PCCA-AS1	100480979	100481118	0	140	0	862	0	722	0.0	0.0
chr13	GGACT	100533286	100533561	0	276	1330	3482	1330	3206	0.0	0.4148471615720524
chr13	TMTC4	100670282	100670358	0	77	712800	6368	712800	6291	0.0	113.30472103004291
chr13	NALCN	101345265	101345299	0	35	129727	19504	129727	19469	0.0	6.663259540808465
chr13	NALCN	101416312	101416434	0	123	129727	19504	129727	19381	0.0	6.693514266549713
chr13	AL390755.1	110045196	110045431	0	236	0	4212	0	3976	0.0	0.0
chr13	AL390755.1	110045196	110045783	0	588	0	4212	0	3624	0.0	0.0
chr13	AL390755.1	110045432	110045783	0	352	0	4212	0	3860	0.0	0.0
chr13	AL390755.1	110045779	110045783	0	5	0	4212	0	4207	0.0	0.0
chr13	COL4A1	110152333	110152338	0	6	51	12365	51	12359	0.0	0.0041265474552957355
chr13	CARS2	110713136	110713301	0	166	51	8121	51	7955	0.0	0.006411062225015713
chr13	ANKRD10	110883552	110883696	0	145	504	4241	504	4096	0.0	0.123046875
chr13	PCID2	113208023	113208597	71833	575	10874	4056	-60959	3481	124.92695652173913	-17.51192186153404
chr13	GRTP1	113364019	113364070	0	52	149	2926	149	2874	0.0	0.05184411969380654
chr13	LINC00454	113880698	113881346	20418	649	78300	2845	57882	2196	31.46070878274268	26.35792349726776
chr13	LINC00408	18907803	18907817	0	15	0	2363	0	2348	0.0	0.0
chr13	LINC00408	18906659	18906692	0	34	0	2363	0	2329	0.0	0.0
chr13	LINC00408	18905573	18905576	0	4	0	2363	0	2359	0.0	0.0
chr13	LINC00350	19587157	19587389	0	233	0	1646	0	1413	0.0	0.0
chr13	ZMYM2	19958772	19958841	0	70	70	12671	70	12601	0.0	0.005555114673438616
chr13	LINC00327	23467164	23467749	0	586	0	5213	0	4627	0.0	0.0
chr13	RPL21	27255350	27255354	161	5	14629	1957	14468	1952	32.2	7.411885245901639
chr13	RPL21	27251586	27251656	671	71	14629	1957	13958	1886	9.450704225352112	7.40084835630965
chr13	RPL21	27251586	27251850	1344	265	14629	1957	13285	1692	5.071698113207547	7.851654846335697
chr13	RPL21	27251657	27251850	673	194	14629	1957	13956	1763	3.4690721649484537	7.916052183777651
chr13	RPL21	27251700	27251850	503	151	14629	1957	14126	1806	3.3311258278145695	7.821705426356589
chr13	RPL21	27251657	27251699	170	43	14629	1957	14459	1914	3.953488372093023	7.554336468129572
chr13	GTF3A	27424854	27424938	0	85	167	2790	167	2705	0.0	0.061737523105360445
chr13	GTF3A	27424939	27425165	0	227	167	2790	167	2563	0.0	0.06515801794771751
chr13	GTF3A	27424854	27425165	0	312	167	2790	167	2478	0.0	0.06739305891848264
chr13	POLR1D	27621105	27621140	0	36	19668	9742	19668	9706	0.0	2.0263754378734804
chr13	POLR1D	27621141	27621437	0	297	19668	9742	19668	9445	0.0	2.0823716251985176
chr13	POLR1D	27621264	27621437	0	174	19668	9742	19668	9568	0.0	2.055602006688963
chr13	POLR1D	27648450	27648453	144	4	19668	9742	19524	9738	36.0	2.004929143561306
chr13	POLR1D	27650242	27651352	0	1111	19668	9742	19668	8631	0.0	2.278762599930483
chr13	BRCA2	32316524	32316527	0	4	2373	12439	2373	12435	0.0	0.190832328106152
chr13	PDS5B	32764589	32764594	0	6	0	13222	0	13216	0.0	0.0
chr13	STARD13-AS	33279571	33279656	0	86	11189	3839	11189	3753	0.0	2.9813482547295496
chr13	STARD13-AS	33271562	33271582	0	21	11189	3839	11189	3818	0.0	2.930591932949188
chr13	STARD13-AS	33277576	33277696	0	121	11189	3839	11189	3718	0.0	3.009413663259817
chr13	STARD13-AS	33272794	33272894	0	101	11189	3839	11189	3738	0.0	2.9933119315141785
chr13	STARD13-AS	33273977	33274058	1589	82	11189	3839	9600	3757	19.378048780487806	2.5552302368911364
chr13	STARD13-AS	33280480	33280583	0	104	11189	3839	11189	3735	0.0	2.995716198125837
chr13	LINC00445	35697616	35697851	81	236	81	1560	0	1324	0.3432203389830508	0.0
chr13	LINC00445	35697637	35697851	81	215	81	1560	0	1345	0.3767441860465116	0.0
chr13	LINC00445	35697616	35697636	0	21	81	1560	81	1539	0.0	0.05263157894736842
chr13	LINC02334	37934897	37935037	0	141	51	6006	51	5865	0.0	0.008695652173913044
chr13	LINC02334	38029692	38029696	0	5	51	6006	51	6001	0.0	0.0084985835694051
chr13	UFM1	38350056	38350227	0	172	1632	4388	1632	4216	0.0	0.3870967741935484
chr13	NHLRC3	39038466	39038723	23	258	102	6410	79	6152	0.08914728682170543	0.012841352405721717
chr13	SLC25A15	40799173	40799315	0	143	0	4194	0	4051	0.0	0.0
chr13	NAA16	41362160	41362873	0	714	5973	5826	5973	5112	0.0	1.1684272300469483
chr13	DGKH	42198594	42198595	0	2	1883	19782	1883	19780	0.0	0.09519716885743175
chr13	TPT1-AS1	45383170	45383235	0	66	51	8229	51	8163	0.0	0.006247703050349137
chr13	TPT1-AS1	45390859	45390902	0	44	51	8229	51	8185	0.0	0.006230910201588271
chr13	TPT1-AS1	45341615	45341630	0	16	51	8229	51	8213	0.0	0.00620966760014611
chr13	TPT1-AS1	45379336	45380001	0	666	51	8229	51	7563	0.0	0.006743355811186037
chr13	TPT1-AS1	45383839	45383843	0	5	51	8229	51	8224	0.0	0.00620136186770428
chr13	TPT1-AS1	45389821	45390902	0	1082	51	8229	51	7147	0.0	0.007135861200503708
chr13	CPB2-AS1	46098668	46098781	0	114	31164	17234	31164	17120	0.0	1.8203271028037382
chr13	CPB2-AS1	46098782	46098810	294	29	31164	17234	30870	17205	10.137931034482758	1.7942458587619878
chr13	CPB2-AS1	46098668	46098810	294	143	31164	17234	30870	17091	2.055944055944056	1.8062137967351237
chr13	CYSLTR2	48691279	48691301	0	23	14009	5116	14009	5093	0.0	2.7506381307677206
chr13	FNDC3A	49191110	49191120	0	11	0	7727	0	7716	0.0	0.0
chr13	PHF11	49496449	49496600	0	152	0	4736	0	4584	0.0	0.0
chr13	PHF11	49496483	49496600	0	118	0	4736	0	4618	0.0	0.0
chr13	PHF11	49496449	49496482	0	34	0	4736	0	4702	0.0	0.0
chr13	TRIM13	49997132	49997216	0	85	16051	8102	16051	8017	0.0	2.0021204939503554
chr13	DLEU1	50082558	50083194	1660	637	131553	22973	129893	22336	2.6059654631083204	5.815410100286533
chr13	RNASEH2B	50910141	50910558	0	418	1275	19088	1275	18670	0.0	0.0682913765399036
chr13	RNASEH2B	50910439	50910558	0	120	1275	19088	1275	18968	0.0	0.06721847321805145
chr13	RNASEH2B	50910559	50913131	0	2573	1275	19088	1275	16515	0.0	0.07720254314259764
chr13	RNASEH2B	50910439	50913131	0	2693	1275	19088	1275	16395	0.0	0.0777676120768527
chr13	RNASEH2B	50930760	50930848	0	89	1275	19088	1275	18999	0.0	0.06710879519974736
chr13	SERPINE3	51340862	51340925	0	64	48	2576	48	2512	0.0	0.01910828025477707
chr13	ALG11	52012463	52012574	0	112	101123	11770	101123	11658	0.0	8.67412935323383
chr13	LINC02333	52341058	52341075	0	18	33720	1049	33720	1031	0.0	32.706110572259945
chr13	AL137058.1	52584704	52585168	612	465	8125	4551	7513	4086	1.3161290322580645	1.8387175721977485
chr13	AL390964.1	54980425	54980446	0	22	0	4150	0	4128	0.0	0.0
chr13	AL390964.1	54940050	54940160	0	111	0	4150	0	4039	0.0	0.0
chr13	AL390964.1	54940130	54940160	0	31	0	4150	0	4119	0.0	0.0
chr13	AL390964.1	54940161	54940315	0	155	0	4150	0	3995	0.0	0.0
chr13	AL390964.1	54940130	54940315	0	186	0	4150	0	3964	0.0	0.0
chr13	AL390964.1	54940316	54940360	0	45	0	4150	0	4105	0.0	0.0
chr13	AL390964.1	54940762	54940782	0	21	0	4150	0	4129	0.0	0.0
chr13	AL390964.1	54940783	54940966	0	184	0	4150	0	3966	0.0	0.0
chr13	AL390964.1	54940881	54940966	0	86	0	4150	0	4064	0.0	0.0
chr13	AL390964.1	54941124	54941176	0	53	0	4150	0	4097	0.0	0.0
chr13	AL390964.1	54941674	54941799	0	126	0	4150	0	4024	0.0	0.0
chr13	LINC00378	60724213	60724493	0	281	0	3415	0	3134	0.0	0.0
chr13	LINC00348	71157765	71157799	0	35	0	1793	0	1758	0.0	0.0
chr13	BORA	72728008	72728260	0	253	0	3201	0	2948	0.0	0.0
chr13	LINC00392	73574727	73574806	0	80	19	1093	19	1013	0.0	0.018756169792694965
chr13	AL353660.1	74365062	74365087	0	26	0	3166	0	3140	0.0	0.0
chr13	LMO7	75760560	75760665	0	106	98590	12803	98590	12697	0.0	7.764826336929984
chr13	LMO7	75760666	75760831	0	166	98590	12803	98590	12637	0.0	7.801693439898711
chr13	CLN5	76992582	76992852	0	271	204	21845	204	21574	0.0	0.009455826457773245
chr13	MYCBP2-AS1	77076867	77076933	0	67	0	4097	0	4030	0.0	0.0
chr13	SLAIN1	77697929	77698539	0	611	392	4111	392	3500	0.0	0.112
chr13	SLAIN1	77699058	77699223	0	166	392	4111	392	3945	0.0	0.09936628643852978
chr13	SLAIN1	77744433	77744516	0	84	392	4111	392	4027	0.0	0.09734293518748448
chr13	SLAIN1	77743166	77743462	0	297	392	4111	392	3814	0.0	0.10277923439958049
chr13	OBI1-AS1	78605445	78605456	0	12	102	8801	102	8789	0.0	0.01160541586073501
chr13	RBM26-AS1	79406478	79407095	0	618	1683	6758	1683	6140	0.0	0.2741042345276873
chr13	IPO5	97953717	97954198	0	482	9322	9701	9322	9219	0.0	1.0111725783707561
chr13	IPO5	97953928	97954198	0	271	9322	9701	9322	9430	0.0	0.9885471898197243
chr13	IPO5	97953717	97953927	0	211	9322	9701	9322	9490	0.0	0.9822971548998947
chr13	UBAC2	99200940	99201567	0	628	51	4688	51	4060	0.0	0.012561576354679803
chr13	UBAC2	99201185	99201567	0	383	51	4688	51	4305	0.0	0.011846689895470384
chr13	UBAC2	99200940	99201184	0	245	51	4688	51	4443	0.0	0.011478730587440918
chr13	PCCA	100302997	100302998	0	2	5436	7321	5436	7319	0.0	0.742724415903812
chr13	BIVM	102816555	102817128	0	574	0	7930	0	7356	0.0	0.0
chr13	LINC01309	103421273	103421388	330	116	4009	1672	3679	1556	2.8448275862068964	2.36439588688946
chr13	LINC00343	105761438	105761560	0	123	0	12772	0	12649	0.0	0.0
chr13	LINC00343	105761387	105761560	0	174	0	12772	0	12598	0.0	0.0
chr13	LINC00343	105706727	105706917	0	191	0	12772	0	12581	0.0	0.0
chr13	LINC00343	105761387	105761437	0	51	0	12772	0	12721	0.0	0.0
chr13	LINC00343	105718560	105718852	0	293	0	12772	0	12479	0.0	0.0
chr13	LINC00343	105706918	105706925	0	8	0	12772	0	12764	0.0	0.0
chr13	LINC00343	105728728	105730458	0	1731	0	12772	0	11041	0.0	0.0
chr13	LINC00460	106376557	106376665	0	109	0	4088	0	3979	0.0	0.0
chr13	ING1	110715529	110716008	0	480	0	5643	0	5163	0.0	0.0
chr13	ARHGEF7	111115058	111115691	1047	634	559370	11306	558323	10672	1.6514195583596214	52.316622938530735
chr13	LINC00354	111893449	111893574	0	126	400	1978	400	1852	0.0	0.2159827213822894
chr13	MCF2L	113090152	113090160	0	9	204	16966	204	16957	0.0	0.01203042991095123
chr13	F10	113147493	113147496	0	4	79543	2380	79543	2376	0.0	33.477693602693606
chr13	F10	113147487	113147496	0	10	79543	2380	79543	2370	0.0	33.562447257383965
chr13	F10	113147487	113147492	0	6	79543	2380	79543	2374	0.0	33.50589721988206
chr13	CUL4A	113210064	113210088	0	25	90040	7698	90040	7673	0.0	11.73465398149355
chr13	TFDP1	113585428	113585677	0	250	0	3759	0	3509	0.0	0.0
chr13	TMEM255B	113800866	113800912	26	47	3052	7316	3026	7269	0.5531914893617021	0.41628834777823637
chr13	BX072579.2	113885053	113885158	1804	106	135384	1573	133580	1467	17.0188679245283	91.05657805044308
chr13	CFAP97D2	114179368	114179420	790	53	13296	2188	12506	2135	14.90566037735849	5.857611241217799
chr13	UPF3A	114301868	114302025	0	158	430496	5735	430496	5577	0.0	77.19132149901381
chr14	MED15P6	19485767	19485768	0	2	0	792	0	790	0.0	0.0
chr14	OR11G2	20191040	20191666	0	627	0	4513	0	3886	0.0	0.0
chr14	PARP2	20345088	20345126	0	39	87	3806	87	3767	0.0	0.02309530130076984
chr14	APEX1	20455241	20455338	0	98	0	1679	0	1581	0.0	0.0
chr14	APEX1	20455329	20455338	0	10	0	1679	0	1669	0.0	0.0
chr14	APEX1	20455339	20455389	0	51	0	1679	0	1628	0.0	0.0
chr14	APEX1	20455241	20455389	0	149	0	1679	0	1530	0.0	0.0
chr14	APEX1	20455329	20455389	0	61	0	1679	0	1618	0.0	0.0
chr14	APEX1	20455339	20455394	0	56	0	1679	0	1623	0.0	0.0
chr14	APEX1	20455241	20455394	0	154	0	1679	0	1525	0.0	0.0
chr14	APEX1	20455390	20455394	0	5	0	1679	0	1674	0.0	0.0
chr14	APEX1	20455329	20455394	0	66	0	1679	0	1613	0.0	0.0
chr14	APEX1	20455241	20455328	0	88	0	1679	0	1591	0.0	0.0
chr14	APEX1	20455704	20455773	0	70	0	1679	0	1609	0.0	0.0
chr14	APEX1	20455339	20455401	0	63	0	1679	0	1616	0.0	0.0
chr14	APEX1	20455241	20455401	0	161	0	1679	0	1518	0.0	0.0
chr14	APEX1	20455390	20455401	0	12	0	1679	0	1667	0.0	0.0
chr14	APEX1	20455395	20455401	0	7	0	1679	0	1672	0.0	0.0
chr14	APEX1	20455329	20455401	0	73	0	1679	0	1606	0.0	0.0
chr14	APEX1	20455339	20455428	0	90	0	1679	0	1589	0.0	0.0
chr14	APEX1	20455390	20455428	0	39	0	1679	0	1640	0.0	0.0
chr14	APEX1	20455395	20455428	0	34	0	1679	0	1645	0.0	0.0
chr14	APEX1	20455329	20455428	0	100	0	1679	0	1579	0.0	0.0
chr14	APEX1	20455402	20455428	0	27	0	1679	0	1652	0.0	0.0
chr14	ANG	20684697	20684758	0	62	0	1443	0	1381	0.0	0.0
chr14	METTL17	20990263	20990383	0	121	1020	3390	1020	3269	0.0	0.3120220250841236
chr14	TPPP2	21030305	21030317	0	13	0	2314	0	2301	0.0	0.0
chr14	ARHGEF40	21074992	21075180	0	189	1392	8078	1392	7889	0.0	0.17644821903916846
chr14	TMEM253	21102121	21102192	0	72	0	2166	0	2094	0.0	0.0
chr14	RPGRIP1	21321301	21321402	0	102	79	4850	79	4748	0.0	0.016638584667228305
chr14	RPGRIP1	21324726	21325070	0	345	79	4850	79	4505	0.0	0.01753607103218646
chr14	RPGRIP1	21321972	21322004	0	33	79	4850	79	4817	0.0	0.016400249117708116
chr14	RPGRIP1	21321403	21321506	0	104	79	4850	79	4746	0.0	0.016645596291613992
chr14	TOX4	21487603	21487693	0	91	32	6373	32	6282	0.0	0.005093919134033747
chr14	TOX4	21477565	21477592	0	28	32	6373	32	6345	0.0	0.00504334121355398
chr14	ABHD4	22603458	22603762	0	305	0	3045	0	2740	0.0	0.0
chr14	ABHD4	22598330	22598442	0	113	0	3045	0	2932	0.0	0.0
chr14	OXA1L	22766765	22766914	0	150	0	4326	0	4176	0.0	0.0
chr14	OXA1L	22766765	22767051	0	287	0	4326	0	4039	0.0	0.0
chr14	OXA1L	22766915	22767051	0	137	0	4326	0	4189	0.0	0.0
chr14	MRPL52	22829941	22829948	0	8	0	2769	0	2761	0.0	0.0
chr14	MRPL52	22829941	22830110	0	170	0	2769	0	2599	0.0	0.0
chr14	MRPL52	22833483	22833489	0	7	0	2769	0	2762	0.0	0.0
chr14	BCL2L2	23306895	23306947	561	53	479178	2991	478617	2938	10.584905660377359	162.9057181756297
chr14	BCL2L2	23306942	23306947	44	6	479178	2991	479134	2985	7.333333333333333	160.5139028475712
chr14	BCL2L2	23306895	23306941	517	47	479178	2991	478661	2944	11.0	162.58865489130434
chr14	PABPN1	23324290	23324328	0	39	287	3086	287	3047	0.0	0.09419100754840827
chr14	THTPA	23557040	23557304	204	265	66500	2498	66296	2233	0.769811320754717	29.68920734437976
chr14	THTPA	23557035	23557304	204	270	66500	2498	66296	2228	0.7555555555555555	29.755834829443447
chr14	THTPA	23557035	23557039	0	5	66500	2498	66500	2493	0.0	26.674689129562775
chr14	THTPA	23556344	23557304	4541	961	66500	2498	61959	1537	4.72528616024974	40.31164606376057
chr14	THTPA	23556344	23557039	4337	696	66500	2498	62163	1802	6.23132183908046	34.496670366259714
chr14	DHRS2	23644496	23644543	0	48	0	4357	0	4309	0.0	0.0
chr14	DHRS2	23644544	23644554	0	11	0	4357	0	4346	0.0	0.0
chr14	DHRS2	23644496	23644554	0	59	0	4357	0	4298	0.0	0.0
chr14	CPNE6	24070976	24071028	0	53	0	3677	0	3624	0.0	0.0
chr14	CPNE6	24071029	24071038	0	10	0	3677	0	3667	0.0	0.0
chr14	CPNE6	24070976	24071038	0	63	0	3677	0	3614	0.0	0.0
chr14	CPNE6	24074126	24074365	0	240	0	3677	0	3437	0.0	0.0
chr14	CPNE6	24074126	24074160	0	35	0	3677	0	3642	0.0	0.0
chr14	CPNE6	24073105	24073119	0	15	0	3677	0	3662	0.0	0.0
chr14	PCK2	24094255	24094434	0	180	0	3751	0	3571	0.0	0.0
chr14	PCK2	24094435	24094845	0	411	0	3751	0	3340	0.0	0.0
chr14	PCK2	24094737	24094845	0	109	0	3751	0	3642	0.0	0.0
chr14	PCK2	24094435	24094736	0	302	0	3751	0	3449	0.0	0.0
chr14	PCK2	24099237	24099247	0	11	0	3751	0	3740	0.0	0.0
chr14	DCAF11	24115727	24115749	0	23	1397	5675	1397	5652	0.0	0.24716914366595896
chr14	DCAF11	24114925	24115293	0	369	1397	5675	1397	5306	0.0	0.26328684508104033
chr14	DCAF11	24114925	24114969	0	45	1397	5675	1397	5630	0.0	0.24813499111900533
chr14	PSME1	24136302	24136341	0	40	0	1347	0	1307	0.0	0.0
chr14	PSME1	24138561	24138568	0	8	0	1347	0	1339	0.0	0.0
chr14	PSME1	24138400	24138403	0	4	0	1347	0	1343	0.0	0.0
chr14	RNF31	24148062	24148122	0	61	0	5009	0	4948	0.0	0.0
chr14	RNF31	24148414	24148477	0	64	0	5009	0	4945	0.0	0.0
chr14	RNF31	24147592	24147890	0	299	0	5009	0	4710	0.0	0.0
chr14	IRF9	24162281	24162324	0	44	0	3101	0	3057	0.0	0.0
chr14	TSSK4	24205805	24206148	51	344	459	1855	408	1511	0.14825581395348839	0.2700198544010589
chr14	GMPR2	24233594	24233598	0	5	51	2910	51	2905	0.0	0.01755593803786575
chr14	GMPR2	24233587	24233598	0	12	51	2910	51	2898	0.0	0.017598343685300208
chr14	GMPR2	24232789	24232847	0	59	51	2910	51	2851	0.0	0.017888460189407224
chr14	GMPR2	24236042	24236140	0	99	51	2910	51	2811	0.0	0.01814300960512273
chr14	GMPR2	24233587	24233593	0	7	51	2910	51	2903	0.0	0.01756803306923872
chr14	GMPR2	24238749	24238769	0	21	51	2910	51	2889	0.0	0.017653167185877467
chr14	LTB4R2	24311559	24311804	0	246	0	1652	0	1406	0.0	0.0
chr14	LTB4R	24315017	24315020	0	4	0	3122	0	3118	0.0	0.0
chr14	NFATC4	24369671	24370594	0	924	518	7075	518	6151	0.0	0.08421394895139002
chr14	NFATC4	24376555	24376878	0	324	518	7075	518	6751	0.0	0.07672937342615908
chr14	NFATC4	24369157	24369343	0	187	518	7075	518	6888	0.0	0.07520325203252033
chr14	NFATC4	24369344	24369376	0	33	518	7075	518	7042	0.0	0.073558648111332
chr14	NFATC4	24369157	24369376	0	220	518	7075	518	6855	0.0	0.07556528081692196
chr14	KHNYN	24429992	24430119	0	128	29965	8033	29965	7905	0.0	3.790638836179633
chr14	LINC02588	26663787	26663930	0	144	0	5137	0	4993	0.0	0.0
chr14	MIR4307HG	26873222	26873294	0	73	2422	3583	2422	3510	0.0	0.69002849002849
chr14	MIR4307HG	26873472	26873542	0	71	2422	3583	2422	3512	0.0	0.6896355353075171
chr14	MIR4307HG	26873532	26873542	0	11	2422	3583	2422	3572	0.0	0.6780515117581187
chr14	MIR4307HG	26873440	26873542	0	103	2422	3583	2422	3480	0.0	0.6959770114942528
chr14	MIR4307HG	26873489	26873542	0	54	2422	3583	2422	3529	0.0	0.6863134032303769
chr14	MIR4307HG	26873440	26873471	0	32	2422	3583	2422	3551	0.0	0.6820613911574205
chr14	MIR4307HG	26880456	26880635	0	180	2422	3583	2422	3403	0.0	0.711724948574787
chr14	MIR4307HG	26873472	26873531	0	60	2422	3583	2422	3523	0.0	0.687482259437979
chr14	MIR4307HG	26873440	26873531	0	92	2422	3583	2422	3491	0.0	0.693784016041249
chr14	MIR4307HG	26873489	26873531	0	43	2422	3583	2422	3540	0.0	0.6841807909604519
chr14	MIR4307HG	26873472	26873488	0	17	2422	3583	2422	3566	0.0	0.6791923724060572
chr14	MIR4307HG	26873543	26874043	0	501	2422	3583	2422	3082	0.0	0.7858533419857235
chr14	MIR4307HG	26873472	26874043	0	572	2422	3583	2422	3011	0.0	0.8043839256061109
chr14	MIR4307HG	26873532	26874043	0	512	2422	3583	2422	3071	0.0	0.7886681862585477
chr14	MIR4307HG	26873440	26874043	0	604	2422	3583	2422	2979	0.0	0.8130245048674052
chr14	MIR4307HG	26873489	26874043	0	555	2422	3583	2422	3028	0.0	0.7998678996036989
chr14	MIR4307HG	26873440	26873488	0	49	2422	3583	2422	3534	0.0	0.6853423882286361
chr14	LINC02327	28834821	28834904	0	84	102	5076	102	4992	0.0	0.020432692307692308
chr14	SCFD1	30675066	30676855	0	1790	0	20324	0	18534	0.0	0.0
chr14	SCFD1	30676634	30676855	0	222	0	20324	0	20102	0.0	0.0
chr14	SCFD1	30707915	30708065	0	151	0	20324	0	20173	0.0	0.0
chr14	SCFD1	30705886	30708065	0	2180	0	20324	0	18144	0.0	0.0
chr14	SCFD1	30622400	30622462	0	63	0	20324	0	20261	0.0	0.0
chr14	COCH	30875104	30875298	0	195	0	3999	0	3804	0.0	0.0
chr14	COCH	30874973	30875055	0	83	0	3999	0	3916	0.0	0.0
chr14	ARHGAP5	32094384	32094386	0	3	1479	10287	1479	10284	0.0	0.14381563593932323
chr14	ARHGAP5	32077436	32077436	0	1	1479	10287	1479	10286	0.0	0.14378767256465097
chr14	NPAS3	33797573	33797581	0	9	128	9801	128	9792	0.0	0.013071895424836602
chr14	SRP54	34983004	34983215	0	212	11261	8450	11261	8238	0.0	1.3669579995144452
chr14	SRP54	34999645	34999649	5	5	11261	8450	11256	8445	1.0	1.3328596802841919
chr14	FAM177A1	35046629	35046954	1915	326	66531	8320	64616	7994	5.874233128834356	8.083062296722542
chr14	FAM177A1	35046955	35047084	1489	130	66531	8320	65042	8190	11.453846153846154	7.941636141636142
chr14	PSMA6	35312922	35313059	0	138	1020	2284	1020	2146	0.0	0.47530288909599255
chr14	PRORP	35122636	35122767	0	132	17174	7001	17174	6869	0.0	2.500218372397729
chr14	PRORP	35122768	35122806	0	39	17174	7001	17174	6962	0.0	2.466819879345016
chr14	PSMA6	35292553	35292600	20	48	1020	2284	1000	2236	0.4166666666666667	0.4472271914132379
chr14	AL133304.3	35898841	35898884	0	44	204	3442	204	3398	0.0	0.06003531489111242
chr14	PAX9	36666592	36666601	0	10	0	4791	0	4781	0.0	0.0
chr14	MIPOL1	37198105	37198278	0	174	408	20276	408	20102	0.0	0.020296487911650583
chr14	AL355835.1	38298605	38298811	0	207	0	1874	0	1667	0.0	0.0
chr14	GEMIN2	39114396	39114475	0	80	0	2501	0	2421	0.0	0.0
chr14	GEMIN2	39114421	39114475	0	55	0	2501	0	2446	0.0	0.0
chr14	GEMIN2	39114467	39114475	0	9	0	2501	0	2492	0.0	0.0
chr14	GEMIN2	39114396	39114420	0	25	0	2501	0	2476	0.0	0.0
chr14	GEMIN2	39114396	39114466	0	71	0	2501	0	2430	0.0	0.0
chr14	GEMIN2	39114421	39114466	0	46	0	2501	0	2455	0.0	0.0
chr14	MIA2	39276956	39277065	0	110	153	9868	153	9758	0.0	0.0156794425087108
chr14	MIA2	39267190	39267522	0	333	153	9868	153	9535	0.0	0.016046145778710014
chr14	MIA2	39291097	39291111	0	15	153	9868	153	9853	0.0	0.01552826550289252
chr14	AL049828.1	39470401	39470589	0	189	2549	12973	2549	12784	0.0	0.1993898623279099
chr14	AL049828.1	39474898	39474955	0	58	2549	12973	2549	12915	0.0	0.19736740224545102
chr14	PRPF39	45095534	45095563	0	30	0	4642	0	4612	0.0	0.0
chr14	FANCM	45198836	45198935	0	100	284	8294	284	8194	0.0	0.034659506956309497
chr14	DMAC2L	50312390	50313060	1912	671	5585	4575	3673	3904	2.849478390461997	0.9408299180327869
chr14	DMAC2L	50322720	50322806	0	87	5585	4575	5585	4488	0.0	1.2444295900178253
chr14	ATL1	50560300	50560500	180	201	15445	6261	15265	6060	0.8955223880597015	2.518976897689769
chr14	TMX1	51245359	51245454	0	96	1578	4616	1578	4520	0.0	0.3491150442477876
chr14	FRMD6	51701136	51701159	0	24	49973	7476	49973	7452	0.0	6.705984970477724
chr14	FRMD6	51651997	51652217	0	221	49973	7476	49973	7255	0.0	6.888077188146106
chr14	PSMC6	52707305	52707529	0	225	330	7350	330	7125	0.0	0.04631578947368421
chr14	AL139317.5	52898151	52898154	204	4	32562	6856	32358	6852	51.0	4.722416812609457
chr14	SAMD4A	54567311	54567338	0	28	153	12348	153	12320	0.0	0.01241883116883117
chr14	SAMD4A	54784382	54784447	0	66	153	12348	153	12282	0.0	0.012457254518808011
chr14	KTN1	55648089	55648115	0	27	19648	13937	19648	13910	0.0	1.412508986340762
chr14	LINC02284	56311095	56311102	0	8	0	4445	0	4437	0.0	0.0
chr14	AP5M1	57269070	57269388	0	319	0	12111	0	11792	0.0	0.0
chr14	NAA30	57391507	57391728	0	222	0	7303	0	7081	0.0	0.0
chr14	ACTR10	58211393	58211410	0	18	0	3657	0	3639	0.0	0.0
chr14	ARID4A	58366069	58366230	0	162	0	7475	0	7313	0.0	0.0
chr14	KIAA0586	58459910	58460070	0	161	51	17469	51	17308	0.0	0.002946614282412757
chr14	KIAA0586	58427814	58428463	0	650	51	17469	51	16819	0.0	0.0030322849158689576
chr14	KIAA0586	58427858	58428463	0	606	51	17469	51	16863	0.0	0.003024372887386586
chr14	KIAA0586	58427814	58427857	0	44	51	17469	51	17425	0.0	0.002926829268292683
chr14	LINC01500	58828549	58828555	7	7	26561	6780	26554	6773	1.0	3.920566957035287
chr14	JKAMP	59495088	59495224	0	137	0	4049	0	3912	0.0	0.0
chr14	JKAMP	59484594	59485116	0	523	0	4049	0	3526	0.0	0.0
chr14	LRRC9	60032064	60032067	0	4	5592	5408	5592	5404	0.0	1.0347890451517394
chr14	PCNX4	60124311	60125251	0	941	0	9442	0	8501	0.0	0.0
chr14	PCNX4	60124714	60125251	0	538	0	9442	0	8904	0.0	0.0
chr14	PCNX4	60124311	60124713	0	403	0	9442	0	9039	0.0	0.0
chr14	PPM1A	60282795	60283537	0	743	75	11920	75	11177	0.0	0.006710208463809609
chr14	SLC38A6	60981383	60981687	0	305	186	4924	186	4619	0.0	0.040268456375838924
chr14	SLC38A6	60981688	60981691	0	4	186	4924	186	4920	0.0	0.03780487804878049
chr14	PRKCH	61281269	61281308	0	40	32148	8398	32148	8358	0.0	3.8463747307968412
chr14	LINC00643	62117567	62117588	0	22	0	4644	0	4622	0.0	0.0
chr14	AL136038.4	63642186	63642197	0	12	0	1434	0	1422	0.0	0.0
chr14	AL136038.4	63651420	63651456	0	37	0	1434	0	1397	0.0	0.0
chr14	SYNE2	64137984	64138001	0	18	47311	32202	47311	32184	0.0	1.470016157096694
chr14	SYNE2	64212955	64213005	0	51	47311	32202	47311	32151	0.0	1.4715249914466113
chr14	SYNE2	63997392	63997576	0	185	47311	32202	47311	32017	0.0	1.4776837305181623
chr14	MTHFD1	64390468	64390791	0	324	5247	12243	5247	11919	0.0	0.44022149509187014
chr14	PLEKHG3	64738138	64738224	0	87	102	11824	102	11737	0.0	0.00869046604754196
chr14	FNTB	65027766	65027781	0	16	1465	3789	1465	3773	0.0	0.38828518420355157
chr14	AL139022.1	65090020	65090227	0	208	0	1382	0	1174	0.0	0.0
chr14	AL139022.1	65090161	65090227	0	67	0	1382	0	1315	0.0	0.0
chr14	AL139022.1	65090020	65090160	0	141	0	1382	0	1241	0.0	0.0
chr14	LINC02290	66111772	66112354	0	583	408	4521	408	3938	0.0	0.10360589131538853
chr14	LINC02290	66111996	66112354	0	359	408	4521	408	4162	0.0	0.0980297933685728
chr14	LINC02290	66123181	66123313	0	133	408	4521	408	4388	0.0	0.09298085688240657
chr14	LINC02290	66111772	66111995	0	224	408	4521	408	4297	0.0	0.0949499650919246
chr14	FAM71D	67221808	67222025	0	218	1684	4520	1684	4302	0.0	0.3914458391445839
chr14	PLEKHH1	67581002	67581038	0	37	29791	8378	29791	8341	0.0	3.5716340966310995
chr14	GALNT16	69259747	69259797	1023	51	1484799	9668	1483776	9617	20.058823529411764	154.2867838203182
chr14	SLC39A9	69398451	69398603	0	153	306	7148	306	6995	0.0	0.04374553252323088
chr14	SRSF5	69767252	69767255	0	4	3958	3622	3958	3618	0.0	1.093974571586512
chr14	SRSF5	69767256	69767380	0	125	3958	3622	3958	3497	0.0	1.1318272805261653
chr14	SRSF5	69767252	69767380	0	129	3958	3622	3958	3493	0.0	1.1331233896364157
chr14	AC004816.1	70810292	70810665	0	374	0	1456	0	1082	0.0	0.0
chr14	AC004816.1	70810666	70810674	0	9	0	1456	0	1447	0.0	0.0
chr14	AC004816.1	70810292	70810674	0	383	0	1456	0	1073	0.0	0.0
chr14	PCNX1	70995844	70995925	0	82	5327	16758	5327	16676	0.0	0.31944111297673305
chr14	DCAF4	72954463	72954483	0	21	51	5555	51	5534	0.0	0.009215757137694253
chr14	RBM25	73058706	73058811	0	106	2179	11083	2179	10977	0.0	0.198505967021955
chr14	PSEN1	73136449	73136583	0	135	35813	9942	35813	9807	0.0	3.651779341286836
chr14	PSEN1	73136580	73136583	0	4	35813	9942	35813	9938	0.0	3.6036425840209296
chr14	PSEN1	73136449	73136579	0	131	35813	9942	35813	9811	0.0	3.650290490266028
chr14	PSEN1	73148095	73148106	0	12	35813	9942	35813	9930	0.0	3.6065458207452163
chr14	ACOT2	73569397	73569883	28406	487	79234	2306	50828	1819	58.328542094455855	27.94282572842221
chr14	PTGR2	73851944	73852004	0	61	2692	6154	2692	6093	0.0	0.44181848022320697
chr14	PTGR2	73874144	73874214	0	71	2692	6154	2692	6083	0.0	0.44254479697517674
chr14	PTGR2	73852005	73852120	0	116	2692	6154	2692	6038	0.0	0.4458429943689964
chr14	PTGR2	73852117	73852120	0	4	2692	6154	2692	6150	0.0	0.4377235772357724
chr14	PTGR2	73852005	73852116	0	112	2692	6154	2692	6042	0.0	0.44554783184376034
chr14	ZNF410	73892108	73892208	0	101	508	5246	508	5145	0.0	0.09873663751214772
chr14	ZNF410	73886916	73886927	0	12	508	5246	508	5234	0.0	0.09705769965609476
chr14	COQ6	73950289	73950495	0	207	194241	5835	194241	5628	0.0	34.51332622601279
chr14	FCF1	74713553	74713620	0	68	0	4755	0	4687	0.0	0.0
chr14	FCF1	74713508	74713620	0	113	0	4755	0	4642	0.0	0.0
chr14	FCF1	74713508	74713552	0	45	0	4755	0	4710	0.0	0.0
chr14	FCF1	74713201	74713259	0	59	0	4755	0	4696	0.0	0.0
chr14	DLST	74891168	74891193	0	26	0	4551	0	4525	0.0	0.0
chr14	ZC2HC1C	75069750	75071396	7499	1647	31516	7841	24017	6194	4.553126897389192	3.8774620600581207
chr14	ZC2HC1C	75069686	75069749	165	64	31516	7841	31351	7777	2.578125	4.031245981741031
chr14	ZC2HC1C	75071397	75071738	51	342	31516	7841	31465	7499	0.14912280701754385	4.1958927857047605
chr14	ZC2HC1C	75071397	75071911	51	515	31516	7841	31465	7326	0.09902912621359224	4.294976794976795
chr14	ZC2HC1C	75071739	75071911	0	173	31516	7841	31516	7668	0.0	4.110067814293166
chr14	ZC2HC1C	75069750	75069948	141	199	31516	7841	31375	7642	0.7085427135678392	4.105600628107825
chr14	ZC2HC1C	75069686	75069948	306	263	31516	7841	31210	7578	1.1634980988593155	4.118500923726577
chr14	ZC2HC1C	75069926	75069948	7	23	31516	7841	31509	7818	0.30434782608695654	4.03031465848043
chr14	ZC2HC1C	75069750	75071911	7550	2162	31516	7841	23966	5679	3.49213691026827	4.2201091741503785
chr14	ZC2HC1C	75069750	75069925	134	176	31516	7841	31382	7665	0.7613636363636364	4.094194390084801
chr14	ZC2HC1C	75069686	75069925	299	240	31516	7841	31217	7601	1.2458333333333333	4.106959610577555
chr14	LINC01220	75294542	75294737	629	196	3869	1982	3240	1786	3.2091836734693877	1.8141097424412094
chr14	BATF	75522541	75522745	3090	205	6280	931	3190	726	15.073170731707316	4.393939393939394
chr14	IFT43	75986283	75986308	0	26	51	3897	51	3871	0.0	0.013174890209248256
chr14	GPATCH2L	76151976	76151991	0	16	15297	20948	15297	20932	0.0	0.7307949550926811
chr14	LRRC74A	76826584	76826734	0	151	40	2320	40	2169	0.0	0.018441678192715538
chr14	GSTZ1	77327511	77327552	0	42	0	5473	0	5431	0.0	0.0
chr14	SLIRP	77710881	77710896	0	16	830	2452	830	2436	0.0	0.34072249589490966
chr14	C14ORF178	77768466	77768523	0	58	878	703	878	645	0.0	1.3612403100775194
chr14	NRXN3	79805191	79805199	0	9	255	14947	255	14938	0.0	0.01707055830767171
chr14	LINC02301	82657212	82657455	0	244	0	6218	0	5974	0.0	0.0
chr14	LINC02301	82642675	82642798	0	124	0	6218	0	6094	0.0	0.0
chr14	LINC00911	85393900	85393959	0	60	0	1755	0	1695	0.0	0.0
chr14	FLRT2	85530535	85530556	0	22	51	30568	51	30546	0.0	0.001669613042624239
chr14	LINC01146	88087024	88087037	0	14	0	9300	0	9286	0.0	0.0
chr14	LINC01146	88091450	88091652	0	203	0	9300	0	9097	0.0	0.0
chr14	LINC01146	88084156	88084483	0	328	0	9300	0	8972	0.0	0.0
chr14	SPATA7	88396185	88396203	0	19	2237	6106	2237	6087	0.0	0.3675045178248727
chr14	SPATA7	88385838	88386031	0	194	2237	6106	2237	5912	0.0	0.378382949932341
chr14	ZC3H14	88603046	88603060	0	15	0	20176	0	20161	0.0	0.0
chr14	TTC8	88840924	88840928	0	5	0	6251	0	6246	0.0	0.0
chr14	TTC8	88841515	88841557	0	43	0	6251	0	6208	0.0	0.0
chr14	TDP1	89980633	89980679	0	47	204	6245	204	6198	0.0	0.03291384317521781
chr14	CALM1	90397155	90397233	248	79	5033	7087	4785	7008	3.1392405063291138	0.682791095890411
chr14	CALM1	90399088	90399162	0	75	5033	7087	5033	7012	0.0	0.7177695379349687
chr14	LINC00642	90455487	90456254	5039	768	23015	5124	17976	4356	6.561197916666667	4.126721763085399
chr14	LINC00642	90455506	90456254	5039	749	23015	5124	17976	4375	6.7276368491321765	4.1088
chr14	LINC00642	90455379	90456270	10624	892	23015	5124	12391	4232	11.910313901345292	2.927930056710775
chr14	LINC00642	90456255	90456270	0	16	23015	5124	23015	5108	0.0	4.505677368833203
chr14	LINC00642	90455379	90456254	10624	876	23015	5124	12391	4248	12.127853881278538	2.9169020715630887
chr14	LINC00642	90455487	90456270	5039	784	23015	5124	17976	4340	6.427295918367347	4.141935483870967
chr14	LINC00642	90455506	90456270	5039	765	23015	5124	17976	4359	6.586928104575163	4.1238816242257395
chr14	LINC00642	90455487	90455505	0	19	23015	5124	23015	5105	0.0	4.508325171400588
chr14	DGLUCY	91114284	91114528	0	245	10229	7243	10229	6998	0.0	1.4617033438125178
chr14	DGLUCY	91170187	91170201	0	15	10229	7243	10229	7228	0.0	1.41519092418373
chr14	DGLUCY	91173404	91173439	0	36	10229	7243	10229	7207	0.0	1.4193145552934647
chr14	DGLUCY	91114995	91115221	0	227	10229	7243	10229	7016	0.0	1.4579532497149372
chr14	DGLUCY	91204826	91204867	0	42	10229	7243	10229	7201	0.0	1.4204971531731705
chr14	DGLUCY	91215557	91215793	0	237	10229	7243	10229	7006	0.0	1.4600342563516986
chr14	CPSF2	92122129	92122351	0	223	51	13579	51	13356	0.0	0.0038185085354896678
chr14	SLC24A4	92449160	92449216	0	57	52562	14801	52562	14744	0.0	3.5649755832881174
chr14	FAM181A	93927400	93927454	0	55	0	2123	0	2068	0.0	0.0
chr14	FAM181A	93927455	93927626	0	172	0	2123	0	1951	0.0	0.0
chr14	FAM181A	93927400	93927626	0	227	0	2123	0	1896	0.0	0.0
chr14	CCDC197	94001320	94001323	0	4	0	2717	0	2713	0.0	0.0
chr14	CCDC197	94001324	94001722	0	399	0	2717	0	2318	0.0	0.0
chr14	CCDC197	94001320	94001722	0	403	0	2717	0	2314	0.0	0.0
chr14	IFI27L1	94101976	94102059	0	84	0	2366	0	2282	0.0	0.0
chr14	IFI27	94110762	94110797	0	36	0	3825	0	3789	0.0	0.0
chr14	SERPINA4	94561495	94561809	1637	315	18576	1992	16939	1677	5.196825396825397	10.10077519379845
chr14	SERPINA4	94561655	94561809	1100	155	18576	1992	17476	1837	7.096774193548387	9.513336962438759
chr14	SERPINA4	94561495	94561654	537	160	18576	1992	18039	1832	3.35625	9.846615720524017
chr14	SERPINA5	94581491	94581710	102	220	2600	3760	2498	3540	0.4636363636363636	0.7056497175141243
chr14	SERPINA5	94581639	94581710	18	72	2600	3760	2582	3688	0.25	0.7001084598698482
chr14	SERPINA5	94581491	94581638	84	148	2600	3760	2516	3612	0.5675675675675675	0.6965669988925803
chr14	SERPINA5	94581999	94582342	1887	344	2600	3760	713	3416	5.4854651162790695	0.20872365339578455
chr14	SERPINA3	94612444	94612447	0	4	102	5005	102	5001	0.0	0.020395920815836834
chr14	LINC02292	95331518	95331645	0	128	0	3162	0	3034	0.0	0.0
chr14	LINC02292	95329639	95329668	0	30	0	3162	0	3132	0.0	0.0
chr14	LINC02318	95573683	95573684	0	2	5164	2840	5164	2838	0.0	1.8195912614517267
chr14	LINC02318	95573685	95573886	0	202	5164	2840	5164	2638	0.0	1.957543593631539
chr14	LINC02318	95573683	95573886	0	204	5164	2840	5164	2636	0.0	1.9590288315629742
chr14	LINC02318	95580612	95580651	0	40	5164	2840	5164	2800	0.0	1.8442857142857143
chr14	LINC02318	95577606	95577696	327	91	5164	2840	4837	2749	3.5934065934065935	1.7595489268825026
chr14	AL133467.2	95621034	95621118	0	85	1989	1929	1989	1844	0.0	1.0786334056399132
chr14	TCL6	95668581	95669617	102	1037	2040	10388	1938	9351	0.09836065573770492	0.20725056143727943
chr14	TCL6	95663636	95665076	0	1441	2040	10388	2040	8947	0.0	0.22800938862188444
chr14	AL139020.1	95711899	95712025	0	127	0	3021	0	2894	0.0	0.0
chr14	GSKIP	96379756	96379788	0	33	0	4558	0	4525	0.0	0.0
chr14	GSKIP	96379735	96379788	0	54	0	4558	0	4504	0.0	0.0
chr14	GSKIP	96379735	96379755	0	21	0	4558	0	4537	0.0	0.0
chr14	GSKIP	96363569	96365266	0	1698	0	4558	0	2860	0.0	0.0
chr14	AL137786.1	96592816	96593249	0	434	102	2863	102	2429	0.0	0.04199258954302182
chr14	AL137786.1	96593580	96593699	0	120	102	2863	102	2743	0.0	0.03718556325191396
chr14	AL137786.1	96593696	96593699	0	4	102	2863	102	2859	0.0	0.035676810073452254
chr14	AL137786.1	96592808	96592815	0	8	102	2863	102	2855	0.0	0.03572679509632224
chr14	AL137786.1	96594882	96594949	0	68	102	2863	102	2795	0.0	0.036493738819320214
chr14	AL137786.1	96593580	96593695	0	116	102	2863	102	2747	0.0	0.037131416090280304
chr14	LINC02325	97427120	97427254	0	135	897	5246	897	5111	0.0	0.17550381530033263
chr14	CCNK	99481480	99481614	0	135	0	5576	0	5441	0.0	0.0
chr14	CYP46A1	99722037	99722066	0	30	55	9376	55	9346	0.0	0.005884870532848277
chr14	EML1	99793518	99793543	0	26	4718	8834	4718	8808	0.0	0.5356494096276113
chr14	WDR25	100376496	100376504	0	9	25387	4230	25387	4221	0.0	6.014451551764985
chr14	WDR25	100376505	100376704	13868	200	25387	4230	11519	4030	69.34	2.8583126550868485
chr14	WDR25	100376496	100376704	13868	209	25387	4230	11519	4021	66.35406698564593	2.8647102710768464
chr14	LINC00523	100657711	100658105	0	395	4665	3347	4665	2952	0.0	1.5802845528455285
chr14	MEG3	100829750	100829787	18	38	138632	9744	138614	9706	0.47368421052631576	14.281269317947661
chr14	MEG3	100834752	100835879	70204	1128	138632	9744	68428	8616	62.237588652482266	7.941968430826369
chr14	MEG3	100835550	100835879	23107	330	138632	9744	115525	9414	70.02121212121212	12.271616741024006
chr14	MEG3	100835880	100836075	1222	196	138632	9744	137410	9548	6.23469387755102	14.39149560117302
chr14	MEG3	100834752	100836075	71426	1324	138632	9744	67206	8420	53.94712990936556	7.981710213776722
chr14	MEG3	100835550	100836075	24329	526	138632	9744	114303	9218	46.252851711026615	12.399978303319592
chr14	MEG8	100944873	100944925	0	53	16860	24817	16860	24764	0.0	0.6808270069455662
chr14	MEG8	100944894	100944925	0	32	16860	24817	16860	24785	0.0	0.6802501513011903
chr14	MEG3	100856269	100857388	0	1120	138632	9744	138632	8624	0.0	16.075139146567718
chr14	MEG8	100942827	100942838	0	12	16860	24817	16860	24805	0.0	0.6797016730497883
chr14	MEG8	100968723	100968724	0	2	16860	24817	16860	24815	0.0	0.6794277654644368
chr14	MEG8	100944873	100944893	0	21	16860	24817	16860	24796	0.0	0.6799483787707695
chr14	MEG8	100966732	100966735	0	4	16860	24817	16860	24813	0.0	0.6794825293193084
chr14	MEG8	100977695	100977722	0	28	16860	24817	16860	24789	0.0	0.6801403848481181
chr14	MEG8	100997547	100997552	0	6	16860	24817	16860	24811	0.0	0.6795373020031438
chr14	MEG8	100967787	100967790	0	4	16860	24817	16860	24813	0.0	0.6794825293193084
chr14	DYNC1H1	102049583	102049611	0	29	44258	31680	44258	31651	0.0	1.3983128495150232
chr14	WDR20	102139988	102140172	0	185	0	7270	0	7085	0.0	0.0
chr14	ZNF839	102339224	102339229	30	6	1596	5405	1566	5399	5.0	0.29005371365067606
chr14	AMN	102928943	102928975	0	33	5416	4057	5416	4024	0.0	1.345924453280318
chr14	TNFAIP2	103123484	103123951	0	468	852	3893	852	3425	0.0	0.24875912408759124
chr14	EIF5	103334261	103334597	0	337	58325	6699	58325	6362	0.0	9.16771455517133
chr14	EIF5	103335063	103335185	306	123	58325	6699	58019	6576	2.4878048780487805	8.822840632603405
chr14	EIF5	103335039	103335185	306	147	58325	6699	58019	6552	2.0816326530612246	8.85515873015873
chr14	EIF5	103335039	103335062	0	24	58325	6699	58325	6675	0.0	8.737827715355806
chr14	MARK3	103385698	103386080	1333	383	68861	15808	67528	15425	3.480417754569191	4.377828200972448
chr14	MARK3	103411750	103411765	39	16	68861	15808	68822	15792	2.4375	4.358029381965552
chr14	KLC1	103662922	103662927	0	6	153	18950	153	18944	0.0	0.00807643581081081
chr14	KLC1	103679519	103679545	0	27	153	18950	153	18923	0.0	0.008085398721133013
chr14	INF2	104706153	104706176	0	24	51	13399	51	13375	0.0	0.0038130841121495327
chr14	INF2	104711008	104711011	0	4	51	13399	51	13395	0.0	0.003807390817469205
chr14	ADSS1	104729896	104730213	0	318	0	4717	0	4399	0.0	0.0
chr14	CLBA1	104989075	104989088	0	14	0	5232	0	5218	0.0	0.0
chr14	CLBA1	104985879	104986854	0	976	0	5232	0	4256	0.0	0.0
chr14	CLBA1	104989089	104989707	0	619	0	5232	0	4613	0.0	0.0
chr14	CLBA1	104989075	104989707	0	633	0	5232	0	4599	0.0	0.0
chr14	PACS2	105368516	105368539	0	24	7767	12388	7767	12364	0.0	0.6281947589776772
chr14	PACS2	105382047	105382058	0	12	7767	12388	7767	12376	0.0	0.6275856496444732
chr14	TEDC1	105491119	105491126	0	8	306	3476	306	3468	0.0	0.08823529411764706
chr14	AL928654.3	105488795	105488947	0	153	226	1416	226	1263	0.0	0.1789390340459224
chr14	TEDC1	105491119	105491132	0	14	306	3476	306	3462	0.0	0.08838821490467938
chr14	TEDC1	105491127	105491132	0	6	306	3476	306	3470	0.0	0.08818443804034583
chr14	TEDC1	105491119	105491154	0	36	306	3476	306	3440	0.0	0.08895348837209302
chr14	TEDC1	105491127	105491154	0	28	306	3476	306	3448	0.0	0.08874709976798144
chr14	TEDC1	105491133	105491154	0	22	306	3476	306	3454	0.0	0.08859293572669369
chr14	TEDC1	105491684	105491700	0	17	306	3476	306	3459	0.0	0.08846487424111014
chr14	TEDC1	105491361	105491522	0	162	306	3476	306	3314	0.0	0.09233554616777308
chr14	OR4K13	20035641	20035936	0	296	0	5982	0	5686	0.0	0.0
chr14	TTC5	20300606	20300673	0	68	102	8194	102	8126	0.0	0.012552301255230125
chr14	TTC5	20305355	20305885	0	531	102	8194	102	7663	0.0	0.013310713819652877
chr14	CCNB1IP1	20329173	20329222	0	50	0	3695	0	3645	0.0	0.0
chr14	CCNB1IP1	20317793	20317793	0	1	0	3695	0	3694	0.0	0.0
chr14	CCNB1IP1	20332843	20333252	0	410	0	3695	0	3285	0.0	0.0
chr14	TEP1	20413370	20413403	0	34	222	11420	222	11386	0.0	0.01949762866678377
chr14	KLHL33	20435063	20435462	0	400	102	5114	102	4714	0.0	0.021637675010606705
chr14	OSGEP	20451973	20451993	0	21	0	4721	0	4700	0.0	0.0
chr14	PIP4P1	20461162	20461182	0	21	0	3028	0	3007	0.0	0.0
chr14	RNASE9	20558539	20558613	0	75	0	2714	0	2639	0.0	0.0
chr14	RNASE11	20587968	20588013	0	46	8	1739	8	1693	0.0	0.004725339633786178
chr14	RNASE11	20587877	20587967	0	91	8	1739	8	1648	0.0	0.0048543689320388345
chr14	RNASE11	20587742	20587967	0	226	8	1739	8	1513	0.0	0.005287508261731659
chr14	RNASE11	20587742	20587876	0	135	8	1739	8	1604	0.0	0.004987531172069825
chr14	RNASE11	20587742	20587767	0	26	8	1739	8	1713	0.0	0.004670169293636894
chr14	RNASE11	20587742	20587858	0	117	8	1739	8	1622	0.0	0.004932182490752158
chr14	RNASE11	20587768	20587967	0	200	8	1739	8	1539	0.0	0.005198180636777128
chr14	RNASE11	20587768	20587876	0	109	8	1739	8	1630	0.0	0.0049079754601227
chr14	RNASE11	20587768	20587858	0	91	8	1739	8	1648	0.0	0.0048543689320388345
chr14	RNASE11	20587859	20587876	0	18	8	1739	8	1721	0.0	0.004648460197559558
chr14	NDRG2	21018762	21018794	0	33	0	5997	0	5964	0.0	0.0
chr14	NDRG2	21023985	21024028	0	44	0	5997	0	5953	0.0	0.0
chr14	NDRG2	21024825	21024847	0	23	0	5997	0	5974	0.0	0.0
chr14	NDRG2	21024848	21025027	0	180	0	5997	0	5817	0.0	0.0
chr14	NDRG2	21025028	21025062	0	35	0	5997	0	5962	0.0	0.0
chr14	NDRG2	21024029	21024847	0	819	0	5997	0	5178	0.0	0.0
chr14	NDRG2	21024029	21024824	0	796	0	5997	0	5201	0.0	0.0
chr14	NDRG2	21024029	21024836	0	808	0	5997	0	5189	0.0	0.0
chr14	NDRG2	21025393	21025469	0	77	0	5997	0	5920	0.0	0.0
chr14	NDRG2	21020968	21021038	0	71	0	5997	0	5926	0.0	0.0
chr14	NDRG2	21021746	21021815	0	70	0	5997	0	5927	0.0	0.0
chr14	NDRG2	21024215	21024234	0	20	0	5997	0	5977	0.0	0.0
chr14	NDRG2	21023975	21024028	0	54	0	5997	0	5943	0.0	0.0
chr14	NDRG2	21023975	21023984	0	10	0	5997	0	5987	0.0	0.0
chr14	NDRG2	21024825	21024836	0	12	0	5997	0	5985	0.0	0.0
chr14	NDRG2	21024837	21024847	0	11	0	5997	0	5986	0.0	0.0
chr14	NDRG2	21025470	21025675	0	206	0	5997	0	5791	0.0	0.0
chr14	ZNF219	21094390	21094418	0	29	0	5150	0	5121	0.0	0.0
chr14	OR5AU1	21158345	21158821	511	477	16779	8411	16268	7934	1.071278825995807	2.0504159314343333
chr14	HNRNPC	21230957	21230995	0	39	102	5164	102	5125	0.0	0.019902439024390244
chr14	HNRNPC	21262600	21263309	0	710	102	5164	102	4454	0.0	0.022900763358778626
chr14	CHD8	21430800	21431809	0	1010	0	13518	0	12508	0.0	0.0
chr14	SALL2	21536848	21536960	0	113	0	4770	0	4657	0.0	0.0
chr14	DAD1	22588946	22589034	0	89	0	765	0	676	0.0	0.0
chr14	DAD1	22588946	22589029	0	84	0	765	0	681	0.0	0.0
chr14	DAD1	22589030	22589034	0	5	0	765	0	760	0.0	0.0
chr14	SLC7A7	22815313	22815318	0	6	255	4786	255	4780	0.0	0.053347280334728034
chr14	PRMT5	22922175	22922208	0	34	0	3100	0	3066	0.0	0.0
chr14	PRMT5	22924269	22924304	0	36	0	3100	0	3064	0.0	0.0
chr14	PRMT5	22926505	22926522	0	18	0	3100	0	3082	0.0	0.0
chr14	PRMT5	22929166	22929250	0	85	0	3100	0	3015	0.0	0.0
chr14	PRMT5	22929166	22929217	0	52	0	3100	0	3048	0.0	0.0
chr14	PRMT5	22929166	22929332	0	167	0	3100	0	2933	0.0	0.0
chr14	PRMT5	22920839	22920986	0	148	0	3100	0	2952	0.0	0.0
chr14	PRMT5	22929251	22929332	0	82	0	3100	0	3018	0.0	0.0
chr14	PRMT5	22929218	22929250	0	33	0	3100	0	3067	0.0	0.0
chr14	PRMT5	22929218	22929332	0	115	0	3100	0	2985	0.0	0.0
chr14	HAUS4	22956915	22956922	0	8	0	2413	0	2405	0.0	0.0
chr14	HAUS4	22956745	22956914	0	170	0	2413	0	2243	0.0	0.0
chr14	HAUS4	22956745	22956922	0	178	0	2413	0	2235	0.0	0.0
chr14	C14ORF93	23010016	23010099	0	84	0	3210	0	3126	0.0	0.0
chr14	C14ORF93	23010016	23010064	0	49	0	3210	0	3161	0.0	0.0
chr14	PSMB5	23034475	23034682	1275	208	1168	1347	-107	1139	6.1298076923076925	-0.09394205443371378
chr14	ACIN1	23071124	23071425	0	302	57945	7290	57945	6988	0.0	8.292072123640526
chr14	PPP1R3E	23301297	23301396	4685	100	173836	4258	169151	4158	46.85	40.68085618085618
chr14	SLC22A17	23347459	23347512	570	54	296834	4288	296264	4234	10.555555555555555	69.97260273972603
chr14	AP1G2	23567110	23567235	76817	126	402491	5143	325674	5017	609.6587301587301	64.91409208690453
chr14	AP1G2	23567596	23567737	70679	142	402491	5143	331812	5001	497.73943661971833	66.34913017396521
chr14	DHRS4-AS1	23953773	23954123	0	351	25330	7706	25330	7355	0.0	3.443915703602991
chr14	DHRS4-AS1	23953308	23953772	0	465	25330	7706	25330	7241	0.0	3.4981356166275375
chr14	DHRS4-AS1	23953308	23953572	0	265	25330	7706	25330	7441	0.0	3.4041123504905255
chr14	DHRS4-AS1	23953308	23954123	0	816	25330	7706	25330	6890	0.0	3.676342525399129
chr14	DHRS4-AS1	23953573	23953772	0	200	25330	7706	25330	7506	0.0	3.3746336264321877
chr14	DHRS4-AS1	23953573	23954123	0	551	25330	7706	25330	7155	0.0	3.5401816911250874
chr14	DHRS4-AS1	24052297	24052385	0	89	25330	7706	25330	7617	0.0	3.325456216358146
chr14	DHRS4-AS1	23952597	23953772	0	1176	25330	7706	25330	6530	0.0	3.879019908116386
chr14	DHRS4-AS1	23952597	23953307	0	711	25330	7706	25330	6995	0.0	3.6211579699785563
chr14	DHRS4-AS1	23952597	23953572	0	976	25330	7706	25330	6730	0.0	3.763744427934621
chr14	DHRS4-AS1	23952597	23954123	0	1527	25330	7706	25330	6179	0.0	4.099368829907752
chr14	NRL	24081679	24081766	0	88	255	4561	255	4473	0.0	0.05700871898054997
chr14	EMC9	24141106	24141346	0	241	0	1307	0	1066	0.0	0.0
chr14	IPO4	24180682	24180687	0	6	27	4634	27	4628	0.0	0.0058340535868625755
chr14	TM9SF1	24190379	24190429	0	51	0	2941	0	2890	0.0	0.0
chr14	TM9SF1	24195345	24195548	0	204	0	2941	0	2737	0.0	0.0
chr14	TM9SF1	24195308	24195344	0	37	0	2941	0	2904	0.0	0.0
chr14	TM9SF1	24195308	24195548	0	241	0	2941	0	2700	0.0	0.0
chr14	CHMP4A	24211410	24211413	0	4	13	1933	13	1929	0.0	0.00673924313115604
chr14	MDP1	24214491	24214544	0	54	0	1029	0	975	0.0	0.0
chr14	NEDD8	24218058	24218131	0	74	153	3793	153	3719	0.0	0.04114009142242538
chr14	TINF2	24242140	24242375	0	236	0	2610	0	2374	0.0	0.0
chr14	TGM1	24263933	24263992	0	60	0	3450	0	3390	0.0	0.0
chr14	RABGGTA	24270333	24270358	0	26	0	3090	0	3064	0.0	0.0
chr14	RABGGTA	24271112	24271485	0	374	0	3090	0	2716	0.0	0.0
chr14	RABGGTA	24267865	24267868	0	4	0	3090	0	3086	0.0	0.0
chr14	DHRS1	24292620	24292650	0	31	0	4668	0	4637	0.0	0.0
chr14	ADCY4	24326078	24326103	0	26	0	7362	0	7336	0.0	0.0
chr14	ADCY4	24334493	24334982	0	490	0	7362	0	6872	0.0	0.0
chr14	ADCY4	24334884	24334982	0	99	0	7362	0	7263	0.0	0.0
chr14	RIPK3	24338210	24338247	0	38	153	2737	153	2699	0.0	0.05668766209707299
chr14	SDR39U1	24441673	24441676	0	4	0	2120	0	2116	0.0	0.0
chr14	SDR39U1	24442812	24442816	0	5	0	2120	0	2115	0.0	0.0
chr14	SDR39U1	24442097	24442176	0	80	0	2120	0	2040	0.0	0.0
chr14	SDR39U1	24442097	24442107	0	11	0	2120	0	2109	0.0	0.0
chr14	SDR39U1	24442108	24442176	0	69	0	2120	0	2051	0.0	0.0
chr14	STXBP6	25049206	25049876	0	671	360	8079	360	7408	0.0	0.04859611231101512
chr14	AL390334.1	27656337	27656441	0	105	0	1674	0	1569	0.0	0.0
chr14	FOXG1-AS1	28765142	28765158	0	17	0	4513	0	4496	0.0	0.0
chr14	LINC02281	28830073	28830124	0	52	0	431	0	379	0.0	0.0
chr14	AL133166.1	29267599	29267732	0	134	3673	11324	3673	11190	0.0	0.3282394995531725
chr14	AL049830.3	30889119	30889141	0	23	0	2531	0	2508	0.0	0.0
chr14	HECTD1	31122913	31122918	0	6	51545	11639	51545	11633	0.0	4.430929252987192
chr14	HECTD1	31207015	31207389	0	375	51545	11639	51545	11264	0.0	4.576083096590909
chr14	AL139353.1	31457028	31457281	0	254	81517	4448	81517	4194	0.0	19.43657606103958
chr14	EGLN3	33950395	33950676	0	282	0	4709	0	4427	0.0	0.0
chr14	EAPP	34539255	34539553	0	299	0	1953	0	1654	0.0	0.0
chr14	CFL2	34713253	34713506	0	254	0	4948	0	4694	0.0	0.0
chr14	CFL2	34713253	34713395	0	143	0	4948	0	4805	0.0	0.0
chr14	CFL2	34713642	34713672	0	31	0	4948	0	4917	0.0	0.0
chr14	CFL2	34713396	34713506	0	111	0	4948	0	4837	0.0	0.0
chr14	CFL2	34714434	34714536	0	103	0	4948	0	4845	0.0	0.0
chr14	SRP54-AS1	34982423	34982428	0	6	2321	1535	2321	1529	0.0	1.5179856115107915
chr14	PPP2R3C	35109818	35109846	0	29	51580	3757	51580	3728	0.0	13.835836909871245
chr14	PPP2R3C	35108094	35108137	0	44	51580	3757	51580	3713	0.0	13.891731753299219
chr14	RALGAPA1	35688458	35689834	255	1377	8964	14305	8709	12928	0.18518518518518517	0.6736540841584159
chr14	LINC00639	38835541	38838839	0	3299	0	9470	0	6171	0.0	0.0
chr14	TRAPPC6B	39170014	39170016	0	3	0	4538	0	4535	0.0	0.0
chr14	TRAPPC6B	39159449	39159481	0	33	0	4538	0	4505	0.0	0.0
chr14	AL161752.1	44393608	44393616	0	9	0	270	0	261	0.0	0.0
chr14	LINC02277	44478719	44478727	0	9	0	709	0	700	0.0	0.0
chr14	KLHL28	44961596	44961844	0	249	60	7833	60	7584	0.0	0.007911392405063292
chr14	MDGA2	47342941	47343096	0	156	0	8746	0	8590	0.0	0.0
chr14	LINC01588	50005363	50005592	0	230	291360	13032	291360	12802	0.0	22.75894391501328
chr14	LINC01588	49992995	49993001	0	7	291360	13032	291360	13025	0.0	22.36928982725528
chr14	VCPKMT	50116068	50116078	0	11	16721	2061	16721	2050	0.0	8.156585365853658
chr14	MAP4K5	50532399	50532446	0	48	1361	7433	1361	7385	0.0	0.1842924847664184
chr14	NIN	50759856	50759992	867	137	28389	13565	27522	13428	6.328467153284672	2.049597855227882
chr14	NIN	50771315	50771330	0	16	28389	13565	28389	13549	0.0	2.0952837847811647
chr14	ERO1A	52678318	52678432	0	115	60	7564	60	7449	0.0	0.008054772452678213
chr14	FERMT2	52950827	52950919	0	93	0	6261	0	6168	0.0	0.0
chr14	FERMT2	52928019	52928344	0	326	0	6261	0	5935	0.0	0.0
chr14	BMP4	53956549	53956757	0	209	51	2108	51	1899	0.0	0.026856240126382307
chr14	WDHD1	55026710	55027026	0	317	120186	6411	120186	6094	0.0	19.72202166064982
chr14	LINC00520	55796602	55796670	0	69	408	2977	408	2908	0.0	0.14030261348005502
chr14	LINC00520	55793045	55793366	0	322	408	2977	408	2655	0.0	0.1536723163841808
chr14	AL137100.3	56992068	56992198	0	131	16	4378	16	4247	0.0	0.0037673651989639746
chr14	CCDC198	57493492	57493511	0	20	0	4116	0	4096	0.0	0.0
chr14	CCDC198	57490941	57490987	0	47	0	4116	0	4069	0.0	0.0
chr14	SLC35F4	57596686	57596797	0	112	95	4288	95	4176	0.0	0.02274904214559387
chr14	SLC35F4	57595734	57596685	0	952	95	4288	95	3336	0.0	0.028477218225419664
chr14	SLC35F4	57595734	57596797	0	1064	95	4288	95	3224	0.0	0.02946650124069479
chr14	ARMH4	58137989	58138346	0	358	255	4073	255	3715	0.0	0.06864064602960969
chr14	L3HYPDH	59483489	59483678	0	190	0	3501	0	3311	0.0	0.0
chr14	L3HYPDH	59483679	59483807	0	129	0	3501	0	3372	0.0	0.0
chr14	DHRS7	60149352	60149448	0	97	19	3008	19	2911	0.0	0.006526966678117485
chr14	TRMT5	60980962	60981022	0	61	102	5519	102	5458	0.0	0.01868816416269696
chr14	TRMT5	60980843	60980961	0	119	102	5519	102	5400	0.0	0.01888888888888889
chr14	TRMT5	60980843	60981022	0	180	102	5519	102	5339	0.0	0.019104701254916652
chr14	LINC01303	61560742	61565117	1683	4376	1683	5194	0	818	0.3845978062157221	0.0
chr14	PPP2R5E	63382055	63382069	0	15	51	6784	51	6769	0.0	0.007534347761855518
chr14	TEX21P	64353952	64353999	0	48	51	3094	51	3046	0.0	0.01674326986211425
chr14	GPX2	64942504	64942665	0	162	1976	1444	1976	1282	0.0	1.5413416536661466
chr14	RAB15	64950942	64951072	3613	131	33925	4909	30312	4778	27.580152671755727	6.344077019673503
chr14	RAB15	64972694	64972708	90	15	33925	4909	33835	4894	6.0	6.913567633837352
chr14	RAB15	64950578	64950941	10853	364	33925	4909	23072	4545	29.815934065934066	5.076347634763477
chr14	RAB15	64950578	64951072	14466	495	33925	4909	19459	4414	29.224242424242423	4.408473040326235
chr14	MAX	65077327	65077342	0	16	0	5511	0	5495	0.0	0.0
chr14	MAX	65102303	65102507	0	205	0	5511	0	5306	0.0	0.0
chr14	PLEK2	67388218	67388222	0	5	548	1579	548	1574	0.0	0.34815756035578144
chr14	PIGH	67593727	67593741	0	15	0	2424	0	2409	0.0	0.0
chr14	VTI1B	67656411	67656414	0	4	38341	5775	38341	5771	0.0	6.6437359209842315
chr14	RDH11	67692933	67692971	25	39	573	3089	548	3050	0.6410256410256411	0.179672131147541
chr14	ZFYVE26	67782779	67783097	1377	319	101767	15344	100390	15025	4.316614420062696	6.68153078202995
chr14	ZFYVE26	67777513	67777557	0	45	101767	15344	101767	15299	0.0	6.651872671416433
chr14	ZFP36L1	68796042	68796073	0	32	51	4219	51	4187	0.0	0.012180558872701218
chr14	ACTN1	68978176	68978215	0	40	2026	9387	2026	9347	0.0	0.21675403872900395
chr14	ACTN1	68978015	68978175	0	161	2026	9387	2026	9226	0.0	0.21959679167569912
chr14	ACTN1	68978015	68978215	0	201	2026	9387	2026	9186	0.0	0.2205530154583061
chr14	ACTN1	68977949	68978175	0	227	2026	9387	2026	9160	0.0	0.22117903930131005
chr14	ACTN1	68977949	68978215	0	267	2026	9387	2026	9120	0.0	0.22214912280701754
chr14	ACTN1	68977949	68978014	0	66	2026	9387	2026	9321	0.0	0.217358652505096
chr14	DCAF5	69152764	69152942	0	179	5035	8307	5035	8128	0.0	0.6194635826771654
chr14	DCAF5	69152413	69152487	0	75	5035	8307	5035	8232	0.0	0.6116375121477162
chr14	MAP3K9	70739897	70740040	0	144	67417	12402	67417	12258	0.0	5.499836841246533
chr14	ZFYVE1	72986891	72986895	0	5	0	5233	0	5228	0.0	0.0
chr14	AC005280.2	73462528	73462599	450	72	2118	1417	1668	1345	6.25	1.2401486988847583
chr14	ENTPD5	74015823	74015846	0	24	134555	8498	134555	8474	0.0	15.878569742742506
chr14	ALDH6A1	74072202	74072240	50	39	18334	6675	18284	6636	1.2820512820512822	2.7552742616033754
chr14	ABCD4	74288659	74288714	0	56	357	8153	357	8097	0.0	0.04409040385327899
chr14	ABCD4	74297638	74297928	51	291	357	8153	306	7862	0.17525773195876287	0.038921394047316205
chr14	NPC2	74480701	74480709	0	9	1734	2591	1734	2582	0.0	0.6715724244771495
chr14	NPC2	74480685	74480700	0	16	1734	2591	1734	2575	0.0	0.6733980582524272
chr14	NPC2	74480685	74480709	0	25	1734	2591	1734	2566	0.0	0.6757599376461418
chr14	LTBP2	74502563	74502651	0	89	8077	9114	8077	9025	0.0	0.8949584487534626
chr14	AC013451.2	74616572	74616586	0	15	210	704	210	689	0.0	0.3047895500725689
chr14	AREL1	74675698	74675739	0	42	11629	7250	11629	7208	0.0	1.61334628190899
chr14	RPS6KL1	74921977	74922339	51	363	178	4369	127	4006	0.14049586776859505	0.031702446330504244
chr14	RPS6KL1	74907387	74907433	0	47	178	4369	178	4322	0.0	0.04118463674224896
chr14	MLH3	75051379	75051413	0	35	29983	6620	29983	6585	0.0	4.553227031131359
chr14	MLH3	75051379	75051437	0	59	29983	6620	29983	6561	0.0	4.569882639841488
chr14	MLH3	75051414	75051437	0	24	29983	6620	29983	6596	0.0	4.545633717404487
chr14	ACYP1	75063953	75063970	7	18	3447	1809	3440	1791	0.3888888888888889	1.92071468453378
chr14	NEK9	75126702	75126903	318	202	4964	13134	4646	12932	1.5742574257425743	0.35926384163315805
chr14	NEK9	75106465	75106500	0	36	4964	13134	4964	13098	0.0	0.3789891586501756
chr14	NEK9	75086647	75086779	0	133	4964	13134	4964	13001	0.0	0.38181678332435964
chr14	LINC02289	77076104	77076298	0	195	0	3491	0	3296	0.0	0.0
chr14	POMT2	77306336	77306400	0	65	865	7097	865	7032	0.0	0.12300910125142207
chr14	VIPAS39	77457094	77457316	0	223	71	3451	71	3228	0.0	0.021995043370508054
chr14	VIPAS39	77457094	77457493	10	400	71	3451	61	3051	0.025	0.019993444772205833
chr14	VIPAS39	77457317	77457493	10	177	71	3451	61	3274	0.05649717514124294	0.01863164324984728
chr14	ISM2	77498223	77498315	0	93	153	4104	153	4011	0.0	0.0381451009723261
chr14	ISM2	77498316	77498651	0	336	153	4104	153	3768	0.0	0.04060509554140127
chr14	ISM2	77498223	77498651	0	429	153	4104	153	3675	0.0	0.04163265306122449
chr14	LINC02308	81442284	81442364	0	81	0	785	0	704	0.0	0.0
chr14	LINC02305	83914978	83915039	0	62	0	1003	0	941	0.0	0.0
chr14	LINC02316	86061402	86061516	0	115	12	3279	12	3164	0.0	0.0037926675094816687
chr14	PTPN21	88468915	88468985	0	71	6	7692	6	7621	0.0	0.0007872982548222018
chr14	PTPN21	88551235	88551310	0	76	6	7692	6	7616	0.0	0.0007878151260504202
chr14	FOXN3	89190383	89190385	0	3	23	11177	23	11174	0.0	0.002058349740468946
chr14	EFCAB11	89954585	89954731	0	147	1959	7113	1959	6966	0.0	0.28122308354866493
chr14	PPP4R3A	91475810	91475848	0	39	0	5929	0	5890	0.0	0.0
chr14	TC2N	91836182	91836369	0	188	19899	6166	19899	5978	0.0	3.3287052525928402
chr14	ATXN3	92080952	92080963	0	12	153	9265	153	9253	0.0	0.016535177780179402
chr14	LGMN	92718746	92718772	0	27	0	3797	0	3770	0.0	0.0
chr14	LGMN	92712722	92712803	0	82	0	3797	0	3715	0.0	0.0
chr14	LGMN	92741704	92741716	0	13	0	3797	0	3784	0.0	0.0
chr14	GON7	93206829	93206907	0	79	0	1048	0	969	0.0	0.0
chr14	SERPINA6	94313886	94314034	0	149	0	1852	0	1703	0.0	0.0
chr14	SERPINA1	94390419	94390455	0	37	0	4706	0	4669	0.0	0.0
chr14	SERPINA1	94380650	94380869	0	220	0	4706	0	4486	0.0	0.0
chr14	SERPINA1	94388800	94388817	0	18	0	4706	0	4688	0.0	0.0
chr14	DICER1	95157229	95157389	0	161	2499	10278	2499	10117	0.0	0.24700998319659978
chr14	SNHG10	95533692	95534512	0	821	0	4852	0	4031	0.0	0.0
chr14	SNHG10	95533692	95534033	0	342	0	4852	0	4510	0.0	0.0
chr14	SNHG10	95533692	95534591	0	900	0	4852	0	3952	0.0	0.0
chr14	SNHG10	95534513	95534591	0	79	0	4852	0	4773	0.0	0.0
chr14	SNHG10	95534034	95534512	0	479	0	4852	0	4373	0.0	0.0
chr14	SNHG10	95534034	95534591	0	558	0	4852	0	4294	0.0	0.0
chr14	TCL1A	95711748	95711752	0	5	0	1869	0	1864	0.0	0.0
chr14	TCL1A	95712550	95712678	0	129	0	1869	0	1740	0.0	0.0
chr14	AL133167.1	95866029	95866178	0	150	153	1083	153	933	0.0	0.1639871382636656
chr14	WARS1	100375282	100375509	0	228	38826	6022	38826	5794	0.0	6.701070072488782
chr14	DIO3OS	101557648	101557752	0	105	0	4042	0	3937	0.0	0.0
chr14	DIO3OS	101559799	101560250	0	452	0	4042	0	3590	0.0	0.0
chr14	HSP90AA1	102085757	102085963	0	207	51	4954	51	4747	0.0	0.010743627554244786
chr14	MOK	102225094	102225218	0	125	41382	7725	41382	7600	0.0	5.445
chr14	CINP	102355767	102355770	56	4	73937	3837	73881	3833	14.0	19.274980433081137
chr14	ANKRD9	102508640	102508734	6542	95	613613	7211	607071	7116	68.86315789473684	85.31070826306915
chr14	LINC00677	103122608	103122858	0	251	0	586	0	335	0.0	0.0
chr14	CKB	103520468	103520500	0	33	300	2363	300	2330	0.0	0.12875536480686695
chr14	CKB	103522300	103522436	0	137	300	2363	300	2226	0.0	0.1347708894878706
chr14	BAG5	103561912	103562098	0	187	0	5274	0	5087	0.0	0.0
chr14	AKT1	104793126	104794117	0	992	51	7131	51	6139	0.0	0.008307541944942173
chr14	BRF1	105247070	105247286	357	217	432696	12275	432339	12058	1.6451612903225807	35.854951069829156
chr14	BRF1	105246865	105247069	255	205	432696	12275	432441	12070	1.2439024390243902	35.82775476387738
chr14	BRF1	105226102	105226112	0	11	432696	12275	432696	12264	0.0	35.28180039138943
chr14	BRF1	105315321	105315340	0	20	432696	12275	432696	12255	0.0	35.30771113831089
chr14	BRF1	105247287	105248073	4029	787	432696	12275	428667	11488	5.119440914866582	37.31432799442897
chr14	AL928654.1	105418938	105419020	23067	83	222005	2368	198938	2285	277.9156626506024	87.06258205689278
chr15	LINC01193	20940767	20940770	0	4	983	6672	983	6668	0.0	0.14742051589682065
chr15	LINC01193	20981969	20981980	0	12	983	6672	983	6660	0.0	0.1475975975975976
chr15	LINC01193	20979119	20979357	0	239	983	6672	983	6433	0.0	0.1528058448624281
chr15	AC134980.1	21990152	21990390	403	239	444	2337	41	2098	1.6861924686192469	0.019542421353670163
chr15	WHAMMP3	22664961	22665334	0	374	129	5719	129	5345	0.0	0.024134705332086063
chr15	NIPA2	22838922	22838947	21	26	40305	4741	40284	4715	0.8076923076923077	8.543796394485684
chr15	NIPA2	22838948	22839174	67	227	40305	4741	40238	4514	0.29515418502202645	8.914045192733717
chr15	NIPA2	22838922	22839174	88	253	40305	4741	40217	4488	0.34782608695652173	8.961007130124777
chr15	GOLGA8DP	23165866	23165875	0	10	1275	5274	1275	5264	0.0	0.2422112462006079
chr15	MKRN3	23565834	23566087	0	254	204	7026	204	6772	0.0	0.030124040165386886
chr15	MKRN3	23566088	23566709	0	622	204	7026	204	6404	0.0	0.03185509056839475
chr15	MKRN3	23565834	23566709	0	876	204	7026	204	6150	0.0	0.033170731707317075
chr15	PWRN4	23914827	23914915	0	89	42	4181	42	4092	0.0	0.010263929618768328
chr15	PWRN1	24507424	24507478	0	55	51	22178	51	22123	0.0	0.002305293133842607
chr15	PWRN1	24299715	24299769	0	55	51	22178	51	22123	0.0	0.002305293133842607
chr15	PWRN1	24276659	24276710	0	52	51	22178	51	22126	0.0	0.002304980565850131
chr15	PWRN1	24346553	24346586	0	34	51	22178	51	22144	0.0	0.002303106936416185
chr15	PWRN1	24574745	24574813	0	69	51	22178	51	22109	0.0	0.002306752906056357
chr15	SNRPN	24823824	24823850	0	27	0	3407	0	3380	0.0	0.0
chr15	SNRPN	24967153	24967240	0	88	0	3407	0	3319	0.0	0.0
chr15	SNHG14	25042516	25042910	0	395	1162	110104	1162	109709	0.0	0.010591656108432308
chr15	SNHG14	25095729	25095828	0	100	1162	110104	1162	110004	0.0	0.010563252245372896
chr15	SNHG14	25099279	25102147	51	2869	1162	110104	1111	107235	0.017776228651097944	0.01036042336923579
chr15	SNHG14	25101932	25102147	0	216	1162	110104	1162	109888	0.0	0.010574403028538147
chr15	SNHG14	25100891	25102147	0	1257	1162	110104	1162	108847	0.0	0.01067553538453058
chr15	SNHG14	25109100	25109103	0	4	1162	110104	1162	110100	0.0	0.010554041780199818
chr15	SNHG14	25109671	25109715	0	45	1162	110104	1162	110059	0.0	0.010557973450603768
chr15	SNHG14	25053968	25054866	0	899	1162	110104	1162	109205	0.0	0.010640538436884757
chr15	SNHG14	25051677	25052140	0	464	1162	110104	1162	109640	0.0	0.010598321780372127
chr15	SNHG14	25053968	25055230	0	1263	1162	110104	1162	108841	0.0	0.010676123887138119
chr15	SNHG14	25056623	25057088	0	466	1162	110104	1162	109638	0.0	0.0105985151133731
chr15	SNHG14	25093975	25095828	51	1854	1162	110104	1111	108250	0.02750809061488673	0.010263279445727483
chr15	SNHG14	25086465	25086614	0	150	1162	110104	1162	109954	0.0	0.010568055732397184
chr15	SNHG14	25099279	25100290	51	1012	1162	110104	1111	109092	0.05039525691699605	0.010184064826018406
chr15	SNHG14	25099647	25100290	51	644	1162	110104	1111	109460	0.07919254658385093	0.010149826420610268
chr15	SNHG14	25111895	25115656	51	3762	1162	110104	1111	106342	0.013556618819776715	0.010447424347858796
chr15	SNHG14	25234618	25234619	0	2	1162	110104	1162	110102	0.0	0.010553850066302157
chr15	SNHG14	25250812	25250814	0	3	1162	110104	1162	110101	0.0	0.01055394592238036
chr15	SNHG14	25247289	25247289	0	1	1162	110104	1162	110103	0.0	0.01055375421196516
chr15	SNHG14	25266383	25266614	0	232	1162	110104	1162	109872	0.0	0.010575942915392456
chr15	LINC00929	26116285	26116700	0	416	0	3665	0	3249	0.0	0.0
chr15	LINC00929	26116301	26116700	0	400	0	3665	0	3265	0.0	0.0
chr15	LINC00929	26116478	26116700	0	223	0	3665	0	3442	0.0	0.0
chr15	LINC00929	26116285	26116300	0	16	0	3665	0	3649	0.0	0.0
chr15	LINC00929	26116285	26116477	0	193	0	3665	0	3472	0.0	0.0
chr15	LINC00929	26116301	26116477	0	177	0	3665	0	3488	0.0	0.0
chr15	GABRA5	26867385	26867418	0	34	0	3621	0	3587	0.0	0.0
chr15	GOLGA8F	28378681	28378809	48	129	36347	5682	36299	5553	0.37209302325581395	6.53682694039258
chr15	HERC2P9	28641227	28641312	0	86	213	8168	213	8082	0.0	0.02635486265775798
chr15	HERC2P9	28655421	28655691	0	271	213	8168	213	7897	0.0	0.026972267949854373
chr15	WHAMMP2	28741267	28741283	0	17	51	6666	51	6649	0.0	0.007670326364866897
chr15	WHAMMP2	28751675	28751678	0	4	51	6666	51	6662	0.0	0.007655358751125788
chr15	PDCD6IPP2	28801493	28801496	0	4	11729	5256	11729	5252	0.0	2.233244478293983
chr15	APBA2	28921719	28921749	312	31	8992	6889	8680	6858	10.064516129032258	1.2656751239428405
chr15	FAN1	30904591	30905353	0	763	128408	15722	128408	14959	0.0	8.583996256434254
chr15	FAN1	30905354	30905897	0	544	128408	15722	128408	15178	0.0	8.46013967584662
chr15	FAN1	30904591	30905897	0	1307	128408	15722	128408	14415	0.0	8.90794311481096
chr15	FAN1	30903888	30903894	0	7	128408	15722	128408	15715	0.0	8.171046770601336
chr15	FAN1	30904012	30904024	0	13	128408	15722	128408	15709	0.0	8.17416767458145
chr15	FAN1	30903888	30904024	0	137	128408	15722	128408	15585	0.0	8.239204363169714
chr15	FAN1	30903895	30904024	0	130	128408	15722	128408	15592	0.0	8.235505387378142
chr15	FAN1	30903895	30904011	0	117	128408	15722	128408	15605	0.0	8.22864466517142
chr15	CHRNA7	32157772	32157775	0	4	102	13012	102	13008	0.0	0.007841328413284132
chr15	CHRNA7	32030650	32030736	0	87	102	13012	102	12925	0.0	0.007891682785299807
chr15	ARHGAP11A	32629676	32629762	0	87	0	6156	0	6069	0.0	0.0
chr15	ARHGAP11A	32615919	32616340	0	422	0	6156	0	5734	0.0	0.0
chr15	RYR3	33807570	33807800	0	231	14	19804	14	19573	0.0	0.0007152710366320952
chr15	EMC4	34225651	34225658	0	8	102	2766	102	2758	0.0	0.03698332124728064
chr15	DPH6-DT	35711792	35711889	0	98	0	2857	0	2759	0.0	0.0
chr15	TMCO5A	37941731	37941743	0	13	51	4376	51	4363	0.0	0.01168920467568187
chr15	AC109630.1	39479353	39479499	0	147	255	3057	255	2910	0.0	0.08762886597938144
chr15	AC109630.1	39479264	39479352	0	89	255	3057	255	2968	0.0	0.08591644204851752
chr15	AC109630.1	39479264	39479499	0	236	255	3057	255	2821	0.0	0.09039347749025169
chr15	AC109630.1	39473895	39473933	0	39	255	3057	255	3018	0.0	0.08449304174950298
chr15	BUB1B	40170572	40170681	0	110	1491	4281	1491	4171	0.0	0.35746823303764086
chr15	BUB1B	40170122	40170163	0	42	1491	4281	1491	4239	0.0	0.35173389950460016
chr15	PAK6	40239136	40239802	0	667	7840	6404	7840	5737	0.0	1.3665678926268083
chr15	KNSTRN	40387207	40387218	0	12	12011	3389	12011	3377	0.0	3.556707136511697
chr15	IVD	40407726	40407812	0	87	0	6598	0	6511	0.0	0.0
chr15	RPUSD2	40569761	40569943	0	183	21358	2459	21358	2276	0.0	9.384007029876978
chr15	RAD51	40695322	40695425	0	104	7900	2952	7900	2848	0.0	2.773876404494382
chr15	RAD51	40695426	40695860	51	435	7900	2952	7849	2517	0.11724137931034483	3.11839491458085
chr15	RAD51	40695627	40695860	51	234	7900	2952	7849	2718	0.21794871794871795	2.887785136129507
chr15	ZFYVE19	40807822	40807868	0	47	1383	3308	1383	3261	0.0	0.42410303587856485
chr15	ZFYVE19	40807672	40807868	0	197	1383	3308	1383	3111	0.0	0.4445515911282546
chr15	SPINT1	40853882	40853929	0	48	5450	3461	5450	3413	0.0	1.5968356284793437
chr15	SPINT1	40844187	40844278	51	92	5450	3461	5399	3369	0.5543478260869565	1.6025526862570496
chr15	OIP5-AS1	41284111	41284288	0	178	6336	12683	6336	12505	0.0	0.5066773290683727
chr15	NUSAP1	41332996	41333050	0	55	1177	3040	1177	2985	0.0	0.3943048576214405
chr15	AC020659.1	41893079	41895336	51	2258	102	4463	51	2205	0.022586359610274578	0.02312925170068027
chr15	GANC	42273445	42273829	0	385	51	10932	51	10547	0.0	0.004835498245946715
chr15	GANC	42273612	42273829	0	218	51	10932	51	10714	0.0	0.004760126936718312
chr15	GANC	42273445	42273611	0	167	51	10932	51	10765	0.0	0.004737575476079888
chr15	GANC	42273830	42274044	0	215	51	10932	51	10717	0.0	0.004758794438742185
chr15	CAPN3	42402916	42403002	0	87	102	10244	102	10157	0.0	0.010042335335236782
chr15	CAPN3	42410927	42411000	0	74	102	10244	102	10170	0.0	0.010029498525073746
chr15	CAPN3	42404852	42404955	0	104	102	10244	102	10140	0.0	0.010059171597633136
chr15	CAPN3	42408141	42408324	0	184	102	10244	102	10060	0.0	0.010139165009940358
chr15	CAPN3	42404956	42404968	0	13	102	10244	102	10231	0.0	0.00996969993158049
chr15	CAPN3	42404852	42404968	0	117	102	10244	102	10127	0.0	0.010072084526513281
chr15	CAPN3	42404852	42405943	0	1092	102	10244	102	9152	0.0	0.011145104895104896
chr15	CAPN3	42404956	42405943	0	988	102	10244	102	9256	0.0	0.011019878997407088
chr15	CAPN3	42404969	42405943	0	975	102	10244	102	9269	0.0	0.011004423346639335
chr15	CAPN3	42404956	42408324	0	3369	102	10244	102	6875	0.0	0.014836363636363637
chr15	CAPN3	42404969	42408324	0	3356	102	10244	102	6888	0.0	0.014808362369337979
chr15	CAPN3	42404852	42408324	0	3473	102	10244	102	6771	0.0	0.015064244572441293
chr15	CAPN3	42405944	42408324	0	2381	102	10244	102	7863	0.0	0.012972148035101107
chr15	CAPN3	42408325	42408437	0	113	102	10244	102	10131	0.0	0.010068107787977496
chr15	CAPN3	42409996	42410274	0	279	102	10244	102	9965	0.0	0.010235825388861013
chr15	SNAP23	42492946	42492957	0	12	45062	5373	45062	5361	0.0	8.405521357955605
chr15	SNAP23	42495714	42495931	0	218	45062	5373	45062	5155	0.0	8.74141610087294
chr15	STARD9	42585635	42585637	0	3	2895	20421	2895	20418	0.0	0.14178665883044372
chr15	TUBGCP4	43403800	43403842	0	43	117399	9091	117399	9048	0.0	12.975132625994695
chr15	CKMT1B	43593680	43593711	0	32	0	3278	0	3246	0.0	0.0
chr15	SERF2	43792384	43792611	0	228	4444	8388	4444	8160	0.0	0.5446078431372549
chr15	SERF2	43792579	43792611	0	33	4444	8388	4444	8355	0.0	0.5318970676241771
chr15	SERF2	43792384	43792578	0	195	4444	8388	4444	8193	0.0	0.5424142560722568
chr15	WDR76	43827093	43827118	1061	26	36968	4060	35907	4034	40.80769230769231	8.901090728805157
chr15	CTDSPL2	44427693	44427772	0	80	588	9295	588	9215	0.0	0.06380900705371677
chr15	CTDSPL2	44427894	44428005	0	112	588	9295	588	9183	0.0	0.06403136229990199
chr15	CTDSPL2	44427894	44428095	0	202	588	9295	588	9093	0.0	0.06466512702078522
chr15	CTDSPL2	44428006	44428095	0	90	588	9295	588	9205	0.0	0.06387832699619772
chr15	TRIM69	44758804	44758854	0	51	4352	6935	4352	6884	0.0	0.6321905868680999
chr15	TRIM69	44729350	44729552	357	203	4352	6935	3995	6732	1.7586206896551724	0.5934343434343434
chr15	SORD	45068979	45069052	0	74	1632	8966	1632	8892	0.0	0.18353576248313092
chr15	DUOX1	45131648	45131662	1478	15	41934	8173	40456	8158	98.53333333333333	4.959058592792351
chr15	DUOX1	45139169	45139244	0	76	41934	8173	41934	8097	0.0	5.178955168580956
chr15	SPATA5L1	45415780	45415809	0	30	0	3407	0	3377	0.0	0.0
chr15	BLOC1S6	45597892	45597996	0	105	0	6784	0	6679	0.0	0.0
chr15	BLOC1S6	45587797	45587876	0	80	0	6784	0	6704	0.0	0.0
chr15	SQOR	45632016	45632019	0	4	510	2809	510	2805	0.0	0.18181818181818182
chr15	SEMA6D	47768616	47768748	0	133	0	8530	0	8397	0.0	0.0
chr15	SLC12A1	48220758	48220765	0	8	0	8819	0	8811	0.0	0.0
chr15	DUT	48331480	48331795	0	316	0	3152	0	2836	0.0	0.0
chr15	DUT	48331727	48331795	0	69	0	3152	0	3083	0.0	0.0
chr15	DUT	48331480	48331726	0	247	0	3152	0	2905	0.0	0.0
chr15	GALK2	49170359	49170375	17692	17	156067	7192	138375	7175	1040.7058823529412	19.285714285714285
chr15	DTWD1	49621123	49621193	0	71	5908	14874	5908	14803	0.0	0.39910828886036614
chr15	DTWD1	49621123	49621329	102	207	5908	14874	5806	14667	0.4927536231884058	0.3958546396672803
chr15	DTWD1	49621194	49621329	102	136	5908	14874	5806	14738	0.75	0.3939476184014113
chr15	GABPB1-AS1	50355766	50355788	0	23	0	4668	0	4645	0.0	0.0
chr15	GABPB1-AS1	50355546	50355788	0	243	0	4668	0	4425	0.0	0.0
chr15	GABPB1-AS1	50355784	50355788	0	5	0	4668	0	4663	0.0	0.0
chr15	GABPB1-AS1	50355546	50355765	0	220	0	4668	0	4448	0.0	0.0
chr15	GABPB1-AS1	50355766	50355783	0	18	0	4668	0	4650	0.0	0.0
chr15	GABPB1-AS1	50355789	50355932	0	144	0	4668	0	4524	0.0	0.0
chr15	GABPB1-AS1	50355766	50355932	0	167	0	4668	0	4501	0.0	0.0
chr15	GABPB1-AS1	50355784	50355932	0	149	0	4668	0	4519	0.0	0.0
chr15	USP8	50424515	50424654	0	140	51	20665	51	20525	0.0	0.002484774665042631
chr15	USP8	50476994	50476997	0	4	51	20665	51	20661	0.0	0.002468418759982576
chr15	TMOD3	51908863	51908876	0	14	4327	8470	4327	8456	0.0	0.5117076631977294
chr15	PIGB	55350804	55350912	0	109	0	3377	0	3268	0.0	0.0
chr15	TEX9	56365671	56365893	10037	223	26393	8304	16356	8081	45.00896860986547	2.024006929835416
chr15	MINDY2	58810287	58810388	0	102	0	9464	0	9362	0.0	0.0
chr15	MINDY2	58821820	58821823	0	4	0	9464	0	9460	0.0	0.0
chr15	FAM81A	59458618	59458646	34	29	4880	5589	4846	5560	1.1724137931034482	0.8715827338129496
chr15	TLN2	62836074	62836118	0	45	1605	16272	1605	16227	0.0	0.09890922536513219
chr15	TPM1	63064143	63064190	0	48	15989	12357	15989	12309	0.0	1.298968234625071
chr15	TPM1	63064191	63064982	0	792	15989	12357	15989	11565	0.0	1.3825335062689148
chr15	TPM1	63064143	63064982	0	840	15989	12357	15989	11517	0.0	1.3882955630806633
chr15	APH1B	63277737	63277929	0	193	0	5418	0	5225	0.0	0.0
chr15	SNX22	64153340	64153386	0	47	51	4065	51	4018	0.0	0.012692882030861125
chr15	ANKDD1A	64917485	64917514	0	30	6625	5051	6625	5021	0.0	1.3194582752439754
chr15	HACD3	65530644	65530718	0	75	14320	7025	14320	6950	0.0	2.060431654676259
chr15	RAB11A	65792650	65792772	23	123	285083	5691	285060	5568	0.18699186991869918	51.196120689655174
chr15	DIS3L	66293337	66293367	0	31	7	5320	7	5289	0.0	0.0013235016071090943
chr15	DIS3L	66294175	66294448	0	274	7	5320	7	5046	0.0	0.0013872374157748713
chr15	ZWILCH	66518970	66519078	0	109	0	4786	0	4677	0.0	0.0
chr15	SMAD3	67098769	67099024	0	256	7360	7224	7360	6968	0.0	1.0562571756601606
chr15	C15ORF61	67522122	67522204	621	83	81284	4654	80663	4571	7.481927710843373	17.64668562677751
chr15	C15ORF61	67522205	67522242	0	38	81284	4654	81284	4616	0.0	17.609185441941076
chr15	C15ORF61	67522122	67522242	621	121	81284	4654	80663	4533	5.132231404958677	17.794617251268477
chr15	SKOR1	67825626	67825709	0	84	672	3778	672	3694	0.0	0.18191662154845695
chr15	EWSAT1	69092243	69092367	340	125	19156	3583	18816	3458	2.72	5.441295546558704
chr15	PAQR5	69337502	69337505	0	4	51	6270	51	6266	0.0	0.008139163740823492
chr15	KIF23	69426458	69426656	0	199	0	6339	0	6140	0.0	0.0
chr15	DRAIC	69548486	69548631	6167	146	128281	25376	122114	25230	42.23972602739726	4.840031708283789
chr15	DRAIC	69463126	69463285	0	160	128281	25376	128281	25216	0.0	5.087285850253807
chr15	DRAIC	69526358	69526538	21	181	128281	25376	128260	25195	0.11602209944751381	5.090692597737647
chr15	DRAIC	69561781	69562017	9698	237	128281	25376	118583	25139	40.91983122362869	4.717092963125025
chr15	DRAIC	69563805	69564019	8946	215	128281	25376	119335	25161	41.609302325581396	4.742856007312905
chr15	LRRC49	70893641	70893655	0	15	4840	9178	4840	9163	0.0	0.5282112845138055
chr15	LRRC49	70894670	70894755	0	86	4840	9178	4840	9092	0.0	0.5323361196656401
chr15	SENP8	72117063	72117166	1221	104	6645	4933	5424	4829	11.740384615384615	1.1232139159246222
chr15	ARIH1	72580878	72580991	0	114	19942	22087	19942	21973	0.0	0.9075683793746872
chr15	BBS4	72686252	72686564	0	313	51	4162	51	3849	0.0	0.013250194855806703
chr15	CD276	73684408	73684460	0	53	66	5220	66	5167	0.0	0.012773369460034836
chr15	CD276	73684800	73684899	51	100	66	5220	15	5120	0.51	0.0029296875
chr15	LOXL1	73949538	73949574	0	37	0	3644	0	3607	0.0	0.0
chr15	PML	74023366	74023408	0	43	28830	10347	28830	10304	0.0	2.797942546583851
chr15	PML	74033415	74033422	0	8	28830	10347	28830	10339	0.0	2.7884708385723957
chr15	ISLR2	74129957	74129973	0	17	204	5585	204	5568	0.0	0.036637931034482756
chr15	ISLR2	74129957	74130087	0	131	204	5585	204	5454	0.0	0.0374037403740374
chr15	ISLR2	74129974	74130087	0	114	204	5585	204	5471	0.0	0.037287515993419854
chr15	CCDC33	74217434	74217581	0	148	34918	6959	34918	6811	0.0	5.126706797827045
chr15	UBL7-AS1	74462028	74462031	0	4	11586	2142	11586	2138	0.0	5.419083255378859
chr15	UBL7-AS1	74462032	74462098	0	67	11586	2142	11586	2075	0.0	5.583614457831326
chr15	UBL7-AS1	74462028	74462098	0	71	11586	2142	11586	2071	0.0	5.594398841139546
chr15	CLK3	74615050	74615898	0	849	51	14732	51	13883	0.0	0.003673557588417489
chr15	CLK3	74615899	74615949	0	51	51	14732	51	14681	0.0	0.0034738778012396976
chr15	MPI	74891490	74891579	0	90	11714	7175	11714	7085	0.0	1.6533521524347212
chr15	MPI	74890090	74890201	1415	112	11714	7175	10299	7063	12.633928571428571	1.4581622539997168
chr15	MPI	74890090	74890654	9677	565	11714	7175	2037	6610	17.127433628318585	0.3081694402420575
chr15	SCAMP5	74996260	74996320	0	61	8255	4634	8255	4573	0.0	1.8051607260004374
chr15	C15ORF39	75208825	75208876	0	52	23948	5813	23948	5761	0.0	4.156917201874674
chr15	COMMD4	75336093	75336221	90	129	53671	4643	53581	4514	0.6976744186046512	11.869960124058485
chr15	NEIL1	75348000	75348026	0	27	11132	6176	11132	6149	0.0	1.8103756708407872
chr15	NEIL1	75348647	75348723	50	77	11132	6176	11082	6099	0.6493506493506493	1.8170191834727005
chr15	AC019294.2	75758614	75758627	0	14	229473	6185	229473	6171	0.0	37.18570734078755
chr15	TMEM266	76156653	76156758	0	106	46258	5159	46258	5053	0.0	9.154561646546606
chr15	PSTPIP1	77028644	77028652	0	9	208	4597	208	4588	0.0	0.045335658238884045
chr15	PSTPIP1	77032395	77032428	0	34	208	4597	208	4563	0.0	0.045584045584045586
chr15	HMG20A	77458497	77458558	0	62	2599	5473	2599	5411	0.0	0.48031787100351137
chr15	CSPG4P13	77901789	77901804	0	16	0	4825	0	4809	0.0	0.0
chr15	IDH3A	78155252	78155275	0	24	306	5879	306	5855	0.0	0.05226302305721606
chr15	DNAJA4	78274409	78274424	0	16	438	5692	438	5676	0.0	0.07716701902748414
chr15	CRABP1	78341222	78341336	0	115	0	857	0	742	0.0	0.0
chr15	IREB2	78439877	78439881	0	5	1985	8021	1985	8016	0.0	0.24762974051896208
chr15	PSMA4	78540464	78540539	0	76	0	5745	0	5669	0.0	0.0
chr15	CHRNA5	78589850	78590636	3094	787	3900	3367	806	2580	3.9313850063532403	0.3124031007751938
chr15	CHRNA5	78590099	78590636	2403	538	3900	3367	1497	2829	4.466542750929368	0.5291622481442205
chr15	CHRNA5	78590507	78590636	1054	130	3900	3367	2846	3237	8.107692307692307	0.8792091442693852
chr15	CHRNA5	78589850	78590098	691	249	3900	3367	3209	3118	2.7751004016064256	1.0291853752405389
chr15	MORF4L1	78873058	78873118	0	61	17564	6570	17564	6509	0.0	2.6984175756644646
chr15	MORF4L1	78873058	78873218	4885	161	17564	6570	12679	6409	30.341614906832298	1.9783117491028241
chr15	MORF4L1	78873119	78873218	4885	100	17564	6570	12679	6470	48.85	1.959659969088099
chr15	MORF4L1	78873840	78873920	0	81	17564	6570	17564	6489	0.0	2.706734473724765
chr15	ZFAND6	80075243	80075315	0	73	120388	3588	120388	3515	0.0	34.249786628734
chr15	FAH	80152842	80152905	0	64	1716	7210	1716	7146	0.0	0.2401343408900084
chr15	FAH	80180226	80180330	0	105	1716	7210	1716	7105	0.0	0.2415200562983814
chr15	ABHD17C	80749591	80749692	0	102	3111	3627	3111	3525	0.0	0.8825531914893617
chr15	CEMIP	80873637	80873696	1747	60	18923	7651	17176	7591	29.116666666666667	2.2626794888683968
chr15	IL16	81197138	81197152	0	15	47528	11081	47528	11066	0.0	4.294957527561901
chr15	TMC3-AS1	81380255	81380260	0	6	5407	12395	5407	12389	0.0	0.43643554766324966
chr15	SAXO2	82262933	82263188	0	256	0	4166	0	3910	0.0	0.0
chr15	SNHG21	82750715	82750848	0	134	1026	1055	1026	921	0.0	1.1140065146579805
chr15	TM6SF1	83119682	83119734	0	53	6419	2508	6419	2455	0.0	2.614663951120163
chr15	TM6SF1	83107773	83107886	612	114	6419	2508	5807	2394	5.368421052631579	2.4256474519632416
chr15	LINC00933	84572340	84572344	0	5	153	3006	153	3001	0.0	0.050983005664778404
chr15	ZSCAN2	84601136	84601188	0	53	0	4531	0	4478	0.0	0.0
chr15	ZSCAN2	84604201	84604333	0	133	0	4531	0	4398	0.0	0.0
chr15	ZSCAN2	84604331	84604333	0	3	0	4531	0	4528	0.0	0.0
chr15	ZSCAN2	84604201	84604330	0	130	0	4531	0	4401	0.0	0.0
chr15	ZSCAN2	84620773	84622714	0	1942	0	4531	0	2589	0.0	0.0
chr15	SCAND2P	84632299	84632338	0	40	102	9041	102	9001	0.0	0.011332074213976225
chr15	ZNF592	84790873	84790883	0	11	1354	6050	1354	6039	0.0	0.2242093061765193
chr15	AEN	88621383	88621663	102	281	2958	5979	2856	5698	0.36298932384341637	0.5012285012285013
chr15	ACAN	88874025	88874059	0	35	0	10933	0	10898	0.0	0.0
chr15	FANCI	89247727	89247731	0	5	51	11868	51	11863	0.0	0.0042990811767681025
chr15	FANCI	89244034	89244067	0	34	51	11868	51	11834	0.0	0.00430961635964171
chr15	FANCI	89244045	89244067	0	23	51	11868	51	11845	0.0	0.004305614183199662
chr15	FANCI	89244034	89244044	0	11	51	11868	51	11857	0.0	0.0043012566416462845
chr15	FANCI	89244039	89244067	0	29	51	11868	51	11839	0.0	0.004307796266576569
chr15	MIR9-3HG	89362732	89362735	0	4	0	8103	0	8099	0.0	0.0
chr15	MIR9-3HG	89387498	89387538	0	41	0	8103	0	8062	0.0	0.0
chr15	MIR9-3HG	89379270	89379407	0	138	0	8103	0	7965	0.0	0.0
chr15	MIR9-3HG	89382494	89382597	0	104	0	8103	0	7999	0.0	0.0
chr15	MIR9-3HG	89388582	89388746	0	165	0	8103	0	7938	0.0	0.0
chr15	SEMA4B	90217830	90217928	0	99	23624	5402	23624	5303	0.0	4.454836884782199
chr15	SEMA4B	90225398	90225427	1312	30	23624	5402	22312	5372	43.733333333333334	4.153387937453463
chr15	TTLL13P	90263075	90263145	0	71	14	3011	14	2940	0.0	0.004761904761904762
chr15	LINC01585	90660825	90661006	0	182	0	1507	0	1325	0.0	0.0
chr15	FURIN	90880116	90880273	0	158	0	4749	0	4591	0.0	0.0
chr15	FES	90884545	90884639	0	95	3613	4121	3613	4026	0.0	0.8974167908594138
chr15	FES	90885259	90885585	102	327	3613	4121	3511	3794	0.3119266055045872	0.9254085397996837
chr15	MAN2A2	90903433	90903734	357	302	5969	9354	5612	9052	1.1821192052980132	0.6199734865223155
chr15	MAN2A2	90913375	90913406	0	32	5969	9354	5969	9322	0.0	0.6403132375026819
chr15	UNC45A	90935101	90935330	495	230	22716	7365	22221	7135	2.152173913043478	3.114365802382621
chr15	UNC45A	90935331	90935375	0	45	22716	7365	22716	7320	0.0	3.10327868852459
chr15	VPS33B-DT	91023436	91023594	0	159	52642	3435	52642	3276	0.0	16.06898656898657
chr15	C15ORF32	92473073	92473110	0	38	0	1790	0	1752	0.0	0.0
chr15	AC091544.2	92580844	92580895	0	52	0	3868	0	3816	0.0	0.0
chr15	CHD2	92946217	92946340	0	124	53276	16852	53276	16728	0.0	3.1848397895743665
chr15	LINC02207	93844339	93844861	0	523	153	7807	153	7284	0.0	0.021004942339373972
chr15	LINC02207	93844339	93845206	0	868	153	7807	153	6939	0.0	0.02204928664072633
chr15	LINC02207	93858551	93858644	0	94	153	7807	153	7713	0.0	0.019836639439906652
chr15	LINC01580	93899291	93899405	0	115	0	2674	0	2559	0.0	0.0
chr15	LINC01580	93899291	93899603	0	313	0	2674	0	2361	0.0	0.0
chr15	LINC01580	93899406	93899603	0	198	0	2674	0	2476	0.0	0.0
chr15	AC087633.2	95018870	95019043	0	174	64	3304	64	3130	0.0	0.020447284345047924
chr15	NR2F2	96332548	96332621	0	74	0	6481	0	6407	0.0	0.0
chr15	SPATA8	96783590	96783744	7	155	1122	1471	1115	1316	0.04516129032258064	0.8472644376899696
chr15	SPATA8	96783745	96783830	292	86	1122	1471	830	1385	3.395348837209302	0.5992779783393501
chr15	SPATA8	96783590	96783830	299	241	1122	1471	823	1230	1.2406639004149378	0.6691056910569105
chr15	LINC02251	98020537	98020688	0	152	0	2090	0	1938	0.0	0.0
chr15	LUNAR1	99024674	99024787	0	114	0	1690	0	1576	0.0	0.0
chr15	LRRC28	99255974	99256125	0	152	5	6078	5	5926	0.0	0.0008437394532568343
chr15	AC015712.1	100850333	100850468	0	136	0	1487	0	1351	0.0	0.0
chr15	LRRK1	101022479	101022597	0	119	357	17485	357	17366	0.0	0.020557411033053093
chr15	DNM1P47	101751724	101751745	0	22	28545	13739	28545	13717	0.0	2.0809943865276663
chr15	WASH3P	101974085	101974106	0	22	0	2365	0	2343	0.0	0.0
chr15	HERC2P3	20445858	20445883	0	26	3097	9444	3097	9418	0.0	0.3288383945636016
chr15	HERC2P3	20453619	20453704	0	86	3097	9444	3097	9358	0.0	0.330946783500748
chr15	HERC2P3	20443338	20443369	0	32	3097	9444	3097	9412	0.0	0.329048023799405
chr15	HERC2P3	20453612	20453618	0	7	3097	9444	3097	9437	0.0	0.3281763272226343
chr15	CYFIP1	22916476	22916880	0	405	202017	10198	202017	9793	0.0	20.62871438782804
chr15	CYFIP1	22917622	22917786	35	165	202017	10198	201982	10033	0.21212121212121213	20.131765174922755
chr15	UBE3A	25415709	25415713	0	5	0	16169	0	16164	0.0	0.0
chr15	UBE3A	25408571	25408618	0	48	0	16169	0	16121	0.0	0.0
chr15	UBE3A	25438052	25438289	0	238	0	16169	0	15931	0.0	0.0
chr15	OCA2	28099110	28099222	0	113	0	3280	0	3167	0.0	0.0
chr15	GOLGA8G	28532825	28532953	0	129	10739	6365	10739	6236	0.0	1.722097498396408
chr15	TJP1	29704161	29704220	0	60	51	11348	51	11288	0.0	0.004518072289156626
chr15	TJP1	29704161	29704199	0	39	51	11348	51	11309	0.0	0.004509682553718277
chr15	TJP1	29704200	29704220	0	21	51	11348	51	11327	0.0	0.004502516111944911
chr15	CHRFAM7A	30386862	30386882	0	21	123	4049	123	4028	0.0	0.030536246276067526
chr15	TRPM1	31063117	31063134	179	18	57575	7483	57396	7465	9.944444444444445	7.688680509042197
chr15	TRPM1	31063087	31063116	449	30	57575	7483	57126	7453	14.966666666666667	7.664832953173219
chr15	TRPM1	31063087	31063134	628	48	57575	7483	56947	7435	13.083333333333334	7.659314055144587
chr15	ULK4P1	32428190	32428210	0	21	0	1694	0	1673	0.0	0.0
chr15	AC135983.2	32533194	32533210	0	17	0	2691	0	2674	0.0	0.0
chr15	FMN1	33066510	33067792	264	1283	62287	20297	62023	19014	0.20576773187840997	3.2619648679920057
chr15	TMCO5B	33246502	33246567	0	66	0	2056	0	1990	0.0	0.0
chr15	EMC7	34101603	34101763	0	161	108	1458	108	1297	0.0	0.08326908249807248
chr15	SLC12A6	34337331	34337473	0	143	1581	9653	1581	9510	0.0	0.1662460567823344
chr15	SLC12A6	34237389	34237417	0	29	1581	9653	1581	9624	0.0	0.16427680798004987
chr15	GOLGA8A	34407523	34407574	0	52	196693	6731	196693	6679	0.0	29.449468483305886
chr15	GOLGA8B	34527921	34527923	0	3	51197	7660	51197	7657	0.0	6.686300117539506
chr15	ACTC1	34793244	34793296	46	53	988	2299	942	2246	0.8679245283018868	0.41941228851291185
chr15	AQR	34906518	34906543	0	26	2809	13465	2809	13439	0.0	0.20901852816429795
chr15	CSNK1A1P1	36817726	36817934	0	209	0	2589	0	2380	0.0	0.0
chr15	RASGRP1	38564972	38565070	0	99	1173	6027	1173	5928	0.0	0.1978744939271255
chr15	AC013652.1	38886696	38886828	0	133	0	7014	0	6881	0.0	0.0
chr15	BMF	40104179	40104241	0	63	84283	5238	84283	5175	0.0	16.28657004830918
chr15	BMF	40106304	40106356	0	53	84283	5238	84283	5185	0.0	16.255159112825456
chr15	PLCB2	40296745	40296756	0	12	19600	6493	19600	6481	0.0	3.0242246566887827
chr15	CCDC32	40564790	40564974	3087	185	6755	8099	3668	7914	16.686486486486487	0.4634824361890321
chr15	CCDC32	40564765	40564974	4028	210	6755	8099	2727	7889	19.18095238095238	0.3456711877297503
chr15	CCDC32	40564765	40564789	941	25	6755	8099	5814	8074	37.64	0.7200891751300471
chr15	RMDN3	40755082	40755197	2053	116	58227	4467	56174	4351	17.698275862068964	12.910595265456218
chr15	DNAJC17	40779850	40779926	0	77	38598	5641	38598	5564	0.0	6.937095614665708
chr15	DNAJC17	40780092	40780230	0	139	38598	5641	38598	5502	0.0	7.015267175572519
chr15	DNAJC17	40779083	40779221	0	139	38598	5641	38598	5502	0.0	7.015267175572519
chr15	DNAJC17	40774967	40775029	0	63	38598	5641	38598	5578	0.0	6.919684474722122
chr15	NDUFAF1	41402143	41402445	102	303	14506	3613	14404	3310	0.33663366336633666	4.3516616314199394
chr15	NDUFAF1	41402143	41402258	67	116	14506	3613	14439	3497	0.5775862068965517	4.1289676865885045
chr15	NDUFAF1	41394104	41394263	0	160	14506	3613	14506	3453	0.0	4.200984651028092
chr15	LTK	41507513	41507560	0	48	202	3509	202	3461	0.0	0.058364634498699795
chr15	RPAP1	41543912	41544217	0	306	3842	6765	3842	6459	0.0	0.594828920885586
chr15	RPAP1	41543912	41544185	0	274	3842	6765	3842	6491	0.0	0.5918964720382067
chr15	RPAP1	41544186	41544217	0	32	3842	6765	3842	6733	0.0	0.5706223080350512
chr15	AC016134.1	41621088	41621207	0	120	3635	1392	3635	1272	0.0	2.8577044025157234
chr15	AC016134.1	41621066	41621087	0	22	3635	1392	3635	1370	0.0	2.653284671532847
chr15	AC016134.1	41621066	41621207	0	142	3635	1392	3635	1250	0.0	2.908
chr15	AC073657.1	41772430	41772513	20921	84	19308	428	-1613	344	249.0595238095238	-4.688953488372093
chr15	TMEM87A	42272888	42272961	0	74	145172	5620	145172	5546	0.0	26.17598269022719
chr15	ZNF106	42456957	42457215	3817	259	156023	9722	152206	9463	14.737451737451737	16.084328437070695
chr15	LRRC57	42548692	42548698	0	7	5824	7909	5824	7902	0.0	0.7370286003543407
chr15	LRRC57	42548666	42548691	24	26	5824	7909	5800	7883	0.9230769230769231	0.735760497272612
chr15	LRRC57	42548666	42548698	24	33	5824	7909	5800	7876	0.7272727272727273	0.7364144235652615
chr15	CDAN1	42727620	42727666	2202	47	28315	4961	26113	4914	46.851063829787236	5.314000814000814
chr15	CDAN1	42736988	42737011	0	24	28315	4961	28315	4937	0.0	5.73526433056512
chr15	UBR1	43025373	43025379	138	7	47020	9976	46882	9969	19.714285714285715	4.702778613702478
chr15	EPB42	43220725	43220814	0	90	449	2855	449	2765	0.0	0.16238698010849908
chr15	ZSCAN29	43363914	43364124	0	211	3522	6474	3522	6263	0.0	0.562350311352387
chr15	TP53BP1	43420304	43420616	153	313	47370	13009	47217	12696	0.48881789137380194	3.719045368620038
chr15	PPIP5K1	43573356	43573379	0	24	489	7736	489	7712	0.0	0.06340767634854771
chr15	PPIP5K1	43589881	43589900	0	20	489	7736	489	7716	0.0	0.06337480559875583
chr15	STRC	43612790	43612797	0	8	51	6367	51	6359	0.0	0.008020128951092938
chr15	CATSPER2	43648817	43648820	0	4	643	5336	643	5332	0.0	0.12059264816204052
chr15	SERINC4	43797140	43797143	0	4	459	2886	459	2882	0.0	0.159264399722415
chr15	FRMD5	43888808	43888822	225	15	25088	6396	24863	6381	15.0	3.896411220811785
chr15	FRMD5	43885667	43885679	0	13	25088	6396	25088	6383	0.0	3.930440231865894
chr15	EIF3J-DT	44536042	44536799	0	758	0	3200	0	2442	0.0	0.0
chr15	EIF3J-DT	44535759	44536041	0	283	0	3200	0	2917	0.0	0.0
chr15	EIF3J-DT	44535759	44536799	0	1041	0	3200	0	2159	0.0	0.0
chr15	SPG11	44620124	44620188	27	65	17003	11477	16976	11412	0.4153846153846154	1.4875569575885033
chr15	DUOXA1	45129761	45129850	0	90	145775	3541	145775	3451	0.0	42.241379310344826
chr15	DUOXA1	45129761	45129821	0	61	145775	3541	145775	3480	0.0	41.889367816091955
chr15	DUOXA1	45129822	45129850	0	29	145775	3541	145775	3512	0.0	41.507687927107064
chr15	SHF	45172146	45172147	0	2	0	4906	0	4904	0.0	0.0
chr15	GATM	45375650	45376599	0	950	120212	6854	120212	5904	0.0	20.36111111111111
chr15	LINC01491	47804768	47804772	0	5	0	1932	0	1927	0.0	0.0
chr15	LINC01491	47827558	47827569	0	12	0	1932	0	1920	0.0	0.0
chr15	AC066612.1	48190039	48190056	0	18	0	3119	0	3101	0.0	0.0
chr15	FAM227B	49620630	49620698	5864	69	24449	5713	18585	5644	84.98550724637681	3.292877391920624
chr15	GABPB1	50301220	50301255	0	36	102	5585	102	5549	0.0	0.018381690394665706
chr15	CYP19A1	51338436	51338493	0	58	5463	7380	5463	7322	0.0	0.7461076208686152
chr15	BCL2L10	52112167	52112236	0	70	0	1321	0	1251	0.0	0.0
chr15	MYO5C	52260861	52260900	0	40	78500	10094	78500	10054	0.0	7.807837676546648
chr15	ARPP19	52569111	52569114	0	4	0	6840	0	6836	0.0	0.0
chr15	FAM214A	52587055	52587149	0	95	23457	9760	23457	9665	0.0	2.427004655975168
chr15	FAM214A	52678429	52678570	0	142	23457	9760	23457	9618	0.0	2.438864628820961
chr15	FAM214A	52678429	52678702	0	274	23457	9760	23457	9486	0.0	2.4728020240354205
chr15	FAM214A	52678827	52679274	0	448	23457	9760	23457	9312	0.0	2.5190077319587627
chr15	WDR72	53759586	53759631	0	46	0	8513	0	8467	0.0	0.0
chr15	WDR72	53711299	53711334	0	36	0	8513	0	8477	0.0	0.0
chr15	RSL24D1	55192710	55192718	0	9	21	6103	21	6094	0.0	0.0034460124712832295
chr15	RSL24D1	55192402	55192718	0	317	21	6103	21	5786	0.0	0.003629450397511234
chr15	RSL24D1	55192402	55192709	0	308	21	6103	21	5795	0.0	0.00362381363244176
chr15	RAB27A	55270755	55270857	0	103	61	5247	61	5144	0.0	0.011858475894245723
chr15	PIGBOS1	55318863	55318905	0	43	0	947	0	904	0.0	0.0
chr15	PIGBOS1	55318863	55318899	0	37	0	947	0	910	0.0	0.0
chr15	PIGBOS1	55318900	55318905	0	6	0	947	0	941	0.0	0.0
chr15	CCPG1	55359538	55359786	0	249	51	5580	51	5331	0.0	0.009566685424873381
chr15	ZNF280D	56666678	56666798	0	121	2916	10430	2916	10309	0.0	0.2828596372102047
chr15	AC090517.5	56917064	56917145	0	82	51	6477	51	6395	0.0	0.007974980453479281
chr15	SLTM	58893820	58893900	192	81	127912	6192	127720	6111	2.3703703703703702	20.90001636393389
chr15	GTF2A2	59657123	59657404	0	282	4335	2929	4335	2647	0.0	1.6377030600680016
chr15	BNIP2	59678747	59678774	0	28	6688	7747	6688	7719	0.0	0.8664334758388392
chr15	ANXA2	60393012	60393237	0	226	0	11528	0	11302	0.0	0.0
chr15	ANXA2	60393012	60393036	0	25	0	11528	0	11503	0.0	0.0
chr15	ANXA2	60396279	60396371	0	93	0	11528	0	11435	0.0	0.0
chr15	ANXA2	60393037	60393237	0	201	0	11528	0	11327	0.0	0.0
chr15	ANXA2	60396150	60396278	0	129	0	11528	0	11399	0.0	0.0
chr15	ANXA2	60396150	60396371	0	222	0	11528	0	11306	0.0	0.0
chr15	ANXA2	60357138	60357144	0	7	0	11528	0	11521	0.0	0.0
chr15	ANXA2	60397870	60397941	0	72	0	11528	0	11456	0.0	0.0
chr15	ANXA2	60352378	60352381	0	4	0	11528	0	11524	0.0	0.0
chr15	ANXA2	60397254	60397256	0	3	0	11528	0	11525	0.0	0.0
chr15	ANXA2	60360930	60360939	0	10	0	11528	0	11518	0.0	0.0
chr15	ANXA2	60391022	60391106	0	85	0	11528	0	11443	0.0	0.0
chr15	ICE2	60479002	60479070	0	69	102	10708	102	10639	0.0	0.009587367233762571
chr15	VPS13C	61954420	61954465	0	46	40	19787	40	19741	0.0	0.0020262398054809788
chr15	USP3-AS1	63556831	63556892	2735	62	53378	2791	50643	2729	44.11290322580645	18.55734701355808
chr15	USP3-AS1	63599182	63600587	42747	1406	53378	2791	10631	1385	30.403271692745378	7.675812274368231
chr15	USP3-AS1	63599182	63600260	31590	1079	53378	2791	21788	1712	29.27710843373494	12.726635514018692
chr15	USP3-AS1	63600261	63600587	11157	327	53378	2791	42221	2464	34.11926605504587	17.135146103896105
chr15	HERC1	63625941	63625983	0	43	31914	16742	31914	16699	0.0	1.9111324031379124
chr15	HERC1	63833821	63833825	0	5	31914	16742	31914	16737	0.0	1.906793332138376
chr15	DAPK2	63983532	63983623	0	92	18372	11854	18372	11762	0.0	1.5619792552287026
chr15	AC087632.2	64365973	64365984	132	12	108400	3306	108268	3294	11.0	32.868245294474804
chr15	AC087632.2	64373494	64373696	3147	203	108400	3306	105253	3103	15.502463054187192	33.919755075733164
chr15	AC087632.2	64373155	64373696	22183	542	108400	3306	86217	2764	40.928044280442805	31.192836468885673
chr15	AC087632.2	64373155	64373493	19036	339	108400	3306	89364	2967	56.15339233038348	30.119312436804854
chr15	PIF1	64825568	64825591	33	24	173217	3967	173184	3943	1.375	43.92188688815622
chr15	MTFMT	65026817	65026829	0	13	1468	2292	1468	2279	0.0	0.6441421676173761
chr15	CLPX	65158574	65158685	1738	112	9269	5476	7531	5364	15.517857142857142	1.4039895600298284
chr15	CLPX	65156777	65156842	0	66	9269	5476	9269	5410	0.0	1.7133086876155268
chr15	DPP8	65517380	65517484	0	105	115640	9869	115640	9764	0.0	11.843506759524784
chr15	INTS14	65599773	65599836	0	64	1689	4223	1689	4159	0.0	0.40610723731666265
chr15	INTS14	65607158	65607300	0	143	1689	4223	1689	4080	0.0	0.4139705882352941
chr15	INTS14	65610795	65611096	0	302	1689	4223	1689	3921	0.0	0.43075745983167557
chr15	INTS14	65610685	65611096	0	412	1689	4223	1689	3811	0.0	0.4431907635791131
chr15	INTS14	65610685	65610794	0	110	1689	4223	1689	4113	0.0	0.41064916119620715
chr15	DENND4A	65761359	65761365	0	7	21937	7940	21937	7933	0.0	2.765284255640993
chr15	MEGF11	65916597	65916826	2187	230	50288	9387	48101	9157	9.508695652173913	5.25292126242219
chr15	MEGF11	65971165	65971202	0	38	50288	9387	50288	9349	0.0	5.378971012942561
chr15	TIPIN	66386606	66386648	0	43	84	2519	84	2476	0.0	0.033925686591276254
chr15	TIPIN	66386419	66386605	0	187	84	2519	84	2332	0.0	0.036020583190394515
chr15	TIPIN	66386419	66386648	0	230	84	2519	84	2289	0.0	0.03669724770642202
chr15	SNAPC5	66494276	66494413	0	138	0	2480	0	2342	0.0	0.0
chr15	SNAPC5	66494902	66495328	0	427	0	2480	0	2053	0.0	0.0
chr15	SNAPC5	66497489	66497640	0	152	0	2480	0	2328	0.0	0.0
chr15	AAGAB	67254413	67254557	0	145	2079	4153	2079	4008	0.0	0.5187125748502994
chr15	CLN6	68211555	68211673	0	119	51	7108	51	6989	0.0	0.007297181284876234
chr15	CLN6	68211555	68211647	0	93	51	7108	51	7015	0.0	0.007270135424091233
chr15	CLN6	68256689	68256695	0	7	51	7108	51	7101	0.0	0.007182087029995775
chr15	CLN6	68211648	68211673	0	26	51	7108	51	7082	0.0	0.007201355549279864
chr15	ITGA11	68311286	68311288	0	3	634	10898	634	10895	0.0	0.058191831115190454
chr15	TLE3	70057458	70057472	0	15	51	9700	51	9685	0.0	0.0052658750645327825
chr15	TLE3	70058158	70058184	0	27	51	9700	51	9673	0.0	0.005272407732864675
chr15	TLE3	70058149	70058157	0	9	51	9700	51	9691	0.0	0.005262614797234547
chr15	TLE3	70058149	70058184	0	36	51	9700	51	9664	0.0	0.005277317880794702
chr15	TLE3	70074502	70074531	0	30	51	9700	51	9670	0.0	0.005274043433298862
chr15	TLE3	70095389	70095576	0	188	51	9700	51	9512	0.0	0.0053616484440706475
chr15	UACA	70671964	70671969	0	6	51	11017	51	11011	0.0	0.004631731904459177
chr15	THAP10	70891843	70892371	0	529	459	1521	459	992	0.0	0.4627016129032258
chr15	CT62	71113536	71113633	216	98	408	2536	192	2438	2.204081632653061	0.07875307629204266
chr15	CT62	71114923	71115127	0	205	408	2536	408	2331	0.0	0.17503217503217502
chr15	THSD4-AS1	71185404	71185423	0	20	10409	4037	10409	4017	0.0	2.5912372417226788
chr15	MYO9A	71951701	71951775	0	75	15277	14410	15277	14335	0.0	1.0657132891524241
chr15	PKM	72230899	72231114	0	216	2988	7878	2988	7662	0.0	0.3899765074393109
chr15	PKM	72230899	72231322	0	424	2988	7878	2988	7454	0.0	0.4008585994097129
chr15	PKM	72231115	72231322	0	208	2988	7878	2988	7670	0.0	0.38956975228161667
chr15	PKM	72230895	72231114	0	220	2988	7878	2988	7658	0.0	0.39018020370854006
chr15	PKM	72230895	72230898	0	4	2988	7878	2988	7874	0.0	0.3794767589535179
chr15	PKM	72208616	72208619	0	4	2988	7878	2988	7874	0.0	0.3794767589535179
chr15	PKM	72231323	72231597	0	275	2988	7878	2988	7603	0.0	0.39300276206760487
chr15	PARP6	72260477	72260536	0	60	1644	7059	1644	6999	0.0	0.23489069867123874
chr15	PARP6	72265269	72265411	0	143	1644	7059	1644	6916	0.0	0.23770965876229033
chr15	PARP6	72272280	72272391	0	112	1644	7059	1644	6947	0.0	0.2366489131999424
chr15	ADPGK	72783245	72783457	0	213	6103	5311	6103	5098	0.0	1.1971361318163987
chr15	ADPGK	72783245	72783300	0	56	6103	5311	6103	5255	0.0	1.1613701236917222
chr15	ADPGK	72783301	72783457	0	157	6103	5311	6103	5154	0.0	1.1841288319751648
chr15	LOXL1-AS1	73919837	73919958	0	122	9966	4796	9966	4674	0.0	2.1322207958921693
chr15	STOML1	73992090	73992211	0	122	11297	8369	11297	8247	0.0	1.3698314538620104
chr15	STRA6	74202417	74202711	408	295	8425	6568	8017	6273	1.383050847457627	1.278016897816037
chr15	STRA6	74183252	74183854	0	603	8425	6568	8425	5965	0.0	1.4124056999161776
chr15	STRA6	74197519	74197750	0	232	8425	6568	8425	6336	0.0	1.3297032828282829
chr15	UBL7	74460667	74461035	1020	369	2051	1897	1031	1528	2.7642276422764227	0.6747382198952879
chr15	UBL7	74461036	74461106	0	71	2051	1897	2051	1826	0.0	1.1232201533406352
chr15	EDC3	74695369	74695421	0	53	49	5102	49	5049	0.0	0.009704892057833234
chr15	EDC3	74695325	74695421	0	97	49	5102	49	5005	0.0	0.009790209790209791
chr15	EDC3	74695325	74695368	0	44	49	5102	49	5058	0.0	0.009687623566627125
chr15	ULK3	74837750	74837755	0	6	7655	3361	7655	3355	0.0	2.2816691505216093
chr15	ULK3	74842534	74842537	0	4	7655	3361	7655	3357	0.0	2.2803098004170392
chr15	ULK3	74842534	74842544	0	11	7655	3361	7655	3350	0.0	2.2850746268656716
chr15	ULK3	74842538	74842544	0	7	7655	3361	7655	3354	0.0	2.2823494335122243
chr15	FAM219B	74906277	74906322	0	46	969	3076	969	3030	0.0	0.3198019801980198
chr15	FAM219B	74906277	74906585	0	309	969	3076	969	2767	0.0	0.35019877123238163
chr15	DNM1P34	75302443	75302471	5	29	3218	2307	3213	2278	0.1724137931034483	1.4104477611940298
chr15	SIN3A	75451359	75451421	0	63	4904	12419	4904	12356	0.0	0.3968921981223697
chr15	SNUPN	75625335	75625664	0	330	51	3528	51	3198	0.0	0.01594746716697936
chr15	NRG4	76012301	76012317	0	17	15022	3050	15022	3033	0.0	4.952851961754039
chr15	SCAPER	76771723	76771740	0	18	411	11270	411	11252	0.0	0.03652683967294703
chr15	SCAPER	76795240	76795278	0	39	411	11270	411	11231	0.0	0.03659513845605912
chr15	TSPAN3	77070891	77071003	0	113	620	6899	620	6786	0.0	0.09136457412319482
chr15	LINGO1	77820786	77820841	0	56	1020	5340	1020	5284	0.0	0.19303557910673733
chr15	WDR61	78299455	78299560	0	106	31328	5010	31328	4904	0.0	6.388254486133769
chr15	CHRNB4	78630927	78631074	0	148	0	5003	0	4855	0.0	0.0
chr15	CTSH	78931868	78931899	0	32	136	11133	136	11101	0.0	0.01225114854517611
chr15	CTSH	78932582	78934976	0	2395	136	11133	136	8738	0.0	0.01556420233463035
chr15	CTSH	78932582	78933729	0	1148	136	11133	136	9985	0.0	0.013620430645968953
chr15	CTSH	78932582	78934813	0	2232	136	11133	136	8901	0.0	0.015279182114369173
chr15	CTSH	78933730	78934976	0	1247	136	11133	136	9886	0.0	0.01375682783734574
chr15	CTSH	78933730	78934813	0	1084	136	11133	136	10049	0.0	0.0135336849437755
chr15	CTSH	78944777	78944889	0	113	136	11133	136	11020	0.0	0.012341197822141561
chr15	CTSH	78926562	78927711	0	1150	136	11133	136	9983	0.0	0.013623159370930582
chr15	CTSH	78926562	78926780	0	219	136	11133	136	10914	0.0	0.012461059190031152
chr15	CTSH	78926562	78927366	0	805	136	11133	136	10328	0.0	0.013168086754453912
chr15	CTSH	78932371	78934976	0	2606	136	11133	136	8527	0.0	0.01594933739885071
chr15	CTSH	78932275	78932370	0	96	136	11133	136	11037	0.0	0.01232218900063423
chr15	CTSH	78934814	78934976	0	163	136	11133	136	10970	0.0	0.012397447584320875
chr15	CTSH	78926174	78927711	0	1538	136	11133	136	9595	0.0	0.014174048983845753
chr15	CTSH	78926174	78926780	0	607	136	11133	136	10526	0.0	0.012920387611628349
chr15	CTSH	78926174	78926561	0	388	136	11133	136	10745	0.0	0.01265704979060028
chr15	CTSH	78926174	78927366	0	1193	136	11133	136	9940	0.0	0.013682092555331992
chr15	RASGRF1	79006176	79006184	0	9	531	9181	531	9172	0.0	0.05789358918447449
chr15	ANKRD34C-AS1	79260224	79260227	0	4	762076	10687	762076	10683	0.0	71.33539267995882
chr15	MTHFS	79896790	79896870	0	81	0	1423	0	1342	0.0	0.0
chr15	AC016705.2	80347687	80347697	0	11	12418	8076	12418	8065	0.0	1.5397396156230627
chr15	MESD	80978765	80978929	0	165	0	4448	0	4283	0.0	0.0
chr15	STARD5	81323801	81323999	816	199	4437	5447	3621	5248	4.100502512562814	0.6899771341463414
chr15	GOLGA2P10	82513665	82513714	0	50	94	1291	94	1241	0.0	0.0757453666398066
chr15	GOLGA2P10	82477393	82477479	0	87	94	1291	94	1204	0.0	0.07807308970099668
chr15	CPEB1	82553451	82553465	0	15	9896	8139	9896	8124	0.0	1.2181191531265387
chr15	CPEB1	82628137	82628362	0	226	9896	8139	9896	7913	0.0	1.2506002780235057
chr15	CPEB1	82647136	82647207	0	72	9896	8139	9896	8067	0.0	1.2267261683401511
chr15	AP3B2	82688987	82689156	255	170	1015751	8150	1015496	7980	1.5	127.25513784461153
chr15	AC105339.1	82711560	82711674	255	115	5901	1228	5646	1113	2.217391304347826	5.07277628032345
chr15	HOMER2	82985786	82986078	203	293	203	13758	0	13465	0.6928327645051194	0.0
chr15	C15ORF40	83011485	83011495	32	11	4452	2219	4420	2208	2.909090909090909	2.0018115942028984
chr15	C15ORF40	82991931	82991954	0	24	4452	2219	4452	2195	0.0	2.028246013667426
chr15	AC024270.4	83106629	83106711	704	83	6565	2477	5861	2394	8.481927710843374	2.448203842940685
chr15	GOLGA2P7	84229851	84229900	0	50	0	3261	0	3211	0.0	0.0
chr15	UBE2Q2P1	84554960	84554964	0	5	150	2432	150	2427	0.0	0.06180469715698393
chr15	UBE2Q2P1	84542144	84542145	0	2	150	2432	150	2430	0.0	0.06172839506172839
chr15	UBE2Q2P1	84570486	84570597	0	112	150	2432	150	2320	0.0	0.06465517241379311
chr15	WDR73	84653631	84653698	0	68	51	8315	51	8247	0.0	0.0061840669334303384
chr15	AC044860.1	85234478	85234527	450	50	140103	2932	139653	2882	9.0	48.45697432338654
chr15	LINC01584	86116580	86116613	0	34	199	3080	199	3046	0.0	0.06533158240315168
chr15	DET1	88531608	88531611	0	4	40	4789	40	4785	0.0	0.008359456635318705
chr15	RLBP1	89219736	89219794	0	59	0	1857	0	1798	0.0	0.0
chr15	POLG	89325449	89325488	0	40	29	6927	29	6887	0.0	0.004210832002323217
chr15	POLG	89334672	89334683	0	12	29	6927	29	6915	0.0	0.004193781634128706
chr15	RHCG	89472710	89472720	0	11	0	2548	0	2537	0.0	0.0
chr15	LINC00928	89517283	89517400	0	118	0	2562	0	2444	0.0	0.0
chr15	PLIN1	89679250	89679320	0	71	0	3804	0	3733	0.0	0.0
chr15	MESP1	89750508	89751022	0	515	612	1856	612	1341	0.0	0.4563758389261745
chr15	ANPEP	89803611	89803645	0	35	34696	5070	34696	5035	0.0	6.890963257199603
chr15	ANPEP	89804945	89805076	4586	132	34696	5070	30110	4938	34.74242424242424	6.097610368570272
chr15	AP3S2	89893876	89893879	0	4	27629	3566	27629	3562	0.0	7.756597417181359
chr15	CIB1	90233834	90233917	114	84	1470	1480	1356	1396	1.3571428571428572	0.9713467048710601
chr15	HDDC3	90932385	90932427	446	43	12886	2622	12440	2579	10.372093023255815	4.823575029081039
chr15	PRC1	90969446	90969522	2032	77	15855	5528	13823	5451	26.38961038961039	2.5358649789029535
chr15	LINC00930	92571185	92571199	0	15	51	4167	51	4152	0.0	0.012283236994219654
chr15	AC091544.4	92596055	92596300	51	246	51	2472	0	2226	0.2073170731707317	0.0
chr15	FAM174B	92655130	92655314	0	185	325	4298	325	4113	0.0	0.07901774860199368
chr15	RGMA	93073563	93073582	0	20	109	12942	109	12922	0.0	0.0084352267450859
chr15	RGMA	93088280	93088397	0	118	109	12942	109	12824	0.0	0.008499688084840923
chr15	RGMA	93065831	93066099	0	269	109	12942	109	12673	0.0	0.008600962676556459
chr15	LINC01579	93900035	93900349	0	315	0	9355	0	9040	0.0	0.0
chr15	LINC01579	93900350	93900467	0	118	0	9355	0	9237	0.0	0.0
chr15	AC027013.1	95469744	95469782	0	39	0	1510	0	1471	0.0	0.0
chr15	LINC02254	97427650	97427841	0	192	0	5214	0	5022	0.0	0.0
chr15	LINC01582	98088697	98088737	0	41	0	2922	0	2881	0.0	0.0
chr15	LINC01582	98088505	98088737	0	233	0	2922	0	2689	0.0	0.0
chr15	LINC01582	98088505	98088696	0	192	0	2922	0	2730	0.0	0.0
chr15	TTC23	99249170	99249415	0	246	1481	5136	1481	4890	0.0	0.3028629856850716
chr15	TTC23	99249170	99249620	0	451	1481	5136	1481	4685	0.0	0.31611526147278546
chr15	DNM1P46	99800974	99801040	0	67	276836	3985	276836	3918	0.0	70.65747830525778
chr15	DNM1P46	99804799	99804803	0	5	276836	3985	276836	3980	0.0	69.55678391959799
chr15	SPATA41	100346523	100348732	12188	2210	1134	3001	-11054	791	5.5149321266968325	-13.97471554993679
chr15	SPATA41	100346523	100349306	12240	2784	1134	3001	-11106	217	4.396551724137931	-51.17972350230415
chr15	SPATA41	100348733	100349306	52	574	1134	3001	1082	2427	0.09059233449477352	0.4458178821590441
chr15	CERS3	100544123	100544214	0	92	227	5147	227	5055	0.0	0.04490603363006924
chr15	LINS1	100580443	100580799	0	357	102	7512	102	7155	0.0	0.014255765199161425
chr15	LINS1	100602116	100602119	0	4	102	7512	102	7508	0.0	0.013585508790623336
chr15	SELENOS	101277091	101277279	0	189	0	3069	0	2880	0.0	0.0
chr15	PCSK6	101318184	101318317	0	134	16240	16686	16240	16552	0.0	0.9811503141614306
chr15	TM2D3	101651695	101652269	0	575	1122	11588	1122	11013	0.0	0.10187959684009806
chr15	TM2D3	101651695	101651826	0	132	1122	11588	1122	11456	0.0	0.09793994413407821
chr15	TM2D3	101651827	101652269	0	443	1122	11588	1122	11145	0.0	0.10067294751009422
chr16	SNRNP25	55543	55549	0	7	0	1293	0	1286	0.0	0.0
chr16	HBA2	172959	173007	0	49	2042	815	2042	766	0.0	2.6657963446475197
chr16	HBA1	176763	176811	0	49	1811	813	1811	764	0.0	2.3704188481675392
chr16	FAM234A	249655	249658	0	4	45819	5109	45819	5105	0.0	8.97531831537708
chr16	ARHGDIG	282356	282373	0	18	22352	1855	22352	1837	0.0	12.167664670658683
chr16	PDIA2	285434	285437	200	4	8313	1999	8113	1995	50.0	4.066666666666666
chr16	NME4	398386	398394	0	9	47153	3175	47153	3166	0.0	14.893556538218572
chr16	NME4	397903	398179	68	277	47153	3175	47085	2898	0.24548736462093862	16.247412008281575
chr16	DECR2	410754	410784	0	31	459	2636	459	2605	0.0	0.17619961612284069
chr16	DECR2	406362	406397	0	36	459	2636	459	2600	0.0	0.17653846153846153
chr16	DECR2	407561	407580	0	20	459	2636	459	2616	0.0	0.17545871559633028
chr16	DECR2	406778	406952	0	175	459	2636	459	2461	0.0	0.18650954896383584
chr16	DECR2	406890	406952	0	63	459	2636	459	2573	0.0	0.17839098328799066
chr16	DECR2	410368	410404	0	37	459	2636	459	2599	0.0	0.17660638707195075
chr16	RAB11FIP3	475046	475098	0	53	113579	6050	113579	5997	0.0	18.939302984825748
chr16	PIGQ	574439	574763	443	325	22332	6456	21889	6131	1.363076923076923	3.570216930353939
chr16	PIGQ	575971	576002	51	32	22332	6456	22281	6424	1.59375	3.4683997509339974
chr16	PIGQ	578463	578505	93	43	22332	6456	22239	6413	2.1627906976744184	3.467799781693435
chr16	WDR90	658615	658653	498	39	31625	10446	31127	10407	12.76923076923077	2.9909676179494573
chr16	WDR90	655886	655889	40	4	31625	10446	31585	10442	10.0	3.024803677456426
chr16	RHOT2	668155	668236	1567	82	11678	4192	10111	4110	19.109756097560975	2.4600973236009733
chr16	ANTKMT	722084	722134	26943	51	233021	1398	206078	1347	528.2941176470588	152.9903489235338
chr16	HAGHL	727141	727175	0	35	218775	4949	218775	4914	0.0	44.520757020757024
chr16	CHTF18	788757	788775	37	19	11477	4621	11440	4602	1.9473684210526316	2.4858757062146895
chr16	CHTF18	792348	792367	340	20	11477	4621	11137	4601	17.0	2.4205607476635516
chr16	CACNA1H	1201836	1202452	0	617	0	8655	0	8038	0.0	0.0
chr16	CACNA1H	1209413	1209462	0	50	0	8655	0	8605	0.0	0.0
chr16	CACNA1H	1212139	1212171	0	33	0	8655	0	8622	0.0	0.0
chr16	UBE2I	1309272	1309419	0	148	0	8510	0	8362	0.0	0.0
chr16	UBE2I	1312559	1312603	0	45	0	8510	0	8465	0.0	0.0
chr16	UBE2I	1312604	1312667	0	64	0	8510	0	8446	0.0	0.0
chr16	UBE2I	1312559	1312667	0	109	0	8510	0	8401	0.0	0.0
chr16	CRAMP1	1612423	1612657	0	235	26493	8617	26493	8382	0.0	3.1607015032211883
chr16	CRAMP1	1668185	1668193	0	9	26493	8617	26493	8608	0.0	3.077718401486989
chr16	JPT2	1678322	1678356	0	35	9604	3868	9604	3833	0.0	2.5056091834072527
chr16	JPT2	1683593	1683620	0	28	9604	3868	9604	3840	0.0	2.5010416666666666
chr16	JPT2	1680499	1680587	0	89	9604	3868	9604	3779	0.0	2.5414130722413337
chr16	MAPK8IP3	1761279	1761305	0	27	14390	7888	14390	7861	0.0	1.8305559089174406
chr16	NUBP2	1783037	1783506	403	470	14368	3124	13965	2654	0.8574468085106383	5.261868877166541
chr16	NDUFB10	1961259	1961291	0	33	0	679	0	646	0.0	0.0
chr16	NDUFB10	1961612	1961636	0	25	0	679	0	654	0.0	0.0
chr16	TBL3	1976258	1976314	0	57	486	6954	486	6897	0.0	0.0704654197477164
chr16	SLC9A3R2	2033427	2033432	0	6	127544	3115	127544	3109	0.0	41.024123512383404
chr16	TSC2	2084703	2084715	12	13	112940	14665	112928	14652	0.9230769230769231	7.707343707343707
chr16	TSC2	2082501	2082504	0	4	112940	14665	112940	14661	0.0	7.703430871018348
chr16	TSC2	2053453	2053542	0	90	112940	14665	112940	14575	0.0	7.748885077186964
chr16	TSC2	2076171	2076257	0	87	112940	14665	112940	14578	0.0	7.747290437645767
chr16	TSC2	2082505	2082558	0	54	112940	14665	112940	14611	0.0	7.729792621997126
chr16	TSC2	2082501	2082558	0	58	112940	14665	112940	14607	0.0	7.7319093585267336
chr16	TSC2	2082505	2082594	14	90	112940	14665	112926	14575	0.15555555555555556	7.747924528301887
chr16	TSC2	2082501	2082594	14	94	112940	14665	112926	14571	0.14893617021276595	7.750051472102121
chr16	TSC2	2082559	2082594	14	36	112940	14665	112926	14629	0.3888888888888889	7.719324629161255
chr16	AC009065.2	2091609	2091614	6	6	15821	592	15815	586	1.0	26.988054607508534
chr16	MLST8	2204683	2204858	3441	176	52567	3668	49126	3492	19.551136363636363	14.06815578465063
chr16	E4F1	2234950	2235001	0	52	24902	5540	24902	5488	0.0	4.537536443148688
chr16	E4F1	2223771	2223929	14752	159	24902	5540	10150	5381	92.77987421383648	1.8862664932168742
chr16	ABCA17P	2425050	2425086	0	37	1484	6345	1484	6308	0.0	0.2352568167406468
chr16	TEDC2	2460171	2460381	0	211	231	2854	231	2643	0.0	0.08740068104426787
chr16	ATP6V0C	2514130	2514182	3899	53	6191	1396	2292	1343	73.56603773584905	1.7066269545793
chr16	AMDHD2	2528560	2528718	140	159	8096	3044	7956	2885	0.8805031446540881	2.7577123050259966
chr16	SRRM2	2752847	2752854	0	8	122789	11355	122789	11347	0.0	10.82127434564202
chr16	PRSS21	2821068	2821109	250	42	595735	1973	595485	1931	5.9523809523809526	308.3816675297773
chr16	FLYWCH2	2883273	2883366	0	94	51	1343	51	1249	0.0	0.04083266613290633
chr16	PAQR4	2969444	2969840	51	397	1938	2874	1887	2477	0.12846347607052896	0.7618086394832458
chr16	TNFRSF12A	3020492	3020759	2243	268	146947	1406	144704	1138	8.369402985074627	127.15641476274165
chr16	MMP25	3050546	3050546	0	1	13979	4257	13979	4256	0.0	3.2845394736842106
chr16	IL32	3067416	3067613	0	198	459	2993	459	2795	0.0	0.16422182468694096
chr16	IL32	3065495	3065826	0	332	459	2993	459	2661	0.0	0.17249154453213078
chr16	IL32	3065656	3065687	0	32	459	2993	459	2961	0.0	0.15501519756838905
chr16	IL32	3065688	3065710	0	23	459	2993	459	2970	0.0	0.15454545454545454
chr16	IL32	3065656	3065710	0	55	459	2993	459	2938	0.0	0.1562287270251872
chr16	ZNF205	3112683	3112950	0	268	9357	2337	9357	2069	0.0	4.52247462542291
chr16	ZNF213	3135388	3135445	0	58	51	3717	51	3659	0.0	0.013938234490297895
chr16	NAA60	3443828	3443837	0	10	23096	6190	23096	6180	0.0	3.737216828478964
chr16	NAA60	3443828	3443893	0	66	23096	6190	23096	6124	0.0	3.7713912475506204
chr16	NAA60	3443838	3443893	0	56	23096	6190	23096	6134	0.0	3.765242908379524
chr16	NAA60	3485062	3485083	0	22	23096	6190	23096	6168	0.0	3.7444876783398184
chr16	DNASE1	3655938	3655966	0	29	86877	8622	86877	8593	0.0	10.11020598161294
chr16	HMOX2	4483739	4483754	13	16	51530	3349	51517	3333	0.8125	15.456645664566457
chr16	HMOX2	4476418	4476665	5754	248	51530	3349	45776	3101	23.201612903225808	14.761689777491132
chr16	HMOX2	4476488	4476665	4121	178	51530	3349	47409	3171	23.151685393258425	14.950804162724692
chr16	HMOX2	4476418	4476487	1633	70	51530	3349	49897	3279	23.32857142857143	15.217139371759682
chr16	NUDT16L1	4694239	4694308	0	70	0	1422	0	1352	0.0	0.0
chr16	C16ORF71	4737947	4737988	337	42	107198	3600	106861	3558	8.023809523809524	30.034007869589658
chr16	C16ORF71	4746513	4746521	25	9	107198	3600	107173	3591	2.7777777777777777	29.84489000278474
chr16	SMIM22	4796034	4796048	0	15	102	1629	102	1614	0.0	0.06319702602230483
chr16	UBN1	4848211	4848393	0	183	107762	7647	107762	7464	0.0	14.437566988210076
chr16	UBN1	4860954	4861102	0	149	107762	7647	107762	7498	0.0	14.372099226460389
chr16	ALG1	5072058	5072213	0	156	21406	5368	21406	5212	0.0	4.107060629316961
chr16	ALG1	5072214	5072318	0	105	21406	5368	21406	5263	0.0	4.067262017860536
chr16	ALG1	5072304	5072318	0	15	21406	5368	21406	5353	0.0	3.9988791331963385
chr16	AC074051.3	5107768	5107850	0	83	0	1934	0	1851	0.0	0.0
chr16	RBFOX1	6019902	6019992	0	91	51	14371	51	14280	0.0	0.0035714285714285713
chr16	METTL22	8623896	8624118	0	223	108	7747	108	7524	0.0	0.014354066985645933
chr16	ABAT	8713866	8713879	0	14	65715	9737	65715	9723	0.0	6.758716445541499
chr16	LITAFD	8882511	8882790	0	280	51	1632	51	1352	0.0	0.03772189349112426
chr16	AC012178.1	9467011	9467028	0	18	0	4432	0	4414	0.0	0.0
chr16	AC012178.1	9490098	9490425	0	328	0	4432	0	4104	0.0	0.0
chr16	ATF7IP2	10387485	10387494	0	10	51	5287	51	5277	0.0	0.009664582148948267
chr16	CIITA	10866320	10866572	0	253	51	11180	51	10927	0.0	0.00466733778713279
chr16	CLEC16A	11003258	11003305	0	48	13299	11576	13299	11528	0.0	1.1536259541984732
chr16	RMI2	11345544	11345766	148	223	204	3308	56	3085	0.6636771300448431	0.01815235008103728
chr16	U91319.1	13350422	13350616	0	195	561	3219	561	3024	0.0	0.18551587301587302
chr16	ERCC4	13932286	13932404	0	119	89	8348	89	8229	0.0	0.010815408919674323
chr16	MRTFB	14247358	14247507	69	150	1492	15184	1423	15034	0.46	0.09465212185712385
chr16	MIR193BHG	14302537	14302597	0	61	3194	6057	3194	5996	0.0	0.5326884589726484
chr16	MIR193BHG	14322544	14322547	0	4	3194	6057	3194	6053	0.0	0.527672228646952
chr16	MIR193BHG	14322544	14322550	0	7	3194	6057	3194	6050	0.0	0.5279338842975206
chr16	MIR193BHG	14322548	14322550	0	3	3194	6057	3194	6054	0.0	0.527585067723819
chr16	MIR193BHG	14322548	14322554	0	7	3194	6057	3194	6050	0.0	0.5279338842975206
chr16	MIR193BHG	14322544	14322554	0	11	3194	6057	3194	6046	0.0	0.5282831624214357
chr16	NOMO1	14895642	14895694	0	53	9750	5532	9750	5479	0.0	1.7795218105493704
chr16	NPIPA1	14929422	14930031	918	610	36362	7367	35444	6757	1.5049180327868852	5.245523161166198
chr16	PDXDC1	14974805	14974973	52	169	88641	9435	88589	9266	0.3076923076923077	9.560651845456508
chr16	PDXDC1	15001857	15001887	0	31	88641	9435	88641	9404	0.0	9.425882603147597
chr16	NDE1	15725120	15727000	4336	1881	11014	8104	6678	6223	2.3051568314726207	1.0731158605174353
chr16	NOMO3	16294296	16294348	0	53	24287	10120	24287	10067	0.0	2.4125360087414323
chr16	NOMO3	16265180	16265271	0	92	24287	10120	24287	10028	0.0	2.421918627842042
chr16	PKD1P1	16328199	16328516	1124	318	30927	6837	29803	6519	3.5345911949685536	4.571713452983587
chr16	ABCC6P1	18571305	18571311	0	7	40199	3328	40199	3321	0.0	12.10448660042156
chr16	TMC7	19035811	19035823	0	13	4818	5656	4818	5643	0.0	0.8538011695906432
chr16	COQ7	19074036	19074097	1259	62	6999	3599	5740	3537	20.306451612903224	1.6228442182640657
chr16	COQ7	19068009	19068230	0	222	6999	3599	6999	3377	0.0	2.0725496002368966
chr16	COQ7	19068009	19068878	0	870	6999	3599	6999	2729	0.0	2.5646757053865885
chr16	COQ7	19068231	19068878	0	648	6999	3599	6999	2951	0.0	2.3717383937648253
chr16	TMC5	19410541	19410773	0	233	2294	6198	2294	5965	0.0	0.3845766974015088
chr16	TMC5	19410774	19411176	0	403	2294	6198	2294	5795	0.0	0.3958584987057808
chr16	TMC5	19456746	19457016	0	271	2294	6198	2294	5927	0.0	0.3870423485743209
chr16	VPS35L	19581654	19581654	0	1	31992	9805	31992	9804	0.0	3.263157894736842
chr16	REXO5	20806491	20806721	0	231	24784	3857	24784	3626	0.0	6.835079977937121
chr16	REXO5	20806706	20806721	0	16	24784	3857	24784	3841	0.0	6.452486331684457
chr16	REXO5	20806722	20806735	0	14	24784	3857	24784	3843	0.0	6.449128285193859
chr16	REXO5	20806706	20806735	0	30	24784	3857	24784	3827	0.0	6.476090932845571
chr16	REXO5	20806722	20806817	0	96	24784	3857	24784	3761	0.0	6.589736772135071
chr16	REXO5	20806706	20806817	0	112	24784	3857	24784	3745	0.0	6.617890520694259
chr16	REXO5	20806736	20806817	0	82	24784	3857	24784	3775	0.0	6.565298013245033
chr16	REXO5	20806722	20807091	612	370	24784	3857	24172	3487	1.654054054054054	6.932033266418125
chr16	LYRM1	20920607	20920674	0	68	3501	3603	3501	3535	0.0	0.9903818953323904
chr16	CRYM-AS1	21301328	21301335	0	8	3261	2720	3261	2712	0.0	1.2024336283185841
chr16	METTL9	21599829	21599898	0	70	1836	3443	1836	3373	0.0	0.5443225615179366
chr16	OTOA	21701028	21701069	0	42	162	7574	162	7532	0.0	0.021508231545406268
chr16	EEF2K	22258696	22258827	57	132	17891	5214	17834	5082	0.4318181818181818	3.5092483274301456
chr16	NPIPB5	22513601	22513610	363	10	106344	8940	105981	8930	36.3	11.867973124300113
chr16	NPIPB5	22513522	22513600	1115	79	106344	8940	105229	8861	14.113924050632912	11.875521950118497
chr16	NPIPB5	22519270	22519414	6131	145	106344	8940	100213	8795	42.282758620689656	11.394314951677089
chr16	NPIPB5	22527643	22527665	432	23	106344	8940	105912	8917	18.782608695652176	11.87753728832567
chr16	UBFD1	23557746	23557767	0	22	186275	7830	186275	7808	0.0	23.856941598360656
chr16	PLK1	23679341	23679500	49845	160	412586	3134	362741	2974	311.53125	121.97074646940148
chr16	SLC5A11	24846013	24846084	0	72	612	3411	612	3339	0.0	0.18328840970350405
chr16	LINC02175	25067647	25067660	0	14	3343	5566	3343	5552	0.0	0.6021253602305475
chr16	LINC02175	25076184	25076274	0	91	3343	5566	3343	5475	0.0	0.610593607305936
chr16	LCMT1	25170798	25170805	0	8	23015	2603	23015	2595	0.0	8.86897880539499
chr16	LCMT1	25111769	25111996	0	228	23015	2603	23015	2375	0.0	9.690526315789473
chr16	LCMT1	25128567	25128570	0	4	23015	2603	23015	2599	0.0	8.8553289726818
chr16	KDM8	27219047	27219110	0	64	10101	3982	10101	3918	0.0	2.5781010719754978
chr16	KDM8	27204165	27204175	0	11	10101	3982	10101	3971	0.0	2.5436917652984135
chr16	IL4R	27314021	27314231	0	211	28368	5144	28368	4933	0.0	5.750658828299209
chr16	EIF3C	28711519	28711567	720	49	783933	4992	783213	4943	14.693877551020408	158.44891766133927
chr16	ATXN2L	28836123	28836176	238	54	110970	6097	110732	6043	4.407407407407407	18.32401125268906
chr16	ATXN2L	28836486	28836490	95	5	110970	6097	110875	6092	19.0	18.200098489822718
chr16	ATXN2L	28824543	28824661	1434	119	110970	6097	109536	5978	12.050420168067227	18.3231850117096
chr16	ATXN2L	28836123	28836485	2671	363	110970	6097	108299	5734	7.358126721763085	18.88716428322288
chr16	ATXN2L	28836177	28836485	2433	309	110970	6097	108537	5788	7.87378640776699	18.752073255010366
chr16	SH2B1	28863755	28867033	4895	3279	116058	4469	111163	1190	1.4928331808478195	93.41428571428571
chr16	SH2B1	28872706	28872758	0	53	116058	4469	116058	4416	0.0	26.28125
chr16	ATP2A1	28892432	28892659	51	228	39675	4569	39624	4341	0.2236842105263158	9.127850725639254
chr16	NFATC2IP	28951052	28951398	0	347	174139	5696	174139	5349	0.0	32.5554309216676
chr16	RRN3P2	29094331	29094408	0	78	2480	2287	2480	2209	0.0	1.1226799456767769
chr16	AC009093.11	29326484	29326487	0	4	102	1729	102	1725	0.0	0.059130434782608696
chr16	SULT1A4	29461739	29461763	94	25	40008	1840	39914	1815	3.76	21.991184573002755
chr16	QPRT	29694756	29695199	0	444	2292	2415	2292	1971	0.0	1.1628614916286149
chr16	KIF22	29790830	29791221	0	392	1868	3665	1868	3273	0.0	0.5707302169263673
chr16	KIF22	29797089	29797093	0	5	1868	3665	1868	3660	0.0	0.5103825136612021
chr16	KIF22	29791222	29791461	0	240	1868	3665	1868	3425	0.0	0.5454014598540146
chr16	KIF22	29804066	29804107	0	42	1868	3665	1868	3623	0.0	0.5155948109301683
chr16	MAZ	29807829	29807885	0	57	558616	3213	558616	3156	0.0	177.00126742712294
chr16	PRRT2	29811977	29812036	2566	60	238274	2305	235708	2245	42.766666666666666	104.9924276169265
chr16	PRRT2	29813394	29814009	19809	616	238274	2305	218465	1689	32.157467532467535	129.3457667258733
chr16	PRRT2	29813934	29814009	6664	76	238274	2305	231610	2229	87.6842105263158	103.9075818752804
chr16	PRRT2	29813779	29814009	12397	231	238274	2305	225877	2074	53.666666666666664	108.90887174541948
chr16	PRRT2	29813776	29814009	12589	234	238274	2305	225685	2071	53.7991452991453	108.97392563978754
chr16	PRRT2	29813779	29813933	5733	155	238274	2305	232541	2150	36.987096774193546	108.15860465116279
chr16	PRRT2	29813776	29813933	5925	158	238274	2305	232349	2147	37.5	108.22030740568235
chr16	PRRT2	29813394	29813933	13145	540	238274	2305	225129	1765	24.34259259259259	127.55184135977338
chr16	PRRT2	29813394	29813778	7412	385	238274	2305	230862	1920	19.25194805194805	120.240625
chr16	PRRT2	29813776	29813778	192	3	238274	2305	238082	2302	64.0	103.42397914856646
chr16	PRRT2	29812324	29812351	789	28	238274	2305	237485	2277	28.178571428571427	104.29732103645146
chr16	PRRT2	29813394	29813775	7220	382	238274	2305	231054	1923	18.900523560209425	120.15288611544462
chr16	PRRT2	29812352	29812404	3341	53	238274	2305	234933	2252	63.0377358490566	104.32193605683837
chr16	PRRT2	29812405	29812472	6068	68	238274	2305	232206	2237	89.23529411764706	103.80241394725078
chr16	MVP	29834067	29834397	168	331	220929	5786	220761	5455	0.5075528700906344	40.46947754353804
chr16	ASPHD1	29900567	29900741	0	175	6537	2178	6537	2003	0.0	3.2636045931103346
chr16	AC093512.2	30064072	30064248	0	177	2956	3371	2956	3194	0.0	0.9254852849092048
chr16	ALDOA	30067334	30067366	0	33	9775	2724	9775	2691	0.0	3.6324786324786325
chr16	ALDOA	30064506	30064784	2669	279	9775	2724	7106	2445	9.5663082437276	2.9063394683026584
chr16	ALDOA	30068979	30068990	36	12	9775	2724	9739	2712	3.0	3.591076696165192
chr16	PPP4C	30076095	30076100	126	6	2799166	2653	2799040	2647	21.0	1057.4386097468832
chr16	PPP4C	30082848	30082963	4441	116	2799166	2653	2794725	2537	38.28448275862069	1101.5865195112337
chr16	CORO1A	30183014	30183133	0	120	68	3668	68	3548	0.0	0.019165727170236752
chr16	SLX1A-SULT1A3	30194792	30195227	204	436	46425	4064	46221	3628	0.46788990825688076	12.740077177508269
chr16	ITGAL	30483960	30483964	0	5	102	9594	102	9589	0.0	0.010637188445093336
chr16	ITGAL	30489387	30492069	51	2683	102	9594	51	6911	0.01900857249347745	0.007379539863984951
chr16	PRR14	30654998	30655214	0	217	357	3517	357	3300	0.0	0.10818181818181818
chr16	PHKG2	30748419	30748490	8925	72	281841	4744	272916	4672	123.95833333333333	58.415239726027394
chr16	PHKG2	30751218	30751281	12427	64	281841	4744	269414	4680	194.171875	57.567094017094014
chr16	RNF40	30762361	30762398	0	38	594609	6186	594609	6148	0.0	96.7158425504229
chr16	FBXL19	30928629	30928630	0	2	23349	4683	23349	4681	0.0	4.988036744285409
chr16	FBXL19	30928500	30928630	478	131	23349	4683	22871	4552	3.648854961832061	5.0243848857644995
chr16	FBXL19	30928500	30928628	478	129	23349	4683	22871	4554	3.705426356589147	5.022178304787
chr16	HSD3B7	30985825	30985947	951	123	3341	2497	2390	2374	7.7317073170731705	1.0067396798652064
chr16	ZNF646	31074632	31074761	0	130	17567	8293	17567	8163	0.0	2.152027440891829
chr16	ZNF646	31074721	31074761	0	41	17567	8293	17567	8252	0.0	2.1288172564226855
chr16	ZNF646	31074632	31074720	0	89	17567	8293	17567	8204	0.0	2.1412725499756218
chr16	ARMC5	31458977	31459340	0	364	36438	4981	36438	4617	0.0	7.8921377517868745
chr16	ARMC5	31460000	31460278	357	279	36438	4981	36081	4702	1.2795698924731183	7.673543173117822
chr16	ZNF720	31713436	31713448	0	13	3667	6006	3667	5993	0.0	0.6118805272818288
chr16	AC142381.3	31984190	31984197	0	8	51	2178	51	2170	0.0	0.023502304147465437
chr16	AC137800.1	32602633	32602697	0	65	0	1168	0	1103	0.0	0.0
chr16	AC142086.1	32886592	32886772	0	181	204	2163	204	1982	0.0	0.1029263370332997
chr16	AC023824.5	35144766	35144969	0	204	0	1223	0	1019	0.0	0.0
chr16	AC023824.5	35144970	35145075	0	106	0	1223	0	1117	0.0	0.0
chr16	AC023824.5	35144766	35145075	0	310	0	1223	0	913	0.0	0.0
chr16	GPT2	46884725	46884958	0	234	11425	6374	11425	6140	0.0	1.8607491856677525
chr16	LINC02134	47965821	47966010	0	190	0	756	0	566	0.0	0.0
chr16	AC007614.1	49285521	49285623	0	103	51	24089	51	23986	0.0	0.00212624030684566
chr16	ADCY7	50304517	50304551	0	35	526	8372	526	8337	0.0	0.06309223941465755
chr16	ADCY7	50266588	50266680	0	93	526	8372	526	8279	0.0	0.06353424326609494
chr16	NOD2	50697317	50698039	0	723	0	6889	0	6166	0.0	0.0
chr16	NOD2	50712374	50712401	0	28	0	6889	0	6861	0.0	0.0
chr16	NOD2	50712402	50712637	0	236	0	6889	0	6653	0.0	0.0
chr16	NOD2	50712374	50712637	0	264	0	6889	0	6625	0.0	0.0
chr16	CYLD	50742823	50742841	0	19	38045	10005	38045	9986	0.0	3.809833767274184
chr16	CYLD	50742125	50742216	0	92	38045	10005	38045	9913	0.0	3.8378896398668414
chr16	LINC02128	50884278	50884322	0	45	0	5070	0	5025	0.0	0.0
chr16	LINC02128	50884310	50884322	0	13	0	5070	0	5057	0.0	0.0
chr16	LINC02128	50884278	50884309	0	32	0	5070	0	5038	0.0	0.0
chr16	LINC02128	50884742	50884747	0	6	0	5070	0	5064	0.0	0.0
chr16	LINC02128	50880262	50880520	0	259	0	5070	0	4811	0.0	0.0
chr16	LINC02127	51025014	51025059	0	46	0	1918	0	1872	0.0	0.0
chr16	LINC02127	51022277	51022863	0	587	0	1918	0	1331	0.0	0.0
chr16	LINC02180	52092337	52092338	0	2	0	2068	0	2066	0.0	0.0
chr16	LINC02180	52092339	52092342	0	4	0	2068	0	2064	0.0	0.0
chr16	LINC02180	52092337	52092342	0	6	0	2068	0	2062	0.0	0.0
chr16	AC007333.1	52238566	52238711	0	146	0	2171	0	2025	0.0	0.0
chr16	AC026462.3	52607158	52607538	0	381	0	3107	0	2726	0.0	0.0
chr16	CHD9	53307906	53307953	0	48	7725	15474	7725	15426	0.0	0.500777907429016
chr16	GNAO1	56354988	56355081	0	94	122	13840	122	13746	0.0	0.008875309180852612
chr16	OGFOD1	56451568	56451760	94	193	59909	5793	59815	5600	0.48704663212435234	10.68125
chr16	OGFOD1	56453381	56453408	0	28	59909	5793	59909	5765	0.0	10.3918473547268
chr16	OGFOD1	56451568	56451766	94	199	59909	5793	59815	5594	0.4723618090452261	10.692706471219163
chr16	OGFOD1	56451761	56451766	0	6	59909	5793	59909	5787	0.0	10.352341454985313
chr16	MT1B	56652635	56652636	328	2	9888	396	9560	394	164.0	24.263959390862944
chr16	MT1F	56658741	56658782	0	42	10843	589	10843	547	0.0	19.822669104204753
chr16	MT1X	56683231	56683386	0	156	0	1133	0	977	0.0	0.0
chr16	NUP93	56782308	56782641	11159	334	182644	11123	171485	10789	33.41017964071856	15.894429511539531
chr16	NUP93	56783573	56783872	0	300	182644	11123	182644	10823	0.0	16.87554282546429
chr16	SLC12A3	56892134	56892160	0	27	100000	6207	100000	6180	0.0	16.181229773462782
chr16	HERPUD1	56940089	56940245	0	157	765	4885	765	4728	0.0	0.1618020304568528
chr16	NLRC5	56989596	56989617	0	22	18664	12006	18664	11984	0.0	1.5574098798397864
chr16	NLRC5	57028156	57028203	0	48	18664	12006	18664	11958	0.0	1.560796119752467
chr16	RSPRY1	57186430	57186442	1783	13	190126	5008	188343	4995	137.15384615384616	37.70630630630631
chr16	RSPRY1	57186430	57186785	66762	356	190126	5008	123364	4652	187.53370786516854	26.518486672398968
chr16	RSPRY1	57186443	57186785	64979	343	190126	5008	125147	4665	189.44314868804665	26.82679528403001
chr16	RSPRY1	57186452	57186785	63835	334	190126	5008	126291	4674	191.12275449101796	27.0198973042362
chr16	RSPRY1	57186430	57186451	2927	22	190126	5008	187199	4986	133.04545454545453	37.54492579221821
chr16	RSPRY1	57186443	57186451	1144	9	190126	5008	188982	4999	127.11111111111111	37.803960792158435
chr16	RSPRY1	57186430	57187050	142044	621	190126	5008	48082	4387	228.7342995169082	10.960109414178254
chr16	RSPRY1	57186443	57187050	140261	608	190126	5008	49865	4400	230.69243421052633	11.332954545454545
chr16	RSPRY1	57186786	57187050	75282	265	190126	5008	114844	4743	284.0830188679245	24.21336706725701
chr16	RSPRY1	57186452	57187050	139117	599	190126	5008	51009	4409	232.24874791318865	11.569290088455432
chr16	COQ9	57456627	57456646	0	20	600	3924	600	3904	0.0	0.15368852459016394
chr16	ADGRG5	57542702	57543173	0	472	9084	5643	9084	5171	0.0	1.7567201701798492
chr16	ADGRG1	57650352	57650355	0	4	809	7445	809	7441	0.0	0.10872194597500336
chr16	ADGRG1	57628727	57628802	0	76	809	7445	809	7369	0.0	0.10978423123897409
chr16	ADGRG1	57628803	57628828	0	26	809	7445	809	7419	0.0	0.10904434559913735
chr16	ADGRG1	57628727	57628828	0	102	809	7445	809	7343	0.0	0.110172953833583
chr16	ADGRG1	57640143	57640268	0	126	809	7445	809	7319	0.0	0.11053422598715672
chr16	ADGRG1	57645996	57646319	0	324	809	7445	809	7121	0.0	0.11360763937649207
chr16	ADGRG1	57646150	57646319	0	170	809	7445	809	7275	0.0	0.11120274914089347
chr16	DRC7	57699025	57699033	0	9	36999	4027	36999	4018	0.0	9.208312593330016
chr16	KATNB1	57737068	57737283	0	216	157	3360	157	3144	0.0	0.04993638676844784
chr16	USB1	58002591	58002645	0	55	1308	4598	1308	4543	0.0	0.28791547435615233
chr16	USB1	58014295	58014326	0	32	1308	4598	1308	4566	0.0	0.2864651773981603
chr16	USB1	58001582	58001588	0	7	1308	4598	1308	4591	0.0	0.284905249401002
chr16	LINC02137	58421386	58421421	0	36	7506	1782	7506	1746	0.0	4.298969072164948
chr16	NDRG4	58465072	58465235	0	164	204	7151	204	6987	0.0	0.029197080291970802
chr16	NDRG4	58503904	58503957	0	54	204	7151	204	7097	0.0	0.02874453994645625
chr16	NDRG4	58501613	58501678	0	66	204	7151	204	7085	0.0	0.028793225123500354
chr16	SETD6	58515881	58516097	0	217	177	7506	177	7289	0.0	0.02428316641514611
chr16	AC009081.2	60359904	60359966	0	63	0	2517	0	2454	0.0	0.0
chr16	CDH5	66376543	66376600	0	58	102	6002	102	5944	0.0	0.017160161507402422
chr16	CMTM1	66566595	66566612	0	18	2039	1471	2039	1453	0.0	1.4033035099793532
chr16	CMTM1	66566613	66566960	459	348	2039	1471	1580	1123	1.3189655172413792	1.406945681211042
chr16	CMTM1	66566595	66566960	459	366	2039	1471	1580	1105	1.2540983606557377	1.4298642533936652
chr16	CMTM1	66566595	66566945	459	351	2039	1471	1580	1120	1.3076923076923077	1.4107142857142858
chr16	CMTM3	66604450	66604482	0	33	5477	2917	5477	2884	0.0	1.8990984743411927
chr16	CMTM3	66604183	66604482	204	300	5477	2917	5273	2617	0.68	2.0149025601834163
chr16	CMTM3	66604183	66604449	204	267	5477	2917	5273	2650	0.7640449438202247	1.989811320754717
chr16	CMTM3	66604483	66604555	0	73	5477	2917	5477	2844	0.0	1.9258087201125176
chr16	CMTM3	66604450	66604555	0	106	5477	2917	5477	2811	0.0	1.9484169334756314
chr16	PDP2	66880641	66880756	0	116	306	5160	306	5044	0.0	0.060666137985725614
chr16	PDP2	66880665	66880756	0	92	306	5160	306	5068	0.0	0.060378847671665355
chr16	PDP2	66880674	66880756	0	83	306	5160	306	5077	0.0	0.06027181406342328
chr16	PDP2	66880641	66880664	0	24	306	5160	306	5136	0.0	0.05957943925233645
chr16	PDP2	66880641	66880673	0	33	306	5160	306	5127	0.0	0.05968402574605032
chr16	PDP2	66880665	66880673	0	9	306	5160	306	5151	0.0	0.0594059405940594
chr16	CES2	66935712	66935976	0	265	0	4926	0	4661	0.0	0.0
chr16	CES2	66935876	66935976	0	101	0	4926	0	4825	0.0	0.0
chr16	CES2	66942738	66942785	0	48	0	4926	0	4878	0.0	0.0
chr16	CES2	66935712	66935875	0	164	0	4926	0	4762	0.0	0.0
chr16	CES4A	67000780	67000783	0	4	1458	4201	1458	4197	0.0	0.34739099356683345
chr16	CES4A	67000991	67001046	0	56	1458	4201	1458	4145	0.0	0.3517490952955368
chr16	CES4A	67001003	67001046	0	44	1458	4201	1458	4157	0.0	0.3507337021890787
chr16	CES4A	67000991	67001002	0	12	1458	4201	1458	4189	0.0	0.3480544282645023
chr16	CBFB	67082309	67082339	22	31	132925	4534	132903	4503	0.7096774193548387	29.514323784143905
chr16	CBFB	67029814	67030177	102	364	132925	4534	132823	4170	0.2802197802197802	31.852038369304555
chr16	C16ORF70	67109990	67110004	0	15	570965	5214	570965	5199	0.0	109.82208116945567
chr16	HSF4	67166370	67166395	3499	26	27639	2898	24140	2872	134.57692307692307	8.405292479108635
chr16	HSF4	67166012	67166070	42	59	27639	2898	27597	2839	0.711864406779661	9.720676294469884
chr16	NOL3	67174341	67174464	8294	124	52121	2844	43827	2720	66.88709677419355	16.112867647058824
chr16	NOL3	67174455	67174464	684	10	52121	2844	51437	2834	68.4	18.149964714184897
chr16	NOL3	67174341	67174454	7610	114	52121	2844	44511	2730	66.75438596491227	16.304395604395605
chr16	NOL3	67174945	67174946	60	2	52121	2844	52061	2842	30.0	18.318437719915554
chr16	E2F4	67192825	67192870	881	46	53541	3376	52660	3330	19.152173913043477	15.813813813813814
chr16	ELMO3	67199583	67199593	50	11	63032	2551	62982	2540	4.545454545454546	24.796062992125986
chr16	ELMO3	67200807	67200808	0	2	63032	2551	63032	2549	0.0	24.728128677912906
chr16	TMEM208	67228837	67228881	17776	45	270757	1641	252981	1596	395.02222222222224	158.5093984962406
chr16	TMEM208	67228632	67228657	19280	26	270757	1641	251477	1615	741.5384615384615	155.71331269349847
chr16	PLEKHG4	67280184	67280806	204	623	18388	5721	18184	5098	0.3274478330658106	3.5668889760690465
chr16	PLEKHG4	67280397	67280806	0	410	18388	5721	18388	5311	0.0	3.4622481641875353
chr16	PLEKHG4	67279627	67279789	0	163	18388	5721	18388	5558	0.0	3.3083843109032025
chr16	PLEKHG4	67279662	67279789	0	128	18388	5721	18388	5593	0.0	3.287681029858752
chr16	PLEKHG4	67280184	67280396	204	213	18388	5721	18184	5508	0.9577464788732394	3.301379811183733
chr16	PLEKHG4	67279627	67279661	0	35	18388	5721	18388	5686	0.0	3.2339078438269433
chr16	LRRC36	67347516	67347591	0	76	102	4036	102	3960	0.0	0.025757575757575757
chr16	LRRC36	67326846	67326932	0	87	102	4036	102	3949	0.0	0.025829323879463156
chr16	RIPOR1	67529860	67530087	2555	228	11665	6172	9110	5944	11.206140350877194	1.5326379542395694
chr16	PARD6A	67661588	67661677	0	90	35143	1261	35143	1171	0.0	30.01110162254483
chr16	TSNAXIP1	67807197	67807385	0	189	255	3696	255	3507	0.0	0.07271171941830624
chr16	NUTF2	67847457	67847566	0	110	32157	2866	32157	2756	0.0	11.667997097242381
chr16	DUS2	68023352	68023615	0	264	15973	4104	15973	3840	0.0	4.159635416666666
chr16	NFATC3	68084926	68085180	229	255	28113	8798	27884	8543	0.8980392156862745	3.2639587966756407
chr16	SLC7A6	68264577	68264741	0	165	60272	6338	60272	6173	0.0	9.763810140936336
chr16	PRMT7	68311100	68311246	951	147	96056	8534	95105	8387	6.469387755102041	11.33957314892095
chr16	PRMT7	68311112	68311246	876	135	96056	8534	95180	8399	6.488888888888889	11.332301464460055
chr16	PRMT7	68311100	68311111	75	12	96056	8534	95981	8522	6.25	11.262731753109598
chr16	PRMT7	68311506	68311745	439	240	96056	8534	95617	8294	1.8291666666666666	11.528454304316373
chr16	ZFP90	68530335	68530534	0	200	2484	5921	2484	5721	0.0	0.43418982695332986
chr16	ZFP90	68539430	68539469	0	40	2484	5921	2484	5881	0.0	0.42237714674375104
chr16	ZFP90	68539470	68539487	0	18	2484	5921	2484	5903	0.0	0.4208029815348128
chr16	ZFP90	68539430	68539487	0	58	2484	5921	2484	5863	0.0	0.4236738870885212
chr16	ZFP90	68539480	68539487	0	8	2484	5921	2484	5913	0.0	0.4200913242009132
chr16	ZFP90	68539470	68539479	0	10	2484	5921	2484	5911	0.0	0.42023346303501946
chr16	ZFP90	68539430	68539479	0	50	2484	5921	2484	5871	0.0	0.4230965763924374
chr16	CDH3	68687737	68687744	0	8	12025	5982	12025	5974	0.0	2.0128891864747236
chr16	CDH1	68813496	68813562	0	67	64	5466	64	5399	0.0	0.011854047045749213
chr16	TANGO6	68909403	68909615	0	213	3727	6935	3727	6722	0.0	0.5544480809282951
chr16	SNTB2	69187734	69187746	0	13	28812	9427	28812	9414	0.0	3.0605481198215423
chr16	SNTB2	69260128	69260260	0	133	28812	9427	28812	9294	0.0	3.1000645577792123
chr16	NFAT5	69647168	69647586	130	419	17314	11906	17184	11487	0.31026252983293556	1.4959519456777226
chr16	CLEC18A	69951040	69951097	0	58	20062	5340	20062	5282	0.0	3.798182506626278
chr16	PDPR	70145798	70145833	0	36	62796	9700	62796	9664	0.0	6.497930463576159
chr16	CLEC18C	70173952	70174009	0	58	54319	4195	54319	4137	0.0	13.130045927000241
chr16	CLEC18C	70173973	70174009	0	37	54319	4195	54319	4158	0.0	13.063732563732565
chr16	CLEC18C	70173952	70173972	0	21	54319	4195	54319	4174	0.0	13.01365596550072
chr16	DDX19B	70294918	70295066	155235	149	250673	4471	95438	4322	1041.8456375838925	22.081906524757056
chr16	DDX19A	70361511	70361636	0	126	12443	5294	12443	5168	0.0	2.407701238390093
chr16	FCSK	70475416	70475493	0	78	4898	7256	4898	7178	0.0	0.6823627751462803
chr16	FCSK	70454806	70454940	0	135	4898	7256	4898	7121	0.0	0.6878247437157703
chr16	SF3B3	70523929	70524055	80	127	168803	8298	168723	8171	0.6299212598425197	20.649002570064862
chr16	AC106736.1	71301796	71301850	0	55	0	1680	0	1625	0.0	0.0
chr16	CALB2	71384020	71384025	0	6	0	1478	0	1472	0.0	0.0
chr16	TAT-AS1	71565095	71565122	0	28	0	1575	0	1547	0.0	0.0
chr16	TAT-AS1	71565123	71565666	0	544	0	1575	0	1031	0.0	0.0
chr16	TAT-AS1	71565095	71565666	0	572	0	1575	0	1003	0.0	0.0
chr16	MARVELD3	71626534	71626696	0	163	214	6429	214	6266	0.0	0.03415256942227896
chr16	DHX38	72093890	72094051	0	162	357	6143	357	5981	0.0	0.05968901521484701
chr16	HCCAT5	73092594	73092985	0	392	1067	2298	1067	1906	0.0	0.5598111227701994
chr16	ZFP1	75148644	75148662	0	19	153	3766	153	3747	0.0	0.04083266613290633
chr16	ZFP1	75166897	75166913	0	17	153	3766	153	3749	0.0	0.04081088290210723
chr16	AC009078.2	75227229	75227306	0	78	0	1027	0	949	0.0	0.0
chr16	TERF2IP	75648553	75648682	0	130	67694	4429	67694	4299	0.0	15.746452663410095
chr16	MON1B	77190935	77191260	0	326	0	6532	0	6206	0.0	0.0
chr16	MON1B	77191225	77191260	0	36	0	6532	0	6496	0.0	0.0
chr16	MON1B	77191259	77191260	0	2	0	6532	0	6530	0.0	0.0
chr16	MON1B	77191225	77191258	0	34	0	6532	0	6498	0.0	0.0
chr16	WWOX	78099886	78099999	0	114	204	4894	204	4780	0.0	0.042677824267782424
chr16	LINC01229	79722396	79722453	0	58	0	9960	0	9902	0.0	0.0
chr16	CENPN	81007278	81007445	0	168	12013	3581	12013	3413	0.0	3.519777322004102
chr16	CENPN	81014182	81014391	1574	210	12013	3581	10439	3371	7.495238095238095	3.096707208543459
chr16	ATMIN	81037476	81037498	0	23	139471	6264	139471	6241	0.0	22.347540458259893
chr16	AC099524.1	81739386	81739436	0	51	19551	1867	19551	1816	0.0	10.765969162995594
chr16	AC099524.1	81739437	81739734	255	298	19551	1867	19296	1569	0.8557046979865772	12.298279158699808
chr16	DNAAF1	84174723	84174728	0	6	6396	3756	6396	3750	0.0	1.7056
chr16	ADAD2	84195159	84195194	0	36	102	3985	102	3949	0.0	0.025829323879463156
chr16	KLHL36	84648650	84648887	884	238	5125	10014	4241	9776	3.7142857142857144	0.43381751227495907
chr16	KLHL36	84649067	84649318	1622	252	5125	10014	3503	9762	6.436507936507937	0.358840401557058
chr16	KIAA0513	85027852	85027858	7	7	3578	8851	3571	8844	1.0	0.40377657168701947
chr16	COX4I1	85799753	85799884	1861	132	9255	1997	7394	1865	14.098484848484848	3.964611260053619
chr16	COX4I1	85805105	85805153	0	49	9255	1997	9255	1948	0.0	4.751026694045175
chr16	IRF8	85902868	85902889	0	22	51	4561	51	4539	0.0	0.011235955056179775
chr16	IRF8	85914142	85914171	0	30	51	4561	51	4531	0.0	0.011255793423085412
chr16	LINC02188	86734889	86734909	0	21	0	5791	0	5770	0.0	0.0
chr16	LINC02188	86722132	86722147	0	16	0	5791	0	5775	0.0	0.0
chr16	MAP1LC3B	87392468	87393319	0	852	13541	5043	13541	4191	0.0	3.2309711286089238
chr16	BANP	87975186	87975203	0	18	20852	7681	20852	7663	0.0	2.721127495758841
chr16	BANP	87975186	87975207	0	22	20852	7681	20852	7659	0.0	2.722548635592114
chr16	BANP	87975204	87975207	0	4	20852	7681	20852	7677	0.0	2.7161651686856847
chr16	ZC3H18	88577376	88577726	204	351	5836	7150	5632	6799	0.5811965811965812	0.828357111339903
chr16	SNAI3-AS1	88671466	88671693	0	228	72147	5297	72147	5069	0.0	14.232984809627146
chr16	SNAI3-AS1	88672115	88672122	0	8	72147	5297	72147	5289	0.0	13.640952921157119
chr16	CDT1	88806639	88806674	0	36	40257	2770	40257	2734	0.0	14.72457937088515
chr16	TRAPPC2L	88857184	88857451	512	268	2271	3018	1759	2750	1.9104477611940298	0.6396363636363637
chr16	AC092384.2	88881613	88881620	88	8	25786	2819	25698	2811	11.0	9.141942369263607
chr16	ACSF3	89093993	89093996	0	4	182	8565	182	8561	0.0	0.02125919869174162
chr16	AC137932.1	89297751	89297962	6468	212	31603	1262	25135	1050	30.50943396226415	23.938095238095237
chr16	SPG7	89529525	89529579	51	55	25176	18796	25125	18741	0.9272727272727272	1.3406435088842645
chr16	SPG7	89540978	89541027	89	50	25176	18796	25087	18746	1.78	1.3382588285500907
chr16	SPG7	89541385	89542279	0	895	25176	18796	25176	17901	0.0	1.4064018769901123
chr16	SPG7	89541347	89542279	0	933	25176	18796	25176	17863	0.0	1.409393718860214
chr16	SPG7	89541371	89542279	0	909	25176	18796	25176	17887	0.0	1.407502655559904
chr16	SPG7	89545980	89546030	0	51	25176	18796	25176	18745	0.0	1.3430781541744465
chr16	SPG7	89545996	89546030	0	35	25176	18796	25176	18761	0.0	1.3419327327967592
chr16	SPG7	89541347	89541384	0	38	25176	18796	25176	18758	0.0	1.3421473504638022
chr16	SPG7	89541371	89541384	0	14	25176	18796	25176	18782	0.0	1.3404323288254711
chr16	SPG7	89546031	89546181	0	151	25176	18796	25176	18645	0.0	1.3502815768302494
chr16	SPG7	89545980	89546181	0	202	25176	18796	25176	18594	0.0	1.3539851565020975
chr16	SPG7	89545996	89546181	0	186	25176	18796	25176	18610	0.0	1.352821063944116
chr16	SPG7	89530809	89530957	95	149	25176	18796	25081	18647	0.6375838926174496	1.3450420979245992
chr16	SPG7	89553136	89553163	226	28	25176	18796	24950	18768	8.071428571428571	1.3293904518329072
chr16	SPG7	89541347	89541370	0	24	25176	18796	25176	18772	0.0	1.341146388237801
chr16	SPG7	89545980	89545995	0	16	25176	18796	25176	18780	0.0	1.3405750798722045
chr16	SPG7	89546182	89546187	0	6	25176	18796	25176	18790	0.0	1.3398616285258116
chr16	SPG7	89544773	89546181	1224	1409	25176	18796	23952	17387	0.8687012065294535	1.3775809512854431
chr16	SPG7	89549337	89549713	255	377	25176	18796	24921	18419	0.6763925729442971	1.3530050491340464
chr16	RPL13	89560713	89560839	51	127	8832	3088	8781	2961	0.4015748031496063	2.9655521783181356
chr16	RPL13	89560713	89561063	470	351	8832	3088	8362	2737	1.339031339031339	3.055169894044574
chr16	RPL13	89562392	89562445	0	54	8832	3088	8832	3034	0.0	2.911008569545155
chr16	SPATA33	89657836	89657866	2915	31	34818	3500	31903	3469	94.03225806451613	9.196598443355434
chr16	SPATA33	89657867	89657948	2058	82	34818	3500	32760	3418	25.097560975609756	9.584552369806906
chr16	SPATA33	89657836	89657948	4973	113	34818	3500	29845	3387	44.008849557522126	8.81163271331562
chr16	SPATA33	89658210	89658421	2575	212	34818	3500	32243	3288	12.14622641509434	9.806265206812652
chr16	CDK10	89695053	89695070	0	18	189	5398	189	5380	0.0	0.035130111524163565
chr16	CDK10	89689307	89689324	0	18	189	5398	189	5380	0.0	0.035130111524163565
chr16	CDK10	89686760	89686797	0	38	189	5398	189	5360	0.0	0.03526119402985075
chr16	VPS9D1-AS1	89716638	89716904	45	267	187615	1700	187570	1433	0.16853932584269662	130.89323098394976
chr16	ZNF276	89727326	89727357	3907	32	75883	5580	71976	5548	122.09375	12.973323720259552
chr16	TCF25	89887682	89887717	0	36	41425	6664	41425	6628	0.0	6.25
chr16	TCF25	89909084	89909107	0	24	41425	6664	41425	6640	0.0	6.238704819277109
chr16	TUBB3	89922184	89922245	0	62	45431	4255	45431	4193	0.0	10.834963033627474
chr16	DEF8	89949514	89949638	481	125	142694	5553	142213	5428	3.848	26.199889462048638
chr16	DEF8	89950307	89950328	171	22	142694	5553	142523	5531	7.7727272727272725	25.768034713433376
chr16	AFG3L1P	89981919	89981923	34	5	4130458	8480	4130424	8475	6.8	487.36566371681414
chr16	AFG3L1P	89984600	89984617	372	18	4130458	8480	4130086	8462	20.666666666666668	488.07445048451905
chr16	TUBB8P7	90094536	90094639	41	104	17438	2470	17397	2366	0.3942307692307692	7.352916314454776
chr16	TUBB8P7	90094536	90094829	145	294	17438	2470	17293	2176	0.4931972789115646	7.947150735294118
chr16	TUBB8P7	90094640	90094829	104	190	17438	2470	17334	2280	0.5473684210526316	7.602631578947369
chr16	LINC02193	90215557	90216198	144	642	5807	4443	5663	3801	0.22429906542056074	1.4898710865561695
chr16	LINC02193	90222293	90222296	0	4	5807	4443	5807	4439	0.0	1.3081775174588872
chr16	NPRL3	138149	138230	0	82	35931	5493	35931	5411	0.0	6.640362225097024
chr16	NPRL3	138149	138640	612	492	35931	5493	35319	5001	1.2439024390243902	7.062387522495501
chr16	LUC7L	227986	229277	0	1292	5993	6101	5993	4809	0.0	1.246205032231233
chr16	LUC7L	227986	228331	0	346	5993	6101	5993	5755	0.0	1.0413553431798437
chr16	LUC7L	227986	228699	0	714	5993	6101	5993	5387	0.0	1.1124930387971042
chr16	LUC7L	189930	189966	476	37	5993	6101	5517	6064	12.864864864864865	0.9097955145118733
chr16	LUC7L	189930	189945	161	16	5993	6101	5832	6085	10.0625	0.9584223500410847
chr16	LUC7L	189946	189966	315	21	5993	6101	5678	6080	15.0	0.9338815789473685
chr16	LUC7L	228488	228699	0	212	5993	6101	5993	5889	0.0	1.0176600441501105
chr16	LUC7L	228700	228788	0	89	5993	6101	5993	6012	0.0	0.9968396540252827
chr16	LUC7L	228789	229277	0	489	5993	6101	5993	5612	0.0	1.0678902352102637
chr16	RGS11	275837	275847	0	11	26270	4272	26270	4261	0.0	6.165219432058202
chr16	MRPL28	370484	370497	0	14	8668	2261	8668	2247	0.0	3.8575878949710725
chr16	MRPL28	370443	370497	0	55	8668	2261	8668	2206	0.0	3.929283771532185
chr16	MRPL28	370443	370483	0	41	8668	2261	8668	2220	0.0	3.9045045045045046
chr16	METTL26	635517	635610	150	94	3671	1123	3521	1029	1.5957446808510638	3.421768707482993
chr16	JMJD8	682952	682956	0	5	7250	2400	7250	2395	0.0	3.0271398747390394
chr16	JMJD8	683860	683908	0	49	7250	2400	7250	2351	0.0	3.0837941301573797
chr16	CCDC78	725412	725444	33	33	249184	2919	249151	2886	1.0	86.33090783090783
chr16	CIAO3	737497	737659	3924	163	487970	6627	484046	6464	24.073619631901842	74.88335396039604
chr16	CIAO3	739539	739641	4534	103	487970	6627	483436	6524	44.019417475728154	74.1011649294911
chr16	MSLNL	778625	778640	0	16	18321	2355	18321	2339	0.0	7.832834544677213
chr16	RPUSD1	787353	787395	5	43	15436	2764	15431	2721	0.11627906976744186	5.6710768099963245
chr16	RPUSD1	787067	787075	0	9	15436	2764	15436	2755	0.0	5.602903811252268
chr16	RPUSD1	787343	787352	0	10	15436	2764	15436	2754	0.0	5.604938271604938
chr16	RPUSD1	787343	787395	5	53	15436	2764	15431	2711	0.09433962264150944	5.6919955735890815
chr16	LMF1	934189	934242	0	54	1722	8238	1722	8184	0.0	0.21041055718475074
chr16	CEROX1	979600	980125	0	526	1435	2975	1435	2449	0.0	0.5859534503879135
chr16	UNKL	1367091	1367240	5840	150	261720	4550	255880	4400	38.93333333333333	58.154545454545456
chr16	UNKL	1369933	1370128	6577	196	261720	4550	255143	4354	33.55612244897959	58.59967845659164
chr16	UNKL	1379532	1379592	0	61	261720	4550	261720	4489	0.0	58.30251726442415
chr16	CCDC154	1434667	1434749	0	83	10122	2440	10122	2357	0.0	4.294442087399236
chr16	PTX4	1487315	1487759	79	445	567	1692	488	1247	0.17752808988764046	0.3913392141138733
chr16	IFT140	1526618	1526731	0	114	113268	8162	113268	8048	0.0	14.074055666003977
chr16	IFT140	1610416	1610662	0	247	113268	8162	113268	7915	0.0	14.31054958938724
chr16	NME3	1770880	1770887	0	8	98	1294	98	1286	0.0	0.07620528771384137
chr16	NME3	1771268	1771278	0	11	98	1294	98	1283	0.0	0.07638347622759158
chr16	NME3	1771279	1771303	0	25	98	1294	98	1269	0.0	0.07722616233254531
chr16	HAGH	1826506	1826710	2657	205	348055	5851	345398	5646	12.960975609756098	61.17569961034361
chr16	MSRB1	1940777	1941255	0	479	51	2025	51	1546	0.0	0.032988357050452784
chr16	RPS2	1964448	1964805	0	358	51	1934	51	1576	0.0	0.03236040609137056
chr16	NOXO1	1980640	1980654	0	15	333	2072	333	2057	0.0	0.16188624210014585
chr16	ZNF598	2000390	2000407	0	18	223414	4333	223414	4315	0.0	51.776129779837774
chr16	ZNF598	2001582	2001590	0	9	223414	4333	223414	4324	0.0	51.66836262719704
chr16	NTHL1	2046127	2046278	0	152	54124	1666	54124	1514	0.0	35.74900924702774
chr16	PKD1	2103265	2103723	11436	459	208723	16200	197287	15741	24.915032679738562	12.53332062766025
chr16	PKD1	2103265	2103430	8363	166	208723	16200	200360	16034	50.37951807228916	12.495946114506673
chr16	PKD1	2103431	2103723	3073	293	208723	16200	205650	15907	10.488054607508532	12.928270572703841
chr16	ECI1	2243317	2243367	0	51	961	2942	961	2891	0.0	0.3324109304738845
chr16	RNPS1	2263095	2263140	5045	46	525759	7319	520714	7273	109.67391304347827	71.59549016911866
chr16	RNPS1	2264175	2264181	2533	7	525759	7319	523226	7312	361.85714285714283	71.55716630196936
chr16	RNPS1	2267174	2267207	0	34	525759	7319	525759	7285	0.0	72.17007549759781
chr16	RNPS1	2267174	2267573	153	400	525759	7319	525606	6919	0.3825	75.96560196560196
chr16	RNPS1	2267174	2267198	0	25	525759	7319	525759	7294	0.0	72.0810255004113
chr16	RNPS1	2267174	2267187	0	14	525759	7319	525759	7305	0.0	71.97248459958932
chr16	RNPS1	2267932	2268053	0	122	525759	7319	525759	7197	0.0	73.05252188411838
chr16	RNPS1	2267208	2267661	306	454	525759	7319	525453	6865	0.6740088105726872	76.54085943190094
chr16	RNPS1	2267208	2267573	153	366	525759	7319	525606	6953	0.4180327868852459	75.59413202933985
chr16	RNPS1	2267574	2267661	153	88	525759	7319	525606	7231	1.7386363636363635	72.68787166367031
chr16	RNPS1	2267199	2267207	0	9	525759	7319	525759	7310	0.0	71.92325581395349
chr16	RNPS1	2267188	2267207	0	20	525759	7319	525759	7299	0.0	72.03164817098232
chr16	RNPS1	2267188	2267198	0	11	525759	7319	525759	7308	0.0	71.94293924466338
chr16	ERVK13-1	2671344	2671593	3506	250	42024	6668	38518	6418	14.024	6.001558117793706
chr16	ERVK13-1	2669410	2671343	6523	1934	42024	6668	35501	4734	3.372802481902792	7.499155048584706
chr16	ERVK13-1	2669410	2671593	10029	2184	42024	6668	31995	4484	4.592032967032967	7.135370205173952
chr16	ERVK13-1	2671023	2671343	652	321	42024	6668	41372	6347	2.0311526479750777	6.518355128407121
chr16	ERVK13-1	2671023	2671593	4158	571	42024	6668	37866	6097	7.281961471103328	6.2105953747744795
chr16	ERVK13-1	2670809	2670862	145	54	42024	6668	41879	6614	2.685185185185185	6.331871787118234
chr16	ERVK13-1	2672706	2673281	5506	576	42024	6668	36518	6092	9.559027777777779	5.994418910045962
chr16	SRRM2-AS1	2743441	2743550	0	110	61299	5093	61299	4983	0.0	12.30162552679109
chr16	SRRM2-AS1	2738368	2738440	0	73	61299	5093	61299	5020	0.0	12.210956175298804
chr16	PRSS30P	2840147	2841161	0	1015	51	1785	51	770	0.0	0.06623376623376623
chr16	PRSS30P	2841407	2841678	0	272	51	1785	51	1513	0.0	0.033707865168539325
chr16	PRSS30P	2841407	2841571	0	165	51	1785	51	1620	0.0	0.03148148148148148
chr16	PRSS22	2856081	2856132	0	52	157	2201	157	2149	0.0	0.07305723592368543
chr16	PRSS22	2857636	2857826	0	191	157	2201	157	2010	0.0	0.0781094527363184
chr16	PKMYT1	2979647	2979806	10977	160	33913	4989	22936	4829	68.60625	4.7496376061296335
chr16	PKMYT1	2979647	2979814	11713	168	33913	4989	22200	4821	69.7202380952381	4.604853764779092
chr16	PKMYT1	2979807	2979814	736	8	33913	4989	33177	4981	92.0	6.660710700662517
chr16	PKMYT1	2980218	2980284	44	67	33913	4989	33869	4922	0.6567164179104478	6.881145875660301
chr16	ZSCAN10	3092541	3092675	0	135	34	3080	34	2945	0.0	0.011544991511035654
chr16	ZNF213-AS1	3129247	3129459	0	213	6634	9872	6634	9659	0.0	0.6868205818407702
chr16	ZNF213-AS1	3142805	3143602	0	798	6634	9872	6634	9074	0.0	0.7310998457130262
chr16	ZNF213-AS1	3134508	3134632	0	125	6634	9872	6634	9747	0.0	0.6806196778495948
chr16	ZNF200	3234986	3235110	0	125	1880	7136	1880	7011	0.0	0.26815004992155184
chr16	ZNF200	3234635	3234985	102	351	1880	7136	1778	6785	0.2905982905982906	0.26204863669859985
chr16	ZNF200	3234635	3235110	102	476	1880	7136	1778	6660	0.21428571428571427	0.266966966966967
chr16	MEFV	3244135	3244252	0	118	2408	4838	2408	4720	0.0	0.5101694915254237
chr16	C16ORF90	3495375	3495408	0	34	340	941	340	907	0.0	0.3748621830209482
chr16	ADCY9	3993348	3993404	0	57	8669	9168	8669	9111	0.0	0.9514872132586982
chr16	LINC01569	4253646	4253675	0	30	51	2431	51	2401	0.0	0.0212411495210329
chr16	LINC01569	4246972	4246987	0	16	51	2431	51	2415	0.0	0.02111801242236025
chr16	LINC01569	4252877	4253645	0	769	51	2431	51	1662	0.0	0.030685920577617327
chr16	LINC01569	4252877	4253675	0	799	51	2431	51	1632	0.0	0.03125
chr16	CORO7	4407500	4407560	14	61	13299	7153	13285	7092	0.22950819672131148	1.8732374506486182
chr16	CORO7	4416458	4416783	0	326	13299	7153	13299	6827	0.0	1.9480005859088911
chr16	CORO7	4415714	4415764	0	51	13299	7153	13299	7102	0.0	1.8725711067304984
chr16	NMRAL1	4463659	4463676	0	18	5841	3199	5841	3181	0.0	1.8362150267211568
chr16	NMRAL1	4463641	4463658	0	18	5841	3199	5841	3181	0.0	1.8362150267211568
chr16	NMRAL1	4463641	4463676	0	36	5841	3199	5841	3163	0.0	1.8466645589630097
chr16	NMRAL1	4474409	4474552	0	144	5841	3199	5841	3055	0.0	1.9119476268412439
chr16	NMRAL1	4474409	4474421	0	13	5841	3199	5841	3186	0.0	1.8333333333333333
chr16	NMRAL1	4474422	4474552	0	131	5841	3199	5841	3068	0.0	1.9038461538461537
chr16	NMRAL1	4471313	4471355	0	43	5841	3199	5841	3156	0.0	1.8507604562737643
chr16	CDIP1	4514574	4514629	131	56	190098	2499	189967	2443	2.3392857142857144	77.75972165370446
chr16	CDIP1	4513695	4513814	112597	120	190098	2499	77501	2379	938.3083333333333	32.5771332492644
chr16	UBALD1	4614492	4614676	0	185	255	2587	255	2402	0.0	0.10616153205661949
chr16	ANKS3	4733937	4734154	24	218	48341	6948	48317	6730	0.11009174311926606	7.179346210995543
chr16	SEPTIN12	4783316	4783460	0	145	3786	1954	3786	1809	0.0	2.0928689883913765
chr16	SEPTIN12	4787468	4787478	0	11	3786	1954	3786	1943	0.0	1.9485331960885228
chr16	ROGDI	4801049	4801265	11574	217	53447	2850	41873	2633	53.336405529953915	15.90315229775921
chr16	NAGPA	5033272	5033339	0	68	204	4883	204	4815	0.0	0.04236760124610592
chr16	EEF2KMT	5095374	5095450	0	77	51	2853	51	2776	0.0	0.018371757925072046
chr16	LINC01570	5616101	5616124	0	24	0	3791	0	3767	0.0	0.0
chr16	CARHSP1	8868048	8868325	0	278	51	4936	51	4658	0.0	0.010948905109489052
chr16	CARHSP1	8861641	8861664	0	24	51	4936	51	4912	0.0	0.010382736156351791
chr16	USP7	8923214	8923352	0	139	86953	8661	86953	8522	0.0	10.203356019713683
chr16	AC099489.1	11391665	11391782	0	118	8414	12096	8414	11978	0.0	0.7024544999165137
chr16	LITAF	11636069	11636239	459	171	561	4952	102	4781	2.6842105263157894	0.021334448860071114
chr16	ZC3H7A	11761405	11761466	0	62	24930	7094	24930	7032	0.0	3.545221843003413
chr16	BCAR4	11821633	11821636	0	4	22353	1241	22353	1237	0.0	18.070331447049313
chr16	NPIPB2	11941837	11941981	78	145	220490	2700	220412	2555	0.5379310344827586	86.26692759295499
chr16	PARN	14630106	14630188	0	83	31291	8816	31291	8733	0.0	3.5830756899118286
chr16	PARN	14591912	14593299	0	1388	31291	8816	31291	7428	0.0	4.212574044157243
chr16	NTAN1	15047996	15048076	0	81	103989	3324	103989	3243	0.0	32.06567992599445
chr16	NTAN1	15047417	15047440	0	24	103989	3324	103989	3300	0.0	31.51181818181818
chr16	PKD1P6	15131073	15131085	1244	13	469759	6041	468515	6028	95.6923076923077	77.72312541473126
chr16	ABCC6	16221612	16221647	78	36	76212	6965	76134	6929	2.1666666666666665	10.987732717563862
chr16	AC126755.5	18339367	18339384	0	18	0	4104	0	4086	0.0	0.0
chr16	NOMO2	18529408	18529499	0	92	261804	6838	261804	6746	0.0	38.80877557070857
chr16	RPS15A	18790243	18790308	0	66	870	4037	870	3971	0.0	0.2190883908335432
chr16	RPS15A	18789896	18790242	0	347	870	4037	870	3690	0.0	0.23577235772357724
chr16	SMG1	18868522	18868631	39	110	521065	22455	521026	22345	0.35454545454545455	23.317341687178338
chr16	AC099518.4	19067242	19067316	0	75	1275	892	1275	817	0.0	1.5605875152998776
chr16	AC099518.4	19067550	19067579	0	30	1275	892	1275	862	0.0	1.4791183294663572
chr16	GDE1	19507654	19507685	0	32	4687	4397	4687	4365	0.0	1.0737686139747995
chr16	GP2	20326255	20326336	0	82	0	4061	0	3979	0.0	0.0
chr16	UMOD	20349770	20349799	0	30	0	3277	0	3247	0.0	0.0
chr16	UMOD	20352541	20352687	0	147	0	3277	0	3130	0.0	0.0
chr16	UMOD	20349707	20349769	0	63	0	3277	0	3214	0.0	0.0
chr16	UMOD	20349707	20349799	0	93	0	3277	0	3184	0.0	0.0
chr16	UMOD	20351019	20351128	0	110	0	3277	0	3167	0.0	0.0
chr16	ACSM1	20627188	20627254	0	67	0	2887	0	2820	0.0	0.0
chr16	NPIPB3	21411241	21411263	0	23	47286	4575	47286	4552	0.0	10.387961335676625
chr16	NPIPB3	21425289	21425298	10	10	47286	4575	47276	4565	1.0	10.35618838992333
chr16	IGSF6	21647132	21647305	97	174	2048	3473	1951	3299	0.5574712643678161	0.5913913307062746
chr16	NPIPB4	21857569	21857578	0	10	47981	7314	47981	7304	0.0	6.569140197152246
chr16	NPIPB4	21857569	21857657	166	89	47981	7314	47815	7225	1.8651685393258426	6.6179930795847755
chr16	NPIPB4	21851769	21851913	2222	145	47981	7314	45759	7169	15.324137931034484	6.382898591156367
chr16	AC009034.1	22288430	22288434	10	5	2874	716	2864	711	2.0	4.028129395218003
chr16	AC009034.1	22288390	22288434	502	45	2874	716	2372	671	11.155555555555555	3.535022354694486
chr16	AC009034.1	22288390	22288429	492	40	2874	716	2382	676	12.3	3.5236686390532546
chr16	GGA2	23495693	23495712	0	20	181970	5750	181970	5730	0.0	31.75741710296684
chr16	GGA2	23495688	23495692	0	5	181970	5750	181970	5745	0.0	31.67449956483899
chr16	GGA2	23495688	23495712	0	25	181970	5750	181970	5725	0.0	31.785152838427948
chr16	GGA2	23494298	23494301	1173	4	181970	5750	180797	5746	293.25	31.46484510964149
chr16	EARS2	23553006	23553042	0	37	166472	4213	166472	4176	0.0	39.8639846743295
chr16	PALB2	23641109	23641125	453	17	34414	4745	33961	4728	26.647058823529413	7.182952622673435
chr16	NSMCE1	27241352	27241797	51	446	15363	2869	15312	2423	0.11434977578475336	6.319438712340074
chr16	GTF3C1	27464319	27464393	0	75	317883	10137	317883	10062	0.0	31.59242695289207
chr16	GTF3C1	27471564	27471746	0	183	317883	10137	317883	9954	0.0	31.935201928872814
chr16	AC016597.1	27718242	27718332	280	91	9124	5320	8844	5229	3.076923076923077	1.691336775674125
chr16	EIF3CL	28403782	28403785	52	4	859871	3074	859819	3070	13.0	280.071335504886
chr16	CLN3	28482476	28482606	1032	131	183736	5985	182704	5854	7.877862595419847	31.2101127434233
chr16	AC138894.1	28477011	28477462	0	452	35427	4138	35427	3686	0.0	9.611231687466088
chr16	CLN3	28491481	28491712	1296	232	183736	5985	182440	5753	5.586206896551724	31.712150182513472
chr16	CLN3	28495125	28495339	8597	215	183736	5985	175139	5770	39.986046511627904	30.353379549393413
chr16	ATP2A1-AS1	28879488	28879540	37	53	2680	585	2643	532	0.6981132075471698	4.9680451127819545
chr16	AC133555.3	29465394	29465476	38066	83	362227	1824	324161	1741	458.6265060240964	186.19241815048824
chr16	NPIPB12	29505783	29505792	12	10	48626	4334	48614	4324	1.2	11.242830712303423
chr16	NPIPB12	29499997	29500141	1363	145	48626	4334	47263	4189	9.4	11.282645022678443
chr16	KCTD13	29911660	29911813	481	154	85834	5191	85353	5037	3.1233766233766236	16.945205479452056
chr16	HIRIP3	29993905	29994646	86375	742	222691	3487	136316	2745	116.40835579514825	49.659744990892534
chr16	DOC2A	30006784	30006854	413	71	455469	6385	455056	6314	5.816901408450704	72.0709534368071
chr16	DOC2A	30008995	30009002	24	8	455469	6385	455445	6377	3.0	71.41994668339345
chr16	DOC2A	30010898	30010901	4	4	455469	6385	455465	6381	1.0	71.37831060962232
chr16	TLCD3B	30035306	30035349	0	44	4184	4932	4184	4888	0.0	0.855973813420622
chr16	YPEL3	30096615	30096743	97525	129	546687	2150	449162	2021	756.0077519379845	222.24740227610093
chr16	YPEL3	30095995	30096095	130162	101	546687	2150	416525	2049	1288.7326732673268	203.2820888238165
chr16	YPEL3	30094997	30095101	126058	105	546687	2150	420629	2045	1200.5523809523809	205.68655256723716
chr16	GDPD3	30108120	30108211	905	92	3403	1473	2498	1381	9.83695652173913	1.8088341781317885
chr16	MAPK3	30118046	30118097	0	52	4953	3678	4953	3626	0.0	1.3659680088251518
chr16	MAPK3	30117136	30117152	0	17	4953	3678	4953	3661	0.0	1.3529090412455613
chr16	AC106782.1	30204744	30204825	25628	82	291762	2545	266134	2463	312.5365853658537	108.05278116118555
chr16	NPIPB13	30245764	30245773	0	10	24224	5013	24224	5003	0.0	4.841894863082151
chr16	DCTPP1	30429588	30429746	1869	159	14615	1485	12746	1326	11.754716981132075	9.61236802413273
chr16	DCTPP1	30429854	30429878	631	25	14615	1485	13984	1460	25.24	9.578082191780823
chr16	ZNF688	30571433	30572120	102	688	3809	2926	3707	2238	0.14825581395348839	1.6563896336014299
chr16	ZNF785	30585121	30585165	1	45	10109	3100	10108	3055	0.022222222222222223	3.3086743044189855
chr16	ZNF785	30585375	30585405	0	31	10109	3100	10109	3069	0.0	3.293906810035842
chr16	ZNF689	30609836	30610200	0	365	1239	3804	1239	3439	0.0	0.36027915091596396
chr16	AC093249.6	30698135	30698879	0	745	0	780	0	35	0.0	0.0
chr16	ZNF668	31063812	31064293	0	482	38689	3757	38689	3275	0.0	11.813435114503816
chr16	ZNF668	31072739	31072884	7904	146	38689	3757	30785	3611	54.136986301369866	8.525339241207421
chr16	ZNF668	31064799	31064902	0	104	38689	3757	38689	3653	0.0	10.591021078565563
chr16	PRSS36	31140491	31140677	66	187	61253	3373	61187	3186	0.35294117647058826	19.20495919648462
chr16	PRSS36	31142480	31142494	129	15	61253	3373	61124	3358	8.6	18.202501488981536
chr16	HERC2P4	32180584	32180618	0	35	438	5885	438	5850	0.0	0.07487179487179488
chr16	HERC2P4	32181810	32181862	0	53	438	5885	438	5832	0.0	0.07510288065843622
chr16	TP53TG3	32675735	32675858	0	124	0	3008	0	2884	0.0	0.0
chr16	HERC2P8	33095356	33095365	0	10	1211	5145	1211	5135	0.0	0.2358325219084713
chr16	HERC2P8	33115362	33115367	0	6	1211	5145	1211	5139	0.0	0.2356489589414283
chr16	BMS1P8	33698306	33698423	0	118	0	2182	0	2064	0.0	0.0
chr16	AC140658.1	33974767	33974947	0	181	0	2508	0	2327	0.0	0.0
chr16	AC018558.1	35505627	35505760	0	134	0	1199	0	1065	0.0	0.0
chr16	AC018558.1	35505565	35505626	0	62	0	1199	0	1137	0.0	0.0
chr16	VPS35	46688313	46689129	1481	817	173190	9751	171709	8934	1.8127294981640147	19.219722408775464
chr16	NETO2	47122867	47122887	273	21	24546	7390	24273	7369	13.0	3.2939340480390826
chr16	NETO2	47109482	47109529	0	48	24546	7390	24546	7342	0.0	3.3432307273222555
chr16	ABCC12	48086740	48087924	0	1185	153	8731	153	7546	0.0	0.020275642724622317
chr16	ABCC12	48086740	48087938	0	1199	153	8731	153	7532	0.0	0.020313329792883698
chr16	ABCC12	48087925	48087938	0	14	153	8731	153	8717	0.0	0.017551910060800733
chr16	ABCC12	48111577	48111585	0	9	153	8731	153	8722	0.0	0.01754184819995414
chr16	ABCC12	48139162	48139186	0	25	153	8731	153	8706	0.0	0.01757408683666437
chr16	ABCC12	48155817	48155839	0	23	153	8731	153	8708	0.0	0.017570050528249885
chr16	ABCC11	48247313	48247480	0	168	0	8503	0	8335	0.0	0.0
chr16	SIAH1	48361462	48361486	0	25	12742	5767	12742	5742	0.0	2.219087425983978
chr16	AKTIP	53503117	53503145	0	29	36041	4978	36041	4949	0.0	7.2824813093554255
chr16	AKTIP	53502699	53503145	0	447	36041	4978	36041	4531	0.0	7.9543147208121825
chr16	AKTIP	53502699	53503116	0	418	36041	4978	36041	4560	0.0	7.903728070175439
chr16	RPGRIP1L	53703554	53703801	0	248	11018	12304	11018	12056	0.0	0.913901791639018
chr16	LINC02169	54246822	54246837	0	16	0	858	0	842	0.0	0.0
chr16	IRX3	54285783	54286677	0	895	0	1990	0	1095	0.0	0.0
chr16	LINC02140	54370283	54370300	0	18	0	2558	0	2540	0.0	0.0
chr16	LINC02140	54370301	54370564	0	264	0	2558	0	2294	0.0	0.0
chr16	CRNDE	54848140	54848286	0	147	2295	12295	2295	12148	0.0	0.18891998682910768
chr16	CRNDE	54847975	54848139	0	165	2295	12295	2295	12130	0.0	0.18920032976092332
chr16	CRNDE	54928493	54928768	357	276	2295	12295	1938	12019	1.2934782608695652	0.16124469589816123
chr16	CRNDE	54926880	54928003	0	1124	2295	12295	2295	11171	0.0	0.20544266404081998
chr16	AC106738.2	54938163	54938383	153	221	306	780	153	559	0.6923076923076923	0.2737030411449016
chr16	CES5A	55871624	55871713	0	90	0	3225	0	3135	0.0	0.0
chr16	CES5A	55869478	55869609	0	132	0	3225	0	3093	0.0	0.0
chr16	CES5A	55873822	55873831	0	10	0	3225	0	3215	0.0	0.0
chr16	BBS2	56502672	56502700	0	29	294140	5825	294140	5796	0.0	50.7487922705314
chr16	BBS2	56519745	56519955	0	211	294140	5825	294140	5614	0.0	52.394014962593516
chr16	AC106779.1	56729505	56729781	0	277	0	1568	0	1291	0.0	0.0
chr16	PSME3IP1	57185820	57185823	0	4	71894	3087	71894	3083	0.0	23.31949399935128
chr16	PSME3IP1	57185820	57186029	282	210	71894	3087	71612	2877	1.3428571428571427	24.891206117483488
chr16	PSME3IP1	57185824	57186029	282	206	71894	3087	71612	2881	1.3689320388349515	24.856646997570287
chr16	PSME3IP1	57185544	57185819	90	276	71894	3087	71804	2811	0.32608695652173914	25.54393454286731
chr16	PSME3IP1	57178501	57178804	105	304	71894	3087	71789	2783	0.34539473684210525	25.795544376572046
chr16	PSME3IP1	57185544	57185734	90	191	71894	3087	71804	2896	0.4712041884816754	24.794198895027623
chr16	CIAPIN1	57439181	57439184	0	4	0	3392	0	3388	0.0	0.0
chr16	DOK4	57479844	57479859	0	16	184052	4617	184052	4601	0.0	40.00260812866768
chr16	DOK4	57487095	57487129	524	35	184052	4617	183528	4582	14.971428571428572	40.05412483631602
chr16	DOK4	57480294	57480328	1510	35	184052	4617	182542	4582	43.142857142857146	39.8389349628983
chr16	DOK4	57487130	57487244	2354	115	184052	4617	181698	4502	20.469565217391306	40.359395824078184
chr16	KIFC3	57797704	57797963	510	260	120266	7697	119756	7437	1.9615384615384615	16.102729595266908
chr16	KIFC3	57761314	57761411	0	98	120266	7697	120266	7599	0.0	15.826556125806027
chr16	CNGB1	57960481	57960498	0	18	51	7346	51	7328	0.0	0.006959606986899563
chr16	CNOT1	58556846	58556860	255	15	51765	10398	51510	10383	17.0	4.960993932389483
chr16	CNOT1	58536967	58536987	0	21	51765	10398	51765	10377	0.0	4.988435964151489
chr16	CNOT1	58624652	58624671	0	20	51765	10398	51765	10378	0.0	4.9879552900366155
chr16	SLC38A7	58683954	58684715	0	762	1520	6005	1520	5243	0.0	0.2899103566660309
chr16	GOT2	58722118	58722148	0	31	4464	3760	4464	3729	0.0	1.1971037811745777
chr16	AC092378.1	58879878	58879983	51	106	51	883	0	777	0.4811320754716981	0.0
chr16	CDH11	65071988	65072044	0	57	67466	13237	67466	13180	0.0	5.1188163884673745
chr16	CDH11	65121874	65121878	0	5	67466	13237	67466	13232	0.0	5.098700120918984
chr16	LINC00922	65356394	65356429	0	36	1173	2337	1173	2301	0.0	0.5097783572359843
chr16	BEAN1-AS1	66471376	66471513	0	138	0	1739	0	1601	0.0	0.0
chr16	TK2	66510610	66511956	306	1347	23401	8924	23095	7577	0.22717149220489977	3.048040121420087
chr16	TK2	66510610	66510721	0	112	23401	8924	23401	8812	0.0	2.655583295506128
chr16	TK2	66510722	66511956	306	1235	23401	8924	23095	7689	0.24777327935222673	3.0036415658733255
chr16	TK2	66551411	66551538	0	128	23401	8924	23401	8796	0.0	2.660413824465666
chr16	TK2	66551411	66552423	16452	1013	23401	8924	6949	7911	16.24086870681145	0.8783971684995576
chr16	TK2	66549576	66549665	0	90	23401	8924	23401	8834	0.0	2.6489698890649764
chr16	TK2	66546104	66546145	0	42	23401	8924	23401	8882	0.0	2.6346543571267733
chr16	CMTM4	66696339	66696425	21	87	2163	6340	2142	6253	0.2413793103448276	0.3425555733248041
chr16	TERB1	66759114	66759139	602	26	229202	3451	228600	3425	23.153846153846153	66.74452554744525
chr16	TERB1	66801467	66801569	0	103	229202	3451	229202	3348	0.0	68.45937873357228
chr16	NAE1	66826667	66826675	0	9	153	4416	153	4407	0.0	0.03471749489448604
chr16	NAE1	66827934	66827978	0	45	153	4416	153	4371	0.0	0.035003431708991076
chr16	KIAA0895L	67181557	67181604	6052	48	188263	3439	182211	3391	126.08333333333333	53.73370687112946
chr16	EXOC3L1	67188720	67188902	12815	183	36657	3057	23842	2874	70.02732240437159	8.295755045233124
chr16	EXOC3L1	67184685	67184900	653	216	36657	3057	36004	2841	3.0231481481481484	12.673002463921154
chr16	KCTD19	67326621	67326703	102	83	87576	7397	87474	7314	1.2289156626506024	11.95980311730927
chr16	TPPP3	67392946	67393378	153	433	120	2263	-33	1830	0.3533487297921478	-0.018032786885245903
chr16	ATP6V0D1	67458963	67459096	0	134	13854	6487	13854	6353	0.0	2.180702030536754
chr16	AC027682.6	67528316	67528598	2700	283	18524	602	15824	319	9.540636042402827	49.60501567398119
chr16	ACD	67659876	67659901	42	26	43330	2398	43288	2372	1.6153846153846154	18.249578414839796
chr16	GFOD2	67685456	67685510	0	55	6963	4622	6963	4567	0.0	1.5246332384497483
chr16	CENPT	67829764	67829920	0	157	1224	5102	1224	4945	0.0	0.2475227502527806
chr16	CENPT	67829764	67829928	0	165	1224	5102	1224	4937	0.0	0.24792384038890014
chr16	CENPT	67847400	67847578	0	179	1224	5102	1224	4923	0.0	0.24862888482632542
chr16	CENPT	67829921	67829928	0	8	1224	5102	1224	5094	0.0	0.24028268551236748
chr16	CENPT	67842957	67842997	0	41	1224	5102	1224	5061	0.0	0.24184943687018376
chr16	CENPT	67842998	67843029	0	32	1224	5102	1224	5070	0.0	0.24142011834319527
chr16	CENPT	67842957	67843029	0	73	1224	5102	1224	5029	0.0	0.24338834758401273
chr16	CTRL	67930680	67930724	434	45	2791	2174	2357	2129	9.644444444444444	1.1070925317050258
chr16	DPEP2	67999374	67999394	0	21	26474	3207	26474	3186	0.0	8.30947897049592
chr16	DPEP2	67999266	67999373	216	108	26474	3207	26258	3099	2.0	8.473055824459504
chr16	DPEP2	67999266	67999394	216	129	26474	3207	26258	3078	1.6744186046511629	8.530864197530864
chr16	ESRP2	68231177	68231294	0	118	10496	5121	10496	5003	0.0	2.097941235258845
chr16	SMPD3	68363776	68363799	4	24	110548	6995	110544	6971	0.16666666666666666	15.857696169846507
chr16	TERF2	69385592	69385629	191	38	422022	3724	421831	3686	5.026315789473684	114.44139989148128
chr16	NQO1	69726432	69726499	1854	68	18444	2978	16590	2910	27.264705882352942	5.701030927835052
chr16	NOB1	69748917	69748949	332752	33	3327707	2054	2994955	2021	10083.39393939394	1481.9173676397822
chr16	SMG1P7	70221249	70221252	0	4	2720	4515	2720	4511	0.0	0.6029705165151851
chr16	SMG1P7	70222366	70222369	0	4	2720	4515	2720	4511	0.0	0.6029705165151851
chr16	SMG1P7	70231322	70231435	0	114	2720	4515	2720	4401	0.0	0.6180413542376733
chr16	SMG1P7	70233412	70233422	0	11	2720	4515	2720	4504	0.0	0.6039076376554174
chr16	SMG1P7	70241006	70241034	0	29	2720	4515	2720	4486	0.0	0.606330806954971
chr16	SMG1P7	70243612	70243625	14	14	2720	4515	2706	4501	1.0	0.6011997333925794
chr16	AARS1	70258032	70258051	0	20	146049	9918	146049	9898	0.0	14.755405132349969
chr16	AARS1	70262345	70262365	210	21	146049	9918	145839	9897	10.0	14.735677478023643
chr16	AARS1	70262345	70262371	260	27	146049	9918	145789	9891	9.62962962962963	14.739561217268223
chr16	AARS1	70289420	70289528	1396	109	146049	9918	144653	9809	12.807339449541285	14.746967071057192
chr16	AARS1	70262366	70262371	50	6	146049	9918	145999	9912	8.333333333333334	14.7295197740113
chr16	AARS1	70258032	70258978	3977	947	146049	9918	142072	8971	4.199577613516367	15.8368074908037
chr16	AARS1	70255719	70255726	8	8	146049	9918	146041	9910	1.0	14.736730575176589
chr16	AARS1	70253665	70253712	367	48	146049	9918	145682	9870	7.645833333333333	14.760081053698075
chr16	COG4	70519648	70519675	0	28	47623	4424	47623	4396	0.0	10.833257506824387
chr16	HYDIN	71230561	71230628	0	68	44577	28693	44577	28625	0.0	1.5572751091703056
chr16	HYDIN	71230561	71230658	0	98	44577	28693	44577	28595	0.0	1.5589089001573702
chr16	HYDIN	71230629	71230658	0	30	44577	28693	44577	28663	0.0	1.5552105501866518
chr16	CMTR2	71289135	71289350	0	216	0	5440	0	5224	0.0	0.0
chr16	CMTR2	71288555	71288674	0	120	0	5440	0	5320	0.0	0.0
chr16	CMTR2	71289085	71289134	0	50	0	5440	0	5390	0.0	0.0
chr16	ZNF23	71453242	71453301	0	60	51	6589	51	6529	0.0	0.007811303415530709
chr16	ZNF23	71461658	71462208	0	551	51	6589	51	6038	0.0	0.00844650546538589
chr16	ZNF19	71488997	71489270	3004	274	11609	8775	8605	8501	10.963503649635037	1.012233854840607
chr16	AP1G1	71769618	71769621	0	4	93793	10941	93793	10937	0.0	8.575752034378715
chr16	AP1G1	71808504	71808761	51	258	93793	10941	93742	10683	0.19767441860465115	8.774875971169147
chr16	ZNF821	71867892	71867910	0	19	64247	3268	64247	3249	0.0	19.774392120652507
chr16	PMFBP1	72132732	72132746	0	15	224526	5619	224526	5604	0.0	40.065310492505354
chr16	LINC01572	72284571	72284575	0	5	2036	12582	2036	12577	0.0	0.1618828019400493
chr16	LINC01572	72570434	72570449	0	16	2036	12582	2036	12566	0.0	0.16202451058411588
chr16	AC138627.1	74215833	74215964	0	132	102	7414	102	7282	0.0	0.014007140895358419
chr16	AC138627.1	74296414	74296421	0	8	102	7414	102	7406	0.0	0.013772616797191467
chr16	AC138627.1	74296414	74296621	0	208	102	7414	102	7206	0.0	0.014154870940882597
chr16	RFWD3	74664623	74664688	6054	66	98553	6472	92499	6406	91.72727272727273	14.439431782703716
chr16	MLKL	74675323	74675353	13	31	110520	4745	110507	4714	0.41935483870967744	23.44229953330505
chr16	LDHD	75116611	75116647	0	37	918	2378	918	2341	0.0	0.392140111063648
chr16	CTRB2	75204772	75204795	351	24	28421	2319	28070	2295	14.625	12.230936819172113
chr16	CTRB2	75204741	75204795	650	55	28421	2319	27771	2264	11.818181818181818	12.266342756183745
chr16	CTRB2	75204741	75204771	299	31	28421	2319	28122	2288	9.64516129032258	12.291083916083917
chr16	BCAR1	75242469	75242912	1938	444	7240	8469	5302	8025	4.364864864864865	0.6606853582554517
chr16	BCAR1	75263637	75264349	187638	713	7240	8469	-180398	7756	263.1669004207574	-23.259154203197525
chr16	BCAR1	75263637	75264339	187638	703	7240	8469	-180398	7766	266.9103840682788	-23.229204223538503
chr16	BCAR1	75236827	75236880	0	54	7240	8469	7240	8415	0.0	0.8603683897801545
chr16	BCAR1	75264340	75264349	0	10	7240	8469	7240	8459	0.0	0.8558931315758364
chr16	TMEM170A	75464467	75464670	0	204	171706	5151	171706	4947	0.0	34.70911663634526
chr16	TMEM170A	75451668	75451736	0	69	171706	5151	171706	5082	0.0	33.78709169618261
chr16	TMEM231	75545825	75545862	0	38	15467	5614	15467	5576	0.0	2.773852223816356
chr16	ADAT1	75622791	75623236	1097	446	180100	4501	179003	4055	2.4596412556053813	44.14377311960543
chr16	KARS1	75647463	75647576	0	114	211095	3670	211095	3556	0.0	59.36304836895388
chr16	AC105430.1	75851426	75851429	0	4	0	737	0	733	0.0	0.0
chr16	ADAMTS18	77367436	77367439	0	4	2534	6624	2534	6620	0.0	0.38277945619335346
chr16	WWOX-AS1	78241193	78241196	0	4	102	1564	102	1560	0.0	0.06538461538461539
chr16	AC105411.1	80540604	80540848	0	245	0	7114	0	6869	0.0	0.0
chr16	LINC01227	80568815	80569223	0	409	0	3106	0	2697	0.0	0.0
chr16	LINC01227	80568806	80568814	0	9	0	3106	0	3097	0.0	0.0
chr16	LINC01227	80568806	80569223	0	418	0	3106	0	2688	0.0	0.0
chr16	ARLNC1	80831692	80831841	0	150	0	5783	0	5633	0.0	0.0
chr16	ARLNC1	80846456	80846658	0	203	0	5783	0	5580	0.0	0.0
chr16	ARLNC1	80837910	80837930	0	21	0	5783	0	5762	0.0	0.0
chr16	ARLNC1	80845630	80846658	0	1029	0	5783	0	4754	0.0	0.0
chr16	ARLNC1	80845630	80846455	0	826	0	5783	0	4957	0.0	0.0
chr16	ARLNC1	80845630	80846272	0	643	0	5783	0	5140	0.0	0.0
chr16	ARLNC1	80845630	80846092	0	463	0	5783	0	5320	0.0	0.0
chr16	MPHOSPH6	82164081	82164113	0	33	69	2011	69	1978	0.0	0.03488372093023256
chr16	MPHOSPH6	82170092	82170123	0	32	69	2011	69	1979	0.0	0.03486609398686205
chr16	AC009119.1	83804507	83805621	0	1115	0	5039	0	3924	0.0	0.0
chr16	SLC38A8	84042550	84042562	0	13	0	1990	0	1977	0.0	0.0
chr16	TAF1C	84183071	84183074	0	4	2163	4997	2163	4993	0.0	0.4332064890847186
chr16	LINC00917	86349550	86349573	0	24	0	5647	0	5623	0.0	0.0
chr16	LINC00917	86332958	86333686	0	729	0	5647	0	4918	0.0	0.0
chr16	MTHFSD	86555168	86555171	0	4	3209	6866	3209	6862	0.0	0.4676479160594579
chr16	MTHFSD	86551972	86552031	0	60	3209	6866	3209	6806	0.0	0.47149573905377606
chr16	LINC02189	86721695	86721898	0	204	51	902	51	698	0.0	0.07306590257879657
chr16	LINC02189	86721764	86721898	0	135	51	902	51	767	0.0	0.06649282920469361
chr16	LINC02189	86721695	86721763	0	69	51	902	51	833	0.0	0.061224489795918366
chr16	C16ORF95	87317086	87317089	0	4	378	3579	378	3575	0.0	0.10573426573426574
chr16	KLHDC4	87701553	87701636	0	84	38175	8827	38175	8743	0.0	4.366350223035571
chr16	KLHDC4	87756398	87756420	0	23	38175	8827	38175	8804	0.0	4.336097228532485
chr16	AC126696.3	87778807	87778985	987	179	34904	1276	33917	1097	5.5139664804469275	30.9179580674567
chr16	MVD	88657734	88657913	0	180	11030	4212	11030	4032	0.0	2.7356150793650795
chr16	RNF166	88702789	88703133	396	345	261054	4086	260658	3741	1.1478260869565218	69.67602245388933
chr16	PIEZO1	88715932	88715969	548	38	220564	10919	220016	10881	14.421052631578947	20.220200349232606
chr16	APRT	88811496	88811548	0	53	1087	1728	1087	1675	0.0	0.648955223880597
chr16	ANKRD11	89313316	89313349	0	34	29810	12643	29810	12609	0.0	2.36418431279245
chr16	CHMP1A	89649350	89649376	318	27	197850	5318	197532	5291	11.777777777777779	37.33358533358533
chr16	CHMP1A	89647034	89647201	13064	168	197850	5318	184786	5150	77.76190476190476	35.88077669902913
chr16	CHMP1A	89653798	89653902	3843	105	197850	5318	194007	5213	36.6	37.21599846537502
chr16	CHMP1A	89656632	89657580	21975	949	197850	5318	175875	4369	23.15595363540569	40.25520714122225
chr16	SPATA2L	89701490	89701626	0	137	0	2471	0	2334	0.0	0.0
chr16	FANCA	89739132	89739136	10	5	192118	7815	192108	7810	2.0	24.597695262483995
chr16	FANCA	89739128	89739131	56	4	192118	7815	192062	7811	14.0	24.58865702214825
chr16	FANCA	89739128	89739136	66	9	192118	7815	192052	7806	7.333333333333333	24.603125800666156
chr16	FANCA	89764806	89764888	0	83	192118	7815	192118	7732	0.0	24.847128815312985
chr16	FANCA	89769707	89769835	0	129	192118	7815	192118	7686	0.0	24.99583658600052
chr16	FANCA	89798950	89799164	1339	215	192118	7815	190779	7600	6.227906976744186	25.1025
chr16	FANCA	89799165	89799170	0	6	192118	7815	192118	7809	0.0	24.60212575233705
chr16	FANCA	89816079	89816535	80456	457	192118	7815	111662	7358	176.05251641137855	15.175591193259038
chr17	RPH3AL	352592	352710	0	119	2238	6091	2238	5972	0.0	0.37474882786336233
chr17	RPH3AL	338535	338864	0	330	2238	6091	2238	5761	0.0	0.38847422322513453
chr17	VPS53	553379	553431	0	53	142813	10943	142813	10890	0.0	13.114141414141415
chr17	GLOD4	778621	778693	10	73	979	3270	969	3197	0.136986301369863	0.3030966531122928
chr17	GLOD4	781862	782164	0	303	979	3270	979	2967	0.0	0.3299629255139872
chr17	NXN	805067	805208	0	142	63781	5509	63781	5367	0.0	11.88392025340041
chr17	NXN	863886	864013	0	128	63781	5509	63781	5381	0.0	11.853001300873444
chr17	ABR	1057843	1057968	74	126	28766	9793	28692	9667	0.5873015873015873	2.968035584979828
chr17	ABR	1078804	1078812	0	9	28766	9793	28766	9784	0.0	2.9401062959934587
chr17	CRK	1436619	1436788	934	170	826096	2531	825162	2361	5.4941176470588236	349.49682337992374
chr17	INPP5K	1515426	1515567	0	142	55804	5034	55804	4892	0.0	11.407195421095667
chr17	INPP5K	1509167	1509176	0	10	55804	5034	55804	5024	0.0	11.10748407643312
chr17	PITPNA	1562540	1562654	1555	115	432790	4776	431235	4661	13.521739130434783	92.51984552671101
chr17	PITPNA	1559507	1559754	102775	248	432790	4776	330015	4528	414.4153225806452	72.88317137809187
chr17	SLC43A2	1628080	1628112	0	33	1006389	10395	1006389	10362	0.0	97.12304574406485
chr17	SCARF1	1645559	1645595	0	37	78098	4563	78098	4526	0.0	17.255413168360583
chr17	MIR22HG	1713702	1713854	0	153	6531	2975	6531	2822	0.0	2.3143160878809357
chr17	TSR1	2335259	2335306	0	48	324113	4816	324113	4768	0.0	67.97671979865771
chr17	CLUH	2711561	2711716	0	156	89	6845	89	6689	0.0	0.01330542682015249
chr17	OR1D2	3104098	3104102	0	5	0	1315	0	1310	0.0	0.0
chr17	AC090282.1	3176790	3176874	0	85	0	712	0	627	0.0	0.0
chr17	SPATA22	3467425	3467472	53	48	54004	2625	53951	2577	1.1041666666666667	20.93558401241754
chr17	SPATA22	3471582	3471680	87	99	54004	2625	53917	2526	0.8787878787878788	21.34481393507522
chr17	SPATA22	3471582	3471722	122	141	54004	2625	53882	2484	0.8652482269503546	21.691626409017715
chr17	SPATA22	3471681	3471744	57	64	54004	2625	53947	2561	0.890625	21.064818430300665
chr17	SPATA22	3471681	3471722	35	42	54004	2625	53969	2583	0.8333333333333334	20.89392179636082
chr17	SPATA22	3471723	3471744	22	22	54004	2625	53982	2603	1.0	20.738378793699578
chr17	SPATA22	3471723	3471865	31	143	54004	2625	53973	2482	0.21678321678321677	21.74576954069299
chr17	TRPV3	3513411	3513609	25337	199	322103	9617	296766	9418	127.321608040201	31.510511785941812
chr17	SPATA22	3471430	3471581	153	152	54004	2625	53851	2473	1.006578947368421	21.775576223210674
chr17	SPATA22	3471430	3471680	240	251	54004	2625	53764	2374	0.9561752988047809	22.647009267059815
chr17	SPATA22	3471430	3471722	275	293	54004	2625	53729	2332	0.9385665529010239	23.039879931389365
chr17	SPATA22	3471745	3471865	9	121	54004	2625	53995	2504	0.0743801652892562	21.56349840255591
chr17	TRPV1	3588187	3588216	0	30	1427330	5538	1427330	5508	0.0	259.13761801016705
chr17	ATP2A3	3928226	3928238	718	13	87282	6298	86564	6285	55.23076923076923	13.773110580747812
chr17	ZZEF1	4070683	4070809	47117	127	263654	14559	216537	14432	371.0	15.00394955654102
chr17	AC127521.1	4483451	4483530	0	80	51	1062	51	982	0.0	0.051934826883910386
chr17	PELP1	4676356	4676499	0	144	1173	6512	1173	6368	0.0	0.18420226130653267
chr17	VMO1	4785936	4785955	0	20	794	806	794	786	0.0	1.0101781170483461
chr17	VMO1	4785900	4785935	536	36	794	806	258	770	14.88888888888889	0.33506493506493507
chr17	VMO1	4785900	4785955	536	56	794	806	258	750	9.571428571428571	0.344
chr17	CHRNE	4901931	4901977	204	47	14335	3533	14131	3486	4.340425531914893	4.05364314400459
chr17	SLC25A11	4939815	4939847	0	33	287	1758	287	1725	0.0	0.1663768115942029
chr17	INCA1	4996840	4997001	6643	162	20310	1562	13667	1400	41.00617283950617	9.762142857142857
chr17	ZNF232	5109393	5109709	0	317	1045	2800	1045	2483	0.0	0.4208618606524366
chr17	ZNF594	5191431	5191746	510	316	510	5302	0	4986	1.6139240506329113	0.0
chr17	SCIMP	5223332	5223352	0	21	3039	4255	3039	4234	0.0	0.7177609825224374
chr17	C1QBP	5438491	5438707	0	217	1683	2090	1683	1873	0.0	0.8985584623598505
chr17	DERL2	5486068	5486115	955	48	1154	5129	199	5081	19.895833333333332	0.03916551859870104
chr17	DERL2	5485862	5486067	232	206	1154	5129	922	4923	1.1262135922330097	0.18728417631525493
chr17	DERL2	5485862	5486115	1187	254	1154	5129	-33	4875	4.673228346456693	-0.00676923076923077
chr17	NLRP1	5533291	5533302	0	12	867	11515	867	11503	0.0	0.07537164218030079
chr17	AIPL1	6434950	6435007	0	58	102	3150	102	3092	0.0	0.032988357050452784
chr17	SLC13A5	6707027	6707030	4	4	36	5209	32	5205	1.0	0.006147934678194044
chr17	CLEC10A	7075975	7075983	0	9	2548	2340	2548	2331	0.0	1.093093093093093
chr17	ASGR2	7108756	7108770	0	15	32670	2445	32670	2430	0.0	13.444444444444445
chr17	ASGR2	7114116	7114172	98	57	32670	2445	32572	2388	1.719298245614035	13.639865996649917
chr17	DLG4	7208074	7208172	0	99	295145	9775	295145	9676	0.0	30.502790409260026
chr17	DVL2	7230045	7230056	1552	12	294605	4256	293053	4244	129.33333333333334	69.05113100848256
chr17	PHF23	7238785	7238799	0	15	437	2660	437	2645	0.0	0.16521739130434782
chr17	GABARAP	7241600	7242239	0	640	0	1609	0	969	0.0	0.0
chr17	CTDNEP1	7244101	7244187	0	87	804	2647	804	2560	0.0	0.3140625
chr17	CLDN7	7261820	7261845	0	26	51	2285	51	2259	0.0	0.02257636122177955
chr17	YBX2	7294229	7294566	10	338	130173	2588	130163	2250	0.029585798816568046	57.85022222222222
chr17	NEURL4	7324798	7324909	105	112	684454	6057	684349	5945	0.9375	115.11337258200169
chr17	NEURL4	7322947	7322952	5277	6	684454	6057	679177	6051	879.5	112.24210874235663
chr17	FXR2	7614451	7614789	61447	339	268315	4035	206868	3696	181.25958702064898	55.97077922077922
chr17	FXR2	7606015	7606095	5293	81	268315	4035	263022	3954	65.34567901234568	66.52048558421852
chr17	SAT2	7627556	7627568	0	13	0	1405	0	1392	0.0	0.0
chr17	SAT2	7626706	7626751	0	46	0	1405	0	1359	0.0	0.0
chr17	NAA38	7856984	7857013	0	30	2002	1833	2002	1803	0.0	1.110371602884082
chr17	KCNAB3	7929096	7929343	0	248	17880	4331	17880	4083	0.0	4.3791329904482
chr17	TRAPPC1	7931927	7931938	0	12	0	1175	0	1163	0.0	0.0
chr17	PER1	8144750	8144758	0	9	43786	6344	43786	6335	0.0	6.911760063141279
chr17	VAMP2	8162443	8162876	327	434	370771	3246	370444	2812	0.7534562211981567	131.73684210526315
chr17	TMEM107	8174519	8174539	854	21	862526	3772	861672	3751	40.666666666666664	229.71794188216475
chr17	AURKB	8205215	8205316	0	102	818	2119	818	2017	0.0	0.40555280118988596
chr17	CTC1	8229301	8229333	0	33	570	8044	570	8011	0.0	0.07115216577206342
chr17	SLC25A35	8290602	8290613	0	12	807	3447	807	3435	0.0	0.2349344978165939
chr17	RPL26	8383141	8383155	81	15	57869	2188	57788	2173	5.4	26.593649332719743
chr17	RPL26	8382780	8383140	1546	361	57869	2188	56323	1827	4.282548476454294	30.828133552271485
chr17	RPL26	8382780	8383155	1627	376	57869	2188	56242	1812	4.327127659574468	31.038631346578367
chr17	RPL26	8382780	8382860	541	81	57869	2188	57328	2107	6.679012345679013	27.208353108685333
chr17	RPL26	8382861	8383140	1005	280	57869	2188	56864	1908	3.5892857142857144	29.80293501048218
chr17	RPL26	8382861	8383155	1086	295	57869	2188	56783	1893	3.68135593220339	29.996302165874273
chr17	RPL26	8382774	8382779	6	6	57869	2188	57863	2182	1.0	26.51833180568286
chr17	RPL26	8382774	8382860	547	87	57869	2188	57322	2101	6.287356321839081	27.283198476915754
chr17	SPDYE4	8758268	8758272	0	5	51	1069	51	1064	0.0	0.047932330827067667
chr17	PIK3R6	8837802	8837817	0	16	0	3586	0	3570	0.0	0.0
chr17	PIK3R6	8838295	8838562	0	268	0	3586	0	3318	0.0	0.0
chr17	GAS7	10036433	10036450	0	18	131	3981	131	3963	0.0	0.03305576583396417
chr17	SCO1	10692763	10692855	0	93	51	10307	51	10214	0.0	0.004993146661445075
chr17	ELAC2	13002440	13002444	0	5	408	6704	408	6699	0.0	0.06090461262875056
chr17	ELAC2	13010612	13010616	0	5	408	6704	408	6699	0.0	0.06090461262875056
chr17	ELAC2	13017702	13017989	0	288	408	6704	408	6416	0.0	0.06359102244389027
chr17	ELAC2	13003449	13003477	0	29	408	6704	408	6675	0.0	0.06112359550561798
chr17	ELAC2	13017566	13017580	0	15	408	6704	408	6689	0.0	0.06099566452384512
chr17	ELAC2	13017496	13017565	0	70	408	6704	408	6634	0.0	0.061501356647573106
chr17	ELAC2	13017496	13017580	0	85	408	6704	408	6619	0.0	0.06164073122828222
chr17	ELAC2	13017412	13017565	0	154	408	6704	408	6550	0.0	0.06229007633587786
chr17	ELAC2	13017412	13017580	0	169	408	6704	408	6535	0.0	0.06243305279265494
chr17	ELAC2	13017412	13017495	0	84	408	6704	408	6620	0.0	0.06163141993957704
chr17	COX10-AS1	14033551	14033938	0	388	0	11234	0	10846	0.0	0.0
chr17	COX10-AS1	14033551	14034006	0	456	0	11234	0	10778	0.0	0.0
chr17	COX10-AS1	14033939	14034006	0	68	0	11234	0	11166	0.0	0.0
chr17	CDRT15	14236571	14236694	0	124	0	782	0	658	0.0	0.0
chr17	PMP22	15262428	15263063	0	636	0	6135	0	5499	0.0	0.0
chr17	PMP22	15262424	15262427	0	4	0	6135	0	6131	0.0	0.0
chr17	PMP22	15271671	15271694	0	24	0	6135	0	6111	0.0	0.0
chr17	TVP23C	15553684	15553763	352	80	44612	5447	44260	5367	4.4	8.246692752002982
chr17	TRIM16	15682853	15682859	0	7	5359	4831	5359	4824	0.0	1.1109038142620231
chr17	ZSWIM7	15999502	15999504	3	3	6388	2082	6385	2079	1.0	3.0711880711880712
chr17	ZSWIM7	15999502	15999517	16	16	6388	2082	6372	2066	1.0	3.0842207163601163
chr17	ZSWIM7	15999505	15999517	13	13	6388	2082	6375	2069	1.0	3.081198646689222
chr17	ZSWIM7	15999518	15999658	1412	141	6388	2082	4976	1941	10.01418439716312	2.5636269963936114
chr17	ZSWIM7	15999502	15999658	1428	157	6388	2082	4960	1925	9.095541401273886	2.5766233766233766
chr17	ZSWIM7	15999505	15999658	1425	154	6388	2082	4963	1928	9.253246753246753	2.574170124481328
chr17	NCOR1	16046950	16046988	1919	39	77691	14501	75772	14462	49.205128205128204	5.239385977043286
chr17	NCOR1	16061400	16061756	0	357	77691	14501	77691	14144	0.0	5.492859162895928
chr17	ZNF287	16568749	16568950	0	202	1967	7922	1967	7720	0.0	0.2547927461139896
chr17	ZNF624	16653567	16653762	0	196	9244	5100	9244	4904	0.0	1.8849918433931485
chr17	KRT16P6	16820646	16820657	0	12	0	1817	0	1805	0.0	0.0
chr17	KRT16P6	16820618	16820645	0	28	0	1817	0	1789	0.0	0.0
chr17	KRT16P6	16820618	16820657	0	40	0	1817	0	1777	0.0	0.0
chr17	KRT17P4	16852298	16852325	0	28	0	2302	0	2274	0.0	0.0
chr17	TBC1D27P	16929520	16929828	0	309	51	4955	51	4646	0.0	0.010977184674989237
chr17	TBC1D27P	16930308	16930371	51	64	51	4955	0	4891	0.796875	0.0
chr17	TBC1D27P	16932782	16932785	0	4	51	4955	51	4951	0.0	0.010300949303171077
chr17	PEMT	17591530	17591595	51	66	302	1735	251	1669	0.7727272727272727	0.15038945476333135
chr17	SREBF1	17819537	17819542	0	6	14378	6629	14378	6623	0.0	2.17091952287483
chr17	SREBF1	17817547	17817694	220	148	14378	6629	14158	6481	1.4864864864864864	2.1845394229285606
chr17	FLII	18245743	18245836	0	94	143447	5686	143447	5592	0.0	25.652181688125893
chr17	FLII	18253543	18253597	0	55	143447	5686	143447	5631	0.0	25.474516071745693
chr17	TOP3A	18290539	18290555	0	17	800	5240	800	5223	0.0	0.15316867700555237
chr17	TOP3A	18308312	18308349	0	38	800	5240	800	5202	0.0	0.15378700499807765
chr17	TOP3A	18308312	18308411	0	100	800	5240	800	5140	0.0	0.1556420233463035
chr17	TOP3A	18308350	18308411	0	62	800	5240	800	5178	0.0	0.1544998068752414
chr17	FAM106A	18521059	18521077	0	19	4864	8673	4864	8654	0.0	0.5620522301825746
chr17	FAM106A	18523776	18524141	369	366	4864	8673	4495	8307	1.0081967213114753	0.5411099073070904
chr17	FAM106A	18523650	18523775	141	126	4864	8673	4723	8547	1.119047619047619	0.5525915525915526
chr17	FOXO3B	18681393	18681613	0	221	1441	6171	1441	5950	0.0	0.24218487394957983
chr17	B9D1	19362506	19362598	0	93	785	6772	785	6679	0.0	0.11753256475520288
chr17	MFAP4	19387040	19387148	0	109	153	1919	153	1810	0.0	0.08453038674033149
chr17	ALDH3A1	19744967	19744996	0	30	995	3484	995	3454	0.0	0.2880718008106543
chr17	ALDH3A1	19747901	19747934	0	34	995	3484	995	3450	0.0	0.28840579710144926
chr17	ALDH3A1	19747935	19748257	0	323	995	3484	995	3161	0.0	0.3147738057576716
chr17	KRT17P7	20521595	20522065	51	471	2499	2635	2448	2164	0.10828025477707007	1.1312384473197783
chr17	CCDC144NL	20866547	20866574	0	28	0	3361	0	3333	0.0	0.0
chr17	USP22	21043320	21043624	0	305	427	4014	427	3709	0.0	0.11512537071987058
chr17	NOS2	27781035	27781109	0	75	687	4427	687	4352	0.0	0.15785845588235295
chr17	KRT18P55	28306975	28307030	0	56	663	2032	663	1976	0.0	0.3355263157894737
chr17	PIGS	28571048	28571461	306	414	306	4809	0	4395	0.7391304347826086	0.0
chr17	PIGS	28570851	28571047	0	197	306	4809	306	4612	0.0	0.0663486556808326
chr17	ALDOC	28575964	28576278	45152	315	153368	2363	108216	2048	143.33968253968254	52.83984375
chr17	SPAG5	28598464	28598508	338	45	4663	4721	4325	4676	7.511111111111111	0.9249358426005133
chr17	RSKR	28613077	28613088	12	12	79625	6992	79613	6980	1.0	11.405873925501433
chr17	PROCA1	28706676	28706678	266	3	9951	3553	9685	3550	88.66666666666667	2.728169014084507
chr17	RAB34	28715194	28715217	0	24	816	3005	816	2981	0.0	0.27373364642737336
chr17	RAB34	28715027	28715030	0	4	816	3005	816	3001	0.0	0.27190936354548484
chr17	FAM222B	28812157	28812207	0	51	14290	5523	14290	5472	0.0	2.6114766081871346
chr17	FLOT2	28883107	28883175	0	69	0	3397	0	3328	0.0	0.0
chr17	PHF12	28950894	28951465	1915	572	4355	6230	2440	5658	3.347902097902098	0.43124779073877695
chr17	GIT1	29577135	29577182	288	48	5346	5400	5058	5352	6.0	0.945067264573991
chr17	BLMH	30291806	30291912	146	107	4080	5133	3934	5026	1.3644859813084111	0.7827298050139275
chr17	BLMH	30291179	30291309	51	131	4080	5133	4029	5002	0.3893129770992366	0.8054778088764494
chr17	COPRS	31858757	31858823	0	67	0	1318	0	1251	0.0	0.0
chr17	C17ORF75	32341800	32341861	0	62	0	5756	0	5694	0.0	0.0
chr17	RAD51D	35119531	35119698	0	168	153	11317	153	11149	0.0	0.013723203874786977
chr17	NLE1	35139819	35139847	0	29	0	5488	0	5459	0.0	0.0
chr17	SLFN11	35362738	35362765	0	28	2457	4258	2457	4230	0.0	0.5808510638297872
chr17	SLFN11	35367602	35367648	20	47	2457	4258	2437	4211	0.425531914893617	0.5787223937307053
chr17	SLFN11	35373473	35373580	0	108	2457	4258	2457	4150	0.0	0.5920481927710843
chr17	SLFN11	35367540	35367601	0	62	2457	4258	2457	4196	0.0	0.5855576739752145
chr17	SLFN11	35367540	35367648	20	109	2457	4258	2437	4149	0.1834862385321101	0.5873704507110147
chr17	SLFN13	35445372	35445654	0	283	63464	9056	63464	8773	0.0	7.234013450359056
chr17	GAS2L2	35750153	35750153	3	1	5601	3381	5598	3380	3.0	1.6562130177514793
chr17	HEATR9	35864757	35864876	0	120	6406	2944	6406	2824	0.0	2.268413597733711
chr17	HEATR9	35865214	35865217	0	4	6406	2944	6406	2940	0.0	2.1789115646258503
chr17	HEATR9	35862950	35862993	0	44	6406	2944	6406	2900	0.0	2.208965517241379
chr17	HEATR9	35868566	35868653	0	88	6406	2944	6406	2856	0.0	2.242997198879552
chr17	RDM1	35930075	35930630	0	556	1556	1650	1556	1094	0.0	1.4223034734917732
chr17	CCL14	35984333	35984336	0	4	14964	1206	14964	1202	0.0	12.449251247920133
chr17	CCL23	36013631	36013742	0	112	51	746	51	634	0.0	0.0804416403785489
chr17	MYO19	36512873	36513427	1224	555	10987	11489	9763	10934	2.2054054054054055	0.8929028717761112
chr17	MYO19	36508896	36509060	347	165	10987	11489	10640	11324	2.103030303030303	0.9395973154362416
chr17	MYO19	36534672	36534759	336	88	10987	11489	10651	11401	3.8181818181818183	0.9342162968160688
chr17	MYO19	36534672	36534682	132	11	10987	11489	10855	11478	12.0	0.9457222512632862
chr17	MYO19	36534683	36534759	204	77	10987	11489	10783	11412	2.6493506493506493	0.944882579740624
chr17	SYNRG	37577379	37577445	0	67	13477	8725	13477	8658	0.0	1.5565950565950566
chr17	SYNRG	37609278	37609366	0	89	13477	8725	13477	8636	0.0	1.560560444650301
chr17	NPEPPSP1	38202735	38202779	0	45	2326	1700	2326	1655	0.0	1.4054380664652568
chr17	PCGF2	38738748	38738751	0	4	0	2284	0	2280	0.0	0.0
chr17	CWC25	38825165	38825268	0	104	340	3726	340	3622	0.0	0.09387078961899503
chr17	CWC25	38810275	38810466	0	192	340	3726	340	3534	0.0	0.09620826259196379
chr17	RPL23	38853301	38853357	0	57	0	5524	0	5467	0.0	0.0
chr17	PLXDC1	39152468	39152544	0	77	51	9280	51	9203	0.0	0.005541671194175812
chr17	STAC2	39217866	39218067	0	202	102	3441	102	3239	0.0	0.031491200987959246
chr17	ORMDL3	39924029	39924076	0	48	26533	2853	26533	2805	0.0	9.459180035650624
chr17	KRT222	40664921	40665002	1243	82	24107	3031	22864	2949	15.158536585365853	7.7531366564937265
chr17	SMARCE1	40642117	40642453	0	337	93994	10517	93994	10180	0.0	9.23320235756385
chr17	SMARCE1	40642117	40642163	0	47	93994	10517	93994	10470	0.0	8.977459407831901
chr17	KRT10	40818766	40818785	3016	20	121505	2171	118489	2151	150.8	55.08554160855416
chr17	KRT23	40937127	40937344	428	218	102686	2919	102258	2701	1.963302752293578	37.85931136616068
chr17	KRT19	41527827	41527919	0	93	35	2153	35	2060	0.0	0.01699029126213592
chr17	KRT42P	41628604	41629074	0	471	1439	4308	1439	3837	0.0	0.3750325775345322
chr17	HAP1	41732694	41732717	21	24	251	2283	230	2259	0.875	0.1018149623727313
chr17	JUP	41786502	41786586	0	85	51	4876	51	4791	0.0	0.010644959298685034
chr17	NT5C3B	41836078	41836180	0	103	0	2859	0	2756	0.0	0.0
chr17	DNAJC7	41997114	41997135	0	22	408	9268	408	9246	0.0	0.04412719013627515
chr17	DNAJC7	42017039	42017050	0	12	408	9268	408	9256	0.0	0.04407951598962835
chr17	DNAJC7	41982245	41982253	0	9	408	9268	408	9259	0.0	0.044065233826547145
chr17	DNAJC7	41982245	41982248	0	4	408	9268	408	9264	0.0	0.04404145077720207
chr17	DNAJC7	42016586	42017038	0	453	408	9268	408	8815	0.0	0.046284741917186616
chr17	DNAJC7	42016586	42017050	0	465	408	9268	408	8803	0.0	0.04634783596501193
chr17	DNAJC7	41982249	41982253	0	5	408	9268	408	9263	0.0	0.04404620533304545
chr17	ZNF385C	42027617	42027631	0	15	73	5209	73	5194	0.0	0.01405467847516365
chr17	DHX58	42111724	42111744	0	21	98558	3749	98558	3728	0.0	26.43723175965665
chr17	KAT2A	42114891	42114952	990	62	191161	3583	190171	3521	15.96774193548387	54.010508378301616
chr17	KAT2A	42119053	42119243	518	191	191161	3583	190643	3392	2.712041884816754	56.203714622641506
chr17	RAB5C	42136264	42136339	204	76	2001	2590	1797	2514	2.6842105263157894	0.7147971360381862
chr17	KCNH4	42159730	42159733	0	4	22518	3805	22518	3801	0.0	5.92423046566693
chr17	GHDC	42194392	42194415	0	24	969	3702	969	3678	0.0	0.2634584013050571
chr17	STAT3	42322281	42322283	0	3	684	9674	684	9671	0.0	0.07072691552062868
chr17	STAT3	42323259	42323285	0	27	684	9674	684	9647	0.0	0.0709028713589717
chr17	STAT3	42323452	42323571	0	120	684	9674	684	9554	0.0	0.07159305003140046
chr17	PSMC3IP	42574098	42574194	0	97	703	2585	703	2488	0.0	0.282556270096463
chr17	PSMC3IP	42577079	42577211	40	133	703	2585	663	2452	0.3007518796992481	0.2703915171288744
chr17	PSMC3IP	42573818	42574097	0	280	703	2585	703	2305	0.0	0.3049891540130152
chr17	PSMC3IP	42573818	42574194	0	377	703	2585	703	2208	0.0	0.3183876811594203
chr17	RETREG3	42608659	42609084	357	426	2779	4732	2422	4306	0.8380281690140845	0.5624709707385044
chr17	PLEKHH3	42670993	42671001	0	9	102	3655	102	3646	0.0	0.027975863960504662
chr17	PLEKHH3	42669917	42669941	0	25	102	3655	102	3630	0.0	0.02809917355371901
chr17	EZH1	42727634	42727660	0	27	482	6587	482	6560	0.0	0.07347560975609756
chr17	BECN1	42824132	42824153	170	22	38488	5109	38318	5087	7.7272727272727275	7.532533909966581
chr17	BECN1	42823704	42823746	56	43	38488	5109	38432	5066	1.302325581395349	7.586261350177655
chr17	AARSD1	42951799	42951799	1	1	100248	2950	100247	2949	1.0	33.99355713801289
chr17	AARSD1	42964401	42964441	184	41	100248	2950	100064	2909	4.487804878048781	34.39807493984187
chr17	PTGES3L-AARSD1	42979549	42979626	0	78	33710	2312	33710	2234	0.0	15.08952551477171
chr17	VAT1	43021935	43022138	6642	204	85476	3313	78834	3109	32.55882352941177	25.356706336442585
chr17	BRCA1	43091434	43094742	510	3309	26109	8555	25599	5246	0.1541251133272892	4.8797178802897445
chr17	BRCA1	43106455	43106476	158	22	26109	8555	25951	8533	7.181818181818182	3.04125161139107
chr17	BRCA1	43125270	43125275	36	6	26109	8555	26073	8549	6.0	3.0498303895192422
chr17	BRCA1	43125181	43125269	60	89	26109	8555	26049	8466	0.6741573033707865	3.0768958185683912
chr17	BRCA1	43125181	43125275	96	95	26109	8555	26013	8460	1.0105263157894737	3.074822695035461
chr17	BRCA1	43124736	43125269	60	534	26109	8555	26049	8021	0.11235955056179775	3.2476000498690936
chr17	BRCA1	43124736	43125275	96	540	26109	8555	26013	8015	0.17777777777777778	3.2455396132252026
chr17	BRCA1	43124736	43125180	0	445	26109	8555	26109	8110	0.0	3.2193588162762024
chr17	AC060780.1	43159422	43159465	132	44	58621	6052	58489	6008	3.0	9.735186418109187
chr17	CCDC200	43224163	43224232	561	70	96869	3210	96308	3140	8.014285714285714	30.671337579617834
chr17	CCDC200	43224163	43224353	867	191	96869	3210	96002	3019	4.539267015706806	31.799271281881417
chr17	CCDC200	43224111	43224162	0	52	96869	3210	96869	3158	0.0	30.674160861304625
chr17	CCDC200	43224111	43224232	561	122	96869	3210	96308	3088	4.598360655737705	31.18782383419689
chr17	CCDC200	43224111	43224353	867	243	96869	3210	96002	2967	3.567901234567901	32.35658914728682
chr17	CCDC200	43228768	43228960	28080	193	96869	3210	68789	3017	145.49222797927462	22.80046403712297
chr17	CCDC200	43224233	43224353	306	121	96869	3210	96563	3089	2.5289256198347108	31.260278407251537
chr17	LINC00910	43388288	43388289	0	2	248238	8593	248238	8591	0.0	28.8951228029333
chr17	LINC00910	43388288	43388503	1321	216	248238	8593	246917	8377	6.1157407407407405	29.475587919302853
chr17	LINC00910	43387935	43388287	1836	353	248238	8593	246402	8240	5.201133144475921	29.903155339805824
chr17	LINC00910	43387935	43388289	1836	355	248238	8593	246402	8238	5.171830985915493	29.910415149308083
chr17	DUSP3	43773973	43774033	0	61	0	4997	0	4936	0.0	0.0
chr17	MPP2	43898261	43898278	0	18	67	6133	67	6115	0.0	0.010956663941128373
chr17	MPP2	43907212	43907472	0	261	67	6133	67	5872	0.0	0.01141008174386921
chr17	MPP2	43907209	43907211	0	3	67	6133	67	6130	0.0	0.010929853181076673
chr17	MPP2	43907128	43907208	0	81	67	6133	67	6052	0.0	0.011070720423000661
chr17	MPP2	43907128	43907211	0	84	67	6133	67	6049	0.0	0.011076210943957679
chr17	MPP2	43898243	43898260	0	18	67	6133	67	6115	0.0	0.010956663941128373
chr17	MPP2	43898243	43898278	0	36	67	6133	67	6097	0.0	0.01098901098901099
chr17	TMEM101	44014815	44014982	0	168	0	3037	0	2869	0.0	0.0
chr17	HDAC5	44123253	44123502	1345	250	3691	7417	2346	7167	5.38	0.3273336123901214
chr17	UBTF	44207698	44207701	12	4	5940	6885	5928	6881	3.0	0.861502688562709
chr17	FAM171A2	44358944	44359060	0	117	357	3579	357	3462	0.0	0.10311958405545928
chr17	GFAP	44903958	44904440	0	483	51	7492	51	7009	0.0	0.007276358967042374
chr17	GFAP	44910091	44910613	0	523	51	7492	51	6969	0.0	0.007318123116659492
chr17	GFAP	44910091	44910224	0	134	51	7492	51	7358	0.0	0.006931231312856755
chr17	GFAP	44910091	44910139	0	49	51	7492	51	7443	0.0	0.0068520757758968156
chr17	GFAP	44910140	44910224	0	85	51	7492	51	7407	0.0	0.00688537869582827
chr17	DCAKD	45051360	45051551	0	192	102	2808	102	2616	0.0	0.0389908256880734
chr17	PLCD3	45115093	45115141	0	49	25902	6647	25902	6598	0.0	3.9257350712337074
chr17	ARHGAP27	45404923	45405026	0	104	3970	10105	3970	10001	0.0	0.396960303969603
chr17	ARHGAP27	45405675	45405845	0	171	3970	10105	3970	9934	0.0	0.3996376082142138
chr17	PLEKHM1	45477899	45478099	0	201	30369	9251	30369	9050	0.0	3.3556906077348065
chr17	PLEKHM1	45440026	45440161	0	136	30369	9251	30369	9115	0.0	3.3317608337904554
chr17	PLEKHM1	45477804	45477898	0	95	30369	9251	30369	9156	0.0	3.3168414154652686
chr17	PLEKHM1	45477804	45478099	0	296	30369	9251	30369	8955	0.0	3.3912897822445562
chr17	MAPT-AS1	45894611	45895478	2550	868	3836	7365	1286	6497	2.9377880184331797	0.19793750961982454
chr17	AC005670.3	47033277	47033318	0	42	436388	10495	436388	10453	0.0	41.74763225868172
chr17	AC005670.3	47056455	47056458	0	4	436388	10495	436388	10491	0.0	41.596415975598134
chr17	CDC27	47189145	47189259	0	115	198	6557	198	6442	0.0	0.030735796336541447
chr17	MRPL10	47831310	47831458	0	149	731	2777	731	2628	0.0	0.278158295281583
chr17	SCRN2	47838269	47838334	0	66	861	3004	861	2938	0.0	0.2930565010211028
chr17	SCRN2	47841184	47841206	0	23	861	3004	861	2981	0.0	0.2888292519288829
chr17	SP2-AS1	47941335	47941345	0	11	12607	2536	12607	2525	0.0	4.992871287128713
chr17	CBX1	48075988	48075999	0	12	1124	3053	1124	3041	0.0	0.36961525813877016
chr17	TTLL6	48787788	48787809	0	22	38468	5118	38468	5096	0.0	7.548665620094192
chr17	SNF8	48937019	48937107	0	89	27396	4805	27396	4716	0.0	5.809160305343512
chr17	SNF8	48936130	48936168	0	39	27396	4805	27396	4766	0.0	5.7482165337809485
chr17	SNF8	48936854	48937018	0	165	27396	4805	27396	4640	0.0	5.904310344827586
chr17	GNGT2	49209206	49209351	0	146	51	1694	51	1548	0.0	0.03294573643410853
chr17	GNGT2	49209206	49209241	0	36	51	1694	51	1658	0.0	0.030759951749095297
chr17	GNGT2	49209242	49209351	0	110	51	1694	51	1584	0.0	0.032196969696969696
chr17	PHOSPHO1	49230467	49230575	0	109	83	2397	83	2288	0.0	0.036276223776223776
chr17	ZNF652	49316825	49317364	1246	540	14546	11753	13300	11213	2.3074074074074074	1.1861232497993401
chr17	PHB	49414741	49414746	0	6	255	5014	255	5008	0.0	0.0509185303514377
chr17	PHB	49414741	49414742	0	2	255	5014	255	5012	0.0	0.05087789305666401
chr17	PHB	49414747	49414833	0	87	255	5014	255	4927	0.0	0.05175563223056627
chr17	PHB	49414739	49414740	0	2	255	5014	255	5012	0.0	0.05087789305666401
chr17	PHB	49414739	49414833	0	95	255	5014	255	4919	0.0	0.051839804838381784
chr17	PHB	49414739	49414746	0	8	255	5014	255	5006	0.0	0.05093887335197763
chr17	PHB	49414739	49414742	0	4	255	5014	255	5010	0.0	0.05089820359281437
chr17	PHB	49414743	49414833	0	91	255	5014	255	4923	0.0	0.0517976843388178
chr17	PHB	49414743	49414746	0	4	255	5014	255	5010	0.0	0.05089820359281437
chr17	SLC35B1	49707729	49708074	0	346	340	5087	340	4741	0.0	0.07171482809533854
chr17	FAM117A	49788496	49788500	0	5	0	3816	0	3811	0.0	0.0
chr17	TAC4	49847894	49847911	0	18	0	1002	0	984	0.0	0.0
chr17	CHAD	50465282	50465292	0	11	962	1735	962	1724	0.0	0.5580046403712297
chr17	CACNA1G-AS1	50559304	50559326	0	23	0	1559	0	1536	0.0	0.0
chr17	MBTD1	51192657	51192780	0	124	0	6681	0	6557	0.0	0.0
chr17	TRIM25	56891354	56891362	0	9	435	6852	435	6843	0.0	0.06356861025865848
chr17	MRPS23	57849838	57849965	0	128	969	6256	969	6128	0.0	0.1581266318537859
chr17	SRSF1	58005397	58005412	0	16	9305	2405	9305	2389	0.0	3.8949351192967767
chr17	SRSF1	58006906	58006942	0	37	9305	2405	9305	2368	0.0	3.9294763513513513
chr17	MKS1	58206464	58207083	2244	620	30663	8985	28419	8365	3.6193548387096772	3.397369994022714
chr17	RNF43	58415325	58417015	102	1691	408	5286	306	3595	0.06031933767001774	0.0851182197496523
chr17	SUPT4H1	58352064	58352065	0	2	1	2085	1	2083	0.0	0.00048007681228996637
chr17	SUPT4H1	58352023	58352065	0	43	1	2085	1	2042	0.0	0.0004897159647404506
chr17	SUPT4H1	58352023	58352063	0	41	1	2085	1	2044	0.0	0.0004892367906066536
chr17	SEPTIN4	58526681	58526765	0	85	59483	6797	59483	6712	0.0	8.862187127532778
chr17	SEPTIN4	58526681	58526930	0	250	59483	6797	59483	6547	0.0	9.085535359706736
chr17	SEPTIN4	58542625	58544269	16306	1645	59483	6797	43177	5152	9.912462006079027	8.380628881987578
chr17	SEPTIN4	58526766	58526930	0	165	59483	6797	59483	6632	0.0	8.969089264173704
chr17	SKA2	59154955	59155129	0	175	2668	3064	2668	2889	0.0	0.923502942194531
chr17	SKA2	59119298	59119317	0	20	2668	3064	2668	3044	0.0	0.8764783180026281
chr17	RNFT1	59962826	59962930	0	105	9788	3189	9788	3084	0.0	3.173800259403372
chr17	TBC1D3P1-DHX40P1	60001516	60001668	0	153	3145	1855	3145	1702	0.0	1.8478260869565217
chr17	WFDC21P	60085054	60085101	0	48	10833	1104	10833	1056	0.0	10.258522727272727
chr17	WFDC21P	60085054	60085111	0	58	10833	1104	10833	1046	0.0	10.3565965583174
chr17	WFDC21P	60085102	60085111	0	10	10833	1104	10833	1094	0.0	9.902193784277879
chr17	AC025048.2	60128955	60128991	0	37	204	3106	204	3069	0.0	0.06647116324535679
chr17	AC025048.2	60135085	60135095	0	11	204	3106	204	3095	0.0	0.06591276252019386
chr17	AC025048.2	60128535	60128539	0	5	204	3106	204	3101	0.0	0.06578523057078361
chr17	USP32	60219627	60219668	0	42	16691	9563	16691	9521	0.0	1.7530721562861045
chr17	TBX2-AS1	61399036	61399237	0	202	0	1010	0	808	0.0	0.0
chr17	INTS2	61927653	61927933	0	281	722087	8387	722087	8106	0.0	89.08055761164569
chr17	INTS2	61927653	61927920	0	268	722087	8387	722087	8119	0.0	88.93792338957999
chr17	INTS2	61927921	61927933	0	13	722087	8387	722087	8374	0.0	86.22963935992357
chr17	TBC1D3P2	62270916	62270968	4764	53	29879	2130	25115	2077	89.88679245283019	12.091959557053443
chr17	CYB561	63436006	63436052	0	47	51	4066	51	4019	0.0	0.012689723811893506
chr17	CYB561	63438022	63438039	0	18	51	4066	51	4048	0.0	0.012598814229249012
chr17	STRADA	63713405	63713458	0	54	1296	9568	1296	9514	0.0	0.1362203069161236
chr17	STRADA	63704340	63704430	0	91	1296	9568	1296	9477	0.0	0.13675213675213677
chr17	STRADA	63728333	63728356	0	24	1296	9568	1296	9544	0.0	0.1357921207041073
chr17	STRADA	63741453	63741739	0	287	1296	9568	1296	9281	0.0	0.1396401249865316
chr17	STRADA	63741453	63741716	0	264	1296	9568	1296	9304	0.0	0.13929492691315562
chr17	STRADA	63741717	63741739	0	23	1296	9568	1296	9545	0.0	0.1357778941854374
chr17	FTSJ3	63827051	63827107	0	57	51	4818	51	4761	0.0	0.010712035286704474
chr17	FTSJ3	63826546	63826565	0	20	51	4818	51	4798	0.0	0.0106294289287203
chr17	SMARCD2	63842380	63842457	0	78	115	3571	115	3493	0.0	0.03292298883481248
chr17	SMARCD2	63837145	63837193	0	49	115	3571	115	3522	0.0	0.0326519023282226
chr17	GH2	63880771	63880774	0	4	51	1160	51	1156	0.0	0.04411764705882353
chr17	ICAM2	64020405	64020521	0	117	51	1706	51	1589	0.0	0.032095657646318436
chr17	POLG2	64496406	64496530	0	125	174	4433	174	4308	0.0	0.0403899721448468
chr17	POLG2	64483963	64485726	0	1764	174	4433	174	2669	0.0	0.06519295616335706
chr17	DDX5	64505040	64505217	0	178	9763	7977	9763	7799	0.0	1.2518271573278625
chr17	DDX5	64505040	64505284	153	245	9763	7977	9610	7732	0.6244897959183674	1.2428867046042422
chr17	DDX5	64506075	64506512	51	438	9763	7977	9712	7539	0.11643835616438356	1.2882345138612548
chr17	DDX5	64501260	64502008	667	749	9763	7977	9096	7228	0.890520694259012	1.2584394023242944
chr17	DDX5	64505218	64505284	153	67	9763	7977	9610	7910	2.283582089552239	1.2149178255372945
chr17	DDX5	64505285	64505437	153	153	9763	7977	9610	7824	1.0	1.2282719836400817
chr17	HELZ	67128494	67128649	0	156	2766	15615	2766	15459	0.0	0.1789248981176014
chr17	C17ORF58	67992900	67993042	0	143	0	2252	0	2109	0.0	0.0
chr17	AC145343.1	68100551	68101413	0	863	0	675	0	-188	0.0	-0.0
chr17	LRRC37A16P	68145488	68145524	0	37	102	3794	102	3757	0.0	0.027149321266968326
chr17	WIPI1	68433463	68433466	0	4	153	3414	153	3410	0.0	0.044868035190615836
chr17	WIPI1	68426057	68426073	2	17	153	3414	151	3397	0.11764705882352941	0.04445098616426259
chr17	ABCA10	69149983	69149986	0	4	477	8379	477	8375	0.0	0.05695522388059702
chr17	ABCA10	69196245	69196284	0	40	477	8379	477	8339	0.0	0.05720110324979014
chr17	ABCA5	69273942	69273957	0	16	0	13202	0	13186	0.0	0.0
chr17	CASC17	71132361	71132388	0	28	2762	2897	2762	2869	0.0	0.9627047751829906
chr17	CASC17	71168603	71168612	0	10	2762	2897	2762	2887	0.0	0.9567024593003117
chr17	ROCR	72030200	72030319	0	120	102	3480	102	3360	0.0	0.030357142857142857
chr17	SOX9-AS1	72081359	72081371	0	13	102	11672	102	11659	0.0	0.008748606226949137
chr17	LINC00511	72324431	72324538	0	108	344	21819	344	21711	0.0	0.015844502786605867
chr17	LINC00511	72323742	72324020	0	279	344	21819	344	21540	0.0	0.0159702878365831
chr17	LINC00511	72342105	72342123	0	19	344	21819	344	21800	0.0	0.01577981651376147
chr17	LINC00511	72501611	72501755	0	145	344	21819	344	21674	0.0	0.015871551167297222
chr17	LINC00511	72422746	72422783	0	38	344	21819	344	21781	0.0	0.015793581561911758
chr17	LINC00511	72420699	72422783	0	2085	344	21819	344	19734	0.0	0.01743184351880004
chr17	LINC00511	72420699	72422745	0	2047	344	21819	344	19772	0.0	0.017398341088407848
chr17	LINC00511	72516675	72516788	0	114	344	21819	344	21705	0.0	0.01584888274591108
chr17	SLC39A11	72947730	72947750	0	21	3171	5564	3171	5543	0.0	0.572072884719466
chr17	SLC39A11	72947527	72947750	0	224	3171	5564	3171	5340	0.0	0.5938202247191011
chr17	SLC39A11	72947527	72947729	0	203	3171	5564	3171	5361	0.0	0.591494124230554
chr17	SLC39A11	73092494	73092609	0	116	3171	5564	3171	5448	0.0	0.5820484581497798
chr17	MGC16275	74212523	74212950	51	428	0	2276	-51	1848	0.1191588785046729	-0.027597402597402596
chr17	MGC16275	74212424	74212522	0	99	0	2276	0	2177	0.0	0.0
chr17	MGC16275	74212424	74212950	51	527	0	2276	-51	1749	0.0967741935483871	-0.029159519725557463
chr17	NAT9	74776266	74776307	478	42	16833	2692	16355	2650	11.380952380952381	6.1716981132075475
chr17	NAT9	74776266	74776269	12	4	16833	2692	16821	2688	3.0	6.2578125
chr17	NAT9	74776270	74776307	466	38	16833	2692	16367	2654	12.263157894736842	6.1669178598342125
chr17	FDXR	74863895	74864146	0	252	37	3392	37	3140	0.0	0.01178343949044586
chr17	FDXR	74872768	74872864	0	97	37	3392	37	3295	0.0	0.011229135053110774
chr17	HID1	74963739	74963769	0	31	102	5791	102	5760	0.0	0.017708333333333333
chr17	NT5C	75130964	75131043	0	80	0	1396	0	1316	0.0	0.0
chr17	JPT1	75153217	75153827	0	611	4669	2939	4669	2328	0.0	2.0055841924398625
chr17	JPT1	75153217	75153768	0	552	4669	2939	4669	2387	0.0	1.9560117302052786
chr17	JPT1	75152904	75153216	9	313	4669	2939	4660	2626	0.02875399361022364	1.7745620715917745
chr17	JPT1	75147519	75147554	423	36	4669	2939	4246	2903	11.75	1.4626248708232863
chr17	MIF4GD	75270942	75271142	0	201	102	3393	102	3192	0.0	0.03195488721804511
chr17	MIF4GD	75267450	75267536	0	87	102	3393	102	3306	0.0	0.030852994555353903
chr17	SLC25A19	75289088	75289352	0	265	204	2966	204	2701	0.0	0.07552758237689744
chr17	SLC25A19	75288387	75288500	0	114	204	2966	204	2852	0.0	0.07152875175315568
chr17	SLC25A19	75288387	75288496	0	110	204	2966	204	2856	0.0	0.07142857142857142
chr17	SLC25A19	75288497	75288500	0	4	204	2966	204	2962	0.0	0.0688723835246455
chr17	SLC25A19	75289009	75289352	0	344	204	2966	204	2622	0.0	0.07780320366132723
chr17	GALK1	75758209	75758358	0	150	0	1926	0	1776	0.0	0.0
chr17	H3-3B	75778809	75778881	0	73	51	3476	51	3403	0.0	0.014986776373787834
chr17	H3-3B	75778809	75778819	0	11	51	3476	51	3465	0.0	0.01471861471861472
chr17	H3-3B	75778820	75778881	0	62	51	3476	51	3414	0.0	0.014938488576449912
chr17	H3-3B	75779646	75779655	0	10	51	3476	51	3466	0.0	0.014714368147720716
chr17	WBP2	75855179	75855237	0	59	0	4661	0	4602	0.0	0.0
chr17	WBP2	75846335	75846736	0	402	0	4661	0	4259	0.0	0.0
chr17	WBP2	75855123	75855178	0	56	0	4661	0	4605	0.0	0.0
chr17	TRIM47	75877850	75877872	0	23	0	3017	0	2994	0.0	0.0
chr17	AC087289.3	75909467	75909572	51	106	102	4991	51	4885	0.4811320754716981	0.010440122824974411
chr17	FBF1	75914746	75914828	0	83	153	6205	153	6122	0.0	0.02499183273440052
chr17	ACOX1	75978790	75978963	0	174	711	6842	711	6668	0.0	0.10662867426514697
chr17	EVPL	76018094	76018159	0	66	4367	6988	4367	6922	0.0	0.6308870268708465
chr17	RNF157	76154279	76154281	0	3	158165	5950	158165	5947	0.0	26.595762569362705
chr17	PRPSAP1	76383845	76384379	556	535	109201	6579	108645	6044	1.0392523364485982	17.975678358702847
chr17	UBE2O	76400146	76400220	3008	75	53743	6064	50735	5989	40.10666666666667	8.471364167640674
chr17	RHBDF2	76500935	76501351	102	417	255	6598	153	6181	0.2446043165467626	0.024753276168904707
chr17	ST6GALNAC1	76626005	76626049	0	45	0	3207	0	3162	0.0	0.0
chr17	ST6GALNAC1	76626288	76626316	0	29	0	3207	0	3178	0.0	0.0
chr17	SRSF2	76736798	76736833	28	36	816	2637	788	2601	0.7777777777777778	0.302960399846213
chr17	SRSF2	76735617	76735770	0	154	816	2637	816	2483	0.0	0.328634716069271
chr17	TMC6	78128611	78128657	0	47	1002723	11377	1002723	11330	0.0	88.50158870255957
chr17	SCAT1	78631918	78631947	0	30	20317	4114	20317	4084	0.0	4.974779627815867
chr17	SCAT1	78631918	78631988	0	71	20317	4114	20317	4043	0.0	5.025228790502102
chr17	SCAT1	78630031	78630315	0	285	20317	4114	20317	3829	0.0	5.306085139723165
chr17	SCAT1	78631948	78631988	0	41	20317	4114	20317	4073	0.0	4.988215074883378
chr17	USP36	78796316	78797784	33091	1469	34927	7560	1836	6091	22.526208304969366	0.3014283368904942
chr17	USP36	78796316	78798398	33091	2083	34927	7560	1836	5477	15.886221795487279	0.33522001095490234
chr17	USP36	78836110	78836260	0	151	34927	7560	34927	7409	0.0	4.714131461735727
chr17	USP36	78840399	78840524	0	126	34927	7560	34927	7434	0.0	4.698278181329028
chr17	USP36	78840341	78840398	0	58	34927	7560	34927	7502	0.0	4.655691815515863
chr17	USP36	78840341	78840524	0	184	34927	7560	34927	7376	0.0	4.735222342733189
chr17	TIMP2	78855963	78857520	8143	1558	17648	5639	9505	4081	5.2265725288831835	2.3290860083312914
chr17	LGALS3BP	78976942	78976993	0	52	38996	2991	38996	2939	0.0	13.268458659407962
chr17	LGALS3BP	78976994	78977138	1	145	38996	2991	38995	2846	0.006896551724137931	13.701686577652847
chr17	C1QTNF1-AS1	79019958	79020004	0	47	3042	2065	3042	2018	0.0	1.5074331020812686
chr17	SGSH	80209401	80209404	2466	4	297589	3964	295123	3960	616.5	74.5260101010101
chr17	AC127496.1	80969713	80970786	1242	1074	1803	4209	561	3135	1.1564245810055866	0.17894736842105263
chr17	BAIAP2-DT	81034377	81034563	0	187	0	4775	0	4588	0.0	0.0
chr17	CEP131	81198105	81198113	0	9	855	3992	855	3983	0.0	0.21466231483806175
chr17	TEPSIN	81238513	81238984	0	472	0	4141	0	3669	0.0	0.0
chr17	AC110285.1	81385291	81385298	0	8	0	2396	0	2388	0.0	0.0
chr17	AC110285.1	81384945	81385127	0	183	0	2396	0	2213	0.0	0.0
chr17	ACTG1	81512605	81512732	0	128	0	2143	0	2015	0.0	0.0
chr17	ACTG1	81512605	81512613	0	9	0	2143	0	2134	0.0	0.0
chr17	ACTG1	81510478	81510478	0	1	0	2143	0	2142	0.0	0.0
chr17	ACTG1	81512614	81512732	0	119	0	2143	0	2024	0.0	0.0
chr17	ACTG1	81512463	81512732	0	270	0	2143	0	1873	0.0	0.0
chr17	ACTG1	81512463	81512604	0	142	0	2143	0	2001	0.0	0.0
chr17	ACTG1	81512463	81512613	0	151	0	2143	0	1992	0.0	0.0
chr17	FAAP100	81551731	81551926	0	196	0	5365	0	5169	0.0	0.0
chr17	NPLOC4	81566387	81566469	0	83	0	7339	0	7256	0.0	0.0
chr17	OXLD1	81666276	81666516	0	241	0	1189	0	948	0.0	0.0
chr17	OXLD1	81666154	81666516	0	363	0	1189	0	826	0.0	0.0
chr17	OXLD1	81666154	81666275	0	122	0	1189	0	1067	0.0	0.0
chr17	OXLD1	81666145	81666516	0	372	0	1189	0	817	0.0	0.0
chr17	OXLD1	81666145	81666275	0	131	0	1189	0	1058	0.0	0.0
chr17	OXLD1	81666145	81666153	0	9	0	1189	0	1180	0.0	0.0
chr17	OXLD1	81666145	81666148	0	4	0	1189	0	1185	0.0	0.0
chr17	OXLD1	81666149	81666516	0	368	0	1189	0	821	0.0	0.0
chr17	OXLD1	81666149	81666275	0	127	0	1189	0	1062	0.0	0.0
chr17	OXLD1	81666149	81666153	0	5	0	1189	0	1184	0.0	0.0
chr17	ARL16	81683535	81683591	0	57	0	2599	0	2542	0.0	0.0
chr17	ARL16	81682442	81682489	0	48	0	2599	0	2551	0.0	0.0
chr17	P4HB	81860326	81860345	0	20	0	4717	0	4697	0.0	0.0
chr17	P4HB	81859178	81859179	0	2	0	4717	0	4715	0.0	0.0
chr17	PYCR1	81937179	81937226	0	48	0	2584	0	2536	0.0	0.0
chr17	PYCR1	81937179	81937191	0	13	0	2584	0	2571	0.0	0.0
chr17	PYCR1	81937257	81937260	0	4	0	2584	0	2580	0.0	0.0
chr17	PYCR1	81937192	81937226	0	35	0	2584	0	2549	0.0	0.0
chr17	PYCR1	81936969	81937178	0	210	0	2584	0	2374	0.0	0.0
chr17	PYCR1	81936969	81937226	0	258	0	2584	0	2326	0.0	0.0
chr17	PYCR1	81936969	81937191	0	223	0	2584	0	2361	0.0	0.0
chr17	CENPX	82019292	82019306	0	15	0	1407	0	1392	0.0	0.0
chr17	CENPX	82019509	82019639	0	131	0	1407	0	1276	0.0	0.0
chr17	DCXR	82036383	82036412	0	30	0	1446	0	1416	0.0	0.0
chr17	DCXR	82036181	82036189	0	9	0	1446	0	1437	0.0	0.0
chr17	DCXR	82036146	82036189	0	44	0	1446	0	1402	0.0	0.0
chr17	DCXR	82036146	82036180	0	35	0	1446	0	1411	0.0	0.0
chr17	DCXR	82037613	82037629	0	17	0	1446	0	1429	0.0	0.0
chr17	RFNG	82051011	82051292	0	282	0	2763	0	2481	0.0	0.0
chr17	DUS1L	82061556	82061616	0	61	0	3907	0	3846	0.0	0.0
chr17	FASN	82086253	82086258	0	6	0	9367	0	9361	0.0	0.0
chr17	CCDC57	82198313	82198335	0	23	0	9455	0	9432	0.0	0.0
chr17	CCDC57	82207730	82207845	0	116	0	9455	0	9339	0.0	0.0
chr17	SECTM1	82333694	82333698	0	5	0	2913	0	2908	0.0	0.0
chr17	OGFOD3	82415397	82415404	0	8	0	3642	0	3634	0.0	0.0
chr17	OGFOD3	82403894	82403935	0	42	0	3642	0	3600	0.0	0.0
chr17	OGFOD3	82418405	82418410	0	6	0	3642	0	3636	0.0	0.0
chr17	CYBC1	82449169	82449172	0	4	0	3566	0	3562	0.0	0.0
chr17	CYBC1	82450479	82450698	0	220	0	3566	0	3346	0.0	0.0
chr17	CYBC1	82450479	82450531	0	53	0	3566	0	3513	0.0	0.0
chr17	CYBC1	82450532	82450698	0	167	0	3566	0	3399	0.0	0.0
chr17	B3GNTL1	83048668	83048705	0	38	0	6597	0	6559	0.0	0.0
chr17	AC139099.1	83227620	83227647	0	28	0	2628	0	2600	0.0	0.0
chr17	AC129507.4	321611	321631	0	21	0	434	0	413	0.0	0.0
chr17	AC129507.1	331718	331721	0	4	0	1968	0	1964	0.0	0.0
chr17	WDR81	1724787	1728626	8607	3840	31994	8095	23387	4255	2.24140625	5.49635722679201
chr17	SERPINF1	1762114	1762273	751	160	4818	2082	4067	1922	4.69375	2.1160249739854318
chr17	RPA1	1830127	1830134	0	8	6771	5478	6771	5470	0.0	1.2378427787934188
chr17	DPH1	2036654	2036686	145	33	9361	4551	9216	4518	4.393939393939394	2.039840637450199
chr17	DPH1	2041876	2042231	357	356	9361	4551	9004	4195	1.002808988764045	2.1463647199046485
chr17	PAFAH1B1	2593703	2594006	72359	304	113619	9736	41260	9432	238.02302631578948	4.374469889737066
chr17	ASPA	3476301	3476395	60	95	36984	5827	36924	5732	0.631578947368421	6.441730635031402
chr17	CTNS	3655327	3655352	0	26	153	4697	153	4671	0.0	0.03275529865125241
chr17	CTNS	3636704	3636708	0	5	153	4697	153	4692	0.0	0.03260869565217391
chr17	CTNS	3636832	3636887	0	56	153	4697	153	4641	0.0	0.03296703296703297
chr17	EMC6	3668900	3669012	0	113	0	774	0	661	0.0	0.0
chr17	CYB5D2	4143314	4144005	459	692	4676	2188	4217	1496	0.6632947976878613	2.818850267379679
chr17	CYB5D2	4143764	4144005	123	242	4676	2188	4553	1946	0.5082644628099173	2.33967112024666
chr17	CYB5D2	4143314	4143763	336	450	4676	2188	4340	1738	0.7466666666666667	2.4971231300345225
chr17	ARRB2	4719290	4719420	37	131	109835	3784	109798	3653	0.2824427480916031	30.05693950177936
chr17	ARRB2	4716609	4716671	807	63	109835	3784	109028	3721	12.80952380952381	29.300725611394785
chr17	PLD2	4819550	4819582	0	33	384	4796	384	4763	0.0	0.08062145706487509
chr17	PLD2	4808417	4808451	0	35	384	4796	384	4761	0.0	0.08065532451165722
chr17	MINK1	4886618	4886626	116	9	214859	6924	214743	6915	12.88888888888889	31.05466377440347
chr17	RNF167	4940643	4940726	0	84	102	2282	102	2198	0.0	0.04640582347588717
chr17	RNF167	4940231	4940360	0	130	102	2282	102	2152	0.0	0.047397769516728624
chr17	ENO3	4948348	4948373	0	26	77	4037	77	4011	0.0	0.019197207678883072
chr17	ENO3	4951183	4951224	0	42	77	4037	77	3995	0.0	0.019274092615769713
chr17	ENO3	4951215	4951224	0	10	77	4037	77	4027	0.0	0.019120933697541594
chr17	ENO3	4951183	4951214	0	32	77	4037	77	4005	0.0	0.019225967540574283
chr17	ZNF232-AS1	5112102	5112118	0	17	1042	1476	1042	1459	0.0	0.7141877998629198
chr17	MIS12	5486421	5486684	0	264	3538	3162	3538	2898	0.0	1.2208419599723948
chr17	AC007846.1	5837217	5837249	0	33	0	1825	0	1792	0.0	0.0
chr17	PIMREG	6445343	6445404	0	62	51	2570	51	2508	0.0	0.02033492822966507
chr17	TXNDC17	6641101	6641152	0	52	0	2558	0	2506	0.0	0.0
chr17	TXNDC17	6641101	6641227	0	127	0	2558	0	2431	0.0	0.0
chr17	TXNDC17	6641153	6641227	0	75	0	2558	0	2483	0.0	0.0
chr17	TXNDC17	6641835	6641932	0	98	0	2558	0	2460	0.0	0.0
chr17	ALOX12P2	6899707	6899760	321	54	57285	5629	56964	5575	5.944444444444445	10.217757847533631
chr17	ALOX12P2	6854436	6854453	0	18	57285	5629	57285	5611	0.0	10.209410087328463
chr17	ALOX12P2	6894514	6894519	0	6	57285	5629	57285	5623	0.0	10.187622265694468
chr17	ALOX12P2	6895200	6895203	4	4	57285	5629	57281	5625	1.0	10.183288888888889
chr17	RNASEK	7012758	7012761	0	4	0	1124	0	1120	0.0	0.0
chr17	C17ORF49	7016526	7016685	0	160	0	1569	0	1409	0.0	0.0
chr17	RNASEK	7012762	7012777	0	16	0	1124	0	1108	0.0	0.0
chr17	RNASEK	7012758	7012777	0	20	0	1124	0	1104	0.0	0.0
chr17	RNASEK	7013517	7013535	0	19	0	1124	0	1105	0.0	0.0
chr17	ACADVL	7223859	7223875	0	17	162847	3886	162847	3869	0.0	42.09020418712846
chr17	ELP5	7254767	7254803	89	37	10281	2734	10192	2697	2.4054054054054053	3.779013718946978
chr17	ELP5	7252338	7252345	0	8	10281	2734	10281	2726	0.0	3.771460014673514
chr17	SLC2A4	7284940	7285000	95	61	14378	4007	14283	3946	1.5573770491803278	3.619614799797263
chr17	EIF5A	7308114	7308133	6	20	139926	2599	139920	2579	0.3	54.253586661496705
chr17	TNK1	7384254	7384376	0	123	12129	3534	12129	3411	0.0	3.55584872471416
chr17	EIF4A1	7573534	7573547	376	14	1389251	4446	1388875	4432	26.857142857142858	313.37432310469313
chr17	EIF4A1	7577917	7578244	126682	328	1389251	4446	1262569	4118	386.2256097560976	306.5976202039825
chr17	MPDU1	7586778	7586838	39	61	51333	2956	51294	2895	0.639344262295082	17.718134715025908
chr17	WRAP53	7687604	7688561	0	958	0	3629	0	2671	0.0	0.0
chr17	DNAH2	7717832	7718799	0	968	556145	16910	556145	15942	0.0	34.885522519131854
chr17	CHD3	7909339	7909384	0	46	26	10249	26	10203	0.0	0.002548270116632363
chr17	CNTROB	7948620	7948685	0	66	342	5814	342	5748	0.0	0.059498956158663886
chr17	CNTROB	7949138	7949157	0	20	342	5814	342	5794	0.0	0.059026579219882636
chr17	ODF4	8340161	8340505	969	345	3762	1326	2793	981	2.8086956521739133	2.8470948012232418
chr17	NDEL1	8435920	8436045	204	126	32489	5059	32285	4933	1.619047619047619	6.5446989661463615
chr17	USP43	9701686	9701700	0	15	0	4991	0	4976	0.0	0.0
chr17	AC005323.2	10406239	10406277	0	39	198	774	198	735	0.0	0.2693877551020408
chr17	ADPRM	10706551	10706554	0	4	0	1949	0	1945	0.0	0.0
chr17	ADPRM	10705528	10705615	0	88	0	1949	0	1861	0.0	0.0
chr17	TMEM220-AS1	10729877	10729900	0	24	0	2726	0	2702	0.0	0.0
chr17	LINC02096	14840047	14840123	0	77	102	3329	102	3252	0.0	0.03136531365313653
chr17	ZNF286A	15700169	15700366	49	198	215	3177	166	2979	0.2474747474747475	0.05572339711312521
chr17	TTC19	16000246	16000382	0	137	10668	4955	10668	4818	0.0	2.2141967621419676
chr17	UBB	16381030	16381036	0	7	1887	1438	1887	1431	0.0	1.3186582809224319
chr17	UBB	16381463	16381515	0	53	1887	1438	1887	1385	0.0	1.3624548736462094
chr17	UBB	16381516	16381679	0	164	1887	1438	1887	1274	0.0	1.4811616954474098
chr17	SNHG29	16439030	16439060	62	31	42991	5724	42929	5693	2.0	7.5406639733005445
chr17	SNHG29	16439394	16439414	0	21	42991	5724	42991	5703	0.0	7.538313168507803
chr17	SNHG29	16463248	16463317	0	70	42991	5724	42991	5654	0.0	7.603643438273789
chr17	SNHG29	16463318	16464341	1298	1024	42991	5724	41693	4700	1.267578125	8.870851063829788
chr17	SNHG29	16463248	16464341	1298	1094	42991	5724	41693	4630	1.186471663619744	9.004967602591792
chr17	SNHG29	16439061	16439414	122	354	42991	5724	42869	5370	0.3446327683615819	7.983054003724395
chr17	SNHG29	16439415	16439703	0	289	42991	5724	42991	5435	0.0	7.910027598896044
chr17	SNHG29	16439394	16439703	0	310	42991	5724	42991	5414	0.0	7.940709272257111
chr17	SNHG29	16439061	16439245	122	185	42991	5724	42869	5539	0.6594594594594595	7.739483661310706
chr17	USP32P1	16794640	16794658	0	19	50	5336	50	5317	0.0	0.009403799134850479
chr17	MPRIP	17138076	17138429	0	354	369333	14685	369333	14331	0.0	25.77161398367176
chr17	NT5M	17344909	17344926	0	18	23	1969	23	1951	0.0	0.011788826242952332
chr17	NT5M	17303818	17303901	0	84	23	1969	23	1885	0.0	0.01220159151193634
chr17	NT5M	17304478	17304481	0	4	23	1969	23	1965	0.0	0.011704834605597965
chr17	DRC3	17973752	17973753	0	2	26994	4609	26994	4607	0.0	5.859344475797699
chr17	DRC3	17972975	17973099	0	125	26994	4609	26994	4484	0.0	6.02007136485281
chr17	DRG2	18093969	18093973	0	5	321194	6021	321194	6016	0.0	53.38996010638298
chr17	DRG2	18099078	18099093	0	16	321194	6021	321194	6005	0.0	53.487760199833474
chr17	DRG2	18099716	18099723	0	8	321194	6021	321194	6013	0.0	53.41659737235989
chr17	DRG2	18106471	18106486	4	16	321194	6021	321190	6005	0.25	53.48709408825978
chr17	MYO15A	18157883	18157900	12907	18	1750422	16458	1737515	16440	717.0555555555555	105.68826034063261
chr17	KRT17P5	18422343	18422813	343	471	11470	3166	11127	2695	0.7282377919320594	4.1287569573283855
chr17	KRT17P5	18420418	18420445	0	28	11470	3166	11470	3138	0.0	3.6551943913320586
chr17	KRT17P2	18427362	18427374	0	13	7451	2153	7451	2140	0.0	3.4817757009345796
chr17	TRIM16L	18727703	18727758	0	56	8856	3780	8856	3724	0.0	2.3780880773361974
chr17	FBXW10	18770049	18770085	7	37	1130	3798	1123	3761	0.1891891891891892	0.2985908003190641
chr17	FBXW10	18744750	18745395	0	646	1130	3798	1130	3152	0.0	0.35850253807106597
chr17	TVP23B	18790961	18791040	0	80	23565	5755	23565	5675	0.0	4.152422907488987
chr17	PRPSAP2	18856404	18856429	0	26	5997	4727	5997	4701	0.0	1.2756860242501595
chr17	MAPK7	19378399	19378542	0	144	655	4017	655	3873	0.0	0.1691195455719081
chr17	MAPK7	19378403	19378542	0	140	655	4017	655	3877	0.0	0.1689450606138767
chr17	MAPK7	19378399	19378402	0	4	655	4017	655	4013	0.0	0.16321953650635435
chr17	MAPK7	19378543	19378630	0	88	655	4017	655	3929	0.0	0.16670908628149655
chr17	SLC47A1P1	19594324	19594334	0	11	65178	1413	65178	1402	0.0	46.48930099857347
chr17	SPECC1	20246072	20246574	546	503	67459	19316	66913	18813	1.0854870775347913	3.5567426779354703
chr17	SPECC1	20095913	20096037	163	125	67459	19316	67296	19191	1.304	3.506643739252775
chr17	SPECC1	20232406	20232414	63	9	67459	19316	67396	19307	7.0	3.4907546485730565
chr17	SPECC1	20232406	20232451	202	46	67459	19316	67257	19270	4.391304347826087	3.4902439024390244
chr17	SPECC1	20232415	20232451	139	37	67459	19316	67320	19279	3.7567567567567566	3.491882359043519
chr17	CCDC144NL-AS1	20956710	20956824	0	115	3990549	10522	3990549	10407	0.0	383.4485442490631
chr17	TBC1D3P5	27419608	27419613	0	6	34006	4122	34006	4116	0.0	8.261904761904763
chr17	KSR1	27483835	27483851	0	17	75022	11040	75022	11023	0.0	6.805951192960174
chr17	KSR1	27623669	27623795	0	127	75022	11040	75022	10913	0.0	6.874553285072849
chr17	TMEM199	28360572	28360576	0	5	153	4566	153	4561	0.0	0.03354527515895637
chr17	SPAG5-AS1	28599840	28599855	6665	16	135276	2896	128611	2880	416.5625	44.656597222222224
chr17	SUPT6H	28673511	28673618	0	108	91	9640	91	9532	0.0	0.009546789760805707
chr17	RPL23A	28720329	28720430	84	102	357	2219	273	2117	0.8235294117647058	0.12895606991025035
chr17	NEK8	28734955	28735004	0	50	151	4426	151	4376	0.0	0.03450639853747715
chr17	NEK8	28725973	28726003	0	31	151	4426	151	4395	0.0	0.034357224118316265
chr17	TRAF4	28748136	28748178	0	43	39258	3983	39258	3940	0.0	9.963959390862945
chr17	TRAF4	28747265	28747391	0	127	39258	3983	39258	3856	0.0	10.181016597510373
chr17	ERAL1	28856583	28856685	0	103	4638	2084	4638	1981	0.0	2.3412417970721857
chr17	ERAL1	28858634	28858824	102	191	4638	2084	4536	1893	0.5340314136125655	2.3961965134706813
chr17	PIPOX	28952456	28952476	0	21	19446	3797	19446	3776	0.0	5.14989406779661
chr17	PIPOX	29044313	29044394	0	82	19446	3797	19446	3715	0.0	5.234454912516823
chr17	TP53I13	29568509	29568548	0	40	723	2803	723	2763	0.0	0.26167209554831705
chr17	ANKRD13B	29608000	29608110	0	111	921	3581	921	3470	0.0	0.2654178674351585
chr17	GOSR1	30481258	30481263	0	6	43549	9580	43549	9574	0.0	4.54867349070399
chr17	GOSR1	30477465	30477486	0	22	43549	9580	43549	9558	0.0	4.556287926344424
chr17	AC005562.1	30631896	30631927	0	32	46098	8636	46098	8604	0.0	5.357740585774058
chr17	AC005562.1	30601824	30601828	0	5	46098	8636	46098	8631	0.0	5.340980187695516
chr17	AC005562.1	30631928	30631979	0	52	46098	8636	46098	8584	0.0	5.37022367194781
chr17	AC005562.1	30631896	30631979	0	84	46098	8636	46098	8552	0.0	5.390318054256315
chr17	AC005562.1	30631928	30632099	0	172	46098	8636	46098	8464	0.0	5.446361058601134
chr17	AC005562.1	30631980	30632099	0	120	46098	8636	46098	8516	0.0	5.413104744011273
chr17	AC005562.1	30631896	30632099	0	204	46098	8636	46098	8432	0.0	5.467030360531309
chr17	ADAP2	30956392	30956469	0	78	51	3738	51	3660	0.0	0.013934426229508197
chr17	NF1	31340584	31340645	0	62	102	20076	102	20014	0.0	0.005096432497251923
chr17	RAB11FIP4	31488273	31488432	0	160	0	12597	0	12437	0.0	0.0
chr17	RHOT1	32202901	32202906	0	6	102	5502	102	5496	0.0	0.018558951965065504
chr17	ZNF207	32369746	32369782	0	37	46386	8928	46386	8891	0.0	5.217185918344393
chr17	PSMD11	32444519	32444614	0	96	0	6502	0	6406	0.0	0.0
chr17	PSMD11	32473946	32474081	0	136	0	6502	0	6366	0.0	0.0
chr17	CCL13	34357569	34357589	0	21	0	816	0	795	0.0	0.0
chr17	AC011193.1	34479508	34479895	0	388	0	1763	0	1375	0.0	0.0
chr17	LIG3	34980598	34980622	0	25	317	10453	317	10428	0.0	0.030398925968546223
chr17	UNC45B	35170256	35170261	0	6	0	5699	0	5693	0.0	0.0
chr17	AC022706.1	35313645	35313706	0	62	102	1393	102	1331	0.0	0.07663410969196092
chr17	AC022706.1	35323269	35323343	0	75	102	1393	102	1318	0.0	0.07738998482549317
chr17	AC022706.1	35323261	35323343	0	83	102	1393	102	1310	0.0	0.07786259541984733
chr17	AC022706.1	35323261	35323268	0	8	102	1393	102	1385	0.0	0.0736462093862816
chr17	AP2B1	35587429	35587597	0	169	11180	7621	11180	7452	0.0	1.5002683843263553
chr17	AP2B1	35587598	35587663	0	66	11180	7621	11180	7555	0.0	1.4798146922567836
chr17	C17ORF50	35764237	35764325	0	89	4313	1044	4313	955	0.0	4.516230366492146
chr17	TAF15	35820240	35820248	77	9	15459	5459	15382	5450	8.555555555555555	2.8223853211009176
chr17	TAF15	35809577	35809616	561	40	15459	5459	14898	5419	14.025	2.7492157224580183
chr17	PIGW	36535055	36535592	663	538	1613	2801	950	2263	1.2323420074349443	0.4197967300044189
chr17	PIGW	36535593	36535601	0	9	1613	2801	1613	2792	0.0	0.5777220630372493
chr17	MRM1	36602177	36602352	0	176	0	1465	0	1289	0.0	0.0
chr17	AC243830.1	36722809	36724653	0	1845	304	2449	304	604	0.0	0.5033112582781457
chr17	TADA2A	37437830	37437922	0	93	3218	5170	3218	5077	0.0	0.6338388812290723
chr17	PSMB3	38752814	38752829	0	16	0	1122	0	1106	0.0	0.0
chr17	LRRC37A11P	39032438	39032438	0	1	60	5878	60	5877	0.0	0.010209290454313425
chr17	LRRC37A11P	39044942	39046341	1020	1400	60	5878	-960	4478	0.7285714285714285	-0.21438142027690935
chr17	RPL19	39202444	39202445	0	2	51	2265	51	2263	0.0	0.022536456031816175
chr17	RPL19	39200350	39200743	0	394	51	2265	51	1871	0.0	0.027258150721539285
chr17	RPL19	39200479	39200743	0	265	51	2265	51	2000	0.0	0.0255
chr17	RPL19	39200350	39200478	0	129	51	2265	51	2136	0.0	0.023876404494382022
chr17	PPP1R1B	39627465	39627473	0	9	0	2807	0	2798	0.0	0.0
chr17	PPP1R1B	39628623	39628706	0	84	0	2807	0	2723	0.0	0.0
chr17	STARD3	39657840	39657852	0	13	0	4382	0	4369	0.0	0.0
chr17	STARD3	39662345	39662367	0	23	0	4382	0	4359	0.0	0.0
chr17	ERBB2	39723625	39723660	0	36	0	8554	0	8518	0.0	0.0
chr17	ERBB2	39707142	39707204	0	63	0	8554	0	8491	0.0	0.0
chr17	GRB7	39743277	39743301	0	25	204	3325	204	3300	0.0	0.06181818181818182
chr17	CSF3	40015846	40015854	0	9	204	2223	204	2214	0.0	0.0921409214092141
chr17	CSF3	40015515	40015845	51	331	204	2223	153	1892	0.1540785498489426	0.08086680761099366
chr17	THRA	40062452	40062548	155	97	77476	7349	77321	7252	1.597938144329897	10.662024269167127
chr17	RAPGEFL1	40177123	40177284	30212	162	56248	5363	26036	5201	186.49382716049382	5.005960392232263
chr17	RAPGEFL1	40177187	40177284	19928	98	56248	5363	36320	5265	203.3469387755102	6.898385565052232
chr17	RAPGEFL1	40177123	40177186	10284	64	56248	5363	45964	5299	160.6875	8.674089450839782
chr17	RAPGEFL1	40181374	40181486	0	113	56248	5363	56248	5250	0.0	10.713904761904763
chr17	WIPF2	40260628	40260667	0	40	887700	8133	887700	8093	0.0	109.68738415914989
chr17	WIPF2	40219493	40219517	0	25	887700	8133	887700	8108	0.0	109.48445979279724
chr17	CDC6	40288038	40288090	0	53	2351	5266	2351	5213	0.0	0.45098791482831385
chr17	CDC6	40287950	40288090	270	141	2351	5266	2081	5125	1.9148936170212767	0.4060487804878049
chr17	CDC6	40287950	40288037	270	88	2351	5266	2081	5178	3.0681818181818183	0.4018926226342217
chr17	CDC6	40288091	40288132	407	42	2351	5266	1944	5224	9.69047619047619	0.3721286370597244
chr17	CDC6	40288038	40288132	407	95	2351	5266	1944	5171	4.28421052631579	0.3759427576871011
chr17	CDC6	40287950	40288132	677	183	2351	5266	1674	5083	3.699453551912568	0.3293330710210506
chr17	TMEM99	40819171	40819208	32	38	43040	3058	43008	3020	0.8421052631578947	14.241059602649006
chr17	TMEM99	40819209	40819279	70	71	43040	3058	42970	2987	0.9859154929577465	14.385671242048879
chr17	KRTAP9-1	41190177	41190248	33	72	384	554	351	482	0.4583333333333333	0.7282157676348547
chr17	KRTAP9-1	41189947	41189970	80	24	384	554	304	530	3.3333333333333335	0.5735849056603773
chr17	FKBP10	41819676	41820049	69	374	102	4057	33	3683	0.18449197860962566	0.008960086885691013
chr17	FKBP10	41820024	41820049	18	26	102	4057	84	4031	0.6923076923076923	0.020838501612503103
chr17	KLHL10	41838065	41838126	0	62	135375	2288	135375	2226	0.0	60.815363881401616
chr17	CNP	41966888	41967013	0	126	10574	6383	10574	6257	0.0	1.6899472590698417
chr17	NKIRAS2	42022473	42022640	0	168	41	4020	41	3852	0.0	0.010643821391484943
chr17	NKIRAS2	42020205	42020269	0	65	41	4020	41	3955	0.0	0.010366624525916562
chr17	STAT5A	42304647	42304652	0	6	292155	5445	292155	5439	0.0	53.714837286265855
chr17	COASY	42562214	42562487	0	274	1069	3038	1069	2764	0.0	0.38675832127351667
chr17	COASY	42562220	42562487	0	268	1069	3038	1069	2770	0.0	0.3859205776173285
chr17	COASY	42562237	42562487	0	251	1069	3038	1069	2787	0.0	0.3835665590240402
chr17	COASY	42562214	42562219	0	6	1069	3038	1069	3032	0.0	0.35257255936675463
chr17	COASY	42562214	42562236	0	23	1069	3038	1069	3015	0.0	0.35456053067993365
chr17	COASY	42562220	42562236	0	17	1069	3038	1069	3021	0.0	0.3538563389606091
chr17	MLX	42567167	42567328	51	162	3738	3476	3687	3314	0.3148148148148148	1.1125528062764032
chr17	MLX	42567161	42567328	51	168	3738	3476	3687	3308	0.30357142857142855	1.114570737605804
chr17	MLX	42567161	42567166	0	6	3738	3476	3738	3470	0.0	1.0772334293948127
chr17	TUBG1	42610591	42610629	0	39	1865	2419	1865	2380	0.0	0.7836134453781513
chr17	RAMP2	42761013	42761075	696	63	18124	1121	17428	1058	11.047619047619047	16.472589792060493
chr17	CNTD1	42799185	42799236	0	52	63263	3323	63263	3271	0.0	19.34056863344543
chr17	CNTD1	42799019	42799236	0	218	63263	3323	63263	3105	0.0	20.374557165861514
chr17	CNTD1	42799019	42799184	0	166	63263	3323	63263	3157	0.0	20.038961038961038
chr17	CNTD1	42807865	42807892	0	28	63263	3323	63263	3295	0.0	19.19969650986343
chr17	PSME3	42833506	42833673	51	168	67484	4720	67433	4552	0.30357142857142855	14.813927943760984
chr17	PSME3	42833674	42833939	0	266	67484	4720	67484	4454	0.0	15.151324651998204
chr17	PSME3	42833506	42833939	51	434	67484	4720	67433	4286	0.1175115207373272	15.733317778814746
chr17	AOC2	42849291	42849371	0	81	7958	2681	7958	2600	0.0	3.060769230769231
chr17	RPL27	42998832	42998912	0	81	23538	2030	23538	1949	0.0	12.076962544894817
chr17	IFI35	43013374	43013379	78	6	91509	1892	91431	1886	13.0	48.478791092258746
chr17	NBR1	43170612	43170943	51	332	117813	7964	117762	7632	0.1536144578313253	15.43003144654088
chr17	G6PC3	44071184	44071242	0	59	220	4172	220	4113	0.0	0.05348893751519572
chr17	G6PC3	44071812	44071821	0	10	220	4172	220	4162	0.0	0.05285920230658337
chr17	ASB16	44176941	44177230	255	290	2074	2239	1819	1949	0.8793103448275862	0.9332991277578245
chr17	TMUB2	44189300	44189588	0	289	204	3574	204	3285	0.0	0.062100456621004566
chr17	TMUB2	44189092	44189588	0	497	204	3574	204	3077	0.0	0.06629834254143646
chr17	TMUB2	44189092	44189299	0	208	204	3574	204	3366	0.0	0.06060606060606061
chr17	TMUB2	44187401	44187431	0	31	204	3574	204	3543	0.0	0.057578323454699404
chr17	GRN	44345335	44345605	0	271	821	3085	821	2814	0.0	0.2917555081734186
chr17	GRN	44351101	44351163	0	63	821	3085	821	3022	0.0	0.27167438782263403
chr17	MEIOC	44656620	44656682	23	63	2669	8627	2646	8564	0.36507936507936506	0.30896777206912657
chr17	MEIOC	44665138	44665488	0	351	2669	8627	2669	8276	0.0	0.32249879168680523
chr17	ADAM11	44772463	44772466	0	4	856	4841	856	4837	0.0	0.17696919578250983
chr17	CCDC103	44899830	44899859	0	30	0	3900	0	3870	0.0	0.0
chr17	CCDC103	44899844	44899859	0	16	0	3900	0	3884	0.0	0.0
chr17	CCDC103	44899830	44899843	0	14	0	3900	0	3886	0.0	0.0
chr17	NMT1	45081753	45081995	0	243	6475	7711	6475	7468	0.0	0.8670326727370112
chr17	HEXIM2	45161249	45161400	0	152	1422	1994	1422	1842	0.0	0.7719869706840391
chr17	HEXIM2	45161940	45162031	0	92	1422	1994	1422	1902	0.0	0.7476340694006309
chr17	FMNL1	45232451	45232480	0	30	66880	6173	66880	6143	0.0	10.88718867003093
chr17	MAP3K14-AS1	45262344	45263391	153	1048	11521	4874	11368	3826	0.14599236641221375	2.9712493465760583
chr17	MAP3K14-AS1	45266519	45266699	10061	181	11521	4874	1460	4693	55.58563535911602	0.31110164074152996
chr17	KANSL1-AS1	46193739	46193885	0	147	10692	668	10692	521	0.0	20.52207293666027
chr17	GOSR2	46935170	46935225	0	56	187163	11566	187163	11510	0.0	16.260903562119896
chr17	GOSR2	46923222	46923269	474	48	187163	11566	186689	11518	9.875	16.208456329223825
chr17	GOSR2	46923222	46923387	785	166	187163	11566	186378	11400	4.728915662650603	16.34894736842105
chr17	GOSR2	46923270	46923387	311	118	187163	11566	186852	11448	2.635593220338983	16.32180293501048
chr17	GOSR2	46923222	46923632	1086	411	187163	11566	186077	11155	2.6423357664233578	16.68103989242492
chr17	GOSR2	46923270	46923632	612	363	187163	11566	186551	11203	1.6859504132231404	16.65187896099259
chr17	GOSR2	46923388	46923632	301	245	187163	11566	186862	11321	1.2285714285714286	16.505785707976326
chr17	MYL4	47209092	47209155	0	64	0	1645	0	1581	0.0	0.0
chr17	MYL4	47213827	47213919	0	93	0	1645	0	1552	0.0	0.0
chr17	ITGB3	47291089	47291427	0	339	204	6355	204	6016	0.0	0.0339095744680851
chr17	EFCAB13	47324075	47324099	0	25	8913	6489	8913	6464	0.0	1.3788675742574257
chr17	NPEPPS	47579456	47579511	537	56	4931	9467	4394	9411	9.589285714285714	0.4669004356603974
chr17	NPEPPS	47586245	47586249	0	5	4931	9467	4931	9462	0.0	0.521137180300148
chr17	NPEPPS	47619323	47619372	0	50	4931	9467	4931	9417	0.0	0.523627482213019
chr17	NPEPPS	47619373	47619495	0	123	4931	9467	4931	9344	0.0	0.5277183219178082
chr17	NPEPPS	47619323	47619495	0	173	4931	9467	4931	9294	0.0	0.5305573488272003
chr17	NPEPPS	47585701	47585745	0	45	4931	9467	4931	9422	0.0	0.523349607302059
chr17	SP2	47896294	47896337	0	44	3139	3654	3139	3610	0.0	0.8695290858725762
chr17	PNPO	47941603	47942051	0	449	0	4987	0	4538	0.0	0.0
chr17	PNPO	47941814	47942051	0	238	0	4987	0	4749	0.0	0.0
chr17	PNPO	47941603	47941813	0	211	0	4987	0	4776	0.0	0.0
chr17	PNPO	47944716	47945612	0	897	0	4987	0	4090	0.0	0.0
chr17	CDK5RAP3	47975639	47975653	0	15	0	4158	0	4143	0.0	0.0
chr17	CDK5RAP3	47973651	47973696	0	46	0	4158	0	4112	0.0	0.0
chr17	CDK5RAP3	47973694	47973696	0	3	0	4158	0	4155	0.0	0.0
chr17	CDK5RAP3	47974032	47974035	0	4	0	4158	0	4154	0.0	0.0
chr17	CDK5RAP3	47973651	47973693	0	43	0	4158	0	4115	0.0	0.0
chr17	CDK5RAP3	47971310	47971407	0	98	0	4158	0	4060	0.0	0.0
chr17	CDK5RAP3	47971153	47971171	0	19	0	4158	0	4139	0.0	0.0
chr17	NFE2L1	48050782	48050819	0	38	1339	5475	1339	5437	0.0	0.24627551958800808
chr17	NFE2L1	48048848	48048864	0	17	1339	5475	1339	5458	0.0	0.24532795895932577
chr17	NFE2L1	48054762	48055150	0	389	1339	5475	1339	5086	0.0	0.26327172630751083
chr17	SNX11	48112086	48112111	0	26	0	4144	0	4118	0.0	0.0
chr17	SNX11	48107597	48107838	0	242	0	4144	0	3902	0.0	0.0
chr17	LINC02086	48705351	48705683	0	333	24	3504	24	3171	0.0	0.007568590350047304
chr17	CALCOCO2	48848083	48848166	0	84	17632	7200	17632	7116	0.0	2.477796514896009
chr17	ATP5MC1	48892841	48892910	0	70	0	1499	0	1429	0.0	0.0
chr17	UBE2Z	48912966	48913021	0	56	0	3711	0	3655	0.0	0.0
chr17	ABI3	49216681	49216698	0	18	57	2279	57	2261	0.0	0.025210084033613446
chr17	FLJ40194	49252919	49253133	0	215	61955	4893	61955	4678	0.0	13.243907652843095
chr17	ITGA3	50074281	50074292	0	12	0	8655	0	8643	0.0	0.0
chr17	PDK2	50095381	50095553	0	173	0	4742	0	4569	0.0	0.0
chr17	SGCA	50175376	50175449	0	74	0	2358	0	2284	0.0	0.0
chr17	SGCA	50166078	50166136	0	59	0	2358	0	2299	0.0	0.0
chr17	SGCA	50167728	50167736	0	9	0	2358	0	2349	0.0	0.0
chr17	SGCA	50169105	50169254	0	150	0	2358	0	2208	0.0	0.0
chr17	AC015909.1	50209053	50209072	0	20	0	2615	0	2595	0.0	0.0
chr17	AC015909.1	50209073	50209123	0	51	0	2615	0	2564	0.0	0.0
chr17	AC015909.1	50209053	50209123	0	71	0	2615	0	2544	0.0	0.0
chr17	AC015909.1	50209081	50209123	0	43	0	2615	0	2572	0.0	0.0
chr17	AC015909.1	50214175	50214316	0	142	0	2615	0	2473	0.0	0.0
chr17	AC015909.1	50209073	50209080	0	8	0	2615	0	2607	0.0	0.0
chr17	AC015909.1	50209053	50209080	0	28	0	2615	0	2587	0.0	0.0
chr17	AC015909.1	50214175	50214530	0	356	0	2615	0	2259	0.0	0.0
chr17	XYLT2	50346231	50346275	0	45	0	5479	0	5434	0.0	0.0
chr17	EME1	50375513	50375983	0	471	0	3178	0	2707	0.0	0.0
chr17	ACSF2	50472525	50472579	0	55	0	5152	0	5097	0.0	0.0
chr17	ACSF2	50461288	50461370	0	83	0	5152	0	5069	0.0	0.0
chr17	RSAD1	50484546	50484642	0	97	306	4146	306	4049	0.0	0.07557421585576686
chr17	RSAD1	50483432	50483487	0	56	306	4146	306	4090	0.0	0.07481662591687041
chr17	MYCBPAP	50517453	50517497	0	45	51	6482	51	6437	0.0	0.007922945471492932
chr17	MYCBPAP	50529189	50529430	0	242	51	6482	51	6240	0.0	0.008173076923076924
chr17	EPN3	50532845	50532985	0	141	102	4499	102	4358	0.0	0.023405231757687012
chr17	EPN3	50532923	50532985	0	63	102	4499	102	4436	0.0	0.022993688007213707
chr17	EPN3	50532845	50532922	0	78	102	4499	102	4421	0.0	0.023071703234562316
chr17	EPN3	50536200	50536278	0	79	102	4499	102	4420	0.0	0.023076923076923078
chr17	SPATA20	50547768	50547954	80	187	1700	4742	1620	4555	0.42780748663101603	0.3556531284302964
chr17	SPATA20	50551191	50551222	0	32	1700	4742	1700	4710	0.0	0.3609341825902335
chr17	CACNA1G	50617909	50617929	0	21	356	10101	356	10080	0.0	0.03531746031746032
chr17	CACNA1G	50608020	50608040	0	21	356	10101	356	10080	0.0	0.03531746031746032
chr17	ABCC3	50676454	50676588	0	135	459	8868	459	8733	0.0	0.052559257986946065
chr17	ABCC3	50658497	50658546	0	50	459	8868	459	8818	0.0	0.052052619641642095
chr17	ABCC3	50673139	50673169	0	31	459	8868	459	8837	0.0	0.051940703858775604
chr17	NME2	51166498	51166563	0	66	0	2502	0	2436	0.0	0.0
chr17	LINC02073	51341312	51341683	0	372	51	7442	51	7070	0.0	0.0072135785007072135
chr17	TOM1L1	54901182	54901245	766	64	13392	7265	12626	7201	11.96875	1.753367587835023
chr17	PCTP	55751245	55751477	300	233	924	5817	624	5584	1.2875536480686696	0.11174785100286533
chr17	AKAP1	57085867	57086074	927	208	34241	5359	33314	5151	4.456730769230769	6.467482042321879
chr17	AKAP1	57085870	57086074	927	205	34241	5359	33314	5154	4.521951219512195	6.46371750097012
chr17	RAD51C	58692633	58692685	0	53	7456	5705	7456	5652	0.0	1.319179051663128
chr17	RAD51C	58692686	58692788	0	103	7456	5705	7456	5602	0.0	1.3309532309889325
chr17	RAD51C	58692633	58692788	0	156	7456	5705	7456	5549	0.0	1.3436655253198775
chr17	RAD51C	58692686	58693650	0	965	7456	5705	7456	4740	0.0	1.5729957805907173
chr17	RAD51C	58692789	58693650	0	862	7456	5705	7456	4843	0.0	1.5395416064422878
chr17	RAD51C	58692633	58693650	0	1018	7456	5705	7456	4687	0.0	1.5907830168551311
chr17	RAD51C	58692686	58693811	0	1126	7456	5705	7456	4579	0.0	1.6283031229526097
chr17	RAD51C	58692789	58693811	0	1023	7456	5705	7456	4682	0.0	1.5924818453652285
chr17	RAD51C	58692633	58693811	0	1179	7456	5705	7456	4526	0.0	1.6473707467962881
chr17	RAD51C	58693651	58693811	0	161	7456	5705	7456	5544	0.0	1.3448773448773448
chr17	SMG8	59210262	59211810	204	1549	255	3602	51	2053	0.131697869593286	0.02484169508037019
chr17	SMG8	59212943	59213601	0	659	255	3602	255	2943	0.0	0.08664627930682976
chr17	SMG8	59211811	59212030	51	220	255	3602	204	3382	0.2318181818181818	0.06031933767001774
chr17	DHX40	59565724	59565783	0	60	248	5857	248	5797	0.0	0.0427807486631016
chr17	DHX40	59566710	59566794	0	85	248	5857	248	5772	0.0	0.042966042966042964
chr17	CLTC	59644484	59644495	0	12	2427	11871	2427	11859	0.0	0.20465469263850242
chr17	VMP1	59707749	59708077	0	329	118	5500	118	5171	0.0	0.022819570682653258
chr17	AC011921.1	60548567	60548695	0	129	26557	871	26557	742	0.0	35.7911051212938
chr17	BCAS3	61038050	61038054	0	5	10553	8054	10553	8049	0.0	1.3110945459063237
chr17	BCAS3	60887127	60887211	0	85	10553	8054	10553	7969	0.0	1.3242564939139165
chr17	BCAS3	60887312	60887447	0	136	10553	8054	10553	7918	0.0	1.3327860570851224
chr17	EFCAB3	62380590	62380613	0	24	30	3095	30	3071	0.0	0.00976880494952784
chr17	MRC2	62678618	62678646	540	29	6658	6443	6118	6414	18.620689655172413	0.95385095104459
chr17	TANC2	63099247	63099357	0	111	7841	19851	7841	19740	0.0	0.39721377912867273
chr17	ACE	63484970	63485066	0	97	4513	8236	4513	8139	0.0	0.5544907236761273
chr17	KCNH6	63524237	63524369	0	133	12821	4226	12821	4093	0.0	3.132421206938676
chr17	MAP3K3	63685579	63685590	0	12	157	5824	157	5812	0.0	0.027013076393668272
chr17	MAP3K3	63632799	63632802	0	4	157	5824	157	5820	0.0	0.026975945017182132
chr17	SNHG25	64145996	64146000	0	5	0	280	0	275	0.0	0.0
chr17	CEP95	64531019	64531022	4	4	4076	6734	4072	6730	1.0	0.6050520059435364
chr17	RGS9	65177795	65177803	0	9	2591	7076	2591	7067	0.0	0.36663364935616244
chr17	RGS9	65208008	65208011	0	4	2591	7076	2591	7072	0.0	0.36637443438914025
chr17	BPTF	67945897	67946325	0	429	51	14493	51	14064	0.0	0.003626279863481229
chr17	KPNA2	68035837	68035840	0	4	408	6696	408	6692	0.0	0.06096832038254633
chr17	AMZ2	68248087	68248157	0	71	0	3654	0	3583	0.0	0.0
chr17	AMZ2	68248111	68248157	0	47	0	3654	0	3607	0.0	0.0
chr17	AMZ2	68248087	68248110	0	24	0	3654	0	3630	0.0	0.0
chr17	AMZ2	68248158	68248162	0	5	0	3654	0	3649	0.0	0.0
chr17	AMZ2	68248087	68248162	0	76	0	3654	0	3578	0.0	0.0
chr17	AMZ2	68248111	68248162	0	52	0	3654	0	3602	0.0	0.0
chr17	AMZ2	68250129	68250470	0	342	0	3654	0	3312	0.0	0.0
chr17	AMZ2	68250471	68250480	0	10	0	3654	0	3644	0.0	0.0
chr17	PRKAR1A	68515567	68515576	0	10	51	6098	51	6088	0.0	0.008377135348226018
chr17	PRKAR1A	68512549	68512579	0	31	51	6098	51	6067	0.0	0.008406131531234548
chr17	PRKAR1A	68512496	68512579	0	84	51	6098	51	6014	0.0	0.008480212836714332
chr17	PRKAR1A	68512496	68512548	0	53	51	6098	51	6045	0.0	0.008436724565756825
chr17	PRKAR1A	68512971	68512978	0	8	51	6098	51	6090	0.0	0.008374384236453201
chr17	PRKAR1A	68512979	68513271	0	293	51	6098	51	5805	0.0	0.008785529715762274
chr17	MAP2K6	69517552	69517613	0	62	153	15176	153	15114	0.0	0.010123064708217546
chr17	MAP2K6	69502685	69502685	0	1	153	15176	153	15175	0.0	0.010082372322899505
chr17	AC118653.1	71596567	71596574	0	8	0	572	0	564	0.0	0.0
chr17	COG1	73206818	73206908	0	91	12922	4290	12922	4199	0.0	3.0773993808049536
chr17	C17ORF80	73232630	73232717	577	88	168752	4671	168175	4583	6.556818181818182	36.695396028802094
chr17	AC124804.1	73518391	73518523	4001	133	171704	4841	167703	4708	30.082706766917294	35.62085811384877
chr17	LINC02092	73787372	73787699	2383	328	23798	3086	21415	2758	7.265243902439025	7.764684554024655
chr17	RPL38	74203711	74203745	0	35	0	3653	0	3618	0.0	0.0
chr17	RPL38	74203711	74203770	0	60	0	3653	0	3593	0.0	0.0
chr17	RPL38	74203746	74203770	0	25	0	3653	0	3628	0.0	0.0
chr17	DNAI2	74312076	74312230	0	155	3120	2878	3120	2723	0.0	1.1457950789570326
chr17	GPR142	74367749	74367794	0	46	270	1561	270	1515	0.0	0.1782178217821782
chr17	GPR142	74369583	74369634	0	52	270	1561	270	1509	0.0	0.17892644135188868
chr17	GPRC5C	74440047	74440827	0	781	5960	5898	5960	5117	0.0	1.1647449677545436
chr17	GPRC5C	74432142	74432523	0	382	5960	5898	5960	5516	0.0	1.0804931109499638
chr17	CD300A	74466656	74466743	0	88	19985	2709	19985	2621	0.0	7.6249523082792825
chr17	KCTD2	75032654	75032724	0	71	102	5290	102	5219	0.0	0.019543973941368076
chr17	ARMC7	75110543	75110606	0	64	0	2712	0	2648	0.0	0.0
chr17	NUP85	75231980	75232116	0	137	35616	4297	35616	4160	0.0	8.561538461538461
chr17	NUP85	75234789	75234794	0	6	35616	4297	35616	4291	0.0	8.300163132137031
chr17	MRPS7	75265965	75265966	0	2	51	3331	51	3329	0.0	0.015319915890657855
chr17	TMEM94	75491853	75491900	1578	48	345606	7638	344028	7590	32.875	45.32648221343874
chr17	TMEM94	75471930	75471955	52	26	345606	7638	345554	7612	2.0	45.395953757225435
chr17	TMEM94	75491456	75491467	365	12	345606	7638	345241	7626	30.416666666666668	45.27157094151587
chr17	TSEN54	75522334	75522521	0	188	0	2942	0	2754	0.0	0.0
chr17	MYO15B	75606022	75606058	0	37	29	12656	29	12619	0.0	0.0022981218797052064
chr17	MYO15B	75624250	75624269	0	20	29	12656	29	12636	0.0	0.0022950300728078504
chr17	MYO15B	75624640	75624688	0	49	29	12656	29	12607	0.0	0.002300309351947331
chr17	ITGB4	75721564	75721612	0	49	0	6607	0	6558	0.0	0.0
chr17	UNK	75812289	75812360	0	72	34	5560	34	5488	0.0	0.00619533527696793
chr17	TEN1-CDK3	75991578	75991623	0	46	2948	3907	2948	3861	0.0	0.7635327635327636
chr17	ZACN	76080425	76081118	0	694	9012	3339	9012	2645	0.0	3.4071833648393195
chr17	UBALD2	76265404	76265625	0	222	102	1630	102	1408	0.0	0.07244318181818182
chr17	SPHK1	76384807	76385169	71	363	5519	4022	5448	3659	0.19559228650137742	1.4889314020224105
chr17	PRCD	76543933	76544370	51	438	51	5045	0	4607	0.11643835616438356	0.0
chr17	PRCD	76545637	76547372	0	1736	51	5045	51	3309	0.0	0.015412511332728921
chr17	PRCD	76546132	76547372	0	1241	51	5045	51	3804	0.0	0.013406940063091483
chr17	SNHG16	76561399	76561402	0	4	0	5256	0	5252	0.0	0.0
chr17	SNHG16	76558601	76559043	0	443	0	5256	0	4813	0.0	0.0
chr17	SNHG16	76557858	76559043	0	1186	0	5256	0	4070	0.0	0.0
chr17	METTL23	76726880	76727213	107	334	450	1838	343	1504	0.3203592814371258	0.22805851063829788
chr17	METTL23	76727179	76727213	56	35	450	1838	394	1803	1.6	0.2185246810870771
chr17	METTL23	76726880	76727178	51	299	450	1838	399	1539	0.1705685618729097	0.25925925925925924
chr17	METTL23	76733378	76733381	0	4	450	1838	450	1834	0.0	0.24536532170119957
chr17	METTL23	76726880	76727357	450	478	450	1838	0	1360	0.9414225941422594	0.0
chr17	METTL23	76727214	76727357	343	144	450	1838	107	1694	2.3819444444444446	0.06316410861865407
chr17	METTL23	76727179	76727357	399	179	450	1838	51	1659	2.2290502793296088	0.03074141048824593
chr17	MFSD11	76737999	76738165	0	167	7254	5442	7254	5275	0.0	1.3751658767772512
chr17	MFSD11	76737977	76738165	0	189	7254	5442	7254	5253	0.0	1.3809251856082239
chr17	MFSD11	76737884	76738165	160	282	7254	5442	7094	5160	0.5673758865248227	1.3748062015503877
chr17	MFSD11	76737977	76737998	0	22	7254	5442	7254	5420	0.0	1.3383763837638376
chr17	MFSD11	76737884	76737998	160	115	7254	5442	7094	5327	1.391304347826087	1.3317064013516051
chr17	MFSD11	76737884	76737976	160	93	7254	5442	7094	5349	1.7204301075268817	1.3262292017199477
chr17	SNHG20	77088683	77088949	0	267	10	4357	10	4090	0.0	0.0024449877750611247
chr17	SNHG20	77088878	77088949	0	72	10	4357	10	4285	0.0	0.002333722287047841
chr17	SNHG20	77088950	77088985	0	36	10	4357	10	4321	0.0	0.0023142791020597086
chr17	SNHG20	77088878	77088985	0	108	10	4357	10	4249	0.0	0.002353494939985879
chr17	SEC14L1	77141055	77141107	0	53	102	8098	102	8045	0.0	0.012678682411435674
chr17	SEPTIN9	77288211	77288214	0	4	0	13488	0	13484	0.0	0.0
chr17	SEPTIN9	77453997	77454363	0	367	0	13488	0	13121	0.0	0.0
chr17	SEPTIN9	77454109	77454363	0	255	0	13488	0	13233	0.0	0.0
chr17	SEPTIN9	77454364	77454449	0	86	0	13488	0	13402	0.0	0.0
chr17	SEPTIN9	77454109	77454449	0	341	0	13488	0	13147	0.0	0.0
chr17	AC021683.3	77517326	77517522	0	197	0	5420	0	5223	0.0	0.0
chr17	AC021683.3	77527146	77527495	0	350	0	5420	0	5070	0.0	0.0
chr17	AC021683.3	77527845	77527858	0	14	0	5420	0	5406	0.0	0.0
chr17	TNRC6C	78051449	78051457	9	9	25733	11136	25724	11127	1.0	2.311854048710344
chr17	TMC8	78130852	78130887	0	36	217	5471	217	5435	0.0	0.03992640294388224
chr17	TMC8	78137324	78137358	0	35	217	5471	217	5436	0.0	0.03991905813097866
chr17	TMC8	78132031	78132214	0	184	217	5471	217	5287	0.0	0.04104407036126348
chr17	AFMID	78205739	78205753	90	15	19354	4061	19264	4046	6.0	4.7612456747404845
chr17	BIRC5	78216035	78216066	0	32	19594	3820	19594	3788	0.0	5.172650475184794
chr17	BIRC5	78214790	78214793	0	4	19594	3820	19594	3816	0.0	5.134696016771488
chr17	PGS1	78419676	78419725	0	50	7166	4741	7166	4691	0.0	1.5276060541462375
chr17	DNAH17-AS1	78485091	78485162	0	72	1122	7667	1122	7595	0.0	0.1477287689269256
chr17	ENGASE	79083932	79083951	1122	20	38216	6011	37094	5991	56.1	6.191620764480054
chr17	ENGASE	79082064	79082877	5080	814	38216	6011	33136	5197	6.240786240786241	6.375986145853377
chr17	CCDC40	80036692	80036757	1001	66	131490	8392	130489	8326	15.166666666666666	15.672471775162142
chr17	GAA	80101626	80101890	765	265	39243	5083	38478	4818	2.8867924528301887	7.986301369863014
chr17	GAA	80101891	80101925	0	35	39243	5083	39243	5048	0.0	7.773969889064976
chr17	CARD14	80204342	80204351	340	10	379763	9239	379423	9229	34.0	41.11203814064363
chr17	CARD14	80170057	80170136	51	80	379763	9239	379712	9159	0.6375	41.457801069985805
chr17	CARD14	80198163	80198173	55	11	379763	9239	379708	9228	5.0	41.14737754659731
chr17	ENDOV	80415611	80415821	4928	211	105383	6269	100455	6058	23.355450236966824	16.58220534829977
chr17	BAIAP2	81053740	81053743	0	4	0	8058	0	8054	0.0	0.0
chr17	BAIAP2	81085716	81085725	0	10	0	8058	0	8048	0.0	0.0
chr17	BAIAP2	81053744	81053791	0	48	0	8058	0	8010	0.0	0.0
chr17	BAIAP2	81053740	81053791	0	52	0	8058	0	8006	0.0	0.0
chr17	BAIAP2	81110956	81110959	0	4	0	8058	0	8054	0.0	0.0
chr17	NDUFAF8	81239679	81239682	0	4	0	1254	0	1250	0.0	0.0
chr17	CCDC137	81666901	81667007	0	107	0	2396	0	2289	0.0	0.0
chr17	HGS	81688791	81688827	0	37	0	8542	0	8505	0.0	0.0
chr17	HGS	81690209	81690234	0	26	0	8542	0	8516	0.0	0.0
chr17	HGS	81693963	81693965	0	3	0	8542	0	8539	0.0	0.0
chr17	HGS	81696526	81696529	0	4	0	8542	0	8538	0.0	0.0
chr17	HGS	81696700	81696747	0	48	0	8542	0	8494	0.0	0.0
chr17	HGS	81700478	81700600	0	123	0	8542	0	8419	0.0	0.0
chr17	HGS	81700811	81700814	0	4	0	8542	0	8538	0.0	0.0
chr17	HGS	81701128	81701131	0	4	0	8542	0	8538	0.0	0.0
chr17	HGS	81684892	81685069	0	178	0	8542	0	8364	0.0	0.0
chr17	HGS	81696000	81696041	0	42	0	8542	0	8500	0.0	0.0
chr17	HGS	81696004	81696041	0	38	0	8542	0	8504	0.0	0.0
chr17	HGS	81685690	81685693	0	4	0	8542	0	8538	0.0	0.0
chr17	HGS	81693966	81694050	0	85	0	8542	0	8457	0.0	0.0
chr17	HGS	81693963	81694050	0	88	0	8542	0	8454	0.0	0.0
chr17	HGS	81696000	81696003	0	4	0	8542	0	8538	0.0	0.0
chr17	HGS	81696530	81696531	0	2	0	8542	0	8540	0.0	0.0
chr17	HGS	81696526	81696531	0	6	0	8542	0	8536	0.0	0.0
chr17	HGS	81701419	81701422	0	4	0	8542	0	8538	0.0	0.0
chr17	ANAPC11	81891834	81891841	0	8	0	2490	0	2482	0.0	0.0
chr17	ANAPC11	81894587	81894624	0	38	0	2490	0	2452	0.0	0.0
chr17	ANAPC11	81891842	81891863	0	22	0	2490	0	2468	0.0	0.0
chr17	ANAPC11	81891834	81891863	0	30	0	2490	0	2460	0.0	0.0
chr17	ANAPC11	81899328	81899542	0	215	0	2490	0	2275	0.0	0.0
chr17	ANAPC11	81891830	81891841	0	12	0	2490	0	2478	0.0	0.0
chr17	ASPSCR1	82017089	82017113	0	25	0	8568	0	8543	0.0	0.0
chr17	ASPSCR1	81978340	81978804	0	465	0	8568	0	8103	0.0	0.0
chr17	RAC3	82032459	82032498	0	40	0	1479	0	1439	0.0	0.0
chr17	DCXR-DT	82038269	82038413	0	145	0	585	0	440	0.0	0.0
chr17	GPS1	82052443	82052459	0	17	0	3905	0	3888	0.0	0.0
chr17	GPS1	82051965	82052459	0	495	0	3905	0	3410	0.0	0.0
chr17	SLC16A3	82236845	82236872	0	28	0	5874	0	5846	0.0	0.0
chr17	SLC16A3	82228530	82228545	0	16	0	5874	0	5858	0.0	0.0
chr17	AC132872.5	82273924	82274483	0	560	0	4275	0	3715	0.0	0.0
chr17	HEXD	82441071	82441075	0	5	0	4126	0	4121	0.0	0.0
chr17	HEXD	82439714	82440334	0	621	0	4126	0	3505	0.0	0.0
chr17	NARF	82458509	82458517	0	9	0	6641	0	6632	0.0	0.0
chr17	NARF	82484931	82484950	0	20	0	6641	0	6621	0.0	0.0
chr17	NARF	82460073	82460323	0	251	0	6641	0	6390	0.0	0.0
chr17	FOXK2	82559448	82559480	0	33	0	7313	0	7280	0.0	0.0
chr17	FN3KRP	82720842	82720965	0	124	0	2954	0	2830	0.0	0.0
chr18	CLUL1	616758	616764	0	7	6705	3861	6705	3854	0.0	1.7397509081473794
chr18	AP000829.1	1133895	1133952	0	58	51	2283	51	2225	0.0	0.02292134831460674
chr18	AP005262.1	1509224	1509337	0	114	51	9198	51	9084	0.0	0.005614266842800529
chr18	MYL12A	3252326	3252482	2147	157	4590647	2866	4588500	2709	13.67515923566879	1693.7984496124031
chr18	MYL12B	3262757	3262784	93	28	2434309	1549	2434216	1521	3.3214285714285716	1600.4049967126891
chr18	TGIF1	3449657	3450070	2013	414	290076	7818	288063	7404	4.86231884057971	38.906401944894654
chr18	TGIF1	3451772	3451775	40	4	290076	7818	290036	7814	10.0	37.11748144356284
chr18	TGIF1	3451763	3451775	130	13	290076	7818	289946	7805	10.0	37.14875080076874
chr18	TGIF1	3451763	3451771	90	9	290076	7818	289986	7809	10.0	37.13484441029581
chr18	TGIF1	3451776	3452382	1737	607	290076	7818	288339	7211	2.8616144975288305	39.98599362085702
chr18	TGIF1	3451772	3452382	1777	611	290076	7818	288299	7207	2.9083469721767594	40.00263632579437
chr18	TGIF1	3451763	3452382	1867	620	290076	7818	288209	7198	3.011290322580645	40.040150041678245
chr18	GAPLINC	3467271	3467296	0	26	0	1056	0	1030	0.0	0.0
chr18	AP002478.1	3653212	3653335	0	124	459	1765	459	1641	0.0	0.2797074954296161
chr18	LINC01892	5085229	5085962	0	734	0	2813	0	2079	0.0	0.0
chr18	LINC00667	5238894	5239049	15611	156	190677	9559	175066	9403	100.07051282051282	18.618100606189515
chr18	LINC00667	5241813	5241889	103	77	190677	9559	190574	9482	1.3376623376623376	20.098502425648597
chr18	LINC00667	5239050	5239196	12028	147	190677	9559	178649	9412	81.82312925170068	18.980981725456864
chr18	LINC00667	5238894	5239196	27639	303	190677	9559	163038	9256	91.21782178217822	17.614304235090753
chr18	LINC00667	5241256	5241812	8339	557	190677	9559	182338	9002	14.971274685816876	20.255276605198844
chr18	LINC00667	5239197	5241812	36217	2616	190677	9559	154460	6943	13.844418960244647	22.24686734840847
chr18	LINC00667	5240709	5241255	2503	547	190677	9559	188174	9012	4.575868372943328	20.880381713271195
chr18	LINC00667	5240820	5241255	1476	436	190677	9559	189201	9123	3.385321100917431	20.73890167707991
chr18	LINC00667	5240965	5241255	1026	291	190677	9559	189651	9268	3.5257731958762886	20.46299093655589
chr18	LINC00667	5241256	5241889	8442	634	190677	9559	182235	8925	13.315457413249211	20.41848739495798
chr18	LINC00667	5239197	5241889	36320	2693	190677	9559	154357	6866	13.486817675454883	22.4813574133411
chr18	LINC00667	5240709	5240819	1027	111	190677	9559	189650	9448	9.252252252252251	20.07303132938188
chr18	LINC00667	5239197	5241255	27878	2059	190677	9559	162799	7500	13.539582321515299	21.706533333333333
chr18	LINC00667	5239050	5241255	39906	2206	190677	9559	150771	7353	18.089755213055305	20.5046919624643
chr18	LINC00667	5238894	5241255	55517	2362	190677	9559	135160	7197	23.504233700254023	18.78004724190635
chr18	LINC00667	5240616	5241255	3374	640	190677	9559	187303	8919	5.271875	21.000448480771386
chr18	LINC00667	5240278	5241255	3743	978	190677	9559	186934	8581	3.82719836400818	21.784640484791982
chr18	LINC00667	5240709	5240964	1477	256	190677	9559	189200	9303	5.76953125	20.33752552939912
chr18	LINC00667	5240820	5240964	450	145	190677	9559	190227	9414	3.103448275862069	20.206819630337794
chr18	MIR3976HG	5793705	5793742	0	38	0	12474	0	12436	0.0	0.0
chr18	MIR3976HG	5750833	5750904	0	72	0	12474	0	12402	0.0	0.0
chr18	MIR3976HG	5762474	5762619	0	146	0	12474	0	12328	0.0	0.0
chr18	ARHGAP28	6868232	6868234	0	3	102	11935	102	11932	0.0	0.008548441166610795
chr18	NDUFV2	9102798	9103433	11960	636	609648	2300	597688	1664	18.80503144654088	359.1875
chr18	NDUFV2	9102963	9103433	11830	471	609648	2300	597818	1829	25.116772823779193	326.8551120831055
chr18	ANKRD12	9208798	9208803	12	6	75494	12266	75482	12260	2.0	6.156769983686786
chr18	ANKRD12	9136966	9137096	44	131	75494	12266	75450	12135	0.33587786259541985	6.217552533992583
chr18	TXNDC2	9886081	9886283	0	203	7140	3299	7140	3096	0.0	2.306201550387597
chr18	LINC01255	11505925	11505956	0	32	0	8070	0	8038	0.0	0.0
chr18	LINC01255	11490966	11490995	0	30	0	8070	0	8040	0.0	0.0
chr18	IMPA2	12012216	12012349	617	134	268401	3420	267784	3286	4.604477611940299	81.49239196591601
chr18	AP005264.4	12218831	12218832	0	2	255	2207	255	2205	0.0	0.11564625850340136
chr18	CIDEA	12254422	12254956	0	535	0	1816	0	1281	0.0	0.0
chr18	PRELID3A	12429434	12429436	151	3	99411	2584	99260	2581	50.333333333333336	38.45796203022084
chr18	PSMG2	12658206	12658343	1063	138	825504	2401	824441	2263	7.702898550724638	364.31330092797174
chr18	LDLRAD4	13612065	13612774	0	710	918	29113	918	28403	0.0	0.03232052952152942
chr18	LDLRAD4	13612775	13613168	0	394	918	29113	918	28719	0.0	0.03196490128486368
chr18	RBBP8	22934079	22934159	0	81	150	5107	150	5026	0.0	0.029844807003581376
chr18	RBBP8	22934079	22934264	0	186	150	5107	150	4921	0.0	0.03048160942897785
chr18	RBBP8	22934160	22934264	0	105	150	5107	150	5002	0.0	0.029988004798080767
chr18	CABLES1	23134652	23134670	0	19	0	6524	0	6505	0.0	0.0
chr18	RIOK3	23473484	23473626	0	143	153	4777	153	4634	0.0	0.0330168321104877
chr18	CABYR	24156043	24156999	0	957	0	3482	0	2525	0.0	0.0
chr18	CABYR	24150625	24150631	0	7	0	3482	0	3475	0.0	0.0
chr18	IMPACT	24426744	24426792	0	49	0	4343	0	4294	0.0	0.0
chr18	IMPACT	24450815	24450867	0	53	0	4343	0	4290	0.0	0.0
chr18	AC007922.4	24500610	24500624	0	15	3	857	3	842	0.0	0.0035629453681710215
chr18	LINC01915	24692641	24692670	0	30	0	10136	0	10106	0.0	0.0
chr18	LINC01915	24694367	24694527	0	161	0	10136	0	9975	0.0	0.0
chr18	AC018697.1	24726758	24726761	0	4	0	8294	0	8290	0.0	0.0
chr18	PSMA8	26144572	26144685	0	114	0	1902	0	1788	0.0	0.0
chr18	LINC01543	26425128	26425301	0	174	0	1147	0	973	0.0	0.0
chr18	AC012588.1	26688155	26688333	0	179	0	2696	0	2517	0.0	0.0
chr18	TTR	31576169	31576271	0	103	0	2183	0	2080	0.0	0.0
chr18	ASXL3	33578974	33579107	114	134	323536	13548	323422	13414	0.8507462686567164	24.110779782316982
chr18	MAPRE2	35041662	35041766	0	105	0	6148	0	6043	0.0	0.0
chr18	ZNF397	35241072	35241109	0	38	0	8716	0	8678	0.0	0.0
chr18	ZNF397	35241110	35241690	0	581	0	8716	0	8135	0.0	0.0
chr18	ZNF397	35241072	35241690	0	619	0	8716	0	8097	0.0	0.0
chr18	ZNF397	35242885	35242941	0	57	0	8716	0	8659	0.0	0.0
chr18	ZNF271P	35290392	35291232	0	841	0	7454	0	6613	0.0	0.0
chr18	C18ORF21	35972841	35972907	0	67	0	1621	0	1554	0.0	0.0
chr18	KIAA1328	37222118	37225283	0	3166	610	9612	610	6446	0.0	0.09463233012721067
chr18	KIAA1328	36923958	36923961	0	4	610	9612	610	9608	0.0	0.063488759367194
chr18	LINC01902	39870969	39875941	0	4973	0	12838	0	7865	0.0	0.0
chr18	LINC01902	39865912	39866037	0	126	0	12838	0	12712	0.0	0.0
chr18	SLC14A2	45615547	45615582	24	36	24	4754	0	4718	0.6666666666666666	0.0
chr18	SLC14A1	45730121	45730471	0	351	0	6081	0	5730	0.0	0.0
chr18	SIGLEC15	45837886	45837896	0	11	0	3457	0	3446	0.0	0.0
chr18	HAUS1	46105369	46105408	0	40	51	2132	51	2092	0.0	0.024378585086042064
chr18	CTIF	48758406	48758411	0	6	1884	6386	1884	6380	0.0	0.29529780564263325
chr18	LIPG	49561461	49561890	0	430	0	11485	0	11055	0.0	0.0
chr18	SKA1	50375195	50375239	0	45	0	2904	0	2859	0.0	0.0
chr18	SMAD4	51030277	51030623	0	347	0	10684	0	10337	0.0	0.0
chr18	DCC	53486953	53486958	0	6	4935	13013	4935	13007	0.0	0.37941108633812565
chr18	POLI	54269662	54270032	2554	371	630654	9485	628100	9114	6.884097035040432	68.91595347816546
chr18	POLI	54284014	54284065	1408	52	630654	9485	629246	9433	27.076923076923077	66.70688010177038
chr18	C18ORF54	54361892	54362431	4945	540	9876	4915	4931	4375	9.157407407407407	1.1270857142857142
chr18	C18ORF54	54361949	54362431	4226	483	9876	4915	5650	4432	8.749482401656314	1.2748194945848375
chr18	C18ORF54	54361892	54361948	719	57	9876	4915	9157	4858	12.614035087719298	1.8849320708110333
chr18	LINC01905	56063232	56063353	500	122	1497	3707	997	3585	4.098360655737705	0.2781032078103208
chr18	LINC01905	56063289	56063353	200	65	1497	3707	1297	3642	3.076923076923077	0.3561230093355299
chr18	LINC01905	56063232	56063288	300	57	1497	3707	1197	3650	5.2631578947368425	0.32794520547945205
chr18	AC006305.3	56137826	56137943	0	118	10853	1531	10853	1413	0.0	7.680820948336872
chr18	NEDD4L	58091515	58091627	0	113	51	30352	51	30239	0.0	0.001686563709117365
chr18	NEDD4L	58149560	58149569	0	10	51	30352	51	30342	0.0	0.0016808384417638916
chr18	NEDD4L	58227889	58227907	0	19	51	30352	51	30333	0.0	0.001681337157551182
chr18	ZNF532	58863687	58863750	0	64	0	9593	0	9529	0.0	0.0
chr18	ZNF532	58864987	58865385	0	399	0	9593	0	9194	0.0	0.0
chr18	SEC11C	59152613	59152685	0	73	102	3813	102	3740	0.0	0.02727272727272727
chr18	GRP	59225716	59225734	0	19	102	843	102	824	0.0	0.12378640776699029
chr18	AC090621.1	60294312	60294673	0	362	0	998	0	636	0.0	0.0
chr18	AC010928.1	60643579	60643580	0	2	8903	1706	8903	1704	0.0	5.224765258215962
chr18	RELCH	62282443	62282444	0	2	100	10758	100	10756	0.0	0.009297136481963555
chr18	SERPINB12	63558427	63558486	0	60	0	1285	0	1225	0.0	0.0
chr18	SERPINB13	63589713	63589715	0	3	0	4545	0	4542	0.0	0.0
chr18	SERPINB13	63589716	63589742	0	27	0	4545	0	4518	0.0	0.0
chr18	SERPINB13	63589713	63589742	0	30	0	4545	0	4515	0.0	0.0
chr18	SERPINB8	63970171	63970187	0	17	0	5687	0	5670	0.0	0.0
chr18	LINC01924	64147371	64147475	0	105	0	3465	0	3360	0.0	0.0
chr18	AC021701.1	70206483	70206574	0	92	0	2394	0	2302	0.0	0.0
chr18	CNDP2	74497596	74497726	0	131	37641	7642	37641	7511	0.0	5.011449873518839
chr18	CNDP1	74561012	74561018	49	7	5346	6780	5297	6773	7.0	0.7820758895614942
chr18	TSHZ1	75211244	75211916	0	673	51	5987	51	5314	0.0	0.00959729017689123
chr18	LINC01893	76214457	76214493	0	37	0	1662	0	1625	0.0	0.0
chr18	LINC00683	76619571	76620021	0	451	102	14982	102	14531	0.0	0.007019475603881357
chr18	LINC00683	76620022	76621194	0	1173	102	14982	102	13809	0.0	0.007386487073647621
chr18	NFATC1	79451042	79451126	0	85	0	9083	0	8998	0.0	0.0
chr18	NFATC1	79486631	79486937	0	307	0	9083	0	8776	0.0	0.0
chr18	ADNP2	80117585	80117650	0	66	0	5664	0	5598	0.0	0.0
chr18	ENOSF1	712359	712502	102	144	2531416	9343	2531314	9199	0.7083333333333334	275.1727361669747
chr18	ENOSF1	712359	712376	0	18	2531416	9343	2531416	9325	0.0	271.46552278820377
chr18	ENOSF1	712377	712502	102	126	2531416	9343	2531314	9217	0.8095238095238095	274.63534772702616
chr18	LINC00470	1269669	1269685	0	17	0	7735	0	7718	0.0	0.0
chr18	LINC00470	1361142	1361175	0	34	0	7735	0	7701	0.0	0.0
chr18	METTL4	2566820	2567510	32659	691	212012	3516	179353	2825	47.26338639652677	63.48778761061947
chr18	MYOM1	3151693	3151694	0	2	2142	6472	2142	6470	0.0	0.33106646058732614
chr18	AP005329.1	3261271	3261608	2049	338	472309	1066	470260	728	6.062130177514793	645.9615384615385
chr18	LINC01895	3358401	3358437	0	37	0	2092	0	2055	0.0	0.0
chr18	DLGAP1	3874147	3874152	0	6	102	12099	102	12093	0.0	0.008434631605060779
chr18	EPB41L3	5406764	5406775	0	12	204	9610	204	9598	0.0	0.02125442800583455
chr18	EPB41L3	5488861	5488999	0	139	204	9610	204	9471	0.0	0.021539436173582515
chr18	LINC00668	6929738	6929781	0	44	0	3701	0	3657	0.0	0.0
chr18	PPP4R1	9615018	9615182	267	165	1387250	7841	1386983	7676	1.6181818181818182	180.69085461177696
chr18	LINC01887	10616832	10616833	0	2	0	861	0	859	0.0	0.0
chr18	PIEZO2	10680198	10680273	0	76	0	15683	0	15607	0.0	0.0
chr18	NPIPB1P	11629641	11629644	0	4	6674	1141	6674	1137	0.0	5.869832893579596
chr18	MPPE1	11905737	11905910	14610	174	385619	5862	371009	5688	83.96551724137932	65.22661744022504
chr18	SPIRE1	12656574	12656649	0	76	886274	6556	886274	6480	0.0	136.77067901234568
chr18	CEP76	12697222	12697227	320	6	232172	5989	231852	5983	53.333333333333336	38.751796757479525
chr18	AP005901.1	15325556	15325659	0	104	153	1803	153	1699	0.0	0.09005297233666863
chr18	ABHD3	21663677	21664116	255	440	3125	4348	2870	3908	0.5795454545454546	0.7343909928352098
chr18	MIR133A1HG	21831175	21831320	0	146	102	4362	102	4216	0.0	0.024193548387096774
chr18	GATA6-AS1	22168043	22168084	0	42	0	2648	0	2606	0.0	0.0
chr18	ANKRD29	23629852	23629855	0	4	32401	6292	32401	6288	0.0	5.152830788804072
chr18	OSBPL1A	24368286	24368365	0	80	35137	7984	35137	7904	0.0	4.44547064777328
chr18	OSBPL1A	24397572	24397653	0	82	35137	7984	35137	7902	0.0	4.446595798532017
chr18	SS18	26091003	26091094	0	92	51	6099	51	6007	0.0	0.008490094889295821
chr18	SS18	26089757	26089823	0	67	51	6099	51	6032	0.0	0.008454907161803714
chr18	DSG2-AS1	31555962	31556575	0	614	0	2000	0	1386	0.0	0.0
chr18	TRAPPC8	31942607	31942950	0	344	153	7830	153	7486	0.0	0.020438151215602458
chr18	ZSCAN30	35290083	35290129	0	47	51	5878	51	5831	0.0	0.008746355685131196
chr18	ZNF24	35344359	35344368	0	10	0	8250	0	8240	0.0	0.0
chr18	INO80C	35480452	35480454	0	3	0	5014	0	5011	0.0	0.0
chr18	SLC39A6	36129100	36129112	0	13	0	3680	0	3667	0.0	0.0
chr18	CELF4	37266532	37266534	0	3	2099	4935	2099	4932	0.0	0.42558799675588
chr18	CELF4	37274310	37274312	0	3	2099	4935	2099	4932	0.0	0.42558799675588
chr18	CELF4	37321802	37321831	0	30	2099	4935	2099	4905	0.0	0.4279306829765545
chr18	CELF4	37321802	37321828	0	27	2099	4935	2099	4908	0.0	0.4276691116544417
chr18	CELF4	37259120	37259179	15	60	2099	4935	2084	4875	0.25	0.4274871794871795
chr18	CELF4	37321829	37321831	0	3	2099	4935	2099	4932	0.0	0.42558799675588
chr18	AC100781.1	38660737	38660738	0	2	0	882	0	880	0.0	0.0
chr18	MIR924HG	39233108	39233401	0	294	416	11691	416	11397	0.0	0.03650083355268931
chr18	MIR924HG	39751830	39751903	0	74	416	11691	416	11617	0.0	0.03580958939485237
chr18	MIR924HG	39340490	39340584	0	95	416	11691	416	11596	0.0	0.03587443946188341
chr18	SYT4	43277247	43277341	0	95	0	2529	0	2434	0.0	0.0
chr18	AC090376.1	45181000	45181149	0	150	349	3400	349	3250	0.0	0.10738461538461538
chr18	AC090376.1	45169387	45169430	11	44	349	3400	338	3356	0.25	0.10071513706793803
chr18	ATP5F1A	46089822	46089887	0	66	1187	7373	1187	7307	0.0	0.16244696866018887
chr18	ATP5F1A	46097835	46098170	0	336	1187	7373	1187	7037	0.0	0.16867983515702714
chr18	ATP5F1A	46094979	46095051	0	73	1187	7373	1187	7300	0.0	0.1626027397260274
chr18	LOXHD1	46477639	46477652	922	14	91845	8983	90923	8969	65.85714285714286	10.137473519901885
chr18	LOXHD1	46520297	46520575	0	279	91845	8983	91845	8704	0.0	10.552045036764707
chr18	LOXHD1	46559073	46559168	0	96	91845	8983	91845	8887	0.0	10.334758636210195
chr18	HDHD2	47136301	47136337	0	37	0	4612	0	4575	0.0	0.0
chr18	SMAD2	47930251	47930359	0	109	785738	36439	785738	36330	0.0	21.627800715661987
chr18	SMAD2	47930795	47930798	0	4	785738	36439	785738	36435	0.0	21.56547275970907
chr18	ZBTB7C	48165126	48165129	0	4	0	7629	0	7625	0.0	0.0
chr18	ZBTB7C	48180329	48180385	0	57	0	7629	0	7572	0.0	0.0
chr18	DYM	49368601	49368670	0	70	161	12141	161	12071	0.0	0.013337751636152763
chr18	DYM	49368601	49368616	0	16	161	12141	161	12125	0.0	0.013278350515463918
chr18	DYM	49368617	49368670	0	54	161	12141	161	12087	0.0	0.013320095970877802
chr18	RPL17	49491735	49491744	0	10	0	2096	0	2086	0.0	0.0
chr18	RPL17	49492257	49492273	0	17	0	2096	0	2079	0.0	0.0
chr18	RPL17	49491531	49491624	0	94	0	2096	0	2002	0.0	0.0
chr18	RPL17	49492130	49492256	0	127	0	2096	0	1969	0.0	0.0
chr18	RPL17	49492130	49492273	0	144	0	2096	0	1952	0.0	0.0
chr18	ACAA2	49813731	49813815	0	85	0	4883	0	4798	0.0	0.0
chr18	ACAA2	49813681	49813815	0	135	0	4883	0	4748	0.0	0.0
chr18	ACAA2	49813681	49813730	0	50	0	4883	0	4833	0.0	0.0
chr18	MBD1	50272823	50272846	0	24	0	5812	0	5788	0.0	0.0
chr18	MBD1	50281362	50281573	0	212	0	5812	0	5600	0.0	0.0
chr18	CXXC1	50284719	50284730	0	12	0	3854	0	3842	0.0	0.0
chr18	TCF4	55232508	55232519	60	12	106663	22459	106603	22447	5.0	4.7490978749944315
chr18	TCF4	55588037	55588447	0	411	106663	22459	106663	22048	0.0	4.837763062409289
chr18	TCF4	55588037	55588468	0	432	106663	22459	106663	22027	0.0	4.842375266718118
chr18	TCF4	55586920	55587043	0	124	106663	22459	106663	22335	0.0	4.775598835907768
chr18	TCF4	55588448	55588468	0	21	106663	22459	106663	22438	0.0	4.753676798288618
chr18	TCF4	55585810	55585877	0	68	106663	22459	106663	22391	0.0	4.763655039971417
chr18	TCF4	55585810	55585971	0	162	106663	22459	106663	22297	0.0	4.783737722563574
chr18	TCF4	55401579	55401687	0	109	106663	22459	106663	22350	0.0	4.772393736017897
chr18	TCF4	55422179	55422190	4	12	106663	22459	106659	22447	0.3333333333333333	4.75159264044193
chr18	TCF4	55422175	55422178	16	4	106663	22459	106647	22455	4.0	4.74936539746159
chr18	TCF4	55422175	55422190	20	16	106663	22459	106643	22443	1.25	4.751726596266097
chr18	TCF4	55401000	55401498	153	499	106663	22459	106510	21960	0.3066132264529058	4.850182149362477
chr18	TCF4	55585723	55585809	0	87	106663	22459	106663	22372	0.0	4.767700697300197
chr18	TCF4	55422153	55422178	104	26	106663	22459	106559	22433	4.0	4.750100298667142
chr18	TCF4	55422153	55422174	88	22	106663	22459	106575	22437	4.0	4.749966573071267
chr18	TCF4	55422153	55422190	108	38	106663	22459	106555	22421	2.8421052631578947	4.7524642076624595
chr18	LINC01415	55780122	55780147	0	26	765	4412	765	4386	0.0	0.1744186046511628
chr18	LINC01539	56095829	56096005	0	177	147	4888	147	4711	0.0	0.031203566121842496
chr18	LINC01539	56085198	56085203	0	6	147	4888	147	4882	0.0	0.030110610405571486
chr18	LINC-ROR	57058886	57059201	0	316	90	3868	90	3552	0.0	0.02533783783783784
chr18	FECH	57580054	57580071	0	18	2338	8798	2338	8780	0.0	0.2662870159453303
chr18	NARS1	57621707	57621737	0	31	252	3990	252	3959	0.0	0.06365243748421319
chr18	LINC01897	57961501	57961504	0	4	0	409	0	405	0.0	0.0
chr18	AC107896.1	58195519	58195597	0	79	0	571	0	492	0.0	0.0
chr18	AC105094.2	61748039	61748073	0	35	0	1162	0	1127	0.0	0.0
chr18	PIGN	62186843	62187021	0	179	0	17779	0	17600	0.0	0.0
chr18	PIGN	62088390	62088754	0	365	0	17779	0	17414	0.0	0.0
chr18	BCL2	63317529	63318080	0	552	51	8671	51	8119	0.0	0.006281561768690725
chr18	KDSR	63355203	63355217	0	15	0	8861	0	8846	0.0	0.0
chr18	FBXO15	74147540	74147668	0	129	2651	6149	2651	6020	0.0	0.4403654485049834
chr18	FBXO15	74147493	74147539	0	47	2651	6149	2651	6102	0.0	0.43444772205834153
chr18	LINC00909	74596427	74597734	0	1308	6671	4420	6671	3112	0.0	2.1436375321336762
chr18	LINC00909	74596427	74597256	0	830	6671	4420	6671	3590	0.0	1.8582172701949862
chr18	LINC01927	76638207	76638547	0	341	0	1701	0	1360	0.0	0.0
chr18	LINC01927	76638207	76638783	0	577	0	1701	0	1124	0.0	0.0
chr18	MBP	77016831	77016912	0	82	0	6992	0	6910	0.0	0.0
chr18	MBP	76988299	76988493	0	195	0	6992	0	6797	0.0	0.0
chr18	LINC01029	77993634	77993695	0	62	765	4456	765	4394	0.0	0.17410104688211198
chr18	LINC01896	78978462	78978784	0	323	0	1736	0	1413	0.0	0.0
chr19	LINC01002	203870	203945	569	76	54808	7755	54239	7679	7.4868421052631575	7.063289490819117
chr19	LINC01002	203870	203873	4	4	54808	7755	54804	7751	1.0	7.070571539156238
chr19	LINC01002	209224	209234	20	11	54808	7755	54788	7744	1.8181818181818181	7.074896694214876
chr19	LINC01002	203874	203945	565	72	54808	7755	54243	7683	7.847222222222222	7.060132760640375
chr19	LINC01002	204833	204842	0	10	54808	7755	54808	7745	0.0	7.076565526145901
chr19	LINC01002	204817	204832	0	16	54808	7755	54808	7739	0.0	7.0820519446956975
chr19	LINC01002	204817	204842	0	26	54808	7755	54808	7729	0.0	7.09121490490361
chr19	LINC01002	223937	223965	226	29	54808	7755	54582	7726	7.793103448275862	7.0647165415480195
chr19	PLPP2	291284	291324	5560	41	546872	2033	541312	1992	135.609756097561	271.7429718875502
chr19	PLPP2	291284	291287	449	4	546872	2033	546423	2029	112.25	269.30655495317893
chr19	PLPP2	291288	291324	5111	37	546872	2033	541761	1996	138.13513513513513	271.42334669338675
chr19	MIER2	308800	308820	830	21	188073	7934	187243	7913	39.523809523809526	23.662706937950208
chr19	POLRMT	633197	633423	969	227	286041	4590	285072	4363	4.2687224669603525	65.33852853541141
chr19	RNF126	651610	651690	1555	81	301971	3235	300416	3154	19.19753086419753	95.24920735573875
chr19	MED16	868410	868414	394	5	271794	3907	271400	3902	78.8	69.55407483341875
chr19	R3HDM4	901419	901420	0	2	295331	2427	295331	2425	0.0	121.7859793814433
chr19	POLR2E	1089471	1089488	16949	18	762390	2591	745441	2573	941.6111111111111	289.71667314418966
chr19	GAMT	1401295	1401363	2657	69	76222	1551	73565	1482	38.507246376811594	49.63900134952767
chr19	C19ORF25	1478653	1478772	204	120	89048	4190	88844	4070	1.7	21.82899262899263
chr19	C19ORF25	1479139	1479161	23	23	89048	4190	89025	4167	1.0	21.36429085673146
chr19	C19ORF25	1479113	1479161	45	49	89048	4190	89003	4141	0.9183673469387755	21.49311760444337
chr19	C19ORF25	1479113	1479138	22	26	89048	4190	89026	4164	0.8461538461538461	21.379923150816524
chr19	PCSK4	1482352	1482400	124	49	16392	3654	16268	3605	2.5306122448979593	4.512621359223301
chr19	ADAMTSL5	1511035	1511074	333	40	6861	2885	6528	2845	8.325	2.2945518453427063
chr19	ADAMTSL5	1507544	1507555	0	12	6861	2885	6861	2873	0.0	2.3880960668290987
chr19	MBD3	1592521	1592616	420	96	744850	7530	744430	7434	4.375	100.13855259617972
chr19	MBD3	1591984	1592275	6246	292	744850	7530	738604	7238	21.39041095890411	102.04531638574191
chr19	TCF3	1631950	1632036	1514	87	1381814	5864	1380300	5777	17.402298850574713	238.9302406093128
chr19	ATP8B3	1811488	1811599	4237	112	182370	7043	178133	6931	37.830357142857146	25.70090895974607
chr19	ATP8B3	1791970	1791999	0	30	182370	7043	182370	7013	0.0	26.004562954513048
chr19	ATP8B3	1812067	1812184	0	118	182370	7043	182370	6925	0.0	26.335018050541517
chr19	ABHD17A	1881234	1881260	2297	27	244868	4179	242571	4152	85.07407407407408	58.422687861271676
chr19	BTBD2	1990003	1990090	23874	88	542084	5031	518210	4943	271.29545454545456	104.83714343516084
chr19	MKNK2	2051095	2051216	91	122	415667	5232	415576	5110	0.7459016393442623	81.32602739726028
chr19	MKNK2	2046521	2046602	966	82	415667	5232	414701	5150	11.78048780487805	80.52446601941747
chr19	PLEKHJ1	2236154	2236376	21860	223	317968	3179	296108	2956	98.02690582959642	100.17185385656292
chr19	TIMM13	2427413	2427457	45725	45	330931	1622	285206	1577	1016.1111111111111	180.85351934051997
chr19	SGTA	2782569	2783231	3475	663	1468669	7950	1465194	7287	5.24132730015083	201.06957595718401
chr19	SGTA	2768964	2768967	169	4	1468669	7950	1468500	7946	42.25	184.80996727913416
chr19	SGTA	2757564	2757691	1008	128	1468669	7950	1467661	7822	7.875	187.63244694451546
chr19	TLE2	3006419	3006475	2599	57	89672	4108	87073	4051	45.59649122807018	21.49419896321896
chr19	AC010649.1	3302793	3302794	0	2	51	530	51	528	0.0	0.09659090909090909
chr19	AC010649.1	3302789	3302792	0	4	51	530	51	526	0.0	0.09695817490494296
chr19	AC010649.1	3302789	3302794	0	6	51	530	51	524	0.0	0.09732824427480916
chr19	DOHH	3500532	3500559	149	28	132137	2126	131988	2098	5.321428571428571	62.911344137273595
chr19	MFSD12	3557105	3557131	6284	27	623954	4683	617670	4656	232.74074074074073	132.66108247422682
chr19	TBXA2R	3599848	3600236	14079	389	114364	2455	100285	2066	36.19280205655527	48.5406582768635
chr19	CACTIN	3614385	3614395	3	11	244619	5168	244616	5157	0.2727272727272727	47.433779329067285
chr19	PIP5K1C	3664821	3664855	3451	35	471267	6975	467816	6940	98.6	67.40864553314121
chr19	DAPK3	3970920	3971020	71	101	550502	3559	550431	3458	0.7029702970297029	159.17611336032388
chr19	TMIGD2	4294566	4294577	0	12	51	1267	51	1255	0.0	0.04063745019920319
chr19	DPP9	4715528	4715663	1271	136	1361843	6781	1360572	6645	9.345588235294118	204.7512415349887
chr19	DPP9	4715664	4716051	2077	388	1361843	6781	1359766	6393	5.353092783505154	212.6960738307524
chr19	PLIN3	4847690	4847815	99245	126	1286622	1780	1187377	1654	787.6587301587301	717.8821039903265
chr19	PLIN3	4866632	4866878	1758	247	1286622	1780	1284864	1533	7.117408906882591	838.1369863013699
chr19	SAFB2	5616127	5616130	0	4	1061989	5607	1061989	5603	0.0	189.53935391754416
chr19	LONP1	5711770	5711817	27351	48	2189766	5053	2162415	5005	569.8125	432.05094905094904
chr19	DUS3L	5790818	5790884	1502	67	430724	2948	429222	2881	22.417910447761194	148.98368622006248
chr19	FUT6	5834839	5834948	0	110	0	2530	0	2420	0.0	0.0
chr19	RANBP3	5931403	5931417	1018	15	967748	7119	966730	7104	67.86666666666666	136.08248873873873
chr19	RANBP3	5957906	5957916	0	11	967748	7119	967748	7108	0.0	136.14912774338774
chr19	RFX2	6199475	6199478	76	4	76789	7521	76713	7517	19.0	10.205268059066118
chr19	KHSRP	6415533	6415607	23165	75	3028878	4006	3005713	3931	308.8666666666667	764.6179089290257
chr19	KHSRP	6424137	6424215	0	79	3028878	4006	3028878	3927	0.0	771.2956455309396
chr19	DENND1C	6481649	6481677	0	29	1414	4369	1414	4340	0.0	0.3258064516129032
chr19	TUBB4A	6500927	6501285	306	359	59742	1824	59436	1465	0.8523676880222841	40.570648464163824
chr19	TUBB4A	6502155	6502187	801	33	59742	1824	58941	1791	24.272727272727273	32.90954773869347
chr19	TNFSF14	6669850	6669957	260	108	68575	4677	68315	4569	2.4074074074074074	14.951849420004377
chr19	GPR108	6735539	6735620	749	82	307609	2886	306860	2804	9.134146341463415	109.43651925820257
chr19	GPR108	6732471	6732474	0	4	307609	2886	307609	2882	0.0	106.73455933379597
chr19	FCER2	7702014	7702017	36	4	38292	2333	38256	2329	9.0	16.425933877200514
chr19	CLEC4G	7732047	7732087	0	41	80	1553	80	1512	0.0	0.05291005291005291
chr19	CD209	7745517	7745999	1581	483	153407	4420	151826	3937	3.2732919254658386	38.56388112776226
chr19	CD209	7745517	7745654	0	138	153407	4420	153407	4282	0.0	35.82601588042971
chr19	CD209	7745517	7745792	0	276	153407	4420	153407	4144	0.0	37.019063706563706
chr19	CD209	7745655	7745999	1581	345	153407	4420	151826	4075	4.582608695652174	37.25791411042945
chr19	CD209	7745655	7745792	0	138	153407	4420	153407	4282	0.0	35.82601588042971
chr19	CD209	7747305	7747464	77774	160	153407	4420	75633	4260	486.0875	17.754225352112677
chr19	CD209	7745793	7745999	1581	207	153407	4420	151826	4213	7.63768115942029	36.03750296700689
chr19	RAB11B-AS1	8376904	8376960	0	57	479	1160	479	1103	0.0	0.4342701722574796
chr19	ZNF414	8511475	8511484	0	10	43109	2689	43109	2679	0.0	16.091452034341174
chr19	MYO1F	8541905	8541911	21	7	769408	6070	769387	6063	3.0	126.89873000164935
chr19	MYO1F	8555636	8555657	0	22	769408	6070	769408	6048	0.0	127.21693121693121
chr19	ADAMTS10	8595761	8595771	0	11	3150	5729	3150	5718	0.0	0.5508919202518363
chr19	MUC16	8858585	8858598	0	14	18306	43914	18306	43900	0.0	0.41699316628701594
chr19	ZNF266	9418761	9419215	0	455	6936	4513	6936	4058	0.0	1.7092163627402661
chr19	ZNF266	9418761	9418764	0	4	6936	4513	6936	4509	0.0	1.5382568196939455
chr19	ZNF266	9418761	9419049	0	289	6936	4513	6936	4224	0.0	1.6420454545454546
chr19	ZNF266	9419050	9419215	0	166	6936	4513	6936	4347	0.0	1.5955831608005522
chr19	ZNF561	9617044	9617047	0	4	51	5565	51	5561	0.0	0.009171012407840316
chr19	ZNF561	9620915	9621160	0	246	51	5565	51	5319	0.0	0.009588268471517203
chr19	ZNF562	9674631	9675013	40515	383	44676	2122	4161	1739	105.78328981723237	2.392754456584244
chr19	ZNF846	9785925	9785936	60	12	75442	3924	75382	3912	5.0	19.269427402862984
chr19	FBXL12	9818544	9818726	0	183	0	2784	0	2601	0.0	0.0
chr19	FBXL12	9818727	9818752	0	26	0	2784	0	2758	0.0	0.0
chr19	FBXL12	9818727	9818830	0	104	0	2784	0	2680	0.0	0.0
chr19	FBXL12	9818753	9818830	0	78	0	2784	0	2706	0.0	0.0
chr19	OLFM2	9857262	9857385	0	124	3985	2508	3985	2384	0.0	1.6715604026845639
chr19	ANGPTL6	10093692	10093811	0	120	51	2187	51	2067	0.0	0.02467343976777939
chr19	ANGPTL6	10102551	10102566	0	16	51	2187	51	2171	0.0	0.02349147858129894
chr19	EIF3G	10116799	10116822	0	24	0	3387	0	3363	0.0	0.0
chr19	EIF3G	10118861	10118866	0	6	0	3387	0	3381	0.0	0.0
chr19	EIF3G	10119066	10119086	0	21	0	3387	0	3366	0.0	0.0
chr19	DNMT1	10142027	10142078	0	52	49341	13688	49341	13636	0.0	3.618436491639777
chr19	DNMT1	10166591	10166596	0	6	49341	13688	49341	13682	0.0	3.6062710130097937
chr19	DNMT1	10137075	10137083	0	9	49341	13688	49341	13679	0.0	3.6070619197309743
chr19	DNMT1	10135438	10135734	0	297	49341	13688	49341	13391	0.0	3.6846389365992085
chr19	FDX2	10315851	10315968	0	118	51	813	51	695	0.0	0.07338129496402877
chr19	ICAM3	10334159	10334227	523	69	9537	2076	9014	2007	7.579710144927536	4.491280518186348
chr19	ICAM3	10335065	10335139	695	75	9537	2076	8842	2001	9.266666666666667	4.4187906046976515
chr19	CDC37	10393258	10393278	0	21	844676	3052	844676	3031	0.0	278.67898383371823
chr19	KEAP1	10502387	10502407	146	21	4225	3562	4079	3541	6.9523809523809526	1.1519344817848065
chr19	S1PR5	10517040	10517396	611	357	95551	2225	94940	1868	1.711484593837535	50.82441113490364
chr19	AP1M2	10587154	10587188	0	35	73812	2145	73812	2110	0.0	34.98199052132701
chr19	TMED1	10835255	10835289	0	35	2700	1889	2700	1854	0.0	1.4563106796116505
chr19	TMED1	10834818	10834932	0	115	2700	1889	2700	1774	0.0	1.5219842164599775
chr19	YIPF2	10928510	10928583	0	74	92640	2417	92640	2343	0.0	39.53905249679897
chr19	KANK2	11195555	11195620	0	66	19006	7137	19006	7071	0.0	2.6878800735398105
chr19	TMEM205	11346126	11346206	0	81	12586	1389	12586	1308	0.0	9.622324159021407
chr19	TMEM205	11346126	11346141	0	16	12586	1389	12586	1373	0.0	9.16678805535324
chr19	TMEM205	11346007	11346125	0	119	12586	1389	12586	1270	0.0	9.910236220472441
chr19	TMEM205	11346007	11346206	0	200	12586	1389	12586	1189	0.0	10.585365853658537
chr19	TMEM205	11346007	11346141	0	135	12586	1389	12586	1254	0.0	10.036682615629983
chr19	TMEM205	11345519	11346125	0	607	12586	1389	12586	782	0.0	16.09462915601023
chr19	TMEM205	11345519	11346206	0	688	12586	1389	12586	701	0.0	17.95435092724679
chr19	TMEM205	11346142	11346206	0	65	12586	1389	12586	1324	0.0	9.506042296072508
chr19	RGL3	11415936	11415945	0	10	94	3935	94	3925	0.0	0.02394904458598726
chr19	ZNF653	11484041	11484078	0	38	5762	3095	5762	3057	0.0	1.8848544324501144
chr19	ECSIT	11507701	11507989	0	289	0	2365	0	2076	0.0	0.0
chr19	ELOF1	11555344	11555520	874	177	1349255	4090	1348381	3913	4.937853107344632	344.5900843342704
chr19	ACP5	11578479	11578583	0	105	0	2095	0	1990	0.0	0.0
chr19	ACP5	11578023	11578074	0	52	0	2095	0	2043	0.0	0.0
chr19	ZNF433	12035536	12035545	0	10	21145	3086	21145	3076	0.0	6.874187256176853
chr19	ZNF625	12147675	12147678	0	4	13148	2215	13148	2211	0.0	5.946630483943917
chr19	ZNF443	12432286	12432375	0	90	10642	2667	10642	2577	0.0	4.129608071400853
chr19	DHPS	12680160	12680200	0	41	153	2991	153	2950	0.0	0.05186440677966102
chr19	DHPS	12680160	12680194	0	35	153	2991	153	2956	0.0	0.05175913396481732
chr19	DHPS	12680195	12680200	0	6	153	2991	153	2985	0.0	0.05125628140703518
chr19	DHPS	12680149	12680200	0	52	153	2991	153	2939	0.0	0.05205852330724736
chr19	DHPS	12680149	12680159	0	11	153	2991	153	2980	0.0	0.05134228187919463
chr19	DHPS	12680149	12680194	0	46	153	2991	153	2945	0.0	0.05195246179966044
chr19	TRIR	12734312	12734334	0	23	1885	1314	1885	1291	0.0	1.4601084430673896
chr19	HOOK2	12774634	12774667	3527	34	332865	5239	329338	5205	103.73529411764706	63.273390970220944
chr19	HOOK2	12778299	12778343	42	45	332865	5239	332823	5194	0.9333333333333333	64.0783596457451
chr19	HOOK2	12774560	12774633	18872	74	332865	5239	313993	5165	255.02702702702703	60.79244917715392
chr19	HOOK2	12774560	12774667	22399	108	332865	5239	310466	5131	207.39814814814815	60.50789319820698
chr19	SYCE2	12899957	12900002	0	46	88602	1482	88602	1436	0.0	61.700557103064064
chr19	FARSA	12928534	12928571	0	38	96097	2378	96097	2340	0.0	41.067094017094014
chr19	TRMT1	13112895	13112907	0	13	3786	3150	3786	3137	0.0	1.2068855594517054
chr19	TRMT1	13116145	13116185	184	41	3786	3150	3602	3109	4.487804878048781	1.1585718880669025
chr19	TRMT1	13116145	13116170	64	26	3786	3150	3722	3124	2.4615384615384617	1.1914212548015366
chr19	TRMT1	13116105	13116144	0	40	3786	3150	3786	3110	0.0	1.2173633440514469
chr19	TRMT1	13116171	13116185	120	15	3786	3150	3666	3135	8.0	1.169377990430622
chr19	STX10	13144763	13144766	0	4	324	1305	324	1301	0.0	0.2490392006149116
chr19	CACNA1A	13303536	13303544	0	9	1105115	33625	1105115	33616	0.0	32.87467277486911
chr19	C19ORF57	13905714	13906057	0	344	295150	3853	295150	3509	0.0	84.1122827016244
chr19	PODNL1	13934242	13934252	475	11	48802	3221	48327	3210	43.18181818181818	15.055140186915889
chr19	C19ORF67	14085292	14085722	391	431	5166	1541	4775	1110	0.9071925754060325	4.301801801801802
chr19	DDX39A	14410420	14410546	0	127	157	3413	157	3286	0.0	0.047778454047474134
chr19	DNAJB1	14527686	14527724	16	39	66706	7011	66690	6972	0.41025641025641024	9.56540447504303
chr19	DNAJB1	14529209	14529220	30	12	66706	7011	66676	6999	2.5	9.52650378625518
chr19	DNAJB1	14529209	14529309	68	101	66706	7011	66638	6910	0.6732673267326733	9.643704775687409
chr19	DNAJB1	14527357	14527724	6242	368	66706	7011	60464	6643	16.96195652173913	9.101911786843294
chr19	DNAJB1	14527357	14527685	6226	329	66706	7011	60480	6682	18.924012158054712	9.051182280754265
chr19	SLC1A6	14979308	14979511	0	204	0	7643	0	7439	0.0	0.0
chr19	ILVBL	15125655	15125660	0	6	51	4314	51	4308	0.0	0.011838440111420613
chr19	ILVBL	15124924	15125068	0	145	51	4314	51	4169	0.0	0.012233149436315663
chr19	ILVBL	15125379	15125654	0	276	51	4314	51	4038	0.0	0.01263001485884101
chr19	AKAP8L	15403474	15403656	0	183	7065	4512	7065	4329	0.0	1.632016632016632
chr19	AKAP8L	15403652	15403656	0	5	7065	4512	7065	4507	0.0	1.567561570889727
chr19	AKAP8L	15418910	15419057	0	148	7065	4512	7065	4364	0.0	1.6189275893675528
chr19	ZNF861P	15823673	15823678	0	6	0	703	0	697	0.0	0.0
chr19	LINC01764	15835526	15835634	0	109	0	2347	0	2238	0.0	0.0
chr19	EPS15L1	16361778	16361884	0	107	18113	8149	18113	8042	0.0	2.252300422780403
chr19	EPS15L1	16440861	16440883	0	23	18113	8149	18113	8126	0.0	2.229017967019444
chr19	EPS15L1	16402314	16402319	0	6	18113	8149	18113	8143	0.0	2.2243644848335995
chr19	SMIM7	16647095	16647118	0	24	247567	4512	247567	4488	0.0	55.16198752228164
chr19	CPAMD8	16975086	16975095	0	10	47830	7832	47830	7822	0.0	6.114804397852212
chr19	USHBP1	17264560	17264669	0	110	21163	5041	21163	4931	0.0	4.291827215574934
chr19	IQCN	18264362	18264922	0	561	87257	7022	87257	6461	0.0	13.505184955889181
chr19	ISYNA1	18435247	18435264	0	18	0	3012	0	2994	0.0	0.0
chr19	ISYNA1	18437598	18437858	0	261	0	3012	0	2751	0.0	0.0
chr19	FKBP8	18543481	18543484	0	4	30357	2467	30357	2463	0.0	12.325213154689402
chr19	FKBP8	18543424	18543480	0	57	30357	2467	30357	2410	0.0	12.596265560165975
chr19	CRLF1	18596621	18596662	29	42	26856	2979	26827	2937	0.6904761904761905	9.134150493701055
chr19	HOMER3	18941050	18941191	0	142	153	3433	153	3291	0.0	0.04649042844120328
chr19	SUGP2	18993637	18993646	0	10	231411	6566	231411	6556	0.0	35.29758999389872
chr19	SUGP2	19033436	19033487	33826	52	231411	6566	197585	6514	650.5	30.332361068467915
chr19	TMEM161A	19121307	19121316	0	10	296772	3291	296772	3281	0.0	90.451691557452
chr19	TMEM161A	19138425	19138455	0	31	296772	3291	296772	3260	0.0	91.03435582822085
chr19	MEF2B	19149216	19149224	36	9	8735	2099	8699	2090	4.0	4.162200956937799
chr19	BORCS8	19192080	19192528	0	449	1182	5232	1182	4783	0.0	0.24712523520802843
chr19	SUGP1	19316246	19316420	0	175	61876	4861	61876	4686	0.0	13.204438753734529
chr19	TSSK6	19514144	19514153	0	10	166	1531	166	1521	0.0	0.1091387245233399
chr19	PBX4	19570098	19570107	0	10	34593	2054	34593	2044	0.0	16.924168297455967
chr19	PBX4	19570585	19570685	0	101	34593	2054	34593	1953	0.0	17.712749615975422
chr19	GMIP	19642534	19642535	0	2	75629	3751	75629	3749	0.0	20.173112830088023
chr19	LINC00663	19776322	19776325	0	4	221348	1894	221348	1890	0.0	117.11534391534391
chr19	LINC00663	19761256	19761324	713	69	221348	1894	220635	1825	10.333333333333334	120.8958904109589
chr19	LINC00663	19761203	19761324	1416	122	221348	1894	219932	1772	11.60655737704918	124.11512415349887
chr19	LINC00663	19761203	19761255	703	53	221348	1894	220645	1841	13.264150943396226	119.85062466051059
chr19	ZNF43	21845391	21845428	0	38	102	8432	102	8394	0.0	0.012151536812008578
chr19	AC003973.1	22026235	22026308	3908	74	77573	5670	73665	5596	52.810810810810814	13.163867047891351
chr19	AC003973.1	22034672	22035096	9594	425	77573	5670	67979	5245	22.574117647058824	12.960724499523355
chr19	ZNF98	22422194	22422245	0	52	47	3299	47	3247	0.0	0.014474899907607022
chr19	LINC01859	23017717	23017729	0	13	51	3966	51	3953	0.0	0.012901593726283835
chr19	LINC01859	23023345	23023518	0	174	51	3966	51	3792	0.0	0.013449367088607595
chr19	LINC01224	23415893	23415902	0	10	50459	3998	50459	3988	0.0	12.652708124373119
chr19	LINC01224	23402176	23403204	23024	1029	50459	3998	27435	2969	22.375121477162292	9.240485011788481
chr19	ERVK-28	27640377	27640433	0	57	0	598	0	541	0.0	0.0
chr19	LINC00662	27684694	27685055	0	362	204	28747	204	28385	0.0	0.0071868944865245725
chr19	LINC00662	27746080	27746096	0	17	204	28747	204	28730	0.0	0.007100591715976331
chr19	LINC00662	27746020	27746096	0	77	204	28747	204	28670	0.0	0.00711545169166376
chr19	LINC00662	27746020	27746079	0	60	204	28747	204	28687	0.0	0.007111235054205738
chr19	LINC00662	27771543	27771662	0	120	204	28747	204	28627	0.0	0.007126139658364481
chr19	AC005394.2	28437484	28437580	0	97	663	3123	663	3026	0.0	0.21910112359550563
chr19	AC005394.2	28726293	28726297	0	5	663	3123	663	3118	0.0	0.2126363053239256
chr19	LINC01837	32010423	32010520	0	98	400	7200	400	7102	0.0	0.056322162771050406
chr19	LINC01837	31967320	31967554	0	235	400	7200	400	6965	0.0	0.057430007178750894
chr19	LINC01837	31980108	31980154	39	47	400	7200	361	7153	0.8297872340425532	0.050468334964350624
chr19	SLC7A9	32869676	32869684	0	9	4301	2601	4301	2592	0.0	1.6593364197530864
chr19	AC008555.4	34860448	34860532	102	85	2040	1105	1938	1020	1.2	1.9
chr19	LINC00904	34898837	34898852	2	16	325148	3576	325146	3560	0.125	91.33314606741573
chr19	LINC00904	34904150	34904657	5193	508	325148	3576	319955	3068	10.222440944881889	104.28780964797915
chr19	LINC00904	34904960	34905041	102	82	325148	3576	325046	3494	1.2439024390243902	93.02976531196336
chr19	LINC00904	34904658	34904959	14281	302	325148	3576	310867	3274	47.288079470198674	94.95021380574221
chr19	LGI4	35131788	35131789	0	2	482	4379	482	4377	0.0	0.11012108750285583
chr19	DMKN	35498597	35498714	91	118	109511	4934	109420	4816	0.7711864406779662	22.720099667774086
chr19	DMKN	35510370	35510377	789	8	109511	4934	108722	4926	98.625	22.07105156313439
chr19	DMKN	35501800	35501821	176	22	109511	4934	109335	4912	8.0	22.258754071661237
chr19	DMKN	35510378	35510481	16420	104	109511	4934	93091	4830	157.8846153846154	19.273498964803313
chr19	DMKN	35500377	35500531	1734	155	109511	4934	107777	4779	11.187096774193549	22.552207574806445
chr19	SBSN	35526643	35527905	5431	1263	11622	962	6191	-301	4.300079176563737	-20.568106312292358
chr19	TMEM147-AS1	35544111	35545317	51	1207	51	3084	0	1877	0.04225352112676056	0.0
chr19	IGFLR1	35742389	35742394	0	6	204	1961	204	1955	0.0	0.10434782608695652
chr19	U2AF1L4	35744011	35744068	0	58	153	2606	153	2548	0.0	0.060047095761381473
chr19	LINC01529	35790017	35790046	0	30	0	4162	0	4132	0.0	0.0
chr19	LINC01529	35792287	35792386	0	100	0	4162	0	4062	0.0	0.0
chr19	NPHS1	35845367	35845397	0	31	51	6717	51	6686	0.0	0.007627879150463655
chr19	TYROBP	35908167	35908173	0	7	0	910	0	903	0.0	0.0
chr19	SYNE4	36006422	36006600	0	179	0	2554	0	2375	0.0	0.0
chr19	ALKBH6	36013309	36013342	0	34	0	2256	0	2222	0.0	0.0
chr19	ALKBH6	36013309	36013326	0	18	0	2256	0	2238	0.0	0.0
chr19	ALKBH6	36013513	36014173	0	661	0	2256	0	1595	0.0	0.0
chr19	ALKBH6	36013327	36013342	0	16	0	2256	0	2240	0.0	0.0
chr19	THAP8	36054134	36054147	0	14	22901	1807	22901	1793	0.0	12.77244841048522
chr19	THAP8	36054148	36054347	0	200	22901	1807	22901	1607	0.0	14.250777846919727
chr19	POLR2I	36114797	36114818	535	22	39090	1141	38555	1119	24.318181818181817	34.454870420017876
chr19	POLR2I	36114150	36114175	2449	26	39090	1141	36641	1115	94.1923076923077	32.86188340807175
chr19	COX7A1	36151668	36151694	0	27	35	590	35	563	0.0	0.06216696269982238
chr19	LINC00665	36331446	36331725	0	280	58340	10527	58340	10247	0.0	5.693373670342539
chr19	LINC00665	36326289	36326480	0	192	58340	10527	58340	10335	0.0	5.644895984518626
chr19	LINC00665	36326052	36326288	0	237	58340	10527	58340	10290	0.0	5.669582118561711
chr19	LINC00665	36326052	36326480	0	429	58340	10527	58340	10098	0.0	5.777381659734601
chr19	ZNF566	36489473	36489484	0	12	510	3205	510	3193	0.0	0.15972439711869715
chr19	ZNF260	36525154	36525172	223	19	42788	5512	42565	5493	11.736842105263158	7.748953213180411
chr19	ZNF461	36658298	36658334	0	37	13537	2885	13537	2848	0.0	4.75316011235955
chr19	ZNF829	36915795	36916009	51	215	17826	7748	17775	7533	0.2372093023255814	2.3596176821983272
chr19	ZNF585B	37210440	37210457	445	18	8610	4304	8165	4286	24.72222222222222	1.9050396640223985
chr19	ZNF569	37467083	37467257	3809	175	25459	5026	21650	4851	21.765714285714285	4.462997320140177
chr19	ZNF793-AS1	37505845	37505970	458	126	2616	1411	2158	1285	3.634920634920635	1.6793774319066148
chr19	ZNF571	37594086	37594218	0	133	15779	6081	15779	5948	0.0	2.652824478816409
chr19	ZNF571	37594086	37594739	408	654	15779	6081	15371	5427	0.6238532110091743	2.832319882071126
chr19	ZFP30	37655046	37655098	0	53	10745	7720	10745	7667	0.0	1.4014608060519107
chr19	WDR87	37896137	37896253	0	117	4284	9205	4284	9088	0.0	0.47139084507042256
chr19	DPF1	38222834	38223081	7853	248	25512	4499	17659	4251	31.66532258064516	4.154081392613502
chr19	YIF1B	38315859	38315867	0	9	4361	4073	4361	4064	0.0	1.0730807086614174
chr19	YIF1B	38315716	38315745	0	30	4361	4073	4361	4043	0.0	1.0786544645065546
chr19	YIF1B	38315716	38315721	0	6	4361	4073	4361	4067	0.0	1.072289156626506
chr19	YIF1B	38315722	38315745	0	24	4361	4073	4361	4049	0.0	1.0770560632254877
chr19	ECH1	38831308	38831318	0	11	6028	2085	6028	2074	0.0	2.9064609450337513
chr19	ECH1	38831695	38831719	0	25	6028	2085	6028	2060	0.0	2.92621359223301
chr19	ECH1	38831606	38831719	0	114	6028	2085	6028	1971	0.0	3.058346017250127
chr19	ECH1	38831606	38831694	0	89	6028	2085	6028	1996	0.0	3.0200400801603204
chr19	HNRNPL	38849699	38849869	0	171	306	5612	306	5441	0.0	0.05623966182687006
chr19	GMFG	39329543	39329546	5796	4	731932	1395	726136	1391	1449.0	522.0244428468727
chr19	RPS16	39435606	39435656	10070	51	75492	1461	65422	1410	197.45098039215685	46.39858156028369
chr19	RPS16	39433493	39433520	30	28	75492	1461	75462	1433	1.0714285714285714	52.66015352407537
chr19	RPS16	39433493	39433516	18	24	75492	1461	75474	1437	0.75	52.521920668058456
chr19	RPS16	39433517	39433520	12	4	75492	1461	75480	1457	3.0	51.805078929306795
chr19	DYRK1B	39833266	39833599	91	334	2739	3204	2648	2870	0.27245508982035926	0.9226480836236933
chr19	FBL	39840616	39840618	190	3	24370	2147	24180	2144	63.333333333333336	11.277985074626866
chr19	FBL	39840616	39840654	1991	39	24370	2147	22379	2108	51.05128205128205	10.616223908918407
chr19	FBL	39840682	39840720	6	39	24370	2147	24364	2108	0.15384615384615385	11.55787476280835
chr19	FBL	39840619	39840654	1801	36	24370	2147	22569	2111	50.02777777777778	10.691141639033633
chr19	ZNF780B	40047374	40047404	0	31	260456	9246	260456	9215	0.0	28.26435160065111
chr19	ZNF780B	40056100	40056187	0	88	260456	9246	260456	9158	0.0	28.440270801485042
chr19	ZNF780A	40090749	40090792	0	44	0	5940	0	5896	0.0	0.0
chr19	AKT2	40235044	40235099	0	56	188	12439	188	12383	0.0	0.015182104498102237
chr19	AKT2	40265221	40265257	0	37	188	12439	188	12402	0.0	0.015158845347524593
chr19	AKT2	40266010	40266204	0	195	188	12439	188	12244	0.0	0.015354459327017315
chr19	AKT2	40284764	40284862	0	99	188	12439	188	12340	0.0	0.015235008103727715
chr19	C19ORF47	40341785	40341837	0	53	290305	2632	290305	2579	0.0	112.56494765412951
chr19	PRX	40414699	40414756	0	58	204	6803	204	6745	0.0	0.030244625648628613
chr19	PRX	40398560	40398618	0	59	204	6803	204	6744	0.0	0.030249110320284697
chr19	PRX	40408329	40408332	0	4	204	6803	204	6799	0.0	0.030004412413590233
chr19	SERTAD3	40442322	40442325	0	4	0	1709	0	1705	0.0	0.0
chr19	BLVRB	40458154	40458172	0	19	103	1617	103	1598	0.0	0.06445556946182729
chr19	BLVRB	40457498	40458172	0	675	103	1617	103	942	0.0	0.10934182590233546
chr19	BLVRB	40457498	40458153	0	656	103	1617	103	961	0.0	0.10718002081165452
chr19	COQ8B	40705324	40705348	104	25	19490	11023	19386	10998	4.16	1.762684124386252
chr19	COQ8B	40703368	40703539	51	172	19490	11023	19439	10851	0.29651162790697677	1.791447792830154
chr19	COQ8B	40715324	40715585	38	262	19490	11023	19452	10761	0.1450381679389313	1.807638695288542
chr19	COQ8B	40716586	40716860	102	275	19490	11023	19388	10748	0.3709090909090909	1.8038704875325642
chr19	COQ8B	40715052	40715055	201	4	19490	11023	19289	11019	50.25	1.7505218259370179
chr19	COQ8B	40715032	40715055	1251	24	19490	11023	18239	10999	52.125	1.6582416583325756
chr19	COQ8B	40715032	40715051	1050	20	19490	11023	18440	11003	52.5	1.6759065709351995
chr19	C19ORF54	40743904	40743913	5335	10	286489	2845	281154	2835	533.5	99.17248677248678
chr19	C19ORF54	40742398	40742513	414	116	286489	2845	286075	2729	3.5689655172413794	104.82777574203004
chr19	CYP2T1P	40810584	40810660	2314	77	6642	1970	4328	1893	30.051948051948052	2.2863180137348125
chr19	CYP2A6	40850236	40850245	0	10	100	2222	100	2212	0.0	0.045207956600361664
chr19	CYP2A7	40882020	40882029	0	10	385846	2583	385846	2573	0.0	149.95958025650992
chr19	TGFB1	41332039	41332126	0	88	1871	3272	1871	3184	0.0	0.5876256281407035
chr19	DMAC2	41436391	41436427	0	37	0	2624	0	2587	0.0	0.0
chr19	DMAC2	41438217	41438233	0	17	0	2624	0	2607	0.0	0.0
chr19	PCAT19	41494539	41495300	0	762	0	5541	0	4779	0.0	0.0
chr19	PCAT19	41456590	41456614	0	25	0	5541	0	5516	0.0	0.0
chr19	RABAC1	41959114	41959235	0	122	0	1564	0	1442	0.0	0.0
chr19	ATP1A3	41994010	41994069	0	60	1	5613	1	5553	0.0	0.00018008283810552856
chr19	DEDD2	42215132	42215146	0	15	0	2616	0	2601	0.0	0.0
chr19	DEDD2	42201988	42202049	0	62	0	2616	0	2554	0.0	0.0
chr19	DEDD2	42217607	42217630	0	24	0	2616	0	2592	0.0	0.0
chr19	GSK3A	42232495	42232497	0	3	0	5487	0	5484	0.0	0.0
chr19	GSK3A	42234547	42234550	0	4	0	5487	0	5483	0.0	0.0
chr19	GSK3A	42239954	42239960	0	7	0	5487	0	5480	0.0	0.0
chr19	GSK3A	42239954	42239977	0	24	0	5487	0	5463	0.0	0.0
chr19	GSK3A	42242182	42242314	0	133	0	5487	0	5354	0.0	0.0
chr19	GSK3A	42232929	42233108	0	180	0	5487	0	5307	0.0	0.0
chr19	GSK3A	42236593	42236604	0	12	0	5487	0	5475	0.0	0.0
chr19	GSK3A	42239961	42239977	0	17	0	5487	0	5470	0.0	0.0
chr19	GSK3A	42239951	42239953	0	3	0	5487	0	5484	0.0	0.0
chr19	GSK3A	42239951	42239960	0	10	0	5487	0	5477	0.0	0.0
chr19	GSK3A	42239951	42239977	0	27	0	5487	0	5460	0.0	0.0
chr19	GSK3A	42241900	42242181	0	282	0	5487	0	5205	0.0	0.0
chr19	GSK3A	42241900	42242314	0	415	0	5487	0	5072	0.0	0.0
chr19	PAFAH1B3	42299969	42300040	0	72	0	1298	0	1226	0.0	0.0
chr19	PAFAH1B3	42299969	42300007	0	39	0	1298	0	1259	0.0	0.0
chr19	PAFAH1B3	42302436	42302697	0	262	0	1298	0	1036	0.0	0.0
chr19	PAFAH1B3	42300008	42300040	0	33	0	1298	0	1265	0.0	0.0
chr19	ETHE1	43526936	43527095	0	160	54	1596	54	1436	0.0	0.037604456824512536
chr19	PLAUR	43667776	43668042	0	267	1020	4200	1020	3933	0.0	0.2593440122044241
chr19	PLAUR	43667776	43667777	0	2	1020	4200	1020	4198	0.0	0.2429728442115293
chr19	PLAUR	43667778	43668275	0	498	1020	4200	1020	3702	0.0	0.2755267423014587
chr19	PLAUR	43667778	43668042	0	265	1020	4200	1020	3935	0.0	0.25921219822109276
chr19	SMG9	43739672	43740105	0	434	3187	7922	3187	7488	0.0	0.4256143162393162
chr19	SMG9	43754541	43754562	0	22	3187	7922	3187	7900	0.0	0.40341772151898736
chr19	SMG9	43754375	43754540	0	166	3187	7922	3187	7756	0.0	0.41090768437338837
chr19	SMG9	43754375	43754528	0	154	3187	7922	3187	7768	0.0	0.41027291452111225
chr19	SMG9	43754375	43754562	0	188	3187	7922	3187	7734	0.0	0.41207654512542025
chr19	SMG9	43754375	43754376	0	2	3187	7922	3187	7920	0.0	0.4023989898989899
chr19	SMG9	43754529	43754540	0	12	3187	7922	3187	7910	0.0	0.4029077117572693
chr19	SMG9	43754529	43754562	0	34	3187	7922	3187	7888	0.0	0.4040314401622718
chr19	SMG9	43754377	43754540	0	164	3187	7922	3187	7758	0.0	0.41080175302913124
chr19	SMG9	43754377	43754528	0	152	3187	7922	3187	7770	0.0	0.4101673101673102
chr19	SMG9	43754377	43754562	0	186	3187	7922	3187	7736	0.0	0.4119700103412616
chr19	KCNN4	43769346	43769440	0	95	1473	3224	1473	3129	0.0	0.4707574304889741
chr19	KCNN4	43769332	43769440	0	109	1473	3224	1473	3115	0.0	0.4728731942215088
chr19	KCNN4	43769332	43769345	0	14	1473	3224	1473	3210	0.0	0.4588785046728972
chr19	LYPD5	43820477	43820538	0	62	2814	5338	2814	5276	0.0	0.5333586050037907
chr19	AC006213.2	43901036	43901043	0	8	51	2188	51	2180	0.0	0.023394495412844038
chr19	ZNF45	43934923	43935228	0	306	0	4108	0	3802	0.0	0.0
chr19	AC006213.1	44002264	44002622	51	359	10444	3370	10393	3011	0.14206128133704735	3.4516771836599136
chr19	AC067968.2	44024878	44024896	304	19	8031	1074	7727	1055	16.0	7.324170616113744
chr19	ZNF235	44298807	44298818	0	12	8041	5999	8041	5987	0.0	1.3430766661099047
chr19	ZNF112	44340415	44340418	0	4	685	3854	685	3850	0.0	0.17792207792207793
chr19	ZNF285	44401422	44401566	102	145	30009	6726	29907	6581	0.7034482758620689	4.544446132806565
chr19	ZNF285	44392205	44392338	1276	134	30009	6726	28733	6592	9.522388059701493	4.358768203883495
chr19	ZNF229	44442813	44442826	0	14	17922	5508	17922	5494	0.0	3.262104113578449
chr19	ZNF229	44432221	44432238	60	18	17922	5508	17862	5490	3.3333333333333335	3.253551912568306
chr19	ZNF229	44431766	44432238	570	473	17922	5508	17352	5035	1.2050739957716703	3.4462760675273088
chr19	ZNF229	44431766	44432220	510	455	17922	5508	17412	5053	1.120879120879121	3.4458737383732436
chr19	ZNF180	44500197	44500273	370	77	23257	4714	22887	4637	4.805194805194805	4.935734310976925
chr19	TRAPPC6A	45178092	45178133	0	42	78473	939	78473	897	0.0	87.48383500557414
chr19	ERCC2	45370132	45370534	0	403	56083	5327	56083	4924	0.0	11.389723801787165
chr19	ERCC2	45370470	45370534	0	65	56083	5327	56083	5262	0.0	10.658114785252756
chr19	ERCC1	45423780	45423821	0	42	11661	5262	11661	5220	0.0	2.2339080459770115
chr19	RTN2	45494117	45494164	107138	48	497650	3171	390512	3123	2232.0416666666665	125.04386807556837
chr19	EML2	45639294	45639355	0	62	36470	6562	36470	6500	0.0	5.610769230769231
chr19	DMPK	45777326	45777340	0	15	12161	4865	12161	4850	0.0	2.507422680412371
chr19	DMPK	45779133	45779262	0	130	12161	4865	12161	4735	0.0	2.5683210137275605
chr19	DMPK	45780213	45780321	0	109	12161	4865	12161	4756	0.0	2.5569806560134567
chr19	SYMPK	45828969	45829053	0	85	354933	10339	354933	10254	0.0	34.614101813926275
chr19	IGFL2-AS1	46190223	46190283	0	61	92395	3342	92395	3281	0.0	28.16062176165803
chr19	PNMA8A	46469937	46470818	0	882	153	3699	153	2817	0.0	0.054313099041533544
chr19	PNMA8A	46469732	46469936	0	205	153	3699	153	3494	0.0	0.04378935317687464
chr19	PNMA8A	46469732	46470818	0	1087	153	3699	153	2612	0.0	0.05857580398162328
chr19	PRKD2	46716814	46716949	1004	136	22041	5270	21037	5134	7.382352941176471	4.09758472925594
chr19	PRKD2	46678365	46678394	0	30	22041	5270	22041	5240	0.0	4.206297709923664
chr19	STRN4	46746148	46746762	0	615	9700	7060	9700	6445	0.0	1.505042668735454
chr19	STRN4	46746763	46746800	0	38	9700	7060	9700	7022	0.0	1.3813728282540587
chr19	SLC1A5	46784516	46784593	0	78	10	3202	10	3124	0.0	0.003201024327784891
chr19	SLC1A5	46784699	46784731	0	33	10	3202	10	3169	0.0	0.003155569580309246
chr19	AP2S1	46850655	46850762	0	108	136	1456	136	1348	0.0	0.10089020771513353
chr19	MEIS3	47419069	47419430	0	362	1278	4243	1278	3881	0.0	0.32929657304818344
chr19	KPTN	47480759	47480762	0	4	3100	2116	3100	2112	0.0	1.4678030303030303
chr19	KPTN	47484219	47484233	0	15	3100	2116	3100	2101	0.0	1.475487862922418
chr19	NAPA	47503392	47503421	120	30	73632	4857	73512	4827	4.0	15.22933499067744
chr19	PLA2G4C	48052953	48052995	0	43	1957	5764	1957	5721	0.0	0.3420730641496242
chr19	LIG1	48120166	48121168	769	1003	6623	6607	5854	5604	0.7666999002991027	1.0446109921484654
chr19	CARD8	48249522	48249749	439	228	309364	11518	308925	11290	1.9254385964912282	27.362710363153234
chr19	CCDC114	48320754	48320770	0	17	161	5076	161	5059	0.0	0.031824471239375374
chr19	CCDC114	48321677	48321719	0	43	161	5076	161	5033	0.0	0.031988873435326845
chr19	AC008403.2	48469010	48469428	0	419	0	1864	0	1445	0.0	0.0
chr19	DBP	48634348	48634506	29278	159	80961	3763	51683	3604	184.13836477987422	14.340455049944506
chr19	IZUMO1	48745624	48745690	0	67	10562	2382	10562	2315	0.0	4.562419006479482
chr19	IZUMO1	48743407	48743443	0	37	10562	2382	10562	2345	0.0	4.504051172707889
chr19	FUT1	48755289	48755324	7	36	42671	4347	42664	4311	0.19444444444444445	9.896543725353746
chr19	HSD17B14	48813432	48813454	0	23	313555	1121	313555	1098	0.0	285.56921675774134
chr19	TULP2	48896429	48896437	0	9	2303	2263	2303	2254	0.0	1.0217391304347827
chr19	TULP2	48881998	48882030	0	33	2303	2263	2303	2230	0.0	1.0327354260089685
chr19	TULP2	48898486	48898588	102	103	2303	2263	2201	2160	0.9902912621359223	1.0189814814814815
chr19	AC008687.1	49036525	49036701	0	177	0	612	0	435	0.0	0.0
chr19	CGB7	49057461	49057663	0	203	240	2976	240	2773	0.0	0.0865488640461594
chr19	TEAD2	49355302	49355310	0	9	39611	2995	39611	2986	0.0	13.265572672471533
chr19	TEAD2	49362328	49362331	276	4	39611	2995	39335	2991	69.0	13.151120026746907
chr19	TEAD2	49362328	49362371	2751	44	39611	2995	36860	2951	62.52272727272727	12.490681125042359
chr19	TEAD2	49362332	49362371	2475	40	39611	2995	37136	2955	61.875	12.567174280879865
chr19	PIH1D1	49451367	49451483	0	117	51	2510	51	2393	0.0	0.02131216046803176
chr19	PIH1D1	49449339	49449473	0	135	51	2510	51	2375	0.0	0.021473684210526315
chr19	PIH1D1	49453375	49453391	0	17	51	2510	51	2493	0.0	0.02045728038507822
chr19	PIH1D1	49453269	49453391	0	123	51	2510	51	2387	0.0	0.0213657310431504
chr19	PIH1D1	49453269	49453374	0	106	51	2510	51	2404	0.0	0.021214642262895173
chr19	NOSIP	49557080	49557088	0	9	1956	2911	1956	2902	0.0	0.6740179186767746
chr19	NOSIP	49556874	49556956	0	83	1956	2911	1956	2828	0.0	0.6916548797736917
chr19	IRF3	49662424	49662591	3811	168	28716	3464	24905	3296	22.68452380952381	7.556128640776699
chr19	IRF3	49665630	49665670	0	41	28716	3464	28716	3423	0.0	8.389132340052585
chr19	IRF3	49665483	49665629	0	147	28716	3464	28716	3317	0.0	8.65722037986132
chr19	IRF3	49665483	49665670	0	188	28716	3464	28716	3276	0.0	8.765567765567766
chr19	IRF3	49661449	49661946	14261	498	28716	3464	14455	2966	28.636546184738958	4.873567093728928
chr19	IRF3	49664673	49665629	1136	957	28716	3464	27580	2507	1.187042842215256	11.00119664938173
chr19	IRF3	49664442	49664551	390	110	28716	3464	28326	3354	3.5454545454545454	8.445438282647585
chr19	IRF3	49664442	49664585	390	144	28716	3464	28326	3320	2.7083333333333335	8.531927710843373
chr19	IRF3	49665630	49665633	0	4	28716	3464	28716	3460	0.0	8.299421965317919
chr19	IRF3	49664552	49664585	0	34	28716	3464	28716	3430	0.0	8.37201166180758
chr19	IRF3	49664552	49664672	37	121	28716	3464	28679	3343	0.30578512396694213	8.578821417888124
chr19	IRF3	49665458	49665629	0	172	28716	3464	28716	3292	0.0	8.722964763061968
chr19	IRF3	49665458	49665482	0	25	28716	3464	28716	3439	0.0	8.350101773771446
chr19	IRF3	49665458	49665670	0	213	28716	3464	28716	3251	0.0	8.832974469394033
chr19	FUZ	49812614	49812636	190	23	16551	2967	16361	2944	8.26086956521739	5.557404891304348
chr19	FUZ	49812995	49813131	957	137	16551	2967	15594	2830	6.985401459854015	5.510247349823322
chr19	FUZ	49812446	49812613	2762	168	16551	2967	13789	2799	16.44047619047619	4.926402286530904
chr19	FUZ	49812446	49812636	2952	191	16551	2967	13599	2776	15.455497382198953	4.898775216138328
chr19	PNKP	49867468	49867493	0	26	38801	3802	38801	3776	0.0	10.275688559322035
chr19	AKT1S1	49877024	49877235	0	212	1860	5298	1860	5086	0.0	0.3657097915847424
chr19	AKT1S1	49876602	49877023	0	422	1860	5298	1860	4876	0.0	0.38146021328958163
chr19	AKT1S1	49876602	49877235	0	634	1860	5298	1860	4664	0.0	0.39879931389365353
chr19	IL4I1	49895814	49895924	0	111	38	2507	38	2396	0.0	0.015859766277128547
chr19	NUP62	49929325	49929348	0	24	0	2772	0	2748	0.0	0.0
chr19	NUP62	49929325	49929415	0	91	0	2772	0	2681	0.0	0.0
chr19	NUP62	49927693	49929324	0	1632	0	2772	0	1140	0.0	0.0
chr19	NUP62	49929349	49929415	0	67	0	2772	0	2705	0.0	0.0
chr19	VRK3	50025266	50025344	0	79	2662226	7489	2662226	7410	0.0	359.27476383265855
chr19	VRK3	50025345	50025666	639	322	2662226	7489	2661587	7167	1.984472049689441	371.36695967629413
chr19	VRK3	50020461	50020583	0	123	2662226	7489	2662226	7366	0.0	361.42085256584306
chr19	FAM71E1	50467555	50467620	0	66	0	1599	0	1533	0.0	0.0
chr19	JOSD2	50511074	50511115	3339	42	784	1198	-2555	1156	79.5	-2.2102076124567476
chr19	ASPDH	50514477	50514489	13	13	11311	1675	11298	1662	1.0	6.79783393501805
chr19	C19ORF48	50799271	50799292	0	22	51	2224	51	2202	0.0	0.02316076294277929
chr19	KLK15	50826877	50826994	0	118	0	1623	0	1505	0.0	0.0
chr19	KLK4	50909239	50909250	42	12	105390	1350	105348	1338	3.5	78.73542600896862
chr19	KLK5	50952746	50952948	0	203	38	1576	38	1373	0.0	0.027676620538965767
chr19	KLK5	50952746	50952896	0	151	38	1576	38	1425	0.0	0.02666666666666667
chr19	KLK7	50983771	50983849	2835	79	56990	2454	54155	2375	35.88607594936709	22.802105263157895
chr19	KLK11	51024633	51024636	0	4	110	2286	110	2282	0.0	0.04820333041191937
chr19	KLK12	51034794	51034804	0	11	0	1762	0	1751	0.0	0.0
chr19	KLK12	51034424	51034583	0	160	0	1762	0	1602	0.0	0.0
chr19	KLK12	51031779	51031874	0	96	0	1762	0	1666	0.0	0.0
chr19	KLK13	51059824	51060034	0	211	0	2594	0	2383	0.0	0.0
chr19	KLK13	51059824	51060042	0	219	0	2594	0	2375	0.0	0.0
chr19	KLK13	51060035	51060042	0	8	0	2594	0	2586	0.0	0.0
chr19	KLK13	51059744	51059823	0	80	0	2594	0	2514	0.0	0.0
chr19	KLK13	51059744	51060034	0	291	0	2594	0	2303	0.0	0.0
chr19	KLK13	51059744	51060042	0	299	0	2594	0	2295	0.0	0.0
chr19	NKG7	51371939	51372159	0	221	0	924	0	703	0.0	0.0
chr19	LIM2	51387142	51387267	0	126	0	1007	0	881	0.0	0.0
chr19	C19ORF84	51390348	51390476	0	129	0	1466	0	1337	0.0	0.0
chr19	HAS1	51716229	51716254	0	26	0	2243	0	2217	0.0	0.0
chr19	ZNF577	51886820	51887894	0	1075	1110	5101	1110	4026	0.0	0.2757078986587183
chr19	ZNF577	51887831	51887894	0	64	1110	5101	1110	5037	0.0	0.22036926742108398
chr19	ZNF577	51887831	51887842	0	12	1110	5101	1110	5089	0.0	0.21811750835134605
chr19	ZNF577	51887843	51887894	0	52	1110	5101	1110	5049	0.0	0.21984551396316102
chr19	ZNF577	51887753	51887894	0	142	1110	5101	1110	4959	0.0	0.2238354506957048
chr19	ZNF577	51887753	51887830	0	78	1110	5101	1110	5023	0.0	0.22098347601035237
chr19	ZNF577	51887753	51887842	0	90	1110	5101	1110	5011	0.0	0.22151267212133308
chr19	ZNF577	51887587	51887830	0	244	1110	5101	1110	4857	0.0	0.2285361334156887
chr19	ZNF577	51887587	51887842	0	256	1110	5101	1110	4845	0.0	0.22910216718266255
chr19	ZNF577	51887587	51887752	0	166	1110	5101	1110	4935	0.0	0.22492401215805471
chr19	ZNF649	51899797	51900091	0	295	3570	3541	3570	3246	0.0	1.099815157116451
chr19	ZNF615	52000345	52000356	0	12	0	4909	0	4897	0.0	0.0
chr19	ZNF615	52000258	52000344	0	87	0	4909	0	4822	0.0	0.0
chr19	ZNF615	52000258	52000356	0	99	0	4909	0	4810	0.0	0.0
chr19	ZNF616	52122359	52122406	0	48	0	4913	0	4865	0.0	0.0
chr19	AC011468.2	52171331	52171334	0	4	0	604	0	600	0.0	0.0
chr19	ZNF528-AS1	52396315	52396363	0	49	37060	4684	37060	4635	0.0	7.995685005393743
chr19	ZNF611	52707391	52707467	152	77	498257	6713	498105	6636	1.974025974025974	75.06103074141049
chr19	ZNF611	52707391	52707419	0	29	498257	6713	498257	6684	0.0	74.54473369239976
chr19	ZNF611	52707420	52707467	152	48	498257	6713	498105	6665	3.1666666666666665	74.7344336084021
chr19	ZNF320	52897519	52897646	329	128	33438	6226	33109	6098	2.5703125	5.4294850770744505
chr19	ZNF320	52897509	52897518	50	10	33438	6226	33388	6216	5.0	5.371299871299871
chr19	ZNF320	52897509	52897646	379	138	33438	6226	33059	6088	2.746376811594203	5.4301905387647835
chr19	ZNF816	52962716	52962725	0	10	558	3076	558	3066	0.0	0.18199608610567514
chr19	ZNF702P	52980835	52980890	251	56	261	6512	10	6456	4.482142857142857	0.0015489467162329617
chr19	ZNF702P	53037724	53037768	0	45	261	6512	261	6467	0.0	0.04035874439461883
chr19	ZNF160	53091412	53091635	72	224	58211	7275	58139	7051	0.32142857142857145	8.245497092610977
chr19	ZNF415	53132748	53132854	26	107	70477	3790	70451	3683	0.24299065420560748	19.128699429812652
chr19	ZNF347	53158679	53159007	6867	329	44438	9136	37571	8807	20.872340425531913	4.266038378562507
chr19	ZNF677	53254598	53254628	0	31	10875	8434	10875	8403	0.0	1.29418064976794
chr19	MBOAT7	54189301	54189336	0	36	51	5300	51	5264	0.0	0.009688449848024316
chr19	LILRA6	54241575	54241660	0	86	0	2564	0	2478	0.0	0.0
chr19	LILRB2	54276246	54276262	0	17	55909	3214	55909	3197	0.0	17.48795746011886
chr19	LAIR1	54360915	54361008	0	94	927	7661	927	7567	0.0	0.12250561649266552
chr19	LAIR1	54356711	54356926	112	216	927	7661	815	7445	0.5185185185185185	0.10946944257891202
chr19	LENG8-AS1	54448561	54448631	0	71	860	1667	860	1596	0.0	0.5388471177944862
chr19	NLRP7	54947631	54947641	0	11	96943	3927	96943	3916	0.0	24.75561797752809
chr19	GP6	55015678	55015681	0	4	51	2711	51	2707	0.0	0.01884004432951607
chr19	RDH13	55047104	55047385	0	282	0	7482	0	7200	0.0	0.0
chr19	TNNT1	55146659	55146679	0	21	51	2115	51	2094	0.0	0.024355300859598854
chr19	TNNI3	55154707	55154739	0	33	0	2023	0	1990	0.0	0.0
chr19	DNAAF3	55165781	55165856	0	76	0	3314	0	3238	0.0	0.0
chr19	DNAAF3	55166511	55166521	0	11	0	3314	0	3303	0.0	0.0
chr19	HSPBP1	55279929	55280033	0	105	0	1861	0	1756	0.0	0.0
chr19	TMEM150B	55316774	55316784	0	11	0	1723	0	1712	0.0	0.0
chr19	FAM71E2	55362916	55362968	0	53	0	3231	0	3178	0.0	0.0
chr19	SBK3	55545248	55545497	820	250	932	1524	112	1274	3.28	0.08791208791208792
chr19	ZNF784	55624446	55624482	28	37	25065	2026	25037	1989	0.7567567567567568	12.587732528909
chr19	NLRP11	55836335	55836708	0	374	26634	4326	26634	3952	0.0	6.739372469635628
chr19	ZSCAN5A	56314619	56314679	0	61	2376	5796	2376	5735	0.0	0.41429816913687884
chr19	ZSCAN5A	56314249	56314679	0	431	2376	5796	2376	5365	0.0	0.4428704566635601
chr19	ZSCAN5A	56314249	56314618	0	370	2376	5796	2376	5426	0.0	0.437891632878732
chr19	ZSCAN5A	56314249	56314419	0	171	2376	5796	2376	5625	0.0	0.4224
chr19	ZNF582	56393219	56393440	0	222	0	3346	0	3124	0.0	0.0
chr19	ZNF582	56393219	56393235	0	17	0	3346	0	3329	0.0	0.0
chr19	AC005498.2	56538247	56538251	0	5	0	595	0	590	0.0	0.0
chr19	AC005498.2	56538252	56538355	0	104	0	595	0	491	0.0	0.0
chr19	ZNF835	56671575	56671599	1508	25	50978	3476	49470	3451	60.32	14.334975369458128
chr19	PEG3	56823589	56823591	0	3	14091	8725	14091	8722	0.0	1.615569823434992
chr19	PEG3	56840581	56840585	0	5	14091	8725	14091	8720	0.0	1.615940366972477
chr19	ZNF772	57475023	57475031	0	9	102	2414	102	2405	0.0	0.042411642411642414
chr19	ZNF772	57475023	57475046	0	24	102	2414	102	2390	0.0	0.042677824267782424
chr19	ZNF772	57475032	57475046	0	15	102	2414	102	2399	0.0	0.0425177157148812
chr19	ZNF772	57476379	57476632	0	254	102	2414	102	2160	0.0	0.04722222222222222
chr19	ZNF550	57543650	57544235	0	586	51	5093	51	4507	0.0	0.011315731084978922
chr19	ZNF671	57726907	57727389	7445	483	15708	2912	8263	2429	15.41407867494824	3.401811445039111
chr19	ZNF552	57814532	57814709	5749	178	43231	2758	37482	2580	32.29775280898876	14.527906976744186
chr19	ZNF814	57868457	57868485	798	29	106075	9024	105277	8995	27.517241379310345	11.703946637020566
chr19	ZNF418	57925622	57927975	2499	2354	10530	4415	8031	2061	1.0615972812234495	3.8966521106259098
chr19	ZNF418	57935283	57935333	244	51	10530	4415	10286	4364	4.784313725490196	2.3570119156736937
chr19	ZNF418	57935030	57935078	150	49	10530	4415	10380	4366	3.061224489795918	2.3774622079706824
chr19	ZNF606	58002395	58002778	2719	384	29793	7642	27074	7258	7.080729166666667	3.730228713144117
chr19	ZSCAN18	58097929	58098172	357	244	46202	6534	45845	6290	1.4631147540983607	7.288553259141494
chr19	ZSCAN18	58097929	58098113	349	185	46202	6534	45853	6349	1.8864864864864865	7.2220822176720745
chr19	ZSCAN18	58098114	58098172	8	59	46202	6534	46194	6475	0.13559322033898305	7.134208494208494
chr19	ZSCAN18	58118266	58118346	3814	81	46202	6534	42388	6453	47.08641975308642	6.568727723539439
chr19	ZSCAN18	58118318	58118346	1615	29	46202	6534	44587	6505	55.689655172413794	6.854265949269792
chr19	AC010642.2	58312969	58313098	114	130	41239	4472	41125	4342	0.8769230769230769	9.471441731920773
chr19	AC010642.2	58314670	58314804	1633	135	41239	4472	39606	4337	12.096296296296297	9.132118976250865
chr19	ZNF837	58369716	58369817	407	102	34771	2049	34364	1947	3.9901960784313726	17.649717514124294
chr19	SLC27A5	58511267	58511518	1114	252	29662	4687	28548	4435	4.420634920634921	6.436978579481398
chr19	ZBTB45	58519616	58519740	2018	125	50173	2767	48155	2642	16.144	18.22672218016654
chr19	ZBTB45	58519018	58519261	5209	244	50173	2767	44964	2523	21.348360655737704	17.821640903686088
chr19	CHMP2A	58554776	58554863	0	88	250	1713	250	1625	0.0	0.15384615384615385
chr19	CHMP2A	58554864	58554986	0	123	250	1713	250	1590	0.0	0.15723270440251572
chr19	CHMP2A	58554672	58554863	0	192	250	1713	250	1521	0.0	0.16436554898093358
chr19	CHMP2A	58554672	58554986	0	315	250	1713	250	1398	0.0	0.17882689556509299
chr19	CHMP2A	58554672	58554775	0	104	250	1713	250	1609	0.0	0.15537600994406464
chr19	FSTL3	680775	680879	102	105	254495	3031	254393	2926	0.9714285714285714	86.94224196855775
chr19	FSTL3	680813	680879	40	67	254495	3031	254455	2964	0.5970149253731343	85.84851551956815
chr19	FSTL3	680775	680812	62	38	254495	3031	254433	2993	1.631578947368421	85.00935516204477
chr19	CFD	859745	859765	0	21	14258	1217	14258	1196	0.0	11.921404682274247
chr19	WDR18	991140	991145	673	6	125302	2003	124629	1997	112.16666666666667	62.40811216825238
chr19	WDR18	989896	990103	1908	208	125302	2003	123394	1795	9.173076923076923	68.74317548746518
chr19	CNN2	1032664	1032696	29196	33	2272160	3020	2242964	2987	884.7272727272727	750.908603950452
chr19	CNN2	1032670	1032696	23995	27	2272160	3020	2248165	2993	888.7037037037037	751.1409956565319
chr19	CNN2	1032664	1032669	5201	6	2272160	3020	2266959	3014	866.8333333333334	752.14299933643
chr19	GPX4	1105275	1105280	16936	6	2322068	1885	2305132	1879	2822.6666666666665	1226.7865886109632
chr19	CIRBP	1271366	1271467	11758	102	816286	5567	804528	5465	115.27450980392157	147.21463860933213
chr19	CIRBP	1267166	1267292	516	127	816286	5567	815770	5440	4.062992125984252	149.9577205882353
chr19	CIRBP	1267166	1267366	1173	201	816286	5567	815113	5366	5.835820895522388	151.9032799105479
chr19	CIRBP	1267293	1267366	657	74	816286	5567	815629	5493	8.878378378378379	148.48516293464408
chr19	CIRBP	1267367	1267443	0	77	816286	5567	816286	5490	0.0	148.68597449908924
chr19	CIRBP	1274441	1274444	108	4	816286	5567	816178	5563	27.0	146.7154413086464
chr19	PWWP3A	1358694	1358700	644	7	694598	9648	693954	9641	92.0	71.97946271133699
chr19	PWWP3A	1355021	1355135	617	115	694598	9648	693981	9533	5.3652173913043475	72.79775516626455
chr19	PWWP3A	1371387	1371390	86	4	694598	9648	694512	9644	21.5	72.01493156366652
chr19	NDUFS7	1383938	1383942	747	5	318392	4310	317645	4305	149.4	73.78513356562136
chr19	RPS15	1440242	1440253	4912	12	2040851	1135	2035939	1123	409.3333333333333	1812.946571682992
chr19	RPS15	1438429	1438580	1726	152	2040851	1135	2039125	983	11.355263157894736	2074.3896236012206
chr19	APC2	1450331	1450338	0	8	26378	11710	26378	11702	0.0	2.254144590668262
chr19	CSNK1G2	1979619	1979643	3715	25	467344	3302	463629	3277	148.6	141.4797070491303
chr19	SPPL2B	2337195	2337333	418	139	352215	7292	351797	7153	3.0071942446043165	49.18174192646442
chr19	SPPL2B	2351595	2351657	3860	63	352215	7292	348355	7229	61.26984126984127	48.18854613362844
chr19	GADD45B	2476629	2476630	20	2	233968	1599	233948	1597	10.0	146.49217282404507
chr19	GADD45B	2476403	2476431	50	29	233968	1599	233918	1570	1.7241379310344827	148.99235668789808
chr19	THOP1	2807774	2807808	11521	35	783082	6896	771561	6861	329.1714285714286	112.4560559685177
chr19	THOP1	2807781	2807808	9695	28	783082	6896	773387	6868	346.25	112.6073092603378
chr19	THOP1	2807774	2807780	1826	7	783082	6896	781256	6889	260.85714285714283	113.40629989838874
chr19	ZNF555	2841484	2841575	51	92	30542	8546	30491	8454	0.5543478260869565	3.606695055594985
chr19	ZNF556	2873619	2873622	43	4	132060	6578	132017	6574	10.75	20.081685427441435
chr19	TLE6	2977611	2977619	0	9	2079	3014	2079	3005	0.0	0.691846921797005
chr19	NCLN	3185957	3186214	51866	258	940794	2813	888928	2555	201.03100775193798	347.9170254403131
chr19	NCLN	3207470	3207490	84	21	940794	2813	940710	2792	4.0	336.9305157593123
chr19	FZR1	3534514	3534522	110	9	493047	6492	492937	6483	12.222222222222221	76.03532315286132
chr19	GIPC3	3589913	3589925	0	13	59186	4429	59186	4416	0.0	13.402626811594203
chr19	SHD	4283190	4283242	0	53	0	2071	0	2018	0.0	0.0
chr19	FSD1	4323147	4323237	35982	91	576630	2824	540648	2733	395.4065934065934	197.82217343578486
chr19	FSD1	4323214	4323237	14724	24	576630	2824	561906	2800	613.5	200.6807142857143
chr19	FSD1	4323147	4323213	21258	67	576630	2824	555372	2757	317.2835820895522	201.44069640914037
chr19	CAPS	5915066	5915146	855	81	17700	2457	16845	2376	10.555555555555555	7.0896464646464645
chr19	ACSBG2	6135865	6135909	0	45	4508	3462	4508	3417	0.0	1.3192859233245537
chr19	ACSBG2	6135664	6135673	0	10	4508	3462	4508	3452	0.0	1.305909617612978
chr19	ACSBG2	6135910	6135918	0	9	4508	3462	4508	3453	0.0	1.3055314219519258
chr19	ACSBG2	6135865	6135918	0	54	4508	3462	4508	3408	0.0	1.3227699530516432
chr19	CLPP	6362526	6362542	14195	17	584282	3032	570087	3015	835.0	189.08358208955224
chr19	ADGRE1	6928212	6928310	0	99	51	3729	51	3630	0.0	0.014049586776859505
chr19	PNPLA6	7535203	7535213	294	11	73313	6495	73019	6484	26.727272727272727	11.261412708204812
chr19	TRAPPC5	7680879	7681049	7	171	450725	5480	450718	5309	0.04093567251461988	84.89696741382558
chr19	TRAPPC5	7681027	7681049	0	23	450725	5480	450725	5457	0.0	82.59574857980576
chr19	HNRNPM	8463501	8463504	0	4	19490	4301	19490	4297	0.0	4.5357225971608095
chr19	HNRNPM	8465363	8465515	76	153	19490	4301	19414	4148	0.49673202614379086	4.680327868852459
chr19	NFILZ	8674601	8674604	0	4	0	1698	0	1694	0.0	0.0
chr19	ZNF561-AS1	9626861	9627806	0	946	46434	6441	46434	5495	0.0	8.450227479526843
chr19	UBL5	9827944	9828064	0	121	0	1932	0	1811	0.0	0.0
chr19	UBL5	9827985	9828064	0	80	0	1932	0	1852	0.0	0.0
chr19	UBL5	9827944	9827984	0	41	0	1932	0	1891	0.0	0.0
chr19	PIN1	9849196	9849201	0	6	204	2938	204	2932	0.0	0.06957708049113233
chr19	PIN1	9849202	9849311	0	110	204	2938	204	2828	0.0	0.07213578500707214
chr19	PIN1	9849196	9849311	0	116	204	2938	204	2822	0.0	0.07228915662650602
chr19	PPAN	10110792	10110866	0	75	0	2799	0	2724	0.0	0.0
chr19	PPAN	10111023	10111084	0	62	0	2799	0	2737	0.0	0.0
chr19	ICAM5	10291317	10291341	175	25	251006	3835	250831	3810	7.0	65.83490813648294
chr19	ATG4D	10544321	10544325	10	5	3489	2174	3479	2169	2.0	1.603964960811434
chr19	ATG4D	10547072	10547115	0	44	3489	2174	3489	2130	0.0	1.6380281690140845
chr19	ATG4D	10547083	10547115	0	33	3489	2174	3489	2141	0.0	1.629612330686595
chr19	ATG4D	10547072	10547082	0	11	3489	2174	3489	2163	0.0	1.6130374479889042
chr19	SLC44A2	10635070	10635073	0	4	12149	4084	12149	4080	0.0	2.9776960784313724
chr19	SLC44A2	10625550	10625670	1428	121	12149	4084	10721	3963	11.801652892561984	2.705273782488014
chr19	ILF3	10655124	10655147	24	24	87032	9698	87008	9674	1.0	8.994004548273724
chr19	CARM1	10908669	10908747	2967	79	207096	4435	204129	4356	37.55696202531646	46.861570247933884
chr19	CARM1	10908634	10908747	4050	114	207096	4435	203046	4321	35.526315789473685	46.990511455681556
chr19	CARM1	10908634	10908668	1083	35	207096	4435	206013	4400	30.942857142857143	46.82113636363636
chr19	SMARCA4	11025509	11025619	489	111	1031494	15628	1031005	15517	4.405405405405405	66.4435780112135
chr19	CCDC159	11346628	11346634	0	7	16202	3263	16202	3256	0.0	4.976044226044226
chr19	PLPPR2	11363820	11363835	0	16	863	2858	863	2842	0.0	0.30365939479239973
chr19	PRKCSH	11435673	11435706	1420	34	102037	4436	100617	4402	41.76470588235294	22.857110404361652
chr19	PRKCSH	11435707	11435710	160	4	102037	4436	101877	4432	40.0	22.986687725631768
chr19	PRKCSH	11435673	11435710	1580	38	102037	4436	100457	4398	41.578947368421055	22.841518872214642
chr19	PRKCSH	11447598	11447618	0	21	102037	4436	102037	4415	0.0	23.111438278595696
chr19	CNN1	11539561	11539569	0	9	199612	2816	199612	2807	0.0	71.11221945137157
chr19	ZNF791	12612317	12612365	0	49	19085	6647	19085	6598	0.0	2.8925431949075477
chr19	WDR83	12670081	12670097	0	17	34204	1664	34204	1647	0.0	20.767455980570734
chr19	BEST2	12751840	12751974	8	135	3004527	2567	3004519	2432	0.05925925925925926	1235.4107730263158
chr19	MAST1	12858740	12858741	8	2	281962	6561	281954	6559	4.0	42.98734563195609
chr19	GCDH	12891523	12891660	102	138	1377	4015	1275	3877	0.7391304347826086	0.3288625225689967
chr19	RAD23A	12952821	12952853	19	33	5725	2229	5706	2196	0.5757575757575758	2.598360655737705
chr19	NFIX	13025369	13025552	0	184	1936	3883	1936	3699	0.0	0.5233846985671803
chr19	NFIX	13024681	13024684	0	4	1936	3883	1936	3879	0.0	0.49909770559422534
chr19	NFIX	13024683	13024684	0	2	1936	3883	1936	3881	0.0	0.49884050502447824
chr19	NFIX	13024681	13024682	0	2	1936	3883	1936	3881	0.0	0.49884050502447824
chr19	NFIX	13024681	13024719	0	39	1936	3883	1936	3844	0.0	0.5036420395421436
chr19	NFIX	13024685	13024719	0	35	1936	3883	1936	3848	0.0	0.5031185031185031
chr19	NFIX	13024683	13024719	0	37	1936	3883	1936	3846	0.0	0.5033801352054083
chr19	NFIX	13024681	13024723	0	43	1936	3883	1936	3840	0.0	0.5041666666666667
chr19	NFIX	13024685	13024723	0	39	1936	3883	1936	3844	0.0	0.5036420395421436
chr19	NFIX	13024683	13024723	0	41	1936	3883	1936	3842	0.0	0.5039042165538782
chr19	NFIX	13024720	13024723	0	4	1936	3883	1936	3879	0.0	0.49909770559422534
chr19	CCDC130	13731932	13731950	0	19	0	3082	0	3063	0.0	0.0
chr19	MRI1	13766066	13766129	0	64	218	3471	218	3407	0.0	0.06398591135896683
chr19	C19ORF53	13774575	13774707	0	133	0	1201	0	1068	0.0	0.0
chr19	CYP4F8	15615281	15615375	0	95	53	4309	53	4214	0.0	0.012577123872804937
chr19	CYP4F3	15640930	15640945	0	16	14	5101	14	5085	0.0	0.0027531956735496557
chr19	CYP4F3	15650184	15650290	0	107	14	5101	14	4994	0.0	0.002803364036844213
chr19	CYP4F12	15678330	15678405	0	76	102	4073	102	3997	0.0	0.02551913935451589
chr19	UCA1	15831338	15831356	0	19	0	2973	0	2954	0.0	0.0
chr19	LINC00905	16031714	16031870	0	157	0	3588	0	3431	0.0	0.0
chr19	LINC00905	16035723	16035726	0	4	0	3588	0	3584	0.0	0.0
chr19	TPM4	16067739	16067962	0	224	102	9477	102	9253	0.0	0.011023451853452933
chr19	TPM4	16095358	16095893	0	536	102	9477	102	8941	0.0	0.011408119897103232
chr19	HSH2D	16148801	16148875	0	75	0	3407	0	3332	0.0	0.0
chr19	C19ORF44	16496466	16496692	0	227	80849	4349	80849	4122	0.0	19.614022319262492
chr19	NWD1	16744719	16745147	53738	429	154354	9155	100616	8726	125.26340326340326	11.530598212239285
chr19	NWD1	16738270	16738292	0	23	154354	9155	154354	9132	0.0	16.902540516863777
chr19	MYO9B	17211775	17211786	0	12	247569	9359	247569	9347	0.0	26.486466245854285
chr19	MYO9B	17202884	17203004	90	121	247569	9359	247479	9238	0.743801652892562	26.789240095258712
chr19	BABAM1	17267517	17267527	0	11	18401	1792	18401	1781	0.0	10.331836047164515
chr19	ANKLE1	17281950	17281982	881	33	100907	3243	100026	3210	26.696969696969695	31.1607476635514
chr19	ANKLE1	17283885	17283962	300	78	100907	3243	100607	3165	3.8461538461538463	31.78736176935229
chr19	GTPBP3	17335112	17335122	0	11	60901	3908	60901	3897	0.0	15.627662304336669
chr19	GTPBP3	17337577	17337664	1247	88	60901	3908	59654	3820	14.170454545454545	15.616230366492147
chr19	GTPBP3	17337648	17337664	52	17	60901	3908	60849	3891	3.0588235294117645	15.63839629915189
chr19	GTPBP3	17337577	17337647	1195	71	60901	3908	59706	3837	16.830985915492956	15.560594214229868
chr19	BISPR	17405988	17405995	0	8	20468	3025	20468	3017	0.0	6.784222737819025
chr19	BISPR	17405772	17405995	1940	224	20468	3025	18528	2801	8.660714285714286	6.614780435558729
chr19	BISPR	17405772	17405987	1940	216	20468	3025	18528	2809	8.981481481481481	6.595941616233535
chr19	NIBAN3	17530817	17530885	48	69	8255	6554	8207	6485	0.6956521739130435	1.2655358519660755
chr19	MAP1S	17720344	17720430	0	87	905	3788	905	3701	0.0	0.24452850580924074
chr19	MAP1S	17720431	17720553	0	123	905	3788	905	3665	0.0	0.24693042291950887
chr19	MAP1S	17720344	17720553	0	210	905	3788	905	3578	0.0	0.2529346003353829
chr19	MAP1S	17720431	17720591	0	161	905	3788	905	3627	0.0	0.2495175075820237
chr19	MAP1S	17720554	17720591	0	38	905	3788	905	3750	0.0	0.24133333333333334
chr19	MAP1S	17720344	17720591	0	248	905	3788	905	3540	0.0	0.2556497175141243
chr19	FCHO1	17754362	17754466	0	105	2037	5470	2037	5365	0.0	0.37968313140726934
chr19	FCHO1	17754622	17754758	0	137	2037	5470	2037	5333	0.0	0.3819613725857866
chr19	FCHO1	17754682	17754758	0	77	2037	5470	2037	5393	0.0	0.3777118486927499
chr19	B3GNT3	17795174	17795206	0	33	255	2754	255	2721	0.0	0.09371554575523705
chr19	SSBP4	18419616	18419707	153	92	71246	2816	71093	2724	1.6630434782608696	26.098751835535978
chr19	SSBP4	18433818	18433932	60614	115	71246	2816	10632	2701	527.0782608695653	3.936319881525361
chr19	KXD1	18557915	18557949	0	35	13856	3162	13856	3127	0.0	4.43108410617205
chr19	KXD1	18568680	18568689	50	10	13856	3162	13806	3152	5.0	4.38007614213198
chr19	KXD1	18559131	18560550	102	1420	13856	3162	13754	1742	0.07183098591549296	7.895522388059701
chr19	UBA52	18571837	18571887	186	51	21617	2211	21431	2160	3.6470588235294117	9.92175925925926
chr19	UBA52	18571888	18571909	120	22	21617	2211	21497	2189	5.454545454545454	9.82046596619461
chr19	UBA52	18571888	18572607	20580	720	21617	2211	1037	1491	28.583333333333332	0.6955063715627096
chr19	UBA52	18571910	18572607	20460	698	21617	2211	1157	1513	29.312320916905446	0.7647058823529411
chr19	UBA52	18572146	18572607	20052	462	21617	2211	1565	1749	43.4025974025974	0.8947970268724986
chr19	UBA52	18572180	18572607	20052	428	21617	2211	1565	1783	46.850467289719624	0.8777341559169939
chr19	UBA52	18571888	18572145	528	258	21617	2211	21089	1953	2.046511627906977	10.79825908858167
chr19	UBA52	18571910	18572145	408	236	21617	2211	21209	1975	1.728813559322034	10.73873417721519
chr19	UBA52	18572146	18572179	0	34	21617	2211	21617	2177	0.0	9.929719797887001
chr19	TMEM59L	18618223	18618272	378	50	1398	2533	1020	2483	7.56	0.4107933950865888
chr19	UPF1	18853072	18853104	0	33	6492	8601	6492	8568	0.0	0.757703081232493
chr19	ARMC6	19033931	19034013	300	83	65154	4030	64854	3947	3.6144578313253013	16.431213579934127
chr19	ARMC6	19055929	19055977	19	49	65154	4030	65135	3981	0.3877551020408163	16.36146696809847
chr19	SLC25A42	19064047	19064115	0	69	262482	4650	262482	4581	0.0	57.29796987557302
chr19	RFXANK	19192555	19192685	102	131	1587	2341	1485	2210	0.7786259541984732	0.6719457013574661
chr19	MAU2	19347364	19347366	0	3	131	10018	131	10015	0.0	0.013080379430853719
chr19	MAU2	19342867	19342875	0	9	131	10018	131	10009	0.0	0.013088220601458688
chr19	NDUFA13	19527353	19527372	0	20	3568	2712	3568	2692	0.0	1.325408618127786
chr19	ZNF101	19677987	19677990	0	4	29552	4964	29552	4960	0.0	5.958064516129032
chr19	ZNF66	20776451	20776481	0	31	41108	5687	41108	5656	0.0	7.2680339462517685
chr19	ZNF85	20946341	20946389	0	49	0	4677	0	4628	0.0	0.0
chr19	ZNF85	20923404	20923416	0	13	0	4677	0	4664	0.0	0.0
chr19	ZNF493	21397268	21397422	0	155	2377	9218	2377	9063	0.0	0.2622751848173894
chr19	AC092279.1	24058107	24058300	0	194	3569	11997	3569	11803	0.0	0.30238075065661274
chr19	AC092279.1	24058231	24058300	0	70	3569	11997	3569	11927	0.0	0.2992370252368575
chr19	AC092279.1	24058107	24058230	0	124	3569	11997	3569	11873	0.0	0.30059799545186555
chr19	AC006504.5	27793610	27793650	0	41	102	13629	102	13588	0.0	0.007506623491315867
chr19	AC006504.5	27794123	27794142	0	20	102	13629	102	13609	0.0	0.007495040047027703
chr19	AC079466.1	28612062	28612154	0	93	0	4063	0	3970	0.0	0.0
chr19	AC007795.1	28869922	28870017	0	96	0	987	0	891	0.0	0.0
chr19	LINC00906	28966473	28966627	0	155	144	6203	144	6048	0.0	0.023809523809523808
chr19	LINC00906	28966401	28967440	0	1040	144	6203	144	5163	0.0	0.02789076118535735
chr19	LINC00906	28966829	28967440	0	612	144	6203	144	5591	0.0	0.025755678769450903
chr19	LINC00906	28966664	28967440	0	777	144	6203	144	5426	0.0	0.026538886841135274
chr19	LINC00906	28966473	28967440	0	968	144	6203	144	5235	0.0	0.027507163323782235
chr19	LINC00906	28966628	28966663	0	36	144	6203	144	6167	0.0	0.023350089184368414
chr19	LINC00906	28966473	28966663	0	191	144	6203	144	6012	0.0	0.023952095808383235
chr19	LINC00906	28966401	28966828	0	428	144	6203	144	5775	0.0	0.024935064935064935
chr19	LINC00906	28966664	28966828	0	165	144	6203	144	6038	0.0	0.023848956608148394
chr19	LINC00906	28966473	28966828	0	356	144	6203	144	5847	0.0	0.024628014366341714
chr19	LINC00906	28966401	28966663	0	263	144	6203	144	5940	0.0	0.024242424242424242
chr19	LINC00906	28966401	28966472	0	72	144	6203	144	6131	0.0	0.02348719621595172
chr19	LINC00906	28966628	28969042	0	2415	144	6203	144	3788	0.0	0.03801478352692714
chr19	LINC00906	28966664	28969042	0	2379	144	6203	144	3824	0.0	0.03765690376569038
chr19	POP4	29608710	29608744	0	35	51	4182	51	4147	0.0	0.012298046780805401
chr19	POP4	29606326	29606489	0	164	51	4182	51	4018	0.0	0.012692882030861125
chr19	PLEKHF1	29665506	29665795	0	290	408	2299	408	2009	0.0	0.203086112493778
chr19	PLEKHF1	29665782	29665795	0	14	408	2299	408	2285	0.0	0.1785557986870897
chr19	PLEKHF1	29665506	29665781	0	276	408	2299	408	2023	0.0	0.20168067226890757
chr19	URI1	29980251	29980364	0	114	0	4959	0	4845	0.0	0.0
chr19	LINC01791	31167590	31167833	0	244	0	3441	0	3197	0.0	0.0
chr19	AC011525.2	31588317	31588680	0	364	612	3123	612	2759	0.0	0.2218194998187749
chr19	AC011525.2	31588319	31588680	0	362	612	3123	612	2761	0.0	0.22165881926838102
chr19	AC011525.2	31590453	31590478	0	26	612	3123	612	3097	0.0	0.19761059089441396
chr19	AC011525.2	31588317	31588318	0	2	612	3123	612	3121	0.0	0.19609099647548864
chr19	LINC01533	32037708	32037863	0	156	0	3749	0	3593	0.0	0.0
chr19	LINC01533	32037712	32037863	0	152	0	3749	0	3597	0.0	0.0
chr19	LINC01533	32039620	32040570	0	951	0	3749	0	2798	0.0	0.0
chr19	LINC01533	32045057	32045060	0	4	0	3749	0	3745	0.0	0.0
chr19	LINC01533	32037708	32037711	0	4	0	3749	0	3745	0.0	0.0
chr19	FAAP24	32972347	32972377	0	31	41543	2193	41543	2162	0.0	19.215078630897317
chr19	GPI	34359607	34359896	0	290	0	7809	0	7519	0.0	0.0
chr19	GPI	34359811	34359896	0	86	0	7809	0	7723	0.0	0.0
chr19	GPI	34365020	34365090	0	71	0	7809	0	7738	0.0	0.0
chr19	GPI	34365066	34365090	0	25	0	7809	0	7784	0.0	0.0
chr19	GPI	34381520	34381598	0	79	0	7809	0	7730	0.0	0.0
chr19	ZNF302	34677797	34677856	362	60	97950	4981	97588	4921	6.033333333333333	19.830928673033934
chr19	ZNF302	34677834	34677856	36	23	97950	4981	97914	4958	1.565217391304348	19.74868898749496
chr19	ZNF302	34677755	34677856	510	102	97950	4981	97440	4879	5.0	19.971305595408896
chr19	ZNF302	34677857	34678103	0	247	97950	4981	97950	4734	0.0	20.690747782002536
chr19	ZNF302	34677797	34678103	362	307	97950	4981	97588	4674	1.1791530944625408	20.87890457851947
chr19	ZNF302	34677863	34678103	0	241	97950	4981	97950	4740	0.0	20.664556962025316
chr19	ZNF302	34677834	34678103	36	270	97950	4981	97914	4711	0.13333333333333333	20.7841222670346
chr19	ZNF302	34677755	34678103	510	349	97950	4981	97440	4632	1.4613180515759312	21.036269430051814
chr19	ZNF302	34677755	34677796	148	42	97950	4981	97802	4939	3.5238095238095237	19.80198420732942
chr19	ZNF302	34677857	34677862	0	6	97950	4981	97950	4975	0.0	19.688442211055275
chr19	ZNF302	34677797	34677862	362	66	97950	4981	97588	4915	5.484848484848484	19.855137334689726
chr19	ZNF302	34677834	34677862	36	29	97950	4981	97914	4952	1.2413793103448276	19.772617124394184
chr19	ZNF302	34677755	34677862	510	108	97950	4981	97440	4873	4.722222222222222	19.995895752103426
chr19	ZNF302	34677797	34677833	326	37	97950	4981	97624	4944	8.81081081081081	19.745954692556634
chr19	ZNF302	34677755	34677833	474	79	97950	4981	97476	4902	6.0	19.884944920440635
chr19	ZNF181	34734256	34734360	0	105	153	6016	153	5911	0.0	0.025883945186939605
chr19	ZNF181	34734311	34734360	0	50	153	6016	153	5966	0.0	0.025645323499832385
chr19	ZNF181	34739610	34739621	0	12	153	6016	153	6004	0.0	0.02548301132578281
chr19	ZNF181	34734256	34734310	0	55	153	6016	153	5961	0.0	0.025666834423754403
chr19	AC008555.2	34839787	34839818	416	32	164857	8366	164441	8334	13.0	19.731341492680585
chr19	AC008555.2	34839163	34839392	3672	230	164857	8366	161185	8136	15.965217391304348	19.811332350049163
chr19	AC008555.2	34839245	34839392	3253	148	164857	8366	161604	8218	21.97972972972973	19.664638598199076
chr19	AC008555.2	34839163	34839244	419	82	164857	8366	164438	8284	5.109756097560975	19.85007242877837
chr19	AC008555.2	34839393	34839818	4151	426	164857	8366	160706	7940	9.744131455399062	20.240050377833754
chr19	ZNF30	34927217	34927282	0	66	9326	2751	9326	2685	0.0	3.473370577281192
chr19	FXYD3	35115960	35116040	12	81	593	3345	581	3264	0.14814814814814814	0.17800245098039216
chr19	FXYD7	35151474	35151482	0	9	133	1691	133	1682	0.0	0.07907253269916766
chr19	FXYD5	35157502	35157617	0	116	15019	2929	15019	2813	0.0	5.339139708496267
chr19	FXYD5	35154810	35154869	55	60	15019	2929	14964	2869	0.9166666666666666	5.215754618333914
chr19	FXYD5	35166326	35166428	690	103	15019	2929	14329	2826	6.699029126213592	5.070417551309271
chr19	LSR	35248503	35249131	0	629	2164	2695	2164	2066	0.0	1.047434656340755
chr19	LSR	35248977	35249131	0	155	2164	2695	2164	2540	0.0	0.8519685039370078
chr19	MAG	35295743	35295981	0	239	0	2972	0	2733	0.0	0.0
chr19	LINC01766	35596645	35596693	0	49	0	971	0	922	0.0	0.0
chr19	LINC01766	35596658	35596693	0	36	0	971	0	935	0.0	0.0
chr19	LINC01766	35596645	35596657	0	13	0	971	0	958	0.0	0.0
chr19	HAUS5	35614060	35614231	0	172	7802	5031	7802	4859	0.0	1.6056801811072237
chr19	ETV2	35642157	35642530	15978	374	35824	2008	19846	1634	42.72192513368984	12.145654834761322
chr19	COX6B1	35648894	35648908	60	15	500209	1374	500149	1359	4.0	368.0272259013981
chr19	LIN37	35753194	35753253	0	60	1006	2440	1006	2380	0.0	0.4226890756302521
chr19	PROSER3	35762357	35762477	2639	121	147436	4865	144797	4744	21.8099173553719	30.522133220910625
chr19	WDR62	36083189	36083241	0	53	22785	9265	22785	9212	0.0	2.473404255319149
chr19	TBCB	36121670	36121718	136	49	78786	3141	78650	3092	2.7755102040816326	25.436610608020697
chr19	CAPNS1	36140158	36140265	198	108	94248	2477	94050	2369	1.8333333333333333	39.7002954833263
chr19	ZNF146	36215156	36215196	162	41	775496	3653	775334	3612	3.951219512195122	214.65503875968992
chr19	AC092296.2	36311389	36311503	0	115	0	2027	0	1912	0.0	0.0
chr19	ZNF529-AS1	36573526	36573555	897	30	201569	3624	200672	3594	29.9	55.83528102392877
chr19	ZNF382	36605348	36605446	8954	99	753467	7939	744513	7840	90.44444444444444	94.96339285714286
chr19	ZNF382	36605447	36605730	89292	284	753467	7939	664175	7655	314.40845070422534	86.76355323318093
chr19	ZNF382	36605348	36605730	98246	383	753467	7939	655221	7556	256.51697127937337	86.71532556908417
chr19	ZNF567	36687635	36687686	0	52	64568	4734	64568	4682	0.0	13.79068774028193
chr19	AC020928.1	36773310	36773538	51	229	1689	2122	1638	1893	0.22270742358078602	0.8652931854199684
chr19	AC020928.1	36773510	36773538	0	29	1689	2122	1689	2093	0.0	0.8069756330625896
chr19	AC020928.1	36773310	36773509	51	200	1689	2122	1638	1922	0.255	0.8522372528616025
chr19	ZNF568	36973411	36973753	1489	343	15675	9232	14186	8889	4.341107871720117	1.5959050511868602
chr19	ZNF383	37235676	37235758	264	83	11818	8163	11554	8080	3.180722891566265	1.429950495049505
chr19	ZNF527	37379237	37379246	0	10	56769	2491	56769	2481	0.0	22.88149939540508
chr19	ZNF570	37467927	37468044	1818	118	73207	6067	71389	5949	15.40677966101695	12.000168095478232
chr19	ZNF570	37476435	37476493	135	59	73207	6067	73072	6008	2.288135593220339	12.162450066577897
chr19	ZNF793	37507212	37507307	1745	96	8780	9645	7035	9549	18.177083333333332	0.7367263587810242
chr19	AC016582.3	37817702	37817726	475	25	131584	6940	131109	6915	19.0	18.960086767895877
chr19	SPINT2	38264724	38264998	0	275	2732	3644	2732	3369	0.0	0.8109231225883051
chr19	CATSPERG	38370065	38370073	0	9	241	6878	241	6869	0.0	0.035085165235114284
chr19	PSMD8	38375293	38375509	0	217	0	3064	0	2847	0.0	0.0
chr19	SPRED3	38390387	38390479	0	93	3503	5774	3503	5681	0.0	0.6166167928181658
chr19	EIF3K	38619318	38619327	0	10	3919	2691	3919	2681	0.0	1.4617679970160389
chr19	EIF3K	38619224	38619327	0	104	3919	2691	3919	2587	0.0	1.5148821028218014
chr19	EIF3K	38619224	38619317	0	94	3919	2691	3919	2597	0.0	1.5090489025798999
chr19	NFKBIB	38900080	38900211	0	132	104	2113	104	1981	0.0	0.0524987380111055
chr19	PAK4	39125880	39125919	625	40	18507	7124	17882	7084	15.625	2.524280067758329
chr19	PAK4	39168303	39168312	0	10	18507	7124	18507	7114	0.0	2.601490019679505
chr19	PAK4	39173107	39173376	1858	270	18507	7124	16649	6854	6.881481481481481	2.4290925007295012
chr19	MED29	39393638	39393660	0	23	213927	3844	213927	3821	0.0	55.98717613190264
chr19	ZFP36	39406929	39407109	3480	181	44617	1979	41137	1798	19.226519337016576	22.879310344827587
chr19	PLEKHG2	39423762	39424882	3636	1121	708269	7761	704633	6640	3.2435325602140948	106.11942771084337
chr19	PLEKHG2	39424456	39424882	678	427	708269	7761	707591	7334	1.5878220140515222	96.48091082628852
chr19	TIMM50	39482917	39482963	0	47	0	5589	0	5542	0.0	0.0
chr19	AC005176.1	39640685	39640688	0	4	2593	1839	2593	1835	0.0	1.4130790190735696
chr19	ZNF546	39998333	39998410	425	78	43550	9041	43125	8963	5.448717948717949	4.811447060136115
chr19	MAP3K10	40198512	40198555	0	44	51	4074	51	4030	0.0	0.012655086848635236
chr19	PLD3	40365586	40365930	0	345	102	4360	102	4015	0.0	0.025404732254047324
chr19	PLD3	40348725	40348768	0	44	102	4360	102	4316	0.0	0.023632993512511583
chr19	SHKBP1	40577631	40577709	626	79	13988	3701	13362	3622	7.924050632911392	3.689122032026505
chr19	LTBP4	40611977	40611984	0	8	1155	7848	1155	7840	0.0	0.14732142857142858
chr19	SNRPA	40757442	40757504	1	63	42575	2064	42574	2001	0.015873015873015872	21.276361819090454
chr19	SNRPA	40750938	40750977	0	40	42575	2064	42575	2024	0.0	21.0350790513834
chr19	MIA	40775834	40775885	2	52	28144	1167	28142	1115	0.038461538461538464	25.239461883408072
chr19	RAB4B	40780098	40780099	88	2	76086	2971	75998	2969	44.0	25.597170764567196
chr19	EGLN2	40799639	40799706	0	68	22647	5469	22647	5401	0.0	4.193112386595075
chr19	EGLN2	40799778	40799806	0	29	22647	5469	22647	5440	0.0	4.163051470588235
chr19	EGLN2	40799807	40799830	0	24	22647	5469	22647	5445	0.0	4.159228650137741
chr19	EGLN2	40799778	40799830	0	53	22647	5469	22647	5416	0.0	4.181499261447563
chr19	EGLN2	40799807	40799968	0	162	22647	5469	22647	5307	0.0	4.267382702091577
chr19	EGLN2	40799831	40799968	0	138	22647	5469	22647	5331	0.0	4.248171074845245
chr19	EGLN2	40799778	40799968	0	191	22647	5469	22647	5278	0.0	4.290829859795377
chr19	EGLN2	40799969	40799972	0	4	22647	5469	22647	5465	0.0	4.1440073193046665
chr19	CYP2F1	41122906	41122963	4645	58	70629	2330	65984	2272	80.08620689655173	29.04225352112676
chr19	HNRNPUL1	41262982	41263016	167	35	388413	6669	388246	6634	4.771428571428571	58.52366596321978
chr19	HNRNPUL1	41264693	41264798	0	106	388413	6669	388413	6563	0.0	59.182233734572605
chr19	HNRNPUL1	41265122	41265167	52	46	388413	6669	388361	6623	1.1304347826086956	58.63823040918013
chr19	HNRNPUL1	41265168	41265343	9548	176	388413	6669	378865	6493	54.25	58.34976128137995
chr19	RPS19	41860290	41860445	5687	156	28153	3216	22466	3060	36.455128205128204	7.341830065359477
chr19	RPS19	41861213	41861225	143	13	28153	3216	28010	3203	11.0	8.744926631283173
chr19	CD79A	41879176	41879289	2294	114	6808	1348	4514	1234	20.12280701754386	3.658022690437601
chr19	ZNF526	42220388	42220635	0	248	0	4233	0	3985	0.0	0.0
chr19	CIC	42294299	42294304	6	6	2395	9518	2389	9512	1.0	0.25115643397813286
chr19	TMEM145	42314852	42314893	0	42	0	2662	0	2620	0.0	0.0
chr19	TEX101	43414953	43415038	0	86	0	1606	0	1520	0.0	0.0
chr19	ZNF576	43596586	43596638	0	53	113	3483	113	3430	0.0	0.03294460641399417
chr19	ZNF576	43596639	43596743	0	105	113	3483	113	3378	0.0	0.03345174659561871
chr19	ZNF221	43951401	43951410	0	10	6926	2719	6926	2709	0.0	2.5566629752676264
chr19	ZNF155	43984246	43984348	0	103	5931	3441	5931	3338	0.0	1.7768124625524266
chr19	ZNF155	43984232	43984348	0	117	5931	3441	5931	3324	0.0	1.7842960288808665
chr19	ZNF155	43984323	43984348	0	26	5931	3441	5931	3415	0.0	1.7367496339677893
chr19	ZNF155	43984232	43984245	0	14	5931	3441	5931	3427	0.0	1.7306682229355121
chr19	ZNF155	43984246	43984322	0	77	5931	3441	5931	3364	0.0	1.7630796670630202
chr19	ZNF155	43984232	43984322	0	91	5931	3441	5931	3350	0.0	1.77044776119403
chr19	ZNF230	44008917	44008991	269	75	114229	6292	113960	6217	3.5866666666666664	18.330384429789287
chr19	ZNF224	44094489	44094530	5668	42	83447	5649	77779	5607	134.95238095238096	13.871767433565186
chr19	ZNF234	44141616	44141733	644	118	771794	5221	771150	5103	5.4576271186440675	151.1169900058789
chr19	ZNF227	44228573	44228633	0	61	144102	4812	144102	4751	0.0	30.3308777099558
chr19	ZNF233	44266962	44267144	80	183	28495	4057	28415	3874	0.4371584699453552	7.334796076406815
chr19	ZNF233	44259939	44260208	2922	270	28495	4057	25573	3787	10.822222222222223	6.752838658568788
chr19	ZNF233	44260003	44260208	1844	206	28495	4057	26651	3851	8.951456310679612	6.920540119449494
chr19	ZNF233	44259939	44260002	1078	64	28495	4057	27417	3993	16.84375	6.866265965439519
chr19	PVR	44658766	44658900	0	135	92908	6106	92908	5971	0.0	15.559872718137665
chr19	BCL3	44758414	44758473	49	60	2087	3104	2038	3044	0.8166666666666667	0.6695137976346912
chr19	CBLC	44784402	44784417	0	16	3592	1624	3592	1608	0.0	2.2338308457711444
chr19	TOMM40	44901311	44901452	0	142	910	1952	910	1810	0.0	0.5027624309392266
chr19	APOE	44905842	44905923	0	82	123	2158	123	2076	0.0	0.059248554913294796
chr19	APOC1	44916326	44916470	0	145	0	1238	0	1093	0.0	0.0
chr19	APOC1	44916360	44916470	0	111	0	1238	0	1127	0.0	0.0
chr19	APOC1	44916326	44916359	0	34	0	1238	0	1204	0.0	0.0
chr19	APOC1P1	44926830	44926832	21	3	10971	925	10950	922	7.0	11.876355748373102
chr19	APOC2	44948819	44948860	0	42	1226	1267	1226	1225	0.0	1.0008163265306123
chr19	CLPTM1	44954702	44955085	0	384	5028	4812	5028	4428	0.0	1.1355013550135502
chr19	CLASRP	45057883	45057898	0	16	156	4944	156	4928	0.0	0.03165584415584415
chr19	CLASRP	45068055	45068058	0	4	156	4944	156	4940	0.0	0.031578947368421054
chr19	GEMIN7	45079280	45079377	94	98	94	1913	0	1815	0.9591836734693877	0.0
chr19	KLC3	45345752	45345799	0	48	963	3536	963	3488	0.0	0.2760894495412844
chr19	POLR1G	45406719	45407235	131225	517	214598	3199	83373	2682	253.8201160541586	31.08612975391499
chr19	POLR1G	45406719	45406724	6318	6	214598	3199	208280	3193	1053.0	65.23019104290636
chr19	QPCTL	45692911	45693103	0	193	51	2550	51	2357	0.0	0.021637675010606705
chr19	QPCTL	45693104	45693223	0	120	51	2550	51	2430	0.0	0.020987654320987655
chr19	QPCTL	45692911	45693223	0	313	51	2550	51	2237	0.0	0.022798390701832812
chr19	DM1-AS	45771676	45771684	0	9	19885	1031	19885	1022	0.0	19.456947162426616
chr19	AC006262.1	46204921	46204940	721	20	418433	4973	417712	4953	36.05	84.33515041389057
chr19	FKRP	46746087	46746090	0	4	102	5171	102	5167	0.0	0.019740661892781113
chr19	FKRP	46747295	46747305	0	11	102	5171	102	5160	0.0	0.019767441860465116
chr19	FKRP	46748718	46748884	0	167	102	5171	102	5004	0.0	0.02038369304556355
chr19	FKRP	46748666	46748884	0	219	102	5171	102	4952	0.0	0.02059773828756058
chr19	FKRP	46748622	46748884	0	263	102	5171	102	4908	0.0	0.02078239608801956
chr19	FKRP	46748666	46748717	0	52	102	5171	102	5119	0.0	0.019925766751318616
chr19	FKRP	46748622	46748717	0	96	102	5171	102	5075	0.0	0.020098522167487684
chr19	FKRP	46748622	46748665	0	44	102	5171	102	5127	0.0	0.01989467524868344
chr19	FKRP	46747682	46747732	0	51	102	5171	102	5120	0.0	0.019921875
chr19	SAE1	47130859	47131028	0	170	446615	3760	446615	3590	0.0	124.40529247910864
chr19	SAE1	47131029	47131112	0	84	446615	3760	446615	3676	0.0	121.49483133841132
chr19	CCDC9	47257655	47257909	918	255	19745	3789	18827	3534	3.6	5.327391058290888
chr19	EHD2	47726225	47726319	0	95	51373	3852	51373	3757	0.0	13.673941974980037
chr19	NOP53	47752545	47752559	0	15	1382	3435	1382	3420	0.0	0.404093567251462
chr19	SELENOW	47780918	47781000	704	83	79073	2027	78369	1944	8.481927710843374	40.31327160493827
chr19	ELSPBP1	48022335	48022339	0	5	4243	1130	4243	1125	0.0	3.7715555555555556
chr19	ELSPBP1	48022335	48022376	0	42	4243	1130	4243	1088	0.0	3.8998161764705883
chr19	ELSPBP1	48022340	48022376	0	37	4243	1130	4243	1093	0.0	3.8819762122598354
chr19	EMP3	48327562	48327623	0	62	0	1570	0	1508	0.0	0.0
chr19	EMP3	48327624	48327664	0	41	0	1570	0	1529	0.0	0.0
chr19	EMP3	48327562	48327664	0	103	0	1570	0	1467	0.0	0.0
chr19	CYTH2	48474950	48474953	0	4	153	6155	153	6151	0.0	0.024874004226954967
chr19	SPHK2	48619544	48619689	0	146	165155	5205	165155	5059	0.0	32.645779798379124
chr19	SPHK2	48624431	48624439	2204	9	165155	5205	162951	5196	244.88888888888889	31.360854503464203
chr19	SPHK2	48624431	48624855	33692	425	165155	5205	131463	4780	79.27529411764706	27.502719665271968
chr19	SPHK2	48624440	48624855	31488	416	165155	5205	133667	4789	75.6923076923077	27.91125495928169
chr19	FUT2	48696080	48696089	160	10	22223	2363	22063	2353	16.0	9.376540586485337
chr19	NUCB1	48900932	48901121	1077	190	106668	3350	105591	3160	5.668421052631579	33.414873417721516
chr19	NUCB1	48900373	48900658	255	286	106668	3350	106413	3064	0.8916083916083916	34.73009138381201
chr19	BAX	48954963	48954964	12	2	182482	1767	182470	1765	6.0	103.38243626062322
chr19	RUVBL2	49009872	49009882	0	11	1062	3172	1062	3161	0.0	0.3359696298639671
chr19	RUVBL2	48993903	48993923	0	21	1062	3172	1062	3151	0.0	0.3370358616312282
chr19	CGB2	49032105	49032270	51	166	51	884	0	718	0.3072289156626506	0.0
chr19	SNRNP70	49102174	49103587	612	1414	790	4668	178	3254	0.4328147100424328	0.054701905347264906
chr19	SNRNP70	49102186	49103587	612	1402	790	4668	178	3266	0.43651925820256776	0.054500918554807105
chr19	SNRNP70	49102174	49102185	0	12	790	4668	790	4656	0.0	0.16967353951890035
chr19	TRPM4	49182868	49182922	0	55	3570	6483	3570	6428	0.0	0.5553827006845052
chr19	CD37	49335576	49335609	0	34	20350	3440	20350	3406	0.0	5.974750440399295
chr19	CD37	49335783	49335786	0	4	20350	3440	20350	3436	0.0	5.922584400465658
chr19	DKKL1	49363915	49364008	0	94	6178	1332	6178	1238	0.0	4.990306946688206
chr19	KASH5	49393401	49393419	0	19	313326	5515	313326	5496	0.0	57.00982532751092
chr19	ALDH16A1	49465872	49465905	0	34	443073	3286	443073	3252	0.0	136.24630996309963
chr19	RPL13A	49489913	49489922	37	10	84337	3165	84300	3155	3.7	26.71949286846276
chr19	RPL13A	49489923	49490090	747	168	84337	3165	83590	2997	4.446428571428571	27.891224557891224
chr19	RPL13A	49489913	49490090	784	178	84337	3165	83553	2987	4.404494382022472	27.97221292266488
chr19	RPL13A	49490577	49490600	3682	24	84337	3165	80655	3141	153.41666666666666	25.67812798471824
chr19	RPL13A	49490298	49490301	0	4	84337	3165	84337	3161	0.0	26.680480860487187
chr19	RPS11	49496472	49496497	2060	26	26963	1391	24903	1365	79.23076923076923	18.243956043956043
chr19	FCGRT	49513244	49513473	103862	230	385117	3363	281255	3133	451.5739130434783	89.77178423236515
chr19	RCN3	49534302	49534395	0	94	97	1663	97	1569	0.0	0.061822817080943275
chr19	RCN3	49542669	49542752	0	84	97	1663	97	1579	0.0	0.06143128562381254
chr19	SCAF1	49646203	49646206	151	4	99519	4476	99368	4472	37.75	22.220035778175312
chr19	BCL2L12	49669116	49669164	0	49	11111	2223	11111	2174	0.0	5.110855565777369
chr19	PRMT1	49676261	49676439	4882	179	42307	4621	37425	4442	27.273743016759777	8.425258892390815
chr19	PRMT1	49680239	49680253	0	15	42307	4621	42307	4606	0.0	9.18519322622666
chr19	PRMT1	49677183	49677316	943	134	42307	4621	41364	4487	7.037313432835821	9.218631602406953
chr19	PRMT1	49677317	49677358	0	42	42307	4621	42307	4579	0.0	9.239353570648614
chr19	CPT1C	49691890	49691953	1044	64	34491	5093	33447	5029	16.3125	6.650825213760191
chr19	CPT1C	49691619	49691770	0	152	34491	5093	34491	4941	0.0	6.9805707346690955
chr19	PTOV1	49850956	49851096	217	141	133480	4048	133263	3907	1.5390070921985815	34.108779114410034
chr19	PTOV1	49851209	49851499	2130	291	133480	4048	131350	3757	7.319587628865979	34.96140537663029
chr19	ZNF473	50026123	50026173	8	51	221535	6268	221527	6217	0.1568627450980392	35.632459385555734
chr19	NR1H2	50378313	50378439	2597	127	256105	5355	253508	5228	20.448818897637796	48.49043611323642
chr19	POLD1	50409595	50409666	0	72	86748	4790	86748	4718	0.0	18.38660449342942
chr19	POLD1	50415560	50415590	0	31	86748	4790	86748	4759	0.0	18.228199201512922
chr19	POLD1	50415591	50415602	0	12	86748	4790	86748	4778	0.0	18.155713687735453
chr19	POLD1	50415560	50415602	0	43	86748	4790	86748	4747	0.0	18.274278491678956
chr19	SPIB	50423752	50423755	68	4	110147	4287	110079	4283	17.0	25.7013775391081
chr19	EMC10	50476659	50476723	0	65	118488	9750	118488	9685	0.0	12.23417656169334
chr19	KLK3	50855002	50855424	0	423	0	2916	0	2493	0.0	0.0
chr19	KLK3	50858175	50858175	0	1	0	2916	0	2915	0.0	0.0
chr19	KLK3	50858316	50858333	0	18	0	2916	0	2898	0.0	0.0
chr19	KLK2	50874881	50874966	1	86	10676	5806	10675	5720	0.011627906976744186	1.8662587412587412
chr19	KLK2	50877009	50877045	0	37	10676	5806	10676	5769	0.0	1.8505806898942625
chr19	SPACA6	51703336	51703337	0	2	0	4122	0	4120	0.0	0.0
chr19	ZNF613	51929825	51929896	0	72	154	3225	154	3153	0.0	0.04884237234379955
chr19	PPP2R1A	52190175	52190294	561	120	4883	7147	4322	7027	4.675	0.6150562117546606
chr19	PPP2R1A	52201514	52201694	162	181	4883	7147	4721	6966	0.8950276243093923	0.6777203560149296
chr19	ZNF766	52274583	52274669	0	87	0	6941	0	6854	0.0	0.0
chr19	ZNF610	52347832	52347944	0	113	3426	3557	3426	3444	0.0	0.9947735191637631
chr19	ZNF528	52397901	52397904	0	4	3695	7868	3695	7864	0.0	0.46986266531027465
chr19	ZNF534	52434082	52434120	0	39	6112	3285	6112	3246	0.0	1.8829328404189771
chr19	ZNF808	52527712	52527909	504	198	30291	5015	29787	4817	2.5454545454545454	6.18372430973635
chr19	ZNF761	53445124	53445219	228	96	6220	5617	5992	5521	2.375	1.0853106321318602
chr19	ZNF331	53555904	53555908	0	5	20657	8057	20657	8052	0.0	2.5654495777446598
chr19	ZNF331	53555419	53555581	0	163	20657	8057	20657	7894	0.0	2.616797567772992
chr19	NDUFA3	54106971	54106978	0	8	0	2142	0	2134	0.0	0.0
chr19	NDUFA3	54102889	54102898	0	10	0	2142	0	2132	0.0	0.0
chr19	NDUFA3	54102889	54102959	0	71	0	2142	0	2071	0.0	0.0
chr19	NDUFA3	54102899	54102959	0	61	0	2142	0	2081	0.0	0.0
chr19	CNOT3	54153000	54153082	0	83	191	5828	191	5745	0.0	0.033246301131418625
chr19	TSEN34	54190372	54190450	0	79	50	2983	50	2904	0.0	0.01721763085399449
chr19	TSEN34	54191038	54191041	0	4	50	2983	50	2979	0.0	0.016784155756965426
chr19	RPS9	54200889	54200893	0	5	0	3672	0	3667	0.0	0.0
chr19	RPS9	54200889	54200961	0	73	0	3672	0	3599	0.0	0.0
chr19	RPS9	54200894	54200961	0	68	0	3672	0	3604	0.0	0.0
chr19	RPS9	54206463	54206724	0	262	0	3672	0	3410	0.0	0.0
chr19	TTYH1	54419303	54419306	0	4	1113	6918	1113	6914	0.0	0.1609777263523286
chr19	TTYH1	54419307	54419542	0	236	1113	6918	1113	6682	0.0	0.16656689613888057
chr19	TTYH1	54419303	54419542	0	240	1113	6918	1113	6678	0.0	0.16666666666666666
chr19	LENG8	54449307	54449310	0	4	61	5922	61	5918	0.0	0.010307536329841162
chr19	LILRB1	54633245	54633318	0	74	332540	4895	332540	4821	0.0	68.97739058286662
chr19	KIR2DL4	54813229	54813295	0	67	51	1732	51	1665	0.0	0.03063063063063063
chr19	FCAR	54888229	54888294	0	66	0	3333	0	3267	0.0	0.0
chr19	FCAR	54888221	54888294	0	74	0	3333	0	3259	0.0	0.0
chr19	FCAR	54888221	54888228	0	8	0	3333	0	3325	0.0	0.0
chr19	NLRP2	54953286	54953369	931	84	117189	6333	116258	6249	11.083333333333334	18.60425668106897
chr19	AC011476.3	55006290	55006299	0	10	0	1369	0	1359	0.0	0.0
chr19	RPL28	55386675	55386693	0	19	0	3440	0	3421	0.0	0.0
chr19	U2AF2	55669170	55669181	0	12	2652	4130	2652	4118	0.0	0.6440019426906265
chr19	ZNF444	56141321	56141357	0	37	116528	4183	116528	4146	0.0	28.10612638687892
chr19	EDDM13	56297532	56297535	0	4	0	2340	0	2336	0.0	0.0
chr19	ZNF542P	56368221	56368223	0	3	102	4675	102	4672	0.0	0.02183219178082192
chr19	ZNF542P	56368224	56368460	0	237	102	4675	102	4438	0.0	0.02298332582244254
chr19	ZNF542P	56368221	56368460	0	240	102	4675	102	4435	0.0	0.022998872604284102
chr19	ZNF542P	56374758	56374825	0	68	102	4675	102	4607	0.0	0.02214022140221402
chr19	ZNF542P	56368461	56368466	0	6	102	4675	102	4669	0.0	0.021846219747269222
chr19	ZNF582-AS1	56394039	56394053	0	15	26	1662	26	1647	0.0	0.015786278081360048
chr19	ZNF582-AS1	56394054	56394441	0	388	26	1662	26	1274	0.0	0.02040816326530612
chr19	ZNF583	56404430	56404452	0	23	51	7971	51	7948	0.0	0.006416708605938601
chr19	ZNF667-AS1	56477926	56478381	0	456	108	6804	108	6348	0.0	0.017013232514177693
chr19	ZNF667-AS1	56478277	56478381	0	105	108	6804	108	6699	0.0	0.0161218092252575
chr19	ZNF667-AS1	56478378	56478381	0	4	108	6804	108	6800	0.0	0.01588235294117647
chr19	ZNF667-AS1	56478294	56478381	0	88	108	6804	108	6716	0.0	0.016081000595592615
chr19	ZNF667-AS1	56478277	56478377	0	101	108	6804	108	6703	0.0	0.01611218857228107
chr19	ZNF667-AS1	56478294	56478377	0	84	108	6804	108	6720	0.0	0.01607142857142857
chr19	ZNF667-AS1	56478277	56478293	0	17	108	6804	108	6787	0.0	0.015912774421688522
chr19	AC006115.2	56690746	56690762	0	17	50818	16166	50818	16149	0.0	3.1468202365471547
chr19	AC006115.2	56790079	56791307	1122	1229	50818	16166	49696	14937	0.9129373474369405	3.3270402356564235
chr19	MIMT1	56841440	56841586	0	147	1224	2040	1224	1893	0.0	0.6465927099841522
chr19	USP29	57120230	57120317	0	88	1138	3882	1138	3794	0.0	0.2999472851871376
chr19	AURKC	57231115	57231120	0	6	51	1747	51	1741	0.0	0.02929350947731189
chr19	AURKC	57231121	57231306	51	186	51	1747	0	1561	0.27419354838709675	0.0
chr19	AURKC	57231115	57231306	51	192	51	1747	0	1555	0.265625	0.0
chr19	AURKC	57232681	57232685	0	5	51	1747	51	1742	0.0	0.029276693455797934
chr19	ZNF17	57411407	57411651	0	245	0	3186	0	2941	0.0	0.0
chr19	ZIK1	57584390	57584612	0	223	153	5376	153	5153	0.0	0.02969144187851737
chr19	ZNF211	57633247	57633436	0	190	0	4549	0	4359	0.0	0.0
chr19	ZNF551	57682123	57682244	0	122	31273	4707	31273	4585	0.0	6.82071973827699
chr19	AC008969.1	58003337	58004700	27089	1364	40931	5845	13842	4481	19.859970674486803	3.0890426244141933
chr19	ZNF135	58060036	58060398	1317	363	36365	6389	35048	6026	3.628099173553719	5.816130102887487
chr19	ZNF544	58246391	58246427	506	37	19955	6745	19449	6708	13.675675675675675	2.8993738819320214
chr19	ZNF544	58228947	58229256	357	310	19955	6745	19598	6435	1.1516129032258065	3.0455322455322453
chr19	ZNF544	58230463	58230497	0	35	19955	6745	19955	6710	0.0	2.973919523099851
chr19	A1BG-AS1	58353462	58353474	573	13	109092	3102	108519	3089	44.07692307692308	35.130786662350275
chr19	AC012313.6	58364593	58364599	462	7	28488	1797	28026	1790	66.0	15.656983240223465
chr19	ZNF584	58409166	58409206	28	41	53381	2662	53353	2621	0.6829268292682927	20.355971003433805
chr19	ZNF324B	58451705	58451743	0	39	31627	4041	31627	4002	0.0	7.90279860069965
chr19	ZNF324B	58451744	58451753	0	10	31627	4041	31627	4031	0.0	7.8459439345075666
chr19	ZNF324B	58451705	58451753	0	49	31627	4041	31627	3992	0.0	7.922595190380761
chr19	ZNF324	58467184	58467758	102	575	2817	5390	2715	4815	0.17739130434782607	0.5638629283489096
chr19	TRIM28	58544212	58545097	0	886	9354	3904	9354	3018	0.0	3.099403578528827
chr20	NRSN2	347507	347512	0	6	357	2380	357	2374	0.0	0.15037910699241785
chr20	RBCK1	421007	421031	3517	25	195068	4749	191551	4724	140.68	40.54847586790855
chr20	RAD21L1	1226141	1226180	0	40	939	2747	939	2707	0.0	0.3468784632434429
chr20	RAD21L1	1226141	1226398	0	258	939	2747	939	2489	0.0	0.37725994375251104
chr20	RAD21L1	1226181	1226398	0	218	939	2747	939	2529	0.0	0.37129300118623965
chr20	SDCBP2-AS1	1325530	1325782	765	253	864935	5316	864170	5063	3.0237154150197627	170.68338929488445
chr20	SIRPA	1934755	1934766	0	12	870	4967	870	4955	0.0	0.17558022199798184
chr20	AL121899.1	2207389	2207519	0	131	0	548	0	417	0.0	0.0
chr20	TMC2	2613323	2614020	0	698	670623	5196	670623	4498	0.0	149.0935971542908
chr20	EBF4	2692951	2693148	0	198	1281	3015	1281	2817	0.0	0.4547390841320554
chr20	ITPA	3209567	3209617	12865	51	77834	1951	64969	1900	252.2549019607843	34.19421052631579
chr20	ITPA	3209536	3209617	23450	82	77834	1951	54384	1869	285.9756097560976	29.097913322632422
chr20	CDC25B	3795880	3796731	2259	852	259622	4331	257363	3479	2.6514084507042255	73.97614256970394
chr20	AP5S1	3820759	3820854	0	96	16178	5482	16178	5386	0.0	3.0037133308577793
chr20	AP5S1	3820703	3820854	0	152	16178	5482	16178	5330	0.0	3.0352720450281425
chr20	AP5S1	3820703	3820758	0	56	16178	5482	16178	5426	0.0	2.981570217471434
chr20	PANK2	3908136	3908278	15091	143	197701	5369	182610	5226	105.53146853146853	34.94259471871412
chr20	PRNP	4686509	4686512	0	4	51	2740	51	2736	0.0	0.01864035087719298
chr20	MCM8	5951024	5951077	2813	54	237891	7711	235078	7657	52.092592592592595	30.701057855557007
chr20	CRLS1	6007400	6007410	99	11	16489	5374	16390	5363	9.0	3.056125303002051
chr20	LINC01706	7360697	7360805	0	109	0	1390	0	1281	0.0	0.0
chr20	PLCB1	8150372	8150383	12	12	1579	16902	1567	16890	1.0	0.09277679100059207
chr20	PLCB1	8965152	8965435	0	284	1579	16902	1579	16618	0.0	0.09501745095679384
chr20	LINC01723	12951524	12951567	0	44	51	2909	51	2865	0.0	0.01780104712041885
chr20	LINC01723	12950762	12950800	0	39	51	2909	51	2870	0.0	0.017770034843205575
chr20	SNRPB2	16730065	16730164	0	100	0	2615	0	2515	0.0	0.0
chr20	MGME1	17970131	17970370	1543	240	5017	2236	3474	1996	6.429166666666666	1.7404809619238477
chr20	KAT14	18138052	18138554	153	503	70314	4878	70161	4375	0.30417495029821073	16.0368
chr20	KAT14	18138445	18138554	0	110	70314	4878	70314	4768	0.0	14.747063758389261
chr20	KAT14	18138336	18138554	0	219	70314	4878	70314	4659	0.0	15.092079845460399
chr20	KAT14	18138400	18138554	0	155	70314	4878	70314	4723	0.0	14.887571458818547
chr20	KAT14	18138505	18138554	0	50	70314	4878	70314	4828	0.0	14.563794531897265
chr20	KAT14	18138336	18138444	0	109	70314	4878	70314	4769	0.0	14.743971482491089
chr20	KAT14	18138400	18138444	0	45	70314	4878	70314	4833	0.0	14.54872749844817
chr20	KAT14	18138336	18138399	0	64	70314	4878	70314	4814	0.0	14.606148732862485
chr20	KAT14	18138445	18138504	0	60	70314	4878	70314	4818	0.0	14.594022415940223
chr20	KAT14	18138336	18138504	0	169	70314	4878	70314	4709	0.0	14.93183266086218
chr20	KAT14	18138400	18138504	0	105	70314	4878	70314	4773	0.0	14.731615336266499
chr20	SEC23B	18507670	18507990	0	321	145404	4075	145404	3754	0.0	38.733084709643045
chr20	SEC23B	18507973	18507990	0	18	145404	4075	145404	4057	0.0	35.840276066058664
chr20	SEC23B	18507991	18508030	0	40	145404	4075	145404	4035	0.0	36.035687732342005
chr20	SEC23B	18507670	18508030	0	361	145404	4075	145404	3714	0.0	39.150242326332794
chr20	SEC23B	18507973	18508030	0	58	145404	4075	145404	4017	0.0	36.19716206123973
chr20	SEC23B	18507991	18508054	0	64	145404	4075	145404	4011	0.0	36.25130890052356
chr20	SEC23B	18508031	18508054	0	24	145404	4075	145404	4051	0.0	35.893359664280425
chr20	SEC23B	18507973	18508054	0	82	145404	4075	145404	3993	0.0	36.41472577009767
chr20	SEC23B	18507991	18508297	144056	307	145404	4075	1348	3768	469.23778501628664	0.35774946921443734
chr20	SEC23B	18508031	18508297	144056	267	145404	4075	1348	3808	539.5355805243446	0.3539915966386555
chr20	SEC23B	18508055	18508297	144056	243	145404	4075	1348	3832	592.8230452674898	0.35177453027139877
chr20	SEC23B	18507973	18508297	144056	325	145404	4075	1348	3750	443.2492307692308	0.35946666666666666
chr20	NAA20	20017450	20018041	6731	592	26593	2189	19862	1597	11.369932432432432	12.43706950532248
chr20	CFAP61	20052592	20052661	0	70	52	7956	52	7886	0.0	0.006593963986812072
chr20	CFAP61	20052592	20052732	1	141	52	7956	51	7815	0.0070921985815602835	0.006525911708253359
chr20	CFAP61	20052662	20052732	1	71	52	7956	51	7885	0.014084507042253521	0.006467977171845276
chr20	KIZ	21205531	21205584	0	54	2481	3152	2481	3098	0.0	0.8008392511297612
chr20	LINC01727	21615528	21615888	0	361	0	7415	0	7054	0.0	0.0
chr20	AL118508.1	23180209	23180247	0	39	0	3797	0	3758	0.0	0.0
chr20	AL118508.1	23180529	23180793	0	265	0	3797	0	3532	0.0	0.0
chr20	AL118508.1	23186551	23187640	0	1090	0	3797	0	2707	0.0	0.0
chr20	CST8	23491184	23491342	0	159	0	914	0	755	0.0	0.0
chr20	AL121894.3	23656693	23657210	0	518	0	3234	0	2716	0.0	0.0
chr20	ZNF337-AS1	25624427	25624446	40	20	36614	3182	36574	3162	2.0	11.56672991777356
chr20	AL390198.1	25751339	25752073	255	735	3672	1841	3417	1106	0.3469387755102041	3.0895117540687163
chr20	FAM182A	26072824	26072873	0	50	7126	10300	7126	10250	0.0	0.6952195121951219
chr20	AL121904.1	26188625	26189017	0	393	0	1326	0	933	0.0	0.0
chr20	HM13	31568225	31568280	0	56	561	7787	561	7731	0.0	0.07256499805975941
chr20	HM13	31538262	31538554	0	293	561	7787	561	7494	0.0	0.07485988791032826
chr20	HM13	31538360	31538554	0	195	561	7787	561	7592	0.0	0.07389357218124341
chr20	HM13	31538262	31538359	0	98	561	7787	561	7689	0.0	0.07296137339055794
chr20	TTLL9	31870950	31870953	0	4	2126	5733	2126	5729	0.0	0.3710944318380171
chr20	TM9SF4	32109756	32110039	585	284	3900	5182	3315	4898	2.0598591549295775	0.6768068599428338
chr20	ASXL1	32359335	32359642	0	308	676650	10047	676650	9739	0.0	69.47838587123935
chr20	ASXL1	32359643	32359791	0	149	676650	10047	676650	9898	0.0	68.3622954132148
chr20	BPIFB6	33031745	33031747	0	3	1389	1692	1389	1689	0.0	0.822380106571936
chr20	ZNF341	33757323	33757343	0	21	469	5472	469	5451	0.0	0.08603925885158686
chr20	RALY	34072206	34072330	692	125	136095	7527	135403	7402	5.536	18.29275871386112
chr20	ITCH	34477861	34477906	0	46	25998	10673	25998	10627	0.0	2.446410087512939
chr20	DYNLRB1	34516462	34516876	102	415	8827	2460	8725	2045	0.2457831325301205	4.266503667481663
chr20	ACSS2	34875128	34875137	0	10	0	5112	0	5102	0.0	0.0
chr20	ACSS2	34914118	34914171	0	54	0	5112	0	5058	0.0	0.0
chr20	ACSS2	34876748	34876823	0	76	0	5112	0	5036	0.0	0.0
chr20	MYH7B	35001527	35001592	0	66	0	8201	0	8135	0.0	0.0
chr20	CEP250	35455238	35455242	24	5	133162	10901	133138	10896	4.8	12.218979441997064
chr20	ROMO1	35699452	35699456	0	5	51	681	51	676	0.0	0.07544378698224852
chr20	ROMO1	35699457	35699494	0	38	51	681	51	643	0.0	0.07931570762052877
chr20	AAR2	36236504	36236782	0	279	0	3106	0	2827	0.0	0.0
chr20	DLGAP4	36526007	36526077	0	71	47078	7378	47078	7307	0.0	6.44286300807445
chr20	TGIF2	36573653	36573745	510	93	1259	3979	749	3886	5.483870967741935	0.19274318064848173
chr20	RAB5IF	36609731	36609758	0	28	8007	1286	8007	1258	0.0	6.364864864864865
chr20	NNAT	37522385	37522438	0	54	0	1332	0	1278	0.0	0.0
chr20	NNAT	37522434	37522438	0	5	0	1332	0	1327	0.0	0.0
chr20	NNAT	37522385	37522433	0	49	0	1332	0	1283	0.0	0.0
chr20	LINC01746	37571264	37571298	421	35	20860	1197	20439	1162	12.028571428571428	17.589500860585197
chr20	LINC01746	37577212	37577439	11197	228	20860	1197	9663	969	49.10964912280702	9.972136222910217
chr20	SNHG11	38446853	38447012	0	160	0	4261	0	4101	0.0	0.0
chr20	SNHG11	38446941	38447012	0	72	0	4261	0	4189	0.0	0.0
chr20	SNHG11	38446949	38447012	0	64	0	4261	0	4197	0.0	0.0
chr20	SNHG11	38446968	38447012	0	45	0	4261	0	4216	0.0	0.0
chr20	SNHG11	38446853	38446940	0	88	0	4261	0	4173	0.0	0.0
chr20	SNHG11	38446853	38446948	0	96	0	4261	0	4165	0.0	0.0
chr20	SNHG11	38446941	38446948	0	8	0	4261	0	4253	0.0	0.0
chr20	SNHG11	38446853	38446967	0	115	0	4261	0	4146	0.0	0.0
chr20	SNHG11	38446941	38446967	0	27	0	4261	0	4234	0.0	0.0
chr20	SNHG11	38446949	38446967	0	19	0	4261	0	4242	0.0	0.0
chr20	SNHG11	38447624	38448093	0	470	0	4261	0	3791	0.0	0.0
chr20	RALGAPB	38472928	38473069	0	142	102	11777	102	11635	0.0	0.008766652342071336
chr20	ADIG	38586144	38586257	0	114	0	1037	0	923	0.0	0.0
chr20	LINC01370	40007964	40008459	0	496	0	4191	0	3695	0.0	0.0
chr20	LINC01370	40006359	40006442	0	84	0	4191	0	4107	0.0	0.0
chr20	LPIN3	41357958	41358034	0	77	0	4686	0	4609	0.0	0.0
chr20	L3MBTL1	43530420	43530889	177354	470	2544979	12176	2367625	11706	377.34893617021277	202.25738937297112
chr20	SGK2	43567964	43567999	36	36	427746	4836	427710	4800	1.0	89.10625
chr20	SGK2	43576380	43576383	68	4	427746	4836	427678	4832	17.0	88.50951986754967
chr20	IFT52	43591030	43591054	0	25	6883	2501	6883	2476	0.0	2.779886914378029
chr20	OSER1-DT	44211078	44211356	0	279	102	9245	102	8966	0.0	0.01137631050635735
chr20	HNF4A	44428458	44428487	60	30	546118	7355	546058	7325	2.0	74.54716723549488
chr20	TTPAL	44484429	44484530	300	102	66377	7062	66077	6960	2.9411764705882355	9.493821839080459
chr20	CCN5	44720114	44720121	0	8	363114	4985	363114	4977	0.0	72.95840867992767
chr20	PABPC1L	44935498	44935502	0	5	0	3854	0	3849	0.0	0.0
chr20	RBPJL	45316581	45316590	0	10	113355	2786	113355	2776	0.0	40.83393371757925
chr20	DBNDD2	45408939	45409036	0	98	17	2769	17	2671	0.0	0.00636465743167353
chr20	PIGT	45421534	45421583	0	50	51	11655	51	11605	0.0	0.004394657475226196
chr20	PIGT	45416655	45416694	0	40	51	11655	51	11615	0.0	0.004390873869995695
chr20	PIGT	45416665	45416694	0	30	51	11655	51	11625	0.0	0.004387096774193549
chr20	PIGT	45419591	45419638	0	48	51	11655	51	11607	0.0	0.004393900232618248
chr20	PIGT	45416655	45416664	0	10	51	11655	51	11645	0.0	0.004379562043795621
chr20	PIGT	45418980	45419395	0	416	51	11655	51	11239	0.0	0.004537770264258386
chr20	PIGT	45421584	45421664	0	81	51	11655	51	11574	0.0	0.0044064282011404875
chr20	PIGT	45421534	45421664	0	131	51	11655	51	11524	0.0	0.004425546685178757
chr20	UBE2C	45815541	45815745	0	205	0	1293	0	1088	0.0	0.0
chr20	SNX21	45835110	45835116	0	7	68032	3701	68032	3694	0.0	18.416892257715215
chr20	SNX21	45833941	45834018	0	78	68032	3701	68032	3623	0.0	18.777808446039195
chr20	CTSA	45892881	45892887	14	7	25021	7771	25007	7764	2.0	3.220891293147862
chr20	CTSA	45891380	45891425	0	46	25021	7771	25021	7725	0.0	3.2389644012944983
chr20	CTSA	45891763	45891822	0	60	25021	7771	25021	7711	0.0	3.2448450265853976
chr20	CTSA	45891380	45891449	0	70	25021	7771	25021	7701	0.0	3.24905856382288
chr20	CTSA	45891426	45891449	0	24	25021	7771	25021	7747	0.0	3.2297663611720666
chr20	CTSA	45895134	45895138	0	5	25021	7771	25021	7766	0.0	3.2218645377285604
chr20	CTSA	45897041	45897806	0	766	25021	7771	25021	7005	0.0	3.5718772305496076
chr20	NCOA3	47649098	47649109	0	12	103216	8442	103216	8430	0.0	12.243890865954922
chr20	LINC00494	48360884	48360975	0	92	0	5148	0	5056	0.0	0.0
chr20	LINC00494	48366634	48367059	0	426	0	5148	0	4722	0.0	0.0
chr20	ZFAS1	49278398	49278716	0	319	459	7898	459	7579	0.0	0.06056207943000396
chr20	ZFAS1	49278717	49278738	0	22	459	7898	459	7876	0.0	0.05827831386490604
chr20	LINC01273	50172227	50172330	0	104	51	1682	51	1578	0.0	0.03231939163498099
chr20	PELATON	50277614	50277980	0	367	561	7207	561	6840	0.0	0.08201754385964913
chr20	PELATON	50276391	50276566	0	176	561	7207	561	7031	0.0	0.07978950362679561
chr20	LINC01270	50311920	50312014	0	95	2462	5084	2462	4989	0.0	0.4934856684706354
chr20	AL031674.1	52671843	52671960	0	118	0	3306	0	3188	0.0	0.0
chr20	DOK5	54475905	54476012	0	108	0	2491	0	2383	0.0	0.0
chr20	LINC01440	55423247	55423527	0	281	0	5095	0	4814	0.0	0.0
chr20	LINC01440	55423528	55424041	0	514	0	5095	0	4581	0.0	0.0
chr20	AL109828.1	55775645	55776666	2340	1022	2340	1444	0	422	2.289628180039139	0.0
chr20	CSTF1	56392714	56392815	0	102	0	4800	0	4698	0.0	0.0
chr20	CSTF1	56395722	56395759	0	38	0	4800	0	4762	0.0	0.0
chr20	RAE1	57351359	57351422	0	64	0	3313	0	3249	0.0	0.0
chr20	RAE1	57351920	57351998	0	79	0	3313	0	3234	0.0	0.0
chr20	RAE1	57351571	57351919	0	349	0	3313	0	2964	0.0	0.0
chr20	APCDD1L-DT	58519600	58519625	92	26	40303	5587	40211	5561	3.5384615384615383	7.230893724150333
chr20	STX16	58651415	58651434	0	20	0	5049	0	5029	0.0	0.0
chr20	STX16	58651407	58651434	0	28	0	5049	0	5021	0.0	0.0
chr20	STX16	58651407	58651414	0	8	0	5049	0	5041	0.0	0.0
chr20	STX16	58651435	58651531	0	97	0	5049	0	4952	0.0	0.0
chr20	STX16	58651415	58651531	0	117	0	5049	0	4932	0.0	0.0
chr20	STX16	58651407	58651531	0	125	0	5049	0	4924	0.0	0.0
chr20	STX16	58667598	58667608	0	11	0	5049	0	5038	0.0	0.0
chr20	STX16	58652088	58652138	0	51	0	5049	0	4998	0.0	0.0
chr20	GNAS	58839941	58840886	0	946	26	12313	26	11367	0.0	0.0022873229524060876
chr20	GNAS	58888905	58888908	0	4	26	12313	26	12309	0.0	0.002112275570720611
chr20	GNAS	58888905	58889046	0	142	26	12313	26	12171	0.0	0.002136225453947909
chr20	GNAS	58888909	58889046	0	138	26	12313	26	12175	0.0	0.002135523613963039
chr20	GNAS	58889214	58889353	0	140	26	12313	26	12173	0.0	0.0021358744763000084
chr20	GNAS	58889333	58889353	0	21	26	12313	26	12292	0.0	0.0021151968760169215
chr20	GNAS	58889354	58889549	0	196	26	12313	26	12117	0.0	0.002145745646612198
chr20	GNAS	58889214	58889549	0	336	26	12313	26	11977	0.0	0.002170827419220172
chr20	GNAS	58889407	58889549	0	143	26	12313	26	12170	0.0	0.0021364009860312242
chr20	GNAS	58889333	58889549	0	217	26	12313	26	12096	0.0	0.0021494708994708994
chr20	GNAS	58889354	58889406	0	53	26	12313	26	12260	0.0	0.0021207177814029365
chr20	GNAS	58889214	58889406	0	193	26	12313	26	12120	0.0	0.0021452145214521452
chr20	GNAS	58889333	58889406	0	74	26	12313	26	12239	0.0	0.002124356565078846
chr20	GNAS	58889214	58889332	0	119	26	12313	26	12194	0.0	0.0021321961620469083
chr20	NELFCD	58993676	58993764	0	89	51	5233	51	5144	0.0	0.009914463452566096
chr20	NELFCD	58994192	58994239	0	48	51	5233	51	5185	0.0	0.009836065573770493
chr20	EDN3	59322418	59322452	0	35	0	3293	0	3258	0.0	0.0
chr20	EDN3	59322453	59322482	0	30	0	3293	0	3263	0.0	0.0
chr20	EDN3	59322418	59322482	0	65	0	3293	0	3228	0.0	0.0
chr20	MIR646HG	60154502	60154506	0	5	1329	22150	1329	22145	0.0	0.06001354707608941
chr20	MIR646HG	60098964	60099032	0	69	1329	22150	1329	22081	0.0	0.06018749150853675
chr20	MIR646HG	60098964	60099069	0	106	1329	22150	1329	22044	0.0	0.060288513881328255
chr20	MIR646HG	60099033	60099069	0	37	1329	22150	1329	22113	0.0	0.060100393433726765
chr20	MIR646HG	60097522	60097664	0	143	1329	22150	1329	22007	0.0	0.06038987594856182
chr20	MIR646HG	60378221	60378255	0	35	1329	22150	1329	22115	0.0	0.06009495817318562
chr20	CDH4	61743628	61743789	0	162	13813	7534	13813	7372	0.0	1.8737113402061856
chr20	SS18L1	62158749	62158942	0	194	2118	4351	2118	4157	0.0	0.5095020447438057
chr20	OSBPL2	62242435	62242661	765	227	126363	10826	125598	10599	3.3700440528634363	11.849985847721483
chr20	OSBPL2	62279340	62279519	783	180	126363	10826	125580	10646	4.35	11.79597971068946
chr20	OSBPL2	62279350	62279519	741	170	126363	10826	125622	10656	4.358823529411764	11.78885135135135
chr20	OSBPL2	62279340	62279349	42	10	126363	10826	126321	10816	4.2	11.679086538461538
chr20	LAMA5-AS1	62353209	62353335	0	127	1621	846	1621	719	0.0	2.25452016689847
chr20	SLC17A9	62962735	62962754	0	20	39	5474	39	5454	0.0	0.007150715071507151
chr20	ARFGAP1	63273411	63273518	0	108	0	6173	0	6065	0.0	0.0
chr20	COL20A1	63328128	63328145	0	18	0	9868	0	9850	0.0	0.0
chr20	COL20A1	63306040	63306060	0	21	0	9868	0	9847	0.0	0.0
chr20	RTEL1	63658460	63658466	0	7	0	5965	0	5958	0.0	0.0
chr20	RTEL1	63695481	63695650	0	170	0	5965	0	5795	0.0	0.0
chr20	RTEL1	63658714	63658752	0	39	0	5965	0	5926	0.0	0.0
chr20	ZGPAT	63733713	63733739	0	27	0	3337	0	3310	0.0	0.0
chr20	ZGPAT	63708119	63708188	0	70	0	3337	0	3267	0.0	0.0
chr20	ZGPAT	63708170	63708188	0	19	0	3337	0	3318	0.0	0.0
chr20	ZGPAT	63708119	63708169	0	51	0	3337	0	3286	0.0	0.0
chr20	AL121845.3	63736397	63736712	0	316	0	3201	0	2885	0.0	0.0
chr20	SLC2A4RG	63742365	63742615	0	251	0	2703	0	2452	0.0	0.0
chr20	PCMTD2	64255871	64255924	0	54	0	5895	0	5841	0.0	0.0
chr20	C20ORF96	290586	290589	0	4	57785	1737	57785	1733	0.0	33.34391229082516
chr20	CSNK2A1	543631	543670	0	40	99299	19650	99299	19610	0.0	5.063691993880673
chr20	CSNK2A1	540827	540888	0	62	99299	19650	99299	19588	0.0	5.069379211762303
chr20	CSNK2A1	539198	539673	51	476	99299	19650	99248	19174	0.10714285714285714	5.176176071763847
chr20	FKBP1A	1371021	1371118	0	98	47778	4404	47778	4306	0.0	11.095680445889457
chr20	SIRPB2	1479699	1479992	0	294	0	4491	0	4197	0.0	0.0
chr20	SIRPB2	1479699	1479924	0	226	0	4491	0	4265	0.0	0.0
chr20	SIRPB2	1479925	1479992	0	68	0	4491	0	4423	0.0	0.0
chr20	SIRPD	1551690	1551869	380	180	0	647	-380	467	2.111111111111111	-0.8137044967880086
chr20	PDYN	1983975	1984201	0	227	0	3531	0	3304	0.0	0.0
chr20	ZNF343	2508799	2508879	0	81	102	4645	102	4564	0.0	0.022348816827344433
chr20	IDH3B	2658637	2658757	0	121	510	2575	510	2454	0.0	0.2078239608801956
chr20	IDH3B	2660029	2660066	0	38	510	2575	510	2537	0.0	0.20102483247930628
chr20	SLC4A11	3238979	3239093	455	115	48628	4340	48173	4225	3.9565217391304346	11.40189349112426
chr20	C20ORF27	3760006	3760080	102	75	1437	1361	1335	1286	1.36	1.0381026438569207
chr20	C20ORF27	3767208	3767661	958	454	1437	1361	479	907	2.1101321585903086	0.5281146637265711
chr20	PRNT	4740139	4740375	0	237	0	2101	0	1864	0.0	0.0
chr20	PRNT	4740139	4740598	0	460	0	2101	0	1641	0.0	0.0
chr20	PRNT	4740376	4740598	0	223	0	2101	0	1878	0.0	0.0
chr20	TMEM230	5112742	5112959	0	218	744431	3050	744431	2832	0.0	262.8640536723164
chr20	TMEM230	5112729	5112959	0	231	744431	3050	744431	2819	0.0	264.0762681802058
chr20	TMEM230	5112729	5112741	0	13	744431	3050	744431	3037	0.0	245.1205136648008
chr20	TMEM230	5112719	5112959	0	241	744431	3050	744431	2809	0.0	265.01637593449624
chr20	TMEM230	5112719	5112741	0	23	744431	3050	744431	3027	0.0	245.93029402048234
chr20	TMEM230	5112719	5112728	0	10	744431	3050	744431	3040	0.0	244.87861842105264
chr20	LINC00658	5433788	5433961	0	174	102	2892	102	2718	0.0	0.037527593818984545
chr20	LINC00658	5433788	5434113	0	326	102	2892	102	2566	0.0	0.03975058456742011
chr20	LINC00658	5433788	5434170	0	383	102	2892	102	2509	0.0	0.04065364687126345
chr20	LINC00658	5445503	5445623	0	121	102	2892	102	2771	0.0	0.03680981595092025
chr20	LINC00658	5434171	5434356	0	186	102	2892	102	2706	0.0	0.037694013303769404
chr20	LINC00658	5432450	5432541	0	92	102	2892	102	2800	0.0	0.03642857142857143
chr20	LINC00658	5434171	5434196	0	26	102	2892	102	2866	0.0	0.03558967201674808
chr20	LINC00658	5434114	5434170	0	57	102	2892	102	2835	0.0	0.03597883597883598
chr20	LINC00658	5434114	5434356	0	243	102	2892	102	2649	0.0	0.03850509626274066
chr20	LINC00658	5433962	5434113	0	152	102	2892	102	2740	0.0	0.03722627737226277
chr20	LINC00658	5433962	5434170	0	209	102	2892	102	2683	0.0	0.0380171449869549
chr20	LINC00654	5504022	5504296	0	275	4077	8091	4077	7816	0.0	0.5216223132036848
chr20	LINC00654	5526339	5526636	3547	298	4077	8091	530	7793	11.90268456375839	0.06800975234184524
chr20	FERMT1	6119403	6119419	0	17	3857	4862	3857	4845	0.0	0.796078431372549
chr20	SNAP25-AS1	10219221	10219235	0	15	11611	11293	11611	11278	0.0	1.0295265117928711
chr20	SNAP25-AS1	10104167	10104284	0	118	11611	11293	11611	11175	0.0	1.0390156599552574
chr20	LINC00687	11871898	11871984	0	87	407	1995	407	1908	0.0	0.21331236897274633
chr20	TASP1	13528432	13528444	0	13	700	2914	700	2901	0.0	0.24129610479145122
chr20	RRBP1	17614736	17614738	3	3	169991	5199	169988	5196	1.0	32.715165511932256
chr20	RRBP1	17658595	17658603	0	9	169991	5199	169991	5190	0.0	32.75356454720617
chr20	SNX5	17968374	17968698	4329	325	287252	6160	282923	5835	13.32	48.48723221936589
chr20	AL049646.1	18328697	18328891	0	195	3162	3242	3162	3047	0.0	1.0377420413521496
chr20	DZANK1	18466861	18466994	52	134	55568	6644	55516	6510	0.3880597014925373	8.527803379416282
chr20	LINC00652	18794167	18794469	0	303	51	4119	51	3816	0.0	0.013364779874213837
chr20	AL121830.1	19696543	19696614	0	72	0	2243	0	2171	0.0	0.0
chr20	AL121830.1	19696317	19696614	0	298	0	2243	0	1945	0.0	0.0
chr20	AL121830.1	19696317	19696542	0	226	0	2243	0	2017	0.0	0.0
chr20	AL121830.1	19693551	19693601	0	51	0	2243	0	2192	0.0	0.0
chr20	CRNKL1	20052291	20052477	0	187	27	4575	27	4388	0.0	0.006153144940747493
chr20	CRNKL1	20052291	20052473	0	183	27	4575	27	4392	0.0	0.006147540983606557
chr20	CRNKL1	20052474	20052477	0	4	27	4575	27	4571	0.0	0.0059068037628527675
chr20	LINC00237	21093196	21093736	0	541	0	2419	0	1878	0.0	0.0
chr20	LINC01427	22274403	22274406	0	4	255	6326	255	6322	0.0	0.04033533691869662
chr20	LINC01427	22276420	22280337	255	3918	255	6326	0	2408	0.06508422664624809	0.0
chr20	LINC00656	23128964	23128984	0	21	1342	1914	1342	1893	0.0	0.7089276281035394
chr20	AL035252.2	25144278	25144295	0	18	417	4406	417	4388	0.0	0.09503190519598906
chr20	AL035252.2	25147956	25148597	0	642	417	4406	417	3764	0.0	0.11078639744952179
chr20	ABHD12	25339621	25339693	0	73	48666	4504	48666	4431	0.0	10.983073798239674
chr20	MIR663AHG	26194297	26194384	0	88	252	6568	252	6480	0.0	0.03888888888888889
chr20	MIR663AHG	26209146	26209161	0	16	252	6568	252	6552	0.0	0.038461538461538464
chr20	MIR663AHG	26209146	26209168	0	23	252	6568	252	6545	0.0	0.038502673796791446
chr20	MIR663AHG	26209146	26209262	0	117	252	6568	252	6451	0.0	0.03906371105254999
chr20	MIR663AHG	26209122	26209145	0	24	252	6568	252	6544	0.0	0.03850855745721271
chr20	MIR663AHG	26209122	26209161	0	40	252	6568	252	6528	0.0	0.03860294117647059
chr20	MIR663AHG	26209122	26209168	0	47	252	6568	252	6521	0.0	0.03864437969636559
chr20	MIR663AHG	26209162	26209168	0	7	252	6568	252	6561	0.0	0.038408779149519894
chr20	MIR663AHG	26207669	26207672	0	4	252	6568	252	6564	0.0	0.038391224862888484
chr20	MIR663AHG	26208998	26209021	0	24	252	6568	252	6544	0.0	0.03850855745721271
chr20	MIR663AHG	26208864	26208997	0	134	252	6568	252	6434	0.0	0.039166925707180604
chr20	MIR663AHG	26208864	26209021	0	158	252	6568	252	6410	0.0	0.039313572542901715
chr20	MIR663AHG	26192128	26192131	0	4	252	6568	252	6564	0.0	0.038391224862888484
chr20	MIR663AHG	26209146	26209247	0	102	252	6568	252	6466	0.0	0.03897309000927931
chr20	MIR663AHG	26209169	26209262	0	94	252	6568	252	6474	0.0	0.03892493049119555
chr20	MIR663AHG	26208292	26208301	0	10	252	6568	252	6558	0.0	0.0384263494967978
chr20	MIR663AHG	26209169	26209247	0	79	252	6568	252	6489	0.0	0.038834951456310676
chr20	FRG1CP	28601602	28601655	0	54	0	2742	0	2688	0.0	0.0
chr20	BCL2L1	31721654	31721842	0	189	0	3964	0	3775	0.0	0.0
chr20	BCL2L1	31723847	31723862	0	16	0	3964	0	3948	0.0	0.0
chr20	BCL2L1	31723734	31723862	0	129	0	3964	0	3835	0.0	0.0
chr20	BCL2L1	31723734	31723846	0	113	0	3964	0	3851	0.0	0.0
chr20	DUSP15	31870316	31870574	0	259	18	3591	18	3332	0.0	0.005402160864345739
chr20	DUSP15	31869809	31870046	0	238	18	3591	18	3353	0.0	0.0053683268714583956
chr20	NECAB3	33659496	33659651	0	156	61974	4125	61974	3969	0.0	15.61451247165533
chr20	RALY-AS1	33991774	33993058	4315	1285	101515	8725	97200	7440	3.357976653696498	13.064516129032258
chr20	GSS	34936762	34936763	0	2	62	5144	62	5142	0.0	0.012057565149747181
chr20	GSS	34951723	34951788	0	66	62	5144	62	5078	0.0	0.012209531311539977
chr20	MMP24OS	35278008	35278044	10	37	193528	5505	193518	5468	0.2702702702702703	35.39100219458668
chr20	EIF6	35284175	35284379	2740	205	105796	1643	103056	1438	13.365853658536585	71.66620305980528
chr20	EIF6	35284725	35284763	2231	39	105796	1643	103565	1604	57.205128205128204	64.56670822942644
chr20	UQCC1	35381917	35381924	0	8	156139	4188	156139	4180	0.0	37.35382775119617
chr20	FER1L4	35560122	35560161	308	40	22581	9174	22273	9134	7.7	2.4384716444055177
chr20	FER1L4	35576595	35576650	0	56	22581	9174	22581	9118	0.0	2.4765299407764862
chr20	CPNE1	35626566	35626733	6500	168	50298	2948	43798	2780	38.69047619047619	15.754676258992806
chr20	CPNE1	35664759	35664877	102	119	50298	2948	50196	2829	0.8571428571428571	17.743372216330858
chr20	CPNE1	35626562	35626565	3	4	50298	2948	50295	2944	0.75	17.08389945652174
chr20	CPNE1	35626562	35626733	6503	172	50298	2948	43795	2776	37.80813953488372	15.776296829971182
chr20	CPNE1	35664759	35664800	68	42	50298	2948	50230	2906	1.619047619047619	17.2849277357192
chr20	CPNE1	35664801	35664877	34	77	50298	2948	50264	2871	0.44155844155844154	17.507488679902472
chr20	NFS1	35699191	35699308	70	118	36524	5562	36454	5444	0.5932203389830508	6.696179279941219
chr20	NFS1	35698744	35699043	521	300	36524	5562	36003	5262	1.7366666666666666	6.842075256556442
chr20	DSN1	36773393	36773660	1514	268	122812	2481	121298	2213	5.649253731343284	54.81156800723001
chr20	SAMHD1	36935028	36935079	0	52	138	8463	138	8411	0.0	0.016407085958863393
chr20	BLCAP	37527573	37527629	0	57	0	5359	0	5302	0.0	0.0
chr20	TGM2	38166402	38166433	0	32	0	7962	0	7930	0.0	0.0
chr20	SNHG17	38422086	38422090	0	5	199	11084	199	11079	0.0	0.01796190991966784
chr20	SNHG17	38422086	38422094	0	9	199	11084	199	11075	0.0	0.017968397291196387
chr20	SNHG17	38434503	38434518	0	16	199	11084	199	11068	0.0	0.01797976147452114
chr20	SNHG17	38435026	38435195	0	170	199	11084	199	10914	0.0	0.018233461608942642
chr20	SNHG17	38422091	38422289	0	199	199	11084	199	10885	0.0	0.018282039503904456
chr20	SNHG17	38422091	38422094	0	4	199	11084	199	11080	0.0	0.01796028880866426
chr20	SNHG17	38427246	38427678	0	433	199	11084	199	10651	0.0	0.01868369167214346
chr20	SNHG17	38422086	38422289	0	204	199	11084	199	10880	0.0	0.01829044117647059
chr20	SNHG17	38422095	38422289	0	195	199	11084	199	10889	0.0	0.01827532372118652
chr20	SNHG17	38425934	38426417	0	484	199	11084	199	10600	0.0	0.018773584905660376
chr20	SNHG17	38429868	38429952	0	85	199	11084	199	10999	0.0	0.018092553868533503
chr20	ZHX3	41202056	41204243	0	2188	0	4825	0	2637	0.0	0.0
chr20	ZHX3	41202056	41202281	0	226	0	4825	0	4599	0.0	0.0
chr20	ZHX3	41268978	41268988	0	11	0	4825	0	4814	0.0	0.0
chr20	ZHX3	41202282	41204243	0	1962	0	4825	0	2863	0.0	0.0
chr20	ZHX3	41272138	41272202	0	65	0	4825	0	4760	0.0	0.0
chr20	PTPRT	43189643	43189644	20	2	6630	12975	6610	12973	10.0	0.5095197718338087
chr20	LINC01260	44663204	44663352	0	149	0	1005	0	856	0.0	0.0
chr20	WFDC5	45110373	45110398	0	26	0	1048	0	1022	0.0	0.0
chr20	WFDC11	45670177	45670180	0	4	0	659	0	655	0.0	0.0
chr20	ELMO2	46393980	46394047	5	68	155	4584	150	4516	0.07352941176470588	0.033215234720992026
chr20	ZNF334	46513409	46513495	0	87	0	6001	0	5914	0.0	0.0
chr20	ZNF334	46512539	46513408	0	870	0	6001	0	5131	0.0	0.0
chr20	ZNF334	46512539	46513495	0	957	0	6001	0	5044	0.0	0.0
chr20	TP53RK	46689126	46689130	0	5	0	3187	0	3182	0.0	0.0
chr20	ZMYND8	47238757	47238894	0	138	459	7654	459	7516	0.0	0.06106971793507185
chr20	SULF2	47785834	47786046	0	213	42946	6098	42946	5885	0.0	7.297536108751062
chr20	ZNFX1	49277929	49278019	0	91	435	9357	435	9266	0.0	0.04694582344053529
chr20	UBE2V1	50115698	50115828	0	131	675	4832	675	4701	0.0	0.14358647096362476
chr20	PEDS1	50130855	50130863	0	9	1785	7939	1785	7930	0.0	0.22509457755359394
chr20	LINC01275	50165968	50166028	0	61	0	1006	0	945	0.0	0.0
chr20	DPM1	50941104	50941127	0	24	0	1217	0	1193	0.0	0.0
chr20	KCNG1	51022653	51022868	0	216	0	5421	0	5205	0.0	0.0
chr20	SALL4	51790021	51791331	0	1311	0	5780	0	4469	0.0	0.0
chr20	AC006076.1	53800930	53801141	0	212	0	794	0	582	0.0	0.0
chr20	AURKA	56392153	56392166	0	14	0	2904	0	2890	0.0	0.0
chr20	AURKA	56391942	56392166	0	225	0	2904	0	2679	0.0	0.0
chr20	AURKA	56391942	56392152	0	211	0	2904	0	2693	0.0	0.0
chr20	CTCFL	57525027	57525472	0	446	2916	8679	2916	8233	0.0	0.3541843799344103
chr20	CTCFL	57515464	57515712	72	249	2916	8679	2844	8430	0.2891566265060241	0.3373665480427046
chr20	PMEPA1	57710459	57710465	0	7	0	5734	0	5727	0.0	0.0
chr20	AL354984.2	58071720	58071999	0	280	0	1026	0	746	0.0	0.0
chr20	PPP4R1L	58235239	58235275	0	37	51	9090	51	9053	0.0	0.0056334916602231305
chr20	PHACTR3-AS1	59628093	59628096	0	4	0	2250	0	2246	0.0	0.0
chr20	AL160412.1	61436479	61437039	2038	561	9582	3576	7544	3015	3.6327985739750446	2.502155887230514
chr20	AL160412.1	61436185	61436478	32646	294	9582	3576	-23064	3282	111.04081632653062	-7.027422303473492
chr20	TAF4	62006509	62006544	0	36	510	7829	510	7793	0.0	0.06544334659309636
chr20	PSMA7	62139695	62139779	0	85	20	1759	20	1674	0.0	0.011947431302270013
chr20	LINC00659	62776795	62776804	0	10	0	1374	0	1364	0.0	0.0
chr20	LINC00659	62776455	62776804	0	350	0	1374	0	1024	0.0	0.0
chr20	LINC00659	62776311	62776794	0	484	0	1374	0	890	0.0	0.0
chr20	LINC00659	62776311	62776804	0	494	0	1374	0	880	0.0	0.0
chr20	LINC00659	62776311	62776454	0	144	0	1374	0	1230	0.0	0.0
chr20	LINC00659	62776455	62776794	0	340	0	1374	0	1034	0.0	0.0
chr20	DIDO1	62926431	62926437	14	7	384462	13292	384448	13285	2.0	28.938502070003764
chr20	CHRNA4	63361089	63361175	0	87	0	11311	0	11224	0.0	0.0
chr21	CU633967.1	5584976	5585063	0	88	0	5133	0	5045	0.0	0.0
chr21	SMIM11B	7745368	7745650	0	283	0	4297	0	4014	0.0	0.0
chr21	FP236383.3	8383922	8384098	0	177	0	4407	0	4230	0.0	0.0
chr21	LINC01666	8759262	8759861	0	600	0	843	0	243	0.0	0.0
chr21	CR381653.1	9325101	9325223	0	123	0	1910	0	1787	0.0	0.0
chr21	BAGE2	10497100	10497109	0	10	110	4098	110	4088	0.0	0.026908023483365948
chr21	BAGE2	10498967	10498986	0	20	110	4098	110	4078	0.0	0.026974006866110838
chr21	ABCC13	14313121	14313131	0	11	0	8015	0	8004	0.0	0.0
chr21	MIR99AHG	16041354	16041464	0	111	517	42307	517	42196	0.0	0.012252346193952034
chr21	MIR99AHG	16589468	16589557	0	90	517	42307	517	42217	0.0	0.01224625151005519
chr21	MIR99AHG	16589541	16589557	0	17	517	42307	517	42290	0.0	0.012225112319697327
chr21	MIR99AHG	16589414	16589557	0	144	517	42307	517	42163	0.0	0.012261935820506132
chr21	MIR99AHG	16070549	16070567	0	19	517	42307	517	42288	0.0	0.012225690503216043
chr21	MIR99AHG	16070568	16070892	0	325	517	42307	517	41982	0.0	0.012314801581630222
chr21	MIR99AHG	16070549	16070892	0	344	517	42307	517	41963	0.0	0.012320377475394991
chr21	MIR99AHG	16125009	16125447	0	439	517	42307	517	41868	0.0	0.01234833285564154
chr21	MIR99AHG	16589414	16589467	0	54	517	42307	517	42253	0.0	0.012235817575083427
chr21	MIR99AHG	16589468	16589540	0	73	517	42307	517	42234	0.0	0.012241322157503433
chr21	MIR99AHG	16589414	16589540	0	127	517	42307	517	42180	0.0	0.012256993835941204
chr21	MIR99AHG	16420573	16420576	0	4	517	42307	517	42303	0.0	0.012221355459423681
chr21	MIR99AHG	16589558	16589736	0	179	517	42307	517	42128	0.0	0.012272123053551083
chr21	MIR99AHG	16589468	16589736	0	269	517	42307	517	42038	0.0	0.012298396688710215
chr21	MIR99AHG	16589541	16589736	0	196	517	42307	517	42111	0.0	0.01227707724822493
chr21	MIR99AHG	16589414	16589736	0	323	517	42307	517	41984	0.0	0.01231421493902439
chr21	LINC01684	24438434	24438443	0	10	34	9534	34	9524	0.0	0.0035699286014279717
chr21	JAM2	25711556	25711568	0	13	75	5938	75	5925	0.0	0.012658227848101266
chr21	GABPA	25735071	25735578	0	508	816	5752	816	5244	0.0	0.15560640732265446
chr21	AP001442.1	25934190	25934366	0	177	0	2606	0	2429	0.0	0.0
chr21	LINC00113	27746033	27746036	0	4	0	616	0	612	0.0	0.0
chr21	LINC00161	28539529	28539884	0	356	0	872	0	516	0.0	0.0
chr21	GRIK1-AS1	29759011	29759014	0	4	0	3102	0	3098	0.0	0.0
chr21	SOD1	31659785	31659841	0	57	0	1981	0	1924	0.0	0.0
chr21	EVA1C	32412194	32413013	0	820	11327	4328	11327	3508	0.0	3.2289053591790196
chr21	EVA1C	32501487	32501495	0	9	11327	4328	11327	4319	0.0	2.622597823570271
chr21	EVA1C	32501496	32501538	0	43	11327	4328	11327	4285	0.0	2.6434072345390898
chr21	EVA1C	32501487	32501538	0	52	11327	4328	11327	4276	0.0	2.648971000935454
chr21	PAXBP1-AS1	32730662	32732825	1377	2164	1643	9689	266	7525	0.6363216266173752	0.035348837209302326
chr21	PAXBP1-AS1	32730662	32731577	0	916	1643	9689	1643	8773	0.0	0.1872791519434629
chr21	C21ORF62-AS1	32772309	32772310	2	2	1625	9197	1623	9195	1.0	0.1765089722675367
chr21	C21ORF62-AS1	32772309	32772320	12	12	1625	9197	1613	9185	1.0	0.17561241154055526
chr21	C21ORF62-AS1	32772311	32772320	10	10	1625	9197	1615	9187	1.0	0.17579187983019484
chr21	C21ORF62-AS1	32797043	32797060	0	18	1625	9197	1625	9179	0.0	0.1770345353524349
chr21	OLIG2	33026027	33026260	0	234	510	2724	510	2490	0.0	0.20481927710843373
chr21	OLIG1	33071686	33071705	60	20	6827	1450	6767	1430	3.0	4.732167832167832
chr21	AP000290.1	33152952	33152978	0	27	102	879	102	852	0.0	0.11971830985915492
chr21	LINC00649	33931268	33931742	102	475	125150	8737	125048	8262	0.21473684210526317	15.135318324860808
chr21	LINC00649	33931353	33931742	102	390	125150	8737	125048	8347	0.26153846153846155	14.981190847010902
chr21	LINC00310	34183119	34183192	0	74	663	3286	663	3212	0.0	0.2064134495641345
chr21	AP000317.2	34262922	34262938	0	17	771	647	771	630	0.0	1.223809523809524
chr21	SMIM11A	34375897	34376179	0	283	0	7871	0	7588	0.0	0.0
chr21	MORC3	36375219	36375308	0	90	2483	6433	2483	6343	0.0	0.39145514740658993
chr21	TTC3	37073365	37073473	0	109	102	15936	102	15827	0.0	0.00644468313641246
chr21	DYRK1A	37365835	37366185	0	351	233084	22440	233084	22089	0.0	10.552039476662593
chr21	DYRK1A	37506224	37506354	0	131	233084	22440	233084	22309	0.0	10.447980635617911
chr21	DSCR8	38122412	38122668	7132	257	18958	835	11826	578	27.750972762645915	20.46020761245675
chr21	DSCR8	38122484	38122668	5677	185	18958	835	13281	650	30.686486486486487	20.432307692307692
chr21	DSCR8	38122412	38122483	1455	72	18958	835	17503	763	20.208333333333332	22.939711664482306
chr21	KCNJ15	38297012	38297023	0	12	21554	10358	21554	10346	0.0	2.083317224047941
chr21	ETS2	38819767	38819871	0	105	153	4917	153	4812	0.0	0.031795511221945134
chr21	GET1	39390864	39391476	0	613	0	8656	0	8043	0.0	0.0
chr21	GET1	39390920	39391476	0	557	0	8656	0	8099	0.0	0.0
chr21	GET1	39406059	39406298	0	240	0	8656	0	8416	0.0	0.0
chr21	GET1	39390864	39390919	0	56	0	8656	0	8600	0.0	0.0
chr21	GET1	39380487	39380556	0	70	0	8656	0	8586	0.0	0.0
chr21	GET1	39380557	39380921	0	365	0	8656	0	8291	0.0	0.0
chr21	GET1	39414005	39414591	0	587	0	8656	0	8069	0.0	0.0
chr21	SH3BGR	39445893	39445929	0	37	0	1493	0	1456	0.0	0.0
chr21	SH3BGR	39446082	39446098	0	17	0	1493	0	1476	0.0	0.0
chr21	DSCAM-AS1	40383456	40383584	0	129	744	1772	744	1643	0.0	0.4528301886792453
chr21	BACE2	41241940	41241947	0	8	102	9570	102	9562	0.0	0.010667224430035557
chr21	MX1	41435961	41436029	0	69	0	6893	0	6824	0.0	0.0
chr21	LINC00112	41715835	41715860	0	26	0	1428	0	1402	0.0	0.0
chr21	LINC00112	41715861	41716083	0	223	0	1428	0	1205	0.0	0.0
chr21	UMODL1	42088474	42088480	0	7	0	7308	0	7301	0.0	0.0
chr21	UMODL1	42085413	42085474	0	62	0	7308	0	7246	0.0	0.0
chr21	ABCG1	42288038	42288073	2	36	51	6143	49	6107	0.05555555555555555	0.008023579498935647
chr21	UBASH3A	42404059	42404184	0	126	38	3935	38	3809	0.0	0.009976371751115778
chr21	UBASH3A	42437581	42437596	0	16	38	3935	38	3919	0.0	0.009696351109977035
chr21	LINC00319	43450922	43450972	0	51	204	4286	204	4235	0.0	0.048170011806375444
chr21	PDXK	43732443	43732647	0	205	0	11305	0	11100	0.0	0.0
chr21	RRP1	43789696	43789762	0	67	0	4003	0	3936	0.0	0.0
chr21	ITGB2-AS1	44921328	44921351	0	24	4835	2443	4835	2419	0.0	1.9987598181066557
chr21	FAM207A	44943793	44943837	0	45	0	1408	0	1363	0.0	0.0
chr21	ADARB1	45222108	45223577	122949	1470	490711	8105	367762	6635	83.63877551020408	55.42758100979653
chr21	LINC00334	45234477	45234506	0	30	153	2102	153	2072	0.0	0.07384169884169885
chr21	LINC00205	45288166	45288244	408	79	7750	5252	7342	5173	5.1645569620253164	1.419292480185579
chr21	COL18A1	45456177	45456881	3461	705	107903	8507	104442	7802	4.909219858156028	13.386567546782876
chr21	PCBP3	45914026	45914094	0	69	38877	6336	38877	6267	0.0	6.203446625179511
chr21	MCM3AP-AS1	46229267	46229363	956	97	15028	9232	14072	9135	9.855670103092784	1.5404488232074438
chr21	YBEY	46286989	46287123	6111	135	39436	1807	33325	1672	45.266666666666666	19.93122009569378
chr21	YBEY	46286416	46286737	7461	322	39436	1807	31975	1485	23.17080745341615	21.531986531986533
chr21	YBEY	46286738	46286743	152	6	39436	1807	39284	1801	25.333333333333332	21.81232648528595
chr21	PCNT	46346982	46346998	0	17	43654	11691	43654	11674	0.0	3.739420935412027
chr21	PCNT	46431979	46432215	0	237	43654	11691	43654	11454	0.0	3.8112449799196786
chr21	PRMT2	46635764	46636547	0	784	10776	5492	10776	4708	0.0	2.288870008496177
chr21	FP236241.1	7676337	7676424	0	88	0	5983	0	5895	0.0	0.0
chr21	SMIM34B	7788860	7789472	0	613	0	2314	0	1701	0.0	0.0
chr21	AF127936.1	14753323	14753799	16	477	35	4958	19	4481	0.033542976939203356	0.004240124972104441
chr21	LINC00320	20782249	20782305	0	57	378	16661	378	16604	0.0	0.022765598650927487
chr21	LINC00320	20757218	20757309	0	92	378	16661	378	16569	0.0	0.022813688212927757
chr21	ATP5PF	25734852	25734937	0	86	0	1583	0	1497	0.0	0.0
chr21	ATP5PF	25734938	25734987	0	50	0	1583	0	1533	0.0	0.0
chr21	ATP5PF	25735314	25735485	0	172	0	1583	0	1411	0.0	0.0
chr21	ATP5PF	25734988	25735485	0	498	0	1583	0	1085	0.0	0.0
chr21	ATP5PF	25734988	25735313	0	326	0	1583	0	1257	0.0	0.0
chr21	ADAMTS1	26840275	26840312	0	38	0	7313	0	7275	0.0	0.0
chr21	ADAMTS1	26842796	26842988	0	193	0	7313	0	7120	0.0	0.0
chr21	AF165147.1	28577152	28577273	0	122	0	9450	0	9328	0.0	0.0
chr21	PAXBP1	32755212	32755228	0	17	1060	6180	1060	6163	0.0	0.17199415868895018
chr21	AP000289.1	33114385	33114514	0	130	153	2512	153	2382	0.0	0.06423173803526448
chr21	DNAJC28	33491065	33491416	0	352	0	2483	0	2131	0.0	0.0
chr21	DNAJC28	33491417	33491600	0	184	0	2483	0	2299	0.0	0.0
chr21	GART	33542586	33542658	0	73	936	6725	936	6652	0.0	0.1407095610342754
chr21	GART	33528514	33528517	0	4	936	6725	936	6721	0.0	0.13926499032882012
chr21	GART	33542590	33542658	0	69	936	6725	936	6656	0.0	0.140625
chr21	GART	33542547	33542585	0	39	936	6725	936	6686	0.0	0.13999401734968592
chr21	GART	33542547	33542658	0	112	936	6725	936	6613	0.0	0.14153939210645697
chr21	RUNX1	35049080	35049166	171	87	217102	15480	216931	15393	1.9655172413793103	14.092834405249139
chr21	SETD4	36060281	36060345	0	65	0	6423	0	6358	0.0	0.0
chr21	CBR3-AS1	36134631	36135298	0	668	0	8894	0	8226	0.0	0.0
chr21	CBR3-AS1	36134631	36134888	0	258	0	8894	0	8636	0.0	0.0
chr21	CBR3-AS1	36134631	36134824	0	194	0	8894	0	8700	0.0	0.0
chr21	CBR3-AS1	36134825	36135298	0	474	0	8894	0	8420	0.0	0.0
chr21	CBR3-AS1	36134825	36134888	0	64	0	8894	0	8830	0.0	0.0
chr21	HLCS	36947332	36948164	0	833	0	10535	0	9702	0.0	0.0
chr21	HLCS	36980640	36980782	0	143	0	10535	0	10392	0.0	0.0
chr21	PIGP	37072990	37072998	0	9	0	4217	0	4208	0.0	0.0
chr21	AP001042.1	38904229	38904953	0	725	69893	10133	69893	9408	0.0	7.429102891156463
chr21	AP001042.1	38904229	38904903	0	675	69893	10133	69893	9458	0.0	7.389828716430535
chr21	AP001042.1	38904904	38904953	0	50	69893	10133	69893	10083	0.0	6.93176633938312
chr21	PSMG1	39183063	39183250	0	188	0	2159	0	1971	0.0	0.0
chr21	BRWD1	39210785	39210864	0	80	12	16239	12	16159	0.0	0.0007426202116467603
chr21	BRWD1	39255644	39255663	0	20	12	16239	12	16219	0.0	0.0007398729884703126
chr21	BRWD1	39264890	39264984	0	95	12	16239	12	16144	0.0	0.0007433102081268583
chr21	HMGN1	39347113	39347245	0	133	51	4327	51	4194	0.0	0.012160228898426323
chr21	LCA5L	39445449	39445723	0	275	0	4442	0	4167	0.0	0.0
chr21	TMPRSS2	41494355	41494478	0	124	0	6341	0	6217	0.0	0.0
chr21	TMPRSS2	41506982	41507572	0	591	0	6341	0	5750	0.0	0.0
chr21	TMPRSS2	41506982	41507696	0	715	0	6341	0	5626	0.0	0.0
chr21	TMPRSS2	41507573	41507696	0	124	0	6341	0	6217	0.0	0.0
chr21	TMPRSS2	41507573	41508079	0	507	0	6341	0	5834	0.0	0.0
chr21	TMPRSS2	41507573	41507948	0	376	0	6341	0	5965	0.0	0.0
chr21	TMPRSS2	41507697	41508079	0	383	0	6341	0	5958	0.0	0.0
chr21	TMPRSS2	41507697	41507948	0	252	0	6341	0	6089	0.0	0.0
chr21	TMPRSS2	41507949	41508079	0	131	0	6341	0	6210	0.0	0.0
chr21	WDR4	42873550	42873601	0	52	0	2750	0	2698	0.0	0.0
chr21	WDR4	42879406	42879511	0	106	0	2750	0	2644	0.0	0.0
chr21	WDR4	42879406	42879519	0	114	0	2750	0	2636	0.0	0.0
chr21	WDR4	42879512	42879519	0	8	0	2750	0	2742	0.0	0.0
chr21	HSF2BP	43633262	43633270	0	9	0	1918	0	1909	0.0	0.0
chr21	AATBC	43808800	43810229	0	1430	0	4099	0	2669	0.0	0.0
chr21	CFAP410	44331842	44331846	210	5	94860	5144	94650	5139	42.0	18.4179801517805
chr21	CFAP410	44330462	44330821	11601	360	94860	5144	83259	4784	32.225	17.40363712374582
chr21	UBE2G2	44774566	44774719	0	154	0	6326	0	6172	0.0	0.0
chr21	SUMO3	44808996	44809045	0	50	200	2738	200	2688	0.0	0.0744047619047619
chr21	SUMO3	44813861	44813974	0	114	200	2738	200	2624	0.0	0.07621951219512195
chr21	ITGB2	44910599	44910723	955	125	8147	6221	7192	6096	7.64	1.1797900262467191
chr21	LINC01547	44938760	44939591	204	832	3774	3203	3570	2371	0.24519230769230768	1.5056938000843525
chr21	LINC01547	44938760	44938834	0	75	3774	3203	3774	3128	0.0	1.2065217391304348
chr21	LINC01547	44937538	44939591	1122	2054	3774	3203	2652	1149	0.5462512171372931	2.308093994778068
chr21	LINC01547	44937538	44938834	918	1297	3774	3203	2856	1906	0.707787201233616	1.4984260230849948
chr21	LINC01547	44937538	44938759	918	1222	3774	3203	2856	1981	0.7512274959083469	1.441696113074205
chr21	LINC01547	44937538	44938442	918	905	3774	3203	2856	2298	1.014364640883978	1.2428198433420365
chr21	LINC01547	44938443	44939591	204	1149	3774	3203	3570	2054	0.17754569190600522	1.7380720545277508
chr21	LINC01547	44938443	44938834	0	392	3774	3203	3774	2811	0.0	1.3425827107790822
chr21	LINC01547	44938443	44938759	0	317	3774	3203	3774	2886	0.0	1.3076923076923077
chr21	POFUT2	45283351	45283381	0	31	239	5242	239	5211	0.0	0.04586451736710804
chr21	COL18A1-AS1	45423769	45424882	0	1114	0	3458	0	2344	0.0	0.0
chr21	FTCD	46136914	46136983	0	70	23	3340	23	3270	0.0	0.007033639143730887
chr21	FTCD	46136914	46136977	0	64	23	3340	23	3276	0.0	0.007020757020757021
chr21	FTCD	46136978	46136983	0	6	23	3340	23	3334	0.0	0.006898620275944811
chr21	LSS	46191065	46191074	7504	10	1830016	7259	1822512	7249	750.4	251.41564353703959
chr21	LSS	46222629	46222661	381	33	1830016	7259	1829635	7226	11.545454545454545	253.20163299197344
chr21	LSS	46228684	46228730	20	47	1830016	7259	1829996	7212	0.425531914893617	253.74320576816416
chr21	MCM3AP	46285698	46286149	6312	452	677459	9494	671147	9042	13.964601769911505	74.22550320725503
chr21	MCM3AP	46285698	46285801	1157	104	677459	9494	676302	9390	11.125	72.02364217252396
chr21	C21ORF58	46322638	46323135	0	498	51	4107	51	3609	0.0	0.014131338320864505
chr22	GAB4	16969612	16969941	0	330	102	3152	102	2822	0.0	0.03614457831325301
chr22	ADA2	17189941	17191681	0	1741	0	8720	0	6979	0.0	0.0
chr22	PI4KAP1	18537291	18537293	0	3	20945	3930	20945	3927	0.0	5.333587980646804
chr22	PRODH	18936014	18936388	0	375	1123	7184	1123	6809	0.0	0.16492877074460274
chr22	ESS2	19138214	19138301	0	88	27171	6013	27171	5925	0.0	4.5858227848101265
chr22	CLTCL1	19201328	19201389	24	62	12733	6720	12709	6658	0.3870967741935484	1.9088314809252027
chr22	UFD1	19454748	19454800	198	53	193894	7600	193696	7547	3.7358490566037736	25.665297469193057
chr22	UFD1	19475469	19475494	0	26	193894	7600	193894	7574	0.0	25.599947187747556
chr22	UFD1	19478762	19478823	0	62	193894	7600	193894	7538	0.0	25.72220748209074
chr22	GNB1L	19854659	19854818	559	160	1627	1660	1068	1500	3.49375	0.712
chr22	GNB1L	19854659	19854680	434	22	1627	1660	1193	1638	19.727272727272727	0.7283272283272283
chr22	TXNRD2	19877039	19877107	58	69	13934	6767	13876	6698	0.8405797101449275	2.071663183039713
chr22	TXNRD2	19881035	19881079	36	45	13934	6767	13898	6722	0.8	2.067539422790836
chr22	TRMT2A	20112910	20112954	39581	45	465256	3878	425675	3833	879.5777777777778	111.05530915731802
chr22	TRMT2A	20116037	20116056	0	20	465256	3878	465256	3858	0.0	120.59512700881285
chr22	TRMT2A	20116882	20117027	0	146	465256	3878	465256	3732	0.0	124.66666666666667
chr22	KLHL22	20464857	20465332	0	476	255	4144	255	3668	0.0	0.06952017448200655
chr22	PI4KA	20726487	20726496	0	10	63439	10761	63439	10751	0.0	5.900753418286671
chr22	TUBA3FP	21013781	21014077	0	297	296	2126	296	1829	0.0	0.16183706943685075
chr22	P2RX6P	21044883	21044960	0	78	0	477	0	399	0.0	0.0
chr22	FAM230H	21322194	21322301	0	108	302799	5886	302799	5778	0.0	52.4055036344756
chr22	PI4KAP2	21475991	21476000	540	10	5401	6796	4861	6786	54.0	0.7163277335691128
chr22	PI4KAP2	21514129	21514132	0	4	5401	6796	5401	6792	0.0	0.7952002355712603
chr22	YDJC	21629542	21629600	0	59	0	1668	0	1609	0.0	0.0
chr22	PPM1F	21937672	21938202	0	531	8771	9572	8771	9041	0.0	0.9701360468974671
chr22	TOP3B	21982413	21982728	128071	316	425353	6344	297282	6028	405.2879746835443	49.316854678168546
chr22	TOP3B	21975904	21975979	38856	76	425353	6344	386497	6268	511.2631578947368	61.66193363114231
chr22	TOP3B	21982199	21982728	139324	530	425353	6344	286029	5814	262.8754716981132	49.196594427244584
chr22	TOP3B	21982199	21982412	11253	214	425353	6344	414100	6130	52.58411214953271	67.55301794453507
chr22	PRAME	22558970	22559173	0	204	2	3814	2	3610	0.0	0.000554016620498615
chr22	PRAME	22556811	22557543	0	733	2	3814	2	3081	0.0	0.0006491398896462187
chr22	CES5AP1	23373594	23373628	0	35	0	1570	0	1535	0.0	0.0
chr22	GUSBP11	23686830	23686836	0	7	10883	7702	10883	7695	0.0	1.4142949967511371
chr22	GUSBP11	23717030	23717106	0	77	10883	7702	10883	7625	0.0	1.42727868852459
chr22	GUSBP11	23717030	23717084	0	55	10883	7702	10883	7647	0.0	1.4231724859421995
chr22	GUSBP11	23690231	23690234	0	4	10883	7702	10883	7698	0.0	1.413743829566121
chr22	GUSBP11	23717085	23717106	0	22	10883	7702	10883	7680	0.0	1.4170572916666666
chr22	GUSBP11	23686789	23686829	0	41	10883	7702	10883	7661	0.0	1.4205717269285993
chr22	GUSBP11	23686789	23686836	0	48	10883	7702	10883	7654	0.0	1.4218709171674941
chr22	GSTT2B	23958284	23958325	0	42	0	1113	0	1071	0.0	0.0
chr22	PIWIL3	24762306	24762396	102	91	2033	3826	1931	3735	1.120879120879121	0.5170013386880856
chr22	LRP5L	25359826	25359914	0	89	204	3674	204	3585	0.0	0.05690376569037657
chr22	AL022329.1	25564089	25564355	0	267	0	1300	0	1033	0.0	0.0
chr22	MYO18B-AS1	25895110	25895336	0	227	4763	5997	4763	5770	0.0	0.825476603119584
chr22	MYO18B-AS1	25900269	25900363	0	95	4763	5997	4763	5902	0.0	0.8070145713317519
chr22	MYO18B-AS1	25895097	25895109	0	13	4763	5997	4763	5984	0.0	0.7959558823529411
chr22	MYO18B-AS1	25895097	25895336	0	240	4763	5997	4763	5757	0.0	0.827340628799722
chr22	MYO18B-AS1	25900678	25900823	0	146	4763	5997	4763	5851	0.0	0.8140488805332422
chr22	AL022337.1	26162748	26163143	0	396	0	2023	0	1627	0.0	0.0
chr22	HPS4	26483673	26483763	0	91	0	7752	0	7661	0.0	0.0
chr22	HPS4	26483673	26483743	0	71	0	7752	0	7681	0.0	0.0
chr22	HPS4	26483744	26483763	0	20	0	7752	0	7732	0.0	0.0
chr22	PITPNB	27919101	27919170	0	70	0	5142	0	5072	0.0	0.0
chr22	CHEK2	28741768	28741780	0	13	190	4425	190	4412	0.0	0.04306436990027199
chr22	CHEK2	28730419	28730454	0	36	190	4425	190	4389	0.0	0.04329004329004329
chr22	CHEK2	28724564	28724884	0	321	190	4425	190	4104	0.0	0.046296296296296294
chr22	XBP1	28799041	28799055	0	15	102	3034	102	3019	0.0	0.03378602186154356
chr22	THOC5	29528936	29529160	0	225	2188	7903	2188	7678	0.0	0.2849700442823652
chr22	THOC5	29543414	29543427	0	14	2188	7903	2188	7889	0.0	0.27734820636329066
chr22	THOC5	29553447	29553669	0	223	2188	7903	2188	7680	0.0	0.28489583333333335
chr22	ZMAT5	29766871	29766947	0	77	163031	3206	163031	3129	0.0	52.10322786832854
chr22	ASCC2	29801993	29802113	0	121	15791	5178	15791	5057	0.0	3.1226023333992488
chr22	ASCC2	29801993	29802060	0	68	15791	5178	15791	5110	0.0	3.090215264187867
chr22	CASTOR1	30289292	30289383	0	92	51	2662	51	2570	0.0	0.019844357976653695
chr22	CASTOR1	30289292	30289295	0	4	51	2662	51	2658	0.0	0.019187358916478554
chr22	CASTOR1	30289296	30289383	0	88	51	2662	51	2574	0.0	0.019813519813519812
chr22	RNF215	30379481	30379546	0	66	32997	5055	32997	4989	0.0	6.613950691521347
chr22	RNF215	30379481	30379709	0	229	32997	5055	32997	4826	0.0	6.8373394115209285
chr22	GAL3ST1	30564824	30565075	0	252	0	3105	0	2853	0.0	0.0
chr22	GAL3ST1	30558259	30558277	0	19	0	3105	0	3086	0.0	0.0
chr22	GAL3ST1	30572686	30572801	0	116	0	3105	0	2989	0.0	0.0
chr22	PES1	30584364	30584414	0	51	3901	3945	3901	3894	0.0	1.0017976373908577
chr22	PES1	30605413	30605459	0	47	3901	3945	3901	3898	0.0	1.0007696254489482
chr22	PES1	30591793	30591808	0	16	3901	3945	3901	3929	0.0	0.9928735047085773
chr22	DUSP18	30666806	30667460	0	655	510	2739	510	2084	0.0	0.24472168905950095
chr22	MORC2	30928018	30928026	0	9	8963	8653	8963	8644	0.0	1.0369042110134197
chr22	EIF4ENIF1	31454143	31454178	0	36	496	5677	496	5641	0.0	0.0879276723985109
chr22	PRR14L	31749992	31750070	0	79	14612	11816	14612	11737	0.0	1.2449518616341484
chr22	C22ORF24	31927093	31927097	410	5	6484	5555	6074	5550	82.0	1.0944144144144143
chr22	C22ORF24	31937915	31937987	0	73	6484	5555	6484	5482	0.0	1.182780007296607
chr22	LARGE1	33922476	33922619	0	144	635	14082	635	13938	0.0	0.045558903716458606
chr22	MB	35617076	35617161	0	86	0	2060	0	1974	0.0	0.0
chr22	APOL4	36201699	36201991	0	293	1440	4268	1440	3975	0.0	0.3622641509433962
chr22	APOL4	36195094	36195309	0	216	1440	4268	1440	4052	0.0	0.35538005923000987
chr22	FOXRED2	36506911	36507007	0	97	255	5528	255	5431	0.0	0.04695267906462898
chr22	EIF3D	36528791	36528878	0	88	51	3779	51	3691	0.0	0.013817393660254673
chr22	EIF3D	36528879	36529074	0	196	51	3779	51	3583	0.0	0.014233882221602009
chr22	EIF3D	36528742	36528790	0	49	51	3779	51	3730	0.0	0.013672922252010724
chr22	EIF3D	36528742	36528878	0	137	51	3779	51	3642	0.0	0.01400329489291598
chr22	TEX33	37001836	37002191	0	356	0	810	0	454	0.0	0.0
chr22	IL2RB	37174957	37174992	0	36	51	4633	51	4597	0.0	0.0110941918642593
chr22	RAC2	37244113	37244133	0	21	0	2531	0	2510	0.0	0.0
chr22	RAC2	37244134	37244288	0	155	0	2531	0	2376	0.0	0.0
chr22	MFNG	37485915	37485921	0	7	0	3033	0	3026	0.0	0.0
chr22	ANKRD54	37832957	37833157	0	201	0	4400	0	4199	0.0	0.0
chr22	C22ORF23	37953447	37953532	0	86	0	2290	0	2204	0.0	0.0
chr22	C22ORF23	37953348	37953446	0	99	0	2290	0	2191	0.0	0.0
chr22	C22ORF23	37953348	37953532	0	185	0	2290	0	2105	0.0	0.0
chr22	SOX10	37984198	37984337	0	140	2449	3734	2449	3594	0.0	0.6814134668892599
chr22	PLA2G6	38143104	38143112	0	9	23420	8089	23420	8080	0.0	2.8985148514851486
chr22	PLA2G6	38181663	38181782	0	120	23420	8089	23420	7969	0.0	2.938888191743004
chr22	PLA2G6	38145437	38145561	0	125	23420	8089	23420	7964	0.0	2.940733299849322
chr22	TMEM184B	38246784	38246804	70	21	57550	6174	57480	6153	3.3333333333333335	9.341784495368113
chr22	DDX17	38487872	38487877	0	6	43114	8894	43114	8888	0.0	4.850810081008101
chr22	DMC1	38570042	38570052	0	11	2856	3448	2856	3437	0.0	0.8309572301425662
chr22	FAM227A	38591360	38591433	0	74	3223	3270	3223	3196	0.0	1.0084480600750938
chr22	RPL3	39319389	39319593	0	205	1351	4693	1351	4488	0.0	0.30102495543672014
chr22	RPL3	39319389	39319497	0	109	1351	4693	1351	4584	0.0	0.29472076788830714
chr22	MRTFA	40416975	40416984	0	10	409	7572	409	7562	0.0	0.05408622057656705
chr22	MRTFA	40463220	40463241	0	22	409	7572	409	7550	0.0	0.05417218543046358
chr22	SLC25A17	40797253	40797282	30	30	1668	3372	1638	3342	1.0	0.49012567324955114
chr22	L3MBTL2-AS1	41213629	41213794	503	166	14834	4463	14331	4297	3.0301204819277108	3.3351175238538517
chr22	RANGAP1	41285362	41285542	573	181	28379	5891	27806	5710	3.165745856353591	4.869702276707531
chr22	TOB2	41446374	41446377	0	4	468	4343	468	4339	0.0	0.1078589536759622
chr22	POLR3H	41532603	41532657	0	55	34149	6368	34149	6313	0.0	5.409314113733566
chr22	POLR3H	41543751	41543989	13983	239	34149	6368	20166	6129	58.50627615062761	3.290259422418013
chr22	SNU13	41688078	41688150	0	73	24858	2935	24858	2862	0.0	8.685534591194969
chr22	SNU13	41687721	41688077	44	357	24858	2935	24814	2578	0.12324929971988796	9.625290923196276
chr22	SNU13	41687721	41688150	44	430	24858	2935	24814	2505	0.10232558139534884	9.905788423153693
chr22	CYP2D7	42141533	42141623	0	91	68	3408	68	3317	0.0	0.020500452215857702
chr22	LINC01315	42368714	42369056	0	343	0	1327	0	984	0.0	0.0
chr22	CYB5R3	42646640	42646884	0	245	585	5573	585	5328	0.0	0.1097972972972973
chr22	A4GALT	42695490	42695573	0	84	626	3364	626	3280	0.0	0.19085365853658537
chr22	PACSIN2	42959762	42959797	79	36	97188	4388	97109	4352	2.1944444444444446	22.313648897058822
chr22	PACSIN2	42959571	42959797	907	227	97188	4388	96281	4161	3.995594713656388	23.13890891612593
chr22	PACSIN2	42959571	42959761	828	191	97188	4388	96360	4197	4.335078534031414	22.95925661186562
chr22	TTLL1	43069603	43069634	0	32	1369	1880	1369	1848	0.0	0.7408008658008658
chr22	WNT7B	45975544	45975688	0	145	43225	4942	43225	4797	0.0	9.010840108401084
chr22	LINC00899	46043939	46044607	0	669	0	3069	0	2400	0.0	0.0
chr22	CDPF1	46247109	46247123	0	15	1836	1642	1836	1627	0.0	1.128457283343577
chr22	CDPF1	46247105	46247108	0	4	1836	1642	1836	1638	0.0	1.120879120879121
chr22	LINC00898	47627308	47627436	0	129	1187	4992	1187	4863	0.0	0.2440880115155254
chr22	Z84468.2	48489063	48489158	0	96	0	2513	0	2417	0.0	0.0
chr22	Z84468.1	48547193	48547221	0	29	0	2253	0	2224	0.0	0.0
chr22	C22ORF34	49624369	49624445	0	77	663	6782	663	6705	0.0	0.09888143176733781
chr22	TTLL8	50034344	50034355	0	12	0	2723	0	2711	0.0	0.0
chr22	TUBGCP6	50220191	50221273	2182	1083	26004	7417	23822	6334	2.0147737765466296	3.760972529207452
chr22	TUBGCP6	50220191	50220249	0	59	26004	7417	26004	7358	0.0	3.5341125305789616
chr22	TUBGCP6	50240203	50240223	0	21	26004	7417	26004	7396	0.0	3.5159545700378585
chr22	TUBGCP6	50220250	50221273	2182	1024	26004	7417	23822	6393	2.130859375	3.726263100265916
chr22	HDAC10	50250973	50251100	32	128	5467	4150	5435	4022	0.25	1.351317752362009
chr22	MAPK11	50267252	50267255	0	4	3398	2698	3398	2694	0.0	1.2613214550853749
chr22	PLXNB2	50294718	50294724	49	7	309508	7083	309459	7076	7.0	43.73360655737705
chr22	SCO2	50525441	50525470	0	30	0	1355	0	1325	0.0	0.0
chr22	CPT1B	50577323	50577354	0	32	0	4122	0	4090	0.0	0.0
chr22	CPT1B	50569166	50569334	0	169	0	4122	0	3953	0.0	0.0
chr22	CHKB	50579973	50580055	0	83	0	2709	0	2626	0.0	0.0
chr22	ARSA	50627555	50627944	1810	390	9992	3989	8182	3599	4.641025641025641	2.2734092803556543
chr22	ARSA	50627945	50627989	191	45	9992	3989	9801	3944	4.2444444444444445	2.4850405679513186
chr22	ARSA	50627897	50627944	38	48	9992	3989	9954	3941	0.7916666666666666	2.5257548845470694
chr22	ARSA	50627897	50627989	229	93	9992	3989	9763	3896	2.4623655913978495	2.5059034907597537
chr22	RABL2B	50783038	50783043	0	6	1955	5879	1955	5873	0.0	0.3328792780521028
chr22	RABL2B	50769424	50769453	0	30	1955	5879	1955	5849	0.0	0.3342451701145495
chr22	RABL2B	50782890	50783037	0	148	1955	5879	1955	5731	0.0	0.34112720293142557
chr22	LINC01664	17122040	17122344	0	305	0	1936	0	1631	0.0	0.0
chr22	HDHD5-AS1	17159552	17159837	0	286	0	633	0	347	0.0	0.0
chr22	BCL2L13	17638701	17638886	4444	186	13098	7270	8654	7084	23.892473118279568	1.2216261998870694
chr22	TUBA8	18110840	18110868	0	29	10761	3649	10761	3620	0.0	2.9726519337016573
chr22	DGCR6	18906468	18906484	0	17	51	5168	51	5151	0.0	0.009900990099009901
chr22	AC007326.5	18939750	18939757	0	8	0	1442	0	1434	0.0	0.0
chr22	SEPTIN5	19718572	19718818	0	247	0	4211	0	3964	0.0	0.0
chr22	TANGO2	20061682	20061683	5	2	31465	4941	31460	4939	2.5	6.369710467706013
chr22	TANGO2	20036855	20037094	0	240	31465	4941	31465	4701	0.0	6.693256753882153
chr22	TANGO2	20021135	20021246	0	112	31465	4941	31465	4829	0.0	6.515841789190309
chr22	TANGO2	20021247	20021298	114	52	31465	4941	31351	4889	2.1923076923076925	6.4125588054816935
chr22	DGCR8	20106686	20106698	0	13	257398	7302	257398	7289	0.0	35.31321168884621
chr22	RANBP1	20116396	20116430	28	35	79693	4188	79665	4153	0.8	19.182518661208764
chr22	RANBP1	20117913	20118131	0	219	79693	4188	79693	3969	0.0	20.07886117409927
chr22	RANBP1	20118017	20118131	0	115	79693	4188	79693	4073	0.0	19.566167444144366
chr22	RANBP1	20118132	20118313	0	182	79693	4188	79693	4006	0.0	19.893409885172243
chr22	RANBP1	20118017	20118313	0	297	79693	4188	79693	3891	0.0	20.48136725777435
chr22	ZNF74	20394335	20394662	5952	328	11725	5230	5773	4902	18.146341463414632	1.1776825785393716
chr22	MED15	20507736	20507746	0	11	51	8263	51	8252	0.0	0.006180319922443044
chr22	MED15	20537205	20537215	0	11	51	8263	51	8252	0.0	0.006180319922443044
chr22	MED15	20551167	20551347	0	181	51	8263	51	8082	0.0	0.006310319227913883
chr22	TMEM191A	20703693	20703751	0	59	0	2582	0	2523	0.0	0.0
chr22	TMEM191A	20704041	20704056	0	16	0	2582	0	2566	0.0	0.0
chr22	LZTR1	20992898	20992904	0	7	204	6931	204	6924	0.0	0.029462738301559793
chr22	LZTR1	20982572	20982576	0	5	204	6931	204	6926	0.0	0.029454230436038117
chr22	LZTR1	20983090	20983122	0	33	204	6931	204	6898	0.0	0.029573789504204116
chr22	LZTR1	20990526	20990969	0	444	204	6931	204	6487	0.0	0.03144751040542624
chr22	P2RX6	21015261	21015338	0	78	0	4616	0	4538	0.0	0.0
chr22	P2RX6	21015334	21015338	0	5	0	4616	0	4611	0.0	0.0
chr22	P2RX6	21015261	21015333	0	73	0	4616	0	4543	0.0	0.0
chr22	BCRP2	21116002	21116068	0	67	4567	2960	4567	2893	0.0	1.5786380919460767
chr22	FAM230B	21170498	21170605	0	108	9475	6180	9475	6072	0.0	1.560441370223979
chr22	TMEM191C	21469004	21469062	0	59	714	4210	714	4151	0.0	0.17200674536256325
chr22	AC245060.7	22307246	22307285	0	40	10797	2909	10797	2869	0.0	3.7633321714883237
chr22	GGTLC2	22644709	22644814	255	106	2815	1402	2560	1296	2.4056603773584904	1.9753086419753085
chr22	RGL4	23688852	23688902	0	51	0	4727	0	4676	0.0	0.0
chr22	RGL4	23690948	23692209	0	1262	0	4727	0	3465	0.0	0.0
chr22	C22ORF15	23764398	23764402	0	5	0	1345	0	1340	0.0	0.0
chr22	C22ORF15	23764398	23764412	0	15	0	1345	0	1330	0.0	0.0
chr22	C22ORF15	23764403	23764412	0	10	0	1345	0	1335	0.0	0.0
chr22	MMP11	23771300	23771307	0	8	0	4173	0	4165	0.0	0.0
chr22	MMP11	23779369	23779416	0	48	0	4173	0	4125	0.0	0.0
chr22	MMP11	23779417	23779464	0	48	0	4173	0	4125	0.0	0.0
chr22	MMP11	23779369	23779464	0	96	0	4173	0	4077	0.0	0.0
chr22	SMARCB1	23800971	23801081	0	111	969	12335	969	12224	0.0	0.07927028795811518
chr22	SMARCB1	23801082	23801135	0	54	969	12335	969	12281	0.0	0.07890236951388323
chr22	SMARCB1	23800971	23801135	0	165	969	12335	969	12170	0.0	0.07962202136400987
chr22	SMARCB1	23791868	23791894	0	27	969	12335	969	12308	0.0	0.0787292817679558
chr22	SMARCB1	23801082	23801964	0	883	969	12335	969	11452	0.0	0.08461404121550821
chr22	SMARCB1	23801136	23801964	0	829	969	12335	969	11506	0.0	0.08421693029723623
chr22	SMARCB1	23800971	23801964	0	994	969	12335	969	11341	0.0	0.08544220086412133
chr22	SLC2A11	23858030	23858156	0	127	1701	8383	1701	8256	0.0	0.20603197674418605
chr22	GSTT2	23983003	23983044	19	42	7727	1189	7708	1147	0.4523809523809524	6.720139494333043
chr22	CABIN1	24098106	24098192	0	87	119528	9431	119528	9344	0.0	12.791952054794521
chr22	SPECC1L	24321324	24322918	9373	1595	15373	7480	6000	5885	5.876489028213166	1.0195412064570943
chr22	ADORA2A	24427727	24427746	0	20	1654	4202	1654	4182	0.0	0.39550454328072693
chr22	AP000356.5	24568038	24568176	2086	139	4819	3165	2733	3026	15.007194244604317	0.903172504957039
chr22	GGT1	24603336	24603527	0	192	580	4343	580	4151	0.0	0.13972536738135388
chr22	GGT1	24603322	24603527	0	206	580	4343	580	4137	0.0	0.14019821126420112
chr22	GGT1	24603322	24603335	0	14	580	4343	580	4329	0.0	0.13398013398013398
chr22	BCRP3	24647076	24647142	0	67	196	1751	196	1684	0.0	0.1163895486935867
chr22	MIAT	26647312	26647340	0	29	0	13610	0	13581	0.0	0.0
chr22	MIAT	26663399	26663509	0	111	0	13610	0	13499	0.0	0.0
chr22	LINC01422	26860764	26861022	6105	259	182976	9911	176871	9652	23.571428571428573	18.3248031496063
chr22	TTC28-AS1	27997740	27998838	0	1099	153	11188	153	10089	0.0	0.015165031222123104
chr22	TTC28-AS1	27997740	27998152	0	413	153	11188	153	10775	0.0	0.01419953596287703
chr22	TTC28-AS1	27919546	27919966	0	421	153	11188	153	10767	0.0	0.014210086375034828
chr22	TTC28-AS1	27922179	27922227	0	49	153	11188	153	11139	0.0	0.013735523835173714
chr22	HSCB	28743924	28743978	0	55	0	1462	0	1407	0.0	0.0
chr22	HSCB	28744705	28744709	0	5	0	1462	0	1457	0.0	0.0
chr22	CCDC117	28773035	28773223	0	189	153	4332	153	4143	0.0	0.036929761042722664
chr22	KREMEN1	29073222	29073227	0	6	58659	7935	58659	7929	0.0	7.398032538781687
chr22	KREMEN1	29138783	29138833	23	51	58659	7935	58636	7884	0.45098039215686275	7.437341451040081
chr22	EWSR1	29299281	29299331	0	51	1411	6389	1411	6338	0.0	0.2226254338908173
chr22	GAS2L1	29306770	29307153	102	384	1836	4005	1734	3621	0.265625	0.4788732394366197
chr22	GAS2L1	29307154	29307186	0	33	1836	4005	1836	3972	0.0	0.4622356495468278
chr22	NF2	29683065	29683079	14047	15	251405	5395	237358	5380	936.4666666666667	44.118587360594795
chr22	UQCR10	29767549	29767607	0	59	51	977	51	918	0.0	0.05555555555555555
chr22	TCN2	30612962	30613042	0	81	2086	2960	2086	2879	0.0	0.7245571378951025
chr22	MORC2-AS1	30923423	30923451	0	29	51	2729	51	2700	0.0	0.01888888888888889
chr22	TUG1	30969387	30971779	0	2393	650727	6606	650727	4213	0.0	154.45691906005223
chr22	TUG1	30971611	30971779	0	169	650727	6606	650727	6437	0.0	101.09165760447414
chr22	TUG1	30971770	30971779	0	10	650727	6606	650727	6596	0.0	98.6547907822923
chr22	SMTN	31100954	31101049	0	96	2377	7949	2377	7853	0.0	0.3026868712593913
chr22	INPP5J	31124907	31126010	0	1104	0	4440	0	3336	0.0	0.0
chr22	RNF185	31196991	31197157	0	167	714	3456	714	3289	0.0	0.21708726056552144
chr22	RNF185	31196991	31197158	0	168	714	3456	714	3288	0.0	0.21715328467153286
chr22	RNF185	31197158	31197158	0	1	714	3456	714	3455	0.0	0.20665701881331403
chr22	DEPDC5	31797700	31797703	0	4	175219	17819	175219	17815	0.0	9.835475722705585
chr22	DEPDC5	31753997	31754164	0	168	175219	17819	175219	17651	0.0	9.926859668007479
chr22	DEPDC5	31906067	31906094	0	28	175219	17819	175219	17791	0.0	9.84874374683829
chr22	DEPDC5	31810642	31810665	0	24	175219	17819	175219	17795	0.0	9.846529924135993
chr22	DEPDC5	31784876	31785107	0	232	175219	17819	175219	17587	0.0	9.962984022289191
chr22	LARGE-AS1	33727589	33727632	22	44	666	2871	644	2827	0.5	0.22780332507958967
chr22	LARGE-AS1	33725656	33725756	0	101	666	2871	666	2770	0.0	0.2404332129963899
chr22	LARGE-AS1	33732650	33733685	632	1036	666	2871	34	1835	0.61003861003861	0.018528610354223433
chr22	LINC01643	34206164	34206194	0	31	0	3786	0	3755	0.0	0.0
chr22	LINC01643	34213920	34213970	0	51	0	3786	0	3735	0.0	0.0
chr22	LINC01643	34107990	34107993	0	4	0	3786	0	3782	0.0	0.0
chr22	TOM1	35322020	35322037	0	18	0	5019	0	5001	0.0	0.0
chr22	TOM1	35346970	35346972	0	3	0	5019	0	5016	0.0	0.0
chr22	TOM1	35299379	35299494	0	116	0	5019	0	4903	0.0	0.0
chr22	HMOX1	35381197	35381329	0	133	0	2254	0	2121	0.0	0.0
chr22	APOL1	36259857	36259918	0	62	803	2686	803	2624	0.0	0.30602134146341464
chr22	NCF4	36875784	36875787	0	4	67941	2252	67941	2248	0.0	30.222864768683273
chr22	MPST	37019775	37019872	0	98	0	2486	0	2388	0.0	0.0
chr22	GGA1	37616998	37617048	0	51	162	9038	162	8987	0.0	0.01802603760988094
chr22	GGA1	37608984	37609154	0	171	162	9038	162	8867	0.0	0.01826998985000564
chr22	GGA1	37609155	37609356	0	202	162	9038	162	8836	0.0	0.01833408782254414
chr22	TRIOBP	37751517	37751690	0	174	8168	12205	8168	12031	0.0	0.6789128085778405
chr22	EIF3L	37851491	37851561	0	71	42659	4164	42659	4093	0.0	10.422428536525775
chr22	EIF3L	37849483	37850063	0	581	42659	4164	42659	3583	0.0	11.905944739045493
chr22	MICALL1	37927821	37927826	0	6	16455	5852	16455	5846	0.0	2.814745124871707
chr22	MICALL1	37937793	37937819	0	27	16455	5852	16455	5825	0.0	2.824892703862661
chr22	POLR2F	37956843	37956901	0	59	58086	6258	58086	6199	0.0	9.370221003387643
chr22	POLR2F	37953808	37953860	0	53	58086	6258	58086	6205	0.0	9.36116035455278
chr22	PICK1	38057437	38057489	467	53	1776492	4356	1776025	4303	8.81132075471698	412.7411108528933
chr22	PICK1	38057437	38057587	886	151	1776492	4356	1775606	4205	5.867549668874172	422.2606420927467
chr22	PICK1	38057490	38057587	419	98	1776492	4356	1776073	4258	4.275510204081633	417.11437294504464
chr22	MAFF	38202213	38202238	34778	26	1067074	3894	1032296	3868	1337.6153846153845	266.8810754912099
chr22	GTPBP1	38706782	38706856	12	75	4962	8041	4950	7966	0.16	0.6213909113733367
chr22	APOBEC3G	39077169	39077378	306	210	649209	4135	648903	3925	1.457142857142857	165.3256050955414
chr22	SYNGR1	39374554	39374660	0	107	229147	5655	229147	5548	0.0	41.30263157894737
chr22	ADSL	40363072	40363092	0	21	1168	7463	1168	7442	0.0	0.1569470572426767
chr22	ADSL	40361636	40361677	0	42	1168	7463	1168	7421	0.0	0.15739118717154021
chr22	ADSL	40361667	40361677	0	11	1168	7463	1168	7452	0.0	0.15673644659151906
chr22	ADSL	40361636	40361666	0	31	1168	7463	1168	7432	0.0	0.15715823466092574
chr22	MCHR1	40679405	40679734	0	330	3720	2441	3720	2111	0.0	1.762198010421601
chr22	ACO2	41515918	41515992	357	75	52146	9940	51789	9865	4.76	5.24977192093259
chr22	MEI1	41795453	41795542	0	90	46658	6712	46658	6622	0.0	7.045907580791302
chr22	SMDT1	42079906	42079954	0	49	3490	1734	3490	1685	0.0	2.0712166172106823
chr22	SERHL	42510725	42511927	102	1203	409	2853	307	1650	0.08478802992518704	0.18606060606060607
chr22	SERHL2	42571204	42571901	51	698	8009	2806	7958	2108	0.07306590257879657	3.775142314990512
chr22	TSPO	43152128	43152220	0	93	47	1395	47	1302	0.0	0.03609831029185868
chr22	PNPLA3	43924087	43924098	0	12	0	3195	0	3183	0.0	0.0
chr22	LINC00207	44570589	44570624	0	36	0	1410	0	1374	0.0	0.0
chr22	NUP50	45171144	45171152	0	9	339	6581	339	6572	0.0	0.05158247108947048
chr22	NUP50	45171144	45171177	0	34	339	6581	339	6547	0.0	0.05177944096532763
chr22	NUP50	45171153	45171177	0	25	339	6581	339	6556	0.0	0.05170835875533862
chr22	NUP50	45164729	45164758	0	30	339	6581	339	6551	0.0	0.05174782475957869
chr22	NUP50	45164759	45164955	51	197	339	6581	288	6384	0.25888324873096447	0.045112781954887216
chr22	NUP50	45164729	45164955	51	227	339	6581	288	6354	0.22466960352422907	0.0453257790368272
chr22	FAM118A	45309347	45309650	0	304	0	5330	0	5026	0.0	0.0
chr22	FBLN1	45503065	45503490	0	426	52811	7040	52811	6614	0.0	7.98472936195948
chr22	GRAMD4	46626917	46626961	0	45	9727	4923	9727	4878	0.0	1.9940549405494055
chr22	TBC1D22A	46792763	46792804	0	42	6870	5336	6870	5294	0.0	1.297695504344541
chr22	AL117329.1	47631866	47631886	0	21	102	31762	102	31741	0.0	0.0032135093412305853
chr22	AL117329.1	47631776	47631886	0	111	102	31762	102	31651	0.0	0.003222646993775868
chr22	AL117329.1	47635354	47635355	0	2	102	31762	102	31760	0.0	0.003211586901763224
chr22	AL117329.1	47631776	47631865	0	90	102	31762	102	31672	0.0	0.003220510229856024
chr22	AL117329.1	47631887	47632086	0	200	102	31762	102	31562	0.0	0.0032317343641087384
chr22	AL117329.1	47631866	47632086	0	221	102	31762	102	31541	0.0	0.003233886053073777
chr22	AL117329.1	47631776	47632086	0	311	102	31762	102	31451	0.0	0.0032431401227305968
chr22	MOV10L1	50090186	50091462	0	1277	220	6832	220	5555	0.0	0.039603960396039604
chr22	MOV10L1	50090513	50091462	0	950	220	6832	220	5882	0.0	0.03740224413464808
chr22	MOV10L1	50090398	50091462	0	1065	220	6832	220	5767	0.0	0.038148083925784636
chr22	MOV10L1	50090186	50090512	0	327	220	6832	220	6505	0.0	0.033820138355111454
chr22	MOV10L1	50090398	50090512	0	115	220	6832	220	6717	0.0	0.03275271698675004
chr22	TRABD	50185977	50186001	255	25	20835	2486	20580	2461	10.2	8.362454286875254
chr22	MIOX	50489631	50489644	0	14	0	1806	0	1792	0.0	0.0
chr22	NCAPH2	50508429	50508445	0	17	51	4166	51	4149	0.0	0.012292118582791034
chr22	CHKB-DT	50583324	50583400	0	77	51	4099	51	4022	0.0	0.01268025857782198
chr22	CHKB-DT	50585683	50585955	0	273	51	4099	51	3826	0.0	0.013329848405645583
chr22	RPL23AP82	50783865	50784072	30	208	885	4161	855	3953	0.14423076923076922	0.21629142423475842
chr22	RPL23AP82	50784022	50784072	30	51	885	4161	855	4110	0.5882352941176471	0.20802919708029197
chr22	RPL23AP82	50783865	50784021	0	157	885	4161	885	4004	0.0	0.22102897102897104
chrX	PLCXD1	283489	283520	10	32	56871	6077	56861	6045	0.3125	9.406286186931348
chrX	CSF2RA	1274819	1274842	0	24	0	3562	0	3538	0.0	0.0
chrX	TBL1X	9534961	9535034	0	74	1816	9022	1816	8948	0.0	0.20295037997317836
chrX	HCCS	11111424	11111460	0	37	217	2309	217	2272	0.0	0.09551056338028169
chrX	HCCS	11111461	11111518	0	58	217	2309	217	2251	0.0	0.0964015992892048
chrX	HCCS	11111424	11111518	0	95	217	2309	217	2214	0.0	0.0980126467931346
chrX	MSL3	11758689	11758773	0	85	0	7299	0	7214	0.0	0.0
chrX	MSL3	11759713	11759875	0	163	0	7299	0	7136	0.0	0.0
chrX	MSL3	11760340	11760498	0	159	0	7299	0	7140	0.0	0.0
chrX	MSL3	11767047	11767052	0	6	0	7299	0	7293	0.0	0.0
chrX	MSL3	11767170	11767286	0	117	0	7299	0	7182	0.0	0.0
chrX	PRPS2	12799391	12799399	0	9	5552	2703	5552	2694	0.0	2.060876020786934
chrX	CDKL5	18442391	18442423	0	33	4711	18806	4711	18773	0.0	0.2509455068449369
chrX	CNKSR2	21374919	21374961	0	43	10190	24430	10190	24387	0.0	0.4178455734612703
chrX	PDK3	24534069	24534656	204	588	47338	13518	47134	12930	0.3469387755102041	3.645320959010054
chrX	POLA1	24693987	24694004	0	18	14328	14745	14328	14727	0.0	0.9729069056834386
chrX	AL591501.1	34339016	34339033	0	18	102	14454	102	14436	0.0	0.007065669160432253
chrX	MAGEB16	35798419	35798554	0	136	0	1991	0	1855	0.0	0.0
chrX	PRRG1	37349396	37349469	51	74	204	6149	153	6075	0.6891891891891891	0.025185185185185185
chrX	MID1IP1	38801488	38804413	0	2926	0	4839	0	1913	0.0	0.0
chrX	ATP6AP2	40581072	40581102	104	31	12402	6093	12298	6062	3.3548387096774195	2.02870339821841
chrX	USP9X	41229780	41229827	0	48	24584	14198	24584	14150	0.0	1.7373851590106006
chrX	DDX3X	41333700	41333783	0	84	1939	11657	1939	11573	0.0	0.167545148189752
chrX	DDX3X	41333784	41334297	0	514	1939	11657	1939	11143	0.0	0.17401058960782553
chrX	DDX3X	41333700	41334297	0	598	1939	11657	1939	11059	0.0	0.17533230852699158
chrX	DDX3X	41357940	41358000	0	61	1939	11657	1939	11596	0.0	0.1672128320110383
chrX	DDX3X	41357991	41358000	0	10	1939	11657	1939	11647	0.0	0.166480638791105
chrX	DDX3X	41357940	41357990	0	51	1939	11657	1939	11606	0.0	0.16706875753920386
chrX	DDX3X	41347452	41347454	0	3	1939	11657	1939	11654	0.0	0.16638064183971168
chrX	DDX3X	41344400	41344564	0	165	1939	11657	1939	11492	0.0	0.1687260703097807
chrX	DDX3X	41334770	41334815	0	46	1939	11657	1939	11611	0.0	0.16699681336663508
chrX	KDM6A	45106650	45106713	0	64	51	19804	51	19740	0.0	0.0025835866261398176
chrX	KDM6A	45090833	45090864	0	32	51	19804	51	19772	0.0	0.0025794052195023264
chrX	KRBOX4	46463294	46463308	1662	15	52499	3691	50837	3676	110.8	13.82943416757345
chrX	RBM10	47180038	47180040	0	3	0	3562	0	3559	0.0	0.0
chrX	RBM10	47145486	47145516	0	31	0	3562	0	3531	0.0	0.0
chrX	CDK16	47218050	47218224	0	175	29	5750	29	5575	0.0	0.005201793721973094
chrX	CDK16	47224477	47224518	0	42	29	5750	29	5708	0.0	0.005080588647512264
chrX	CDK16	47222343	47222380	0	38	29	5750	29	5712	0.0	0.00507703081232493
chrX	CXXC1P1	47724335	47724336	0	2	411	2703	411	2701	0.0	0.15216586449463163
chrX	ZNF81	47836988	47837007	78	20	15364	11822	15286	11802	3.9	1.2952042026775124
chrX	FTSJ1	48478681	48478707	0	27	1683	2878	1683	2851	0.0	0.5903191862504384
chrX	RBM3	48575631	48575667	0	37	1123	5201	1123	5164	0.0	0.21746707978311386
chrX	WDR13	48600627	48600656	0	30	1581	7435	1581	7405	0.0	0.21350438892640108
chrX	HDAC6	48801432	48801751	31859	320	133522	7947	101663	7627	99.559375	13.329356234430314
chrX	HDAC6	48802023	48802272	612	250	133522	7947	132910	7697	2.448	17.267766662335976
chrX	HDAC6	48802171	48802272	363	102	133522	7947	133159	7845	3.5588235294117645	16.97374123645634
chrX	HDAC6	48802143	48802272	546	130	133522	7947	132976	7817	4.2	17.011129589356532
chrX	HDAC6	48802236	48802272	0	37	133522	7947	133522	7910	0.0	16.880151706700378
chrX	HDAC6	48802143	48802170	183	28	133522	7947	133339	7919	6.535714285714286	16.83785831544387
chrX	HDAC6	48802273	48802551	1173	279	133522	7947	132349	7668	4.204301075268817	17.259911319770474
chrX	HDAC6	48802171	48802551	1536	381	133522	7947	131986	7566	4.031496062992126	17.444620671424794
chrX	HDAC6	48802143	48802551	1719	409	133522	7947	131803	7538	4.202933985330073	17.485141947466172
chrX	HDAC6	48802236	48802551	1173	316	133522	7947	132349	7631	3.712025316455696	17.34359847988468
chrX	HDAC6	48802171	48802235	363	65	133522	7947	133159	7882	5.584615384615384	16.894062420705406
chrX	HDAC6	48802143	48802235	546	93	133522	7947	132976	7854	5.870967741935484	16.9309905780494
chrX	HDAC6	48805672	48805779	0	108	133522	7947	133522	7839	0.0	17.033039928562317
chrX	PQBP1	48898083	48898093	1316	11	35001	1863	33685	1852	119.63636363636364	18.18844492440605
chrX	PQBP1	48898015	48898093	19688	79	35001	1863	15313	1784	249.21518987341773	8.583520179372197
chrX	PQBP1	48902385	48902517	5	133	35001	1863	34996	1730	0.03759398496240601	20.228901734104046
chrX	PQBP1	48898015	48898082	18372	68	35001	1863	16629	1795	270.1764705882353	9.264066852367687
chrX	PQBP1	48898351	48898576	0	226	35001	1863	35001	1637	0.0	21.3811850946854
chrX	CCDC120	49062059	49062117	0	59	842	4272	842	4213	0.0	0.1998575836695941
chrX	CCDC120	49062105	49062117	0	13	842	4272	842	4259	0.0	0.19769899037332708
chrX	CCDC120	49062290	49062325	0	36	842	4272	842	4236	0.0	0.1987724268177526
chrX	CCDC120	49059060	49059095	0	36	842	4272	842	4236	0.0	0.1987724268177526
chrX	CCDC120	49062059	49062104	0	46	842	4272	842	4226	0.0	0.1992427827733081
chrX	MAGIX	49164790	49165090	0	301	0	4936	0	4635	0.0	0.0
chrX	PPP1R3F	49269934	49270873	0	940	0	4334	0	3394	0.0	0.0
chrX	CLCN5	49923483	49923741	0	259	0	11479	0	11220	0.0	0.0
chrX	MAGED4	52191862	52191873	0	12	204	4286	204	4274	0.0	0.04773046326626111
chrX	XAGE1A	52497458	52497473	0	16	0	943	0	927	0.0	0.0
chrX	SSX2B	52751275	52751318	0	44	0	2265	0	2221	0.0	0.0
chrX	FAM156B	52897410	52898726	0	1317	204	4461	204	3144	0.0	0.0648854961832061
chrX	RIBC1	53422921	53423004	179	84	75276	2329	75097	2245	2.130952380952381	33.45077951002227
chrX	GNL3L	54540239	54540242	0	4	102437	11968	102437	11964	0.0	8.562102975593447
chrX	GNL3L	54530303	54530419	0	117	102437	11968	102437	11851	0.0	8.643743144038478
chrX	GNL3L	54539102	54539500	0	399	102437	11968	102437	11569	0.0	8.854438585876048
chrX	TRO	54928711	54931031	0	2321	0	4939	0	2618	0.0	0.0
chrX	TRO	54920879	54920888	0	10	0	4939	0	4929	0.0	0.0
chrX	TRO	54920879	54920965	0	87	0	4939	0	4852	0.0	0.0
chrX	TRO	54920889	54920965	0	77	0	4939	0	4862	0.0	0.0
chrX	PAGE2B	55076627	55076677	0	51	0	545	0	494	0.0	0.0
chrX	PAGE2	55090560	55090610	0	51	102	657	102	606	0.0	0.16831683168316833
chrX	PAGE5	55221825	55221875	0	51	0	757	0	706	0.0	0.0
chrX	PAGE5	55220453	55220651	0	199	0	757	0	558	0.0	0.0
chrX	RRAGB	55717789	55718419	0	631	3571	2726	3571	2095	0.0	1.7045346062052507
chrX	AL050309.1	55908518	55908800	0	283	357	12309	357	12026	0.0	0.029685681024447033
chrX	NBDY	56729484	56729589	0	106	408	2378	408	2272	0.0	0.1795774647887324
chrX	EDA	70033523	70033528	0	6	1089	7019	1089	7013	0.0	0.15528304577213745
chrX	ARR3	70269693	70269740	0	48	149365	1644	149365	1596	0.0	93.58709273182957
chrX	MED12	71137384	71137392	0	9	102	7470	102	7461	0.0	0.013671089666264576
chrX	GJB1	71215272	71215290	0	19	0	4661	0	4642	0.0	0.0
chrX	GJB1	71215272	71217260	0	1989	0	4661	0	2672	0.0	0.0
chrX	GJB1	71215291	71217260	0	1970	0	4661	0	2691	0.0	0.0
chrX	NONO	71294349	71294528	0	180	0	9256	0	9076	0.0	0.0
chrX	NONO	71297462	71297938	0	477	0	9256	0	8779	0.0	0.0
chrX	NONO	71290792	71290806	0	15	0	9256	0	9241	0.0	0.0
chrX	TAF1	71458358	71458366	0	9	919951	10823	919951	10814	0.0	85.0703717403366
chrX	PIN4	72181829	72181925	0	97	0	4364	0	4267	0.0	0.0
chrX	JPX	73944466	73944662	0	197	306	19827	306	19630	0.0	0.015588385124808967
chrX	JPX	73944415	73944662	0	248	306	19827	306	19579	0.0	0.01562899024464988
chrX	JPX	73944415	73944465	0	51	306	19827	306	19776	0.0	0.015473300970873786
chrX	JPX	73998845	74000496	0	1652	306	19827	306	18175	0.0	0.016836313617606603
chrX	UPRT	75300966	75301015	0	50	0	3706	0	3656	0.0	0.0
chrX	TBX22	80023237	80023240	0	4	333	2671	333	2667	0.0	0.12485939257592801
chrX	CYLC1	83861197	83861199	0	3	0	2133	0	2130	0.0	0.0
chrX	APOOL	85074112	85074112	0	1	0	6508	0	6507	0.0	0.0
chrX	AC003001.1	85212820	85212878	780	59	1197	1484	417	1425	13.220338983050848	0.2926315789473684
chrX	AC003001.1	85212873	85212878	186	6	1197	1484	1011	1478	31.0	0.6840324763193505
chrX	AC003001.1	85212820	85212872	594	53	1197	1484	603	1431	11.20754716981132	0.42138364779874216
chrX	ZNF711	85247184	85247188	0	5	1730	5056	1730	5051	0.0	0.3425064343694318
chrX	DACH2	86813005	86813034	0	30	105	2770	105	2740	0.0	0.03832116788321168
chrX	CPXCR1	88747332	88747369	0	38	0	1623	0	1585	0.0	0.0
chrX	AL157778.1	98731578	98731584	0	7	0	2649	0	2642	0.0	0.0
chrX	CSTF2	100833270	100833472	0	203	82	2791	82	2588	0.0	0.03168469860896445
chrX	ARL13A	100988385	100988558	0	174	0	1320	0	1146	0.0	0.0
chrX	CENPI	101098235	101098248	0	14	0	4333	0	4319	0.0	0.0
chrX	DRP2	101242983	101243098	0	116	159	8211	159	8095	0.0	0.019641754169240272
chrX	ARMCX4	101486093	101486098	6	6	224	13064	218	13058	1.0	0.016694746515546026
chrX	ARMCX3	101623277	101623430	0	154	51	4243	51	4089	0.0	0.012472487160674981
chrX	ARMCX5-GPRASP2	102599848	102599859	0	12	510	8165	510	8153	0.0	0.06255366122899546
chrX	GPRASP1	102651734	102651908	0	175	51	6794	51	6619	0.0	0.007705091403535277
chrX	BHLHB9	102720822	102720825	0	4	0	5486	0	5482	0.0	0.0
chrX	BHLHB9	102721028	102721091	0	64	0	5486	0	5422	0.0	0.0
chrX	LINC00630	102827137	102827144	0	8	295252	11012	295252	11004	0.0	26.831334060341693
chrX	AL117327.1	103405024	103405096	0	73	612	2682	612	2609	0.0	0.23457263319279417
chrX	TCEAL4	103585684	103585760	0	77	0	2405	0	2328	0.0	0.0
chrX	TCEAL4	103586292	103586301	0	10	0	2405	0	2395	0.0	0.0
chrX	TCEAL4	103585625	103585683	0	59	0	2405	0	2346	0.0	0.0
chrX	TCEAL3	103608059	103608070	0	12	51	2257	51	2245	0.0	0.02271714922048998
chrX	TCEAL1	103629562	103629573	0	12	0	1604	0	1592	0.0	0.0
chrX	PLP1	103786622	103786726	0	105	102	5679	102	5574	0.0	0.01829924650161464
chrX	PLP1	103776648	103776747	0	100	102	5679	102	5579	0.0	0.01828284638824162
chrX	TMSB15B	103962724	103964294	51	1571	102	8594	51	7023	0.032463399108847865	0.007261853908586074
chrX	FAM199X	104188178	104188306	0	129	408	7630	408	7501	0.0	0.05439274763364885
chrX	DNAAF6	107207423	107207426	0	4	0	1964	0	1960	0.0	0.0
chrX	PRPS1	107628483	107628750	0	268	828	3405	828	3137	0.0	0.26394644564870895
chrX	MID2	107917650	107917739	1672	90	146672	7565	145000	7475	18.57777777777778	19.39799331103679
chrX	ATG4A	108091837	108091879	0	43	0	2821	0	2778	0.0	0.0
chrX	ATG4A	108137885	108137991	0	107	0	2821	0	2714	0.0	0.0
chrX	AL035425.1	108737880	108737923	0	44	0	1925	0	1881	0.0	0.0
chrX	TMEM164	110003157	110003178	0	22	13	6593	13	6571	0.0	0.0019783898949931517
chrX	ALG13	111682236	111682294	0	59	0	8141	0	8082	0.0	0.0
chrX	ALG13	111681300	111681424	0	125	0	8141	0	8016	0.0	0.0
chrX	ALG13	111682295	111682300	0	6	0	8141	0	8135	0.0	0.0
chrX	ALG13	111682236	111682300	0	65	0	8141	0	8076	0.0	0.0
chrX	TRPC5OS	111876190	111876273	0	84	26	3034	26	2950	0.0	0.008813559322033898
chrX	HTR2C	114848109	114848203	0	95	204	4849	204	4754	0.0	0.04291123264619268
chrX	DOCK11	118683218	118683229	0	12	387106	6776	387106	6764	0.0	57.23033707865169
chrX	LINC01285	118841866	118841871	0	6	1478	5759	1478	5753	0.0	0.256909438553798
chrX	ATP1B4	120366778	120366789	0	12	51	4781	51	4769	0.0	0.010694065841895575
chrX	XIAP	123891310	123891316	0	7	152	3270	152	3263	0.0	0.046582899172540604
chrX	XIAP	123860294	123860545	0	252	152	3270	152	3018	0.0	0.05036447978793903
chrX	STAG2	123960867	123960942	0	76	0	8243	0	8167	0.0	0.0
chrX	SH2D1A	124370312	124370320	0	9	0	2825	0	2816	0.0	0.0
chrX	SH2D1A	124346758	124346779	0	22	0	2825	0	2803	0.0	0.0
chrX	BCORL1	129981753	129981783	0	31	0	8013	0	7982	0.0	0.0
chrX	SLC25A14	130340345	130340353	0	9	0	2668	0	2659	0.0	0.0
chrX	LINC00629	134549945	134550204	0	260	0	2775	0	2515	0.0	0.0
chrX	LINC00629	134550066	134550204	0	139	0	2775	0	2636	0.0	0.0
chrX	LINC00629	134550041	134550204	0	164	0	2775	0	2611	0.0	0.0
chrX	LINC00629	134549945	134550065	0	121	0	2775	0	2654	0.0	0.0
chrX	LINC00629	134550041	134550065	0	25	0	2775	0	2750	0.0	0.0
chrX	LINC00629	134550205	134550225	0	21	0	2775	0	2754	0.0	0.0
chrX	LINC00629	134550066	134550225	0	160	0	2775	0	2615	0.0	0.0
chrX	LINC00629	134550041	134550225	0	185	0	2775	0	2590	0.0	0.0
chrX	FAM122C	134796448	134796460	0	13	0	7535	0	7522	0.0	0.0
chrX	FAM122C	134839478	134839561	0	84	0	7535	0	7451	0.0	0.0
chrX	FAM122C	134839562	134839603	0	42	0	7535	0	7493	0.0	0.0
chrX	FAM122C	134839478	134839603	0	126	0	7535	0	7409	0.0	0.0
chrX	ETDA	135252805	135252823	0	19	5679	654	5679	635	0.0	8.943307086614173
chrX	INTS6L	135577296	135577427	0	132	141354	5582	141354	5450	0.0	25.93651376146789
chrX	INTS6L	135581565	135581631	359	67	141354	5582	140995	5515	5.358208955223881	25.56572982774252
chrX	SLC9A6	135994890	135994985	1648	96	38335	9929	36687	9833	17.166666666666668	3.7310078307739247
chrX	SLC9A6	135974784	135975082	0	299	38335	9929	38335	9630	0.0	3.9807892004153684
chrX	SLC9A6	135985473	135985477	0	5	38335	9929	38335	9924	0.0	3.86285771866183
chrX	FHL1	136168268	136168288	0	21	476	5097	476	5076	0.0	0.0937746256895193
chrX	FHL1	136167078	136167098	0	21	476	5097	476	5076	0.0	0.0937746256895193
chrX	FHL1	136169866	136169980	141	115	476	5097	335	4982	1.2260869565217392	0.06724207145724609
chrX	VGLL1	136548868	136549008	0	141	0	1483	0	1342	0.0	0.0
chrX	LINC00892	136640841	136640873	0	33	0	1924	0	1891	0.0	0.0
chrX	LINC00632	140711657	140716289	0	4633	2038	14900	2038	10267	0.0	0.19850004869971755
chrX	LINC00632	140713490	140716289	0	2800	2038	14900	2038	12100	0.0	0.1684297520661157
chrX	LINC00632	140772252	140772358	0	107	2038	14900	2038	14793	0.0	0.13776786317853038
chrX	AFF2	148652120	148652131	0	12	770	14265	770	14253	0.0	0.05402371430576019
chrX	AFF2	148843416	148843433	0	18	770	14265	770	14247	0.0	0.05404646592265038
chrX	AFF2	148962932	148962937	0	6	770	14265	770	14259	0.0	0.054000981836033385
chrX	EOLA1	149541293	149541343	0	51	360	4468	360	4417	0.0	0.08150328277111162
chrX	EOLA1	149541127	149541343	0	217	360	4468	360	4251	0.0	0.08468595624558928
chrX	EOLA1	149541127	149541292	0	166	360	4468	360	4302	0.0	0.08368200836820083
chrX	EOLA1	149542067	149542085	0	19	360	4468	360	4449	0.0	0.08091706001348618
chrX	LINC00894	149947348	149948175	255	828	13439	6782	13184	5954	0.3079710144927536	2.2143097077594893
chrX	MTMR1	150714530	150714532	0	3	43	4511	43	4508	0.0	0.009538598047914819
chrX	AF274573.1	150919937	150919940	0	4	0	524	0	520	0.0	0.0
chrX	PRRG3	151700157	151700301	0	145	0	5095	0	4950	0.0	0.0
chrX	MAGEA2B	152714683	152714857	1143	175	18605	2427	17462	2252	6.531428571428571	7.753996447602131
chrX	CSAG3	152759634	152759648	0	15	0	1088	0	1073	0.0	0.0
chrX	CSAG3	152759649	152759684	0	36	0	1088	0	1052	0.0	0.0
chrX	CSAG3	152759634	152759684	0	51	0	1088	0	1037	0.0	0.0
chrX	ZNF185	152959897	152959937	3494	41	301000	4837	297506	4796	85.21951219512195	62.03211009174312
chrX	ZNF185	152918155	152918171	0	17	301000	4837	301000	4820	0.0	62.448132780082986
chrX	BGN	153505351	153505401	0	51	51	1980	51	1929	0.0	0.026438569206842923
chrX	ATP2B3	153569690	153569756	0	67	11488029	7513	11488029	7446	0.0	1542.8456889605156
chrX	PLXNB3	153775969	153776214	2061	246	206129	7027	204068	6781	8.378048780487806	30.09408641793246
chrX	SRPK3	153784022	153784024	3	3	77505	4765	77502	4762	1.0	16.275094498110036
chrX	SSR4	153794335	153794585	0	251	9406	2164	9406	1913	0.0	4.916884474647151
chrX	AVPR2	153906329	153906416	0	88	510	2256	510	2168	0.0	0.235239852398524
chrX	TMEM187	153972861	153972886	0	26	0	1499	0	1473	0.0	0.0
chrX	OPN1LW	154156345	154156533	192	189	204	1248	12	1059	1.0158730158730158	0.0113314447592068
chrX	OPN1MW	154193459	154193647	0	189	0	2004	0	1815	0.0	0.0
chrX	OPN1MW2	154230599	154230787	0	189	0	1267	0	1078	0.0	0.0
chrX	TKTL1	154305087	154305124	0	38	7624	3348	7624	3310	0.0	2.303323262839879
chrX	EMD	154379538	154379566	0	29	51	1860	51	1831	0.0	0.02785363189513927
chrX	RPL10	154398395	154398398	0	4	51	4328	51	4324	0.0	0.01179463459759482
chrX	TAZ	154411953	154412006	0	54	161	3645	161	3591	0.0	0.04483430799220273
chrX	TAZ	154413253	154413358	0	106	161	3645	161	3539	0.0	0.04549307714043515
chrX	TAZ	154413340	154413358	0	19	161	3645	161	3626	0.0	0.0444015444015444
chrX	TAZ	154413353	154413358	0	6	161	3645	161	3639	0.0	0.044242923880186864
chrX	TAZ	154413253	154413339	0	87	161	3645	161	3558	0.0	0.04525014052838673
chrX	TAZ	154419624	154419746	0	123	161	3645	161	3522	0.0	0.04571266325951164
chrX	TAZ	154413253	154413352	0	100	161	3645	161	3545	0.0	0.04541607898448519
chrX	TAZ	154413340	154413352	0	13	161	3645	161	3632	0.0	0.044328193832599116
chrX	TAZ	154412866	154412987	0	122	161	3645	161	3523	0.0	0.04569968776610843
chrX	ATP6AP1	154432316	154432459	0	144	273	5136	273	4992	0.0	0.0546875
chrX	ATP6AP1	154432966	154432971	0	6	273	5136	273	5130	0.0	0.05321637426900585
chrX	ATP6AP1	154429175	154429403	0	229	273	5136	273	4907	0.0	0.05563480741797432
chrX	ATP6AP1	154429175	154431657	270	2483	273	5136	3	2653	0.10873942811115586	0.0011307953260459858
chrX	ATP6AP1	154429404	154431657	270	2254	273	5136	3	2882	0.11978704525288376	0.001040943789035392
chrX	IKBKG	154542388	154542452	0	65	0	3473	0	3408	0.0	0.0
chrX	IKBKG	154561764	154561784	0	21	0	3473	0	3452	0.0	0.0
chrX	DKC1	154768313	154768432	0	120	40999	3861	40999	3741	0.0	10.959369152632986
chrX	AC234781.5	155348891	155348965	0	75	0	434	0	359	0.0	0.0
chrX	VAMP7	155889609	155889612	0	4	0	2623	0	2619	0.0	0.0
chrX	VAMP7	155889548	155889612	0	65	0	2623	0	2558	0.0	0.0
chrX	WASH6P	156023210	156023213	0	4	0	2698	0	2694	0.0	0.0
chrX	WASH6P	156025050	156025100	0	51	0	2698	0	2647	0.0	0.0
chrX	BX890604.1	3828505	3829362	306	858	43393	13199	43087	12341	0.35664335664335667	3.491370229316911
chrX	BX890604.1	3866921	3866948	0	28	43393	13199	43393	13171	0.0	3.294586591754612
chrX	BX890604.1	3822072	3822372	3152	301	43393	13199	40241	12898	10.471760797342192	3.119941076135835
chrX	PUDP	7105619	7105747	0	129	702	3833	702	3704	0.0	0.18952483801295897
chrX	PNPLA4	7927670	7927684	0	15	51	3419	51	3404	0.0	0.014982373678025853
chrX	FAM9A	8801239	8801309	0	71	0	1600	0	1529	0.0	0.0
chrX	FAM9B	9164292	9164531	0	240	0	6904	0	6664	0.0	0.0
chrX	MID1	10566887	10567000	0	114	1156	6672	1156	6558	0.0	0.1762732540408661
chrX	ARHGAP6	11265685	11265868	0	184	38768	8912	38768	8728	0.0	4.44179651695692
chrX	FAM9C	13040479	13040756	0	278	0	5587	0	5309	0.0	0.0
chrX	TRAPPC2	13734043	13734048	24	6	43291	5668	43267	5662	4.0	7.641646061462381
chrX	GEMIN8	14026051	14026138	0	88	7091	2432	7091	2344	0.0	3.025170648464164
chrX	ASB9	15248682	15248742	0	61	1872	2338	1872	2277	0.0	0.8221343873517787
chrX	PIGA	15331215	15331588	0	374	0	5184	0	4810	0.0	0.0
chrX	PIGA	15331215	15331818	0	604	0	5184	0	4580	0.0	0.0
chrX	PIGA	15331215	15331872	0	658	0	5184	0	4526	0.0	0.0
chrX	PIGA	15331589	15331818	0	230	0	5184	0	4954	0.0	0.0
chrX	PIGA	15331589	15331872	0	284	0	5184	0	4900	0.0	0.0
chrX	PIGA	15331819	15331872	0	54	0	5184	0	5130	0.0	0.0
chrX	PIGA	15335354	15335370	0	17	0	5184	0	5167	0.0	0.0
chrX	PIR	15493155	15493188	0	34	396	2490	396	2456	0.0	0.16123778501628663
chrX	RBBP7	16870037	16870045	29	9	475093	7223	475064	7214	3.2222222222222223	65.85306348766288
chrX	ADGRG2	19037588	19037596	0	9	1025	5324	1025	5315	0.0	0.19285042333019756
chrX	BCLAF3	19937417	19937503	146	87	5486	5764	5340	5677	1.6781609195402298	0.9406376607363044
chrX	AL807742.1	21373982	21374095	0	114	0	5068	0	4954	0.0	0.0
chrX	RPGR	38287860	38287863	0	4	45	8385	45	8381	0.0	0.00536928767450185
chrX	RPGR	38287093	38287863	0	771	45	8385	45	7614	0.0	0.00591016548463357
chrX	BCOR	40052112	40052217	0	106	389	9975	389	9869	0.0	0.03941635424055122
chrX	BCOR	40097214	40097929	0	716	389	9975	389	9259	0.0	0.04201317636893833
chrX	BCOR	40053837	40053884	0	48	389	9975	389	9927	0.0	0.039186058225042814
chrX	CASK	41853096	41853113	0	18	20301	19740	20301	19722	0.0	1.0293580772741102
chrX	NDP	43958471	43958716	0	246	0	1823	0	1577	0.0	0.0
chrX	LINC01186	46327303	46327549	4723	247	42716	2534	37993	2287	19.12145748987854	16.612592916484477
chrX	ZNF674	46528334	46528348	0	15	23396	4445	23396	4430	0.0	5.281264108352144
chrX	SLC9A7	46606907	46606922	0	16	0	2435	0	2419	0.0	0.0
chrX	NDUFB11	47142583	47142612	0	30	0	955	0	925	0.0	0.0
chrX	ZNF182	48003903	48003907	0	5	1836	3605	1836	3600	0.0	0.51
chrX	ZNF630	48071266	48071464	0	199	528	3458	528	3259	0.0	0.16201288738876957
chrX	SLC38A5	48468240	48468303	0	64	213423	3938	213423	3874	0.0	55.09112028910687
chrX	TIMM17B	48897535	48897722	50	188	315920	2570	315870	2382	0.26595744680851063	132.60705289672543
chrX	SLC35A2	48904163	48904744	153	582	3300	2960	3147	2378	0.26288659793814434	1.323380992430614
chrX	SLC35A2	48909813	48909851	0	39	3300	2960	3300	2921	0.0	1.1297500855871276
chrX	SLC35A2	48911468	48911544	84	77	3300	2960	3216	2883	1.0909090909090908	1.1155046826222685
chrX	SLC35A2	48911468	48911505	0	38	3300	2960	3300	2922	0.0	1.1293634496919918
chrX	SLC35A2	48911545	48911857	2262	313	3300	2960	1038	2647	7.226837060702875	0.3921420476010578
chrX	SLC35A2	48911545	48911711	788	167	3300	2960	2512	2793	4.718562874251497	0.899391335481561
chrX	SLC35A2	48911506	48911544	84	39	3300	2960	3216	2921	2.1538461538461537	1.1009928106812736
chrX	SLC35A2	48911712	48911857	1474	146	3300	2960	1826	2814	10.095890410958905	0.6488983653162758
chrX	OTUD5	48956976	48956979	4	4	76820	3567	76816	3563	1.0	21.559360089811957
chrX	OTUD5	48934695	48934709	727	15	76820	3567	76093	3552	48.46666666666667	21.42257882882883
chrX	WDR45	49079750	49079788	0	39	663	3931	663	3892	0.0	0.17034943473792394
chrX	WDR45	49077836	49077883	0	48	663	3931	663	3883	0.0	0.17074426989441155
chrX	WDR45	49079789	49079937	0	149	663	3931	663	3782	0.0	0.17530407191961925
chrX	WDR45	49076405	49076428	0	24	663	3931	663	3907	0.0	0.16969541847965192
chrX	WDR45	49079746	49079749	0	4	663	3931	663	3927	0.0	0.16883116883116883
chrX	WDR45	49079746	49079788	0	43	663	3931	663	3888	0.0	0.1705246913580247
chrX	SYP	49197538	49197713	0	176	0	4790	0	4614	0.0	0.0
chrX	SYP	49197486	49197713	0	228	0	4790	0	4562	0.0	0.0
chrX	SYP	49197486	49197537	0	52	0	4790	0	4738	0.0	0.0
chrX	CACNA1F	49226936	49226968	0	33	185	6976	185	6943	0.0	0.02664554227279274
chrX	MAGED4B	52064447	52064499	0	53	102	4000	102	3947	0.0	0.025842411958449454
chrX	MAGED4B	52062221	52062232	0	12	102	4000	102	3988	0.0	0.025576730190571714
chrX	XAGE1B	52515415	52515430	0	16	0	1419	0	1403	0.0	0.0
chrX	FAM156A	52995305	52995413	0	109	193538	5892	193538	5783	0.0	33.46671277883451
chrX	FAM156A	52957087	52957600	0	514	193538	5892	193538	5378	0.0	35.98698400892525
chrX	FAM156A	52957087	52958403	0	1317	193538	5892	193538	4575	0.0	42.30338797814208
chrX	KDM5C	53193772	53193780	81	9	91236	8589	91155	8580	9.0	10.624125874125873
chrX	HSD17B10	53431797	53431823	437	27	32268	1118	31831	1091	16.185185185185187	29.175985334555453
chrX	HUWE1	53543840	53543884	0	45	213808	17357	213808	17312	0.0	12.350277264325323
chrX	HUWE1	53602563	53602589	0	27	213808	17357	213808	17330	0.0	12.337449509521061
chrX	PHF8	54043761	54043810	0	50	24833	9217	24833	9167	0.0	2.7089560379622557
chrX	PHF8	54043057	54043109	3714	53	24833	9217	21119	9164	70.0754716981132	2.304561326931471
chrX	WNK3	54238867	54239007	0	141	9310	11498	9310	11357	0.0	0.8197587391036365
chrX	FAM104B	55159125	55159127	0	3	0	2504	0	2501	0.0	0.0
chrX	FAM104B	55159121	55159124	0	4	0	2504	0	2500	0.0	0.0
chrX	FAM104B	55159121	55159127	0	7	0	2504	0	2497	0.0	0.0
chrX	FAM104B	55160864	55160973	0	110	0	2504	0	2394	0.0	0.0
chrX	AL159987.1	55656355	55656376	0	22	0	296	0	274	0.0	0.0
chrX	SPIN3	56995215	56995279	0	65	2630	13521	2630	13456	0.0	0.19545184304399524
chrX	SPIN3	56995215	56995240	0	26	2630	13521	2630	13495	0.0	0.19488699518340125
chrX	SPIN3	56995241	56995279	0	39	2630	13521	2630	13482	0.0	0.19507491470108293
chrX	SPIN3	56995215	56995626	0	412	2630	13521	2630	13109	0.0	0.20062552444885193
chrX	SPIN3	56978291	56978578	378	288	2630	13521	2252	13233	1.3125	0.17018060908335222
chrX	SPIN3	56995058	56995214	0	157	2630	13521	2630	13364	0.0	0.19679736605806644
chrX	SPIN3	56995058	56995279	0	222	2630	13521	2630	13299	0.0	0.19775923001729453
chrX	SPIN3	56995058	56995240	0	183	2630	13521	2630	13338	0.0	0.19718098665467088
chrX	SPIN3	56995058	56995626	0	569	2630	13521	2630	12952	0.0	0.20305744286596664
chrX	SPIN3	56995241	56995626	0	386	2630	13521	2630	13135	0.0	0.200228397411496
chrX	SPIN3	56993786	56994721	918	936	2630	13521	1712	12585	0.9807692307692307	0.13603496225665473
chrX	LINC01278	63238992	63239785	0	794	1173	13947	1173	13153	0.0	0.08918117539724778
chrX	ARHGEF9	63754303	63754313	0	11	8262	12238	8262	12227	0.0	0.6757176740001636
chrX	ARHGEF9	63754303	63754919	0	617	8262	12238	8262	11621	0.0	0.7109543068582738
chrX	ARHGEF9	63754303	63754306	0	4	8262	12238	8262	12234	0.0	0.6753310446297205
chrX	ARHGEF9	63754920	63755017	0	98	8262	12238	8262	12140	0.0	0.6805601317957166
chrX	ARHGEF9	63754314	63754919	0	606	8262	12238	8262	11632	0.0	0.7102819807427786
chrX	ARHGEF9	63755157	63755206	0	50	8262	12238	8262	12188	0.0	0.677879881851001
chrX	ARHGEF9	63754307	63754313	0	7	8262	12238	8262	12231	0.0	0.6754966887417219
chrX	ARHGEF9	63656509	63657903	0	1395	8262	12238	8262	10843	0.0	0.7619662455040118
chrX	LAS1L	65520701	65523558	0	2858	51	7818	51	4960	0.0	0.01028225806451613
chrX	SNX12	71068141	71068152	0	12	102	2360	102	2348	0.0	0.0434412265758092
chrX	AL590764.2	71106339	71106357	0	19	0	2383	0	2364	0.0	0.0
chrX	AL590764.2	71106339	71106352	0	14	0	2383	0	2369	0.0	0.0
chrX	AL590764.2	71106353	71106357	0	5	0	2383	0	2378	0.0	0.0
chrX	ZMYM3	71244301	71244321	0	21	0	6928	0	6907	0.0	0.0
chrX	ZMYM3	71246594	71246629	0	36	0	6928	0	6892	0.0	0.0
chrX	ZMYM3	71254467	71254479	0	13	0	6928	0	6915	0.0	0.0
chrX	BX276092.5	71761967	71762414	96	448	815	1393	719	945	0.21428571428571427	0.7608465608465609
chrX	RPS4X	72272639	72272677	0	39	0	2058	0	2019	0.0	0.0
chrX	HDAC8	72572650	72572692	0	43	139	18208	139	18165	0.0	0.007652078172309386
chrX	HDAC8	72330657	72330689	0	33	139	18208	139	18175	0.0	0.007647867950481431
chrX	HDAC8	72330690	72330814	0	125	139	18208	139	18083	0.0	0.007686777636454128
chrX	XIST	73826114	73826736	78	623	6963	13551	6885	12928	0.12520064205457465	0.5325649752475248
chrX	XIST	73822066	73822069	0	4	6963	13551	6963	13547	0.0	0.513988336901159
chrX	XIST	73841291	73841380	0	90	6963	13551	6963	13461	0.0	0.5172721194562068
chrX	FTX	74280376	74280392	0	17	12300	26391	12300	26374	0.0	0.4663683931144309
chrX	FTX	74292168	74292324	510	157	12300	26391	11790	26234	3.248407643312102	0.449416787375162
chrX	ATRX	77651982	77652112	0	131	221	17249	221	17118	0.0	0.012910386727421428
chrX	ATRX	77785844	77785980	0	137	221	17249	221	17112	0.0	0.012914913510986442
chrX	BRWD3	80684009	80684088	0	80	2200	14275	2200	14195	0.0	0.1549841493483621
chrX	TSPAN6	100636607	100636791	0	185	102	4546	102	4361	0.0	0.023389130933272186
chrX	TRMT2B	101042041	101042231	0	191	0	4036	0	3845	0.0	0.0
chrX	TRMT2B	101051250	101051642	0	393	0	4036	0	3643	0.0	0.0
chrX	TIMM8A	101347926	101348059	0	134	0	3083	0	2949	0.0	0.0
chrX	GLA	101398369	101398783	0	415	0	2857	0	2442	0.0	0.0
chrX	GLA	101401631	101401666	0	36	0	2857	0	2821	0.0	0.0
chrX	GLA	101398718	101398783	0	66	0	2857	0	2791	0.0	0.0
chrX	ARMCX6	101617282	101617290	0	9	0	2071	0	2062	0.0	0.0
chrX	ARMCX2	101658460	101658490	0	31	0	3553	0	3522	0.0	0.0
chrX	ARMCX2	101659407	101659417	0	11	0	3553	0	3542	0.0	0.0
chrX	TCP11X2	102463124	102463218	0	95	86	1930	86	1835	0.0	0.046866485013623976
chrX	BEX2	103310859	103310894	0	36	0	1137	0	1101	0.0	0.0
chrX	BEX2	103310582	103310858	0	277	0	1137	0	860	0.0	0.0
chrX	BEX2	103310582	103310894	0	313	0	1137	0	824	0.0	0.0
chrX	BEX2	103310582	103310584	0	3	0	1137	0	1134	0.0	0.0
chrX	BEX2	103310585	103310858	0	274	0	1137	0	863	0.0	0.0
chrX	BEX2	103310585	103310894	0	310	0	1137	0	827	0.0	0.0
chrX	MORC4	106941937	106941974	0	38	3608	6036	3608	5998	0.0	0.6015338446148716
chrX	TSC22D3	107776969	107777018	0	50	969	4689	969	4639	0.0	0.20888122440181073
chrX	TSC22D3	107777019	107777270	0	252	969	4689	969	4437	0.0	0.21839080459770116
chrX	PSMD10	108087685	108087763	0	79	0	2395	0	2316	0.0	0.0
chrX	CHRDL1	110795685	110795742	0	58	0	3932	0	3874	0.0	0.0
chrX	DCX	111312638	111312640	0	3	0	10073	0	10070	0.0	0.0
chrX	DCX	111330903	111330917	0	15	0	10073	0	10058	0.0	0.0
chrX	DCX	111411969	111412136	0	168	0	10073	0	9905	0.0	0.0
chrX	KLHL13	117972730	117973308	0	579	7751	6416	7751	5837	0.0	1.3279081720061676
chrX	SLC25A5-AS1	119468809	119468980	0	172	0	2106	0	1934	0.0	0.0
chrX	CXORF56	119565124	119565230	131506	107	206531	2588	75025	2481	1229.0280373831777	30.239822652156388
chrX	CUL4B	120538117	120538122	0	6	2142	8106	2142	8100	0.0	0.2644444444444444
chrX	THOC2	123620374	123620905	0	532	51	10063	51	9531	0.0	0.0053509600251809885
chrX	AL034405.1	129933693	129933700	0	8	1020	1797	1020	1789	0.0	0.5701509223029626
chrX	AIFM1	130133312	130133382	0	71	102	10093	102	10022	0.0	0.010177609259628817
chrX	AIFM1	130136044	130136046	0	3	102	10093	102	10090	0.0	0.010109018830525273
chrX	AIFM1	130131666	130131673	0	8	102	10093	102	10085	0.0	0.010114030738720872
chrX	IGSF1	131289405	131289408	0	4	228	7445	228	7441	0.0	0.030641042870581912
chrX	FIRRE	131756610	131756641	0	32	0	9139	0	9107	0.0	0.0
chrX	FIRRE	131794296	131794322	0	27	0	9139	0	9112	0.0	0.0
chrX	MIR503HG	134545346	134545463	0	118	0	2887	0	2769	0.0	0.0
chrX	MIR503HG	134545464	134545950	0	487	0	2887	0	2400	0.0	0.0
chrX	MOSPD1	134896813	134896815	0	3	153	2593	153	2590	0.0	0.059073359073359075
chrX	ETDB	135119714	135119732	0	19	2316	703	2316	684	0.0	3.3859649122807016
chrX	FMR1-AS1	147911377	147911640	0	264	0	2104	0	1840	0.0	0.0
chrX	FMR1-AS1	147911280	147911376	0	97	0	2104	0	2007	0.0	0.0
chrX	MAGEA9B	149587361	149587392	0	32	4156	1926	4156	1894	0.0	2.194297782470961
chrX	EOLA2	149937413	149937431	20988	19	213489	2354	192501	2335	1104.6315789473683	82.44154175588865
chrX	CD99L2	150777335	150777442	0	108	581	5777	581	5669	0.0	0.10248721114835067
chrX	AF274853.1	151395876	151396429	0	554	0	4506	0	3952	0.0	0.0
chrX	MAGEA10	152135989	152136060	0	72	4101	2903	4101	2831	0.0	1.4486047333097845
chrX	CSAG2	152708834	152708848	0	15	17846	492	17846	477	0.0	37.41299790356394
chrX	CSAG2	152708798	152708833	0	36	17846	492	17846	456	0.0	39.1359649122807
chrX	CSAG2	152708798	152708848	0	51	17846	492	17846	441	0.0	40.467120181405896
chrX	CSAG1	152733020	152733023	0	4	42149	1096	42149	1092	0.0	38.59798534798535
chrX	MAGEA2	152753612	152753786	0	175	0	2115	0	1940	0.0	0.0
chrX	PNMA5	152991901	152991914	0	14	131602	3432	131602	3418	0.0	38.50263311878292
chrX	CCNQ	153598961	153598964	4	4	2515831	1673	2515827	1669	1.0	1507.385859796285
chrX	PNCK	153673928	153674272	383808	345	2463660	4218	2079852	3873	1112.486956521739	537.0131680867545
chrX	PNCK	153673299	153673310	223	12	2463660	4218	2463437	4206	18.583333333333332	585.6959106038992
chrX	PNCK	153687249	153687429	293	181	2463660	4218	2463367	4037	1.6187845303867403	610.1974238295765
chrX	PNCK	153687249	153687333	97	85	2463660	4218	2463563	4133	1.1411764705882352	596.0713767239293
chrX	PNCK	153687334	153687429	196	96	2463660	4218	2463464	4122	2.0416666666666665	597.6380397865114
chrX	BCAP31	153702934	153703038	112	105	30479	2972	30367	2867	1.0666666666666667	10.59190791768399
chrX	BCAP31	153723507	153724014	0	508	30479	2972	30479	2464	0.0	12.369724025974026
chrX	BCAP31	153723507	153723953	0	447	30479	2972	30479	2525	0.0	12.07089108910891
chrX	BCAP31	153724260	153724332	0	73	30479	2972	30479	2899	0.0	10.51362538806485
chrX	BCAP31	153724200	153724332	0	133	30479	2972	30479	2839	0.0	10.735822472701656
chrX	BCAP31	153724200	153724259	0	60	30479	2972	30479	2912	0.0	10.46668956043956
chrX	BCAP31	153723954	153724014	0	61	30479	2972	30479	2911	0.0	10.470285125386464
chrX	IDH3G	153794245	153794313	0	69	84138	2656	84138	2587	0.0	32.523386161577115
chrX	PDZD4	153808341	153808358	0	18	1226	4353	1226	4335	0.0	0.2828143021914648
chrX	NAA10	153933942	153933959	0	18	0	4351	0	4333	0.0	0.0
chrX	RENBP	153944079	153944120	0	42	0	2045	0	2003	0.0	0.0
chrX	RENBP	153944579	153944582	0	4	0	2045	0	2041	0.0	0.0
chrX	FLNA	154365744	154366022	0	279	116779	9862	116779	9583	0.0	12.186058645518106
chrX	DNASE1L1	154408557	154409110	0	554	0	3587	0	3033	0.0	0.0
chrX	FAM3A	154515909	154515967	0	59	561	4886	561	4827	0.0	0.11622125543816035
chrX	MPP1	154792141	154792191	0	51	332	5410	332	5359	0.0	0.06195185668968091
chrX	F8	155022409	155022430	0	22	1071	10987	1071	10965	0.0	0.09767441860465116
chrY	PLCXD1	283489	283520	0	32	741	6077	741	6045	0.0	0.12258064516129032
chrY	CSF2RA	1274819	1274842	0	24	421	3562	421	3538	0.0	0.11899378179762578
chrY	ZFY	2935447	2935769	0	323	0	5444	0	5121	0.0	0.0
chrY	LINC00279	8583696	8583701	0	6	77	14291	77	14285	0.0	0.005390269513475674
chrY	NLGN4Y	14524709	14524936	0	228	153	8602	153	8374	0.0	0.018270838309051827
chrY	TXLNGY	19567483	19567570	0	88	0	8366	0	8278	0.0	0.0
chrY	VAMP7	57076129	57076132	0	4	0	2623	0	2619	0.0	0.0
chrY	VAMP7	57076068	57076132	0	65	0	2623	0	2558	0.0	0.0
chrY	WASH6P	57209730	57209733	0	4	0	2698	0	2694	0.0	0.0
chrY	WASH6P	57211570	57211620	0	51	0	2698	0	2647	0.0	0.0
chrY	TTTY23B	6243552	6243552	0	1	0	861	0	860	0.0	0.0
chrY	FAM197Y9	6263833	6263858	0	26	0	2866	0	2840	0.0	0.0
chrY	AC244213.1	12662525	12662655	0	131	0	1220	0	1089	0.0	0.0
chrY	AC244213.1	12663303	12663359	0	57	0	1220	0	1163	0.0	0.0
chrY	UTY	13355002	13355373	0	372	3446	9223	3446	8851	0.0	0.38933453847022936
chrY	TTTY14	19055964	19056082	0	119	408	17451	408	17332	0.0	0.023540272328640664
chrY	TTTY14	19055874	19055963	0	90	408	17451	408	17361	0.0	0.023500950406082598
chrY	TTTY14	19055874	19056082	0	209	408	17451	408	17242	0.0	0.02366314812666744
chrY	TTTY14	19044541	19044660	0	120	408	17451	408	17331	0.0	0.023541630604119786
chrY	TTTY14	18932650	18932741	0	92	408	17451	408	17359	0.0	0.02350365804481825
chrY	TTTY14	18877369	18878203	51	835	408	17451	357	16616	0.06107784431137724	0.02148531535869042
chrY	TTTY14	19077044	19077266	0	223	408	17451	408	17228	0.0	0.02368237752495937
chrY	KDM5D	19708243	19708320	0	78	0	9273	0	9195	0.0	0.0
chrY	TTTY10	20518270	20519034	0	765	0	8026	0	7261	0.0	0.0
