chrom	geneName	splicedExonStart	splicedExonEnd	splicedExonReadCount(rc)	splicedExonLength(sl)	othersExonsReadCount(RC)	othersExonsLength(L)	RC - rc	L - sl	splicedExonAverageReadCoverage(n)	otherExonsAverageReadCoverage(N)
chr1	LINC01128	849483	849602	210	120	50545	13620	50335	13500	1.75	3.7285185185185186
chr1	LINC01128	850180	850351	26	172	50545	13620	50519	13448	0.1511627906976744	3.7566180844735277
chr1	SAMD11	939274	939460	663	187	10829	4083	10166	3896	3.5454545454545454	2.609342915811088
chr1	SAMD11	941143	941306	51	164	10829	4083	10778	3919	0.31097560975609756	2.750191375350855
chr1	MIB2	1625545	1625653	1341	109	73128	7887	71787	7778	12.302752293577981	9.229493443044484
chr1	MIB2	1626649	1626754	45	106	73128	7887	73083	7781	0.42452830188679247	9.392494537977123
chr1	TP73	3730926	3731065	4038	140	125180	6783	121142	6643	28.84285714285714	18.236037934668072
chr1	TP73	3731462	3731556	4384	95	125180	6783	120796	6688	46.14736842105263	18.0616028708134
chr1	LINC01777	4422875	4423187	0	313	102	2582	102	2269	0.0	0.04495372410753636
chr1	LINC01777	4423347	4423448	0	102	102	2582	102	2480	0.0	0.04112903225806452
chr1	LINC01646	4572469	4572592	0	124	0	3336	0	3212	0.0	0.0
chr1	LINC01646	4575321	4575450	0	130	0	3336	0	3206	0.0	0.0
chr1	KCNAB2	5995862	5996084	78	223	24733	13510	24655	13287	0.34977578475336324	1.855573116580116
chr1	KCNAB2	6018634	6018835	0	202	24733	13510	24733	13308	0.0	1.8585061617072438
chr1	CAMTA1	6806982	6807088	0	107	1414	9933	1414	9826	0.0	0.14390392835334825
chr1	CAMTA1	6820180	6820250	0	71	1414	9933	1414	9862	0.0	0.14337862502534982
chr1	CAMTA1	6871756	6871840	0	85	1414	9933	1414	9848	0.0	0.14358245329000813
chr1	CAMTA1	6886239	6886346	0	108	1414	9933	1414	9825	0.0	0.14391857506361322
chr1	LNCTAM34A	9187535	9187789	612	255	612	2148	0	1893	2.4	0.0
chr1	LNCTAM34A	9191039	9191124	0	86	612	2148	612	2062	0.0	0.2967992240543162
chr1	TARDBP	11015523	11015646	0	124	102	4648	102	4524	0.0	0.022546419098143235
chr1	TARDBP	11016122	11016254	0	133	102	4648	102	4515	0.0	0.022591362126245847
chr1	AGTRAP	11745802	11745837	0	36	212944	2351	212944	2315	0.0	91.98444924406047
chr1	AGTRAP	11747439	11747545	0	107	212944	2351	212944	2244	0.0	94.89483065953654
chr1	PLOD1	11956916	11957014	0	99	774	5069	774	4970	0.0	0.1557344064386318
chr1	PLOD1	11957089	11957193	0	105	774	5069	774	4964	0.0	0.15592264302981468
chr1	MFN2	11982066	11982114	1156	49	424359	10140	423203	10091	23.591836734693878	41.93865821028639
chr1	MFN2	11988426	11988516	0	91	424359	10140	424359	10049	0.0	42.22897800776197
chr1	MFN2	11981969	11982114	1299	146	424359	10140	423060	9994	8.897260273972602	42.33139883930358
chr1	MFN2	11981973	11982114	1277	142	424359	10140	423082	9998	8.992957746478874	42.316663332666536
chr1	MFN2	11981809	11982114	5343	306	424359	10140	419016	9834	17.46078431372549	42.608907870652835
chr1	MFN2	11988721	11988843	0	123	424359	10140	424359	10017	0.0	42.36388140161725
chr1	MFN2	11982522	11982590	3567	69	424359	10140	420792	10071	51.69565217391305	41.782543938039915
chr1	MFN2	11988781	11988843	0	63	424359	10140	424359	10077	0.0	42.111640369157485
chr1	FHAD1	15383806	15383861	0	56	4423	11501	4423	11445	0.0	0.38645696810834423
chr1	FHAD1	15388050	15388131	357	82	4423	11501	4066	11419	4.353658536585366	0.3560732113144759
chr1	FHAD1	15383158	15383280	0	123	4423	11501	4423	11378	0.0	0.3887326419405871
chr1	FHAD1	15391209	15391263	15	55	4423	11501	4408	11446	0.2727272727272727	0.3851127031277302
chr1	FHAD1	15383155	15383402	0	248	4423	11501	4423	11253	0.0	0.3930507420243491
chr1	FHAD1	15383806	15383930	0	125	4423	11501	4423	11376	0.0	0.3888009845288326
chr1	DDI2	15633797	15633879	0	83	102	11761	102	11678	0.0	0.008734372324028086
chr1	DDI2	15638306	15638434	0	129	102	11761	102	11632	0.0	0.008768913342503439
chr1	NECAP2	16443631	16443732	0	102	1660932	4594	1660932	4492	0.0	369.753339269813
chr1	NECAP2	16447869	16447974	297	106	1660932	4594	1660635	4488	2.80188679245283	370.0167112299465
chr1	CROCC	16931290	16931397	286	108	102291	8914	102005	8806	2.6481481481481484	11.583579377697024
chr1	CROCC	16936636	16936873	0	238	102291	8914	102291	8676	0.0	11.790110650069156
chr1	PLA2G5	20063483	20063602	0	120	8324	3257	8324	3137	0.0	2.653490596110934
chr1	PLA2G5	20066023	20066129	0	107	8324	3257	8324	3150	0.0	2.6425396825396827
chr1	LINC00339	22027413	22027534	0	122	23942	3569	23942	3447	0.0	6.945749927473165
chr1	LINC00339	22028527	22028660	0	134	23942	3569	23942	3435	0.0	6.9700145560407565
chr1	CDC42	22069220	22069318	0	99	15009	13175	15009	13076	0.0	1.1478280819822575
chr1	CDC42	22074093	22074219	19	127	15009	13175	14990	13048	0.14960629921259844	1.1488350705088903
chr1	LYPLA2	23793859	23793930	0	72	134	1850	134	1778	0.0	0.07536557930258718
chr1	LYPLA2	23794062	23794136	0	75	134	1850	134	1775	0.0	0.07549295774647888
chr1	RCAN3	24531217	24531391	0	175	153	6672	153	6497	0.0	0.023549330460212407
chr1	RCAN3	24533082	24533254	0	173	153	6672	153	6499	0.0	0.023542083397445762
chr1	RHD	25306595	25306729	0	135	0	3324	0	3189	0.0	0.0
chr1	RHD	25316999	25317079	0	81	0	3324	0	3243	0.0	0.0
chr1	RHD	25307646	25307816	0	171	0	3324	0	3153	0.0	0.0
chr1	MTFR1L	25823237	25823323	155	87	11895	4825	11740	4738	1.7816091954022988	2.4778387505276487
chr1	MTFR1L	25823345	25823439	136	95	11895	4825	11759	4730	1.431578947368421	2.486046511627907
chr1	ZPLD2P	26226585	26226616	1492	32	967913	3201	966421	3169	46.625	304.96087093720416
chr1	ZPLD2P	26227403	26227555	814891	153	967913	3201	153022	3048	5326.084967320261	50.20406824146982
chr1	DHDDS	26446315	26446432	0	118	2827	5593	2827	5475	0.0	0.5163470319634703
chr1	DHDDS	26447558	26447660	0	103	2827	5593	2827	5490	0.0	0.514936247723133
chr1	THEMIS2	27876587	27876728	5673	142	21416	2665	15743	2523	39.95070422535211	6.239793896155371
chr1	THEMIS2	27882512	27883043	408	532	21416	2665	21008	2133	0.7669172932330827	9.849038912330052
chr1	XKR8	27964184	27964235	0	52	0	3028	0	2976	0.0	0.0
chr1	XKR8	27965350	27965458	0	109	0	3028	0	2919	0.0	0.0
chr1	XKR8	27965718	27965928	0	211	0	3028	0	2817	0.0	0.0
chr1	PHACTR4	28432930	28433046	0	117	2745	7336	2745	7219	0.0	0.38024657154730573
chr1	PHACTR4	28457831	28457855	0	25	2745	7336	2745	7311	0.0	0.37546163315551906
chr1	PHACTR4	28457831	28457859	3	29	2745	7336	2742	7307	0.10344827586206896	0.37525660325715066
chr1	EPB41	29058588	29058645	0	58	325029	17917	325029	17859	0.0	18.19973122795229
chr1	EPB41	29060421	29060484	0	64	325029	17917	325029	17853	0.0	18.20584775667955
chr1	EPB41	29058810	29058852	0	43	325029	17917	325029	17874	0.0	18.18445787176905
chr1	EPB41	28993329	28993542	51	214	325029	17917	324978	17703	0.2383177570093458	18.357227588544315
chr1	EPB41	28997214	28997319	1073	106	325029	17917	323956	17811	10.122641509433961	18.18853517489192
chr1	EPB41	29068732	29068768	32	37	325029	17917	324997	17880	0.8648648648648649	18.176565995525728
chr1	EPB41	29096154	29096604	48263	451	325029	17917	276766	17466	107.01330376940133	15.845986488033894
chr1	LINC01778	30826133	30826194	0	62	0	2117	0	2055	0.0	0.0
chr1	LINC01778	30829747	30829882	0	136	0	2117	0	1981	0.0	0.0
chr1	LINC01778	30826130	30826194	0	65	0	2117	0	2052	0.0	0.0
chr1	LINC01778	30826533	30826652	0	120	0	2117	0	1997	0.0	0.0
chr1	LINC01778	30826055	30826194	0	140	0	2117	0	1977	0.0	0.0
chr1	LINC01778	30826604	30826652	0	49	0	2117	0	2068	0.0	0.0
chr1	LINC01778	30826554	30826652	0	99	0	2117	0	2018	0.0	0.0
chr1	LINC01226	31540807	31540885	0	79	408	9340	408	9261	0.0	0.04405571752510528
chr1	LINC01226	31551534	31551657	0	124	408	9340	408	9216	0.0	0.044270833333333336
chr1	PEF1-AS1	31655951	31656185	0	235	351	2148	351	1913	0.0	0.18348144276006273
chr1	PEF1-AS1	31656896	31657061	0	166	351	2148	351	1982	0.0	0.17709384460141273
chr1	EIF3I	32226170	32226283	0	114	21504	5731	21504	5617	0.0	3.8283781377959767
chr1	EIF3I	32226402	32226530	0	129	21504	5731	21504	5602	0.0	3.838629061049625
chr1	EIF3I	32226170	32226320	0	151	21504	5731	21504	5580	0.0	3.8537634408602153
chr1	AZIN2	33082177	33082354	0	178	359545	7260	359545	7082	0.0	50.768850607173114
chr1	AZIN2	33083953	33084127	41	175	359545	7260	359504	7085	0.2342857142857143	50.741566690190545
chr1	THRAP3	36224970	36225102	0	133	29510	4735	29510	4602	0.0	6.4124293785310735
chr1	THRAP3	36225411	36225463	86	53	29510	4735	29424	4682	1.6226415094339623	6.284493806065784
chr1	LINC01685	38476728	38476803	0	76	1621	3681	1621	3605	0.0	0.44965325936199724
chr1	LINC01685	38493570	38493621	0	52	1621	3681	1621	3629	0.0	0.4466795260402315
chr1	AKIRIN1	39000971	39001106	0	136	0	2693	0	2557	0.0	0.0
chr1	AKIRIN1	39003346	39003418	0	73	0	2693	0	2620	0.0	0.0
chr1	AKIRIN1	38998170	38998311	0	142	0	2693	0	2551	0.0	0.0
chr1	MACF1	39436481	39436490	0	10	286688	41060	286688	41050	0.0	6.983873325213155
chr1	MACF1	39437776	39438008	0	233	286688	41060	286688	40827	0.0	7.02201974183751
chr1	CAP1	40041428	40041493	51993	66	53087	3616	1094	3550	787.7727272727273	0.30816901408450703
chr1	CAP1	40057445	40057495	0	51	53087	3616	53087	3565	0.0	14.89116409537167
chr1	ZMPSTE24	40262833	40262983	0	151	51	4036	51	3885	0.0	0.013127413127413128
chr1	ZMPSTE24	40267390	40267507	0	118	51	4036	51	3918	0.0	0.013016845329249618
chr1	NFYC	40749572	40749686	0	115	196095	5237	196095	5122	0.0	38.284849668098396
chr1	NFYC	40753150	40753246	0	97	196095	5237	196095	5140	0.0	38.150778210116734
chr1	NFYC	40712686	40712821	0	136	196095	5237	196095	5101	0.0	38.44246226230151
chr1	NFYC	40723688	40723792	0	105	196095	5237	196095	5132	0.0	38.21024941543258
chr1	NFYC	40735600	40735750	49018	151	196095	5237	147077	5086	324.6225165562914	28.918010224144712
chr1	NFYC	40747533	40747605	198	73	196095	5237	195897	5164	2.712328767123288	37.935127807900855
chr1	KCNQ4	40824096	40824258	0	163	41391	4424	41391	4261	0.0	9.713916920910584
chr1	KCNQ4	40826637	40826694	0	58	41391	4424	41391	4366	0.0	9.480302336234539
chr1	CCDC30	42506946	42507069	0	124	197370	22898	197370	22774	0.0	8.666461754632476
chr1	CCDC30	42521162	42521256	0	95	197370	22898	197370	22803	0.0	8.655440073674516
chr1	CCDC30	42473121	42473303	357	183	197370	22898	197013	22715	1.9508196721311475	8.67325555800132
chr1	CCDC30	42480460	42480566	91	107	197370	22898	197279	22791	0.8504672897196262	8.656004563204775
chr1	CCDC30	42477107	42477136	0	30	197370	22898	197370	22868	0.0	8.63083785202029
chr1	CCDC30	42536475	42536601	0	127	197370	22898	197370	22771	0.0	8.667603530806728
chr1	PPIH	42668046	42668151	0	106	9233	4021	9233	3915	0.0	2.3583652618135376
chr1	PPIH	42675366	42675448	130	83	9233	4021	9103	3938	1.5662650602409638	2.3115794819705435
chr1	PPIH	42675287	42675327	26	41	9233	4021	9207	3980	0.6341463414634146	2.313316582914573
chr1	ST3GAL3	43819113	43819236	51	124	242611	18223	242560	18099	0.4112903225806452	13.401845405823526
chr1	ST3GAL3	43824730	43824892	40384	163	242611	18223	202227	18060	247.75460122699386	11.19750830564784
chr1	ST3GAL3	43858134	43858308	51	175	242611	18223	242560	18048	0.2914285714285714	13.439716312056738
chr1	ST3GAL3	43894382	43894477	36	96	242611	18223	242575	18127	0.375	13.381971644508193
chr1	ST3GAL3	43838218	43838311	76	94	242611	18223	242535	18129	0.8085106382978723	13.378288929339732
chr1	ST3GAL3	43879334	43879507	55	174	242611	18223	242556	18049	0.3160919540229885	13.438750069255914
chr1	ST3GAL3	43814890	43814933	0	44	242611	18223	242611	18179	0.0	13.345673579404808
chr1	DPH2	43970965	43971189	0	225	0	2729	0	2504	0.0	0.0
chr1	DPH2	43971386	43972070	0	685	0	2729	0	2044	0.0	0.0
chr1	ARMH1	44684392	44684656	13020	265	21052	3290	8032	3025	49.132075471698116	2.655206611570248
chr1	ARMH1	44688195	44688319	431	125	21052	3290	20621	3165	3.448	6.515323854660347
chr1	ARMH1	44689108	44689224	822	117	21052	3290	20230	3173	7.0256410256410255	6.375669713205169
chr1	KIF2C	44762228	44762295	0	68	41451	3547	41451	3479	0.0	11.91463064098879
chr1	KIF2C	44762345	44762451	0	107	41451	3547	41451	3440	0.0	12.049709302325581
chr1	UROD	45013135	45013215	0	81	192	3179	192	3098	0.0	0.06197546804389929
chr1	UROD	45013291	45013354	0	64	192	3179	192	3115	0.0	0.06163723916532905
chr1	UROD	45013908	45014070	0	163	192	3179	192	3016	0.0	0.0636604774535809
chr1	UROD	45014438	45014576	0	139	192	3179	192	3040	0.0	0.06315789473684211
chr1	UROD	45013354	45013426	0	73	192	3179	192	3106	0.0	0.061815840309079204
chr1	NASP	45594693	45594773	0	81	51	8254	51	8173	0.0	0.006240058729964517
chr1	NASP	45600384	45600457	0	74	51	8254	51	8180	0.0	0.0062347188264058676
chr1	NASP	45591222	45591270	0	49	51	8254	51	8205	0.0	0.006215722120658135
chr1	NASP	45602254	45602365	0	112	51	8254	51	8142	0.0	0.006263817243920413
chr1	NASP	45604935	45605016	0	82	51	8254	51	8172	0.0	0.006240822320117474
chr1	RAD54L	46273354	46273465	52	112	42953	4044	42901	3932	0.4642857142857143	10.910732451678536
chr1	RAD54L	46273623	46273747	0	125	42953	4044	42953	3919	0.0	10.9601939270222
chr1	CYP4B1	46811139	46811184	124	46	25637	3487	25513	3441	2.6956521739130435	7.414414414414415
chr1	CYP4B1	46812176	46812348	92	173	25637	3487	25545	3314	0.5317919075144508	7.708207604103802
chr1	ELAVL4	50120844	50121054	0	211	102	8008	102	7797	0.0	0.013081954597922277
chr1	ELAVL4	50141771	50141858	0	88	102	8008	102	7920	0.0	0.012878787878787878
chr1	OSBPL9	51752502	51752725	1122	224	1293	7377	171	7153	5.008928571428571	0.023906053404166083
chr1	OSBPL9	51756319	51756358	0	40	1293	7377	1293	7337	0.0	0.17623006678478942
chr1	OSBPL9	51651990	51652041	0	52	1293	7377	1293	7325	0.0	0.17651877133105803
chr1	OSBPL9	51669433	51669512	0	80	1293	7377	1293	7297	0.0	0.17719610798958477
chr1	SCP2	52941795	52941853	0	59	4957	6178	4957	6119	0.0	0.810099689491747
chr1	SCP2	52948008	52948080	18	73	4957	6178	4939	6105	0.2465753424657534	0.809009009009009
chr1	SCP2	52950754	52950886	408	133	4957	6178	4549	6045	3.0676691729323307	0.7525227460711331
chr1	SCP2	53027968	53028071	0	104	4957	6178	4957	6074	0.0	0.8161014158709252
chr1	SCP2	53038916	53039046	0	131	4957	6178	4957	6047	0.0	0.8197453282619481
chr1	CPT2	53202322	53202429	0	108	306	5091	306	4983	0.0	0.061408789885611076
chr1	CPT2	53210014	53211319	0	1306	306	5091	306	3785	0.0	0.08084544253632761
chr1	DIO1	53904665	53904809	0	145	122	2265	122	2120	0.0	0.057547169811320756
chr1	DIO1	53906094	53906294	0	201	122	2265	122	2064	0.0	0.05910852713178295
chr1	DIO1	53904733	53904809	0	77	122	2265	122	2188	0.0	0.055758683729433274
chr1	DIO1	53894438	53894547	20	110	122	2265	102	2155	0.18181818181818182	0.047331786542923436
chr1	LRRC42	53947787	53947821	0	35	102	2093	102	2058	0.0	0.04956268221574344
chr1	LRRC42	53947861	53947981	0	121	102	2093	102	1972	0.0	0.05172413793103448
chr1	MROH7	54679890	54680045	175	156	209164	6269	208989	6113	1.1217948717948718	34.18763291346311
chr1	MROH7	54682655	54682794	1295	140	209164	6269	207869	6129	9.25	33.9156469244575
chr1	DAB1-AS1	57864421	57864594	0	174	0	4284	0	4110	0.0	0.0
chr1	DAB1-AS1	57864706	57864824	0	119	0	4284	0	4165	0.0	0.0
chr1	LINC01135	58893544	58893717	0	174	0	5023	0	4849	0.0	0.0
chr1	LINC01135	58896256	58896385	0	130	0	5023	0	4893	0.0	0.0
chr1	LINC01358	59056937	59057032	0	96	9058	8361	9058	8265	0.0	1.095946763460375
chr1	LINC01358	59112505	59112589	0	85	9058	8361	9058	8276	0.0	1.0944900918318028
chr1	LINC01358	59082567	59082708	0	142	9058	8361	9058	8219	0.0	1.1020805450784767
chr1	LINC01358	59082636	59082708	0	73	9058	8361	9058	8288	0.0	1.0929054054054055
chr1	LINC01358	59086402	59086596	0	195	9058	8361	9058	8166	0.0	1.109233406808719
chr1	LINC01358	59062114	59062184	0	71	9058	8361	9058	8290	0.0	1.0926417370325694
chr1	LINC01358	59082220	59082437	0	218	9058	8361	9058	8143	0.0	1.1123664497114085
chr1	FGGY	59339957	59340069	0	113	759	12210	759	12097	0.0	0.06274282880052906
chr1	FGGY	59346246	59346398	102	153	759	12210	657	12057	0.6666666666666666	0.05449116695695447
chr1	FGGY	59378748	59378837	0	90	759	12210	759	12120	0.0	0.06262376237623762
chr1	NFIA	61385870	61385924	0	55	10	32389	10	32334	0.0	0.00030927197377373663
chr1	NFIA	61399375	61399520	0	146	10	32389	10	32243	0.0	0.0003101448376391775
chr1	NFIA	61426464	61426556	0	93	10	32389	10	32296	0.0	0.00030963586821897447
chr1	NFIA	61439450	61439518	0	69	10	32389	10	32320	0.0	0.0003094059405940594
chr1	ALG6	63411145	63411155	0	11	408	5100	408	5089	0.0	0.08017292198860287
chr1	ALG6	63411254	63411331	0	78	408	5100	408	5022	0.0	0.08124253285543608
chr1	SGIP1	66694438	66694504	0	67	1252	13353	1252	13286	0.0	0.09423453259069697
chr1	SGIP1	66695433	66695493	0	61	1252	13353	1252	13292	0.0	0.09419199518507373
chr1	SGIP1	66634079	66634163	0	85	1252	13353	1252	13268	0.0	0.09436237564063914
chr1	SGIP1	66635943	66636015	0	73	1252	13353	1252	13280	0.0	0.09427710843373494
chr1	LINC01702	67529652	67529749	0	98	0	953	0	855	0.0	0.0
chr1	LINC01702	67530314	67530378	0	65	0	953	0	888	0.0	0.0
chr1	LINC01702	67527377	67527437	0	61	0	953	0	892	0.0	0.0
chr1	LINC01702	67529627	67529749	0	123	0	953	0	830	0.0	0.0
chr1	LINC01702	67529618	67529749	0	132	0	953	0	821	0.0	0.0
chr1	GADD45A	67686024	67686126	0	103	0	1706	0	1603	0.0	0.0
chr1	GADD45A	67686349	67686587	0	239	0	1706	0	1467	0.0	0.0
chr1	GNG12-AS1	67956155	67956262	0	108	0	3481	0	3373	0.0	0.0
chr1	GNG12-AS1	68034646	68034763	0	118	0	3481	0	3363	0.0	0.0
chr1	GNG12-AS1	68100697	68100774	0	78	0	3481	0	3403	0.0	0.0
chr1	GNG12-AS1	68102654	68102727	0	74	0	3481	0	3407	0.0	0.0
chr1	SRSF11	70231094	70231203	0	110	51	6054	51	5944	0.0	0.008580080753701211
chr1	SRSF11	70231858	70231975	0	118	51	6054	51	5936	0.0	0.008591644204851753
chr1	ZRANB2-AS2	71093132	71093251	0	120	51	14846	51	14726	0.0	0.0034632622572321066
chr1	ZRANB2-AS2	71223056	71223114	0	59	51	14846	51	14787	0.0	0.003448975451410022
chr1	ZRANB2-AS2	71184346	71184571	0	226	51	14846	51	14620	0.0	0.0034883720930232558
chr1	ZRANB2-AS2	71237129	71237195	0	67	51	14846	51	14779	0.0	0.0034508424115298735
chr1	ZRANB2-AS2	71368054	71368088	0	35	51	14846	51	14811	0.0	0.0034433866720680576
chr1	ZRANB2-AS2	71237129	71237386	0	258	51	14846	51	14588	0.0	0.0034960241294214422
chr1	ZRANB2-AS2	71304358	71304415	0	58	51	14846	51	14788	0.0	0.003448742223424398
chr1	ZRANB2-AS2	71365037	71365199	0	163	51	14846	51	14683	0.0	0.003473404617584962
chr1	ZRANB2-AS2	71193674	71193728	0	55	51	14846	51	14791	0.0	0.0034480427286863635
chr1	ZRANB2-AS2	71208180	71208296	0	117	51	14846	51	14729	0.0	0.003462556860615113
chr1	ZRANB2-AS2	71268434	71268478	0	45	51	14846	51	14801	0.0	0.003445713127491386
chr1	ZRANB2-AS2	71280525	71280615	51	91	51	14846	0	14755	0.5604395604395604	0.0
chr1	ZRANB2-AS2	71202034	71202056	0	23	51	14846	51	14823	0.0	0.0034405990690143697
chr1	ZRANB2-AS2	71476860	71476967	0	108	51	14846	51	14738	0.0	0.0034604423938119147
chr1	ZRANB2-AS2	71484785	71484836	0	52	51	14846	51	14794	0.0	0.0034473435176422874
chr1	LINC01360	73307167	73307384	0	218	0	5538	0	5320	0.0	0.0
chr1	LINC01360	73310852	73310990	0	139	0	5538	0	5399	0.0	0.0
chr1	LINC01360	73307167	73307363	0	197	0	5538	0	5341	0.0	0.0
chr1	ACADM	75728400	75728488	14	89	26	4672	12	4583	0.15730337078651685	0.0026183722452542005
chr1	ACADM	75732643	75732741	0	99	26	4672	26	4573	0.0	0.005685545593702165
chr1	AC092813.1	75983444	75983560	0	117	0	2089	0	1972	0.0	0.0
chr1	AC092813.1	76010739	76010853	0	115	0	2089	0	1974	0.0	0.0
chr1	AC092813.1	75935950	75936154	0	205	0	2089	0	1884	0.0	0.0
chr1	AC092813.1	75935924	75936154	0	231	0	2089	0	1858	0.0	0.0
chr1	ADGRL2	81986900	81987029	0	130	10445	19025	10445	18895	0.0	0.5527917438475787
chr1	ADGRL2	81987259	81987341	0	83	10445	19025	10445	18942	0.0	0.5514201245908563
chr1	ADGRL2	81987868	81987886	0	19	10445	19025	10445	19006	0.0	0.5495632958013259
chr1	ADGRL2	81989656	81989695	0	40	10445	19025	10445	18985	0.0	0.5501711877798262
chr1	ADGRL2	81987288	81987341	0	54	10445	19025	10445	18971	0.0	0.5505771967740235
chr1	ADGRL2	81989656	81989709	0	54	10445	19025	10445	18971	0.0	0.5505771967740235
chr1	LINC01362	82952671	82952728	0	58	2	2150	2	2092	0.0	0.0009560229445506692
chr1	LINC01362	82991859	82991980	0	122	2	2150	2	2028	0.0	0.0009861932938856016
chr1	LINC01362	82952671	82952837	0	167	2	2150	2	1983	0.0	0.0010085728693898135
chr1	BRDT	91949889	91950474	0	586	34576	4344	34576	3758	0.0	9.200638637573178
chr1	BRDT	91962717	91962946	0	230	34576	4344	34576	4114	0.0	8.40447253281478
chr1	BRDT	91949637	91949682	0	46	34576	4344	34576	4298	0.0	8.044671940437413
chr1	BRDT	91950107	91950474	0	368	34576	4344	34576	3976	0.0	8.696177062374245
chr1	BRDT	91949889	91949958	0	70	34576	4344	34576	4274	0.0	8.089845577912962
chr1	BRDT	91957528	91957600	0	73	34576	4344	34576	4271	0.0	8.095527979395927
chr1	BRDT	91949899	91950474	0	576	34576	4344	34576	3768	0.0	9.176220806794054
chr1	BRDT	91950304	91950474	0	171	34576	4344	34576	4173	0.0	8.285645818356098
chr1	ARHGAP29-AS1	94250378	94250544	0	167	46667	3779	46667	3612	0.0	12.91998892580288
chr1	ARHGAP29-AS1	94257960	94258029	23	70	46667	3779	46644	3709	0.32857142857142857	12.575896468050688
chr1	ABCD3	94472172	94472242	0	71	51	7682	51	7611	0.0	0.006700827749310209
chr1	ABCD3	94473765	94473835	0	71	51	7682	51	7611	0.0	0.006700827749310209
chr1	LINC02790	96002100	96002212	0	113	0	2786	0	2673	0.0	0.0
chr1	LINC02790	96006192	96006421	0	230	0	2786	0	2556	0.0	0.0
chr1	LINC02790	96006169	96006421	0	253	0	2786	0	2533	0.0	0.0
chr1	LINC02790	96003362	96003444	0	83	0	2786	0	2703	0.0	0.0
chr1	LINC02790	96005756	96005867	0	112	0	2786	0	2674	0.0	0.0
chr1	LINC02790	96006196	96006421	0	226	0	2786	0	2560	0.0	0.0
chr1	LINC02790	96006362	96006421	0	60	0	2786	0	2726	0.0	0.0
chr1	SLC35A3	99999260	99999415	0	156	867	15955	867	15799	0.0	0.054876890942464715
chr1	SLC35A3	100007033	100007156	0	124	867	15955	867	15831	0.0	0.05476596551070684
chr1	AC093157.1	101075275	101075394	0	120	0	7130	0	7010	0.0	0.0
chr1	AC093157.1	101075394	101075716	0	323	0	7130	0	6807	0.0	0.0
chr1	AC093157.1	101080388	101080613	0	226	0	7130	0	6904	0.0	0.0
chr1	AC093157.1	101080886	101080998	0	113	0	7130	0	7017	0.0	0.0
chr1	LINC01709	101730940	101731053	0	114	0	2787	0	2673	0.0	0.0
chr1	LINC01709	101733329	101733556	0	228	0	2787	0	2559	0.0	0.0
chr1	AL355306.2	105978906	105979020	0	115	0	8939	0	8824	0.0	0.0
chr1	AL355306.2	106022017	106022141	0	125	0	8939	0	8814	0.0	0.0
chr1	NTNG1	107418579	107418645	0	67	0	9155	0	9088	0.0	0.0
chr1	NTNG1	107430749	107430917	0	169	0	9155	0	8986	0.0	0.0
chr1	GPSM2	108914337	108914408	510	72	5867	18055	5357	17983	7.083333333333333	0.2978924539843185
chr1	GPSM2	108918612	108918789	705	178	5867	18055	5162	17877	3.960674157303371	0.288750908989204
chr1	GPSM2	108877530	108877774	0	245	5867	18055	5867	17810	0.0	0.32942167321729365
chr1	GPSM2	108882579	108882625	0	47	5867	18055	5867	18008	0.0	0.3257996446023989
chr1	GPSM2	108922416	108922576	0	161	5867	18055	5867	17894	0.0	0.3278752654521069
chr1	GPSM2	108923999	108924214	0	216	5867	18055	5867	17839	0.0	0.32888614832669993
chr1	ELAPOR1	109173687	109173837	0	151	178014	9175	178014	9024	0.0	19.726728723404257
chr1	ELAPOR1	109185044	109185133	0	90	178014	9175	178014	9085	0.0	19.594276279581727
chr1	CYB561D1	109494519	109494623	0	105	76138	5618	76138	5513	0.0	13.810629421367677
chr1	CYB561D1	109495142	109495180	0	39	76138	5618	76138	5579	0.0	13.647248610862162
chr1	AMPD2	109622184	109622353	0	170	70772	8217	70772	8047	0.0	8.794830371567043
chr1	AMPD2	109623978	109624089	0	112	70772	8217	70772	8105	0.0	8.731893892658853
chr1	LAMTOR5-AS1	110413320	110413410	0	91	1596	11148	1596	11057	0.0	0.14434295016731483
chr1	LAMTOR5-AS1	110414151	110414231	46	81	1596	11148	1550	11067	0.5679012345679012	0.1400560224089636
chr1	LAMTOR5-AS1	110413038	110413094	0	57	1596	11148	1596	11091	0.0	0.14390045983229646
chr1	LAMTOR5-AS1	110416008	110416188	51	181	1596	11148	1545	10967	0.281767955801105	0.14087717698550195
chr1	LAMTOR5-AS1	110417488	110417640	0	153	1596	11148	1596	10995	0.0	0.1451568894952251
chr1	LAMTOR5-AS1	110409084	110409158	0	75	1596	11148	1596	11073	0.0	0.14413438092657815
chr1	LAMTOR5-AS1	110411444	110411521	0	78	1596	11148	1596	11070	0.0	0.14417344173441735
chr1	LAMTOR5-AS1	110408921	110409158	0	238	1596	11148	1596	10910	0.0	0.1462878093492209
chr1	LAMTOR5-AS1	110417793	110417916	0	124	1596	11148	1596	11024	0.0	0.14477503628447025
chr1	LAMTOR5-AS1	110425608	110426067	0	460	1596	11148	1596	10688	0.0	0.1493263473053892
chr1	LAMTOR5-AS1	110429790	110430066	0	277	1596	11148	1596	10871	0.0	0.1468126207340631
chr1	CHIA	111315269	111315435	0	167	0	3684	0	3517	0.0	0.0
chr1	CHIA	111315733	111315872	0	140	0	3684	0	3544	0.0	0.0
chr1	DCLRE1B	113906995	113907161	0	167	68	3872	68	3705	0.0	0.01835357624831309
chr1	DCLRE1B	113908008	113908191	0	184	68	3872	68	3688	0.0	0.01843817787418655
chr1	PHGDH	119724318	119724469	4073	152	19639	6218	15566	6066	26.79605263157895	2.5661061655126938
chr1	PHGDH	119724784	119724875	2517	92	19639	6218	17122	6126	27.358695652173914	2.794972249428665
chr1	NBPF26	120824865	120824917	0	53	41854	6817	41854	6764	0.0	6.18775872264932
chr1	NBPF26	120829763	120829815	0	53	41854	6817	41854	6764	0.0	6.18775872264932
chr1	NBPF26	120834494	120834546	550	53	41854	6817	41304	6764	10.377358490566039	6.106445890005913
chr1	NBPF26	120836516	120836568	106	53	41854	6817	41748	6764	2.0	6.172087522176227
chr1	NBPF26	120832874	120832983	31	110	41854	6817	41823	6707	0.2818181818181818	6.235723870582973
chr1	LINC02798	121397620	121397787	0	168	0	4744	0	4576	0.0	0.0
chr1	LINC02798	121427981	121428064	0	84	0	4744	0	4660	0.0	0.0
chr1	GPR89A	145608347	145608675	62718	329	87735	4656	25017	4327	190.6322188449848	5.781603882597643
chr1	GPR89A	145612201	145612247	0	47	87735	4656	87735	4609	0.0	19.035582555868952
chr1	LIX1L-AS1	145937356	145937464	0	109	2255	3264	2255	3155	0.0	0.7147385103011094
chr1	LIX1L-AS1	145939823	145940066	255	244	2255	3264	2000	3020	1.0450819672131149	0.6622516556291391
chr1	LIX1L-AS1	145932083	145932159	0	77	2255	3264	2255	3187	0.0	0.7075619705051773
chr1	LIX1L-AS1	145944534	145944626	0	93	2255	3264	2255	3171	0.0	0.7111321349731946
chr1	LIX1L-AS1	145958360	145958438	0	79	2255	3264	2255	3185	0.0	0.7080062794348508
chr1	NBPF12	146988840	146988949	0	110	0	7308	0	7198	0.0	0.0
chr1	NBPF12	146990465	146990517	0	53	0	7308	0	7255	0.0	0.0
chr1	NBPF12	146960108	146960318	0	211	0	7308	0	7097	0.0	0.0
chr1	NBPF12	146966463	146966673	0	211	0	7308	0	7097	0.0	0.0
chr1	NBPF12	146970646	146970719	0	74	0	7308	0	7234	0.0	0.0
chr1	NBPF12	146976928	146977001	0	74	0	7308	0	7234	0.0	0.0
chr1	CHD1L	147268781	147268878	0	98	51	4200	51	4102	0.0	0.012432959531935642
chr1	CHD1L	147272170	147272281	0	112	51	4200	51	4088	0.0	0.012475538160469667
chr1	CHD1L	147252622	147252735	0	114	51	4200	51	4086	0.0	0.012481644640234948
chr1	CHD1L	147254869	147254976	0	108	51	4200	51	4092	0.0	0.012463343108504398
chr1	CHD1L	147259836	147259918	0	83	51	4200	51	4117	0.0	0.01238766091814428
chr1	CHD1L	147264421	147264584	0	164	51	4200	51	4036	0.0	0.01263627353815659
chr1	CHD1L	147264428	147264584	0	157	51	4200	51	4043	0.0	0.0126143952510512
chr1	CHD1L	147256530	147256562	0	33	51	4200	51	4167	0.0	0.012239020878329733
chr1	AC245100.4	148424062	148424189	0	128	0	3322	0	3194	0.0	0.0
chr1	AC245100.4	148424626	148424678	0	53	0	3322	0	3269	0.0	0.0
chr1	PDE4DIP	149010442	149010595	0	154	2142	23819	2142	23665	0.0	0.09051341643777731
chr1	PDE4DIP	149012590	149012776	0	187	2142	23819	2142	23632	0.0	0.09063981042654029
chr1	AC245297.3	149177157	149177212	0	56	0	4300	0	4244	0.0	0.0
chr1	AC245297.3	149190635	149190795	0	161	0	4300	0	4139	0.0	0.0
chr1	NBPF19	149488904	149488956	0	53	0	13847	0	13794	0.0	0.0
chr1	NBPF19	149493659	149493711	0	53	0	13847	0	13794	0.0	0.0
chr1	TARS2	150491393	150491511	0	119	2065	4095	2065	3976	0.0	0.5193661971830986
chr1	TARS2	150492410	150492489	0	80	2065	4095	2065	4015	0.0	0.5143212951432129
chr1	PRUNE1	151017811	151017904	0	94	149725	3165	149725	3071	0.0	48.7544773689352
chr1	PRUNE1	151024610	151024795	76044	186	149725	3165	73681	2979	408.83870967741933	24.73346760657939
chr1	PRUNE1	151025514	151025673	63861	160	149725	3165	85864	3005	399.13125	28.57371048252912
chr1	PRUNE1	151018556	151018669	98	114	149725	3165	149627	3051	0.8596491228070176	49.04195345788266
chr1	PRUNE1	151018466	151018669	455	204	149725	3165	149270	2961	2.230392156862745	50.412022965214454
chr1	ZNF687	151288527	151288706	82254	180	192982	6334	110728	6154	456.96666666666664	17.99285017874553
chr1	ZNF687	151289094	151289271	663	178	192982	6334	192319	6156	3.7247191011235956	31.24090318388564
chr1	OAZ3	151768057	151768233	0	177	32072	4640	32072	4463	0.0	7.186197624915976
chr1	OAZ3	151770171	151770257	374	87	32072	4640	31698	4553	4.2988505747126435	6.962003074895673
chr1	FLAD1	154992564	154992673	0	110	174719	3992	174719	3882	0.0	45.007470376094794
chr1	FLAD1	154992712	154992786	0	75	174719	3992	174719	3917	0.0	44.60531018636712
chr1	ADAM15	155061414	155061489	0	76	3893	4801	3893	4725	0.0	0.8239153439153439
chr1	ADAM15	155061903	155061975	0	73	3893	4801	3893	4728	0.0	0.8233925549915397
chr1	ADAM15	155060762	155060832	0	71	3893	4801	3893	4730	0.0	0.8230443974630021
chr1	ADAM15	155061417	155061489	0	73	3893	4801	3893	4728	0.0	0.8233925549915397
chr1	ADAM15	155061903	155062117	0	215	3893	4801	3893	4586	0.0	0.8488879197557785
chr1	SLC50A1	155136827	155136951	0	125	0	1885	0	1760	0.0	0.0
chr1	SLC50A1	155137560	155137722	0	163	0	1885	0	1722	0.0	0.0
chr1	MSTO1	155611215	155611241	216	27	7524	4041	7308	4014	8.0	1.8206278026905829
chr1	MSTO1	155611548	155611603	352	56	7524	4041	7172	3985	6.285714285714286	1.7997490589711418
chr1	DAP3	155717005	155717128	13498	124	54517	4354	41019	4230	108.85483870967742	9.697163120567376
chr1	DAP3	155721516	155721618	3072	103	54517	4354	51445	4251	29.825242718446603	12.101858386262055
chr1	DAP3	155731943	155732033	1380	91	54517	4354	53137	4263	15.164835164835164	12.464696223316913
chr1	DAP3	155736945	155737063	357	119	54517	4354	54160	4235	3.0	12.788665879574971
chr1	PMF1	156225556	156225668	125	113	148704	2529	148579	2416	1.1061946902654867	61.49793046357616
chr1	PMF1	156232319	156232425	0	107	148704	2529	148704	2422	0.0	61.39719240297275
chr1	RHBG	156371181	156371254	0	74	0	3394	0	3320	0.0	0.0
chr1	RHBG	156374606	156374729	0	124	0	3394	0	3270	0.0	0.0
chr1	TTC24	156583041	156583170	0	130	0	2644	0	2514	0.0	0.0
chr1	TTC24	156583799	156583895	0	97	0	2644	0	2547	0.0	0.0
chr1	CD1E	158354376	158354673	0	298	23	2210	23	1912	0.0	0.01202928870292887
chr1	CD1E	158355299	158355569	0	271	23	2210	23	1939	0.0	0.01186178442496132
chr1	IFI16	159045296	159045464	0	169	306	5088	306	4919	0.0	0.06220776580605814
chr1	IFI16	159049431	159049599	0	169	306	5088	306	4919	0.0	0.06220776580605814
chr1	NCSTN	160343703	160343802	0	100	97	4150	97	4050	0.0	0.023950617283950617
chr1	NCSTN	160344475	160344614	0	140	97	4150	97	4010	0.0	0.024189526184538655
chr1	NCSTN	160343703	160343888	0	186	97	4150	97	3964	0.0	0.02447023208879919
chr1	SLAMF7	160749820	160750093	0	274	0	3183	0	2909	0.0	0.0
chr1	SLAMF7	160751344	160751448	0	105	0	3183	0	3078	0.0	0.0
chr1	SLAMF7	160748193	160748514	0	322	0	3183	0	2861	0.0	0.0
chr1	SLAMF7	160750303	160750423	0	121	0	3183	0	3062	0.0	0.0
chr1	LY9	160797109	160797275	0	167	0	5244	0	5077	0.0	0.0
chr1	LY9	160798825	160799008	0	184	0	5244	0	5060	0.0	0.0
chr1	PPOX	161169905	161170024	0	120	31353	4416	31353	4296	0.0	7.298184357541899
chr1	PPOX	161170408	161170519	8	112	31353	4416	31345	4304	0.07142857142857142	7.282760223048327
chr1	PPOX	161167994	161168127	4417	134	31353	4416	26936	4282	32.96268656716418	6.290518449322747
chr1	PPOX	161168412	161168576	5415	165	31353	4416	25938	4251	32.81818181818182	6.101623147494707
chr1	PPOX	161167338	161167486	0	149	31353	4416	31353	4267	0.0	7.347785329271151
chr1	NDUFS2	161212591	161212654	41	64	37441	7304	37400	7240	0.640625	5.165745856353591
chr1	NDUFS2	161213086	161213182	0	97	37441	7304	37441	7207	0.0	5.1950881087831275
chr1	NDUFS2	161213089	161213182	0	94	37441	7304	37441	7210	0.0	5.1929264909847435
chr1	NDUFS2	161209856	161209931	0	76	37441	7304	37441	7228	0.0	5.179994465965689
chr1	NDUFS2	161210110	161210188	0	79	37441	7304	37441	7225	0.0	5.182145328719723
chr1	FCGR2A	161510840	161510956	0	117	1781	4043	1781	3926	0.0	0.45364238410596025
chr1	FCGR2A	161513894	161513932	0	39	1781	4043	1781	4004	0.0	0.4448051948051948
chr1	FCRLA	161710474	161710492	0	19	0	2862	0	2843	0.0	0.0
chr1	FCRLA	161710759	161710912	0	154	0	2862	0	2708	0.0	0.0
chr1	FCRLA	161711207	161711474	0	268	0	2862	0	2594	0.0	0.0
chr1	FCRLA	161711933	161712218	0	286	0	2862	0	2576	0.0	0.0
chr1	HSD17B7	162800212	162800314	0	103	20	3983	20	3880	0.0	0.005154639175257732
chr1	HSD17B7	162803430	162803535	0	106	20	3983	20	3877	0.0	0.005158627805003869
chr1	RCSD1	167685420	167685510	0	91	4131	8178	4131	8087	0.0	0.5108198343019661
chr1	RCSD1	167690048	167690120	0	73	4131	8178	4131	8105	0.0	0.5096853793954349
chr1	DCAF6	168015780	168015951	0	172	65409	6334	65409	6162	0.0	10.61489776046738
chr1	DCAF6	168019544	168019667	180	124	65409	6334	65229	6210	1.4516129032258065	10.503864734299517
chr1	LINC01681	170237747	170237954	0	208	48	2807	48	2599	0.0	0.01846864178530204
chr1	LINC01681	170240229	170240322	0	94	48	2807	48	2713	0.0	0.017692591227423518
chr1	LINC01681	170226918	170227058	0	141	48	2807	48	2666	0.0	0.01800450112528132
chr1	LINC01681	170239969	170240141	0	173	48	2807	48	2634	0.0	0.018223234624145785
chr1	FMO2	171196648	171196811	0	164	0	6211	0	6047	0.0	0.0
chr1	FMO2	171199345	171199488	0	144	0	6211	0	6067	0.0	0.0
chr1	PRRC2C	171589368	171589605	0	238	70197	11736	70197	11498	0.0	6.105148721516786
chr1	PRRC2C	171591151	171591200	0	50	70197	11736	70197	11686	0.0	6.006931370871128
chr1	DARS2	173845228	173845291	434	64	311587	7142	311153	7078	6.78125	43.96058208533484
chr1	DARS2	173850326	173850479	0	154	311587	7142	311587	6988	0.0	44.58886662850601
chr1	SOAT1	179302676	179302802	0	127	16482	7022	16482	6895	0.0	2.3904278462654096
chr1	SOAT1	179323436	179323495	13773	60	16482	7022	2709	6962	229.55	0.3891123240448147
chr1	CACNA1E	181739259	181739269	0	11	0	18323	0	18312	0.0	0.0
chr1	CACNA1E	181750475	181750487	0	13	0	18323	0	18310	0.0	0.0
chr1	CACNA1E	181779442	181779539	0	98	0	18323	0	18225	0.0	0.0
chr1	CACNA1E	181781426	181781523	0	98	0	18323	0	18225	0.0	0.0
chr1	RGSL1	182460623	182460756	0	134	10133	8963	10133	8829	0.0	1.1476950957073282
chr1	RGSL1	182472395	182472557	0	163	10133	8963	10133	8800	0.0	1.1514772727272726
chr1	TSEN15	184093624	184093724	0	101	651	8390	651	8289	0.0	0.07853782120883097
chr1	TSEN15	184095030	184095092	0	63	651	8390	651	8327	0.0	0.07817941635643089
chr1	TSEN15	184058160	184058240	0	81	651	8390	651	8309	0.0	0.07834877843302443
chr1	TSEN15	184070615	184070732	0	118	651	8390	651	8272	0.0	0.07869922630560929
chr1	TSEN15	184054727	184054863	0	137	651	8390	651	8253	0.0	0.07888040712468193
chr1	TSEN15	184072156	184072298	0	143	651	8390	651	8247	0.0	0.07893779556202256
chr1	PRG4	186304107	186304257	2956	151	15859	5062	12903	4911	19.576158940397352	2.6273671350030545
chr1	PRG4	186304793	186304922	0	130	15859	5062	15859	4932	0.0	3.215531224655312
chr1	LINC01036	187092824	187092946	0	123	153	12115	153	11992	0.0	0.012758505670446965
chr1	LINC01036	187326920	187327023	0	104	153	12115	153	12011	0.0	0.012738323203729914
chr1	CFHR2	196949454	196949649	0	196	102	2757	102	2561	0.0	0.03982819211245607
chr1	CFHR2	196950851	196951028	0	178	102	2757	102	2579	0.0	0.039550213260953856
chr1	PTPRC	198694017	198694140	0	124	0	9077	0	8953	0.0	0.0
chr1	PTPRC	198696711	198696909	0	199	0	9077	0	8878	0.0	0.0
chr1	NR5A2	200029032	200029728	0	697	0	7555	0	6858	0.0	0.0
chr1	NR5A2	200039657	200039795	0	139	0	7555	0	7416	0.0	0.0
chr1	AC104461.1	200444613	200444945	0	333	0	4073	0	3740	0.0	0.0
chr1	AC104461.1	200472040	200472119	0	80	0	4073	0	3993	0.0	0.0
chr1	RNPEP	201996146	201996263	0	118	0	3183	0	3065	0.0	0.0
chr1	RNPEP	201997318	201997554	0	237	0	3183	0	2946	0.0	0.0
chr1	RNPEP	201989382	201989531	0	150	0	3183	0	3033	0.0	0.0
chr1	RNPEP	201999901	202000015	0	115	0	3183	0	3068	0.0	0.0
chr1	MDM4	204526359	204526434	2083	76	7363	10513	5280	10437	27.407894736842106	0.5058924978442081
chr1	MDM4	204537458	204537497	0	40	7363	10513	7363	10473	0.0	0.7030459276234126
chr1	NFASC	204991291	204991306	0	16	8857	21307	8857	21291	0.0	0.4159973697806585
chr1	NFASC	205002595	205002748	0	154	8857	21307	8857	21153	0.0	0.4187112939063017
chr1	AC119673.2	205836238	205836303	0	66	15286	5942	15286	5876	0.0	2.60142954390742
chr1	AC119673.2	205853787	205853874	0	88	15286	5942	15286	5854	0.0	2.611206012982576
chr1	AC119673.2	205858142	205858320	663	179	15286	5942	14623	5763	3.7039106145251397	2.5373937185493665
chr1	AC119673.2	205858142	205858289	510	148	15286	5942	14776	5794	3.445945945945946	2.5502243700379705
chr1	CD55	207340390	207340508	0	119	768	5771	768	5652	0.0	0.13588110403397027
chr1	CD55	207347446	207347561	0	116	768	5771	768	5655	0.0	0.13580901856763924
chr1	CD55	207354006	207354099	0	94	768	5771	768	5677	0.0	0.1352827197463449
chr1	CR1	207526752	207526929	0	178	2089	12631	2089	12453	0.0	0.1677507427929013
chr1	CR1	207545307	207545484	0	178	2089	12631	2089	12453	0.0	0.1677507427929013
chr1	CR1	207523610	207524009	0	400	2089	12631	2089	12231	0.0	0.17079551958139155
chr1	CR1	207542181	207542580	0	400	2089	12631	2089	12231	0.0	0.17079551958139155
chr1	CR1	207560738	207561137	0	400	2089	12631	2089	12231	0.0	0.17079551958139155
chr1	CR1L	207708177	207708263	0	87	0	2786	0	2699	0.0	0.0
chr1	CR1L	207715311	207715397	0	87	0	2786	0	2699	0.0	0.0
chr1	CD46	207767778	207767823	0	46	0	7781	0	7735	0.0	0.0
chr1	CD46	207770320	207770362	0	43	0	7781	0	7738	0.0	0.0
chr1	MIR205HG	209430424	209430500	0	77	0	2601	0	2524	0.0	0.0
chr1	MIR205HG	209431742	209431825	0	84	0	2601	0	2517	0.0	0.0
chr1	MIR205HG	209430424	209430476	0	53	0	2601	0	2548	0.0	0.0
chr1	SYT14	209953054	209953259	2788	206	61132	13990	58344	13784	13.533980582524272	4.232733604178758
chr1	SYT14	209965892	209966013	0	122	61132	13990	61132	13868	0.0	4.408133833285261
chr1	LINC00467	211384441	211384534	0	94	18341	6958	18341	6864	0.0	2.6720571095571097
chr1	LINC00467	211390563	211390670	0	108	18341	6958	18341	6850	0.0	2.6775182481751827
chr1	LINC00467	211399376	211399437	0	62	18341	6958	18341	6896	0.0	2.65965777262181
chr1	LINC00467	211422538	211422639	0	102	18341	6958	18341	6856	0.0	2.6751750291715286
chr1	LINC00467	211422538	211422700	0	163	18341	6958	18341	6795	0.0	2.6991905813097867
chr1	LINC00467	211422538	211422670	0	133	18341	6958	18341	6825	0.0	2.6873260073260075
chr1	LINC01693	211639971	211640189	0	219	0	2205	0	1986	0.0	0.0
chr1	LINC01693	211640218	211640360	0	143	0	2205	0	2062	0.0	0.0
chr1	LINC01693	211639996	211640189	0	194	0	2205	0	2011	0.0	0.0
chr1	LINC01693	211640246	211640360	0	115	0	2205	0	2090	0.0	0.0
chr1	LINC01693	211643292	211643431	0	140	0	2205	0	2065	0.0	0.0
chr1	LINC01693	211639971	211640360	0	390	0	2205	0	1815	0.0	0.0
chr1	LINC01693	211650737	211650815	0	79	0	2205	0	2126	0.0	0.0
chr1	TATDN3	212797111	212797196	0	86	6110	3983	6110	3897	0.0	1.5678727226071336
chr1	TATDN3	212802700	212802763	0	64	6110	3983	6110	3919	0.0	1.559071191630518
chr1	RPS6KC1	213071005	213071041	1978	37	14927	6207	12949	6170	53.45945945945946	2.09870340356564
chr1	RPS6KC1	213077695	213077816	0	122	14927	6207	14927	6085	0.0	2.4530813475760067
chr1	MARK1	220529671	220529771	0	101	51	13355	51	13254	0.0	0.003847894975101856
chr1	MARK1	220576645	220576736	0	92	51	13355	51	13263	0.0	0.0038452838724270526
chr1	DISP1	222872270	222872428	0	159	44838	10206	44838	10047	0.0	4.462824723798149
chr1	DISP1	222899780	222899865	0	86	44838	10206	44838	10120	0.0	4.430632411067194
chr1	FBXO28	224134073	224134212	0	140	18549	6025	18549	5885	0.0	3.151911639762107
chr1	FBXO28	224153141	224153337	160	197	18549	6025	18389	5828	0.8121827411167513	3.1552848318462594
chr1	DNAH14	225338060	225338182	81	123	2459	19791	2378	19668	0.6585365853658537	0.12090705714866788
chr1	DNAH14	225338258	225338287	0	30	2459	19791	2459	19761	0.0	0.12443702241789383
chr1	DNAH14	225123526	225123614	0	89	2459	19791	2459	19702	0.0	0.1248096639935032
chr1	DNAH14	225140730	225141021	21	292	2459	19791	2438	19499	0.07191780821917808	0.12503205292579106
chr1	AC099066.2	225710502	225710568	0	67	100944	3554	100944	3487	0.0	28.948666475480355
chr1	AC099066.2	225738094	225738197	0	104	100944	3554	100944	3450	0.0	29.25913043478261
chr1	SRP9	225786861	225786985	0	125	1069	2226	1069	2101	0.0	0.5088053307948596
chr1	SRP9	225789033	225789141	0	109	1069	2226	1069	2117	0.0	0.504959848842702
chr1	TSNAX-DISC1	231561127	231561255	378	129	14587	4222	14209	4093	2.9302325581395348	3.471536770095285
chr1	TSNAX-DISC1	231616643	231616906	0	264	14587	4222	14587	3958	0.0	3.68544719555331
chr1	DISC1	231795241	231795296	0	56	50684	12565	50684	12509	0.0	4.051802702054521
chr1	DISC1	231800107	231800210	0	104	50684	12565	50684	12461	0.0	4.067410320199021
chr1	DISC1	231701954	231702024	13106	71	50684	12565	37578	12494	184.59154929577466	3.0076836881703217
chr1	DISC1	231749925	231750076	0	152	50684	12565	50684	12413	0.0	4.083138644968984
chr1	DISC1	231767139	231767269	0	131	50684	12565	50684	12434	0.0	4.076242560720605
chr1	TBCE	235401502	235401587	0	86	14167	8049	14167	7963	0.0	1.7791033530076605
chr1	TBCE	235414432	235414618	0	187	14167	8049	14167	7862	0.0	1.801958789112185
chr1	AL357556.3	235342835	235342883	0	49	11600	5210	11600	5161	0.0	2.2476264289866306
chr1	AL357556.3	235363013	235363128	100	116	11600	5210	11500	5094	0.8620689655172413	2.2575579112681585
chr1	AL357556.3	235335241	235335334	255	94	11600	5210	11345	5116	2.7127659574468086	2.217552775605942
chr1	TBCE	235419472	235419561	157	90	14167	8049	14010	7959	1.7444444444444445	1.760271390878251
chr1	TBCE	235427139	235427239	0	101	14167	8049	14167	7948	0.0	1.7824609964771012
chr1	TBCE	235414432	235414469	0	38	14167	8049	14167	8011	0.0	1.7684433903382848
chr1	TBCE	235413875	235413997	0	123	14167	8049	14167	7926	0.0	1.7874085288922534
chr1	TBCE	235430704	235430804	0	101	14167	8049	14167	7948	0.0	1.7824609964771012
chr1	TBCE	235434203	235434280	0	78	14167	8049	14167	7971	0.0	1.7773177769414126
chr1	LGALS8	236518423	236518500	0	78	1071	9039	1071	8961	0.0	0.1195179109474389
chr1	LGALS8	236523969	236524061	0	93	1071	9039	1071	8946	0.0	0.11971830985915492
chr1	LGALS8	236525423	236525545	0	123	1071	9039	1071	8916	0.0	0.12012113055181696
chr1	ACTN2	236734432	236734518	0	87	54026	5985	54026	5898	0.0	9.160054255679892
chr1	ACTN2	236735634	236735720	820	87	54026	5985	53206	5898	9.425287356321839	9.021024075957952
chr1	ACTN2	236737121	236737214	0	94	54026	5985	54026	5891	0.0	9.17093872008148
chr1	RYR2	237743599	237743623	0	25	674	17966	674	17941	0.0	0.03756758263196031
chr1	RYR2	237755060	237755117	0	58	674	17966	674	17908	0.0	0.03763681036408309
chr1	EXO1	241852291	241852411	0	121	16	4110	16	3989	0.0	0.004011030333416896
chr1	EXO1	241853357	241853481	0	125	16	4110	16	3985	0.0	0.004015056461731493
chr1	EXO1	241853357	241853472	0	116	16	4110	16	3994	0.0	0.00400600901352028
chr1	CATSPERE	244499001	244499079	0	79	59291	4458	59291	4379	0.0	13.539849280657684
chr1	CATSPERE	244518591	244518698	0	108	59291	4458	59291	4350	0.0	13.630114942528735
chr1	EFCAB2	245002120	245002232	106	113	108001	8154	107895	8041	0.9380530973451328	13.41810720059694
chr1	EFCAB2	245017241	245017326	107792	86	108001	8154	209	8068	1253.3953488372092	0.0259048091224591
chr1	GCSAML	247549044	247549220	0	177	3533	4690	3533	4513	0.0	0.7828495457567028
chr1	GCSAML	247556406	247556466	0	61	3533	4690	3533	4629	0.0	0.7632317995247354
chr1	AL732372.2	502464	502661	0	198	0	6130	0	5932	0.0	0.0
chr1	AL732372.2	502861	502955	0	95	0	6130	0	6035	0.0	0.0
chr1	C1ORF159	1105955	1106049	0	95	510	4115	510	4020	0.0	0.12686567164179105
chr1	C1ORF159	1115021	1115075	0	55	510	4115	510	4060	0.0	0.12561576354679804
chr1	C1ORF159	1090875	1090983	340	109	510	4115	170	4006	3.1192660550458715	0.042436345481777334
chr1	C1ORF159	1091277	1091374	0	98	510	4115	510	4017	0.0	0.12696041822255413
chr1	UBE2J2	1264782	1264830	0	49	354458	4676	354458	4627	0.0	76.60644045818024
chr1	UBE2J2	1266097	1266290	0	194	354458	4676	354458	4482	0.0	79.08478357875948
chr1	INTS11	1321907	1321984	13947	78	392827	6765	378880	6687	178.80769230769232	56.659189472110064
chr1	INTS11	1323180	1323287	139409	108	392827	6765	253418	6657	1290.8240740740741	38.067898452756495
chr1	INTS11	1320995	1321093	40	99	392827	6765	392787	6666	0.40404040404040403	58.923942394239425
chr1	INTS11	1319295	1319524	255	230	392827	6765	392572	6535	1.108695652173913	60.07222647283856
chr1	INTS11	1323146	1323287	159009	142	392827	6765	233818	6623	1119.781690140845	35.303940812320704
chr1	INTS11	1322891	1323287	189241	397	392827	6765	203586	6368	476.67758186397987	31.970163316582916
chr1	CDK11B	1645459	1645508	384	50	227309	3502	226925	3452	7.68	65.73725376593279
chr1	CDK11B	1645578	1645643	306	66	227309	3502	227003	3436	4.636363636363637	66.06606519208381
chr1	CDK11B	1645997	1646048	383	52	227309	3502	226926	3450	7.365384615384615	65.77565217391304
chr1	CDK11B	1646125	1646143	49	19	227309	3502	227260	3483	2.5789473684210527	65.24834912431811
chr1	MEGF6	3546997	3547123	0	127	2751	9060	2751	8933	0.0	0.30795925221090337
chr1	MEGF6	3579824	3579929	0	106	2751	9060	2751	8954	0.0	0.3072369890551709
chr1	MEGF6	3493770	3493797	0	28	2751	9060	2751	9032	0.0	0.3045837023914969
chr1	MEGF6	3493995	3494124	153	130	2751	9060	2598	8930	1.176923076923077	0.29092945128779396
chr1	TP73-AS1	3741219	3741373	1040	155	120321	6550	119281	6395	6.709677419354839	18.652228303362
chr1	TP73-AS1	3742429	3742517	281	89	120321	6550	120040	6461	3.157303370786517	18.579167311561676
chr1	TNFRSF25	6462628	6462663	0	36	373	3596	373	3560	0.0	0.1047752808988764
chr1	TNFRSF25	6464551	6464719	4	169	373	3596	369	3427	0.023668639053254437	0.10767435074409104
chr1	DNAJC11	6651016	6651180	63243	165	109231	5102	45988	4937	383.2909090909091	9.314968604415638
chr1	DNAJC11	6651528	6651602	8434	75	109231	5102	100797	5027	112.45333333333333	20.051123930773823
chr1	ENO1	8870451	8870510	0	60	2034	4608	2034	4548	0.0	0.4472295514511873
chr1	ENO1	8870824	8870883	0	60	2034	4608	2034	4548	0.0	0.4472295514511873
chr1	SPATA21	16410777	16410915	0	139	44	4528	44	4389	0.0	0.010025062656641603
chr1	SPATA21	16421508	16421557	0	50	44	4528	44	4478	0.0	0.00982581509602501
chr1	CROCCP3	16486425	16486661	405	237	63774	5234	63369	4997	1.7088607594936709	12.681408845307184
chr1	CROCCP3	16489684	16489791	0	108	63774	5234	63774	5126	0.0	12.441279750292626
chr1	AKR7A2	19307313	19307410	0	98	20	1788	20	1690	0.0	0.011834319526627219
chr1	AKR7A2	19308157	19308262	0	106	20	1788	20	1682	0.0	0.011890606420927468
chr1	EIF4G3	20982387	20982408	60	22	308882	9643	308822	9621	2.727272727272727	32.09874233447667
chr1	EIF4G3	20997600	20997633	0	34	308882	9643	308882	9609	0.0	32.14507232802581
chr1	EIF4G3	21001198	21001312	0	115	308882	9643	308882	9528	0.0	32.41834592779177
chr1	RHCE	25375348	25375428	0	81	0	2447	0	2366	0.0	0.0
chr1	RHCE	25385710	25385844	0	135	0	2447	0	2312	0.0	0.0
chr1	UBXN11	26294204	26294331	0	128	17300	4722	17300	4594	0.0	3.7657814540705266
chr1	UBXN11	26296918	26296995	0	78	17300	4722	17300	4644	0.0	3.7252368647717486
chr1	EYA3	28042570	28042650	0	81	4501	6293	4501	6212	0.0	0.7245653573728268
chr1	EYA3	28048382	28048426	0	45	4501	6293	4501	6248	0.0	0.7203905249679897
chr1	ADGRB2	31742837	31743002	255	166	246166	7790	245911	7624	1.536144578313253	32.25485309548793
chr1	ADGRB2	31744192	31744357	61441	166	246166	7790	184725	7624	370.1265060240964	24.229407135362013
chr1	PTP4A2	31910037	31910112	0	76	0	6592	0	6516	0.0	0.0
chr1	PTP4A2	31911695	31911826	0	132	0	6592	0	6460	0.0	0.0
chr1	PTP4A2	31915894	31915987	0	94	0	6592	0	6498	0.0	0.0
chr1	BSDC1	32383829	32383939	235	111	7016	6752	6781	6641	2.1171171171171173	1.0210811624755307
chr1	BSDC1	32386778	32386895	5	118	7016	6752	7011	6634	0.0423728813559322	1.0568284594513113
chr1	BSDC1	32383829	32383997	255	169	7016	6752	6761	6583	1.5088757396449703	1.0270393437642413
chr1	BSDC1	32381213	32381268	179	56	7016	6752	6837	6696	3.1964285714285716	1.021057347670251
chr1	ZBTB8OS	32631826	32631879	3034	54	45880	3541	42846	3487	56.18518518518518	12.287353025523373
chr1	ZBTB8OS	32633261	32633354	0	94	45880	3541	45880	3447	0.0	13.310124746156077
chr1	KIAA0319L	35470862	35470960	494	99	20963	9295	20469	9196	4.98989898989899	2.2258590691605047
chr1	KIAA0319L	35474804	35474906	0	103	20963	9295	20963	9192	0.0	2.280570060922541
chr1	OSCP1	36444003	36444033	0	31	7887	2655	7887	2624	0.0	3.0057164634146343
chr1	OSCP1	36447812	36447887	51	76	7887	2655	7836	2579	0.6710526315789473	3.038386971694455
chr1	MEAF6	37496546	37496604	0	59	153	2301	153	2242	0.0	0.06824264049955397
chr1	MEAF6	37496706	37496736	0	31	153	2301	153	2270	0.0	0.06740088105726873
chr1	EPHA10	37722005	37722296	0	292	3	8168	3	7876	0.0	0.0003809040121889284
chr1	EPHA10	37722804	37722931	0	128	3	8168	3	8040	0.0	0.00037313432835820896
chr1	PPIEL	39549789	39549896	0	108	5231	3504	5231	3396	0.0	1.5403415783274441
chr1	PPIEL	39553117	39553144	0	28	5231	3504	5231	3476	0.0	1.504890678941312
chr1	PPIEL	39523561	39523697	0	137	5231	3504	5231	3367	0.0	1.5536085536085535
chr1	PPIEL	39524835	39525057	102	223	5231	3504	5129	3281	0.45739910313901344	1.5632429137458093
chr1	TRIT1	39844530	39844640	0	111	10332	6546	10332	6435	0.0	1.6055944055944056
chr1	TRIT1	39847219	39847297	0	79	10332	6546	10332	6467	0.0	1.5976496056904284
chr1	TRIT1	39847547	39847660	174	114	10332	6546	10158	6432	1.5263157894736843	1.5792910447761195
chr1	TRIT1	39864709	39865667	816	959	10332	6546	9516	5587	0.8508863399374348	1.7032396635045641
chr1	TRIT1	39876061	39876132	2964	72	10332	6546	7368	6474	41.166666666666664	1.1380908248378128
chr1	SCMH1	41151613	41151684	640	72	10699	4464	10059	4392	8.88888888888889	2.2903005464480874
chr1	SCMH1	41159724	41159933	0	210	10699	4464	10699	4254	0.0	2.515044663845792
chr1	ELOVL1	43364927	43365008	0	82	0	2516	0	2434	0.0	0.0
chr1	ELOVL1	43365185	43365376	0	192	0	2516	0	2324	0.0	0.0
chr1	ERI3	44230316	44230470	663	155	5394	2800	4731	2645	4.27741935483871	1.7886578449905481
chr1	ERI3	44232239	44232388	662	150	5394	2800	4732	2650	4.413333333333333	1.7856603773584905
chr1	ERI3	44241914	44242080	0	167	5394	2800	5394	2633	0.0	2.048613748575769
chr1	SPATA6	48413109	48413151	0	43	0	5955	0	5912	0.0	0.0
chr1	SPATA6	48451551	48451600	0	50	0	5955	0	5905	0.0	0.0
chr1	ECHDC2	52897436	52897484	1047	49	61438	10086	60391	10037	21.367346938775512	6.01683770050812
chr1	ECHDC2	52899173	52899224	640	52	61438	10086	60798	10034	12.307692307692308	6.059198724337254
chr1	ECHDC2	52915130	52915292	0	163	61438	10086	61438	9923	0.0	6.19147435251436
chr1	ECHDC2	52917543	52917615	0	73	61438	10086	61438	10013	0.0	6.135823429541596
chr1	LRP8	53271027	53271153	65	127	79251	13559	79186	13432	0.5118110236220472	5.8953245979749855
chr1	LRP8	53271226	53271346	0	121	79251	13559	79251	13438	0.0	5.8975293942550975
chr1	LRP8	53275630	53275753	48	124	79251	13559	79203	13435	0.3870967741935484	5.895273539263119
chr1	LRP8	53280586	53280715	0	130	79251	13559	79251	13429	0.0	5.90148186759997
chr1	LDLRAD1	54012142	54012280	644	139	10460	2382	9816	2243	4.633093525179856	4.376281765492644
chr1	LDLRAD1	54017375	54017427	0	53	10460	2382	10460	2329	0.0	4.491197939029626
chr1	CYB5RL	54187651	54187739	450	89	8687	8739	8237	8650	5.056179775280899	0.9522543352601156
chr1	CYB5RL	54190737	54190896	255	160	8687	8739	8432	8579	1.59375	0.9828651357967129
chr1	SSBP3	54257126	54257186	2	61	16221	3706	16219	3645	0.03278688524590164	4.44965706447188
chr1	SSBP3	54258068	54258149	442	82	16221	3706	15779	3624	5.390243902439025	4.354028697571744
chr1	DHCR24	54877901	54877998	0	98	2550	4979	2550	4881	0.0	0.5224339274738783
chr1	DHCR24	54879748	54879805	0	58	2550	4979	2550	4921	0.0	0.5181873602926235
chr1	AC119674.1	56168238	56168490	0	253	0	6862	0	6609	0.0	0.0
chr1	AC119674.1	56172555	56172666	0	112	0	6862	0	6750	0.0	0.0
chr1	AC119674.1	56253652	56253893	0	242	0	6862	0	6620	0.0	0.0
chr1	AC119674.1	56332292	56332406	0	115	0	6862	0	6747	0.0	0.0
chr1	AC119674.1	56258368	56258500	0	133	0	6862	0	6729	0.0	0.0
chr1	AC119674.1	56304464	56304560	0	97	0	6862	0	6765	0.0	0.0
chr1	AC119674.1	56318385	56318576	0	192	0	6862	0	6670	0.0	0.0
chr1	AC119674.2	56400093	56400267	0	175	0	2666	0	2491	0.0	0.0
chr1	AC119674.2	56478885	56479111	0	227	0	2666	0	2439	0.0	0.0
chr1	AC119674.1	56341660	56341728	0	69	0	6862	0	6793	0.0	0.0
chr1	MYSM1	58668429	58668566	0	138	51	13140	51	13002	0.0	0.003922473465620674
chr1	MYSM1	58668631	58668682	0	52	51	13140	51	13088	0.0	0.0038966992665036677
chr1	LINC01748	60543476	60543521	0	46	0	15481	0	15435	0.0	0.0
chr1	LINC01748	60554472	60554568	0	97	0	15481	0	15384	0.0	0.0
chr1	LINC01748	60573337	60573413	0	77	0	15481	0	15404	0.0	0.0
chr1	LINC01748	60600126	60600250	0	125	0	15481	0	15356	0.0	0.0
chr1	LINC01748	60640010	60640126	0	117	0	15481	0	15364	0.0	0.0
chr1	NFIA-AS2	60963565	60963804	0	240	0	5402	0	5162	0.0	0.0
chr1	NFIA-AS2	60969930	60970065	0	136	0	5402	0	5266	0.0	0.0
chr1	NFIA-AS1	61249947	61249981	0	35	0	846	0	811	0.0	0.0
chr1	NFIA-AS1	61251284	61251369	0	86	0	846	0	760	0.0	0.0
chr1	TM2D1	61723712	61723772	0	61	0	5509	0	5448	0.0	0.0
chr1	TM2D1	61724287	61724425	0	139	0	5509	0	5370	0.0	0.0
chr1	DOCK7	62543655	62543745	0	91	8017	19101	8017	19010	0.0	0.4217254076801683
chr1	DOCK7	62544946	62545039	0	94	8017	19101	8017	19007	0.0	0.4217919713789656
chr1	LINC00466	63171117	63171175	0	59	2776	6950	2776	6891	0.0	0.4028442896531708
chr1	LINC00466	63183439	63183579	0	141	2776	6950	2776	6809	0.0	0.40769569687178736
chr1	LINC00466	63171564	63171681	315	118	2776	6950	2461	6832	2.669491525423729	0.36021662763466045
chr1	LINC00466	63203104	63203167	25	64	2776	6950	2751	6886	0.390625	0.3995062445541679
chr1	LINC00466	63257984	63258050	0	67	2776	6950	2776	6883	0.0	0.4033125090803429
chr1	JAK1	64956933	64957017	0	85	51	11649	51	11564	0.0	0.004410238671739883
chr1	JAK1	65066120	65066176	0	57	51	11649	51	11592	0.0	0.004399585921325052
chr1	PTGER3	70865688	70865833	0	146	86	6851	86	6705	0.0	0.012826249067859806
chr1	PTGER3	70869243	70869319	0	77	86	6851	86	6774	0.0	0.012695600826690287
chr1	AL583808.1	72700939	72701063	0	125	51	2770	51	2645	0.0	0.019281663516068054
chr1	AL583808.1	72735556	72735635	0	80	51	2770	51	2690	0.0	0.01895910780669145
chr1	AL583808.1	72766644	72766687	0	44	51	2770	51	2726	0.0	0.018708730741012473
chr1	AL583808.1	72850749	72850800	0	52	51	2770	51	2718	0.0	0.018763796909492272
chr1	ADGRL4	78921612	78921786	0	175	6644	5737	6644	5562	0.0	1.194534340165408
chr1	ADGRL4	78926885	78927091	0	207	6644	5737	6644	5530	0.0	1.2014466546112115
chr1	ODF2L	86385457	86385590	0	134	61	7821	61	7687	0.0	0.007935475478079875
chr1	ODF2L	86386914	86387086	0	173	61	7821	61	7648	0.0	0.007975941422594142
chr1	LINC02609	90789397	90789487	0	91	51	14100	51	14009	0.0	0.0036405168106217432
chr1	LINC02609	90831929	90832196	0	268	51	14100	51	13832	0.0	0.003687102371312898
chr1	GLMN	92266418	92266492	0	75	5119	2929	5119	2854	0.0	1.7936229852838121
chr1	GLMN	92266539	92266593	0	55	5119	2929	5119	2874	0.0	1.7811412665274877
chr1	CCDC18-AS1	93309714	93309790	911	77	32571	4958	31660	4881	11.831168831168831	6.486375742675682
chr1	CCDC18-AS1	93315148	93315269	0	122	32571	4958	32571	4836	0.0	6.7351116625310175
chr1	CCDC18-AS1	93269682	93269758	0	77	32571	4958	32571	4881	0.0	6.673017824216349
chr1	CCDC18-AS1	93290564	93290686	0	123	32571	4958	32571	4835	0.0	6.736504653567735
chr1	CCDC18-AS1	93311489	93311608	0	120	32571	4958	32571	4838	0.0	6.7323274080198425
chr1	SLC44A3-AS1	94705438	94705557	0	120	9674	10264	9674	10144	0.0	0.9536671924290221
chr1	SLC44A3-AS1	94732257	94732437	0	181	9674	10264	9674	10083	0.0	0.9594366755925816
chr1	SLC44A3-AS1	94770261	94770313	0	53	9674	10264	9674	10211	0.0	0.9474096562530604
chr1	DPH5	101001466	101001544	0	79	0	2126	0	2047	0.0	0.0
chr1	DPH5	101013709	101013818	0	110	0	2126	0	2016	0.0	0.0
chr1	DPH5	101001466	101001587	0	122	0	2126	0	2004	0.0	0.0
chr1	COL11A1	103025799	103025952	0	154	245	8948	245	8794	0.0	0.027859904480327494
chr1	COL11A1	103026215	103026332	0	118	245	8948	245	8830	0.0	0.027746319365798414
chr1	LINC01676	105600630	105600759	0	130	0	3046	0	2916	0.0	0.0
chr1	LINC01676	105603276	105603558	0	283	0	3046	0	2763	0.0	0.0
chr1	LINC01676	105601269	105601385	0	117	0	3046	0	2929	0.0	0.0
chr1	CLCC1	108950308	108950448	160	141	2556	6514	2396	6373	1.1347517730496455	0.3759610858308489
chr1	CLCC1	108962308	108962469	0	162	2556	6514	2556	6352	0.0	0.40239294710327456
chr1	WDR47	109017517	109017601	0	85	3840	4440	3840	4355	0.0	0.8817451205510907
chr1	WDR47	109023354	109023521	0	168	3840	4440	3840	4272	0.0	0.898876404494382
chr1	SLC16A4	110381651	110381795	229	145	2809	3174	2580	3029	1.5793103448275863	0.8517662594915814
chr1	SLC16A4	110382833	110382966	51	134	2809	3174	2758	3040	0.3805970149253731	0.9072368421052631
chr1	DRAM2	111122615	111122643	0	29	0	3309	0	3280	0.0	0.0
chr1	DRAM2	111124741	111124881	0	141	0	3309	0	3168	0.0	0.0
chr1	LINC02884	112238069	112238198	0	130	36782	6272	36782	6142	0.0	5.988603060892218
chr1	LINC02884	112271351	112271605	0	255	36782	6272	36782	6017	0.0	6.113013129466512
chr1	ST7L	112550600	112550693	0	94	0	7822	0	7728	0.0	0.0
chr1	ST7L	112555867	112556018	0	152	0	7822	0	7670	0.0	0.0
chr1	BCL2L15	113881772	113881997	0	226	306	9098	306	8872	0.0	0.03449053201082056
chr1	BCL2L15	113886536	113886658	0	123	306	9098	306	8975	0.0	0.03409470752089137
chr1	CSDE1	114739691	114739890	0	200	0	5803	0	5603	0.0	0.0
chr1	CSDE1	114749820	114750207	0	388	0	5803	0	5415	0.0	0.0
chr1	ATP1A1-AS1	116400895	116401131	0	237	165	13019	165	12782	0.0	0.012908777969018933
chr1	ATP1A1-AS1	116405606	116406148	0	543	165	13019	165	12476	0.0	0.013225392754087848
chr1	ATP1A1-AS1	116406927	116407195	0	269	165	13019	165	12750	0.0	0.012941176470588235
chr1	ATP1A1-AS1	116411260	116411315	0	56	165	13019	165	12963	0.0	0.012728535061328396
chr1	ATP1A1-AS1	116413761	116413913	0	153	165	13019	165	12866	0.0	0.012824498678688016
chr1	LINC01762	116474233	116474338	0	106	0	1769	0	1663	0.0	0.0
chr1	LINC01762	116478051	116478172	0	122	0	1769	0	1647	0.0	0.0
chr1	HMGCS2	119759117	119759282	0	166	238	2575	238	2409	0.0	0.0987961809879618
chr1	HMGCS2	119759863	119759989	0	127	238	2575	238	2448	0.0	0.09722222222222222
chr1	RBM8A	145919186	145919306	195	121	26083	3735	25888	3614	1.6115702479338843	7.163254012174876
chr1	RBM8A	145923508	145923573	4663	66	26083	3735	21420	3669	70.65151515151516	5.838103025347506
chr1	ACP6	147652448	147652549	0	102	51	10129	51	10027	0.0	0.005086267078887005
chr1	ACP6	147652591	147652647	0	57	51	10129	51	10072	0.0	0.0050635424940428915
chr1	AC239809.3	148225075	148225289	0	215	81262	14907	81262	14692	0.0	5.531037299210455
chr1	AC239809.3	148226493	148226621	0	129	81262	14907	81262	14778	0.0	5.498849641358777
chr1	AC239809.3	148226734	148226798	0	65	81262	14907	81262	14842	0.0	5.475138121546961
chr1	AC239809.3	148226100	148226253	0	154	81262	14907	81262	14753	0.0	5.508167830271809
chr1	NBPF14	148535452	148535504	0	53	175958	12061	175958	12008	0.0	14.653397734843438
chr1	NBPF14	148551152	148551261	0	110	175958	12061	175958	11951	0.0	14.723286754246507
chr1	NBPF14	148571681	148571733	125	53	175958	12061	175833	12008	2.358490566037736	14.64298800799467
chr1	NBPF14	148573229	148573338	1104	110	175958	12061	174854	11951	10.036363636363637	14.630909547318216
chr1	NBPF9	149082276	149082430	0	155	298	8033	298	7878	0.0	0.037826859609037825
chr1	NBPF9	149090204	149090428	0	225	298	8033	298	7808	0.0	0.038165983606557374
chr1	NBPF9	149058924	149059097	0	174	298	8033	298	7859	0.0	0.03791831021758493
chr1	NBPF9	149062092	149062265	31	174	298	8033	267	7859	0.1781609195402299	0.03397378801374221
chr1	ANP32E	150230570	150230693	0	124	117	1638	117	1514	0.0	0.0772787318361955
chr1	ANP32E	150231776	150231926	0	151	117	1638	117	1487	0.0	0.07868190988567586
chr1	ANP32E	150229071	150229237	0	167	117	1638	117	1471	0.0	0.07953772943575799
chr1	APH1A	150267715	150267789	74	75	224481	3360	224407	3285	0.9866666666666667	68.31263318112633
chr1	APH1A	150267956	150267991	372	36	224481	3360	224109	3324	10.333333333333334	67.42148014440433
chr1	HORMAD1	150711544	150711571	0	28	354	2428	354	2400	0.0	0.1475
chr1	HORMAD1	150711832	150711853	0	22	354	2428	354	2406	0.0	0.14713216957605985
chr1	SEMA6C	151138008	151138105	4758	98	218031	3937	213273	3839	48.55102040816327	55.5543110184944
chr1	SEMA6C	151138315	151138406	698	92	218031	3937	217333	3845	7.586956521739131	56.52353706111833
chr1	PI4KB	151324744	151324917	0	174	143827	5088	143827	4914	0.0	29.26882376882377
chr1	PI4KB	151326171	151326373	0	203	143827	5088	143827	4885	0.0	29.442579324462642
chr1	PI4KB	151315572	151316509	131360	938	143827	5088	12467	4150	140.04264392324095	3.0040963855421685
chr1	PI4KB	151315572	151315672	31350	101	143827	5088	112477	4987	310.3960396039604	22.554040505313814
chr1	SELENBP1	151369003	151369189	0	187	65782	3236	65782	3049	0.0	21.574942604132502
chr1	SELENBP1	151369441	151369554	0	114	65782	3236	65782	3122	0.0	21.070467648942984
chr1	GATAD2B	153886423	153886521	51	99	41693	9263	41642	9164	0.5151515151515151	4.544085552160628
chr1	GATAD2B	153914673	153914740	3566	68	41693	9263	38127	9195	52.44117647058823	4.146492659053834
chr1	TPM3	154171412	154171488	0	77	183897	14152	183897	14075	0.0	13.06550621669627
chr1	TPM3	154172028	154172104	0	77	183897	14152	183897	14075	0.0	13.06550621669627
chr1	TPM3	154158897	154159048	0	152	183897	14152	183897	14000	0.0	13.1355
chr1	TPM3	154169304	154169383	0	80	183897	14152	183897	14072	0.0	13.068291642978965
chr1	MUC1	155188007	155188063	2406	57	172617	3963	170211	3906	42.21052631578947	43.57680491551459
chr1	MUC1	155188162	155188212	5084	51	172617	3963	167533	3912	99.68627450980392	42.82540899795501
chr1	MUC1	155188007	155188054	2095	48	172617	3963	170522	3915	43.645833333333336	43.556066411238824
chr1	MUC1	155187721	155187858	6982	138	172617	3963	165635	3825	50.594202898550726	43.30326797385621
chr1	MUC1	155187454	155187576	4618	123	172617	3963	167999	3840	37.54471544715447	43.74973958333333
chr1	MUC1	155187454	155187544	4322	91	172617	3963	168295	3872	47.494505494505496	43.46461776859504
chr1	MUC1	155188162	155188285	10468	124	172617	3963	162149	3839	84.41935483870968	42.23730138056786
chr1	MUC1	155188162	155188231	7898	70	172617	3963	164719	3893	112.82857142857142	42.31158489596712
chr1	THBS3	155203512	155203539	773	28	266988	4646	266215	4618	27.607142857142858	57.64724989172802
chr1	THBS3	155204854	155204957	13807	104	266988	4646	253181	4542	132.7596153846154	55.74218405988551
chr1	GBAP1	155217518	155217593	20637	76	270301	3205	249664	3129	271.5394736842105	79.79034835410674
chr1	GBAP1	155217704	155217846	4395	143	270301	3205	265906	3062	30.734265734265733	86.84062704114957
chr1	YY1AP1	155680415	155680456	0	42	9407	4688	9407	4646	0.0	2.0247524752475248
chr1	YY1AP1	155688070	155688201	103	132	9407	4688	9304	4556	0.7803030303030303	2.042142230026339
chr1	SSR2	156011809	156011887	143	79	140240	5038	140097	4959	1.8101265822784811	28.25105868118572
chr1	SSR2	156018269	156018368	7773	100	140240	5038	132467	4938	77.73	26.82604293236128
chr1	CCT3	156337078	156337240	0	163	408	3882	408	3719	0.0	0.10970691045980102
chr1	CCT3	156337676	156337789	0	114	408	3882	408	3768	0.0	0.10828025477707007
chr1	MIR9-1HG	156413412	156413497	0	86	33808	7374	33808	7288	0.0	4.638858397365532
chr1	MIR9-1HG	156414055	156414298	0	244	33808	7374	33808	7130	0.0	4.741654978962131
chr1	MIR9-1HG	156407841	156407975	0	135	33808	7374	33808	7239	0.0	4.670258322972786
chr1	MIR9-1HG	156453130	156453252	13319	123	33808	7374	20489	7251	108.28455284552845	2.825679216659771
chr1	MIR9-1HG	156454642	156454795	0	154	33808	7374	33808	7220	0.0	4.6825484764542935
chr1	MEF2D	156480642	156480777	0	136	5429	3875	5429	3739	0.0	1.4519925113666756
chr1	MEF2D	156480833	156480971	0	139	5429	3875	5429	3736	0.0	1.4531584582441113
chr1	FCRL1	157797758	157797820	0	63	0	3961	0	3898	0.0	0.0
chr1	FCRL1	157797867	157797939	0	73	0	3961	0	3888	0.0	0.0
chr1	LINC01704	158132573	158132656	0	84	12291	2018	12291	1934	0.0	6.355222337125129
chr1	LINC01704	158133114	158133193	0	80	12291	2018	12291	1938	0.0	6.342105263157895
chr1	SNHG28	159838364	159838451	0	88	1229	3025	1229	2937	0.0	0.4184542049710589
chr1	SNHG28	159840710	159840866	0	157	1229	3025	1229	2868	0.0	0.4285216178521618
chr1	SNHG28	159840710	159840881	0	172	1229	3025	1229	2853	0.0	0.4307746232036453
chr1	SNHG28	159840710	159840779	0	70	1229	3025	1229	2955	0.0	0.41590524534686973
chr1	SNHG28	159840768	159840866	0	99	1229	3025	1229	2926	0.0	0.42002734107997264
chr1	IGSF9	159931137	159931261	0	125	205	6448	205	6323	0.0	0.032421318994148345
chr1	IGSF9	159931452	159931603	0	152	205	6448	205	6296	0.0	0.03256035578144854
chr1	AL139011.2	160263264	160263462	1177	199	14777	3223	13600	3024	5.914572864321608	4.497354497354498
chr1	AL139011.2	160278130	160278191	1281	62	14777	3223	13496	3161	20.661290322580644	4.269534957291996
chr1	COPA	160298844	160298991	0	148	25801	7549	25801	7401	0.0	3.486150520199973
chr1	COPA	160299101	160299264	1989	164	25801	7549	23812	7385	12.128048780487806	3.224373730534868
chr1	GPR161	168114455	168114549	0	95	9037	11010	9037	10915	0.0	0.8279431974347229
chr1	GPR161	168134905	168135036	0	132	9037	11010	9037	10878	0.0	0.8307593307593307
chr1	SELP	169611491	169611677	0	187	115	3507	115	3320	0.0	0.03463855421686747
chr1	SELP	169612216	169612402	0	187	115	3507	115	3320	0.0	0.03463855421686747
chr1	SELE	169727738	169727927	0	190	2489	4601	2489	4411	0.0	0.5642711403309907
chr1	SELE	169728057	169728246	0	190	2489	4601	2489	4411	0.0	0.5642711403309907
chr1	AL136114.1	177489598	177489649	0	52	0	2756	0	2704	0.0	0.0
chr1	AL136114.1	177556485	177556556	0	72	0	2756	0	2684	0.0	0.0
chr1	AL136114.1	177399471	177399567	0	97	0	2756	0	2659	0.0	0.0
chr1	LINC01350	185565473	185565696	0	224	0	2415	0	2191	0.0	0.0
chr1	LINC01350	185568863	185568895	0	33	0	2415	0	2382	0.0	0.0
chr1	LINC01350	185622726	185622839	0	114	0	2415	0	2301	0.0	0.0
chr1	LINC01350	185585668	185585783	0	116	0	2415	0	2299	0.0	0.0
chr1	LINC01350	185621460	185621586	0	127	0	2415	0	2288	0.0	0.0
chr1	AL390957.1	192569246	192569304	0	59	859	10139	859	10080	0.0	0.08521825396825397
chr1	AL390957.1	192589025	192589151	0	127	859	10139	859	10012	0.0	0.08579704354774272
chr1	AL353709.1	195754505	195754542	0	38	0	6534	0	6496	0.0	0.0
chr1	AL353709.1	195759333	195759458	0	126	0	6534	0	6408	0.0	0.0
chr1	AL353709.1	195758745	195758810	0	66	0	6534	0	6468	0.0	0.0
chr1	KCNT2	196317173	196317269	0	97	969	7225	969	7128	0.0	0.13594276094276095
chr1	KCNT2	196326716	196326889	0	174	969	7225	969	7051	0.0	0.13742731527442917
chr1	KCNT2	196343055	196343105	0	51	969	7225	969	7174	0.0	0.13507109004739337
chr1	KCNT2	196373139	196373248	0	110	969	7225	969	7115	0.0	0.13619114546732256
chr1	KCNT2	196319483	196319555	0	73	969	7225	969	7152	0.0	0.13548657718120805
chr1	TNNT2	201369815	201369845	0	31	0	5980	0	5949	0.0	0.0
chr1	TNNT2	201372026	201372041	0	16	0	5980	0	5964	0.0	0.0
chr1	KDM5B	202774612	202774735	0	124	219740	17458	219740	17334	0.0	12.676820122302988
chr1	KDM5B	202777016	202777094	0	79	219740	17458	219740	17379	0.0	12.643995626906037
chr1	KLHDC8A	205344133	205344458	0	326	0	3675	0	3349	0.0	0.0
chr1	KLHDC8A	205348375	205348590	0	216	0	3675	0	3459	0.0	0.0
chr1	KLHDC8A	205343228	205343793	0	566	0	3675	0	3109	0.0	0.0
chr1	LEMD1	205384287	205384364	0	78	258	1049	258	971	0.0	0.26570545829042225
chr1	LEMD1	205419229	205419352	0	124	258	1049	258	925	0.0	0.2789189189189189
chr1	CTSE	206012307	206012406	0	100	0	3572	0	3472	0.0	0.0
chr1	CTSE	206012507	206012649	0	143	0	3572	0	3429	0.0	0.0
chr1	AC092810.2	209159483	209159562	0	80	0	3124	0	3044	0.0	0.0
chr1	AC092810.2	209161714	209161841	0	128	0	3124	0	2996	0.0	0.0
chr1	AC092810.2	209151404	209151505	0	102	0	3124	0	3022	0.0	0.0
chr1	AC092810.2	209211755	209211886	0	132	0	3124	0	2992	0.0	0.0
chr1	AC092810.2	209153505	209153750	0	246	0	3124	0	2878	0.0	0.0
chr1	AC092810.2	209153664	209153750	0	87	0	3124	0	3037	0.0	0.0
chr1	AC092810.2	209153571	209153750	0	180	0	3124	0	2944	0.0	0.0
chr1	PROX1-AS1	213915934	213916099	0	166	23	9778	23	9612	0.0	0.00239284228048273
chr1	PROX1-AS1	213966070	213966284	0	215	23	9778	23	9563	0.0	0.0024051030011502665
chr1	PROX1-AS1	213921472	213921580	0	109	23	9778	23	9669	0.0	0.0023787361671320714
chr1	PROX1-AS1	213965303	213965481	0	179	23	9778	23	9599	0.0	0.002396082925304719
chr1	PROX1-AS1	213901294	213901409	0	116	23	9778	23	9662	0.0	0.0023804595321879527
chr1	PROX1-AS1	213966070	213966258	0	189	23	9778	23	9589	0.0	0.002398581708207321
chr1	PROX1-AS1	213843482	213843568	0	87	23	9778	23	9691	0.0	0.002373336085027345
chr1	PROX1-AS1	213876637	213876806	0	170	23	9778	23	9608	0.0	0.0023938384679433804
chr1	PROX1-AS1	213839737	213839797	0	61	23	9778	23	9717	0.0	0.0023669856951734074
chr1	PROX1-AS1	213840680	213840829	0	150	23	9778	23	9628	0.0	0.0023888658080598256
chr1	PROX1-AS1	213842059	213842240	0	182	23	9778	23	9596	0.0	0.0023968320133388914
chr1	PROX1-AS1	213895393	213895518	0	126	23	9778	23	9652	0.0	0.002382925818483216
chr1	PROX1-AS1	213895426	213895518	0	93	23	9778	23	9685	0.0	0.002374806401652039
chr1	PROX1-AS1	213835852	213836054	0	203	23	9778	23	9575	0.0	0.002402088772845953
chr1	PROX1-AS1	213837292	213837295	0	4	23	9778	23	9774	0.0	0.002353181911192961
chr1	PROX1-AS1	213840507	213840600	0	94	23	9778	23	9684	0.0	0.0023750516315572076
chr1	ESRRG	216715073	216715249	0	177	0	10959	0	10782	0.0	0.0
chr1	ESRRG	216865060	216865178	0	119	0	10959	0	10840	0.0	0.0
chr1	ESRRG	216939581	216939673	0	93	0	10959	0	10866	0.0	0.0
chr1	ESRRG	216707358	216707486	0	129	0	10959	0	10830	0.0	0.0
chr1	ESRRG	216714515	216714634	0	120	0	10959	0	10839	0.0	0.0
chr1	LYPLAL1-DT	219149938	219150031	0	94	0	5524	0	5430	0.0	0.0
chr1	LYPLAL1-DT	219156119	219156199	0	81	0	5524	0	5443	0.0	0.0
chr1	TAF1A	222579758	222579872	0	115	175	2904	175	2789	0.0	0.0627465041233417
chr1	TAF1A	222584127	222584297	0	171	175	2904	175	2733	0.0	0.06403219904866447
chr1	TLR5	223137177	223137263	0	87	2024	7742	2024	7655	0.0	0.2644023514043109
chr1	TLR5	223141647	223141763	0	117	2024	7742	2024	7625	0.0	0.26544262295081966
chr1	LINC02765	225450478	225450678	0	201	459	2015	459	1814	0.0	0.25303197353914003
chr1	LINC02765	225462393	225462493	0	101	459	2015	459	1914	0.0	0.23981191222570533
chr1	LINC02765	225461540	225461729	408	190	459	2015	51	1825	2.1473684210526316	0.027945205479452055
chr1	ENAH	225531045	225531057	72	13	1602	15063	1530	15050	5.538461538461538	0.10166112956810631
chr1	ENAH	225535506	225535563	0	58	1602	15063	1602	15005	0.0	0.10676441186271243
chr1	CDC42BPA	227059372	227059389	0	18	40256	13908	40256	13890	0.0	2.898200143988481
chr1	CDC42BPA	227069776	227069853	348	78	40256	13908	39908	13830	4.461538461538462	2.885610990600145
chr1	CDC42BPA	227051880	227051985	0	106	40256	13908	40256	13802	0.0	2.916678742211274
chr1	CDC42BPA	227059372	227059411	0	40	40256	13908	40256	13868	0.0	2.9027978079030863
chr1	MRPL55	228108436	228108474	8	39	6030	1672	6022	1633	0.20512820512820512	3.687691365584813
chr1	MRPL55	228108954	228109021	100	68	6030	1672	5930	1604	1.4705882352941178	3.697007481296758
chr1	MRPL55	228108440	228108508	76	69	6030	1672	5954	1603	1.1014492753623188	3.7142857142857144
chr1	TTC13	230936157	230936264	0	108	135	4237	135	4129	0.0	0.03269556793412449
chr1	TTC13	230939385	230939496	0	112	135	4237	135	4125	0.0	0.03272727272727273
chr1	EGLN1	231367568	231367636	0	69	13421	5387	13421	5318	0.0	2.5236931177134263
chr1	EGLN1	231370561	231370698	0	138	13421	5387	13421	5249	0.0	2.5568679748523526
chr1	AL445524.1	231524282	231524376	0	95	938	4123	938	4028	0.0	0.23286991062562065
chr1	AL445524.1	231524425	231524547	71	123	938	4123	867	4000	0.5772357723577236	0.21675
chr1	RGS7	240800640	240800721	0	82	0	2595	0	2513	0.0	0.0
chr1	RGS7	240801454	240801508	0	55	0	2595	0	2540	0.0	0.0
chr1	AHCTF1	246842693	246842776	495	84	15674	9618	15179	9534	5.892857142857143	1.592091462135515
chr1	AHCTF1	246843794	246843928	0	135	15674	9618	15674	9483	0.0	1.6528524728461458
chr2	SH3YL1	243502	243562	268	61	70692	8808	70424	8747	4.39344262295082	8.051217560306391
chr2	SH3YL1	244626	244738	561	113	70692	8808	70131	8695	4.964601769911504	8.065669925244393
chr2	SH3YL1	242797	242871	722	75	70692	8808	69970	8733	9.626666666666667	8.012137867857552
chr2	AC079779.3	312956	313157	0	202	0	3482	0	3280	0.0	0.0
chr2	AC079779.3	313873	313884	0	12	0	3482	0	3470	0.0	0.0
chr2	AC079779.3	313873	313892	0	20	0	3482	0	3462	0.0	0.0
chr2	MYT1L	1922285	1923263	0	979	51	31707	51	30728	0.0	0.0016597240302004687
chr2	MYT1L	1942981	1943334	0	354	51	31707	51	31353	0.0	0.0016266385991771121
chr2	MYT1L	1979164	1979227	0	64	51	31707	51	31643	0.0	0.0016117308725468508
chr2	EIPR1	3274338	3274419	0	82	2071	5742	2071	5660	0.0	0.36590106007067136
chr2	EIPR1	3318856	3318958	0	103	2071	5742	2071	5639	0.0	0.36726369923745344
chr2	LINC01304	3959563	3960556	0	994	51	6379	51	5385	0.0	0.00947075208913649
chr2	LINC01304	3968178	3968288	0	111	51	6379	51	6268	0.0	0.008136566687938737
chr2	LINC01304	3959915	3960556	0	642	51	6379	51	5737	0.0	0.008889663587240719
chr2	LINC01304	3961769	3961894	0	126	51	6379	51	6253	0.0	0.008156085079162002
chr2	LINC01304	3961769	3961803	0	35	51	6379	51	6344	0.0	0.008039092055485498
chr2	MIR7515HG	6625028	6625145	0	118	11358	7267	11358	7149	0.0	1.5887536718422157
chr2	MIR7515HG	6626136	6626238	0	103	11358	7267	11358	7164	0.0	1.585427135678392
chr2	MIR7515HG	6625028	6625127	0	100	11358	7267	11358	7167	0.0	1.5847634993721222
chr2	MIR7515HG	6618543	6618689	0	147	11358	7267	11358	7120	0.0	1.5952247191011235
chr2	MIR7515HG	6634594	6634733	0	140	11358	7267	11358	7127	0.0	1.5936579205836958
chr2	MIR7515HG	6634799	6634872	0	74	11358	7267	11358	7193	0.0	1.5790351730849437
chr2	MIR7515HG	6647535	6647721	0	187	11358	7267	11358	7080	0.0	1.6042372881355933
chr2	MIR7515HG	6649210	6649263	0	54	11358	7267	11358	7213	0.0	1.5746568695411063
chr2	MIR7515HG	6635575	6635640	0	66	11358	7267	11358	7201	0.0	1.5772809332037216
chr2	MIR7515HG	6638090	6638153	0	64	11358	7267	11358	7203	0.0	1.5768429820907954
chr2	MIR7515HG	6639050	6639273	0	224	11358	7267	11358	7043	0.0	1.6126650575039045
chr2	MIR7515HG	6638966	6639277	0	312	11358	7267	11358	6955	0.0	1.6330697340043134
chr2	MIR7515HG	6639050	6639277	0	228	11358	7267	11358	7039	0.0	1.6135814746412842
chr2	MIR7515HG	6633668	6633969	0	302	11358	7267	11358	6965	0.0	1.6307250538406317
chr2	MIR7515HG	6634799	6634870	0	72	11358	7267	11358	7195	0.0	1.5785962473940236
chr2	MIR7515HG	6634799	6634911	0	113	11358	7267	11358	7154	0.0	1.5876432764886776
chr2	MIR7515HG	6639113	6639277	0	165	11358	7267	11358	7102	0.0	1.5992678118839763
chr2	MIR7515HG	6649210	6649381	0	172	11358	7267	11358	7095	0.0	1.600845665961945
chr2	NRIR	6832478	6832568	0	91	0	2755	0	2664	0.0	0.0
chr2	NRIR	6833313	6833430	0	118	0	2755	0	2637	0.0	0.0
chr2	LINC00299	8037022	8037151	0	130	561	22103	561	21973	0.0	0.02553133390979839
chr2	LINC00299	8060347	8060405	0	59	561	22103	561	22044	0.0	0.025449101796407185
chr2	MBOAT2	8862270	8862322	0	53	8650	8666	8650	8613	0.0	1.0042958318820387
chr2	MBOAT2	8862589	8862722	17	134	8650	8666	8633	8532	0.12686567164179105	1.0118377871542428
chr2	MBOAT2	8958496	8958642	0	147	8650	8666	8650	8519	0.0	1.0153773917126423
chr2	MBOAT2	8974358	8974435	0	78	8650	8666	8650	8588	0.0	1.0072193758733117
chr2	ITGB1BP1	9414177	9414256	0	80	918	6364	918	6284	0.0	0.1460852959898154
chr2	ITGB1BP1	9418625	9418732	0	108	918	6364	918	6256	0.0	0.14673913043478262
chr2	ITGB1BP1	9419989	9420100	0	112	918	6364	918	6252	0.0	0.14683301343570057
chr2	AC064875.1	12972531	12972586	0	56	9203	4174	9203	4118	0.0	2.2348227294803302
chr2	AC064875.1	12981036	12981118	0	83	9203	4174	9203	4091	0.0	2.249572231728184
chr2	HS1BP3	20640972	20641180	0	209	51	10915	51	10706	0.0	0.0047636839155613675
chr2	HS1BP3	20645339	20645505	0	167	51	10915	51	10748	0.0	0.004745068850018608
chr2	LDAH	20790254	20790398	0	145	3129	3421	3129	3276	0.0	0.9551282051282052
chr2	LDAH	20801291	20801465	315	175	3129	3421	2814	3246	1.8	0.866913123844732
chr2	LDAH	20801309	20801465	255	157	3129	3421	2874	3264	1.624203821656051	0.8805147058823529
chr2	DTNB	25383835	25383889	0	55	57218	7172	57218	7117	0.0	8.039623436841365
chr2	DTNB	25387288	25387378	0	91	57218	7172	57218	7081	0.0	8.080497104928682
chr2	DTNB	25596085	25596240	255	156	57218	7172	56963	7016	1.6346153846153846	8.119013683010262
chr2	DTNB	25607235	25607321	51	87	57218	7172	57167	7085	0.5862068965517241	8.068736767819336
chr2	KIF3C	25934032	25934156	0	125	3400	6411	3400	6286	0.0	0.5408845052497614
chr2	KIF3C	25938234	25938348	0	115	3400	6411	3400	6296	0.0	0.5400254129606099
chr2	SLC5A6	27208393	27208448	0	56	262	5118	262	5062	0.0	0.05175819834057685
chr2	SLC5A6	27208613	27208686	0	74	262	5118	262	5044	0.0	0.05194290245836638
chr2	MPV17	27312993	27313109	490	117	55871	4256	55381	4139	4.188034188034188	13.380285093017637
chr2	MPV17	27317077	27317234	714	158	55871	4256	55157	4098	4.518987341772152	13.45949243533431
chr2	MPV17	27312993	27313074	140	82	55871	4256	55731	4174	1.7073170731707317	13.351940584571155
chr2	MPV17	27312993	27313154	510	162	55871	4256	55361	4094	3.1481481481481484	13.52247191011236
chr2	GTF3C2	27350313	27350632	0	320	90796	5782	90796	5462	0.0	16.62321493958257
chr2	GTF3C2	27356086	27356186	33198	101	90796	5782	57598	5681	328.6930693069307	10.138707973948248
chr2	RBKS	27861412	27861546	0	135	56814	3164	56814	3029	0.0	18.756685374711125
chr2	RBKS	27869771	27870890	55633	1120	56814	3164	1181	2044	49.67232142857143	0.5777886497064579
chr2	AC092164.1	28731665	28731737	0	73	0	5024	0	4951	0.0	0.0
chr2	AC092164.1	28731910	28731983	0	74	0	5024	0	4950	0.0	0.0
chr2	GALNT14	30992837	30993007	0	171	13679	4371	13679	4200	0.0	3.256904761904762
chr2	GALNT14	31114742	31114827	0	86	13679	4371	13679	4285	0.0	3.192298716452742
chr2	GALNT14	31125153	31125253	0	101	13679	4371	13679	4270	0.0	3.203512880562061
chr2	GALNT14	31132629	31132712	0	84	13679	4371	13679	4287	0.0	3.190809423839515
chr2	ATL2	38343267	38343512	0	246	3491650	5619	3491650	5373	0.0	649.8511073887959
chr2	ATL2	38354066	38354177	0	112	3491650	5619	3491650	5507	0.0	634.0384964590521
chr2	ATL2	38358442	38358688	0	247	3491650	5619	3491650	5372	0.0	649.9720774385704
chr2	LINC02613	38424421	38424469	0	49	51	5399	51	5350	0.0	0.009532710280373832
chr2	LINC02613	38456318	38456390	0	73	51	5399	51	5326	0.0	0.009575666541494556
chr2	SLC8A1	40175260	40175281	0	22	0	21938	0	21916	0.0	0.0
chr2	SLC8A1	40177751	40177855	0	105	0	21938	0	21833	0.0	0.0
chr2	LINC01819	43032733	43032902	0	170	318	3848	318	3678	0.0	0.0864600326264274
chr2	LINC01819	43033229	43033526	12	298	318	3848	306	3550	0.040268456375838924	0.08619718309859155
chr2	LINC01819	43033229	43033409	12	181	318	3848	306	3667	0.06629834254143646	0.08344695936733024
chr2	THADA	43428099	43428231	0	133	2289	14267	2289	14134	0.0	0.16194990802320644
chr2	THADA	43485233	43485325	0	93	2289	14267	2289	14174	0.0	0.16149287427684492
chr2	PREPL	44332458	44332656	0	199	51	6296	51	6097	0.0	0.008364769558799409
chr2	PREPL	44338350	44338536	0	187	51	6296	51	6109	0.0	0.008348338516942217
chr2	LINC01820	46393112	46393194	0	83	0	640	0	557	0.0	0.0
chr2	LINC01820	46393222	46393345	0	124	0	640	0	516	0.0	0.0
chr2	PIGF	46588074	46588179	37100	106	142714	3770	105614	3664	350.0	28.824781659388645
chr2	PIGF	46591802	46591925	0	124	142714	3770	142714	3646	0.0	39.14262205156336
chr2	MCFD2	46910779	46910873	0	95	51	5539	51	5444	0.0	0.009368111682586333
chr2	MCFD2	46912542	46912658	0	117	51	5539	51	5422	0.0	0.009406123201770564
chr2	PSME4	53869375	53869538	0	164	23649	10440	23649	10276	0.0	2.301381860646166
chr2	PSME4	53874338	53874494	0	157	23649	10440	23649	10283	0.0	2.299815229018769
chr2	CCDC88A	55303068	55303152	0	85	3693	27139	3693	27054	0.0	0.13650476824129518
chr2	CCDC88A	55308808	55309023	0	216	3693	27139	3693	26923	0.0	0.13716896333989526
chr2	CCDC88A	55300252	55300339	0	88	3693	27139	3693	27051	0.0	0.13651990684263057
chr2	CCDC88A	55300956	55300996	0	41	3693	27139	3693	27098	0.0	0.13628312052550004
chr2	CCDC88A	55349517	55349599	0	83	3693	27139	3693	27056	0.0	0.1364946777054997
chr2	CCDC88A	55355578	55355751	0	174	3693	27139	3693	26965	0.0	0.13695531244205453
chr2	CCDC88A	55362307	55362448	0	142	3693	27139	3693	26997	0.0	0.13679297699744417
chr2	EFEMP1	55922609	55922747	0	139	2254	3973	2254	3834	0.0	0.5878977569118414
chr2	EFEMP1	55922898	55922939	0	42	2254	3973	2254	3931	0.0	0.5733909946578479
chr2	AC007179.2	59249488	59249693	0	206	0	5116	0	4910	0.0	0.0
chr2	AC007179.2	59384623	59384793	0	171	0	5116	0	4945	0.0	0.0
chr2	AC007179.2	59240992	59241103	0	112	0	5116	0	5004	0.0	0.0
chr2	AC007179.2	59240289	59240341	0	53	0	5116	0	5063	0.0	0.0
chr2	AC007179.2	59240920	59241103	0	184	0	5116	0	4932	0.0	0.0
chr2	BCL11A	60478163	60478239	0	77	0	10714	0	10637	0.0	0.0
chr2	BCL11A	60508605	60508824	0	220	0	10714	0	10494	0.0	0.0
chr2	XPO1	61534422	61534518	0	97	13238	18326	13238	18229	0.0	0.7262054967359701
chr2	XPO1	61537561	61537587	0	27	13238	18326	13238	18299	0.0	0.7234275096999836
chr2	AC092155.1	62625126	62625220	0	95	288	7620	288	7525	0.0	0.038272425249169434
chr2	AC092155.1	62629352	62629476	0	125	288	7620	288	7495	0.0	0.03842561707805203
chr2	AC092155.1	62624952	62625011	37	60	288	7620	251	7560	0.6166666666666667	0.0332010582010582
chr2	AC092155.1	62629352	62629460	0	109	288	7620	288	7511	0.0	0.038343762481693515
chr2	AC092155.1	62613605	62613702	0	98	288	7620	288	7522	0.0	0.03828768944429673
chr2	AC092155.1	62629352	62629444	0	93	288	7620	288	7527	0.0	0.038262255878836186
chr2	LGALSL-DT	64420227	64420300	0	74	0	3203	0	3129	0.0	0.0
chr2	LGALSL-DT	64439902	64439974	0	73	0	3203	0	3130	0.0	0.0
chr2	RAB1A	65088938	65089070	0	133	1581	3321	1581	3188	0.0	0.49592220828105393
chr2	RAB1A	65097970	65098066	0	97	1581	3321	1581	3224	0.0	0.49038461538461536
chr2	PCBP1-AS1	69988445	69988505	42	61	234223	25966	234181	25905	0.6885245901639344	9.039992279482725
chr2	PCBP1-AS1	69988741	69988838	80	98	234223	25966	234143	25868	0.8163265306122449	9.051453533323025
chr2	PCBP1-AS1	70018014	70018131	102	118	234223	25966	234121	25848	0.864406779661017	9.057606004333024
chr2	PCBP1-AS1	70032132	70032255	0	124	234223	25966	234223	25842	0.0	9.063656063772154
chr2	PCBP1-AS1	70011654	70011752	0	99	234223	25966	234223	25867	0.0	9.054896199791239
chr2	PCBP1-AS1	70003045	70003315	0	271	234223	25966	234223	25695	0.0	9.11550885386262
chr2	PCBP1-AS1	69997912	69998134	0	223	234223	25966	234223	25743	0.0	9.098512216913335
chr2	PCBP1-AS1	70077300	70077381	60	82	234223	25966	234163	25884	0.7317073170731707	9.046631123473961
chr2	PCBP1-AS1	70081369	70081490	0	122	234223	25966	234223	25844	0.0	9.06295465098282
chr2	PCBP1-AS1	69964230	69964427	0	198	234223	25966	234223	25768	0.0	9.089684880471903
chr2	PCBP1-AS1	69975558	69975635	842	78	234223	25966	233381	25888	10.794871794871796	9.015026266996292
chr2	PCBP1-AS1	69964368	69964427	0	60	234223	25966	234223	25906	0.0	9.041264571913842
chr2	PCBP1-AS1	70055713	70055910	0	198	234223	25966	234223	25768	0.0	9.089684880471903
chr2	PCBP1-AS1	70059642	70059680	0	39	234223	25966	234223	25927	0.0	9.03394145099703
chr2	PCBP1-AS1	70055655	70055910	0	256	234223	25966	234223	25710	0.0	9.110190587320108
chr2	PCBP1-AS1	69968398	69968520	0	123	234223	25966	234223	25843	0.0	9.063305343806833
chr2	PCBP1-AS1	70051202	70051305	0	104	234223	25966	234223	25862	0.0	9.056646817724847
chr2	PCBP1-AS1	69996685	69996888	0	204	234223	25966	234223	25762	0.0	9.091801878736122
chr2	PCBP1-AS1	70083506	70083687	0	182	234223	25966	234223	25784	0.0	9.084044368600683
chr2	PCBP1-AS1	70011654	70011718	0	65	234223	25966	234223	25901	0.0	9.043009922396818
chr2	PCBP1-AS1	70015447	70015580	0	134	234223	25966	234223	25832	0.0	9.067164756890678
chr2	PCBP1-AS1	70011654	70011834	0	181	234223	25966	234223	25785	0.0	9.083692069032383
chr2	PCBP1-AS1	70083537	70083687	0	151	234223	25966	234223	25815	0.0	9.073135773774936
chr2	PCBP1-AS1	69996857	69996888	0	32	234223	25966	234223	25934	0.0	9.031503046194185
chr2	PCBP1-AS1	70053730	70053792	0	63	234223	25966	234223	25903	0.0	9.042311701347334
chr2	PCBP1-AS1	70053730	70053815	0	86	234223	25966	234223	25880	0.0	9.050347758887172
chr2	SFXN5	72961130	72961248	0	119	3820	11003	3820	10884	0.0	0.3509739066519662
chr2	SFXN5	72968447	72968533	1954	87	3820	11003	1866	10916	22.45977011494253	0.17094173689996336
chr2	SLC4A5	74222867	74222952	0	86	16945	6641	16945	6555	0.0	2.5850495804729214
chr2	SLC4A5	74224839	74224995	459	157	16945	6641	16486	6484	2.9235668789808917	2.5425663170882173
chr2	DCTN1	74378904	74378972	396	69	331815	9854	331419	9785	5.739130434782608	33.87010730710271
chr2	DCTN1	74390582	74390728	0	147	331815	9854	331815	9707	0.0	34.18306376841455
chr2	MOGS	74463189	74463331	0	143	714	3170	714	3027	0.0	0.2358771060455897
chr2	MOGS	74463379	74463386	64	8	714	3170	650	3162	8.0	0.20556609740670462
chr2	MOGS	74464495	74464722	0	228	714	3170	714	2942	0.0	0.24269204622705642
chr2	MOGS	74464895	74464987	0	93	714	3170	714	3077	0.0	0.23204419889502761
chr2	AC008067.1	80579384	80579483	0	100	0	3369	0	3269	0.0	0.0
chr2	AC008067.1	80605160	80605307	0	148	0	3369	0	3221	0.0	0.0
chr2	ST3GAL5	85852859	85853091	0	233	273942	15937	273942	15704	0.0	17.444090677534387
chr2	ST3GAL5	85858133	85858247	0	115	273942	15937	273942	15822	0.0	17.313993174061434
chr2	ST3GAL5	85852859	85853099	0	241	273942	15937	273942	15696	0.0	17.452981651376145
chr2	ST3GAL5	85852859	85853000	0	142	273942	15937	273942	15795	0.0	17.343589743589742
chr2	ST3GAL5	85861180	85861292	21	113	273942	15937	273921	15824	0.18584070796460178	17.31047775530839
chr2	ST3GAL5	85863361	85863485	0	125	273942	15937	273942	15812	0.0	17.32494308120415
chr2	ST3GAL5	85870071	85870258	51	188	273942	15937	273891	15749	0.2712765957446808	17.391008952949395
chr2	ST3GAL5	85875414	85875545	765	132	273942	15937	273177	15805	5.795454545454546	17.284213856374564
chr2	ST3GAL5	85847860	85848204	75	345	273942	15937	273867	15592	0.21739130434782608	17.56458440225757
chr2	IMMT	86170748	86170841	0	94	204	3687	204	3593	0.0	0.05677706651822989
chr2	IMMT	86171207	86171312	0	106	204	3687	204	3581	0.0	0.056967327562133484
chr2	CD8A	86789322	86789433	740	112	33495	3058	32755	2946	6.607142857142857	11.11846571622539
chr2	CD8A	86789639	86789750	0	112	33495	3058	33495	2946	0.0	11.369653767820774
chr2	ANKRD36C	95918013	95918042	0	30	6954	8656	6954	8626	0.0	0.8061674008810573
chr2	ANKRD36C	95919891	95919920	0	30	6954	8656	6954	8626	0.0	0.8061674008810573
chr2	KANSL3	96619358	96619544	0	187	7890	9053	7890	8866	0.0	0.8899165350778254
chr2	KANSL3	96636920	96637185	435	266	7890	9053	7455	8787	1.6353383458646618	0.8484124274496415
chr2	LMAN2L	96713106	96713139	0	34	102	2719	102	2685	0.0	0.03798882681564246
chr2	LMAN2L	96733518	96733601	0	84	102	2719	102	2635	0.0	0.03870967741935484
chr2	AC092683.1	97423801	97423918	0	118	62322	5579	62322	5461	0.0	11.412195568577184
chr2	AC092683.1	97426842	97427127	10704	286	62322	5579	51618	5293	37.42657342657343	9.752125448705838
chr2	TSGA10	99020279	99020482	0	204	7889	5121	7889	4917	0.0	1.6044335977221884
chr2	TSGA10	99035229	99035439	0	211	7889	5121	7889	4910	0.0	1.6067209775967413
chr2	AFF3	100105503	100105583	0	81	19357	15102	19357	15021	0.0	1.28866253911191
chr2	AFF3	100129223	100129306	0	84	19357	15102	19357	15018	0.0	1.288919962711413
chr2	CHST10	100416222	100416525	0	304	0	4387	0	4083	0.0	0.0
chr2	CHST10	100416722	100417070	0	349	0	4387	0	4038	0.0	0.0
chr2	MRPS9-AS1	105098601	105098668	0	68	0	1182	0	1114	0.0	0.0
chr2	MRPS9-AS1	105099247	105099300	0	54	0	1182	0	1128	0.0	0.0
chr2	SEPTIN10	109585125	109585321	0	197	716	3956	716	3759	0.0	0.19047619047619047
chr2	SEPTIN10	109593050	109593119	0	70	716	3956	716	3886	0.0	0.184251158003088
chr2	SEPTIN10	109574580	109574767	0	188	716	3956	716	3768	0.0	0.19002123142250532
chr2	SEPTIN10	109593046	109593119	0	74	716	3956	716	3882	0.0	0.18444100978876868
chr2	MIR4435-2HG	111164903	111165600	0	698	40775	26838	40775	26140	0.0	1.5598699311400153
chr2	MIR4435-2HG	111239801	111239996	0	196	40775	26838	40775	26642	0.0	1.5304781923279034
chr2	MIR4435-2HG	111233627	111233739	0	113	40775	26838	40775	26725	0.0	1.5257249766136576
chr2	MIR4435-2HG	111248147	111248241	0	95	40775	26838	40775	26743	0.0	1.5246980518266462
chr2	MIR4435-2HG	111207719	111208661	0	943	40775	26838	40775	25895	0.0	1.5746283066229
chr2	MIR4435-2HG	111447211	111447349	0	139	40775	26838	40775	26699	0.0	1.5272107569571893
chr2	MIR4435-2HG	111479906	111480061	0	156	40775	26838	40775	26682	0.0	1.528183794318267
chr2	MIR4435-2HG	111377622	111377917	0	296	40775	26838	40775	26542	0.0	1.5362444427699495
chr2	MIR4435-2HG	111274706	111274861	0	156	40775	26838	40775	26682	0.0	1.528183794318267
chr2	MIR4435-2HG	111344060	111344237	0	178	40775	26838	40775	26660	0.0	1.5294448612153038
chr2	MIR4435-2HG	111208755	111208936	2722	182	40775	26838	38053	26656	14.956043956043956	1.4275585234093637
chr2	MIR4435-2HG	111208755	111208977	2722	223	40775	26838	38053	26615	12.20627802690583	1.4297576554574487
chr2	MIR4435-2HG	111330214	111330554	375	341	40775	26838	40400	26497	1.099706744868035	1.5247009095369286
chr2	MIR4435-2HG	111350607	111350761	0	155	40775	26838	40775	26683	0.0	1.5281265225049656
chr2	MIR4435-2HG	111365560	111365662	0	103	40775	26838	40775	26735	0.0	1.525154292126426
chr2	MIR4435-2HG	111469786	111469987	0	202	40775	26838	40775	26636	0.0	1.5308229463883467
chr2	MIR4435-2HG	111471988	111472097	0	110	40775	26838	40775	26728	0.0	1.5255537264292127
chr2	MIR4435-2HG	111477335	111477481	0	147	40775	26838	40775	26691	0.0	1.5276685024914765
chr2	MIR4435-2HG	111494556	111494778	0	223	40775	26838	40775	26615	0.0	1.5320308096937818
chr2	MIR4435-2HG	111469602	111469987	0	386	40775	26838	40775	26452	0.0	1.5414713443217904
chr2	DPP10-AS1	115131826	115131924	0	99	0	9102	0	9003	0.0	0.0
chr2	DPP10-AS1	115135636	115136161	0	526	0	9102	0	8576	0.0	0.0
chr2	CLASP1	121444938	121444962	0	25	153	10990	153	10965	0.0	0.013953488372093023
chr2	CLASP1	121445448	121445496	0	49	153	10990	153	10941	0.0	0.013984096517685769
chr2	BIN1	127052254	127052362	0	109	46	5365	46	5256	0.0	0.008751902587519025
chr2	BIN1	127057472	127057601	0	130	46	5365	46	5235	0.0	0.008787010506208214
chr2	ERCC3	127280897	127280972	0	76	0	6406	0	6330	0.0	0.0
chr2	ERCC3	127284170	127284289	0	120	0	6406	0	6286	0.0	0.0
chr2	NEB	151533441	151533546	0	106	153	30273	153	30167	0.0	0.0050717671627937815
chr2	NEB	151534214	151534319	0	106	153	30273	153	30167	0.0	0.0050717671627937815
chr2	NEB	151506908	151507013	0	106	153	30273	153	30167	0.0	0.0050717671627937815
chr2	NEB	151508004	151508109	0	106	153	30273	153	30167	0.0	0.0050717671627937815
chr2	CACNB4	151962844	151962911	0	68	102	14196	102	14128	0.0	0.007219705549263873
chr2	CACNB4	151971544	151971704	0	161	102	14196	102	14035	0.0	0.007267545422158889
chr2	CACNB4	151860710	151860820	0	111	102	14196	102	14085	0.0	0.00724174653887114
chr2	CACNB4	151870530	151870611	0	82	102	14196	102	14114	0.0	0.007226866940626329
chr2	CACNB4	151855223	151855375	0	153	102	14196	102	14043	0.0	0.007263405255287332
chr2	CACNB4	151870841	151870861	0	21	102	14196	102	14175	0.0	0.0071957671957671955
chr2	CACNB4	151841902	151842088	0	187	102	14196	102	14009	0.0	0.0072810336212434865
chr2	CACNB4	151853447	151853543	0	97	102	14196	102	14099	0.0	0.00723455564224413
chr2	CACNB4	151869176	151869235	0	60	102	14196	102	14136	0.0	0.007215619694397283
chr2	CACNB4	151967536	151967610	0	75	102	14196	102	14121	0.0	0.007223284469938389
chr2	CACNB4	151970280	151970426	0	147	102	14196	102	14049	0.0	0.007260303224428785
chr2	CACNB4	151971544	151971700	0	157	102	14196	102	14039	0.0	0.00726547474891374
chr2	CACNB4	151872416	151872493	0	78	102	14196	102	14118	0.0	0.007224819379515512
chr2	LINC01876	156024469	156024576	0	108	0	2723	0	2615	0.0	0.0
chr2	LINC01876	156205381	156205438	0	58	0	2723	0	2665	0.0	0.0
chr2	LINC01876	156227966	156228004	0	39	0	2723	0	2684	0.0	0.0
chr2	LINC01876	156252035	156252131	0	97	0	2723	0	2626	0.0	0.0
chr2	CYTIP	157443846	157444006	510	161	9529	3398	9019	3237	3.1677018633540373	2.786221810318196
chr2	CYTIP	157464935	157465027	0	93	9529	3398	9529	3305	0.0	2.88320726172466
chr2	ACVR1	157819402	157819489	0	88	0	4499	0	4411	0.0	0.0
chr2	ACVR1	157860032	157860179	0	148	0	4499	0	4351	0.0	0.0
chr2	ACVR1	157826527	157826646	0	120	0	4499	0	4379	0.0	0.0
chr2	CCDC148	158345214	158345318	0	105	0	3816	0	3711	0.0	0.0
chr2	CCDC148	158358448	158358570	0	123	0	3816	0	3693	0.0	0.0
chr2	COBLL1	164779654	164779785	0	132	58	17102	58	16970	0.0	0.003417796110783736
chr2	COBLL1	164800533	164800554	0	22	58	17102	58	17080	0.0	0.003395784543325527
chr2	COBLL1	164837427	164837498	58	72	58	17102	0	17030	0.8055555555555556	0.0
chr2	SLC38A11	164952706	164952781	0	76	0	5207	0	5131	0.0	0.0
chr2	SLC38A11	164954630	164954745	0	116	0	5207	0	5091	0.0	0.0
chr2	SCN3A	165163617	165163709	0	93	130	11548	130	11455	0.0	0.011348756001745963
chr2	SCN3A	165163801	165163893	0	93	130	11548	130	11455	0.0	0.011348756001745963
chr2	SCN1A	166052851	166052943	0	93	459	18837	459	18744	0.0	0.024487836107554416
chr2	SCN1A	166053038	166053130	0	93	459	18837	459	18744	0.0	0.024487836107554416
chr2	SCN9A	166304030	166304122	0	93	153	13972	153	13879	0.0	0.011023848980474097
chr2	SCN9A	166304237	166304329	0	93	153	13972	153	13879	0.0	0.011023848980474097
chr2	SCN9A	166306955	166307074	0	120	153	13972	153	13852	0.0	0.011045336413514293
chr2	SCN9A	166307148	166307277	0	130	153	13972	153	13842	0.0	0.011053315994798439
chr2	CERS6-AS1	168775195	168775370	0	176	0	4221	0	4045	0.0	0.0
chr2	CERS6-AS1	168777812	168777937	0	126	0	4221	0	4095	0.0	0.0
chr2	CERS6-AS1	168775195	168775315	0	121	0	4221	0	4100	0.0	0.0
chr2	FASTKD1	169537226	169537340	0	115	1194	5035	1194	4920	0.0	0.2426829268292683
chr2	FASTKD1	169538012	169538141	0	130	1194	5035	1194	4905	0.0	0.2434250764525994
chr2	MYO3B-AS1	170340166	170340417	102	252	24581	5707	24479	5455	0.40476190476190477	4.487442713107241
chr2	MYO3B-AS1	170341385	170341429	0	45	24581	5707	24581	5662	0.0	4.341398799010951
chr2	MYO3B-AS1	170340166	170340421	102	256	24581	5707	24479	5451	0.3984375	4.49073564483581
chr2	MYO3B-AS1	170344171	170344298	0	128	24581	5707	24581	5579	0.0	4.405986735974189
chr2	MYO3B-AS1	170344340	170344381	4476	42	24581	5707	20105	5665	106.57142857142857	3.5489849955869373
chr2	MYO3B-AS1	170343816	170343840	0	25	24581	5707	24581	5682	0.0	4.326117564237944
chr2	MYO3B-AS1	170344171	170344301	0	131	24581	5707	24581	5576	0.0	4.408357245337159
chr2	MYO3B-AS1	170344340	170344438	4476	99	24581	5707	20105	5608	45.21212121212121	3.5850570613409416
chr2	MYO3B-AS1	170341329	170341429	0	101	24581	5707	24581	5606	0.0	4.3847663217980735
chr2	MYO3B-AS1	170344340	170344574	11514	235	24581	5707	13067	5472	48.99574468085106	2.3879751461988303
chr2	MYO3B-AS1	170344798	170344933	0	136	24581	5707	24581	5571	0.0	4.412313767725722
chr2	MYO3B-AS1	170344995	170345132	51	138	24581	5707	24530	5569	0.3695652173913043	4.404740527922428
chr2	MYO3B-AS1	170346177	170346242	0	66	24581	5707	24581	5641	0.0	4.357560716185073
chr2	MYO3B-AS1	170347951	170348125	0	175	24581	5707	24581	5532	0.0	4.443420101229212
chr2	MYO3B-AS1	170345062	170345215	49	154	24581	5707	24532	5553	0.3181818181818182	4.417792184404826
chr2	MYO3B-AS1	170346177	170346405	0	229	24581	5707	24581	5478	0.0	4.4872216137276375
chr2	MYO3B-AS1	170349511	170349634	719	124	24581	5707	23862	5583	5.798387096774194	4.274046211714132
chr2	MYO3B-AS1	170347951	170348099	0	149	24581	5707	24581	5558	0.0	4.422634041021951
chr2	MYO3B-AS1	170344798	170345215	51	418	24581	5707	24530	5289	0.12200956937799043	4.637927774626584
chr2	MYO3B-AS1	170344798	170345132	51	335	24581	5707	24530	5372	0.15223880597014924	4.566269545793001
chr2	MYO3B-AS1	170349837	170349851	0	15	24581	5707	24581	5692	0.0	4.318517217146873
chr2	AC007405.1	170733878	170733994	177	117	6662	6575	6485	6458	1.5128205128205128	1.004180860947662
chr2	AC007405.1	170740631	170741287	0	657	6662	6575	6662	5918	0.0	1.1257181480229808
chr2	METTL8	171392042	171392197	0	156	0	9953	0	9797	0.0	0.0
chr2	METTL8	171414602	171414726	0	125	0	9953	0	9828	0.0	0.0
chr2	METTL8	171433025	171433219	0	195	0	9953	0	9758	0.0	0.0
chr2	SLC25A12	171921079	171921231	0	153	8119	6150	8119	5997	0.0	1.353843588460897
chr2	SLC25A12	171991346	171991442	0	97	8119	6150	8119	6053	0.0	1.3413183545349414
chr2	GPR155	174482872	174482918	0	47	0	7788	0	7741	0.0	0.0
chr2	GPR155	174483009	174483158	0	150	0	7788	0	7638	0.0	0.0
chr2	CHN1	174875787	174875865	0	79	410167	9117	410167	9038	0.0	45.38249612746183
chr2	CHN1	174877839	174878128	0	290	410167	9117	410167	8827	0.0	46.467316188965675
chr2	CHN1	174846879	174846957	0	79	410167	9117	410167	9038	0.0	45.38249612746183
chr2	CHN1	174915057	174915171	0	115	410167	9117	410167	9002	0.0	45.56398578093757
chr2	CHN1	174952163	174952202	0	40	410167	9117	410167	9077	0.0	45.187506885534866
chr2	CHN1	174945169	174945261	509	93	410167	9117	409658	9024	5.473118279569892	45.39649822695036
chr2	CHN1	174951742	174951837	0	96	410167	9117	410167	9021	0.0	45.468019066622325
chr2	ATF2	175136411	175136486	0	76	2652	5317	2652	5241	0.0	0.5060103033772181
chr2	ATF2	175147945	175147980	0	36	2652	5317	2652	5281	0.0	0.5021776178754024
chr2	HAGLR	176176898	176176939	0	42	51	4973	51	4931	0.0	0.010342729669438248
chr2	HAGLR	176177000	176177070	0	71	51	4973	51	4902	0.0	0.01040391676866585
chr2	AC073636.1	176847865	176847941	0	77	1225	3276	1225	3199	0.0	0.38293216630196936
chr2	AC073636.1	176847989	176848342	868	354	1225	3276	357	2922	2.4519774011299433	0.12217659137577003
chr2	AC073636.1	176846527	176846629	0	103	1225	3276	1225	3173	0.0	0.3860699653324929
chr2	AC073636.1	176848574	176848657	153	84	1225	3276	1072	3192	1.8214285714285714	0.3358395989974937
chr2	AC074286.1	177097022	177097169	0	148	2703	6857	2703	6709	0.0	0.4028916380980772
chr2	AC074286.1	177131061	177131208	0	148	2703	6857	2703	6709	0.0	0.4028916380980772
chr2	FKBP7	178473028	178473142	0	115	0	3086	0	2971	0.0	0.0
chr2	FKBP7	178477061	178477213	0	153	0	3086	0	2933	0.0	0.0
chr2	FKBP7	178469651	178469785	0	135	0	3086	0	2951	0.0	0.0
chr2	TTN	178756221	178756797	0	577	877	119344	877	118767	0.0	0.007384206050502244
chr2	TTN	178757541	178757916	0	376	877	119344	877	118968	0.0	0.007371730213166566
chr2	CERKL	181558565	181558708	0	144	0	4691	0	4547	0.0	0.0
chr2	CERKL	181573752	181573884	0	133	0	4691	0	4558	0.0	0.0
chr2	LINC01473	186099768	186099830	0	63	0	3606	0	3543	0.0	0.0
chr2	LINC01473	186178598	186178691	0	94	0	3606	0	3512	0.0	0.0
chr2	TFPI	187513615	187513646	0	32	81185	11727	81185	11695	0.0	6.9418554938007695
chr2	TFPI	187520541	187520613	333	73	81185	11727	80852	11654	4.561643835616438	6.937703792689206
chr2	TFPI	187529363	187529485	1022	123	81185	11727	80163	11604	8.308943089430894	6.908221302998966
chr2	AC006460.2	190629750	190629825	44	76	43184	7821	43140	7745	0.5789473684210527	5.570045190445449
chr2	AC006460.2	190640950	190641462	678	513	43184	7821	42506	7308	1.3216374269005848	5.816365626710454
chr2	GTF3C3	196773668	196773726	0	59	87	7152	87	7093	0.0	0.012265613985619626
chr2	GTF3C3	196775115	196775251	0	137	87	7152	87	7015	0.0	0.01240199572344975
chr2	AC097717.1	199884326	199884390	0	65	455	6765	455	6700	0.0	0.06791044776119402
chr2	AC097717.1	199894582	199894663	29	82	455	6765	426	6683	0.35365853658536583	0.0637438276223253
chr2	AC097717.1	199880967	199881060	0	94	455	6765	455	6671	0.0	0.06820566631689402
chr2	AC097717.1	199882440	199882596	0	157	455	6765	455	6608	0.0	0.06885593220338983
chr2	AC097717.1	199908862	199908994	0	133	455	6765	455	6632	0.0	0.06860675512665862
chr2	AC097717.1	199880496	199880598	0	103	455	6765	455	6662	0.0	0.06829780846592615
chr2	AC097717.1	199879405	199879610	0	206	455	6765	455	6559	0.0	0.06937033084311633
chr2	AC097717.1	199879405	199879797	0	393	455	6765	455	6372	0.0	0.07140615191462649
chr2	AC097717.1	199881893	199881991	0	99	455	6765	455	6666	0.0	0.06825682568256826
chr2	AC097717.1	199896504	199896605	0	102	455	6765	455	6663	0.0	0.06828755815698634
chr2	AC097717.1	199908896	199908994	0	99	455	6765	455	6666	0.0	0.06825682568256826
chr2	LINC01792	200716334	200716417	0	84	6056	3235	6056	3151	0.0	1.9219295461758172
chr2	LINC01792	200727060	200727340	0	281	6056	3235	6056	2954	0.0	2.050101557210562
chr2	PPIL3	200882341	200882435	0	95	0	2472	0	2377	0.0	0.0
chr2	PPIL3	200885261	200885367	0	107	0	2472	0	2365	0.0	0.0
chr2	PPIL3	200882341	200882382	0	42	0	2472	0	2430	0.0	0.0
chr2	PPIL3	200885261	200885343	0	83	0	2472	0	2389	0.0	0.0
chr2	CFLAR-AS1	201144135	201144302	0	168	51	4158	51	3990	0.0	0.012781954887218045
chr2	CFLAR-AS1	201147742	201147864	0	123	51	4158	51	4035	0.0	0.012639405204460967
chr2	CFLAR-AS1	201145639	201145690	0	52	51	4158	51	4106	0.0	0.012420847540185095
chr2	CFLAR-AS1	201143346	201143469	0	124	51	4158	51	4034	0.0	0.01264253842340109
chr2	CFLAR-AS1	201145573	201145690	0	118	51	4158	51	4040	0.0	0.012623762376237625
chr2	FLACC1	201330735	201330833	0	99	9688	2497	9688	2398	0.0	4.040033361134278
chr2	FLACC1	201342369	201342431	9163	63	9688	2497	525	2434	145.44444444444446	0.21569433032046015
chr2	MPP4	201685918	201686050	1432	133	22423	4177	20991	4044	10.766917293233083	5.190652818991098
chr2	MPP4	201687290	201687371	12757	82	22423	4177	9666	4095	155.5731707317073	2.3604395604395605
chr2	ALS2	201778440	201778487	1097	48	156840	10478	155743	10430	22.854166666666668	14.932214765100671
chr2	ALS2	201779978	201780083	100	106	156840	10478	156740	10372	0.9433962264150944	15.111839568067875
chr2	SUMO1	202231542	202231732	0	191	0	2157	0	1966	0.0	0.0
chr2	SUMO1	202233577	202233670	0	94	0	2157	0	2063	0.0	0.0
chr2	ICA1L	202869535	202869605	0	71	274	10225	274	10154	0.0	0.02698443962970258
chr2	ICA1L	202870529	202870656	0	128	274	10225	274	10097	0.0	0.027136773298999703
chr2	RAPH1	203470238	203470313	0	76	561	11179	561	11103	0.0	0.05052688462577682
chr2	RAPH1	203477075	203477156	0	82	561	11179	561	11097	0.0	0.05055420383887537
chr2	AC007362.1	205760797	205760911	0	115	0	1629	0	1514	0.0	0.0
chr2	AC007362.1	205761427	205761502	0	76	0	1629	0	1553	0.0	0.0
chr2	AC007362.1	205761427	205761463	0	37	0	1629	0	1592	0.0	0.0
chr2	AC007362.1	205762387	205762509	0	123	0	1629	0	1506	0.0	0.0
chr2	NDUFS1	206149817	206149925	0	109	51	12182	51	12073	0.0	0.004224302161848753
chr2	NDUFS1	206152418	206152510	0	93	51	12182	51	12089	0.0	0.004218711225080652
chr2	C2ORF80	208168381	208168495	0	115	0	1402	0	1287	0.0	0.0
chr2	C2ORF80	208170944	208171063	0	120	0	1402	0	1282	0.0	0.0
chr2	ERBB4	211657753	211657828	0	76	153	13047	153	12971	0.0	0.011795543905635648
chr2	ERBB4	211657949	211657994	0	46	153	13047	153	13001	0.0	0.011768325513422044
chr2	IKZF2	213013790	213013934	0	145	0	12218	0	12073	0.0	0.0
chr2	IKZF2	213021992	213022130	0	139	0	12218	0	12079	0.0	0.0
chr2	IKZF2	213056910	213057099	0	190	0	12218	0	12028	0.0	0.0
chr2	IKZF2	213097876	213097960	0	85	0	12218	0	12133	0.0	0.0
chr2	IKZF2	213056832	213057099	0	268	0	12218	0	11950	0.0	0.0
chr2	BARD1	214780559	214781509	0	951	1632	7585	1632	6634	0.0	0.24600542659029243
chr2	BARD1	214792296	214792445	0	150	1632	7585	1632	7435	0.0	0.219502353732347
chr2	BARD1	214797060	214797117	0	58	1632	7585	1632	7527	0.0	0.21681944998007174
chr2	LINC00607	215641230	215641819	1479	590	1963	6966	484	6376	2.506779661016949	0.07590966122961104
chr2	LINC00607	215740876	215741021	0	146	1963	6966	1963	6820	0.0	0.2878299120234604
chr2	LINC00607	215750242	215750417	0	176	1963	6966	1963	6790	0.0	0.2891016200294551
chr2	LINC00607	215797359	215797591	0	233	1963	6966	1963	6733	0.0	0.291549086588445
chr2	TNS1	217829843	217829882	0	40	0	16327	0	16287	0.0	0.0
chr2	TNS1	217830366	217830390	0	25	0	16327	0	16302	0.0	0.0
chr2	TMBIM1	218284038	218284136	0	99	0	5110	0	5011	0.0	0.0
chr2	TMBIM1	218285762	218285938	0	177	0	5110	0	4933	0.0	0.0
chr2	TMBIM1	218284038	218284160	0	123	0	5110	0	4987	0.0	0.0
chr2	TMBIM1	218284038	218284266	0	229	0	5110	0	4881	0.0	0.0
chr2	TMBIM1	218285762	218285934	0	173	0	5110	0	4937	0.0	0.0
chr2	ABCB6	219216651	219216832	0	182	54392	4486	54392	4304	0.0	12.637546468401487
chr2	ABCB6	219217669	219217807	0	139	54392	4486	54392	4347	0.0	12.5125373821026
chr2	ATG9A	219227921	219228053	0	133	0	4730	0	4597	0.0	0.0
chr2	ATG9A	219228433	219228485	0	53	0	4730	0	4677	0.0	0.0
chr2	AP1S3	223770196	223770325	0	130	5355	5957	5355	5827	0.0	0.9189977690063498
chr2	AP1S3	223773312	223773351	0	40	5355	5957	5355	5917	0.0	0.9050194355247592
chr2	AP1S3	223775900	223776009	0	110	5355	5957	5355	5847	0.0	0.9158542842483325
chr2	AP1S3	223776048	223776158	1173	111	5355	5957	4182	5846	10.567567567567568	0.715360930550804
chr2	SLC19A3	227702591	227702691	517	101	32721	5687	32204	5586	5.118811881188119	5.7651271034729685
chr2	SLC19A3	227706552	227706743	0	192	32721	5687	32721	5495	0.0	5.954686078252958
chr2	PID1	229227956	229228063	0	108	0	3375	0	3267	0.0	0.0
chr2	PID1	229262682	229262893	0	212	0	3375	0	3163	0.0	0.0
chr2	NCL	231455827	231455904	0	78	147	6296	147	6218	0.0	0.023641042135734962
chr2	NCL	231456009	231456136	0	128	147	6296	147	6168	0.0	0.023832684824902722
chr2	NCL	231456009	231456159	0	151	147	6296	147	6145	0.0	0.02392188771358828
chr2	AC073254.1	232595819	232595936	0	118	1035	3540	1035	3422	0.0	0.3024547048509644
chr2	AC073254.1	232606572	232606717	330	146	1035	3540	705	3394	2.26027397260274	0.20771950500883912
chr2	HJURP	233847396	233847461	0	66	0	3831	0	3765	0.0	0.0
chr2	HJURP	233849762	233849859	0	98	0	3831	0	3733	0.0	0.0
chr2	AC012063.1	236959770	236959840	0	71	3813	13105	3813	13034	0.0	0.2925425809421513
chr2	AC012063.1	236979929	236980067	0	139	3813	13105	3813	12966	0.0	0.2940768162887552
chr2	RAB17	237578003	237578155	102	153	102	4078	0	3925	0.6666666666666666	0.0
chr2	RAB17	237585997	237586157	0	161	102	4078	102	3917	0.0	0.026040336992596374
chr2	NDUFA10	239990073	239990182	0	110	53071	18589	53071	18479	0.0	2.8719627685480815
chr2	NDUFA10	240005209	240005295	0	87	53071	18589	53071	18502	0.0	2.8683926062047345
chr2	NDUFA10	239960954	239961186	0	233	53071	18589	53071	18356	0.0	2.8912072346916537
chr2	NDUFA10	239964182	239964261	0	80	53071	18589	53071	18509	0.0	2.8673077962072506
chr2	NDUFA10	239982114	239982219	0	106	53071	18589	53071	18483	0.0	2.8713412324839043
chr2	NDUFA10	239987515	239987578	0	64	53071	18589	53071	18525	0.0	2.8648313090418354
chr2	ANKMY1	240507559	240507691	0	133	0	7366	0	7233	0.0	0.0
chr2	ANKMY1	240511860	240512001	0	142	0	7366	0	7224	0.0	0.0
chr2	ANKMY1	240509347	240509455	0	109	0	7366	0	7257	0.0	0.0
chr2	KIF1A	240728388	240728412	0	25	1290	16333	1290	16308	0.0	0.07910228108903605
chr2	KIF1A	240734718	240734745	0	28	1290	16333	1290	16305	0.0	0.07911683532658693
chr2	MTERF4	241097242	241097427	0	186	95811	9722	95811	9536	0.0	10.047294463087248
chr2	MTERF4	241099395	241099894	0	500	95811	9722	95811	9222	0.0	10.38939492517892
chr2	MTERF4	241101163	241101221	0	59	95811	9722	95811	9663	0.0	9.915243713132568
chr2	HDLBP	241268828	241268953	0	126	6	11245	6	11119	0.0	0.0005396168720208652
chr2	HDLBP	241268953	241269295	0	343	6	11245	6	10902	0.0	0.000550357732526142
chr2	HDLBP	241268957	241269295	0	339	6	11245	6	10906	0.0	0.0005501558774986246
chr2	STK25	241504037	241504096	0	60	35268	5262	35268	5202	0.0	6.779700115340254
chr2	STK25	241508005	241508135	2133	131	35268	5262	33135	5131	16.282442748091604	6.457805496004678
chr2	STK25	241501477	241501708	2220	232	35268	5262	33048	5030	9.568965517241379	6.5701789264413515
chr2	DTYMK	241680228	241680319	0	92	102	2407	102	2315	0.0	0.044060475161987044
chr2	DTYMK	241684715	241684749	0	35	102	2407	102	2372	0.0	0.04300168634064081
chr2	DTYMK	241681918	241682333	0	416	102	2407	102	1991	0.0	0.051230537418382724
chr2	ACP1	272036	272150	44691	115	567456	3562	522765	3447	388.61739130434785	151.6579634464752
chr2	ACP1	272191	272305	16736	115	567456	3562	550720	3447	145.5304347826087	159.76791412822743
chr2	AC093326.1	558733	558985	0	253	0	2562	0	2309	0.0	0.0
chr2	AC093326.1	559108	559216	0	109	0	2562	0	2453	0.0	0.0
chr2	COLEC11	3613310	3613382	0	73	66829	2791	66829	2718	0.0	24.58756438557763
chr2	COLEC11	3637532	3637604	0	73	66829	2791	66829	2718	0.0	24.58756438557763
chr2	AC013460.1	7421684	7421843	0	160	0	5222	0	5062	0.0	0.0
chr2	AC013460.1	7422572	7424012	0	1441	0	5222	0	3781	0.0	0.0
chr2	AC013460.1	7430179	7430293	0	115	0	5222	0	5107	0.0	0.0
chr2	AC013460.1	7436004	7436097	0	94	0	5222	0	5128	0.0	0.0
chr2	AC013460.1	7422572	7423035	0	464	0	5222	0	4758	0.0	0.0
chr2	HPCAL1	10406264	10406361	0	98	443	4816	443	4718	0.0	0.09389571852479864
chr2	HPCAL1	10408561	10408734	0	174	443	4816	443	4642	0.0	0.0954330030159414
chr2	SLC66A3	11171924	11172045	0	122	0	2280	0	2158	0.0	0.0
chr2	SLC66A3	11174967	11175009	0	43	0	2280	0	2237	0.0	0.0
chr2	MIR3681HG	12397521	12398370	0	850	102	8436	102	7586	0.0	0.013445821249670446
chr2	MIR3681HG	12416088	12416286	0	199	102	8436	102	8237	0.0	0.012383149204807575
chr2	LINC01808	19479096	19479142	0	47	0	3067	0	3020	0.0	0.0
chr2	LINC01808	19479223	19479284	0	62	0	3067	0	3005	0.0	0.0
chr2	FKBP1B	24054103	24054192	0	90	1785	1249	1785	1159	0.0	1.5401207937877481
chr2	FKBP1B	24054472	24054540	204	69	1785	1249	1581	1180	2.9565217391304346	1.3398305084745763
chr2	DNAJC27-AS1	25004066	25004110	0	45	185163	5744	185163	5699	0.0	32.49043691875767
chr2	DNAJC27-AS1	25027310	25027517	396	208	185163	5744	184767	5536	1.9038461538461537	33.37554190751445
chr2	DNAJC27-AS1	25003984	25004110	0	127	185163	5744	185163	5617	0.0	32.964749866476765
chr2	DNAJC27-AS1	25001414	25001545	0	132	185163	5744	185163	5612	0.0	32.99411974340698
chr2	SLC35F6	26774250	26774323	0	74	0	3908	0	3834	0.0	0.0
chr2	SLC35F6	26775043	26775215	0	173	0	3908	0	3735	0.0	0.0
chr2	KHK	27094476	27094611	0	136	663	3023	663	2887	0.0	0.2296501558711465
chr2	KHK	27094799	27094934	0	136	663	3023	663	2887	0.0	0.2296501558711465
chr2	SNX17	27371268	27371468	0	201	0	3482	0	3281	0.0	0.0
chr2	SNX17	27372622	27372740	0	119	0	3482	0	3363	0.0	0.0
chr2	SNX17	27371268	27371343	0	76	0	3482	0	3406	0.0	0.0
chr2	ZNF512	27599969	27600053	22832	85	204807	4272	181975	4187	268.61176470588236	43.46190589921185
chr2	ZNF512	27600690	27600815	14274	126	204807	4272	190533	4146	113.28571428571429	45.95586107091172
chr2	BABAM2	28310081	28310153	0	73	11781	3409	11781	3336	0.0	3.531474820143885
chr2	BABAM2	28327273	28327447	0	175	11781	3409	11781	3234	0.0	3.642857142857143
chr2	LCLAT1	30459551	30459722	0	172	153	7528	153	7356	0.0	0.020799347471451877
chr2	LCLAT1	30489159	30489240	0	82	153	7528	153	7446	0.0	0.02054794520547945
chr2	LCLAT1	30476576	30476635	0	60	153	7528	153	7468	0.0	0.020487412961971076
chr2	SPAST	32098795	32098891	11	97	14001	9360	13990	9263	0.1134020618556701	1.51030983482673
chr2	SPAST	32114637	32114825	85	189	14001	9360	13916	9171	0.4497354497354497	1.517391778432014
chr2	SLC30A6	32171286	32171373	0	88	3738	5426	3738	5338	0.0	0.7002622705133008
chr2	SLC30A6	32184272	32184338	0	67	3738	5426	3738	5359	0.0	0.6975181936928532
chr2	LINC00486	32841012	32841233	255	222	1871	7058	1616	6836	1.1486486486486487	0.2363955529549444
chr2	LINC00486	32882698	32882826	0	129	1871	7058	1871	6929	0.0	0.2700245345648723
chr2	LINC01320	34721998	34722438	0	441	144	10145	144	9704	0.0	0.01483924154987634
chr2	LINC01320	34732447	34732557	0	111	144	10145	144	10034	0.0	0.014351205899940203
chr2	LINC01320	34721998	34722121	0	124	144	10145	144	10021	0.0	0.014369823370921065
chr2	LINC01320	34691590	34691669	0	80	144	10145	144	10065	0.0	0.014307004470938897
chr2	LINC01320	34710451	34710513	0	63	144	10145	144	10082	0.0	0.01428288038087681
chr2	AC012593.1	35164127	35164242	0	116	182	4225	182	4109	0.0	0.044293015332197615
chr2	AC012593.1	35170177	35170349	0	173	182	4225	182	4052	0.0	0.04491609081934847
chr2	VIT	36773790	36773847	560	58	46528	3727	45968	3669	9.655172413793103	12.528754428999727
chr2	VIT	36781726	36781771	0	46	46528	3727	46528	3681	0.0	12.640043466449335
chr2	VIT	36775001	36775067	606	67	46528	3727	45922	3660	9.044776119402986	12.546994535519126
chr2	VIT	36783339	36783402	0	64	46528	3727	46528	3663	0.0	12.702156702156703
chr2	NDUFAF7	37232105	37232266	0	162	14	3663	14	3501	0.0	0.003998857469294488
chr2	NDUFAF7	37236095	37236176	0	82	14	3663	14	3581	0.0	0.003909522479754258
chr2	CYP1B1-AS1	38083995	38084110	0	116	51	8859	51	8743	0.0	0.005833238018986618
chr2	CYP1B1-AS1	38121984	38122225	0	242	51	8859	51	8617	0.0	0.005918533132180573
chr2	MAP4K3-DT	39557981	39558046	0	66	10240	10725	10240	10659	0.0	0.9606904962942114
chr2	MAP4K3-DT	39588448	39588567	306	120	10240	10725	9934	10605	2.55	0.9367279585101367
chr2	MAP4K3-DT	39584604	39587353	0	2750	10240	10725	10240	7975	0.0	1.284012539184953
chr2	MAP4K3-DT	39584604	39584810	0	207	10240	10725	10240	10518	0.0	0.9735691196044876
chr2	MAP4K3-DT	39588485	39588567	234	83	10240	10725	10006	10642	2.819277108433735	0.9402367975944371
chr2	SLC8A1-AS1	40209966	40210024	0	59	102	8515	102	8456	0.0	0.012062440870387891
chr2	SLC8A1-AS1	40223629	40223751	0	123	102	8515	102	8392	0.0	0.01215443279313632
chr2	SLC8A1-AS1	40114001	40114103	0	103	102	8515	102	8412	0.0	0.012125534950071327
chr2	SLC8A1-AS1	40213168	40213218	0	51	102	8515	102	8464	0.0	0.012051039697542534
chr2	SLC8A1-AS1	40250298	40250509	0	212	102	8515	102	8303	0.0	0.012284716367577983
chr2	MTA3	42609457	42609584	357	128	8393	10362	8036	10234	2.7890625	0.7852257181942545
chr2	MTA3	42640172	42640236	0	65	8393	10362	8393	10297	0.0	0.8150917743031951
chr2	MTA3	42579106	42579200	69	95	8393	10362	8324	10267	0.7263157894736842	0.8107528976331937
chr2	RHOQ	46560523	46560689	0	167	101431	6433	101431	6266	0.0	16.18751994893074
chr2	RHOQ	46572727	46572786	0	60	101431	6433	101431	6373	0.0	15.915738270830065
chr2	TTC7A	47021861	47021979	0	119	538	7210	538	7091	0.0	0.07587082216894656
chr2	TTC7A	47023407	47023465	0	59	538	7210	538	7151	0.0	0.07523423297440918
chr2	MSH6	47790926	47791123	0	198	40178	10902	40178	10704	0.0	3.7535500747384156
chr2	MSH6	47795893	47796063	0	171	40178	10902	40178	10731	0.0	3.744105861522691
chr2	ACYP2	54222996	54223083	0	88	7506	4979	7506	4891	0.0	1.5346554896749132
chr2	ACYP2	54267295	54267365	0	71	7506	4979	7506	4908	0.0	1.5293398533007334
chr2	EML6	54901940	54902141	0	202	166946	16043	166946	15841	0.0	10.538854870273342
chr2	EML6	54902420	54902541	0	122	166946	16043	166946	15921	0.0	10.485899126939263
chr2	EML6	54900696	54900896	0	201	166946	16043	166946	15842	0.0	10.53818962252241
chr2	EML6	54902424	54902541	0	118	166946	16043	166946	15925	0.0	10.48326530612245
chr2	AC012358.2	55320828	55320928	0	101	0	4927	0	4826	0.0	0.0
chr2	AC012358.2	55329421	55329519	0	99	0	4927	0	4828	0.0	0.0
chr2	AC012358.2	55329421	55329713	0	293	0	4927	0	4634	0.0	0.0
chr2	AC012358.2	55332138	55332261	0	124	0	4927	0	4803	0.0	0.0
chr2	AC012358.2	55338975	55339269	0	295	0	4927	0	4632	0.0	0.0
chr2	AC012358.2	55329567	55329713	0	147	0	4927	0	4780	0.0	0.0
chr2	AC012358.2	55317744	55317809	0	66	0	4927	0	4861	0.0	0.0
chr2	AC012358.2	55339850	55339974	0	125	0	4927	0	4802	0.0	0.0
chr2	VRK2	58026743	58026861	0	119	0	3484	0	3365	0.0	0.0
chr2	VRK2	58028297	58028398	0	102	0	3484	0	3382	0.0	0.0
chr2	LINC01122	58461777	58461845	0	69	0	11565	0	11496	0.0	0.0
chr2	LINC01122	58656649	58656711	0	63	0	11565	0	11502	0.0	0.0
chr2	LINC01122	58912718	58912746	0	29	0	11565	0	11536	0.0	0.0
chr2	LINC01122	58915679	58915902	0	224	0	11565	0	11341	0.0	0.0
chr2	LINC01122	58671433	58671462	0	30	0	11565	0	11535	0.0	0.0
chr2	LINC01122	58728357	58728475	0	119	0	11565	0	11446	0.0	0.0
chr2	AHSA2P	61185838	61185865	0	28	1275	8068	1275	8040	0.0	0.15858208955223882
chr2	AHSA2P	61185979	61186081	0	103	1275	8068	1275	7965	0.0	0.160075329566855
chr2	AC016727.1	61471748	61471808	0	61	6000	2338	6000	2277	0.0	2.635046113306983
chr2	AC016727.1	61480324	61480583	162	260	6000	2338	5838	2078	0.6230769230769231	2.809432146294514
chr2	MDH1	63589960	63590084	0	125	768	5003	768	4878	0.0	0.15744157441574416
chr2	MDH1	63593123	63593628	0	506	768	5003	768	4497	0.0	0.17078052034689792
chr2	MDH1	63593439	63593628	0	190	768	5003	768	4813	0.0	0.15956783710783295
chr2	UGP2	63856787	63856882	0	96	0	6812	0	6716	0.0	0.0
chr2	UGP2	63857549	63857718	0	170	0	6812	0	6642	0.0	0.0
chr2	UGP2	63842058	63842204	0	147	0	6812	0	6665	0.0	0.0
chr2	UGP2	63854883	63854936	0	54	0	6812	0	6758	0.0	0.0
chr2	UGP2	63842538	63842599	0	62	0	6812	0	6750	0.0	0.0
chr2	UGP2	63859179	63859391	0	213	0	6812	0	6599	0.0	0.0
chr2	UGP2	63862840	63862928	0	89	0	6812	0	6723	0.0	0.0
chr2	UGP2	63857549	63857642	0	94	0	6812	0	6718	0.0	0.0
chr2	UGP2	63856305	63856433	0	129	0	6812	0	6683	0.0	0.0
chr2	UGP2	63857549	63857716	0	168	0	6812	0	6644	0.0	0.0
chr2	UGP2	63856329	63856433	0	105	0	6812	0	6707	0.0	0.0
chr2	UGP2	63856963	63857002	0	40	0	6812	0	6772	0.0	0.0
chr2	ACTR2	65241971	65242063	0	93	255	4324	255	4231	0.0	0.06026943984873552
chr2	ACTR2	65246184	65246307	0	124	255	4324	255	4200	0.0	0.060714285714285714
chr2	ACTR2	65242048	65242063	0	16	255	4324	255	4308	0.0	0.059192200557103065
chr2	AC007389.1	65483059	65483152	0	94	2316	12371	2316	12277	0.0	0.1886454345524151
chr2	AC007389.1	65500628	65501147	153	520	2316	12371	2163	11851	0.29423076923076924	0.18251624335499114
chr2	LINC02831	67566775	67566972	0	198	0	3252	0	3054	0.0	0.0
chr2	LINC02831	67568007	67568156	0	150	0	3252	0	3102	0.0	0.0
chr2	ALMS1	73534823	73534949	0	127	271625	14807	271625	14680	0.0	18.50306539509537
chr2	ALMS1	73550266	73550437	0	172	271625	14807	271625	14635	0.0	18.559959002391526
chr2	MTHFD2	74205704	74205889	0	186	4110	11414	4110	11228	0.0	0.36604916280726757
chr2	MTHFD2	74207703	74207826	561	124	4110	11414	3549	11290	4.524193548387097	0.31434898139946854
chr2	MTHFD2	74201381	74201479	0	99	4110	11414	4110	11315	0.0	0.36323464427750773
chr2	DCTN1-AS1	74391158	74391243	287	86	71349	4344	71062	4258	3.3372093023255816	16.689055894786286
chr2	DCTN1-AS1	74391477	74391615	408	139	71349	4344	70941	4205	2.935251798561151	16.87063020214031
chr2	DOK1	74555574	74555668	76	95	629	2957	553	2862	0.8	0.19322152341020266
chr2	DOK1	74555893	74556078	0	186	629	2957	629	2771	0.0	0.22699386503067484
chr2	DOK1	74555578	74555668	76	91	629	2957	553	2866	0.8351648351648352	0.19295184926727146
chr2	SEMA4F	74657852	74657951	702	100	87250	6242	86548	6142	7.02	14.091175512862259
chr2	SEMA4F	74662731	74662825	84	95	87250	6242	87166	6147	0.8842105263157894	14.180250528713193
chr2	ELMOD3	85355075	85355170	0	96	153	6400	153	6304	0.0	0.02427030456852792
chr2	ELMOD3	85355554	85355598	0	45	153	6400	153	6355	0.0	0.024075531077891423
chr2	ELMOD3	85377343	85377474	0	132	153	6400	153	6268	0.0	0.02440970006381621
chr2	ELMOD3	85387097	85387225	0	129	153	6400	153	6271	0.0	0.02439802264391644
chr2	ELMOD3	85355554	85355716	0	163	153	6400	153	6237	0.0	0.024531024531024532
chr2	ELMOD3	85356966	85357252	0	287	153	6400	153	6113	0.0	0.025028627515131685
chr2	ELMOD3	85355554	85355896	0	343	153	6400	153	6057	0.0	0.02526002971768202
chr2	USP39	85644947	85645083	0	137	28552	3963	28552	3826	0.0	7.462624150548876
chr2	USP39	85647929	85648016	0	88	28552	3963	28552	3875	0.0	7.368258064516129
chr2	CYTOR	87480222	87480362	0	141	867	17288	867	17147	0.0	0.05056278066134018
chr2	CYTOR	87503486	87503624	0	139	867	17288	867	17149	0.0	0.05055688378331098
chr2	CYTOR	87480222	87480607	0	386	867	17288	867	16902	0.0	0.05129570465033724
chr2	CYTOR	87455751	87455973	260	223	867	17288	607	17065	1.1659192825112108	0.03556987987108116
chr2	CYTOR	87472739	87472885	0	147	867	17288	867	17141	0.0	0.05058047955195146
chr2	CYTOR	87585170	87585272	51	103	867	17288	816	17185	0.49514563106796117	0.04748327029386092
chr2	CYTOR	87600068	87600222	0	155	867	17288	867	17133	0.0	0.05060409735597969
chr2	CYTOR	87470149	87470304	0	156	867	17288	867	17132	0.0	0.05060705113238384
chr2	CYTOR	87572898	87573193	0	296	867	17288	867	16992	0.0	0.051024011299435026
chr2	THNSL2	88185327	88185479	0	153	0	6615	0	6462	0.0	0.0
chr2	THNSL2	88185550	88185724	0	175	0	6615	0	6440	0.0	0.0
chr2	MAL	95047958	95048126	0	169	0	1458	0	1289	0.0	0.0
chr2	MAL	95049580	95049706	0	127	0	1458	0	1331	0.0	0.0
chr2	C2ORF92	97665823	97665920	0	98	125	6194	125	6096	0.0	0.02050524934383202
chr2	C2ORF92	97666903	97667054	0	152	125	6194	125	6042	0.0	0.02068851373717312
chr2	C2ORF92	97665802	97665940	0	139	125	6194	125	6055	0.0	0.02064409578860446
chr2	C2ORF92	97669689	97669834	11	146	125	6194	114	6048	0.07534246575342465	0.018849206349206348
chr2	C2ORF92	97671193	97671306	0	114	125	6194	125	6080	0.0	0.02055921052631579
chr2	C2ORF92	97674455	97674557	0	103	125	6194	125	6091	0.0	0.02052208175997373
chr2	C2ORF92	97671330	97671499	0	170	125	6194	125	6024	0.0	0.020750332005312084
chr2	C2ORF92	97671190	97671306	0	117	125	6194	125	6077	0.0	0.020569359881520487
chr2	C2ORF92	97671219	97671306	0	88	125	6194	125	6106	0.0	0.02047166721257779
chr2	C2ORF92	97688894	97688993	0	100	125	6194	125	6094	0.0	0.02051197899573351
chr2	C2ORF92	97690255	97690327	0	73	125	6194	125	6121	0.0	0.020421499754942004
chr2	C2ORF92	97675630	97675721	0	92	125	6194	125	6102	0.0	0.020485086856768274
chr2	C2ORF92	97694446	97694599	0	154	125	6194	125	6040	0.0	0.020695364238410598
chr2	C2ORF92	97671330	97671481	0	152	125	6194	125	6042	0.0	0.02068851373717312
chr2	LIPT1	99155481	99155544	0	64	19437	2283	19437	2219	0.0	8.759351059035602
chr2	LIPT1	99156300	99156426	0	127	19437	2283	19437	2156	0.0	9.01530612244898
chr2	MAP4K4	101860824	101860986	0	163	218220	11035	218220	10872	0.0	20.071743929359823
chr2	MAP4K4	101863820	101864051	0	232	218220	11035	218220	10803	0.0	20.199944459872256
chr2	AC096669.1	107363139	107363416	0	278	0	1311	0	1033	0.0	0.0
chr2	AC096669.1	107381038	107381275	0	238	0	1311	0	1073	0.0	0.0
chr2	ACOXL	111031626	111031714	43	89	3948	8196	3905	8107	0.48314606741573035	0.4816824966078697
chr2	ACOXL	111049217	111049288	0	72	3948	8196	3948	8124	0.0	0.4859675036927622
chr2	BCL2L11	111150043	111150147	0	105	24	6670	24	6565	0.0	0.0036557501904036557
chr2	BCL2L11	111153779	111153904	0	126	24	6670	24	6544	0.0	0.003667481662591687
chr2	BCL2L11	111161418	111161550	0	133	24	6670	24	6537	0.0	0.0036714089031665903
chr2	BCL2L11	111124049	111124139	0	91	24	6670	24	6579	0.0	0.00364797081623347
chr2	BCL2L11	111130131	111130247	0	117	24	6670	24	6553	0.0	0.0036624446818251184
chr2	TMEM87B	112091711	112091783	42	73	8179	5342	8137	5269	0.5753424657534246	1.5443158094515088
chr2	TMEM87B	112095227	112095299	0	73	8179	5342	8179	5269	0.0	1.5522869614727652
chr2	IL37	112913791	112913854	150	64	201	845	51	781	2.34375	0.06530089628681178
chr2	IL37	112917128	112917248	0	121	201	845	201	724	0.0	0.2776243093922652
chr2	IL1RN	113120065	113120128	0	64	2143	3112	2143	3048	0.0	0.7030839895013123
chr2	IL1RN	113121447	113121618	0	172	2143	3112	2143	2940	0.0	0.7289115646258504
chr2	PAX8-AS1	113238089	113238212	918	124	54157	13369	53239	13245	7.403225806451613	4.019554548886372
chr2	PAX8-AS1	113250766	113250922	0	157	54157	13369	54157	13212	0.0	4.099076597033
chr2	PAX8-AS1	113236512	113236622	0	111	54157	13369	54157	13258	0.0	4.084854427515462
chr2	PAX8-AS1	113236512	113236613	0	102	54157	13369	54157	13267	0.0	4.08208336473958
chr2	PAX8-AS1	113255389	113255549	879	161	54157	13369	53278	13208	5.459627329192546	4.033767413688674
chr2	PAX8-AS1	113259263	113259584	1493	322	54157	13369	52664	13047	4.636645962732919	4.036483482792979
chr2	PAX8-AS1	113235791	113236613	0	823	54157	13369	54157	12546	0.0	4.316674637334609
chr2	PAX8-AS1	113239088	113239424	255	337	54157	13369	53902	13032	0.7566765578635015	4.136126457949662
chr2	PAX8-AS1	113250766	113250906	0	141	54157	13369	54157	13228	0.0	4.094118536437859
chr2	CBWD2	113455555	113455643	0	89	38189	6917	38189	6828	0.0	5.592999414176918
chr2	CBWD2	113457064	113457209	0	146	38189	6917	38189	6771	0.0	5.640082705656476
chr2	ACTR3	113913171	113913227	0	57	7793	11958	7793	11901	0.0	0.6548189227795983
chr2	ACTR3	113916883	113917008	0	126	7793	11958	7793	11832	0.0	0.6586375929682218
chr2	STEAP3	119230619	119231034	0	416	0	4570	0	4154	0.0	0.0
chr2	STEAP3	119239362	119239430	0	69	0	4570	0	4501	0.0	0.0
chr2	DBI	119367402	119367528	0	127	0	2515	0	2388	0.0	0.0
chr2	DBI	119367558	119367644	0	87	0	2515	0	2428	0.0	0.0
chr2	CFAP221	119638129	119638220	0	92	4978	9690	4978	9598	0.0	0.5186497186913941
chr2	CFAP221	119638258	119638417	0	160	4978	9690	4978	9530	0.0	0.5223504721930745
chr2	CFAP221	119556036	119556239	0	204	4978	9690	4978	9486	0.0	0.5247733502002951
chr2	CFAP221	119557007	119557405	0	399	4978	9690	4978	9291	0.0	0.5357873210633947
chr2	TEX51	126899798	126899853	0	56	0	1165	0	1109	0.0	0.0
chr2	TEX51	126899935	126900019	0	85	0	1165	0	1080	0.0	0.0
chr2	TEX51	126899835	126899853	0	19	0	1165	0	1146	0.0	0.0
chr2	AC010976.1	127470354	127470455	0	102	0	5506	0	5404	0.0	0.0
chr2	AC010976.1	127482827	127482975	0	149	0	5506	0	5357	0.0	0.0
chr2	AC010976.1	127464840	127465030	0	191	0	5506	0	5315	0.0	0.0
chr2	AC010976.1	127468013	127468126	0	114	0	5506	0	5392	0.0	0.0
chr2	AC010976.1	127486419	127486517	0	99	0	5506	0	5407	0.0	0.0
chr2	AC010976.1	127482880	127482975	0	96	0	5506	0	5410	0.0	0.0
chr2	AC010976.1	127487984	127488146	0	163	0	5506	0	5343	0.0	0.0
chr2	GPR17	127648057	127648286	0	230	0	2675	0	2445	0.0	0.0
chr2	GPR17	127650010	127650075	0	66	0	2675	0	2609	0.0	0.0
chr2	DARS-AS1	136014048	136014134	0	87	3985	5976	3985	5889	0.0	0.6766853455595178
chr2	DARS-AS1	136014655	136014762	0	108	3985	5976	3985	5868	0.0	0.679107021131561
chr2	DARS-AS1	136002000	136002126	0	127	3985	5976	3985	5849	0.0	0.6813130449649513
chr2	DARS-AS1	136003244	136003367	7	124	3985	5976	3978	5852	0.056451612903225805	0.6797676008202324
chr2	KYNU	142879462	142879666	0	205	0	17465	0	17260	0.0	0.0
chr2	KYNU	142881344	142881430	0	87	0	17465	0	17378	0.0	0.0
chr2	TEX41	144691038	144691110	0	73	7612	26381	7612	26308	0.0	0.2893416451269576
chr2	TEX41	144766369	144766530	0	162	7612	26381	7612	26219	0.0	0.29032381097677257
chr2	TEX41	144671601	144671664	0	64	7612	26381	7612	26317	0.0	0.28924269483603754
chr2	TEX41	144863944	144863998	0	55	7612	26381	7612	26326	0.0	0.28914381220086605
chr2	TEX41	144903665	144903803	0	139	7612	26381	7612	26242	0.0	0.2900693544699337
chr2	TEX41	145057650	145057728	0	79	7612	26381	7612	26302	0.0	0.2894076496083948
chr2	TEX41	144940857	144940945	0	89	7612	26381	7612	26292	0.0	0.28951772402251635
chr2	TEX41	145016367	145016523	0	157	7612	26381	7612	26224	0.0	0.2902684563758389
chr2	TEX41	144671606	144671664	0	59	7612	26381	7612	26322	0.0	0.289187751690601
chr2	TEX41	144763396	144763528	52	133	7612	26381	7560	26248	0.39097744360902253	0.28802194452910695
chr2	TEX41	145171997	145172131	80	135	7612	26381	7532	26246	0.5925925925925926	0.2869770631715309
chr2	TEX41	145117555	145117653	0	99	7612	26381	7612	26282	0.0	0.28962788220074576
chr2	TEX41	144753114	144753205	0	92	7612	26381	7612	26289	0.0	0.28955076267640456
chr2	TEX41	144851044	144851158	0	115	7612	26381	7612	26266	0.0	0.2898043097540547
chr2	TEX41	144768097	144768280	0	184	7612	26381	7612	26197	0.0	0.29056762224682214
chr2	TEX41	145070819	145070941	0	123	7612	26381	7612	26258	0.0	0.2898926041587326
chr2	TEX41	145164172	145164312	0	141	7612	26381	7612	26240	0.0	0.29009146341463415
chr2	TEX41	145178876	145178967	0	92	7612	26381	7612	26289	0.0	0.28955076267640456
chr2	TEX41	145181009	145181112	0	104	7612	26381	7612	26277	0.0	0.2896829927312859
chr2	TEX41	145174889	145174996	0	108	7612	26381	7612	26273	0.0	0.28972709625851634
chr2	TEX41	145174889	145174992	0	104	7612	26381	7612	26277	0.0	0.2896829927312859
chr2	TEX41	145178732	145178967	0	236	7612	26381	7612	26145	0.0	0.29114553451902847
chr2	TEX41	145113220	145113443	0	224	7612	26381	7612	26157	0.0	0.2910119662040754
chr2	TEX41	145182045	145182093	0	49	7612	26381	7612	26332	0.0	0.28907792799635423
chr2	TEX41	145181196	145181293	0	98	7612	26381	7612	26283	0.0	0.2896168626108131
chr2	TEX41	144865394	144865460	0	67	7612	26381	7612	26314	0.0	0.2892756707456107
chr2	TEX41	144935343	144935483	0	141	7612	26381	7612	26240	0.0	0.29009146341463415
chr2	TEX41	145072523	145072823	0	301	7612	26381	7612	26080	0.0	0.29187116564417176
chr2	TEX41	145090830	145090903	0	74	7612	26381	7612	26307	0.0	0.28935264378302356
chr2	TEX41	145034793	145034885	0	93	7612	26381	7612	26288	0.0	0.289561777236762
chr2	TEX41	145174886	145174992	0	107	7612	26381	7612	26274	0.0	0.289716069117759
chr2	TEX41	145044365	145044463	0	99	7612	26381	7612	26282	0.0	0.28962788220074576
chr2	TEX41	145043886	145044067	0	182	7612	26381	7612	26199	0.0	0.2905454406656743
chr2	LINC01911	146856647	146856807	0	161	0	3576	0	3415	0.0	0.0
chr2	LINC01911	146859537	146859601	0	65	0	3576	0	3511	0.0	0.0
chr2	LINC01911	146857978	146858111	0	134	0	3576	0	3442	0.0	0.0
chr2	LINC01911	146858511	146858644	0	134	0	3576	0	3442	0.0	0.0
chr2	LINC02612	150629430	150629582	0	153	0	3285	0	3132	0.0	0.0
chr2	LINC02612	150629639	150629714	0	76	0	3285	0	3209	0.0	0.0
chr2	AC073225.1	155608214	155608419	0	206	102	17123	102	16917	0.0	0.006029437843589289
chr2	AC073225.1	155626640	155626788	0	149	102	17123	102	16974	0.0	0.006009190526687876
chr2	AC073225.1	155608251	155608419	0	169	102	17123	102	16954	0.0	0.0060162793441075856
chr2	AC073225.1	155541659	155541739	0	81	102	17123	102	17042	0.0	0.005985213003168642
chr2	AC073225.1	155541739	155541814	0	76	102	17123	102	17047	0.0	0.005983457499853346
chr2	AC073225.1	155544224	155544329	0	106	102	17123	102	17017	0.0	0.005994005994005994
chr2	AC073225.1	155560440	155560542	0	103	102	17123	102	17020	0.0	0.005992949471210341
chr2	SCN2A	165309164	165309256	0	93	0	23956	0	23863	0.0	0.0
chr2	SCN2A	165309351	165309443	0	93	0	23956	0	23863	0.0	0.0
chr2	SCN2A	165245329	165245448	0	120	0	23956	0	23836	0.0	0.0
chr2	SCN2A	165290629	165290785	0	157	0	23956	0	23799	0.0	0.0
chr2	SCN1A-AS1	166263711	166263806	0	96	0	18935	0	18839	0.0	0.0
chr2	SCN1A-AS1	166277087	166277247	0	161	0	18935	0	18774	0.0	0.0
chr2	SCN1A-AS1	165984616	165984776	0	161	0	18935	0	18774	0.0	0.0
chr2	SCN1A-AS1	166012840	166012966	0	127	0	18935	0	18808	0.0	0.0
chr2	SCN1A-AS1	166104246	166104348	0	103	0	18935	0	18832	0.0	0.0
chr2	SCN1A-AS1	166109490	166109602	0	113	0	18935	0	18822	0.0	0.0
chr2	NOSTRIN	168811566	168811652	3307	87	35356	4668	32049	4581	38.01149425287356	6.99607072691552
chr2	NOSTRIN	168824633	168824717	0	85	35356	4668	35356	4583	0.0	7.714597425267292
chr2	DHRS9	169072574	169072685	0	112	0	3762	0	3650	0.0	0.0
chr2	DHRS9	169081050	169081152	0	103	0	3762	0	3659	0.0	0.0
chr2	PHOSPHO2	169697360	169697531	141	172	422	1494	281	1322	0.8197674418604651	0.21255673222390317
chr2	PHOSPHO2	169697892	169697982	46	91	422	1494	376	1403	0.5054945054945055	0.26799714896650034
chr2	UBR3	170013840	170013972	0	133	0	9972	0	9839	0.0	0.0
chr2	UBR3	170014814	170014865	0	52	0	9972	0	9920	0.0	0.0
chr2	GORASP2	170929816	170929941	248	126	543	4718	295	4592	1.9682539682539681	0.06424216027874564
chr2	GORASP2	170936623	170936727	0	105	543	4718	543	4613	0.0	0.11771081725558205
chr2	GORASP2	170929740	170929941	248	202	543	4718	295	4516	1.2277227722772277	0.06532329495128432
chr2	HAT1	171946707	171946783	0	77	1173	5990	1173	5913	0.0	0.19837645865043124
chr2	HAT1	171952880	171953001	0	122	1173	5990	1173	5868	0.0	0.19989775051124745
chr2	ITGA6	172470973	172471105	0	133	0	6738	0	6605	0.0	0.0
chr2	ITGA6	172472773	172472890	0	118	0	6738	0	6620	0.0	0.0
chr2	PDK1	172562740	172562800	49	61	140295	13131	140246	13070	0.8032786885245902	10.730374904361133
chr2	PDK1	172564051	172564130	0	80	140295	13131	140295	13051	0.0	10.749750976936634
chr2	PDK1	172562219	172562291	0	73	140295	13131	140295	13058	0.0	10.743988359626282
chr2	PDK1	172564502	172564687	0	186	140295	13131	140295	12945	0.0	10.837775202780996
chr2	PJVK	178458509	178458627	0	119	0	3976	0	3857	0.0	0.0
chr2	PJVK	178460347	178460446	0	100	0	3976	0	3876	0.0	0.0
chr2	TTN-AS1	178529284	178529336	0	53	51	21966	51	21913	0.0	0.0023273855702094647
chr2	TTN-AS1	178531313	178531578	0	266	51	21966	51	21700	0.0	0.002350230414746544
chr2	TTN-AS1	178528723	178528813	0	91	51	21966	51	21875	0.0	0.0023314285714285715
chr2	TTN-AS1	178571299	178571449	0	151	51	21966	51	21815	0.0	0.002337840935136374
chr2	TTN-AS1	178535731	178535828	0	98	51	21966	51	21868	0.0	0.002332174867386135
chr2	TTN-AS1	178537603	178537691	0	89	51	21966	51	21877	0.0	0.002331215431731956
chr2	TTN-AS1	178584572	178584993	0	422	51	21966	51	21544	0.0	0.0023672484218343853
chr2	TTN-AS1	178536333	178536462	0	130	51	21966	51	21836	0.0	0.002335592599377175
chr2	TTN-AS1	178537360	178537447	0	88	51	21966	51	21878	0.0	0.0023311088764969377
chr2	TTN-AS1	178583523	178583648	0	126	51	21966	51	21840	0.0	0.002335164835164835
chr2	TTN-AS1	178591138	178591314	0	177	51	21966	51	21789	0.0	0.0023406305934186977
chr2	TTN-AS1	178600557	178600667	0	111	51	21966	51	21855	0.0	0.0023335621139327386
chr2	TTN-AS1	178636573	178636698	51	126	51	21966	0	21840	0.40476190476190477	0.0
chr2	LINC01934	181262828	181262977	0	150	0	15079	0	14929	0.0	0.0
chr2	LINC01934	181354207	181354343	0	137	0	15079	0	14942	0.0	0.0
chr2	LINC01934	181283176	181283400	0	225	0	15079	0	14854	0.0	0.0
chr2	LINC01934	181341045	181341129	0	85	0	15079	0	14994	0.0	0.0
chr2	NUP35	183118326	183118408	0	83	0	2638	0	2555	0.0	0.0
chr2	NUP35	183120005	183120114	0	110	0	2638	0	2528	0.0	0.0
chr2	ASNSD1	189666040	189666153	0	114	0	2491	0	2377	0.0	0.0
chr2	ASNSD1	189667195	189667596	0	402	0	2491	0	2089	0.0	0.0
chr2	PMS1	189863742	189863974	0	233	127486	4376	127486	4143	0.0	30.771421675114652
chr2	PMS1	189867798	189867929	637	132	127486	4376	126849	4244	4.825757575757576	29.889019792648444
chr2	PMS1	189795768	189795951	0	184	127486	4376	127486	4192	0.0	30.411736641221374
chr2	PMS1	189805651	189805754	0	104	127486	4376	127486	4272	0.0	29.842228464419474
chr2	INPP1	190348887	190349031	0	145	816	3107	816	2962	0.0	0.275489534098582
chr2	INPP1	190359645	190359698	0	54	816	3107	816	3053	0.0	0.26727808712741563
chr2	CAVIN2-AS1	192031331	192031603	0	273	1371	4592	1371	4319	0.0	0.3174345913405881
chr2	CAVIN2-AS1	192032570	192032638	0	69	1371	4592	1371	4523	0.0	0.3031173999557816
chr2	LINC01821	194368840	194369072	0	233	51	5214	51	4981	0.0	0.010238907849829351
chr2	LINC01821	194374135	194374262	0	128	51	5214	51	5086	0.0	0.010027526543452615
chr2	LINC01821	194350667	194350753	0	87	51	5214	51	5127	0.0	0.00994733762434172
chr2	LINC01821	194365412	194365555	0	144	51	5214	51	5070	0.0	0.010059171597633136
chr2	MOB4	197523623	197523686	1372	64	1732	4091	360	4027	21.4375	0.0893965731313633
chr2	MOB4	197535529	197535630	0	102	1732	4091	1732	3989	0.0	0.43419403359237907
chr2	MOB4	197535529	197535605	0	77	1732	4091	1732	4014	0.0	0.43148978574987545
chr2	LINC01877	199608232	199608335	0	104	722	9864	722	9760	0.0	0.07397540983606557
chr2	LINC01877	199624531	199624596	722	66	722	9864	0	9798	10.93939393939394	0.0
chr2	SPATS2L	200372108	200372251	0	144	0	10302	0	10158	0.0	0.0
chr2	SPATS2L	200378140	200378371	0	232	0	10302	0	10070	0.0	0.0
chr2	SPATS2L	200383866	200384017	0	152	0	10302	0	10150	0.0	0.0
chr2	CASP10	201203729	201203766	0	38	204	7593	204	7555	0.0	0.02700198544010589
chr2	CASP10	201208074	201208183	0	110	204	7593	204	7483	0.0	0.02726179339836964
chr2	CASP8	201272897	201272942	0	46	10393	7205	10393	7159	0.0	1.4517390697024724
chr2	CASP8	201274888	201274953	0	66	10393	7205	10393	7139	0.0	1.4558061353130691
chr2	CARF	202924356	202924415	0	60	1123	10132	1123	10072	0.0	0.11149722001588562
chr2	CARF	202941859	202941980	0	122	1123	10132	1123	10010	0.0	0.1121878121878122
chr2	CARF	202924296	202924415	0	120	1123	10132	1123	10012	0.0	0.11216540151817819
chr2	CARF	202938273	202938395	52	123	1123	10132	1071	10009	0.42276422764227645	0.10700369667299431
chr2	CARF	202934501	202934599	0	99	1123	10132	1123	10033	0.0	0.11193062892454898
chr2	CARF	202942739	202942967	0	229	1123	10132	1123	9903	0.0	0.11339997980409977
chr2	ABI2	203342196	203342230	8	35	125437	18798	125429	18763	0.22857142857142856	6.684911794489154
chr2	ABI2	203351554	203351678	153	125	125437	18798	125284	18673	1.224	6.709366464949392
chr2	ABI2	203355153	203355324	814	172	125437	18798	124623	18626	4.732558139534884	6.6908085471920975
chr2	ADAM23	206605789	206605880	0	92	13699	6452	13699	6360	0.0	2.153930817610063
chr2	ADAM23	206609909	206610000	0	92	13699	6452	13699	6360	0.0	2.153930817610063
chr2	PIKFYVE	208274020	208274053	25	34	25	10883	0	10849	0.7352941176470589	0.0
chr2	PIKFYVE	208276711	208276830	0	120	25	10883	25	10763	0.0	0.0023227724612097
chr2	RPE	210003437	210003468	0	32	119	3448	119	3416	0.0	0.03483606557377049
chr2	RPE	210009656	210009736	0	81	119	3448	119	3367	0.0	0.035343035343035345
chr2	RPE	210009638	210009736	0	99	119	3448	119	3349	0.0	0.03553299492385787
chr2	RPE	210017789	210017887	0	99	119	3448	119	3349	0.0	0.03553299492385787
chr2	RPE	210018152	210018221	0	70	119	3448	119	3378	0.0	0.03522794552989935
chr2	SNHG31	214842736	214842832	0	97	0	2559	0	2462	0.0	0.0
chr2	SNHG31	214960392	214960590	0	199	0	2559	0	2360	0.0	0.0
chr2	SNHG31	214947824	214947947	0	124	0	2559	0	2435	0.0	0.0
chr2	SLC11A1	218382959	218383102	0	144	0	7083	0	6939	0.0	0.0
chr2	SLC11A1	218384242	218384365	0	124	0	7083	0	6959	0.0	0.0
chr2	BCS1L	218660036	218660245	0	210	0	2642	0	2432	0.0	0.0
chr2	BCS1L	218660306	218660482	0	177	0	2642	0	2465	0.0	0.0
chr2	BCS1L	218660036	218660218	0	183	0	2642	0	2459	0.0	0.0
chr2	BCS1L	218660036	218660166	0	131	0	2642	0	2511	0.0	0.0
chr2	TTLL4	218747002	218747194	0	193	0	7190	0	6997	0.0	0.0
chr2	TTLL4	218747289	218747372	0	84	0	7190	0	7106	0.0	0.0
chr2	TTLL4	218728024	218728067	0	44	0	7190	0	7146	0.0	0.0
chr2	TTLL4	218736311	218736376	0	66	0	7190	0	7124	0.0	0.0
chr2	ZFAND2B	219207647	219207779	748	133	12355	2754	11607	2621	5.62406015037594	4.428462418924075
chr2	ZFAND2B	219207886	219208038	0	153	12355	2754	12355	2601	0.0	4.750096116878124
chr2	ANKZF1	219230227	219230350	0	124	255	4424	255	4300	0.0	0.05930232558139535
chr2	ANKZF1	219231927	219232040	0	114	255	4424	255	4310	0.0	0.05916473317865429
chr2	ANKZF1	219230227	219230405	0	179	255	4424	255	4245	0.0	0.06007067137809187
chr2	STK16	219246656	219246876	0	221	102	4345	102	4124	0.0	0.024733268671193017
chr2	STK16	219247112	219247246	0	135	102	4345	102	4210	0.0	0.024228028503562947
chr2	RHBDD1	226838072	226838154	0	83	102	6916	102	6833	0.0	0.01492755744182643
chr2	RHBDD1	226839408	226839627	0	220	102	6916	102	6696	0.0	0.015232974910394265
chr2	MFF	227342744	227342819	0	76	0	4113	0	4037	0.0	0.0
chr2	MFF	227352513	227352573	0	61	0	4113	0	4052	0.0	0.0
chr2	MFF	227347225	227347384	0	160	0	4113	0	3953	0.0	0.0
chr2	DAW1	227872148	227872399	0	252	588	2951	588	2699	0.0	0.21785846609855503
chr2	DAW1	227876442	227876494	0	53	588	2951	588	2898	0.0	0.2028985507246377
chr2	AC009950.1	230140067	230140146	0	80	102	5424	102	5344	0.0	0.01908682634730539
chr2	AC009950.1	230167296	230167652	0	357	102	5424	102	5067	0.0	0.020130254588513915
chr2	AC009950.1	230172424	230172515	0	92	102	5424	102	5332	0.0	0.019129782445611403
chr2	AC009950.1	230172569	230172802	51	234	102	5424	51	5190	0.21794871794871795	0.009826589595375723
chr2	SP140	230253315	230253417	0	103	0	5515	0	5412	0.0	0.0
chr2	SP140	230255451	230255532	0	82	0	5515	0	5433	0.0	0.0
chr2	PSMD1	231163634	231163727	0	94	5976	14058	5976	13964	0.0	0.4279576052706961
chr2	PSMD1	231165199	231165286	0	88	5976	14058	5976	13970	0.0	0.42777380100214746
chr2	COPS7B	231788554	231788732	0	179	0	4651	0	4472	0.0	0.0
chr2	COPS7B	231794262	231794351	0	90	0	4651	0	4561	0.0	0.0
chr2	COPS7B	231791732	231791808	0	77	0	4651	0	4574	0.0	0.0
chr2	GIGYF2	232724573	232724691	0	119	350	15277	350	15158	0.0	0.02309011742974007
chr2	GIGYF2	232734416	232734486	0	71	350	15277	350	15206	0.0	0.023017230040773377
chr2	GIGYF2	232731121	232731234	0	114	350	15277	350	15163	0.0	0.02308250346237552
chr2	GIGYF2	232719037	232719128	0	92	350	15277	350	15185	0.0	0.02304906157392163
chr2	GIGYF2	232731121	232731258	0	138	350	15277	350	15139	0.0	0.023119096373604597
chr2	GIGYF2	232698268	232698307	0	40	350	15277	350	15237	0.0	0.0229704009975717
chr2	GIGYF2	232700584	232700654	0	71	350	15277	350	15206	0.0	0.023017230040773377
chr2	GIGYF2	232703423	232703489	0	67	350	15277	350	15210	0.0	0.023011176857330704
chr2	SAG	233309112	233309264	0	153	0	10539	0	10386	0.0	0.0
chr2	SAG	233316074	233316135	0	62	0	10539	0	10477	0.0	0.0
chr2	MLPH	237527376	237527516	0	141	840	6657	840	6516	0.0	0.1289134438305709
chr2	MLPH	237534563	237534647	0	85	840	6657	840	6572	0.0	0.1278149726110773
chr2	MLPH	237527328	237527516	0	189	840	6657	840	6468	0.0	0.12987012987012986
chr2	UBE2F	237973648	237973747	0	100	1036	3471	1036	3371	0.0	0.30732720261050134
chr2	UBE2F	237986161	237986292	0	132	1036	3471	1036	3339	0.0	0.31027253668763105
chr2	UBE2F	238016565	238016633	0	69	1036	3471	1036	3402	0.0	0.3045267489711934
chr2	UBE2F	238025341	238025412	0	72	1036	3471	1036	3399	0.0	0.30479552809649896
chr2	UBE2F	238030555	238030613	0	59	1036	3471	1036	3412	0.0	0.30363423212192264
chr2	UBE2F	237994743	237994809	1036	67	1036	3471	0	3404	15.462686567164178	0.0
chr2	UBE2F	237987962	237987992	0	31	1036	3471	1036	3440	0.0	0.30116279069767443
chr2	ASB1	238433553	238433695	288	143	7344	2402	7056	2259	2.013986013986014	3.1235059760956174
chr2	ASB1	238435710	238436013	51	304	7344	2402	7293	2098	0.16776315789473684	3.4761677788369876
chr2	SEPTIN2	241324215	241324241	0	27	230	6771	230	6744	0.0	0.034104389086595494
chr2	SEPTIN2	241325992	241326113	0	122	230	6771	230	6649	0.0	0.03459166791998797
chr2	SEPTIN2	241317498	241317599	0	102	230	6771	230	6669	0.0	0.03448792922477133
chr2	SEPTIN2	241320202	241320287	0	86	230	6771	230	6685	0.0	0.0344053851907255
chr2	SEPTIN2	241316421	241316555	0	135	230	6771	230	6636	0.0	0.034659433393610606
chr2	ATG4B	241651883	241651974	0	92	204	6287	204	6195	0.0	0.03292978208232446
chr2	ATG4B	241653306	241653369	0	64	204	6287	204	6223	0.0	0.03278161658364133
chr3	LINC01986	14770	14831	0	62	0	2024	0	1962	0.0	0.0
chr3	LINC01986	20556	20597	0	42	0	2024	0	1982	0.0	0.0
chr3	LINC01266	827006	827133	0	128	0	11866	0	11738	0.0	0.0
chr3	LINC01266	840714	840810	0	97	0	11866	0	11769	0.0	0.0
chr3	LINC01266	552688	552854	0	167	0	11866	0	11699	0.0	0.0
chr3	LINC01266	592104	592183	0	80	0	11866	0	11786	0.0	0.0
chr3	CNTN4	2099273	2099649	0	377	0	8815	0	8438	0.0	0.0
chr3	CNTN4	2100557	2100639	0	83	0	8815	0	8732	0.0	0.0
chr3	TRNT1	3139588	3139710	0	123	0	5803	0	5680	0.0	0.0
chr3	TRNT1	3140509	3140648	0	140	0	5803	0	5663	0.0	0.0
chr3	TRNT1	3137259	3137453	0	195	0	5803	0	5608	0.0	0.0
chr3	TRNT1	3140509	3140578	0	70	0	5803	0	5733	0.0	0.0
chr3	AC069277.1	6706635	6706728	0	94	1620	6372	1620	6278	0.0	0.25804396304555594
chr3	AC069277.1	6710452	6710543	0	92	1620	6372	1620	6280	0.0	0.25796178343949044
chr3	AC069277.1	6697395	6697511	0	117	1620	6372	1620	6255	0.0	0.2589928057553957
chr3	AC069277.1	6697831	6697947	0	117	1620	6372	1620	6255	0.0	0.2589928057553957
chr3	AC069277.1	6697782	6697947	0	166	1620	6372	1620	6206	0.0	0.26103770544634225
chr3	AC069277.1	6697831	6697897	0	67	1620	6372	1620	6305	0.0	0.25693893735130846
chr3	AC069277.1	6694724	6694877	0	154	1620	6372	1620	6218	0.0	0.2605339337407527
chr3	LMCD1	8532736	8532825	0	90	639	9033	639	8943	0.0	0.07145253270714526
chr3	LMCD1	8537184	8537440	0	257	639	9033	639	8776	0.0	0.07281221513217867
chr3	SETD5	9429826	9430051	4755	226	345674	12159	340919	11933	21.039823008849556	28.569429313667978
chr3	SETD5	9433369	9433562	57626	194	345674	12159	288048	11965	297.0412371134021	24.074216464688675
chr3	MTMR14	9689963	9690143	0	181	1215	3678	1215	3497	0.0	0.34744066342579355
chr3	MTMR14	9697710	9697866	0	157	1215	3678	1215	3521	0.0	0.3450724226072139
chr3	ARPC4	9801660	9801756	64	97	188349	3616	188285	3519	0.6597938144329897	53.5052571753339
chr3	ARPC4	9803842	9804013	8398	172	188349	3616	179951	3444	48.825581395348834	52.25058072009291
chr3	TTLL3	9817644	9817759	72	116	362171	7028	362099	6912	0.6206896551724138	52.387008101851855
chr3	TTLL3	9818554	9818920	0	367	362171	7028	362171	6661	0.0	54.37186608617325
chr3	IL17RE	9903396	9903412	0	17	839	4690	839	4673	0.0	0.17954205007489835
chr3	IL17RE	9904031	9904151	0	121	839	4690	839	4569	0.0	0.1836288028014883
chr3	IL17RC	9930027	9930149	0	123	12687	3519	12687	3396	0.0	3.7358657243816253
chr3	IL17RC	9930399	9930459	0	61	12687	3519	12687	3458	0.0	3.6688837478311163
chr3	EMC3-AS1	9987814	9987905	6620	92	246989	2562	240369	2470	71.95652173913044	97.31538461538462
chr3	EMC3-AS1	9987905	9988007	7124	103	246989	2562	239865	2459	69.16504854368932	97.54575030500203
chr3	SLC6A1	11018597	11018698	0	102	0	12472	0	12370	0.0	0.0
chr3	SLC6A1	11020212	11020322	0	111	0	12472	0	12361	0.0	0.0
chr3	SLC6A1	11001148	11001303	0	156	0	12472	0	12316	0.0	0.0
chr3	SLC6A1	11012598	11012762	0	165	0	12472	0	12307	0.0	0.0
chr3	SLC6A1	11008311	11008363	0	53	0	12472	0	12419	0.0	0.0
chr3	SLC6A1	11013994	11014184	0	191	0	12472	0	12281	0.0	0.0
chr3	SLC6A1	11011286	11011325	0	40	0	12472	0	12432	0.0	0.0
chr3	SLC6A1	11014717	11014874	0	158	0	12472	0	12314	0.0	0.0
chr3	SLC6A1	11014065	11014184	0	120	0	12472	0	12352	0.0	0.0
chr3	SLC6A1	11014031	11014184	0	154	0	12472	0	12318	0.0	0.0
chr3	ATG7	11379971	11380052	0	82	98972	8862	98972	8780	0.0	11.272437357630979
chr3	ATG7	11426803	11426926	0	124	98972	8862	98972	8738	0.0	11.326619363698788
chr3	PPARG	12344806	12344894	0	89	4942	4552	4942	4463	0.0	1.1073269101501233
chr3	PPARG	12371850	12372111	0	262	4942	4552	4942	4290	0.0	1.151981351981352
chr3	HDAC11	13498512	13498555	0	44	102	5097	102	5053	0.0	0.020186028102117552
chr3	HDAC11	13500712	13500789	0	78	102	5097	102	5019	0.0	0.020322773460848775
chr3	HDAC11	13483463	13483564	0	102	102	5097	102	4995	0.0	0.02042042042042042
chr3	HDAC11	13501870	13501933	0	64	102	5097	102	5033	0.0	0.02026624279753626
chr3	TPRXL	13955561	13955654	0	94	255	3521	255	3427	0.0	0.07440910417274584
chr3	TPRXL	14028275	14028384	0	110	255	3521	255	3411	0.0	0.07475813544415127
chr3	TPRXL	14057137	14057184	0	48	255	3521	255	3473	0.0	0.0734235531241002
chr3	TPRXL	14063378	14063508	0	131	255	3521	255	3390	0.0	0.0752212389380531
chr3	SATB1-AS1	18472361	18472459	0	99	0	12779	0	12680	0.0	0.0
chr3	SATB1-AS1	18473711	18473858	0	148	0	12779	0	12631	0.0	0.0
chr3	SATB1-AS1	18516044	18516178	0	135	0	12779	0	12644	0.0	0.0
chr3	SATB1-AS1	18511531	18511628	0	98	0	12779	0	12681	0.0	0.0
chr3	SATB1-AS1	18527950	18528139	0	190	0	12779	0	12589	0.0	0.0
chr3	SATB1-AS1	18529980	18530185	0	206	0	12779	0	12573	0.0	0.0
chr3	SATB1-AS1	18585386	18585442	0	57	0	12779	0	12722	0.0	0.0
chr3	SATB1-AS1	18548063	18548193	0	131	0	12779	0	12648	0.0	0.0
chr3	SATB1-AS1	18568106	18568154	0	49	0	12779	0	12730	0.0	0.0
chr3	LINC01980	27826057	27826211	0	155	0	4756	0	4601	0.0	0.0
chr3	LINC01980	27848700	27848764	0	65	0	4756	0	4691	0.0	0.0
chr3	LINC01980	27806531	27806622	0	92	0	4756	0	4664	0.0	0.0
chr3	LINC01980	27807952	27808008	0	57	0	4756	0	4699	0.0	0.0
chr3	LINC01980	27806453	27806622	0	170	0	4756	0	4586	0.0	0.0
chr3	LINC01980	27806451	27806622	0	172	0	4756	0	4584	0.0	0.0
chr3	LINC01980	27841727	27841925	0	199	0	4756	0	4557	0.0	0.0
chr3	LINC01980	27826057	27826164	0	108	0	4756	0	4648	0.0	0.0
chr3	LINC01980	27823528	27823617	0	90	0	4756	0	4666	0.0	0.0
chr3	LINC01980	27802763	27802850	0	88	0	4756	0	4668	0.0	0.0
chr3	LINC01980	27802113	27802850	0	738	0	4756	0	4018	0.0	0.0
chr3	LINC01980	27841727	27841823	0	97	0	4756	0	4659	0.0	0.0
chr3	GPD1L	32128075	32128253	0	179	29	4164	29	3985	0.0	0.007277289836888331
chr3	GPD1L	32138586	32138727	0	142	29	4164	29	4022	0.0	0.0072103431128791645
chr3	CNOT10	32765049	32765177	0	129	40685	4488	40685	4359	0.0	9.333562743748566
chr3	CNOT10	32769886	32769962	0	77	40685	4488	40685	4411	0.0	9.223532078893674
chr3	FBXL2	33297868	33297962	0	95	3152	7427	3152	7332	0.0	0.4298963447899618
chr3	FBXL2	33364624	33364719	0	96	3152	7427	3152	7331	0.0	0.4299549856772609
chr3	PDCD6IP	33813558	33813628	0	71	171570	8689	171570	8618	0.0	19.908331399396612
chr3	PDCD6IP	33822034	33822082	0	49	171570	8689	171570	8640	0.0	19.85763888888889
chr3	LINC01811	34300690	34300841	0	152	0	7983	0	7831	0.0	0.0
chr3	LINC01811	34346221	34346289	0	69	0	7983	0	7914	0.0	0.0
chr3	LINC01811	34367379	34367468	0	90	0	7983	0	7893	0.0	0.0
chr3	LINC01811	34386890	34387077	0	188	0	7983	0	7795	0.0	0.0
chr3	LINC01811	34298852	34298919	0	68	0	7983	0	7915	0.0	0.0
chr3	LINC01811	34409260	34409361	0	102	0	7983	0	7881	0.0	0.0
chr3	LINC01811	34170844	34170920	0	77	0	7983	0	7906	0.0	0.0
chr3	LINC01811	34323347	34323598	0	252	0	7983	0	7731	0.0	0.0
chr3	LINC01811	34337022	34337111	0	90	0	7983	0	7893	0.0	0.0
chr3	MLH1	36996623	36996709	0	87	27312	6920	27312	6833	0.0	3.9970730279525832
chr3	MLH1	37000954	37001053	0	100	27312	6920	27312	6820	0.0	4.004692082111437
chr3	MLH1	37042267	37042331	0	65	27312	6920	27312	6855	0.0	3.9842450765864332
chr3	MLH1	37047518	37047683	0	166	27312	6920	27312	6754	0.0	4.043825880959432
chr3	MLH1	37004400	37004474	0	75	27312	6920	27312	6845	0.0	3.9900657414170926
chr3	MLH1	37014431	37014544	0	114	27312	6920	27312	6806	0.0	4.012929767851896
chr3	MLH1	37020309	37020463	0	155	27312	6920	27312	6765	0.0	4.037250554323725
chr3	MLH1	37048516	37048609	5596	94	27312	6920	21716	6826	59.53191489361702	3.1813653677116904
chr3	MLH1	37017505	37017599	22	95	27312	6920	27290	6825	0.23157894736842105	3.9985347985347985
chr3	MYD88	38139863	38139998	0	136	0	3206	0	3070	0.0	0.0
chr3	MYD88	38140387	38140568	0	182	0	3206	0	3024	0.0	0.0
chr3	EXOG	38499680	38499747	0	68	28599	4763	28599	4695	0.0	6.091373801916933
chr3	EXOG	38500089	38500164	0	76	28599	4763	28599	4687	0.0	6.101770855557926
chr3	EXOG	38513749	38513868	0	120	28599	4763	28599	4643	0.0	6.159595089381865
chr3	EXOG	38519261	38519377	294	117	28599	4763	28305	4646	2.5128205128205128	6.092337494619027
chr3	EXOG	38498766	38498836	0	71	28599	4763	28599	4692	0.0	6.095268542199489
chr3	MOBP	39480039	39480123	0	85	0	9245	0	9160	0.0	0.0
chr3	MOBP	39499466	39499532	0	67	0	9245	0	9178	0.0	0.0
chr3	ENTPD3	40394308	40394431	0	124	5	3600	5	3476	0.0	0.0014384349827387803
chr3	ENTPD3	40394629	40394753	0	125	5	3600	5	3475	0.0	0.0014388489208633094
chr3	ZNF620	40507842	40507941	281	100	29332	3791	29051	3691	2.81	7.8707667298835
chr3	ZNF620	40508655	40508774	0	120	29332	3791	29332	3671	0.0	7.990193407790793
chr3	ACKR2	42819630	42819711	0	82	26862	5475	26862	5393	0.0	4.980901168180975
chr3	ACKR2	42864465	42864859	0	395	26862	5475	26862	5080	0.0	5.287795275590551
chr3	ACKR2	42839093	42839279	102	187	26862	5475	26760	5288	0.5454545454545454	5.0605143721633885
chr3	ABHD5	43714946	43715058	0	113	714	7414	714	7301	0.0	0.0977948226270374
chr3	ABHD5	43717670	43717857	0	188	714	7414	714	7226	0.0	0.0988098533075007
chr3	PTPN23	47396142	47396217	0	76	1443	5900	1443	5824	0.0	0.24776785714285715
chr3	PTPN23	47404651	47404779	0	129	1443	5900	1443	5771	0.0	0.2500433200485185
chr3	ARIH2	48922747	48922811	14	65	100980	7097	100966	7032	0.2153846153846154	14.358077360637088
chr3	ARIH2	48927461	48927813	0	353	100980	7097	100980	6744	0.0	14.973309608540925
chr3	ARIH2	48924717	48924839	84	123	100980	7097	100896	6974	0.6829268292682927	14.467450530542013
chr3	ARIH2	48945135	48945181	0	47	100980	7097	100980	7050	0.0	14.323404255319149
chr3	ARIH2	48961611	48961679	2304	69	100980	7097	98676	7028	33.391304347826086	14.040409789413774
chr3	ARIH2	48921479	48921576	21456	98	100980	7097	79524	6999	218.9387755102041	11.362194599228461
chr3	ARIH2	48922348	48922468	0	121	100980	7097	100980	6976	0.0	14.475344036697248
chr3	WDR6	49008926	49009024	2414	99	160033	4997	157619	4898	24.383838383838384	32.1802776643528
chr3	WDR6	49011420	49011516	25	97	160033	4997	160008	4900	0.25773195876288657	32.65469387755102
chr3	WDR6	49011634	49011741	0	108	160033	4997	160033	4889	0.0	32.73327878911843
chr3	DAG1	49476848	49476905	0	58	4259	6735	4259	6677	0.0	0.6378613149618092
chr3	DAG1	49492822	49492973	0	152	4259	6735	4259	6583	0.0	0.646969466808446
chr3	DAG1	49476848	49476900	0	53	4259	6735	4259	6682	0.0	0.6373840167614486
chr3	DAG1	49488625	49488745	0	121	4259	6735	4259	6614	0.0	0.6439371031146054
chr3	DAG1	49492826	49492973	0	148	4259	6735	4259	6587	0.0	0.6465765902535296
chr3	APEH	49676055	49676219	0	165	1028	4242	1028	4077	0.0	0.25214618592102034
chr3	APEH	49676377	49676515	0	139	1028	4242	1028	4103	0.0	0.2505483792347063
chr3	TEX264	51674270	51674562	1428	293	62004	2470	60576	2177	4.873720136518771	27.825447864033073
chr3	TEX264	51684412	51684634	521	223	62004	2470	61483	2247	2.336322869955157	27.362260792167334
chr3	TEX264	51672209	51672301	7343	93	62004	2470	54661	2377	78.95698924731182	22.995793016407237
chr3	TEX264	51672340	51672392	740	53	62004	2470	61264	2417	13.962264150943396	25.34712453454696
chr3	ABHD14A-ACY1	51985206	51985271	0	66	7419	4173	7419	4107	0.0	1.806428049671293
chr3	ABHD14A-ACY1	51985360	51985465	0	106	7419	4173	7419	4067	0.0	1.8241947381362182
chr3	ABHD14A-ACY1	51984046	51984158	0	113	7419	4173	7419	4060	0.0	1.8273399014778324
chr3	ABHD14A-ACY1	51984060	51984158	0	99	7419	4173	7419	4074	0.0	1.821060382916053
chr3	ABHD14A-ACY1	51985851	51985946	0	96	7419	4173	7419	4077	0.0	1.8197203826342898
chr3	ABHD14A-ACY1	51985400	51985465	0	66	7419	4173	7419	4107	0.0	1.806428049671293
chr3	ABHD14A-ACY1	51986987	51987061	0	75	7419	4173	7419	4098	0.0	1.8103953147877012
chr3	ABHD14A-ACY1	51987308	51987453	336	146	7419	4173	7083	4027	2.3013698630136985	1.758877576359573
chr3	PRKCD	53165103	53165215	0	113	48947	3643	48947	3530	0.0	13.86600566572238
chr3	PRKCD	53173526	53173608	0	83	48947	3643	48947	3560	0.0	13.749157303370787
chr3	PRKCD	53173492	53173608	0	117	48947	3643	48947	3526	0.0	13.881735677821894
chr3	CACNA1D	53673022	53673126	0	105	1326	18895	1326	18790	0.0	0.07056945183608303
chr3	CACNA1D	53673712	53673816	0	105	1326	18895	1326	18790	0.0	0.07056945183608303
chr3	CACNA1D	53761997	53762081	0	85	1326	18895	1326	18810	0.0	0.07049441786283892
chr3	CACNA1D	53762550	53762634	0	85	1326	18895	1326	18810	0.0	0.07049441786283892
chr3	CACNA1D	53740279	53740339	0	61	1326	18895	1326	18834	0.0	0.07040458744823191
chr3	CACNA1D	53740418	53740478	0	61	1326	18895	1326	18834	0.0	0.07040458744823191
chr3	CCDC66	56560861	56561012	0	152	5721	7437	5721	7285	0.0	0.7853122855181881
chr3	CCDC66	56561256	56561378	0	123	5721	7437	5721	7314	0.0	0.7821985233798195
chr3	CCDC66	56571180	56571302	0	123	5721	7437	5721	7314	0.0	0.7821985233798195
chr3	CCDC66	56592969	56593101	1386	133	5721	7437	4335	7304	10.421052631578947	0.5935104052573932
chr3	SLMAP	57864806	57864857	0	52	104133	15102	104133	15050	0.0	6.919136212624585
chr3	SLMAP	57871635	57871698	0	64	104133	15102	104133	15038	0.0	6.924657534246576
chr3	SLMAP	57865241	57865292	0	52	104133	15102	104133	15050	0.0	6.919136212624585
chr3	SLMAP	57883960	57884026	110	67	104133	15102	104023	15035	1.6417910447761195	6.918722979714
chr3	SLMAP	57922888	57923023	0	136	104133	15102	104133	14966	0.0	6.95797140184418
chr3	SLMAP	57925844	57925934	44	91	104133	15102	104089	15011	0.4835164835164835	6.934181600159882
chr3	PXK	58420535	58420568	0	34	513657	5376	513657	5342	0.0	96.15443654062149
chr3	PXK	58423460	58423494	130	35	513657	5376	513527	5341	3.7142857142857144	96.14809960681521
chr3	CFAP20DC-AS1	58866541	58866636	296	96	296	3986	0	3890	3.0833333333333335	0.0
chr3	CFAP20DC-AS1	58914872	58914931	0	60	296	3986	296	3926	0.0	0.07539480387162506
chr3	AC126121.3	59071504	59071706	0	203	183	3768	183	3565	0.0	0.05133239831697055
chr3	AC126121.3	59090332	59090385	0	54	183	3768	183	3714	0.0	0.049273021001615507
chr3	SYNPR	63480831	63480956	0	126	0	4059	0	3933	0.0	0.0
chr3	SYNPR	63556542	63556741	0	200	0	4059	0	3859	0.0	0.0
chr3	SYNPR	63609124	63609316	0	193	0	4059	0	3866	0.0	0.0
chr3	SYNPR	63445543	63445576	0	34	0	4059	0	4025	0.0	0.0
chr3	SYNPR	63452072	63452115	0	44	0	4059	0	4015	0.0	0.0
chr3	ADAMTS9-AS1	64568658	64569059	0	402	1880	6303	1880	5901	0.0	0.3185900694797492
chr3	ADAMTS9-AS1	64582517	64582646	197	130	1880	6303	1683	6173	1.5153846153846153	0.27263891138830393
chr3	AC109587.1	69029864	69029994	1173	131	11575	3711	10402	3580	8.954198473282442	2.905586592178771
chr3	AC109587.1	69034974	69035150	0	177	11575	3711	11575	3534	0.0	3.2753254102999434
chr3	ARL6IP5	69089811	69089960	119	150	181331	2213	181212	2063	0.7933333333333333	87.83906931652933
chr3	ARL6IP5	69099971	69100069	252	99	181331	2213	181079	2114	2.5454545454545454	85.65704824976348
chr3	SAMMSON	70084725	70084829	0	105	52998	15618	52998	15513	0.0	3.416360471862309
chr3	SAMMSON	70137595	70137667	0	73	52998	15618	52998	15545	0.0	3.4093277581215826
chr3	LINC02018	75447086	75447296	0	211	204	6501	204	6290	0.0	0.032432432432432434
chr3	LINC02018	75451209	75451402	0	194	204	6501	204	6307	0.0	0.03234501347708895
chr3	AC117461.1	79432116	79432236	0	121	0	2074	0	1953	0.0	0.0
chr3	AC117461.1	79438821	79438931	0	111	0	2074	0	1963	0.0	0.0
chr3	LINC02050	80771369	80771470	0	102	0	1266	0	1164	0.0	0.0
chr3	LINC02050	80780092	80780245	0	154	0	1266	0	1112	0.0	0.0
chr3	LINC02027	81041615	81041679	0	65	51	3715	51	3650	0.0	0.013972602739726028
chr3	LINC02027	81045363	81045462	0	100	51	3715	51	3615	0.0	0.014107883817427386
chr3	LINC02027	81094632	81094764	0	133	51	3715	51	3582	0.0	0.01423785594639866
chr3	AC129807.1	81859673	81859849	0	177	0	2464	0	2287	0.0	0.0
chr3	AC129807.1	81860424	81860534	0	111	0	2464	0	2353	0.0	0.0
chr3	ARL13B	93995877	93995944	0	68	0	4021	0	3953	0.0	0.0
chr3	ARL13B	94003658	94003908	0	251	0	4021	0	3770	0.0	0.0
chr3	ARL13B	93995873	93995944	0	72	0	4021	0	3949	0.0	0.0
chr3	ARL13B	94035330	94035436	0	107	0	4021	0	3914	0.0	0.0
chr3	LINC00879	94962931	94963006	0	76	102	6020	102	5944	0.0	0.017160161507402422
chr3	LINC00879	94971270	94971354	0	85	102	6020	102	5935	0.0	0.017186183656276326
chr3	LINC00879	94962936	94963096	0	161	102	6020	102	5859	0.0	0.017409114183307733
chr3	LINC00879	94962931	94963096	0	166	102	6020	102	5854	0.0	0.01742398360095661
chr3	LINC00879	94938640	94938675	0	36	102	6020	102	5984	0.0	0.017045454545454544
chr3	LINC00879	94962898	94963096	0	199	102	6020	102	5821	0.0	0.01752276241195671
chr3	LINC00879	94962901	94963096	0	196	102	6020	102	5824	0.0	0.017513736263736264
chr3	ARL6	97765990	97766089	0	100	0	2345	0	2245	0.0	0.0
chr3	ARL6	97766631	97766690	0	60	0	2345	0	2285	0.0	0.0
chr3	ST3GAL6	98773919	98773983	0	65	51	6312	51	6247	0.0	0.008163918680966864
chr3	ST3GAL6	98784944	98785040	0	97	51	6312	51	6215	0.0	0.008205953338696701
chr3	COL8A1	99675659	99675721	0	63	306	9418	306	9355	0.0	0.03270978086584714
chr3	COL8A1	99691398	99691568	0	171	306	9418	306	9247	0.0	0.03309181356115497
chr3	CMSS1	100051231	100051306	0	76	10916	7224	10916	7148	0.0	1.5271404588696138
chr3	CMSS1	100141529	100141645	0	117	10916	7224	10916	7107	0.0	1.5359504713662586
chr3	TFG	100739360	100739485	0	126	51	6506	51	6380	0.0	0.00799373040752351
chr3	TFG	100742155	100742200	0	46	51	6506	51	6460	0.0	0.007894736842105263
chr3	DUBR	107246007	107248831	306	2825	3354	13361	3048	10536	0.10831858407079646	0.28929384965831434
chr3	DUBR	107285319	107285531	0	213	3354	13361	3354	13148	0.0	0.2550958320657134
chr3	DUBR	107246007	107246052	0	46	3354	13361	3354	13315	0.0	0.25189635749155087
chr3	DUBR	107248577	107248831	0	255	3354	13361	3354	13106	0.0	0.25591332214253015
chr3	DUBR	107285319	107286177	0	859	3354	13361	3354	12502	0.0	0.26827707566789316
chr3	LINC01990	107433064	107433203	0	140	4648	1872	4648	1732	0.0	2.6836027713625867
chr3	LINC01990	107460672	107460790	0	119	4648	1872	4648	1753	0.0	2.6514546491728463
chr3	LINC01990	107461187	107461390	0	204	4648	1872	4648	1668	0.0	2.7865707434052758
chr3	BBX	107657061	107657172	0	112	167415	11767	167415	11655	0.0	14.364221364221365
chr3	BBX	107677426	107677470	0	45	167415	11767	167415	11722	0.0	14.282119092305068
chr3	BBX	107659567	107659770	0	204	167415	11767	167415	11563	0.0	14.47850903744703
chr3	HHLA2	108302655	108302794	0	140	2414	2940	2414	2800	0.0	0.8621428571428571
chr3	HHLA2	108310654	108310741	0	88	2414	2940	2414	2852	0.0	0.8464235624123422
chr3	HHLA2	108328269	108328347	0	79	2414	2940	2414	2861	0.0	0.8437609227542817
chr3	TRAT1	108830669	108830780	0	112	0	2462	0	2350	0.0	0.0
chr3	TRAT1	108838933	108838967	0	35	0	2462	0	2427	0.0	0.0
chr3	TMPRSS7	112046973	112047012	0	40	26066	3071	26066	3031	0.0	8.599802045529529
chr3	TMPRSS7	112047407	112047520	0	114	26066	3071	26066	2957	0.0	8.81501521812648
chr3	GTPBP8	112993025	112993124	0	100	5503	3804	5503	3704	0.0	1.4856911447084233
chr3	GTPBP8	112995134	112995265	51	132	5503	3804	5452	3672	0.38636363636363635	1.4847494553376905
chr3	QTRT2	114067986	114068063	0	78	408	8066	408	7988	0.0	0.05107661492238358
chr3	QTRT2	114070625	114070838	0	214	408	8066	408	7852	0.0	0.05196128374936322
chr3	STXBP5L	121324492	121324585	0	94	4757	11115	4757	11021	0.0	0.4316305235459577
chr3	STXBP5L	121378715	121378886	0	172	4757	11115	4757	10943	0.0	0.43470711870602213
chr3	CD86	122091600	122091650	336	51	1734	3432	1398	3381	6.588235294117647	0.4134871339840284
chr3	CD86	122103511	122103847	0	337	1734	3432	1734	3095	0.0	0.5602584814216478
chr3	UMPS	124731505	124731604	10197	100	54657	7521	44460	7421	101.97	5.991106319902978
chr3	UMPS	124735092	124735246	0	155	54657	7521	54657	7366	0.0	7.420173771382026
chr3	HMCES	129288853	129288997	51	145	2556	2754	2505	2609	0.35172413793103446	0.9601379839018781
chr3	HMCES	129290678	129290804	0	127	2556	2754	2556	2627	0.0	0.972972972972973
chr3	IFT122	129459314	129459451	0	138	906	9056	906	8918	0.0	0.10159228526575466
chr3	IFT122	129460853	129461006	0	154	906	9056	906	8902	0.0	0.10177488204897776
chr3	IFT122	129492140	129492194	0	55	906	9056	906	9001	0.0	0.10065548272414176
chr3	IFT122	129495445	129495607	0	163	906	9056	906	8893	0.0	0.10187788147981558
chr3	IFT122	129456113	129456264	0	152	906	9056	906	8904	0.0	0.10175202156334232
chr3	IFT122	129457921	129458015	0	95	906	9056	906	8961	0.0	0.10110478741211919
chr3	IFT122	129451913	129451998	0	86	906	9056	906	8970	0.0	0.10100334448160535
chr3	IFT122	129458598	129458677	0	80	906	9056	906	8976	0.0	0.10093582887700535
chr3	IFT122	129451913	129451972	0	60	906	9056	906	8996	0.0	0.10071142730102267
chr3	COL6A5	130429572	130429584	0	13	21107	9473	21107	9460	0.0	2.231183932346723
chr3	COL6A5	130431456	130431461	0	6	21107	9473	21107	9467	0.0	2.2295341713319954
chr3	TMEM108	133303203	133303337	1069	135	13847	8388	12778	8253	7.9185185185185185	1.548285471949594
chr3	TMEM108	133378341	133378556	153	216	13847	8388	13694	8172	0.7083333333333334	1.6757219774840921
chr3	PCCB	136256554	136256623	0	70	969	7380	969	7310	0.0	0.1325581395348837
chr3	PCCB	136260478	136260535	0	58	969	7380	969	7322	0.0	0.1323408904670855
chr3	PCCB	136259175	136259235	0	61	969	7380	969	7319	0.0	0.13239513594753383
chr3	PCCB	136260262	136260355	0	94	969	7380	969	7286	0.0	0.1329947845182542
chr3	NCK1	136867430	136867525	0	96	0	5120	0	5024	0.0	0.0
chr3	NCK1	136889078	136889301	0	224	0	5120	0	4896	0.0	0.0
chr3	ARMC8	138188454	138188530	0	77	1338	9550	1338	9473	0.0	0.14124353425525177
chr3	ARMC8	138209816	138209893	0	78	1338	9550	1338	9472	0.0	0.14125844594594594
chr3	ARMC8	138188400	138188530	0	131	1338	9550	1338	9419	0.0	0.14205329652829388
chr3	FAIM	138610603	138611037	0	435	1468	4080	1468	3645	0.0	0.4027434842249657
chr3	FAIM	138619710	138619770	0	61	1468	4080	1468	4019	0.0	0.365264991291366
chr3	SLC25A36	140966347	140966434	0	88	4811	9584	4811	9496	0.0	0.5066343723673126
chr3	SLC25A36	140966999	140967036	0	38	4811	9584	4811	9546	0.0	0.5039807249109575
chr3	SLC25A36	140966933	140967036	0	104	4811	9584	4811	9480	0.0	0.5074894514767933
chr3	PLS1	142597236	142597348	0	113	6476	5310	6476	5197	0.0	1.2461035212622666
chr3	PLS1	142627815	142627908	0	94	6476	5310	6476	5216	0.0	1.241564417177914
chr3	PLS1	142645295	142645580	0	286	6476	5310	6476	5024	0.0	1.289012738853503
chr3	AC021074.3	142936603	142936646	0	44	51	5484	51	5440	0.0	0.009375
chr3	AC021074.3	142938474	142938653	0	180	51	5484	51	5304	0.0	0.009615384615384616
chr3	LINC02046	148341254	148341337	0	84	51	3775	51	3691	0.0	0.013817393660254673
chr3	LINC02046	148361079	148361150	0	72	51	3775	51	3703	0.0	0.013772616797191467
chr3	LINC02046	148360131	148360177	0	47	51	3775	51	3728	0.0	0.013680257510729614
chr3	LINC02046	148312110	148312252	0	143	51	3775	51	3632	0.0	0.014041850220264317
chr3	LINC02046	148362197	148362301	0	105	51	3775	51	3670	0.0	0.013896457765667575
chr3	LINC02046	148398678	148398776	0	99	51	3775	51	3676	0.0	0.013873775843307944
chr3	RNF13	149813924	149814026	0	103	1428	3524	1428	3421	0.0	0.4174218064893306
chr3	RNF13	149822517	149822573	0	57	1428	3524	1428	3467	0.0	0.41188347274300546
chr3	EIF2A	150558387	150558462	0	76	51	5921	51	5845	0.0	0.00872540633019675
chr3	EIF2A	150562541	150562660	0	120	51	5921	51	5801	0.0	0.008791587657300466
chr3	EIF2A	150575648	150575762	0	115	51	5921	51	5806	0.0	0.00878401653461936
chr3	EIF2A	150581617	150581746	0	130	51	5921	51	5791	0.0	0.00880676912450354
chr3	MBNL1	152455541	152455577	0	37	137	8493	137	8456	0.0	0.01620151371807001
chr3	MBNL1	152456266	152456361	0	96	137	8493	137	8397	0.0	0.016315350720495416
chr3	MLF1	158582655	158582929	0	275	102	3749	102	3474	0.0	0.02936096718480138
chr3	MLF1	158588851	158588924	0	74	102	3749	102	3675	0.0	0.027755102040816326
chr3	MLF1	158573297	158573433	0	137	102	3749	102	3612	0.0	0.02823920265780731
chr3	MLF1	158588859	158588924	0	66	102	3749	102	3683	0.0	0.027694814010317675
chr3	MLF1	158572975	158573039	0	65	102	3749	102	3684	0.0	0.02768729641693811
chr3	MLF1	158592433	158592581	0	149	102	3749	102	3600	0.0	0.028333333333333332
chr3	MLF1	158593381	158593426	0	46	102	3749	102	3703	0.0	0.027545233594382934
chr3	MLF1	158596348	158596423	0	76	102	3749	102	3673	0.0	0.02777021508303839
chr3	MLF1	158593381	158593421	0	41	102	3749	102	3708	0.0	0.02750809061488673
chr3	IL12A	159993011	159993125	486	115	6459	1635	5973	1520	4.226086956521739	3.9296052631578946
chr3	IL12A	159993450	159993492	0	43	6459	1635	6459	1592	0.0	4.057160804020101
chr3	LINC01322	165258405	165258523	0	119	0	14499	0	14380	0.0	0.0
chr3	LINC01322	165345471	165345525	0	55	0	14499	0	14444	0.0	0.0
chr3	LINC01322	165389888	165390111	0	224	0	14499	0	14275	0.0	0.0
chr3	LINC01322	165446042	165446263	0	222	0	14499	0	14277	0.0	0.0
chr3	LINC01322	165491195	165491266	0	72	0	14499	0	14427	0.0	0.0
chr3	LINC01322	165511510	165511651	0	142	0	14499	0	14357	0.0	0.0
chr3	LRRC77P	167915756	167915910	0	155	0	5364	0	5209	0.0	0.0
chr3	LRRC77P	167917347	167917468	0	122	0	5364	0	5242	0.0	0.0
chr3	LRRC77P	167920564	167920791	0	228	0	5364	0	5136	0.0	0.0
chr3	LINC00578	177539394	177539493	0	100	0	6327	0	6227	0.0	0.0
chr3	LINC00578	177629416	177629555	0	140	0	6327	0	6187	0.0	0.0
chr3	ZNF639	179324949	179324993	37	45	316069	6830	316032	6785	0.8222222222222222	46.57803979366249
chr3	ZNF639	179325041	179325322	966	282	316069	6830	315103	6548	3.425531914893617	48.122021991447774
chr3	NDUFB5	179607757	179607812	0	56	0	5543	0	5487	0.0	0.0
chr3	NDUFB5	179615982	179616049	0	68	0	5543	0	5475	0.0	0.0
chr3	NDUFB5	179616982	179617044	0	63	0	5543	0	5480	0.0	0.0
chr3	NDUFB5	179618414	179618521	0	108	0	5543	0	5435	0.0	0.0
chr3	FXR1	180914651	180914995	0	345	139	11810	139	11465	0.0	0.012123855211513301
chr3	FXR1	180933333	180933386	0	54	139	11810	139	11756	0.0	0.011823749574685268
chr3	FXR1	180935137	180935231	0	95	139	11810	139	11715	0.0	0.01186513017498933
chr3	SOX2-OT	181003774	181003933	0	160	51	31226	51	31066	0.0	0.0016416661301744673
chr3	SOX2-OT	181030569	181030689	0	121	51	31226	51	31105	0.0	0.0016396077800996623
chr3	SOX2-OT	181056696	181056786	0	91	51	31226	51	31135	0.0	0.001638027942829613
chr3	SOX2-OT	181610860	181610929	0	70	51	31226	51	31156	0.0	0.0016369238669919116
chr3	SOX2-OT	181699597	181699883	0	287	51	31226	51	30939	0.0	0.0016484049258217784
chr3	SOX2-OT	181610856	181610929	0	74	51	31226	51	31152	0.0	0.0016371340523882896
chr3	SOX2-OT	181583573	181583742	0	170	51	31226	51	31056	0.0	0.0016421947449768162
chr3	SOX2-OT	181630854	181631004	0	151	51	31226	51	31075	0.0	0.0016411906677393402
chr3	SOX2-OT	181715184	181715292	0	109	51	31226	51	31117	0.0	0.0016389754796413535
chr3	SOX2-OT	181690833	181691002	0	170	51	31226	51	31056	0.0	0.0016421947449768162
chr3	SOX2-OT	181604291	181604340	0	50	51	31226	51	31176	0.0	0.0016358737490377213
chr3	SOX2-OT	181610608	181610745	0	138	51	31226	51	31088	0.0	0.0016405043746783325
chr3	SOX2-OT	181736374	181736542	0	169	51	31226	51	31057	0.0	0.0016421418681778666
chr3	SOX2-OT	181737270	181737361	0	92	51	31226	51	31134	0.0	0.0016380805550202352
chr3	SOX2-OT	181732463	181732612	0	150	51	31226	51	31076	0.0	0.0016411378555798686
chr3	SOX2-OT	181722201	181722298	0	98	51	31226	51	31128	0.0	0.0016383962991518889
chr3	SOX2-OT	181722204	181722298	0	95	51	31226	51	31131	0.0	0.00163823841187241
chr3	SOX2-OT	181774247	181774415	0	169	51	31226	51	31057	0.0	0.0016421418681778666
chr3	SOX2-OT	181778534	181778669	0	136	51	31226	51	31090	0.0	0.0016403988420714056
chr3	SOX2-OT	181778534	181778662	0	129	51	31226	51	31097	0.0	0.001640029584847413
chr3	SOX2-OT	181814212	181814516	0	305	51	31226	51	30921	0.0	0.001649364509556612
chr3	SOX2-OT	181825603	181825744	0	142	51	31226	51	31084	0.0	0.0016407154806331232
chr3	LINC01206	181984369	181984491	0	123	0	11383	0	11260	0.0	0.0
chr3	LINC01206	182000188	182000506	0	319	0	11383	0	11064	0.0	0.0
chr3	LINC01206	181973542	181973661	0	120	0	11383	0	11263	0.0	0.0
chr3	LINC01206	181984369	181984431	0	63	0	11383	0	11320	0.0	0.0
chr3	LINC01206	181984723	181984827	0	105	0	11383	0	11278	0.0	0.0
chr3	LINC01206	182000188	182000508	0	321	0	11383	0	11062	0.0	0.0
chr3	LINC01206	182000188	182000445	0	258	0	11383	0	11125	0.0	0.0
chr3	LINC01206	182000188	182000469	0	282	0	11383	0	11101	0.0	0.0
chr3	LINC01206	182000107	182000506	0	400	0	11383	0	10983	0.0	0.0
chr3	KLHL24	183636220	183636311	0	92	72711	8653	72711	8561	0.0	8.493283494918819
chr3	KLHL24	183643479	183643542	5167	64	72711	8653	67544	8589	80.734375	7.864012108510886
chr3	DVL3	184156359	184156447	0	89	0	6169	0	6080	0.0	0.0
chr3	DVL3	184162604	184162801	0	198	0	6169	0	5971	0.0	0.0
chr3	AP2M1	184177542	184177611	0	70	140	4554	140	4484	0.0	0.031222123104371096
chr3	AP2M1	184178217	184178223	0	7	140	4554	140	4547	0.0	0.030789531559269848
chr3	AP2M1	184180644	184180650	0	7	140	4554	140	4547	0.0	0.030789531559269848
chr3	AP2M1	184180841	184180844	0	4	140	4554	140	4550	0.0	0.03076923076923077
chr3	AP2M1	184180644	184180741	0	98	140	4554	140	4456	0.0	0.03141831238779174
chr3	FAM131A	184337310	184337371	0	62	28	7862	28	7800	0.0	0.0035897435897435897
chr3	FAM131A	184341723	184341817	0	95	28	7862	28	7767	0.0	0.003604995493755633
chr3	MAP3K13	185329073	185329249	0	177	79540	12248	79540	12071	0.0	6.589346367326651
chr3	MAP3K13	185428496	185428946	0	451	79540	12248	79540	11797	0.0	6.742392133593286
chr3	SENP2	185598411	185598545	0	135	8371	6876	8371	6741	0.0	1.2418038866636998
chr3	SENP2	185598957	185599024	0	68	8371	6876	8371	6808	0.0	1.2295828437132785
chr3	LINC02020	186441844	186442081	0	238	51	3478	51	3240	0.0	0.01574074074074074
chr3	LINC02020	186444905	186445953	0	1049	51	3478	51	2429	0.0	0.02099629477151091
chr3	LINC02020	186444905	186445833	0	929	51	3478	51	2549	0.0	0.02000784621420165
chr3	LINC02020	186440981	186441179	0	199	51	3478	51	3279	0.0	0.01555352241537054
chr3	LINC02020	186440981	186441121	0	141	51	3478	51	3337	0.0	0.015283188492658075
chr3	LINC02020	186441017	186441121	0	105	51	3478	51	3373	0.0	0.015120071153276016
chr3	FETUB	186641029	186641140	0	112	204	2000	204	1888	0.0	0.10805084745762712
chr3	FETUB	186642470	186642558	0	89	204	2000	204	1911	0.0	0.10675039246467818
chr3	LPP	188225404	188225527	0	124	295	25561	295	25437	0.0	0.011597279553406455
chr3	LPP	188341662	188341719	0	58	295	25561	295	25503	0.0	0.011567266596086735
chr3	LPP	188312834	188312918	0	85	295	25561	295	25476	0.0	0.011579525828230491
chr3	IL1RAP	190554632	190554693	0	62	0	11579	0	11517	0.0	0.0
chr3	IL1RAP	190556129	190556216	0	88	0	11579	0	11491	0.0	0.0
chr3	AC073365.1	191530815	191530850	0	36	0	8311	0	8275	0.0	0.0
chr3	AC073365.1	191546050	191546115	0	66	0	8311	0	8245	0.0	0.0
chr3	AC073365.1	191473550	191473688	0	139	0	8311	0	8172	0.0	0.0
chr3	AC073365.1	191557261	191557384	0	124	0	8311	0	8187	0.0	0.0
chr3	AC073365.1	191568205	191568341	0	137	0	8311	0	8174	0.0	0.0
chr3	AC073365.1	191559677	191559754	0	78	0	8311	0	8233	0.0	0.0
chr3	AC073365.1	191557261	191557288	0	28	0	8311	0	8283	0.0	0.0
chr3	AC073365.1	191546050	191546111	0	62	0	8311	0	8249	0.0	0.0
chr3	AC073365.1	191559677	191559969	0	293	0	8311	0	8018	0.0	0.0
chr3	AC073365.1	191559677	191559750	0	74	0	8311	0	8237	0.0	0.0
chr3	OPA1	193617177	193617285	0	109	102	9079	102	8970	0.0	0.01137123745819398
chr3	OPA1	193617783	193617837	0	55	102	9079	102	9024	0.0	0.011303191489361703
chr3	OPA1	193668314	193668484	0	171	102	9079	102	8908	0.0	0.011450381679389313
chr3	OPA1	193689068	193689170	0	103	102	9079	102	8976	0.0	0.011363636363636364
chr3	OPA1	193596799	193596946	0	148	102	9079	102	8931	0.0	0.011420893516963387
chr3	OPA1	193603499	193603557	0	59	102	9079	102	9020	0.0	0.01130820399113082
chr3	OPA1	193626091	193626202	0	112	102	9079	102	8967	0.0	0.011375041820006692
chr3	OPA1	193628508	193628616	0	109	102	9079	102	8970	0.0	0.01137123745819398
chr3	LINC00884	194490509	194490594	0	86	4050	9432	4050	9346	0.0	0.4333404665097368
chr3	LINC00884	194497937	194498135	612	199	4050	9432	3438	9233	3.0753768844221105	0.3723600129968591
chr3	LINC01968	194714978	194715182	0	205	1495	9041	1495	8836	0.0	0.16919420552286102
chr3	LINC01968	194726726	194726848	0	123	1495	9041	1495	8918	0.0	0.16763848396501457
chr3	LINC01968	194715403	194715652	0	250	1495	9041	1495	8791	0.0	0.17006028893186212
chr3	LINC01968	194718855	194718978	0	124	1495	9041	1495	8917	0.0	0.16765728383985645
chr3	LINC01968	194747417	194747539	0	123	1495	9041	1495	8918	0.0	0.16763848396501457
chr3	LINC01968	194747947	194748040	0	94	1495	9041	1495	8947	0.0	0.16709511568123395
chr3	LINC01968	194709273	194709397	0	125	1495	9041	1495	8916	0.0	0.167676087931808
chr3	LINC01968	194715506	194715652	0	147	1495	9041	1495	8894	0.0	0.16809084776253655
chr3	MUC20-OT1	195685817	195685939	8588	123	133092	13794	124504	13671	69.82113821138212	9.107161144027504
chr3	MUC20-OT1	195686603	195686718	7025	116	133092	13794	126067	13678	60.560344827586206	9.21677145781547
chr3	MUC20-OT1	195689338	195689438	1806	101	133092	13794	131286	13693	17.88118811881188	9.587818593441904
chr3	MUC20-OT1	195707005	195707126	714	122	133092	13794	132378	13672	5.852459016393443	9.682416617905208
chr3	MUC20-OT1	195699029	195699207	50	179	133092	13794	133042	13615	0.27932960893854747	9.77172236503856
chr3	MUC20-OT1	195696360	195696589	9149	230	133092	13794	123943	13564	39.778260869565216	9.1376437629018
chr3	MUC20-OT1	195701379	195701495	9185	117	133092	13794	123907	13677	78.5042735042735	9.05951597572567
chr3	MUC20-OT1	195708133	195708268	2754	136	133092	13794	130338	13658	20.25	9.542978474154342
chr3	MUC20-OT1	195689545	195689608	793	64	133092	13794	132299	13730	12.390625	9.635761107064821
chr3	MUC20-OT1	195708133	195708435	5219	303	133092	13794	127873	13491	17.224422442244226	9.47839300274257
chr3	MUC20-OT1	195701379	195701669	9816	291	133092	13794	123276	13503	33.7319587628866	9.129526771828482
chr3	MUC20-OT1	195701379	195701432	8253	54	133092	13794	124839	13740	152.83333333333334	9.085807860262008
chr3	MUC20-OT1	195708133	195708387	4051	255	133092	13794	129041	13539	15.886274509803922	9.53105842381269
chr3	MUC20-OT1	195702182	195702442	1911	261	133092	13794	131181	13533	7.32183908045977	9.693416093992463
chr3	MUC20-OT1	195707028	195707126	664	99	133092	13794	132428	13695	6.707070707070707	9.669806498722162
chr3	MUC20-OT1	195718023	195718196	0	174	133092	13794	133092	13620	0.0	9.77180616740088
chr3	MUC20-OT1	195722500	195722818	204	319	133092	13794	132888	13475	0.6394984326018809	9.861818181818181
chr3	MUC20-OT1	195718026	195718196	0	171	133092	13794	133092	13623	0.0	9.769654261175953
chr3	MUC20-OT1	195718043	195718196	0	154	133092	13794	133092	13640	0.0	9.757478005865103
chr3	MUC20-OT1	195717913	195718196	0	284	133092	13794	133092	13510	0.0	9.851369356032569
chr3	MUC20-OT1	195729647	195729739	0	93	133092	13794	133092	13701	0.0	9.714035471863367
chr3	MUC20-OT1	195729342	195729551	51	210	133092	13794	133041	13584	0.24285714285714285	9.793948763250883
chr3	AC034195.1	3382477	3382650	0	174	0	1348	0	1174	0.0	0.0
chr3	AC034195.1	3440907	3441005	0	99	0	1348	0	1249	0.0	0.0
chr3	BHLHE40-AS1	4949558	4949698	0	141	408	4557	408	4416	0.0	0.09239130434782608
chr3	BHLHE40-AS1	4959197	4959385	0	189	408	4557	408	4368	0.0	0.09340659340659341
chr3	RAD18	8948508	8948570	153	63	4337	6999	4184	6936	2.4285714285714284	0.6032295271049596
chr3	RAD18	8958919	8959001	0	83	4337	6999	4337	6916	0.0	0.6270965876229034
chr3	SRGAP3	9028099	9028130	0	32	77639	18958	77639	18926	0.0	4.102240304343232
chr3	SRGAP3	9032649	9032752	0	104	77639	18958	77639	18854	0.0	4.117906014638804
chr3	THUMPD3-AS1	9390884	9391826	5767	943	7555	6225	1788	5282	6.1155885471898195	0.33850814085573644
chr3	THUMPD3-AS1	9395505	9395579	0	75	7555	6225	7555	6150	0.0	1.2284552845528456
chr3	THUMPD3-AS1	9391426	9391826	4230	401	7555	6225	3325	5824	10.54862842892768	0.5709134615384616
chr3	THUMPD3-AS1	9391678	9391826	1160	149	7555	6225	6395	6076	7.785234899328859	1.0525016458196181
chr3	THUMPD3-AS1	9391704	9391826	957	123	7555	6225	6598	6102	7.780487804878049	1.0812848246476565
chr3	THUMPD3-AS1	9391106	9391826	5767	721	7555	6225	1788	5504	7.9986130374479885	0.3248546511627907
chr3	THUMPD3-AS1	9391081	9391826	5767	746	7555	6225	1788	5479	7.730563002680965	0.3263369227961307
chr3	RPUSD3	9842198	9842243	0	46	953267	5249	953267	5203	0.0	183.21487603305786
chr3	RPUSD3	9843464	9843601	5105	138	953267	5249	948162	5111	36.992753623188406	185.5139894345529
chr3	LINC00606	10762831	10762922	0	92	0	3183	0	3091	0.0	0.0
chr3	LINC00606	10763199	10763497	0	299	0	3183	0	2884	0.0	0.0
chr3	LINC00606	10762763	10762922	0	160	0	3183	0	3023	0.0	0.0
chr3	HACL1	15589539	15589612	0	74	1686	2788	1686	2714	0.0	0.6212232866617539
chr3	HACL1	15591599	15591680	24	82	1686	2788	1662	2706	0.2926829268292683	0.614190687361419
chr3	HACL1	15586524	15586602	0	79	1686	2788	1686	2709	0.0	0.6223698781838317
chr3	TBC1D5	17518901	17518995	0	95	221	11311	221	11216	0.0	0.019703994293865906
chr3	TBC1D5	17562018	17562142	0	125	221	11311	221	11186	0.0	0.019756838905775075
chr3	TBC1D5	17646960	17647056	0	97	221	11311	221	11214	0.0	0.019707508471553416
chr3	TBC1D5	17662989	17663110	0	122	221	11311	221	11189	0.0	0.019751541692733934
chr3	TBC1D5	17623848	17623913	0	66	221	11311	221	11245	0.0	0.019653179190751446
chr3	TBC1D5	17622647	17622765	0	119	221	11311	221	11192	0.0	0.019746247319513938
chr3	TBC1D5	17547015	17547076	0	62	221	11311	221	11249	0.0	0.019646190772513113
chr3	TBC1D5	17576413	17576549	0	137	221	11311	221	11174	0.0	0.01977805620189726
chr3	ZNF385D	21441685	21441742	0	58	1054	13099	1054	13041	0.0	0.08082202285100835
chr3	ZNF385D	21459331	21459449	0	119	1054	13099	1054	12980	0.0	0.08120184899845917
chr3	ZNF385D	21664885	21665028	918	144	1054	13099	136	12955	6.375	0.0104978772674643
chr3	ZNF385D	21849655	21849719	0	65	1054	13099	1054	13034	0.0	0.08086542887831824
chr3	THRB	24237990	24238081	0	92	300	10954	300	10862	0.0	0.02761922297919352
chr3	THRB	24297225	24297371	0	147	300	10954	300	10807	0.0	0.027759785324326824
chr3	THRB	24228937	24229001	0	65	300	10954	300	10889	0.0	0.02755073927817063
chr3	THRB	24318357	24318494	0	138	300	10954	300	10816	0.0	0.027736686390532544
chr3	NGLY1	25736308	25736400	0	93	5733	6316	5733	6223	0.0	0.9212598425196851
chr3	NGLY1	25737333	25737455	0	123	5733	6316	5733	6193	0.0	0.9257225900209914
chr3	NGLY1	25736003	25736149	0	147	5733	6316	5733	6169	0.0	0.9293240395526017
chr3	NEK10	27363686	27363844	0	159	28237	7836	28237	7677	0.0	3.6781294776605447
chr3	NEK10	27367522	27367562	0	41	28237	7836	28237	7795	0.0	3.622450288646568
chr3	CLASP2	33563963	33563966	0	4	29679	15265	29679	15261	0.0	1.9447611558875566
chr3	CLASP2	33566731	33566734	0	4	29679	15265	29679	15261	0.0	1.9447611558875566
chr3	LRRFIP2	37066223	37066325	0	103	395946	10009	395946	9906	0.0	39.97032101756511
chr3	LRRFIP2	37072789	37072882	164	94	395946	10009	395782	9915	1.7446808510638299	39.917498739283914
chr3	ITGA9-AS1	37821013	37821100	0	88	8307	14074	8307	13986	0.0	0.5939510939510939
chr3	ITGA9-AS1	37834678	37834767	0	90	8307	14074	8307	13984	0.0	0.5940360411899314
chr3	ACAA1	38129289	38129388	0	100	661	6653	661	6553	0.0	0.10086983061193347
chr3	ACAA1	38131595	38131638	0	44	661	6653	661	6609	0.0	0.10001513088213043
chr3	ACAA1	38131925	38132005	0	81	661	6653	661	6572	0.0	0.10057821059038345
chr3	ACAA1	38133951	38134009	0	59	661	6653	661	6594	0.0	0.10024264482863209
chr3	SCN5A	38613742	38613834	0	93	51437	10059	51437	9966	0.0	5.161248244029701
chr3	SCN5A	38613974	38614066	0	93	51437	10059	51437	9966	0.0	5.161248244029701
chr3	VIPR1-AS1	42529339	42529461	0	123	51	4487	51	4364	0.0	0.011686526122823098
chr3	VIPR1-AS1	42530859	42530958	0	100	51	4487	51	4387	0.0	0.011625256439480283
chr3	VIPR1-AS1	42511714	42511909	0	196	51	4487	51	4291	0.0	0.011885341412258214
chr3	VIPR1-AS1	42512057	42512292	0	236	51	4487	51	4251	0.0	0.011997177134791814
chr3	VIPR1-AS1	42516781	42516836	0	56	51	4487	51	4431	0.0	0.011509817197020988
chr3	VIPR1-AS1	42521313	42521372	0	60	51	4487	51	4427	0.0	0.011520216851140727
chr3	VIPR1-AS1	42512057	42512311	0	255	51	4487	51	4232	0.0	0.012051039697542534
chr3	VIPR1-AS1	42519250	42519339	0	90	51	4487	51	4397	0.0	0.011598817375483284
chr3	VIPR1-AS1	42519388	42519452	0	65	51	4487	51	4422	0.0	0.011533242876526458
chr3	VIPR1-AS1	42519388	42519509	0	122	51	4487	51	4365	0.0	0.01168384879725086
chr3	VIPR1-AS1	42530859	42531052	0	194	51	4487	51	4293	0.0	0.011879804332634521
chr3	SEC22C	42563764	42563880	0	117	3137	8177	3137	8060	0.0	0.3892059553349876
chr3	SEC22C	42566743	42566836	0	94	3137	8177	3137	8083	0.0	0.38809847828776445
chr3	SEC22C	42563764	42563980	0	217	3137	8177	3137	7960	0.0	0.3940954773869347
chr3	SEC22C	42565775	42565883	0	109	3137	8177	3137	8068	0.0	0.38882002974714924
chr3	ANO10	43372727	43372847	0	121	15588	5236	15588	5115	0.0	3.047507331378299
chr3	ANO10	43432610	43432727	51	118	15588	5236	15537	5118	0.4322033898305085	3.0357561547479484
chr3	LZTFL1	45837926	45838051	0	126	0	7195	0	7069	0.0	0.0
chr3	LZTFL1	45854985	45855074	0	90	0	7195	0	7105	0.0	0.0
chr3	KIF9	47271236	47271461	460	226	11408	5311	10948	5085	2.0353982300884956	2.152999016715831
chr3	KIF9	47273551	47273658	234	108	11408	5311	11174	5203	2.1666666666666665	2.1476071497213147
chr3	SHISA5	48502320	48502452	2856	133	40429	4383	37573	4250	21.473684210526315	8.84070588235294
chr3	SHISA5	48503094	48503193	113	100	40429	4383	40316	4283	1.13	9.413028251225777
chr3	IP6K2	48708119	48708237	0	119	116050	5121	116050	5002	0.0	23.200719712115156
chr3	IP6K2	48711366	48711459	17550	94	116050	5121	98500	5027	186.70212765957447	19.59419136662025
chr3	IP6K2	48715314	48715527	4106	214	116050	5121	111944	4907	19.186915887850468	22.81312410841655
chr3	IP6K2	48694458	48694525	683	68	116050	5121	115367	5053	10.044117647058824	22.83138729467643
chr3	IP6K2	48694693	48694824	5117	132	116050	5121	110933	4989	38.765151515151516	22.235518139907796
chr3	IP6K2	48715388	48715527	1147	140	116050	5121	114903	4981	8.192857142857143	23.068259385665527
chr3	IP6K2	48694701	48694824	4953	124	116050	5121	111097	4997	39.943548387096776	22.23273964378627
chr3	PRKAR2A	48752175	48752317	3	143	5391	2432	5388	2289	0.02097902097902098	2.3538663171690692
chr3	PRKAR2A	48756378	48756444	0	67	5391	2432	5391	2365	0.0	2.279492600422833
chr3	QARS1	49097991	49098117	0	127	1937	3938	1937	3811	0.0	0.5082655471004985
chr3	QARS1	49098191	49098258	0	68	1937	3938	1937	3870	0.0	0.500516795865633
chr3	QARS1	49101354	49101441	0	88	1937	3938	1937	3850	0.0	0.5031168831168831
chr3	QARS1	49101619	49101705	0	87	1937	3938	1937	3851	0.0	0.5029862373409504
chr3	AMT	49421981	49422049	0	69	2780	4678	2780	4609	0.0	0.603167715339553
chr3	AMT	49422103	49422271	0	169	2780	4678	2780	4509	0.0	0.6165446884009759
chr3	AMT	49421959	49422049	0	91	2780	4678	2780	4587	0.0	0.6060606060606061
chr3	AMT	49420210	49420342	255	133	2780	4678	2525	4545	1.9172932330827068	0.5555555555555556
chr3	AMT	49421491	49421572	1	82	2780	4678	2779	4596	0.012195121951219513	0.6046562228024369
chr3	AMT	49422103	49422257	0	155	2780	4678	2780	4523	0.0	0.6146363033384922
chr3	GMPPB	49722230	49722358	1133	129	964203	6681	963070	6552	8.782945736434108	146.98870573870573
chr3	GMPPB	49722595	49722754	776	160	964203	6681	963427	6521	4.85	147.74221745131115
chr3	MST1R	49895166	49895396	102	231	1469	5135	1367	4904	0.44155844155844154	0.27875203915171287
chr3	MST1R	49895446	49895548	0	103	1469	5135	1469	5032	0.0	0.29193163751987283
chr3	C3ORF18	50565465	50565861	0	397	65	3252	65	2855	0.0	0.02276707530647986
chr3	C3ORF18	50566005	50566094	0	90	65	3252	65	3162	0.0	0.020556609740670462
chr3	C3ORF18	50565525	50565700	0	176	65	3252	65	3076	0.0	0.021131339401820545
chr3	PCBP4	51961748	51961894	0	147	5471	3664	5471	3517	0.0	1.5555871481376173
chr3	PCBP4	51961940	51962088	0	149	5471	3664	5471	3515	0.0	1.5564722617354196
chr3	PCBP4	51962809	51962892	0	84	5471	3664	5471	3580	0.0	1.5282122905027933
chr3	PCBP4	51961748	51962088	0	341	5471	3664	5471	3323	0.0	1.6464038519410171
chr3	PBRM1	52554723	52554879	0	157	271308	9463	271308	9306	0.0	29.154094132817537
chr3	PBRM1	52558248	52558413	700	166	271308	9463	270608	9297	4.216867469879518	29.10702377110896
chr3	GLT8D1	52701208	52701343	0	136	8821	3420	8821	3284	0.0	2.68605359317905
chr3	GLT8D1	52704723	52704952	255	230	8821	3420	8566	3190	1.108695652173913	2.685266457680251
chr3	GLT8D1	52703086	52703255	77	170	8821	3420	8744	3250	0.45294117647058824	2.6904615384615385
chr3	SFMBT1	53019029	53019122	0	94	4675	5707	4675	5613	0.0	0.8328879387137004
chr3	SFMBT1	53043135	53043254	0	120	4675	5707	4675	5587	0.0	0.836763916234115
chr3	AC096887.1	53077978	53078211	2349	234	3352	1771	1003	1537	10.038461538461538	0.6525699414443722
chr3	AC096887.1	53092368	53092618	204	251	3352	1771	3148	1520	0.8127490039840638	2.0710526315789473
chr3	AC096887.1	53085749	53085852	0	104	3352	1771	3352	1667	0.0	2.0107978404319136
chr3	ARF4	57583897	57584007	0	111	5239	2603	5239	2492	0.0	2.102327447833066
chr3	ARF4	57584383	57584464	306	82	5239	2603	4933	2521	3.731707317073171	1.9567631892106307
chr3	ACOX2	58534359	58534522	0	164	693	3288	693	3124	0.0	0.22183098591549297
chr3	ACOX2	58534575	58534608	0	34	693	3288	693	3254	0.0	0.21296865396435158
chr3	PTPRG-AS1	62317105	62317192	0	88	40815	7308	40815	7220	0.0	5.653047091412742
chr3	PTPRG-AS1	62317807	62317900	0	94	40815	7308	40815	7214	0.0	5.657748821735514
chr3	CADPS	62512750	62512768	0	19	0	14019	0	14000	0.0	0.0
chr3	CADPS	62513637	62513706	0	70	0	14019	0	13949	0.0	0.0
chr3	CADPS	62493644	62493665	0	22	0	14019	0	13997	0.0	0.0
chr3	CADPS	62498145	62498154	0	10	0	14019	0	14009	0.0	0.0
chr3	FOXP1	70972010	70972180	0	171	30918	26565	30918	26394	0.0	1.1714025914980677
chr3	FOXP1	70972554	70972676	0	123	30918	26565	30918	26442	0.0	1.1692761515770365
chr3	FOXP1	71359149	71359244	0	96	30918	26565	30918	26469	0.0	1.1680834183384337
chr3	FOXP1	71493425	71493555	0	131	30918	26565	30918	26434	0.0	1.169630021941439
chr3	FOXP1	71581548	71581697	0	150	30918	26565	30918	26415	0.0	1.1704713231118682
chr3	ZNF717	75783305	75783364	0	60	20578	7528	20578	7468	0.0	2.7554900910551687
chr3	ZNF717	75784914	75785002	0	89	20578	7528	20578	7439	0.0	2.766232020432854
chr3	MTHFD2P1	95681001	95681125	0	125	0	2170	0	2045	0.0	0.0
chr3	MTHFD2P1	95681457	95681481	0	25	0	2170	0	2145	0.0	0.0
chr3	ST3GAL6-AS1	98715649	98715777	0	129	408	9394	408	9265	0.0	0.044036697247706424
chr3	ST3GAL6-AS1	98718418	98718521	0	104	408	9394	408	9290	0.0	0.04391819160387513
chr3	ABI3BP	100829580	100829664	0	85	3080	9536	3080	9451	0.0	0.32589144005925297
chr3	ABI3BP	100830577	100830634	0	58	3080	9536	3080	9478	0.0	0.3249630723781389
chr3	ABI3BP	100862837	100862909	0	73	3080	9536	3080	9463	0.0	0.3254781781676001
chr3	ABI3BP	100864001	100864076	0	76	3080	9536	3080	9460	0.0	0.32558139534883723
chr3	SENP7	101398860	101399055	0	196	2477	6421	2477	6225	0.0	0.39791164658634537
chr3	SENP7	101417592	101417790	1090	199	2477	6421	1387	6222	5.477386934673367	0.22291867566698811
chr3	LINC00882	107007065	107007164	0	100	4552	18708	4552	18608	0.0	0.24462596732588135
chr3	LINC00882	107040074	107040116	0	43	4552	18708	4552	18665	0.0	0.24387891776051432
chr3	LINC00882	107049796	107049902	0	107	4552	18708	4552	18601	0.0	0.24471802591258535
chr3	LINC00882	107057669	107057932	48	264	4552	18708	4504	18444	0.18181818181818182	0.24419865538928648
chr3	LINC00882	107112059	107112146	0	88	4552	18708	4552	18620	0.0	0.24446831364124597
chr3	LINC00882	107129887	107129992	0	106	4552	18708	4552	18602	0.0	0.24470487044403827
chr3	LINC00882	107110591	107110653	0	63	4552	18708	4552	18645	0.0	0.24414052024671493
chr3	LINC00882	107114752	107114843	0	92	4552	18708	4552	18616	0.0	0.2445208422862054
chr3	LINC00882	107135625	107135712	0	88	4552	18708	4552	18620	0.0	0.24446831364124597
chr3	LINC00882	107139443	107139637	0	195	4552	18708	4552	18513	0.0	0.24588127261924053
chr3	LINC00882	107129192	107129317	0	126	4552	18708	4552	18582	0.0	0.2449682488429663
chr3	LINC00882	107171266	107171331	0	66	4552	18708	4552	18642	0.0	0.24417980903336553
chr3	LINC00882	107202913	107202981	0	69	4552	18708	4552	18639	0.0	0.24421911046729974
chr3	LINC00635	107867310	107867425	0	116	738	7071	738	6955	0.0	0.10611071171818835
chr3	LINC00635	107872967	107873026	0	60	738	7071	738	7011	0.0	0.10526315789473684
chr3	LINC00635	107854653	107854694	0	42	738	7071	738	7029	0.0	0.10499359795134443
chr3	LINC00635	107855129	107855229	0	101	738	7071	738	6970	0.0	0.10588235294117647
chr3	LINC00635	107867310	107867577	0	268	738	7071	738	6803	0.0	0.10848155225635749
chr3	LINC00635	107853872	107854054	0	183	738	7071	738	6888	0.0	0.10714285714285714
chr3	LINC00635	107859130	107859261	0	132	738	7071	738	6939	0.0	0.10635538261997406
chr3	LINC00635	107866231	107866505	0	275	738	7071	738	6796	0.0	0.10859329017068864
chr3	LINC00635	107876434	107876531	0	98	738	7071	738	6973	0.0	0.1058367990821741
chr3	LINC00635	107877312	107877497	0	186	738	7071	738	6885	0.0	0.10718954248366012
chr3	LINC00635	107876454	107876531	0	78	738	7071	738	6993	0.0	0.10553410553410554
chr3	LINC00635	107849822	107849971	0	150	738	7071	738	6921	0.0	0.10663198959687907
chr3	LINC00635	107850296	107850351	126	56	738	7071	612	7015	2.25	0.08724162508909479
chr3	LINC00635	107855312	107855384	0	73	738	7071	738	6998	0.0	0.1054587024864247
chr3	LINC00635	107856007	107856324	0	318	738	7071	738	6753	0.0	0.10928476232785429
chr3	LINC00635	107855312	107855425	0	114	738	7071	738	6957	0.0	0.10608020698576973
chr3	LINC00635	107866651	107866753	0	103	738	7071	738	6968	0.0	0.10591274397244546
chr3	CCDC191	114036985	114037094	0	110	0	5304	0	5194	0.0	0.0
chr3	CCDC191	114039384	114039488	0	105	0	5304	0	5199	0.0	0.0
chr3	LINC02024	117680938	117680972	0	35	0	1048	0	1013	0.0	0.0
chr3	LINC02024	117688346	117688901	0	556	0	1048	0	492	0.0	0.0
chr3	LINC02024	117688718	117688901	0	184	0	1048	0	864	0.0	0.0
chr3	B4GALT4	119229846	119230244	1837	399	200397	6991	198560	6592	4.6040100250626566	30.12135922330097
chr3	B4GALT4	119235144	119235227	133	84	200397	6991	200264	6907	1.5833333333333333	28.994353554365137
chr3	GSK3B	119843254	119843353	0	100	6764	16821	6764	16721	0.0	0.4045212606901501
chr3	GSK3B	119863418	119863605	0	188	6764	16821	6764	16633	0.0	0.40666145614140564
chr3	GSK3B	119831101	119831251	0	151	6764	16821	6764	16670	0.0	0.4057588482303539
chr3	GSK3B	119840796	119840862	0	67	6764	16821	6764	16754	0.0	0.4037244837053838
chr3	GSK3B	119840796	119840935	0	140	6764	16821	6764	16681	0.0	0.40549127750134883
chr3	GSK3B	119866589	119866628	0	40	6764	16821	6764	16781	0.0	0.40307490614385316
chr3	GSK3B	119875079	119875185	0	107	6764	16821	6764	16714	0.0	0.4046906784731363
chr3	GSK3B	119880244	119880498	714	255	6764	16821	6050	16566	2.8	0.3652058432934927
chr3	GSK3B	119900557	119900613	0	57	6764	16821	6764	16764	0.0	0.40348365545215936
chr3	GSK3B	119880244	119880510	714	267	6764	16821	6050	16554	2.6741573033707864	0.3654705811284282
chr3	GSK3B	119882636	119882834	780	199	6764	16821	5984	16622	3.919597989949749	0.36000481289856817
chr3	GSK3B	119876412	119876508	0	97	6764	16821	6764	16724	0.0	0.4044486964840947
chr3	GSK3B	119905754	119905852	0	99	6764	16821	6764	16722	0.0	0.40449706972850136
chr3	GSK3B	119976484	119976545	0	62	6764	16821	6764	16759	0.0	0.4036040336535593
chr3	GSK3B	119981956	119982125	0	170	6764	16821	6764	16651	0.0	0.4062218485376254
chr3	GSK3B	120000551	120000723	0	173	6764	16821	6764	16648	0.0	0.4062950504565113
chr3	HGD	120644318	120644443	0	126	49	2676	49	2550	0.0	0.019215686274509803
chr3	HGD	120644597	120644619	0	23	49	2676	49	2653	0.0	0.018469656992084433
chr3	RABL3	120694152	120694224	0	73	0	6437	0	6364	0.0	0.0
chr3	RABL3	120698422	120698573	0	152	0	6437	0	6285	0.0	0.0
chr3	HCLS1	121637145	121637256	0	112	2474	5108	2474	4996	0.0	0.4951961569255404
chr3	HCLS1	121642926	121642981	0	56	2474	5108	2474	5052	0.0	0.4897070467141726
chr3	PARP9	122558328	122558401	0	74	34256	8949	34256	8875	0.0	3.859830985915493
chr3	PARP9	122558433	122558467	0	35	34256	8949	34256	8914	0.0	3.8429436840924387
chr3	ITGB5	124809021	124809156	0	136	692	6538	692	6402	0.0	0.10809122149328335
chr3	ITGB5	124817620	124817710	0	91	692	6538	692	6447	0.0	0.10733674577322785
chr3	LINC02614	125848229	125848447	0	219	51	6139	51	5920	0.0	0.008614864864864865
chr3	LINC02614	125873740	125873845	0	106	51	6139	51	6033	0.0	0.008453505718547987
chr3	SLC41A3	126033606	126033678	0	73	414	5485	414	5412	0.0	0.07649667405764966
chr3	SLC41A3	126050897	126051050	0	154	414	5485	414	5331	0.0	0.07765897580191333
chr3	SLC41A3	126056357	126056513	0	157	414	5485	414	5328	0.0	0.0777027027027027
chr3	SLC41A3	126067485	126067586	0	102	414	5485	414	5383	0.0	0.07690878692179082
chr3	TPRA1	127575402	127575505	0	104	104	5638	104	5534	0.0	0.0187929165160824
chr3	TPRA1	127575748	127575809	0	62	104	5638	104	5576	0.0	0.018651362984218076
chr3	MGLL	127694974	127695190	0	217	217912	11869	217912	11652	0.0	18.70168211465843
chr3	MGLL	127710575	127710665	0	91	217912	11869	217912	11778	0.0	18.501613177109867
chr3	PIK3CB	138704442	138704493	0	52	5568	7866	5568	7814	0.0	0.7125671871000768
chr3	PIK3CB	138707158	138707289	0	132	5568	7866	5568	7734	0.0	0.7199379363847944
chr3	NMNAT3	139578871	139579055	0	185	0	12995	0	12810	0.0	0.0
chr3	NMNAT3	139627615	139627764	0	150	0	12995	0	12845	0.0	0.0
chr3	AC010181.1	140453218	140453280	0	63	0	1066	0	1003	0.0	0.0
chr3	AC010181.1	140454275	140454418	0	144	0	1066	0	922	0.0	0.0
chr3	TFDP2	141995019	141995141	0	123	3308	11917	3308	11794	0.0	0.2804816008139732
chr3	TFDP2	142005440	142005544	0	105	3308	11917	3308	11812	0.0	0.2800541821876058
chr3	TFDP2	142054114	142054149	31	36	3308	11917	3277	11881	0.8611111111111112	0.2758185337934517
chr3	TFDP2	142101734	142101841	0	108	3308	11917	3308	11809	0.0	0.2801253281395546
chr3	TFDP2	142093060	142093127	0	68	3308	11917	3308	11849	0.0	0.2791796776099249
chr3	SLC9A9	143796825	143796903	0	79	0	4059	0	3980	0.0	0.0
chr3	SLC9A9	143832018	143832221	0	204	0	4059	0	3855	0.0	0.0
chr3	PLSCR4	146223732	146223777	0	46	561	4242	561	4196	0.0	0.13369876072449952
chr3	PLSCR4	146250556	146250637	0	82	561	4242	561	4160	0.0	0.13485576923076922
chr3	PLSCR1	146537995	146538044	0	50	0	3554	0	3504	0.0	0.0
chr3	PLSCR1	146541133	146541180	0	48	0	3554	0	3506	0.0	0.0
chr3	AC011317.1	150736763	150737022	0	260	0	1472	0	1212	0.0	0.0
chr3	AC011317.1	150737299	150737513	0	215	0	1472	0	1257	0.0	0.0
chr3	CLRN1	150943819	150943991	0	173	51	3358	51	3185	0.0	0.016012558869701727
chr3	CLRN1	150945528	150945679	0	152	51	3358	51	3206	0.0	0.015907673112913287
chr3	ARHGEF26-AS1	154060013	154060062	0	50	12460	7258	12460	7208	0.0	1.7286348501664817
chr3	ARHGEF26-AS1	154108668	154108785	0	118	12460	7258	12460	7140	0.0	1.7450980392156863
chr3	ARHGEF26-AS1	154119685	154119808	0	124	12460	7258	12460	7134	0.0	1.7465657415194842
chr3	ARHGEF26-AS1	154119685	154119783	0	99	12460	7258	12460	7159	0.0	1.7404665456069284
chr3	SLC33A1	155833856	155834041	0	186	0	4422	0	4236	0.0	0.0
chr3	SLC33A1	155842431	155842619	0	189	0	4422	0	4233	0.0	0.0
chr3	VEPH1	157499394	157499675	0	282	2564	6465	2564	6183	0.0	0.4146854277858645
chr3	VEPH1	157505277	157505409	0	133	2564	6465	2564	6332	0.0	0.4049273531269741
chr3	IL12A-AS1	159997843	159998105	0	263	5991	11401	5991	11138	0.0	0.5378883102891003
chr3	IL12A-AS1	160009111	160009257	30	147	5991	11401	5961	11254	0.20408163265306123	0.5296783365914342
chr3	B3GALNT1	161089943	161090062	0	120	102	6044	102	5924	0.0	0.017218095881161376
chr3	B3GALNT1	161101138	161101233	0	96	102	6044	102	5948	0.0	0.01714862138533961
chr3	B3GALNT1	161089943	161090066	0	124	102	6044	102	5920	0.0	0.01722972972972973
chr3	LINC01192	163202081	163202249	0	169	97	7521	97	7352	0.0	0.013193688792165398
chr3	LINC01192	163203417	163203515	46	99	97	7521	51	7422	0.46464646464646464	0.0068714632174616
chr3	LINC01192	163249264	163249374	0	111	97	7521	97	7410	0.0	0.013090418353576248
chr3	LINC01192	163275195	163275319	0	125	97	7521	97	7396	0.0	0.013115197404002164
chr3	LINC01192	163220100	163220187	0	88	97	7521	97	7433	0.0	0.013049912552132382
chr3	LINC01192	163249264	163249381	0	118	97	7521	97	7403	0.0	0.013102796163717411
chr3	LINC01192	163207642	163207757	0	116	97	7521	97	7405	0.0	0.013099257258609049
chr3	ZBBX	167248607	167248649	0	43	384	4593	384	4550	0.0	0.0843956043956044
chr3	ZBBX	167252125	167252211	0	87	384	4593	384	4506	0.0	0.085219707057257
chr3	ZBBX	167373705	167373787	0	83	384	4593	384	4510	0.0	0.08514412416851441
chr3	ZBBX	167379637	167379792	0	156	384	4593	384	4437	0.0	0.08654496281271129
chr3	PDCD10	167725400	167725473	0	74	1531	3179	1531	3105	0.0	0.4930756843800322
chr3	PDCD10	167734213	167734345	1	133	1531	3179	1530	3046	0.007518796992481203	0.5022980958634274
chr3	PDCD10	167734213	167734246	1	34	1531	3179	1530	3145	0.029411764705882353	0.4864864864864865
chr3	PDCD10	167734213	167734350	1	138	1531	3179	1530	3041	0.007246376811594203	0.5031239723775074
chr3	SLC2A2	171009957	171010082	0	126	0	3422	0	3296	0.0	0.0
chr3	SLC2A2	171014468	171014731	0	264	0	3422	0	3158	0.0	0.0
chr3	TBL1XR1	177079826	177079945	0	120	152	10475	152	10355	0.0	0.014678899082568808
chr3	TBL1XR1	177098465	177098541	0	77	152	10475	152	10398	0.0	0.014618195806885939
chr3	TBL1XR1	177110808	177110887	0	80	152	10475	152	10395	0.0	0.014622414622414622
chr3	TBL1XR1	177064919	177065022	0	104	152	10475	152	10371	0.0	0.014656253013209912
chr3	TBL1XR1	177086964	177087041	0	78	152	10475	152	10397	0.0	0.014619601808213908
chr3	TBL1XR1	177131362	177131449	0	88	152	10475	152	10387	0.0	0.014633676711273708
chr3	TBL1XR1	177160870	177160988	0	119	152	10475	152	10356	0.0	0.014677481653147934
chr3	TBL1XR1	177053772	177053918	0	147	152	10475	152	10328	0.0	0.01471727343144849
chr3	TBL1XR1	177091150	177091180	0	31	152	10475	152	10444	0.0	0.014553810800459595
chr3	KCNMB2-AS1	178757079	178757133	0	55	2835	4760	2835	4705	0.0	0.6025504782146652
chr3	KCNMB2-AS1	178841544	178841616	0	73	2835	4760	2835	4687	0.0	0.6048645188820141
chr3	PEX5L	179900669	179900735	0	67	0	10258	0	10191	0.0	0.0
chr3	PEX5L	179971593	179971665	0	73	0	10258	0	10185	0.0	0.0
chr3	PEX5L	179898141	179898246	0	106	0	10258	0	10152	0.0	0.0
chr3	DCUN1D1	182980834	182980935	0	102	26	8289	26	8187	0.0	0.003175766459020398
chr3	DCUN1D1	182985503	182985622	0	120	26	8289	26	8169	0.0	0.0031827641082139797
chr3	MCCC1	183072365	183072487	0	123	5639	4334	5639	4211	0.0	1.3391118499168844
chr3	MCCC1	183086692	183086788	0	97	5639	4334	5639	4237	0.0	1.3308945008260562
chr3	CLCN2	184346934	184347021	0	88	0	7330	0	7242	0.0	0.0
chr3	CLCN2	184352012	184352117	0	106	0	7330	0	7224	0.0	0.0
chr3	AC068631.1	186651809	186651871	0	63	15112	10018	15112	9955	0.0	1.5180311401305877
chr3	AC068631.1	186666967	186667261	0	295	15112	10018	15112	9723	0.0	1.5542528026329323
chr3	AC068631.1	186721219	186721344	0	126	15112	10018	15112	9892	0.0	1.5276991508289526
chr3	AC068631.1	186736538	186736650	0	113	15112	10018	15112	9905	0.0	1.5256940938919739
chr3	AC068631.1	186721219	186721416	0	198	15112	10018	15112	9820	0.0	1.5389002036659878
chr3	AC068631.1	186734712	186734834	0	123	15112	10018	15112	9895	0.0	1.5272359777665487
chr3	AC068631.1	186714739	186714858	0	120	15112	10018	15112	9898	0.0	1.5267730854718125
chr3	AC068631.1	186714447	186714539	0	93	15112	10018	15112	9925	0.0	1.5226196473551636
chr3	AC068631.1	186668911	186669043	0	133	15112	10018	15112	9885	0.0	1.528780981284775
chr3	AC068631.1	186736746	186736883	0	138	15112	10018	15112	9880	0.0	1.5295546558704454
chr3	AC068631.1	186742072	186742249	0	178	15112	10018	15112	9840	0.0	1.5357723577235773
chr3	FGF12	192360427	192360538	0	112	0	7205	0	7093	0.0	0.0
chr3	FGF12	192727180	192727323	0	144	0	7205	0	7061	0.0	0.0
chr3	LINC02028	194048912	194049371	0	460	1802	10141	1802	9681	0.0	0.18613779568226424
chr3	LINC02028	194052359	194052442	0	84	1802	10141	1802	10057	0.0	0.17917868151536243
chr3	LINC02028	194015550	194015635	0	86	1802	10141	1802	10055	0.0	0.17921432123321732
chr3	LINC02028	194023106	194023207	0	102	1802	10141	1802	10039	0.0	0.17949995019424245
chr3	LINC02028	194043743	194043855	0	113	1802	10141	1802	10028	0.0	0.17969684882329479
chr3	LINC02028	194046469	194046679	0	211	1802	10141	1802	9930	0.0	0.18147029204431017
chr3	LINC02028	194057636	194057815	0	180	1802	10141	1802	9961	0.0	0.18090553157313521
chr3	LINC02028	194058059	194058147	0	89	1802	10141	1802	10052	0.0	0.17926780740151213
chr3	LINC02028	194057632	194057815	0	184	1802	10141	1802	9957	0.0	0.18097820628703426
chr3	PPP1R2	195523691	195523786	0	96	0	4053	0	3957	0.0	0.0
chr3	PPP1R2	195524818	195524896	0	79	0	4053	0	3974	0.0	0.0
chr3	APOD	195582616	195582739	0	124	272	2030	272	1906	0.0	0.14270724029380902
chr3	APOD	195583066	195583202	272	137	272	2030	0	1893	1.9854014598540146	0.0
chr3	TFRC	196073929	196074125	0	197	29078	7608	29078	7411	0.0	3.9236270408851706
chr3	TFRC	196075158	196075360	12844	203	29078	7608	16234	7405	63.27093596059113	2.1923024983119515
chr3	ZDHHC19	196198275	196198451	8035	177	60122	2438	52087	2261	45.3954802259887	23.037151702786378
chr3	ZDHHC19	196198451	196198590	6804	140	60122	2438	53318	2298	48.6	23.201914708442125
chr3	DLG1	197075836	197075870	0	35	47199	16100	47199	16065	0.0	2.9380018674136323
chr3	DLG1	197076585	197076685	0	101	47199	16100	47199	15999	0.0	2.9501218826176636
chr3	DLG1	197155668	197155763	0	96	47199	16100	47199	16004	0.0	2.9492001999500124
chr3	DLG1	197161639	197161738	0	100	47199	16100	47199	16000	0.0	2.9499375
chr3	DLG1	197081050	197081117	0	68	47199	16100	47199	16032	0.0	2.9440494011976046
chr3	DLG1	197068501	197068537	0	37	47199	16100	47199	16063	0.0	2.9383676772707465
chr3	DLG1	197069218	197069260	0	43	47199	16100	47199	16057	0.0	2.939465653609018
chr3	DLG1	197076585	197076682	0	98	47199	16100	47199	16002	0.0	2.9495688038995125
chr3	DLG1	197142717	197142768	0	52	47199	16100	47199	16048	0.0	2.9411141575274176
chr3	DLG1	197149742	197149796	0	55	47199	16100	47199	16045	0.0	2.9416640698036773
chr3	BDH1	197546360	197546486	0	127	365591	10256	365591	10129	0.0	36.09349392832461
chr3	BDH1	197554561	197554713	0	153	365591	10256	365591	10103	0.0	36.18638028308423
chr3	BDH1	197555341	197555507	204	167	365591	10256	365387	10089	1.221556886227545	36.21637426900585
chr3	RUBCN	197696953	197697049	0	97	41115	11010	41115	10913	0.0	3.767524970219005
chr3	RUBCN	197699186	197699231	0	46	41115	11010	41115	10964	0.0	3.75
chr4	GAK	904636	904779	0	144	148340	14541	148340	14397	0.0	10.303535458776134
chr4	GAK	913606	913668	0	63	148340	14541	148340	14478	0.0	10.245890316342036
chr4	SLBP	1703595	1703700	156	106	17551	1892	17395	1786	1.471698113207547	9.739641657334827
chr4	SLBP	1711873	1711990	22	118	17551	1892	17529	1774	0.1864406779661017	9.881059751972943
chr4	NELFA	1991543	1991715	15948	173	373039	5076	357091	4903	92.18497109826589	72.83112380175403
chr4	NELFA	2006997	2007199	0	203	373039	5076	373039	4873	0.0	76.5522265544839
chr4	NELFA	1991543	1991730	15948	188	373039	5076	357091	4888	84.82978723404256	73.05462356792144
chr4	NELFA	2007971	2008046	443	76	373039	5076	372596	5000	5.828947368421052	74.5192
chr4	RAB28	13369870	13369965	11094	96	11835	2232	741	2136	115.5625	0.34691011235955055
chr4	RAB28	13371794	13371867	0	74	11835	2232	11835	2158	0.0	5.484244670991659
chr4	LDB2	16674199	16674319	0	121	0	5476	0	5355	0.0	0.0
chr4	LDB2	16752406	16752458	0	53	0	5476	0	5423	0.0	0.0
chr4	LCORL	17866998	17867025	0	28	197422	16931	197422	16903	0.0	11.679701828077857
chr4	LCORL	17873387	17878213	10353	4827	197422	16931	187069	12104	2.144810441267868	15.45513879709187
chr4	LCORL	17886067	17886161	0	95	197422	16931	197422	16836	0.0	11.726181990971726
chr4	LCORL	17909093	17909345	97	253	197422	16931	197325	16678	0.383399209486166	11.831454610864611
chr4	KCNIP4	20882607	20882709	0	103	67349	4251	67349	4148	0.0	16.236499517839924
chr4	KCNIP4	21762920	21763032	0	113	67349	4251	67349	4138	0.0	16.275737071048816
chr4	TLR10	38775774	38775963	0	190	0	1194	0	1004	0.0	0.0
chr4	TLR10	38776109	38776426	0	318	0	1194	0	876	0.0	0.0
chr4	SMIM14	39556427	39556570	0	144	25763	3667	25763	3523	0.0	7.312801589554357
chr4	SMIM14	39572414	39572463	246	50	25763	3667	25517	3617	4.92	7.054741498479403
chr4	APBB2	41033235	41033304	0	70	26951	11681	26951	11611	0.0	2.321160968047541
chr4	APBB2	41065575	41065673	0	99	26951	11681	26951	11582	0.0	2.3269728889656363
chr4	ATP8A1	42590810	42590884	0	75	306	10764	306	10689	0.0	0.02862756104406399
chr4	ATP8A1	42594288	42594362	0	75	306	10764	306	10689	0.0	0.02862756104406399
chr4	AC114757.1	43981597	43981647	0	51	51	9122	51	9071	0.0	0.005622312865174733
chr4	AC114757.1	43993012	43993112	0	101	51	9122	51	9021	0.0	0.005653475224476222
chr4	GNPDA2	44718308	44718410	0	103	89964	2710	89964	2607	0.0	34.508630609896436
chr4	GNPDA2	44722083	44722242	0	160	89964	2710	89964	2550	0.0	35.28
chr4	GABRA2	46303459	46303612	0	154	0	16399	0	16245	0.0	0.0
chr4	GABRA2	46310172	46310255	0	84	0	16399	0	16315	0.0	0.0
chr4	COX7B2	46876638	46876737	0	100	0	822	0	722	0.0	0.0
chr4	COX7B2	46903875	46904014	0	140	0	822	0	682	0.0	0.0
chr4	FRYL	48684672	48684795	0	124	17069	18237	17069	18113	0.0	0.942361839562745
chr4	FRYL	48710518	48710698	0	181	17069	18237	17069	18056	0.0	0.9453367301727957
chr4	SRD5A3-AS1	55377606	55377770	0	165	0	4773	0	4608	0.0	0.0
chr4	SRD5A3-AS1	55382506	55382562	0	57	0	4773	0	4716	0.0	0.0
chr4	SRD5A3-AS1	55377606	55377836	0	231	0	4773	0	4542	0.0	0.0
chr4	SRD5A3-AS1	55380795	55380879	0	85	0	4773	0	4688	0.0	0.0
chr4	SRD5A3-AS1	55382506	55382642	0	137	0	4773	0	4636	0.0	0.0
chr4	SRD5A3-AS1	55383291	55383433	0	143	0	4773	0	4630	0.0	0.0
chr4	SRD5A3-AS1	55383764	55383882	0	119	0	4773	0	4654	0.0	0.0
chr4	NMU	55605274	55605349	0	76	0	986	0	910	0.0	0.0
chr4	NMU	55607297	55607348	0	52	0	986	0	934	0.0	0.0
chr4	NMU	55607436	55607466	0	31	0	986	0	955	0.0	0.0
chr4	AASDH	56382476	56382597	35	122	4110	4669	4075	4547	0.28688524590163933	0.8961952936001759
chr4	AASDH	56384069	56384341	0	273	4110	4669	4110	4396	0.0	0.934940855323021
chr4	AASDH	56378147	56378464	0	318	4110	4669	4110	4351	0.0	0.9446104343829005
chr4	HOPX	56657774	56657899	0	126	0	3242	0	3116	0.0	0.0
chr4	HOPX	56676498	56676566	0	69	0	3242	0	3173	0.0	0.0
chr4	SPINK2	56816710	56816714	0	5	78	732	78	727	0.0	0.10729023383768914
chr4	SPINK2	56820535	56820579	78	45	78	732	0	687	1.7333333333333334	0.0
chr4	ADGRL3-AS1	62081971	62082052	0	82	0	958	0	876	0.0	0.0
chr4	ADGRL3-AS1	62118061	62118102	0	42	0	958	0	916	0.0	0.0
chr4	LINC02232	64939955	64940036	0	82	0	6375	0	6293	0.0	0.0
chr4	LINC02232	64977488	64977629	0	142	0	6375	0	6233	0.0	0.0
chr4	TMPRSS11BNL	68191406	68191524	0	119	51	4327	51	4208	0.0	0.01211977186311787
chr4	TMPRSS11BNL	68206034	68206097	0	64	51	4327	51	4263	0.0	0.011963406052076003
chr4	UGT2A1	69635690	69635822	0	133	0	3689	0	3556	0.0	0.0
chr4	UGT2A1	69638898	69639528	0	631	0	3689	0	3058	0.0	0.0
chr4	JCHAIN	70664101	70664149	0	49	0	1554	0	1505	0.0	0.0
chr4	JCHAIN	70665859	70665886	0	28	0	1554	0	1526	0.0	0.0
chr4	GC	71746150	71746205	0	56	393	2110	393	2054	0.0	0.19133398247322297
chr4	GC	71752517	71752650	0	134	393	2110	393	1976	0.0	0.19888663967611336
chr4	G3BP2	75657556	75657730	0	175	408	11241	408	11066	0.0	0.03686969094523766
chr4	G3BP2	75658842	75658924	0	83	408	11241	408	11158	0.0	0.03656569277648324
chr4	G3BP2	75722196	75722244	0	49	408	11241	408	11192	0.0	0.036454610436025735
chr4	G3BP2	75724055	75724176	0	122	408	11241	408	11119	0.0	0.03669394729741883
chr4	G3BP2	75722196	75722247	0	52	408	11241	408	11189	0.0	0.036464384663508806
chr4	G3BP2	75694797	75694929	0	133	408	11241	408	11108	0.0	0.036730284479654304
chr4	G3BP2	75720876	75720969	0	94	408	11241	408	11147	0.0	0.03660177626267157
chr4	G3BP2	75662212	75662520	0	309	408	11241	408	10932	0.0	0.03732162458836443
chr4	G3BP2	75662689	75662841	0	153	408	11241	408	11088	0.0	0.0367965367965368
chr4	G3BP2	75662212	75662525	0	314	408	11241	408	10927	0.0	0.03733870229706232
chr4	G3BP2	75662765	75662841	0	77	408	11241	408	11164	0.0	0.03654604084557506
chr4	G3BP2	75661930	75662049	0	120	408	11241	408	11121	0.0	0.036687348260048554
chr4	G3BP2	75657800	75657893	0	94	408	11241	408	11147	0.0	0.03660177626267157
chr4	G3BP2	75694797	75695073	0	277	408	11241	408	10964	0.0	0.037212696096315216
chr4	G3BP2	75713125	75713336	0	212	408	11241	408	11029	0.0	0.03699338108622722
chr4	G3BP2	75694792	75694929	0	138	408	11241	408	11103	0.0	0.03674682518238314
chr4	NUP54	76136185	76136412	0	228	68	4007	68	3779	0.0	0.01799417835406192
chr4	NUP54	76144148	76144292	0	145	68	4007	68	3862	0.0	0.017607457276022784
chr4	NUP54	76145982	76146129	0	148	68	4007	68	3859	0.0	0.01762114537444934
chr4	NUP54	76147478	76147640	0	163	68	4007	68	3844	0.0	0.01768990634755463
chr4	NUP54	76145554	76145577	0	24	68	4007	68	3983	0.0	0.017072558373085613
chr4	SCARB2	76175790	76175910	0	121	153	15139	153	15018	0.0	0.010187774670395526
chr4	SCARB2	76176436	76176528	0	93	153	15139	153	15046	0.0	0.010168815632061677
chr4	PAQR3	78933075	78933231	0	157	0	7282	0	7125	0.0	0.0
chr4	PAQR3	78935120	78935283	0	164	0	7282	0	7118	0.0	0.0
chr4	PAQR3	78935120	78935176	0	57	0	7282	0	7225	0.0	0.0
chr4	RASGEF1B	81521411	81521545	0	135	102	10205	102	10070	0.0	0.01012909632571996
chr4	RASGEF1B	81602838	81602922	0	85	102	10205	102	10120	0.0	0.01007905138339921
chr4	SEC31A	82861630	82861708	0	79	102	8631	102	8552	0.0	0.011927034611786716
chr4	SEC31A	82862533	82862572	0	40	102	8631	102	8591	0.0	0.011872890233965778
chr4	SEC31A	82880798	82880922	0	125	102	8631	102	8506	0.0	0.011991535386785799
chr4	SEC31A	82881857	82881940	0	84	102	8631	102	8547	0.0	0.011934011934011933
chr4	THAP9-AS1	82897988	82898062	0	75	0	4254	0	4179	0.0	0.0
chr4	THAP9-AS1	82899712	82899737	0	26	0	4254	0	4228	0.0	0.0
chr4	LIN54	82946257	82946474	0	218	51	3486	51	3268	0.0	0.015605875152998777
chr4	LIN54	82970326	82970469	0	144	51	3486	51	3342	0.0	0.01526032315978456
chr4	HPSE	83310721	83310890	0	170	121992	4700	121992	4530	0.0	26.929801324503313
chr4	HPSE	83313113	83313287	0	175	121992	4700	121992	4525	0.0	26.959558011049722
chr4	WDFY3	84879405	84879494	0	90	91	15989	91	15899	0.0	0.005723630417007359
chr4	WDFY3	84896910	84897010	0	101	91	15989	91	15888	0.0	0.005727593152064451
chr4	MAPK10	86089205	86089277	0	73	153	36649	153	36576	0.0	0.004183070866141733
chr4	MAPK10	86098523	86098595	0	73	153	36649	153	36576	0.0	0.004183070866141733
chr4	MAPK10	86194308	86194335	0	28	153	36649	153	36621	0.0	0.004177930695502581
chr4	MAPK10	86194335	86194407	0	73	153	36649	153	36576	0.0	0.004183070866141733
chr4	MAPK10	86277049	86277223	0	175	153	36649	153	36474	0.0	0.004194768876459944
chr4	MAPK10	86354529	86354644	0	116	153	36649	153	36533	0.0	0.004187994416007445
chr4	MAPK10	86335075	86335156	0	82	153	36649	153	36567	0.0	0.0041841004184100415
chr4	MAPK10	86399746	86399806	0	61	153	36649	153	36588	0.0	0.004181698917677927
chr4	MAPK10	86453029	86453181	0	153	153	36649	153	36496	0.0	0.004192240245506357
chr4	MAPK10	86370713	86370867	0	155	153	36649	153	36494	0.0	0.004192469995067683
chr4	MAPK10	86321843	86322029	0	187	153	36649	153	36462	0.0	0.004196149415830179
chr4	MAPK10	86308661	86308754	0	94	153	36649	153	36555	0.0	0.004185473943373
chr4	MAPK10	86194318	86194407	0	90	153	36649	153	36559	0.0	0.004185016001531771
chr4	MAPK10	86194308	86194407	0	100	153	36649	153	36549	0.0	0.004186161044077813
chr4	MAPK10	86159297	86159467	0	171	153	36649	153	36478	0.0	0.004194308898514173
chr4	MAPK10	86429677	86429805	0	129	153	36649	153	36520	0.0	0.004189485213581599
chr4	MAPK10	86340338	86340423	0	86	153	36649	153	36563	0.0	0.004184558159888412
chr4	MAPK10	86352164	86352224	0	61	153	36649	153	36588	0.0	0.004181698917677927
chr4	MAPK10	86101051	86101217	0	167	153	36649	153	36482	0.0	0.004193849021435228
chr4	MAPK10	86151990	86152196	0	207	153	36649	153	36442	0.0	0.004198452335217606
chr4	MAPK10	86152462	86152629	0	168	153	36649	153	36481	0.0	0.004193963981250514
chr4	MAPK10	86151990	86152144	0	155	153	36649	153	36494	0.0	0.004192469995067683
chr4	MAPK10	86098523	86099285	0	763	153	36649	153	35886	0.0	0.004263501086774786
chr4	MAPK10	86332542	86332727	0	186	153	36649	153	36463	0.0	0.004196034336176398
chr4	MAPK10	86356461	86356519	0	59	153	36649	153	36590	0.0	0.004181470347089369
chr4	MAPK10	86358207	86358312	0	106	153	36649	153	36543	0.0	0.004186848370412938
chr4	SPARCL1	87504821	87504923	0	103	0	3494	0	3391	0.0	0.0
chr4	SPARCL1	87528125	87528233	0	109	0	3494	0	3385	0.0	0.0
chr4	SPARCL1	87528554	87528614	0	61	0	3494	0	3433	0.0	0.0
chr4	DNAJB14	99924759	99924815	0	57	1620	9371	1620	9314	0.0	0.17393171569680052
chr4	DNAJB14	99927716	99927838	0	123	1620	9371	1620	9248	0.0	0.17517301038062283
chr4	MANBA	102726588	102726683	0	96	61	8306	61	8210	0.0	0.0074299634591961025
chr4	MANBA	102734382	102734571	0	190	61	8306	61	8116	0.0	0.007516017742730409
chr4	BDH2	103097635	103097754	0	120	51	5225	51	5105	0.0	0.00999020568070519
chr4	BDH2	103098643	103098802	0	160	51	5225	51	5065	0.0	0.010069101678183614
chr4	INTS12	105702885	105703023	0	139	51	3907	51	3768	0.0	0.013535031847133758
chr4	INTS12	105703647	105703809	0	163	51	3907	51	3744	0.0	0.013621794871794872
chr4	INTS12	105707918	105708162	0	245	51	3907	51	3662	0.0	0.013926815947569634
chr4	ETNPPL	108759748	108759908	0	161	167	2934	167	2773	0.0	0.06022358456545258
chr4	ETNPPL	108760187	108760306	0	120	167	2934	167	2814	0.0	0.059346126510305616
chr4	COL25A1	108819251	108819329	0	79	14410	6485	14410	6406	0.0	2.249453637215111
chr4	COL25A1	108819811	108819898	17	88	14410	6485	14393	6397	0.19318181818181818	2.249960919180866
chr4	COL25A1	108941365	108941437	0	73	14410	6485	14410	6412	0.0	2.247348721147848
chr4	COL25A1	108942208	108942268	50	61	14410	6485	14360	6424	0.819672131147541	2.2353673723536738
chr4	ZGRF1	112628620	112628851	0	232	0	9135	0	8903	0.0	0.0
chr4	ZGRF1	112629758	112630015	0	258	0	9135	0	8877	0.0	0.0
chr4	CAMK2D	113547643	113547716	0	74	1310	7387	1310	7313	0.0	0.1791330507315739
chr4	CAMK2D	113548656	113548729	0	74	1310	7387	1310	7313	0.0	0.1791330507315739
chr4	CAMK2D	113502935	113502977	0	43	1310	7387	1310	7344	0.0	0.17837690631808278
chr4	CAMK2D	113508235	113508268	0	34	1310	7387	1310	7353	0.0	0.17815857473140215
chr4	CETN4P	122730819	122731683	41951	865	67841	3670	25890	2805	48.49826589595376	9.229946524064172
chr4	CETN4P	122732051	122732193	265	143	67841	3670	67576	3527	1.8531468531468531	19.159625744258577
chr4	AC093772.1	127415075	127415162	0	88	0	2660	0	2572	0.0	0.0
chr4	AC093772.1	127457601	127457672	0	72	0	2660	0	2588	0.0	0.0
chr4	MFSD8	127942044	127942158	0	115	0	7255	0	7140	0.0	0.0
chr4	MFSD8	127943751	127943992	0	242	0	7255	0	7013	0.0	0.0
chr4	MFSD8	127938782	127938838	0	57	0	7255	0	7198	0.0	0.0
chr4	MFSD8	127939852	127939997	0	146	0	7255	0	7109	0.0	0.0
chr4	MFSD8	127938782	127938836	0	55	0	7255	0	7200	0.0	0.0
chr4	MFSD8	127949803	127949847	0	45	0	7255	0	7210	0.0	0.0
chr4	AC105383.1	133140469	133140511	0	43	0	11465	0	11422	0.0	0.0
chr4	AC105383.1	133140585	133140659	0	75	0	11465	0	11390	0.0	0.0
chr4	AC105383.1	133140585	133140656	0	72	0	11465	0	11393	0.0	0.0
chr4	AC105383.1	133097639	133097724	0	86	0	11465	0	11379	0.0	0.0
chr4	AC105383.1	133110785	133110910	0	126	0	11465	0	11339	0.0	0.0
chr4	LINC02511	136813649	136813731	0	83	50	3399	50	3316	0.0	0.015078407720144753
chr4	LINC02511	136916174	136916226	0	53	50	3399	50	3346	0.0	0.014943215780035863
chr4	LINC00616	138095283	138095420	0	138	0	6060	0	5922	0.0	0.0
chr4	LINC00616	138098158	138098272	0	115	0	6060	0	5945	0.0	0.0
chr4	LINC00616	138097968	138098272	0	305	0	6060	0	5755	0.0	0.0
chr4	LINC00616	138048379	138048606	0	228	0	6060	0	5832	0.0	0.0
chr4	LINC00616	138090942	138091039	0	98	0	6060	0	5962	0.0	0.0
chr4	NDUFC1	139296331	139296367	0	37	0	2585	0	2548	0.0	0.0
chr4	NDUFC1	139297384	139297443	0	60	0	2585	0	2525	0.0	0.0
chr4	AC097376.3	139415936	139416012	0	77	0	4044	0	3967	0.0	0.0
chr4	AC097376.3	139452356	139452497	0	142	0	4044	0	3902	0.0	0.0
chr4	MGAT4D	140474812	140474946	0	135	408	2816	408	2681	0.0	0.15218202163371877
chr4	MGAT4D	140482326	140482485	0	160	408	2816	408	2656	0.0	0.1536144578313253
chr4	INPP4B	142347373	142347556	0	184	899	14202	899	14018	0.0	0.06413183050363817
chr4	INPP4B	142383961	142384116	0	156	899	14202	899	14046	0.0	0.0640039869001851
chr4	INPP4B	142467956	142468055	0	100	899	14202	899	14102	0.0	0.06374982272018154
chr4	INPP4B	142660776	142660896	0	121	899	14202	899	14081	0.0	0.06384489737944748
chr4	GYPE	143873356	143873475	0	120	0	2013	0	1893	0.0	0.0
chr4	GYPE	143876745	143876855	0	111	0	2013	0	1902	0.0	0.0
chr4	GYPB	144002570	144002694	0	125	0	1716	0	1591	0.0	0.0
chr4	GYPB	144016801	144016884	0	84	0	1716	0	1632	0.0	0.0
chr4	GYPB	144008391	144008449	0	59	0	1716	0	1657	0.0	0.0
chr4	GYPB	143997539	143997634	0	96	0	1716	0	1620	0.0	0.0
chr4	GYPB	143999410	143999449	0	40	0	1716	0	1676	0.0	0.0
chr4	GYPA	144122871	144122989	0	119	16240	4262	16240	4143	0.0	3.919864832247164
chr4	GYPA	144127877	144128035	612	159	16240	4262	15628	4103	3.849056603773585	3.8089203022178895
chr4	GYPA	144138160	144138340	0	181	16240	4262	16240	4081	0.0	3.979416809605489
chr4	GYPA	144138160	144138243	0	84	16240	4262	16240	4178	0.0	3.887027285782671
chr4	GYPA	144118713	144118752	0	40	16240	4262	16240	4222	0.0	3.8465182378019898
chr4	GYPA	144119685	144119781	357	97	16240	4262	15883	4165	3.6804123711340204	3.8134453781512607
chr4	GYPA	144120489	144120588	0	100	16240	4262	16240	4162	0.0	3.901970206631427
chr4	ZNF827	145763089	145763122	0	34	5491	16799	5491	16765	0.0	0.32752758723531167
chr4	ZNF827	145763401	145763468	0	68	5491	16799	5491	16731	0.0	0.3281931743470205
chr4	ZNF827	145763089	145763117	0	29	5491	16799	5491	16770	0.0	0.3274299344066786
chr4	TTC29	146942583	146942684	0	102	252	3350	252	3248	0.0	0.07758620689655173
chr4	TTC29	146944096	146944350	0	255	252	3350	252	3095	0.0	0.08142164781906301
chr4	RNF175	153728206	153728361	0	156	624	3914	624	3758	0.0	0.1660457690260777
chr4	RNF175	153748644	153748786	51	143	624	3914	573	3771	0.35664335664335667	0.15194908512330946
chr4	SPOCK3	167000348	167000463	0	116	0	4501	0	4385	0.0	0.0
chr4	SPOCK3	167062491	167062537	0	47	0	4501	0	4454	0.0	0.0
chr4	SPOCK3	167062641	167062650	0	10	0	4501	0	4491	0.0	0.0
chr4	SPOCK3	167083237	167083246	0	10	0	4501	0	4491	0.0	0.0
chr4	SPOCK3	167119793	167119874	0	82	0	4501	0	4419	0.0	0.0
chr4	SPOCK3	166889129	166889244	0	116	0	4501	0	4385	0.0	0.0
chr4	SPOCK3	166912619	166912743	0	125	0	4501	0	4376	0.0	0.0
chr4	HPGD	174517970	174518077	0	108	51	5539	51	5431	0.0	0.009390535812925796
chr4	HPGD	174521943	174522067	0	125	51	5539	51	5414	0.0	0.009420022164758035
chr4	GPM6A	175812190	175812249	0	60	51	7064	51	7004	0.0	0.007281553398058253
chr4	GPM6A	175961236	175961341	0	106	51	7064	51	6958	0.0	0.007329692440356425
chr4	GPM6A	175891462	175891690	0	229	51	7064	51	6835	0.0	0.007461594732991953
chr4	GPM6A	175906652	175906851	0	200	51	7064	51	6864	0.0	0.00743006993006993
chr4	DCTD	182916418	182916539	0	122	0	3477	0	3355	0.0	0.0
chr4	DCTD	182916722	182916857	0	136	0	3477	0	3341	0.0	0.0
chr4	RWDD4	183651217	183651323	0	107	0	2762	0	2655	0.0	0.0
chr4	RWDD4	183655880	183655961	0	82	0	2762	0	2680	0.0	0.0
chr4	ACSL1	184770254	184770332	0	79	363	6161	363	6082	0.0	0.05968431437027294
chr4	ACSL1	184770398	184770476	0	79	363	6161	363	6082	0.0	0.05968431437027294
chr4	LINC01093	184897669	184897746	0	78	0	3158	0	3080	0.0	0.0
chr4	LINC01093	184898620	184898769	0	150	0	3158	0	3008	0.0	0.0
chr4	LINC01093	184898646	184898769	0	124	0	3158	0	3034	0.0	0.0
chr4	LINC01093	184897334	184897567	0	234	0	3158	0	2924	0.0	0.0
chr4	LINC01093	184897334	184897588	0	255	0	3158	0	2903	0.0	0.0
chr4	LINC01093	184897347	184897588	0	242	0	3158	0	2916	0.0	0.0
chr4	LINC01093	184897347	184897567	0	221	0	3158	0	2937	0.0	0.0
chr4	LINC01093	184897334	184897749	0	416	0	3158	0	2742	0.0	0.0
chr4	LINC01093	184897669	184897749	0	81	0	3158	0	3077	0.0	0.0
chr4	LINC01093	184897334	184897746	0	413	0	3158	0	2745	0.0	0.0
chr4	CCDC110	185452220	185452373	0	154	1796	3546	1796	3392	0.0	0.5294811320754716
chr4	CCDC110	185457161	185457329	428	169	1796	3546	1368	3377	2.532544378698225	0.40509327805744744
chr4	PDLIM3	185513556	185514337	0	782	102	9020	102	8238	0.0	0.012381646030589949
chr4	PDLIM3	185514702	185514890	0	189	102	9020	102	8831	0.0	0.011550220813044956
chr4	PDLIM3	185514269	185514337	0	69	102	9020	102	8951	0.0	0.011395374818456039
chr4	PDLIM3	185523361	185523446	0	86	102	9020	102	8934	0.0	0.011417058428475487
chr4	PDLIM3	185525019	185525171	0	153	102	9020	102	8867	0.0	0.011503326942596143
chr4	SORBS2	185638078	185638162	0	85	166990	11677	166990	11592	0.0	14.405624568668047
chr4	SORBS2	185638876	185639035	0	160	166990	11677	166990	11517	0.0	14.499435616914127
chr4	SORBS2	185684753	185684846	192	94	166990	11677	166798	11583	2.0425531914893615	14.400241733575067
chr4	SORBS2	185690561	185690611	367	51	166990	11677	166623	11626	7.196078431372549	14.331928436263548
chr4	SORBS2	185733997	185734154	0	158	166990	11677	166990	11519	0.0	14.496918135254797
chr4	SORBS2	185734098	185734154	0	57	166990	11677	166990	11620	0.0	14.37091222030981
chr4	SORBS2	185775059	185775111	0	53	166990	11677	166990	11624	0.0	14.365966964900206
chr4	FAT1	186590367	186590403	0	37	348	16199	348	16162	0.0	0.02153198861527039
chr4	FAT1	186590504	186590695	0	192	348	16199	348	16007	0.0	0.021740488536265385
chr4	LINC02492	187558076	187558264	0	189	7373	2773	7373	2584	0.0	2.853328173374613
chr4	LINC02492	187582420	187582530	0	111	7373	2773	7373	2662	0.0	2.7697220135236664
chr4	LINC02492	187558180	187558264	0	85	7373	2773	7373	2688	0.0	2.7429315476190474
chr4	LINC02492	187533351	187533609	0	259	7373	2773	7373	2514	0.0	2.9327764518695307
chr4	LINC02492	187555060	187555144	0	85	7373	2773	7373	2688	0.0	2.7429315476190474
chr4	TMEM175	947708	947892	357	185	50348	3599	49991	3414	1.9297297297297298	14.642940831868776
chr4	TMEM175	948115	948154	24	40	50348	3599	50324	3559	0.6	14.139926945771284
chr4	MAEA	1322380	1322503	406	124	42338	6602	41932	6478	3.274193548387097	6.472985489348565
chr4	MAEA	1327626	1327703	5	78	42338	6602	42333	6524	0.0641025641025641	6.488810545677499
chr4	MAEA	1315396	1315600	153	205	42338	6602	42185	6397	0.7463414634146341	6.594497420665937
chr4	FGFR3	1802913	1803064	91	152	12294	4866	12203	4714	0.5986842105263158	2.588672040729741
chr4	FGFR3	1803691	1803836	466	146	12294	4866	11828	4720	3.191780821917808	2.5059322033898304
chr4	RNF4	2470986	2471109	51	124	366296	7130	366245	7006	0.4112903225806452	52.27590636597203
chr4	RNF4	2490336	2490502	0	167	366296	7130	366296	6963	0.0	52.60606060606061
chr4	RNF4	2497006	2497121	272	116	366296	7130	366024	7014	2.3448275862068964	52.18477331052181
chr4	RNF4	2490336	2490411	0	76	366296	7130	366296	7054	0.0	51.92741706833002
chr4	RNF4	2500658	2500738	0	81	366296	7130	366296	7049	0.0	51.96425024826217
chr4	FAM193A	2708145	2708268	0	124	17487	6976	17487	6852	0.0	2.5521015761821366
chr4	FAM193A	2715321	2715493	0	173	17487	6976	17487	6803	0.0	2.570483610171983
chr4	ADD1	2926284	2926316	84	33	337989	11643	337905	11610	2.5454545454545454	29.1046511627907
chr4	ADD1	2926641	2926675	50	35	337989	11643	337939	11608	1.4285714285714286	29.11259476223294
chr4	ADD1	2926638	2926675	62	38	337989	11643	337927	11605	1.631578947368421	29.11908660060319
chr4	ADD1	2867971	2868129	0	159	337989	11643	337989	11484	0.0	29.431295715778475
chr4	ADD1	2873014	2873135	0	122	337989	11643	337989	11521	0.0	29.33677632149987
chr4	LINC00955	3587874	3588050	0	177	0	2091	0	1914	0.0	0.0
chr4	LINC00955	3588050	3588187	0	138	0	2091	0	1953	0.0	0.0
chr4	STK32B	5416844	5416934	0	91	221	5226	221	5135	0.0	0.043037974683544304
chr4	STK32B	5446672	5446776	0	105	221	5226	221	5121	0.0	0.043155633665299745
chr4	GPR78	8560564	8560633	0	70	51	10176	51	10106	0.0	0.005046507025529388
chr4	GPR78	8572732	8572849	0	118	51	10176	51	10058	0.0	0.005070590574666932
chr4	AC005699.1	11740796	11740939	0	144	510	4472	510	4328	0.0	0.1178373382624769
chr4	AC005699.1	11763458	11763501	0	44	510	4472	510	4428	0.0	0.11517615176151762
chr4	AC005699.1	11768727	11768810	0	84	510	4472	510	4388	0.0	0.1162260711030082
chr4	AC005699.1	11773592	11773664	0	73	510	4472	510	4399	0.0	0.11593543987269835
chr4	AC005699.1	11778185	11778535	0	351	510	4472	510	4121	0.0	0.12375636981315215
chr4	AC005699.1	11776279	11776344	0	66	510	4472	510	4406	0.0	0.11575124829777576
chr4	AC005699.1	11770611	11770688	0	78	510	4472	510	4394	0.0	0.11606736458807465
chr4	LINC02270	12230859	12230984	0	126	0	1314	0	1188	0.0	0.0
chr4	LINC02270	12243051	12243178	0	128	0	1314	0	1186	0.0	0.0
chr4	SLIT2	20489942	20489954	0	13	137140	9063	137140	9050	0.0	15.153591160220994
chr4	SLIT2	20490802	20490814	0	13	137140	9063	137140	9050	0.0	15.153591160220994
chr4	PACRGL	20716106	20716248	0	143	77872	7747	77872	7604	0.0	10.24092582851131
chr4	PACRGL	20724807	20724888	0	82	77872	7747	77872	7665	0.0	10.159425962165688
chr4	PACRGL	20702140	20702221	2426	82	77872	7747	75446	7665	29.585365853658537	9.842922374429223
chr4	PACRGL	20702650	20702740	0	91	77872	7747	77872	7656	0.0	10.171368861024034
chr4	PACRGL	20707802	20707870	0	69	77872	7747	77872	7678	0.0	10.142224537640011
chr4	PACRGL	20709682	20709773	1134	92	77872	7747	76738	7655	12.326086956521738	10.024559111691705
chr4	AC097512.1	23004836	23004928	0	93	0	7737	0	7644	0.0	0.0
chr4	AC097512.1	23032831	23032868	0	38	0	7737	0	7699	0.0	0.0
chr4	AC097512.1	22999584	22999712	0	129	0	7737	0	7608	0.0	0.0
chr4	AC097512.1	23003149	23003243	0	95	0	7737	0	7642	0.0	0.0
chr4	AC097512.1	23038003	23038097	0	95	0	7737	0	7642	0.0	0.0
chr4	AC097512.1	23083696	23083788	0	93	0	7737	0	7644	0.0	0.0
chr4	RBPJ	26429897	26430053	0	157	196733	9040	196733	8883	0.0	22.14713497692221
chr4	RBPJ	26430418	26430522	3719	105	196733	9040	193014	8935	35.41904761904762	21.60201454952434
chr4	STIM2	27019399	27021068	16374	1670	120838	8406	104464	6736	9.804790419161677	15.508313539192399
chr4	STIM2	27021493	27021612	1212	120	120838	8406	119626	8286	10.1	14.437122857832488
chr4	STIM2	27021000	27021068	112	69	120838	8406	120726	8337	1.6231884057971016	14.480748470672903
chr4	LINC02364	29008673	29008747	0	75	0	1744	0	1669	0.0	0.0
chr4	LINC02364	29012714	29012792	0	79	0	1744	0	1665	0.0	0.0
chr4	LINC02501	31509138	31509309	0	172	0	1163	0	991	0.0	0.0
chr4	LINC02501	31522290	31522439	0	150	0	1163	0	1013	0.0	0.0
chr4	AC016687.2	33890305	33890367	0	63	0	7125	0	7062	0.0	0.0
chr4	AC016687.2	33892135	33892245	0	111	0	7125	0	7014	0.0	0.0
chr4	TBC1D1	38051898	38052060	0	163	77728	8862	77728	8699	0.0	8.935279917231865
chr4	TBC1D1	38053105	38053225	0	121	77728	8862	77728	8741	0.0	8.892346413453838
chr4	WDR19	39185725	39185817	0	93	12077	8810	12077	8717	0.0	1.3854537111391534
chr4	WDR19	39186538	39186604	0	67	12077	8810	12077	8743	0.0	1.3813336383392427
chr4	LIAS	39463524	39463605	0	82	91228	9122	91228	9040	0.0	10.091592920353982
chr4	LIAS	39467517	39467646	0	130	91228	9122	91228	8992	0.0	10.145462633451958
chr4	LIAS	39465284	39465342	1171	59	91228	9122	90057	9063	19.847457627118644	9.9367759020192
chr4	LIAS	39466016	39466117	1882	102	91228	9122	89346	9020	18.45098039215686	9.905321507760533
chr4	RHOH	40200511	40200565	0	55	204	6620	204	6565	0.0	0.031073876618431074
chr4	RHOH	40235176	40235358	0	183	204	6620	204	6437	0.0	0.03169178188597173
chr4	RHOH	40212663	40212791	0	129	204	6620	204	6491	0.0	0.031428131258665844
chr4	RHOH	40218146	40218298	0	153	204	6620	204	6467	0.0	0.03154476573372506
chr4	RHOH	40235192	40235358	0	167	204	6620	204	6453	0.0	0.03161320316132032
chr4	LIMCH1	41494535	41494606	0	72	0	10455	0	10383	0.0	0.0
chr4	LIMCH1	41524408	41524478	0	71	0	10455	0	10384	0.0	0.0
chr4	TMEM33	41939195	41939383	1867	189	344307	7774	342440	7585	9.878306878306878	45.14700065919578
chr4	TMEM33	41939720	41939828	0	109	344307	7774	344307	7665	0.0	44.919373776908024
chr4	AC107068.2	47875205	47875331	70	127	126	2267	56	2140	0.5511811023622047	0.026168224299065422
chr4	AC107068.2	47882241	47882345	0	105	126	2267	126	2162	0.0	0.058279370952821465
chr4	AC107068.2	47875176	47875331	75	156	126	2267	51	2111	0.4807692307692308	0.024159166271909047
chr4	DCUN1D4	51848204	51848367	0	164	0	6539	0	6375	0.0	0.0
chr4	DCUN1D4	51860542	51860663	0	122	0	6539	0	6417	0.0	0.0
chr4	DCUN1D4	51905188	51905320	0	133	0	6539	0	6406	0.0	0.0
chr4	DCUN1D4	51908919	51908975	0	57	0	6539	0	6482	0.0	0.0
chr4	DCUN1D4	51899269	51899378	0	110	0	6539	0	6429	0.0	0.0
chr4	DCUN1D4	51911069	51911174	0	106	0	6539	0	6433	0.0	0.0
chr4	LINC02429	59013557	59013625	0	69	0	1102	0	1033	0.0	0.0
chr4	LINC02429	59026111	59026262	0	152	0	1102	0	950	0.0	0.0
chr4	ADGRL3	62063504	62063633	0	130	0	14022	0	13892	0.0	0.0
chr4	ADGRL3	62068165	62068217	0	53	0	14022	0	13969	0.0	0.0
chr4	UBA6-AS1	68077278	68077421	0	144	0	13708	0	13564	0.0	0.0
chr4	UBA6-AS1	68077462	68077630	0	169	0	13708	0	13539	0.0	0.0
chr4	ALB	73405115	73405173	0	59	1078	3401	1078	3342	0.0	0.3225613405146619
chr4	ALB	73406628	73406761	0	134	1078	3401	1078	3267	0.0	0.32996632996632996
chr4	MTHFD2L	74143392	74143467	51	76	3621	8834	3570	8758	0.6710526315789473	0.4076273121717287
chr4	MTHFD2L	74160054	74160088	0	35	3621	8834	3621	8799	0.0	0.41152403682236616
chr4	ODAPH	75556540	75556584	0	45	0	2019	0	1974	0.0	0.0
chr4	ODAPH	75563209	75563345	0	137	0	2019	0	1882	0.0	0.0
chr4	FAM47E-STBD1	76278068	76278224	0	157	0	3250	0	3093	0.0	0.0
chr4	FAM47E-STBD1	76289901	76290060	0	160	0	3250	0	3090	0.0	0.0
chr4	LINC01094	78662917	78663011	0	95	5248	5306	5248	5211	0.0	1.007100364613318
chr4	LINC01094	78673342	78673414	0	73	5248	5306	5248	5233	0.0	1.0028664246130328
chr4	LINC01094	78662917	78662972	0	56	5248	5306	5248	5250	0.0	0.9996190476190476
chr4	LINC01094	78649600	78649709	0	110	5248	5306	5248	5196	0.0	1.0100076982294073
chr4	CFAP299	80608332	80608383	0	52	0	4474	0	4422	0.0	0.0
chr4	CFAP299	80639717	80639835	0	119	0	4474	0	4355	0.0	0.0
chr4	VAMP9P	82285512	82285619	0	108	0	974	0	866	0.0	0.0
chr4	VAMP9P	82290503	82290574	0	72	0	974	0	902	0.0	0.0
chr4	MRPS18C	83458345	83458429	153	85	204	3399	51	3314	1.8	0.015389257694628847
chr4	MRPS18C	83459739	83459797	0	59	204	3399	204	3340	0.0	0.06107784431137724
chr4	WDFY3-AS2	84969724	84969876	0	153	51	8359	51	8206	0.0	0.0062149646600048744
chr4	WDFY3-AS2	85000690	85000765	0	76	51	8359	51	8283	0.0	0.006157189424121695
chr4	WDFY3-AS2	84969775	84969876	0	102	51	8359	51	8257	0.0	0.006176577449436842
chr4	WDFY3-AS2	85002537	85002737	0	201	51	8359	51	8158	0.0	0.0062515322382937
chr4	MEPE	87839684	87839777	0	94	11191	2485	11191	2391	0.0	4.680468423253869
chr4	MEPE	87839926	87840032	0	107	11191	2485	11191	2378	0.0	4.706055508830951
chr4	MEPE	87839926	87840054	0	129	11191	2485	11191	2356	0.0	4.75
chr4	SPP1	87980045	87980126	0	82	867	2329	867	2247	0.0	0.38584779706275035
chr4	SPP1	87980392	87980434	0	43	867	2329	867	2286	0.0	0.37926509186351703
chr4	RAP1GDS1	98343138	98343261	0	124	1020	5439	1020	5315	0.0	0.19190968955785512
chr4	RAP1GDS1	98352475	98352601	0	127	1020	5439	1020	5312	0.0	0.19201807228915663
chr4	RAP1GDS1	98391951	98392080	0	130	1020	5439	1020	5309	0.0	0.19212657750988887
chr4	RAP1GDS1	98379016	98379163	0	148	1020	5439	1020	5291	0.0	0.1927801927801928
chr4	METAP1	99036042	99036089	0	48	102	3921	102	3873	0.0	0.026336173508907823
chr4	METAP1	99037766	99037941	0	176	102	3921	102	3745	0.0	0.027236315086782377
chr4	MTTP	99570703	99570865	0	163	1759	5317	1759	5154	0.0	0.3412883197516492
chr4	MTTP	99574808	99574970	0	163	1759	5317	1759	5154	0.0	0.3412883197516492
chr4	LINC02428	103343091	103343235	0	145	0	3869	0	3724	0.0	0.0
chr4	LINC02428	103425054	103425185	0	132	0	3869	0	3737	0.0	0.0
chr4	LINC02428	103437717	103437842	0	126	0	3869	0	3743	0.0	0.0
chr4	LINC02428	103438706	103438763	0	58	0	3869	0	3811	0.0	0.0
chr4	CXXC4-AS1	104642858	104642923	0	66	0	6781	0	6715	0.0	0.0
chr4	CXXC4-AS1	104643010	104643139	0	130	0	6781	0	6651	0.0	0.0
chr4	HADH	108027938	108028069	0	132	51	6977	51	6845	0.0	0.007450693937180424
chr4	HADH	108032326	108032377	0	52	51	6977	51	6925	0.0	0.007364620938628159
chr4	HADH	108028860	108028869	0	10	51	6977	51	6967	0.0	0.007320223912731448
chr4	ANK2	113348275	113348308	0	34	20092	17468	20092	17434	0.0	1.1524607089595045
chr4	ANK2	113350227	113350249	0	23	20092	17468	20092	17445	0.0	1.1517340212095155
chr4	ANK2	113373089	113373173	0	85	20092	17468	20092	17383	0.0	1.1558419145141805
chr4	ANK2	113374763	113374946	0	184	20092	17468	20092	17284	0.0	1.1624623929645916
chr4	ANK2	113378089	113378181	41	93	20092	17468	20051	17375	0.44086021505376344	1.1540143884892087
chr4	ANK2	113374731	113374946	0	216	20092	17468	20092	17252	0.0	1.1646185949455137
chr4	LINC01378	117428693	117428767	0	75	0	5792	0	5717	0.0	0.0
chr4	LINC01378	117620855	117620992	0	138	0	5792	0	5654	0.0	0.0
chr4	LINC01378	117428696	117428767	0	72	0	5792	0	5720	0.0	0.0
chr4	LINC01378	117586980	117587050	0	71	0	5792	0	5721	0.0	0.0
chr4	LINC01091	123708573	123708677	0	105	13800	11515	13800	11410	0.0	1.2094653812445224
chr4	LINC01091	123825993	123826173	438	181	13800	11515	13362	11334	2.4198895027624308	1.1789306511381683
chr4	LINC01091	123854034	123854107	280	74	13800	11515	13520	11441	3.7837837837837838	1.1817148850624946
chr4	LINC01091	123910393	123910504	161	112	13800	11515	13639	11403	1.4375	1.1960887485749365
chr4	ABHD18	127989720	127989821	0	102	0	6723	0	6621	0.0	0.0
chr4	ABHD18	128001715	128001760	0	46	0	6723	0	6677	0.0	0.0
chr4	LINC02465	129865077	129865109	0	33	12658	6408	12658	6375	0.0	1.9855686274509803
chr4	LINC02465	129900537	129900654	7	118	12658	6408	12651	6290	0.059322033898305086	2.011287758346582
chr4	LINC02465	129812001	129812065	0	65	12658	6408	12658	6343	0.0	1.9955856850070945
chr4	LINC02465	129825339	129825452	0	114	12658	6408	12658	6294	0.0	2.011121703209406
chr4	LINC02465	129812661	129812760	0	100	12658	6408	12658	6308	0.0	2.0066582117945466
chr4	LINC02465	129813673	129813785	0	113	12658	6408	12658	6295	0.0	2.0108022239872914
chr4	LINC02465	129788911	129789224	9448	314	12658	6408	3210	6094	30.089171974522294	0.5267476206104365
chr4	LINC02465	129802991	129803115	0	125	12658	6408	12658	6283	0.0	2.0146426866146747
chr4	LINC02462	134424642	134424731	0	90	0	1601	0	1511	0.0	0.0
chr4	LINC02462	134455293	134455524	0	232	0	1601	0	1369	0.0	0.0
chr4	LINC00499	138349717	138349850	0	134	50	20150	50	20016	0.0	0.002498001598721023
chr4	LINC00499	138521555	138521698	0	144	50	20150	50	20006	0.0	0.0024992502249325203
chr4	LINC00499	138361295	138361402	0	108	50	20150	50	20042	0.0	0.0024947610018960184
chr4	LINC00499	138502011	138502121	0	111	50	20150	50	20039	0.0	0.00249513448774889
chr4	AC093766.1	138795058	138795214	0	157	51	2903	51	2746	0.0	0.018572469045884922
chr4	AC093766.1	138800063	138800107	0	45	51	2903	51	2858	0.0	0.017844646606018196
chr4	AC093766.1	138795061	138795214	0	154	51	2903	51	2749	0.0	0.018552200800291015
chr4	MGST2	139678542	139678642	0	101	0	3181	0	3080	0.0	0.0
chr4	MGST2	139695196	139695267	0	72	0	3181	0	3109	0.0	0.0
chr4	IL15	141656185	141656307	0	123	0	7886	0	7763	0.0	0.0
chr4	IL15	141688821	141689035	0	215	0	7886	0	7671	0.0	0.0
chr4	AC107223.1	143967087	143967179	0	93	2211	15940	2211	15847	0.0	0.13952167602700827
chr4	AC107223.1	143973109	143973251	0	143	2211	15940	2211	15797	0.0	0.13996328416787998
chr4	DCLK2	150253473	150253556	0	84	0	4436	0	4352	0.0	0.0
chr4	DCLK2	150254425	150254438	0	14	0	4436	0	4422	0.0	0.0
chr4	FAM160A1	151454700	151454808	0	109	0	5292	0	5183	0.0	0.0
chr4	FAM160A1	151482523	151482648	0	126	0	5292	0	5166	0.0	0.0
chr4	TRIM2	153281464	153281565	0	102	1268	14876	1268	14774	0.0	0.08582645187491539
chr4	TRIM2	153291731	153291816	0	86	1268	14876	1268	14790	0.0	0.08573360378634212
chr4	TRIM2	153290813	153290906	0	94	1268	14876	1268	14782	0.0	0.08578000270599377
chr4	TRIM2	153290651	153290769	0	119	1268	14876	1268	14757	0.0	0.08592532357525243
chr4	TRIM2	153222242	153223039	0	798	1268	14876	1268	14078	0.0	0.0900696121608183
chr4	TRIM2	153237869	153237957	0	89	1268	14876	1268	14787	0.0	0.08575099749780213
chr4	TRIM2	153222242	153222759	0	518	1268	14876	1268	14358	0.0	0.08831313553419697
chr4	AC013477.1	153397218	153397333	0	116	102	5906	102	5790	0.0	0.017616580310880828
chr4	AC013477.1	153408970	153409015	0	46	102	5906	102	5860	0.0	0.0174061433447099
chr4	AC097467.3	155351026	155351207	0	182	48	5378	48	5196	0.0	0.009237875288683603
chr4	AC097467.3	155352291	155352354	0	64	48	5378	48	5314	0.0	0.009032743695897629
chr4	AC097467.3	155309003	155309076	0	74	48	5378	48	5304	0.0	0.00904977375565611
chr4	AC097467.3	155339780	155339873	0	94	48	5378	48	5284	0.0	0.009084027252081756
chr4	AC097467.3	155329733	155329953	0	221	48	5378	48	5157	0.0	0.009307737056428156
chr4	AC097467.3	155341421	155341540	48	120	48	5378	0	5258	0.4	0.0
chr4	AC097467.3	155349380	155349457	0	78	48	5378	48	5300	0.0	0.009056603773584906
chr4	AC097467.3	155361200	155361322	0	123	48	5378	48	5255	0.0	0.009134157944814463
chr4	AC097467.3	155362263	155362304	0	42	48	5378	48	5336	0.0	0.008995502248875561
chr4	GRIA2	157361009	157361124	0	116	0	8804	0	8688	0.0	0.0
chr4	GRIA2	157361537	157361652	0	116	0	8804	0	8688	0.0	0.0
chr4	FAM198B-AS1	158172251	158172416	0	166	0	5647	0	5481	0.0	0.0
chr4	FAM198B-AS1	158176911	158177046	0	136	0	5647	0	5511	0.0	0.0
chr4	KLHL2	165228806	165228913	0	108	0	3948	0	3840	0.0	0.0
chr4	KLHL2	165238777	165238899	0	123	0	3948	0	3825	0.0	0.0
chr4	LINC01612	170278363	170278468	0	106	0	2193	0	2087	0.0	0.0
chr4	LINC01612	170278943	170279103	0	161	0	2193	0	2032	0.0	0.0
chr4	GALNT7	173297794	173297977	0	184	0	6763	0	6579	0.0	0.0
chr4	GALNT7	173298114	173298297	0	184	0	6763	0	6579	0.0	0.0
chr4	HAND2-AS1	173536847	173536970	0	124	0	14033	0	13909	0.0	0.0
chr4	HAND2-AS1	173559096	173559201	0	106	0	14033	0	13927	0.0	0.0
chr4	HAND2-AS1	173530966	173531078	0	113	0	14033	0	13920	0.0	0.0
chr4	LINC02269	173735369	173735543	0	175	0	3896	0	3721	0.0	0.0
chr4	LINC02269	173856283	173856466	0	184	0	3896	0	3712	0.0	0.0
chr4	LINC02269	173878215	173878280	0	66	0	3896	0	3830	0.0	0.0
chr4	LINC02269	173925877	173925957	0	81	0	3896	0	3815	0.0	0.0
chr4	LINC02269	173928489	173928644	0	156	0	3896	0	3740	0.0	0.0
chr4	LINC02269	173928494	173928617	0	124	0	3896	0	3772	0.0	0.0
chr4	LINC02269	173906696	173906768	0	73	0	3896	0	3823	0.0	0.0
chr4	LINC02269	173928489	173928617	0	129	0	3896	0	3767	0.0	0.0
chr4	LINC02269	173928494	173928644	0	151	0	3896	0	3745	0.0	0.0
chr4	CEP44	174285433	174285574	170	142	3707	6686	3537	6544	1.1971830985915493	0.5404951100244498
chr4	CEP44	174297965	174298062	102	98	3707	6686	3605	6588	1.0408163265306123	0.5472070431086824
chr4	LINC02436	185053104	185053188	0	85	0	7067	0	6982	0.0	0.0
chr4	LINC02436	185054978	185055341	0	364	0	7067	0	6703	0.0	0.0
chr4	LINC02436	185054978	185055237	0	260	0	7067	0	6807	0.0	0.0
chr4	LINC02436	185069960	185070049	0	90	0	7067	0	6977	0.0	0.0
chr4	LINC02436	185062456	185062816	0	361	0	7067	0	6706	0.0	0.0
chr4	LINC02436	185069929	185070030	0	102	0	7067	0	6965	0.0	0.0
chr4	LINC02436	185063247	185063334	0	88	0	7067	0	6979	0.0	0.0
chr4	LINC02436	185064445	185064564	0	120	0	7067	0	6947	0.0	0.0
chr4	LINC02436	185069929	185070049	0	121	0	7067	0	6946	0.0	0.0
chr4	LINC02436	185069960	185070030	0	71	0	7067	0	6996	0.0	0.0
chr4	LINC02436	185062456	185062591	0	136	0	7067	0	6931	0.0	0.0
chr4	AC097521.1	187621676	187621910	0	235	1468	6484	1468	6249	0.0	0.23491758681389022
chr4	AC097521.1	187622641	187622740	0	100	1468	6484	1468	6384	0.0	0.2299498746867168
chr5	SDHA	250991	251043	108	53	1269287	7050	1269179	6997	2.0377358490566038	181.38902386737172
chr5	SDHA	254392	254506	837	115	1269287	7050	1268450	6935	7.278260869565218	182.90555155010816
chr5	SDHA	254357	254506	837	150	1269287	7050	1268450	6900	5.58	183.83333333333334
chr5	PDCD6	304176	304221	0	46	1015817	9301	1015817	9255	0.0	109.75872501350621
chr5	PDCD6	311292	311402	2852	111	1015817	9301	1012965	9190	25.693693693693692	110.22470076169749
chr5	LINC01020	5051207	5051256	0	50	0	4734	0	4684	0.0	0.0
chr5	LINC01020	5059563	5059681	0	119	0	4734	0	4615	0.0	0.0
chr5	CCT5	10254144	10254205	1064	62	3041094	5425	3040030	5363	17.161290322580644	566.852507924669
chr5	CCT5	10254795	10254838	187658	44	3041094	5425	2853436	5381	4264.954545454545	530.2798736294369
chr5	LINC02217	17404557	17404729	0	173	0	8721	0	8548	0.0	0.0
chr5	LINC02217	17437189	17437213	0	25	0	8721	0	8696	0.0	0.0
chr5	LINC02223	17873019	17873086	0	68	88	7967	88	7899	0.0	0.011140650715280415
chr5	LINC02223	17920226	17920309	0	84	88	7967	88	7883	0.0	0.011163262717239629
chr5	LINC02241	20736954	20737101	0	148	518	9146	518	8998	0.0	0.057568348521893756
chr5	LINC02241	20807852	20807913	0	62	518	9146	518	9084	0.0	0.05702333773667988
chr5	LINC02241	20814328	20814398	0	71	518	9146	518	9075	0.0	0.05707988980716253
chr5	LINC02241	20895482	20895567	0	86	518	9146	518	9060	0.0	0.05717439293598234
chr5	LINC02241	20838436	20838487	0	52	518	9146	518	9094	0.0	0.05696063338464922
chr5	LINC02241	20852057	20852103	0	47	518	9146	518	9099	0.0	0.05692933289372459
chr5	LINC02241	20838433	20838487	0	55	518	9146	518	9091	0.0	0.05697943020569794
chr5	LINC02241	20705720	20705817	0	98	518	9146	518	9048	0.0	0.057250221043324494
chr5	LINC02241	20749523	20749607	0	85	518	9146	518	9061	0.0	0.057168082993047126
chr5	LINC02241	20736954	20737145	0	192	518	9146	518	8954	0.0	0.05785123966942149
chr5	LINC02241	20670566	20670611	0	46	518	9146	518	9100	0.0	0.05692307692307692
chr5	LINC02241	20699728	20699855	0	128	518	9146	518	9018	0.0	0.057440674207141273
chr5	LINC02241	20807852	20807865	0	14	518	9146	518	9132	0.0	0.056723609286027155
chr5	PURPL	27484925	27485029	0	105	102	4915	102	4810	0.0	0.021205821205821207
chr5	PURPL	27494234	27494335	0	102	102	4915	102	4813	0.0	0.021192603365884063
chr5	PURPL	27476086	27476158	0	73	102	4915	102	4842	0.0	0.021065675340768277
chr5	PURPL	27489281	27489386	0	106	102	4915	102	4809	0.0	0.021210230817217717
chr5	PURPL	27477638	27477801	0	164	102	4915	102	4751	0.0	0.02146916438644496
chr5	PURPL	27476068	27476158	0	91	102	4915	102	4824	0.0	0.021144278606965175
chr5	PURPL	27494118	27494335	0	218	102	4915	102	4697	0.0	0.021715988929103685
chr5	PURPL	27493569	27494335	0	767	102	4915	102	4148	0.0	0.02459016393442623
chr5	PURPL	27493569	27493687	0	119	102	4915	102	4796	0.0	0.021267723102585488
chr5	RAI14	34658995	34659072	211	78	323911	7612	323700	7534	2.7051282051282053	42.96522431643218
chr5	RAI14	34667262	34667379	0	118	323911	7612	323911	7494	0.0	43.22271150253536
chr5	RAI14	34688067	34688248	1029	182	323911	7612	322882	7430	5.653846153846154	43.45652759084791
chr5	RAI14	34716054	34716221	0	168	323911	7612	323911	7444	0.0	43.51303062869425
chr5	GHR	42629037	42629103	0	67	6967	6970	6967	6903	0.0	1.0092713313052295
chr5	GHR	42688889	42689019	30	131	6967	6970	6937	6839	0.22900763358778625	1.0143295803480041
chr5	AC025171.3	43019235	43019316	192	82	7929	1782	7737	1700	2.341463414634146	4.551176470588235
chr5	AC025171.3	43023918	43024109	126	192	7929	1782	7803	1590	0.65625	4.907547169811321
chr5	AC025171.3	43023918	43024097	126	180	7929	1782	7803	1602	0.7	4.870786516853933
chr5	ZNF131	43139164	43139309	8377	146	325812	8233	317435	8087	57.37671232876713	39.2525040187956
chr5	ZNF131	43161248	43161931	57855	684	325812	8233	267957	7549	84.58333333333333	35.49569479401245
chr5	NNT	43609142	43609346	18150	205	578620	10606	560470	10401	88.53658536585365	53.88616479184694
chr5	NNT	43612907	43613137	38801	231	578620	10606	539819	10375	167.96969696969697	52.03074698795181
chr5	PARP8	50668070	50668125	0	56	0	10081	0	10025	0.0	0.0
chr5	PARP8	50750150	50750188	0	39	0	10081	0	10042	0.0	0.0
chr5	LINC01033	54340192	54340309	0	118	41	3578	41	3460	0.0	0.011849710982658959
chr5	LINC01033	54396996	54397134	0	139	41	3578	41	3439	0.0	0.0119220703692934
chr5	LINC01033	54395348	54395417	0	70	41	3578	41	3508	0.0	0.011687571265678449
chr5	LINC01033	54401642	54403788	0	2147	41	3578	41	1431	0.0	0.0286512928022362
chr5	GPX8	55160329	55160396	603	68	13126	3883	12523	3815	8.867647058823529	3.2825688073394494
chr5	GPX8	55160993	55161255	0	263	13126	3883	13126	3620	0.0	3.6259668508287293
chr5	GPX8	55161119	55161255	0	137	13126	3883	13126	3746	0.0	3.5040042712226374
chr5	DDX4	55767880	55767940	0	61	0	3844	0	3783	0.0	0.0
chr5	DDX4	55779963	55780065	0	103	0	3844	0	3741	0.0	0.0
chr5	GAPT	58493618	58493683	0	66	0	3273	0	3207	0.0	0.0
chr5	GAPT	58493710	58493838	0	129	0	3273	0	3144	0.0	0.0
chr5	PART1	60533931	60534019	0	89	51	12711	51	12622	0.0	0.004040564094438283
chr5	PART1	60542649	60542830	0	182	51	12711	51	12529	0.0	0.004070556309362279
chr5	C5ORF64	61750336	61750544	0	209	51271	22226	51271	22017	0.0	2.3287005495753283
chr5	C5ORF64	61751669	61751770	0	102	51271	22226	51271	22124	0.0	2.317438076297234
chr5	C5ORF64	61643326	61643400	0	75	51271	22226	51271	22151	0.0	2.31461333574105
chr5	C5ORF64	61686882	61687070	3141	189	51271	22226	48130	22037	16.61904761904762	2.1840540908472117
chr5	IPO11	62578703	62578935	0	233	102	7579	102	7346	0.0	0.013885107541519195
chr5	IPO11	62579400	62579483	0	84	102	7579	102	7495	0.0	0.013609072715143429
chr5	ERBIN	66068876	66069020	0	145	153	10160	153	10015	0.0	0.01527708437343984
chr5	ERBIN	66072168	66072291	0	124	153	10160	153	10036	0.0	0.015245117576723794
chr5	MAST4	66902648	66902736	0	89	153	14654	153	14565	0.0	0.010504634397528322
chr5	MAST4	66916982	66917018	0	37	153	14654	153	14617	0.0	0.010467264144489292
chr5	AC112206.2	67620145	67620289	51	145	140	5824	89	5679	0.35172413793103446	0.015671773199506956
chr5	AC112206.2	67763974	67764093	0	120	140	5824	140	5704	0.0	0.024544179523141654
chr5	AC112206.2	67801625	67801698	0	74	140	5824	140	5750	0.0	0.02434782608695652
chr5	AC112206.2	67804279	67804325	0	47	140	5824	140	5777	0.0	0.024234031504240954
chr5	CENPH	69195716	69195791	28	76	2657	2227	2629	2151	0.3684210526315789	1.2222222222222223
chr5	CENPH	69197052	69197109	0	58	2657	2227	2657	2169	0.0	1.2249884739511296
chr5	CDK7	69252417	69252451	0	35	3451	2383	3451	2348	0.0	1.4697614991482113
chr5	CDK7	69254601	69254669	0	69	3451	2383	3451	2314	0.0	1.4913569576490924
chr5	CDK7	69258042	69258153	7	112	3451	2383	3444	2271	0.0625	1.5165125495376486
chr5	CDK7	69259817	69259936	0	120	3451	2383	3451	2263	0.0	1.5249668581528943
chr5	RAD17	69371453	69371557	2357	105	22970	4169	20613	4064	22.447619047619046	5.072096456692913
chr5	RAD17	69372033	69372217	4794	185	22970	4169	18176	3984	25.913513513513514	4.562248995983936
chr5	RAD17	69371034	69371171	286	138	22970	4169	22684	4031	2.072463768115942	5.627387744976432
chr5	RAD17	69373829	69374087	3160	259	22970	4169	19810	3910	12.200772200772201	5.0664961636828645
chr5	SMN2	70071281	70071390	0	110	4803	2998	4803	2888	0.0	1.6630886426592797
chr5	SMN2	70076520	70076574	0	55	4803	2998	4803	2943	0.0	1.6320081549439347
chr5	SMN1	70946706	70946815	51	110	555953	3108	555902	2998	0.4636363636363636	185.4242828552368
chr5	SMN1	70951940	70951994	0	55	555953	3108	555953	3053	0.0	182.1005568293482
chr5	MCCC2	71636103	71636167	483	65	45742	5197	45259	5132	7.430769230769231	8.818978955572875
chr5	MCCC2	71641002	71641075	60	74	45742	5197	45682	5123	0.8108108108108109	8.917040796408354
chr5	PTCD2	72326611	72326741	0	131	23015	11876	23015	11745	0.0	1.9595572584078331
chr5	PTCD2	72331257	72331375	0	119	23015	11876	23015	11757	0.0	1.9575571999659778
chr5	PTCD2	72335017	72335096	0	80	23015	11876	23015	11796	0.0	1.9510851135978298
chr5	BTF3	73499133	73499202	0	70	0	5245	0	5175	0.0	0.0
chr5	BTF3	73502487	73502601	0	115	0	5245	0	5130	0.0	0.0
chr5	LINC01333	74325811	74325937	0	127	510	3595	510	3468	0.0	0.14705882352941177
chr5	LINC01333	74338971	74339125	0	155	510	3595	510	3440	0.0	0.14825581395348839
chr5	POLK	75590343	75590440	0	98	113487	8391	113487	8293	0.0	13.684673821295068
chr5	POLK	75593877	75594049	0	173	113487	8391	113487	8218	0.0	13.809564370893161
chr5	ZBED3-AS1	77088440	77088472	0	33	51	16340	51	16307	0.0	0.0031274912614214757
chr5	ZBED3-AS1	77089345	77089403	0	59	51	16340	51	16281	0.0	0.0031324857195503962
chr5	ZBED3-AS1	77098654	77098747	0	94	51	16340	51	16246	0.0	0.003139234273051828
chr5	ZBED3-AS1	77105655	77105689	0	35	51	16340	51	16305	0.0	0.0031278748850045997
chr5	ZBED3-AS1	77092491	77092533	0	43	51	16340	51	16297	0.0	0.00312941032091796
chr5	ZBED3-AS1	77100235	77100391	0	157	51	16340	51	16183	0.0	0.0031514552307977508
chr5	ZBED3-AS1	77100325	77100391	0	67	51	16340	51	16273	0.0	0.003134025686720334
chr5	ZBED3-AS1	77098654	77098669	0	16	51	16340	51	16324	0.0	0.003124234256309728
chr5	SCAMP1	78421800	78421960	0	161	1845	6758	1845	6597	0.0	0.27967257844474763
chr5	SCAMP1	78449932	78450034	0	103	1845	6758	1845	6655	0.0	0.2772351615326822
chr5	ZFYVE16	80411645	80411773	0	129	550	13810	550	13681	0.0	0.04020173963891528
chr5	ZFYVE16	80427491	80427545	0	55	550	13810	550	13755	0.0	0.039985459832788076
chr5	MSH3	80830636	80830740	0	105	1568	5357	1568	5252	0.0	0.2985529322162985
chr5	MSH3	80848447	80848612	0	166	1568	5357	1568	5191	0.0	0.30206125987285687
chr5	ZCCHC9	81304740	81305141	0	402	0	5131	0	4729	0.0	0.0
chr5	ZCCHC9	81308560	81308711	0	152	0	5131	0	4979	0.0	0.0
chr5	ATG10	81973154	81973301	0	148	255	5459	255	5311	0.0	0.04801355676897006
chr5	ATG10	81976192	81976327	0	136	255	5459	255	5323	0.0	0.04790531655081721
chr5	VCAN	83519348	83522309	0	2962	0	13298	0	10336	0.0	0.0
chr5	VCAN	83537006	83542268	0	5263	0	13298	0	8035	0.0	0.0
chr5	RASA1	87269160	87269287	0	128	51	5265	51	5137	0.0	0.009927973525403932
chr5	RASA1	87330937	87330983	0	47	51	5265	51	5218	0.0	0.009773859716366424
chr5	TMEM161B-AS1	88285743	88285851	0	109	613	27299	613	27190	0.0	0.02254505332842957
chr5	TMEM161B-AS1	88287435	88287622	0	188	613	27299	613	27111	0.0	0.022610748404706577
chr5	TMEM161B-AS1	88282714	88282866	0	153	613	27299	613	27146	0.0	0.022581595815221397
chr5	TMEM161B-AS1	88282041	88282106	0	66	613	27299	613	27233	0.0	0.022509455440091065
chr5	TMEM161B-AS1	88287438	88287622	0	185	613	27299	613	27114	0.0	0.02260824666224091
chr5	TMEM161B-AS1	88283009	88283086	0	78	613	27299	613	27221	0.0	0.022519378421071965
chr5	MEF2C-AS1	88892166	88892277	0	112	0	7887	0	7775	0.0	0.0
chr5	MEF2C-AS1	88903937	88904203	0	267	0	7887	0	7620	0.0	0.0
chr5	PAM	103025130	103025334	0	205	2306	8786	2306	8581	0.0	0.26873324787320824
chr5	PAM	103028184	103028238	0	55	2306	8786	2306	8731	0.0	0.26411636696827395
chr5	PAM	103028181	103028238	0	58	2306	8786	2306	8728	0.0	0.2642071494042163
chr5	SRP19	112864620	112864732	306	113	19221	10412	18915	10299	2.7079646017699117	1.8365860763180892
chr5	SRP19	112881956	112882049	0	94	19221	10412	19221	10318	0.0	1.8628610195774375
chr5	SRP19	112862507	112862583	0	77	19221	10412	19221	10335	0.0	1.8597968069666182
chr5	SRP19	112864456	112864528	0	73	19221	10412	19221	10339	0.0	1.85907728020118
chr5	AC008549.1	115739359	115739507	0	149	0	1583	0	1434	0.0	0.0
chr5	AC008549.1	115746703	115746827	0	125	0	1583	0	1458	0.0	0.0
chr5	HSD17B4	119464613	119464693	0	81	0	10487	0	10406	0.0	0.0
chr5	HSD17B4	119471635	119471700	0	66	0	10487	0	10421	0.0	0.0
chr5	HSD17B4	119472457	119472576	0	120	0	10487	0	10367	0.0	0.0
chr5	HSD17B4	119477797	119477894	0	98	0	10487	0	10389	0.0	0.0
chr5	HSD17B4	119478093	119478141	0	49	0	10487	0	10438	0.0	0.0
chr5	SNCAIP	122336787	122336904	769	118	3883	7286	3114	7168	6.516949152542373	0.43443080357142855
chr5	SNCAIP	122388566	122389870	0	1305	3883	7286	3883	5981	0.0	0.6492225380371175
chr5	SNCAIP	122422867	122423739	2655	873	3883	7286	1228	6413	3.0412371134020617	0.19148604397317948
chr5	SNCAIP	122425351	122425531	0	181	3883	7286	3883	7105	0.0	0.5465165376495426
chr5	SNX24	122853673	122853767	0	95	97	3491	97	3396	0.0	0.02856301531213192
chr5	SNX24	122891026	122891125	0	100	97	3491	97	3391	0.0	0.028605131229725744
chr5	LINC02039	126180595	126180731	0	137	273	727	273	590	0.0	0.46271186440677964
chr5	LINC02039	126191143	126191218	273	76	273	727	0	651	3.5921052631578947	0.0
chr5	GRAMD2B	126466293	126466336	0	44	306	4832	306	4788	0.0	0.06390977443609022
chr5	GRAMD2B	126469676	126469788	0	113	306	4832	306	4719	0.0	0.06484424666242848
chr5	AC116366.2	132486191	132486660	204	470	321	8990	117	8520	0.4340425531914894	0.013732394366197184
chr5	AC116366.2	132556331	132556473	0	143	321	8990	321	8847	0.0	0.03628348592743303
chr5	RAD50	132594868	132595044	0	177	51	9711	51	9534	0.0	0.005349276274386407
chr5	RAD50	132595103	132595201	0	99	51	9711	51	9612	0.0	0.005305867665418227
chr5	RAD50	132592763	132592965	0	203	51	9711	51	9508	0.0	0.005363904080774085
chr5	RAD50	132594561	132594677	0	117	51	9711	51	9594	0.0	0.005315822388993121
chr5	RAD50	132591223	132591406	0	184	51	9711	51	9527	0.0	0.005353206675763619
chr5	RAD50	132591876	132592034	0	159	51	9711	51	9552	0.0	0.005339195979899497
chr5	IL13	132657065	132657244	0	180	51	2890	51	2710	0.0	0.018819188191881917
chr5	IL13	132658289	132658360	0	72	51	2890	51	2818	0.0	0.01809794180269695
chr5	TCF7	134144796	134144869	1213	74	64848	7296	63635	7222	16.39189189189189	8.811271116034339
chr5	TCF7	134145259	134145340	0	82	64848	7296	64848	7214	0.0	8.989187690601607
chr5	JADE2	134573644	134573762	0	119	0	9892	0	9773	0.0	0.0
chr5	JADE2	134576767	134576896	0	130	0	9892	0	9762	0.0	0.0
chr5	AC114296.1	135824897	135825137	0	241	0	2718	0	2477	0.0	0.0
chr5	AC114296.1	135825724	135825995	0	272	0	2718	0	2446	0.0	0.0
chr5	MATR3	139279934	139280058	0	125	255	12741	255	12616	0.0	0.020212428662016488
chr5	MATR3	139293452	139293575	0	124	255	12741	255	12617	0.0	0.020210826662439566
chr5	MATR3	139279050	139279129	0	80	255	12741	255	12661	0.0	0.0201405892109628
chr5	MATR3	139283530	139283601	0	72	255	12741	255	12669	0.0	0.020127871181624436
chr5	MATR3	139314674	139314736	0	63	255	12741	255	12678	0.0	0.020113582584003788
chr5	MATR3	139315696	139315738	0	43	255	12741	255	12698	0.0	0.02008190266183651
chr5	PAIP2	139363758	139363922	0	165	51	3154	51	2989	0.0	0.01706256273001004
chr5	PAIP2	139364563	139364743	0	181	51	3154	51	2973	0.0	0.017154389505549948
chr5	CXXC5	139665579	139665803	0	225	693	3537	693	3312	0.0	0.20923913043478262
chr5	CXXC5	139679846	139679940	0	95	693	3537	693	3442	0.0	0.20133643230679837
chr5	HARS2	140691606	140691756	0	151	448186	3423	448186	3272	0.0	136.97616136919316
chr5	HARS2	140691791	140692017	0	227	448186	3423	448186	3196	0.0	140.23341677096371
chr5	HARS2	140691794	140691937	0	144	448186	3423	448186	3279	0.0	136.68374504422079
chr5	HARS2	140691794	140692017	0	224	448186	3423	448186	3199	0.0	140.10190684588935
chr5	HARS2	140693490	140693508	0	19	448186	3423	448186	3404	0.0	131.66451233842537
chr5	LINC01844	142718115	142718266	0	152	2193	3613	2193	3461	0.0	0.6336318982952904
chr5	LINC01844	142745207	142745718	510	512	2193	3613	1683	3101	0.99609375	0.5427281522089649
chr5	LINC01844	142746477	142746585	0	109	2193	3613	2193	3504	0.0	0.6258561643835616
chr5	LINC01844	142753100	142753227	0	128	2193	3613	2193	3485	0.0	0.6292682926829268
chr5	LINC01844	142756507	142756632	0	126	2193	3613	2193	3487	0.0	0.6289073702322914
chr5	ARHGAP26	143207197	143207308	0	112	2330	17199	2330	17087	0.0	0.13636097618072218
chr5	ARHGAP26	143207382	143207473	0	92	2330	17199	2330	17107	0.0	0.136201554919039
chr5	CARMN	149415520	149415917	255	398	691350	14357	691095	13959	0.6407035175879398	49.508918977004086
chr5	CARMN	149420480	149421068	430	589	691350	14357	690920	13768	0.7300509337860781	50.18303312027891
chr5	CARMN	149420480	149420544	204	65	691350	14357	691146	14292	3.1384615384615384	48.358942065491185
chr5	CARMN	149423185	149423309	51	125	691350	14357	691299	14232	0.408	48.57356661045531
chr5	CARMN	149423433	149423639	0	207	691350	14357	691350	14150	0.0	48.85865724381625
chr5	G3BP1	151792044	151792201	0	158	0	10115	0	9957	0.0	0.0
chr5	G3BP1	151794158	151794249	0	92	0	10115	0	10023	0.0	0.0
chr5	G3BP1	151772534	151772567	0	34	0	10115	0	10081	0.0	0.0
chr5	G3BP1	151772656	151772668	0	13	0	10115	0	10102	0.0	0.0
chr5	G3BP1	151777614	151777734	0	121	0	10115	0	9994	0.0	0.0
chr5	G3BP1	151774604	151774709	0	106	0	10115	0	10009	0.0	0.0
chr5	G3BP1	151794202	151794249	0	48	0	10115	0	10067	0.0	0.0
chr5	GRIA1	153794620	153794735	1294	116	21411	7564	20117	7448	11.155172413793103	2.7009935553168636
chr5	GRIA1	153795475	153795590	6897	116	21411	7564	14514	7448	59.456896551724135	1.9487110633727176
chr5	MFAP3	154121717	154121897	0	181	14507	7808	14507	7627	0.0	1.9020584764651896
chr5	MFAP3	154134844	154134916	0	73	14507	7808	14507	7735	0.0	1.8755009696186167
chr5	CNOT8	154865191	154865385	0	195	38	3723	38	3528	0.0	0.010770975056689343
chr5	CNOT8	154870660	154870822	0	163	38	3723	38	3560	0.0	0.010674157303370787
chr5	CNOT8	154859352	154859496	0	145	38	3723	38	3578	0.0	0.010620458356623811
chr5	CNOT8	154859694	154859873	0	180	38	3723	38	3543	0.0	0.010725373976855771
chr5	MAT2B	163512001	163512196	0	196	0	3962	0	3766	0.0	0.0
chr5	MAT2B	163513554	163513669	0	116	0	3962	0	3846	0.0	0.0
chr5	AC109466.1	164910706	164910758	0	53	153	9904	153	9851	0.0	0.015531418130139071
chr5	AC109466.1	164920134	164920195	0	62	153	9904	153	9842	0.0	0.015545620808778703
chr5	AC109466.1	164354140	164354224	0	85	153	9904	153	9819	0.0	0.015582034830430797
chr5	AC109466.1	164486673	164486741	0	69	153	9904	153	9835	0.0	0.015556685307574987
chr5	SPDL1	169584087	169584166	0	80	8623	4769	8623	4689	0.0	1.838984858178716
chr5	SPDL1	169587198	169587372	0	175	8623	4769	8623	4594	0.0	1.8770134958641707
chr5	SPDL1	169587260	169587372	0	113	8623	4769	8623	4656	0.0	1.8520189003436427
chr5	KCNIP1	170669498	170669660	0	163	32	3382	32	3219	0.0	0.009940975458216837
chr5	KCNIP1	170712853	170712886	0	34	32	3382	32	3348	0.0	0.009557945041816009
chr5	NEURL1B	172669784	172670330	0	547	0	6432	0	5885	0.0	0.0
chr5	NEURL1B	172683418	172684138	0	721	0	6432	0	5711	0.0	0.0
chr5	ATP6V0E1	172994774	172994822	0	49	614774	1613	614774	1564	0.0	393.0780051150895
chr5	ATP6V0E1	173020237	173020367	0	131	614774	1613	614774	1482	0.0	414.8272604588394
chr5	AC016573.1	173431676	173431720	0	45	3392	1709	3392	1664	0.0	2.0384615384615383
chr5	AC016573.1	173439427	173439530	0	104	3392	1709	3392	1605	0.0	2.1133956386292834
chr5	AC016573.1	173385043	173385148	2312	106	3392	1709	1080	1603	21.81132075471698	0.6737367436057392
chr5	AC016573.1	173424713	173424904	0	192	3392	1709	3392	1517	0.0	2.2359920896506265
chr5	CPEB4	173932449	173932500	0	52	0	10457	0	10405	0.0	0.0
chr5	CPEB4	173943025	173943049	0	25	0	10457	0	10432	0.0	0.0
chr5	ZNF346	177041777	177041870	306	94	67992	6647	67686	6553	3.25531914893617	10.32900961391729
chr5	ZNF346	177044391	177044533	0	143	67992	6647	67992	6504	0.0	10.453874538745387
chr5	FAM153CP	178020259	178020453	0	195	87124	18718	87124	18523	0.0	4.703557739027155
chr5	FAM153CP	178032742	178032886	561	145	87124	18718	86563	18573	3.8689655172413793	4.660690249286599
chr5	FAM153CP	178054737	178054807	0	71	87124	18718	87124	18647	0.0	4.6722797232798845
chr5	FAM153CP	178057648	178057818	0	171	87124	18718	87124	18547	0.0	4.697471289157276
chr5	RMND5B	178133451	178133569	357	119	14189	6205	13832	6086	3.0	2.2727571475517583
chr5	RMND5B	178135172	178135312	0	141	14189	6205	14189	6064	0.0	2.3398746701846966
chr5	RMND5B	178136028	178136248	0	221	14189	6205	14189	5984	0.0	2.3711564171122994
chr5	ZFP2	178913877	178913999	0	123	0	2644	0	2521	0.0	0.0
chr5	ZFP2	178916564	178916710	0	147	0	2644	0	2497	0.0	0.0
chr5	CANX	179699574	179699770	495	197	108795	6294	108300	6097	2.512690355329949	17.76283418074463
chr5	CANX	179704154	179704430	34	277	108795	6294	108761	6017	0.12274368231046931	18.075619079275388
chr5	CANX	179705678	179705852	102	175	108795	6294	108693	6119	0.5828571428571429	17.76319660075176
chr5	CANX	179707131	179707190	266	60	108795	6294	108529	6234	4.433333333333334	17.40920757138274
chr5	LINC00847	180831758	180831941	0	184	213	5657	213	5473	0.0	0.0389183263292527
chr5	LINC00847	180832672	180832860	60	189	213	5657	153	5468	0.31746031746031744	0.027980980248719825
chr5	LINC00847	180831735	180831806	0	72	213	5657	213	5585	0.0	0.038137869292748434
chr5	LINC00847	180831735	180831941	0	207	213	5657	213	5450	0.0	0.03908256880733945
chr5	LINC00847	180831758	180831806	0	49	213	5657	213	5608	0.0	0.03798145506419401
chr5	BTNL8	180902345	180902396	55	52	2178	3933	2123	3881	1.0576923076923077	0.5470239628961607
chr5	BTNL8	180908585	180908933	0	349	2178	3933	2178	3584	0.0	0.6077008928571429
chr5	TRIM41	181234931	181234995	0	65	0	9683	0	9618	0.0	0.0
chr5	TRIM41	181234995	181235079	0	85	0	9683	0	9598	0.0	0.0
chr5	ZDHHC11B	755965	756144	742	180	4955	5638	4213	5458	4.122222222222222	0.7718944668376695
chr5	ZDHHC11B	765842	765935	0	94	4955	5638	4955	5544	0.0	0.8937590187590188
chr5	ZDHHC11B	769954	770117	9	164	4955	5638	4946	5474	0.054878048780487805	0.9035440263061747
chr5	ZDHHC11B	783941	784124	0	184	4955	5638	4955	5454	0.0	0.9085075174184085
chr5	LINC02064	29363317	29363382	0	66	0	4274	0	4208	0.0	0.0
chr5	LINC02064	29381852	29381962	0	111	0	4274	0	4163	0.0	0.0
chr5	DROSHA	31515453	31515564	722	112	364450	7164	363728	7052	6.446428571428571	51.577992058990354
chr5	DROSHA	31521122	31521215	0	94	364450	7164	364450	7070	0.0	51.54879773691655
chr5	SLC45A2	33963690	33964016	0	327	0	3230	0	2903	0.0	0.0
chr5	SLC45A2	33982235	33982412	0	178	0	3230	0	3052	0.0	0.0
chr5	AC138409.2	34219916	34219950	0	35	17656	6582	17656	6547	0.0	2.6968076981823734
chr5	AC138409.2	34239374	34239448	0	75	17656	6582	17656	6507	0.0	2.7133855847548793
chr5	RAD1	34913469	34913578	3051	110	463767	6562	460716	6452	27.736363636363638	71.40669559826411
chr5	RAD1	34913926	34914026	3464	101	463767	6562	460303	6461	34.2970297029703	71.24330598978486
chr5	PRLR	35152786	35152973	0	188	9171	3630	9171	3442	0.0	2.6644392794886693
chr5	PRLR	35195550	35195713	62	164	9171	3630	9109	3466	0.3780487804878049	2.6281015579919216
chr5	CPLANE1	37243012	37243119	0	108	68705	20159	68705	20051	0.0	3.426512393396838
chr5	CPLANE1	37244374	37244607	3482	234	68705	20159	65223	19925	14.88034188034188	3.273425345043915
chr5	FYB1	39208863	39208964	0	102	0	7176	0	7074	0.0	0.0
chr5	FYB1	39211057	39211091	0	35	0	7176	0	7141	0.0	0.0
chr5	DAB2	39382617	39383271	80447	655	294632	7579	214185	6924	122.81984732824428	30.93370883882149
chr5	DAB2	39388304	39388367	0	64	294632	7579	294632	7515	0.0	39.20585495675316
chr5	DAB2	39418180	39418345	160	166	294632	7579	294472	7413	0.963855421686747	39.72372858491838
chr5	DAB2	39423703	39423897	0	195	294632	7579	294632	7384	0.0	39.901408450704224
chr5	TTC33	40728344	40728476	1912	133	127014	9717	125102	9584	14.37593984962406	13.05321368948247
chr5	TTC33	40730261	40730343	0	83	127014	9717	127014	9634	0.0	13.183931907826448
chr5	SELENOP	42804655	42804773	0	119	255	5511	255	5392	0.0	0.047292284866468845
chr5	SELENOP	42806895	42807108	0	214	255	5511	255	5297	0.0	0.04814045686237493
chr5	SELENOP	42809759	42809788	0	30	255	5511	255	5481	0.0	0.046524356869184456
chr5	SELENOP	42810690	42810778	0	89	255	5511	255	5422	0.0	0.04703061600885282
chr5	TMEM267	43453657	43454043	11309	387	57186	1523	45877	1136	29.22222222222222	40.38468309859155
chr5	TMEM267	43479889	43479987	1702	99	57186	1523	55484	1424	17.19191919191919	38.96348314606742
chr5	TMEM267	43454454	43454605	304	152	57186	1523	56882	1371	2.0	41.48942377826404
chr5	MOCS2	53101358	53101509	0	152	83	5555	83	5403	0.0	0.015361836017027578
chr5	MOCS2	53102096	53102224	32	129	83	5555	51	5426	0.24806201550387597	0.009399189089568744
chr5	ARL15	54171783	54171928	0	146	51	2967	51	2821	0.0	0.018078695498050336
chr5	ARL15	54307887	54307946	0	60	51	2967	51	2907	0.0	0.017543859649122806
chr5	PLPP1	55475298	55475450	0	153	0	1943	0	1790	0.0	0.0
chr5	PLPP1	55490959	55491114	0	156	0	1943	0	1787	0.0	0.0
chr5	SLC38A9	55672562	55672695	0	134	204	8550	204	8416	0.0	0.02423954372623574
chr5	SLC38A9	55697845	55697992	0	148	204	8550	204	8402	0.0	0.02427993334920257
chr5	SLC38A9	55711451	55711499	0	49	204	8550	204	8501	0.0	0.02399717680272909
chr5	SLC38A9	55702738	55702894	0	157	204	8550	204	8393	0.0	0.0243059692600977
chr5	SLC38A9	55704321	55704434	0	114	204	8550	204	8436	0.0	0.02418207681365576
chr5	MIER3	56950627	56950652	0	26	0	5712	0	5686	0.0	0.0
chr5	MIER3	56959385	56959520	0	136	0	5712	0	5576	0.0	0.0
chr5	DEPDC1B	60687724	60687838	101	115	1876	3820	1775	3705	0.8782608695652174	0.47908232118758437
chr5	DEPDC1B	60688984	60689050	0	67	1876	3820	1876	3753	0.0	0.4998667732480682
chr5	ERCC8	60909647	60909957	0	311	51	13538	51	13227	0.0	0.0038557496030845995
chr5	ERCC8	60915185	60915286	0	102	51	13538	51	13436	0.0	0.00379577255135457
chr5	FAM169A	74813839	74814019	70	181	1366	6891	1296	6710	0.3867403314917127	0.1931445603576751
chr5	FAM169A	74834425	74834597	0	173	1366	6891	1366	6718	0.0	0.20333432569217028
chr5	POC5	75705703	75705787	0	85	51	3430	51	3345	0.0	0.015246636771300448
chr5	POC5	75707736	75707875	0	140	51	3430	51	3290	0.0	0.015501519756838906
chr5	POC5	75712853	75712951	0	99	51	3430	51	3331	0.0	0.015310717502251577
chr5	WDR41	77449759	77449860	0	102	20263	5048	20263	4946	0.0	4.096845936109988
chr5	WDR41	77453816	77453928	0	113	20263	5048	20263	4935	0.0	4.105977710233029
chr5	DMGDH	79055809	79055904	0	96	208	5320	208	5224	0.0	0.039816232771822356
chr5	DMGDH	79063612	79063787	0	176	208	5320	208	5144	0.0	0.04043545878693624
chr5	SERINC5	80114513	80114651	0	139	2377	7714	2377	7575	0.0	0.3137953795379538
chr5	SERINC5	80116137	80116323	0	187	2377	7714	2377	7527	0.0	0.3157964660555334
chr5	DHFR	80633876	80633992	0	117	621	2626	621	2509	0.0	0.2475089677162216
chr5	DHFR	80637882	80638009	0	128	621	2626	621	2498	0.0	0.24859887910328263
chr5	CKMT2-AS1	81240327	81240380	0	54	0	7683	0	7629	0.0	0.0
chr5	CKMT2-AS1	81246889	81246972	0	84	0	7683	0	7599	0.0	0.0
chr5	SSBP2	81489249	81489309	0	61	1098	11043	1098	10982	0.0	0.09998178838098706
chr5	SSBP2	81513627	81513717	0	91	1098	11043	1098	10952	0.0	0.10025566106647188
chr5	LINC00461	88656624	88656707	0	84	0	11943	0	11859	0.0	0.0
chr5	LINC00461	88666790	88667591	0	802	0	11943	0	11141	0.0	0.0
chr5	MEF2C	88760987	88761125	0	139	0	5849	0	5710	0.0	0.0
chr5	MEF2C	88761184	88761328	0	145	0	5849	0	5704	0.0	0.0
chr5	LINC01339	90235428	90235535	0	108	0	2565	0	2457	0.0	0.0
chr5	LINC01339	90244610	90244755	0	146	0	2565	0	2419	0.0	0.0
chr5	LUCAT1	91303872	91303971	0	100	0	15454	0	15354	0.0	0.0
chr5	LUCAT1	91313637	91313777	0	141	0	15454	0	15313	0.0	0.0
chr5	LUCAT1	91310855	91311032	0	178	0	15454	0	15276	0.0	0.0
chr5	LUCAT1	91305679	91305771	0	93	0	15454	0	15361	0.0	0.0
chr5	LUCAT1	91312294	91312413	0	120	0	15454	0	15334	0.0	0.0
chr5	LUCAT1	91312294	91312495	0	202	0	15454	0	15252	0.0	0.0
chr5	LUCAT1	91306031	91306096	0	66	0	15454	0	15388	0.0	0.0
chr5	LUCAT1	91313077	91313229	0	153	0	15454	0	15301	0.0	0.0
chr5	NR2F1-AS1	93438702	93438741	0	40	3564	22614	3564	22574	0.0	0.15788074776291308
chr5	NR2F1-AS1	93544794	93544915	0	122	3564	22614	3564	22492	0.0	0.1584563400320114
chr5	NR2F1-AS1	93432364	93432460	0	97	3564	22614	3564	22517	0.0	0.15828041035661944
chr5	NR2F1-AS1	93496056	93496103	0	48	3564	22614	3564	22566	0.0	0.15793671895772401
chr5	NR2F1-AS1	93423154	93423244	0	91	3564	22614	3564	22523	0.0	0.1582382453491986
chr5	NR2F1-AS1	93535184	93535243	0	60	3564	22614	3564	22554	0.0	0.15802075019952114
chr5	NR2F1-AS1	93543981	93544024	0	44	3564	22614	3564	22570	0.0	0.1579087284005317
chr5	NR2F1-AS1	93569889	93570002	54	114	3564	22614	3510	22500	0.47368421052631576	0.156
chr5	NR2F1-AS1	93580466	93580691	0	226	3564	22614	3564	22388	0.0	0.15919242451313204
chr5	NR2F1-AS1	93569889	93570058	186	170	3564	22614	3378	22444	1.0941176470588236	0.15050793085011585
chr5	MCTP1	94923961	94924021	0	61	15326	12122	15326	12061	0.0	1.2707072382057873
chr5	MCTP1	94931952	94931991	0	40	15326	12122	15326	12082	0.0	1.2684985929481873
chr5	CHD1	98859971	98860068	0	98	340	10309	340	10211	0.0	0.033297424346293215
chr5	CHD1	98863407	98863586	0	180	340	10309	340	10129	0.0	0.03356698588212064
chr5	LINC00491	102617857	102617928	0	72	21405	2811	21405	2739	0.0	7.814895947426068
chr5	LINC00491	102636142	102636291	0	150	21405	2811	21405	2661	0.0	8.043968432919955
chr5	AC099520.1	104744517	104744609	0	93	0	4954	0	4861	0.0	0.0
chr5	AC099520.1	104754822	104755006	0	185	0	4954	0	4769	0.0	0.0
chr5	LINC01950	106818398	106818477	0	80	267	877	267	797	0.0	0.33500627352572143
chr5	LINC01950	106844060	106844214	0	155	267	877	267	722	0.0	0.3698060941828255
chr5	LINC01950	106969883	106969951	220	69	267	877	47	808	3.1884057971014492	0.05816831683168317
chr5	LINC01950	106980763	106980870	0	108	267	877	267	769	0.0	0.3472041612483745
chr5	AC024587.2	107705201	107705301	0	101	51	1495	51	1394	0.0	0.036585365853658534
chr5	AC024587.2	107708886	107708962	0	77	51	1495	51	1418	0.0	0.03596614950634697
chr5	STARD4	111501961	111502088	0	128	205435	5691	205435	5563	0.0	36.92881538738091
chr5	STARD4	111505014	111505043	0	30	205435	5691	205435	5661	0.0	36.289524818936584
chr5	ATG12	115840496	115840612	500	117	3202	7572	2702	7455	4.273504273504273	0.3624413145539906
chr5	ATG12	115840817	115840934	0	118	3202	7572	3202	7454	0.0	0.42956801717198817
chr5	LINC02208	118469080	118469148	0	69	1866	5937	1866	5868	0.0	0.3179959100204499
chr5	LINC02208	118472062	118472189	0	128	1866	5937	1866	5809	0.0	0.3212256842830091
chr5	LINC02201	122718470	122718575	7113	106	13136	3758	6023	3652	67.10377358490567	1.6492332968236583
chr5	LINC02201	122722213	122722323	2430	111	13136	3758	10706	3647	21.89189189189189	2.9355634768302714
chr5	LINC02201	122709016	122709079	0	64	13136	3758	13136	3694	0.0	3.5560368164591227
chr5	CEP120	123403255	123403344	0	90	0	13045	0	12955	0.0	0.0
chr5	CEP120	123409831	123409948	0	118	0	13045	0	12927	0.0	0.0
chr5	LINC01170	124306175	124306291	0	117	45	3859	45	3742	0.0	0.012025654730090861
chr5	LINC01170	124317648	124317861	0	214	45	3859	45	3645	0.0	0.012345679012345678
chr5	ALDH7A1	126554286	126554393	0	108	153	14624	153	14516	0.0	0.010540093689721686
chr5	ALDH7A1	126559239	126559334	0	96	153	14624	153	14528	0.0	0.010531387665198238
chr5	ALDH7A1	126583931	126584012	0	82	153	14624	153	14542	0.0	0.010521248796589189
chr5	ALDH7A1	126592663	126592729	0	67	153	14624	153	14557	0.0	0.010510407364154702
chr5	ALDH7A1	126582850	126582974	0	125	153	14624	153	14499	0.0	0.010552451893234015
chr5	ALDH7A1	126593350	126593404	0	55	153	14624	153	14569	0.0	0.010501750291715286
chr5	LINC01184	128062373	128062500	0	128	51	12548	51	12420	0.0	0.004106280193236715
chr5	LINC01184	128081972	128082191	0	220	51	12548	51	12328	0.0	0.004136924075275795
chr5	LINC01184	128076946	128077093	0	148	51	12548	51	12400	0.0	0.004112903225806452
chr5	LINC01184	128062369	128062500	0	132	51	12548	51	12416	0.0	0.004107603092783505
chr5	LINC01184	128064736	128064850	0	115	51	12548	51	12433	0.0	0.004101986648435615
chr5	LINC01184	128081972	128082194	0	223	51	12548	51	12325	0.0	0.004137931034482759
chr5	HINT1	131160655	131160844	0	190	147	6082	147	5892	0.0	0.02494908350305499
chr5	HINT1	131162063	131162477	0	415	147	6082	147	5667	0.0	0.02593965060878772
chr5	HINT1	131162028	131162503	0	476	147	6082	147	5606	0.0	0.026221905101676775
chr5	HINT1	131162028	131162477	0	450	147	6082	147	5632	0.0	0.026100852272727272
chr5	ACSL6	131974757	131974835	0	79	64616	15803	64616	15724	0.0	4.109386924446706
chr5	ACSL6	131974892	131974970	0	79	64616	15803	64616	15724	0.0	4.109386924446706
chr5	ACSL6	131974892	131975060	0	169	64616	15803	64616	15634	0.0	4.133043367020596
chr5	ACSL6	131974892	131976240	51	1349	64616	15803	64565	14454	0.03780578206078577	4.466929569669296
chr5	ACSL6	131974892	131975250	51	359	64616	15803	64565	15444	0.14206128133704735	4.18058793058793
chr5	P4HA2	132198205	132198271	0	67	35065	9992	35065	9925	0.0	3.5329974811083122
chr5	P4HA2	132198320	132198380	0	61	35065	9992	35065	9931	0.0	3.5308629543852583
chr5	SKP1	134170950	134171038	0	89	122297	12086	122297	11997	0.0	10.193965157956155
chr5	SKP1	134173700	134173766	0	67	122297	12086	122297	12019	0.0	10.175305765870705
chr5	CDKL3	134308573	134308727	0	155	110679	3167	110679	3012	0.0	36.74601593625498
chr5	CDKL3	134312291	134312380	0	90	110679	3167	110679	3077	0.0	35.96977575560611
chr5	CDKL3	134299655	134299750	630	96	110679	3167	110049	3071	6.5625	35.83490719635298
chr5	CDKL3	134302139	134302210	459	72	110679	3167	110220	3095	6.375	35.61227786752827
chr5	SAR1B	134625776	134625876	0	101	183	10558	183	10457	0.0	0.017500239074304293
chr5	SAR1B	134632076	134632195	0	120	183	10558	183	10438	0.0	0.017532094270933128
chr5	SAR1B	134632076	134632199	0	124	183	10558	183	10434	0.0	0.017538815411155838
chr5	MACROH2A1	135350822	135350913	0	92	1181264	10783	1181264	10691	0.0	110.49144139930783
chr5	MACROH2A1	135352945	135353045	0	101	1181264	10783	1181264	10682	0.0	110.58453473132373
chr5	TRPC7	136274672	136274837	0	166	51	3780	51	3614	0.0	0.014111787493082457
chr5	TRPC7	136315596	136315779	0	184	51	3780	51	3596	0.0	0.01418242491657397
chr5	SIL1	139133333	139133471	0	139	2097	3852	2097	3713	0.0	0.564772421222731
chr5	SIL1	139196440	139196528	0	89	2097	3852	2097	3763	0.0	0.5572681371246346
chr5	SIL1	139127943	139128052	0	110	2097	3852	2097	3742	0.0	0.5603955104222341
chr5	SIL1	139137328	139137474	0	147	2097	3852	2097	3705	0.0	0.5659919028340081
chr5	DNAJC18	139428537	139428683	0	147	255	2652	255	2505	0.0	0.10179640718562874
chr5	DNAJC18	139437371	139437558	0	188	255	2652	255	2464	0.0	0.10349025974025974
chr5	NRG2	139865114	139865173	0	60	12857	4616	12857	4556	0.0	2.821992976294996
chr5	NRG2	139865548	139865625	192	78	12857	4616	12665	4538	2.4615384615384617	2.7908770383428823
chr5	NRG2	139859888	139859912	16	25	12857	4616	12841	4591	0.64	2.796994118928338
chr5	HARS1	140677907	140678015	0	109	6636	12088	6636	11979	0.0	0.55396944653143
chr5	HARS1	140683099	140683219	30	121	6636	12088	6606	11967	0.24793388429752067	0.5520180496365004
chr5	HARS1	140683545	140683667	0	123	6636	12088	6636	11965	0.0	0.5546176347680736
chr5	HARS1	140687745	140687933	0	189	6636	12088	6636	11899	0.0	0.5576939238591478
chr5	HARS1	140683545	140683664	0	120	6636	12088	6636	11968	0.0	0.5544786096256684
chr5	DIAPH1	141550498	141550507	0	10	178283	7015	178283	7005	0.0	25.45082084225553
chr5	DIAPH1	141571427	141571436	0	10	178283	7015	178283	7005	0.0	25.45082084225553
chr5	FCHSD1	141642396	141642503	0	108	168	5453	168	5345	0.0	0.0314312441534144
chr5	FCHSD1	141643000	141643088	0	89	168	5453	168	5364	0.0	0.03131991051454139
chr5	LARS1	146168127	146168265	51	139	51	16674	0	16535	0.3669064748201439	0.0
chr5	LARS1	146171909	146171990	0	82	51	16674	51	16592	0.0	0.0030737704918032786
chr5	PPP2R2B	146878001	146878195	0	195	0	13227	0	13032	0.0	0.0
chr5	PPP2R2B	147054597	147054659	0	63	0	13227	0	13164	0.0	0.0
chr5	PPP2R2B	147040716	147040805	0	90	0	13227	0	13137	0.0	0.0
chr5	HTR4	148484259	148484379	0	121	30	7064	30	6943	0.0	0.004320898746939364
chr5	HTR4	148490599	148490846	0	248	30	7064	30	6816	0.0	0.0044014084507042256
chr5	CSNK1A1	149525044	149525171	0	128	3009	8524	3009	8396	0.0	0.3583849452120057
chr5	CSNK1A1	149531393	149531511	0	119	3009	8524	3009	8405	0.0	0.3580011897679952
chr5	CSF1R	150058154	150058271	2272	118	120502	5174	118230	5056	19.25423728813559	23.384098101265824
chr5	CSF1R	150059699	150059862	0	164	120502	5174	120502	5010	0.0	24.052295409181635
chr5	CAMK2A	150228191	150228286	0	96	574	6094	574	5998	0.0	0.09569856618872957
chr5	CAMK2A	150231304	150231380	0	77	574	6094	574	6017	0.0	0.09539637693202592
chr5	TNIP1	151033479	151033579	0	101	860983	5576	860983	5475	0.0	157.25716894977168
chr5	TNIP1	151033607	151033799	0	193	860983	5576	860983	5383	0.0	159.94482630503435
chr5	LINC01470	152623230	152623352	0	123	33	4499	33	4376	0.0	0.007541133455210238
chr5	LINC01470	152631411	152631478	0	68	33	4499	33	4431	0.0	0.007447528774542992
chr5	LINC01470	152972013	152972233	0	221	33	4499	33	4278	0.0	0.007713884992987377
chr5	LINC01470	152972265	152972316	0	52	33	4499	33	4447	0.0	0.007420733078479874
chr5	FAXDC2	154830800	154830922	0	123	0	6073	0	5950	0.0	0.0
chr5	FAXDC2	154834842	154834934	0	93	0	6073	0	5980	0.0	0.0
chr5	FAXDC2	154834624	154834728	0	105	0	6073	0	5968	0.0	0.0
chr5	CCNJL	160261080	160261337	0	258	204	9249	204	8991	0.0	0.022689356022689355
chr5	CCNJL	160276268	160276412	0	145	204	9249	204	9104	0.0	0.02240773286467487
chr5	CCNJL	160274821	160274858	0	38	204	9249	204	9211	0.0	0.022147432417761372
chr5	SLU7	160417111	160417241	0	131	0	4786	0	4655	0.0	0.0
chr5	SLU7	160418595	160418685	0	91	0	4786	0	4695	0.0	0.0
chr5	FBXW11	171914342	171914405	0	64	2040	5539	2040	5475	0.0	0.3726027397260274
chr5	FBXW11	171957596	171957698	0	103	2040	5539	2040	5436	0.0	0.37527593818984545
chr5	FBXW11	171996889	171997051	0	163	2040	5539	2040	5376	0.0	0.3794642857142857
chr5	BOD1	173609237	173609434	0	198	134	2259	134	2061	0.0	0.06501698204754973
chr5	BOD1	173613130	173613255	0	126	134	2259	134	2133	0.0	0.06282231598687295
chr5	LINC01484	173711845	173711948	0	104	0	5287	0	5183	0.0	0.0
chr5	LINC01484	173718840	173719543	0	704	0	5287	0	4583	0.0	0.0
chr5	KIAA1191	176359480	176359567	153	88	5348	3822	5195	3734	1.7386363636363635	1.391269416175683
chr5	KIAA1191	176359810	176359918	153	109	5348	3822	5195	3713	1.4036697247706422	1.3991381632103421
chr5	KIAA1191	176357175	176357273	0	99	5348	3822	5348	3723	0.0	1.4364759602471124
chr5	HK3	176889380	176889564	684	185	224396	3323	223712	3138	3.6972972972972973	71.29126832377311
chr5	HK3	176891036	176891279	79	244	224396	3323	224317	3079	0.3237704918032787	72.8538486521598
chr5	PDLIM7	177491403	177491420	0	18	102	4294	102	4276	0.0	0.023854069223573433
chr5	PDLIM7	177491806	177491925	0	120	102	4294	102	4174	0.0	0.024436990896023
chr5	PDLIM7	177491806	177491976	0	171	102	4294	102	4123	0.0	0.02473926752364783
chr5	FAM193B	177547167	177547228	86	62	4817	5341	4731	5279	1.3870967741935485	0.8961924606933132
chr5	FAM193B	177552041	177552131	156	91	4817	5341	4661	5250	1.7142857142857142	0.8878095238095238
chr5	FAM193B	177531952	177532131	0	180	4817	5341	4817	5161	0.0	0.9333462507266034
chr5	FAM193B	177532155	177532200	0	46	4817	5341	4817	5295	0.0	0.9097261567516525
chr5	FAM153A	177729022	177729053	0	32	7931	8568	7931	8536	0.0	0.9291237113402062
chr5	FAM153A	177731568	177731599	0	32	7931	8568	7931	8536	0.0	0.9291237113402062
chr5	FAM153A	177734379	177734404	0	26	7931	8568	7931	8542	0.0	0.9284710840552564
chr5	FAM153A	177744393	177744418	0	26	7931	8568	7931	8542	0.0	0.9284710840552564
chr5	PHYKPL	178231404	178231523	0	120	0	7715	0	7595	0.0	0.0
chr5	PHYKPL	178231668	178231829	0	162	0	7715	0	7553	0.0	0.0
chr5	HNRNPH1	179619268	179619407	0	140	276	5593	276	5453	0.0	0.05061434072987346
chr5	HNRNPH1	179620891	179621035	0	145	276	5593	276	5448	0.0	0.05066079295154185
chr5	HNRNPH1	179621241	179621397	0	157	276	5593	276	5436	0.0	0.05077262693156733
chr5	MRNIP	179851242	179851337	0	96	306	7454	306	7358	0.0	0.04158738787714053
chr5	MRNIP	179853196	179853276	0	81	306	7454	306	7373	0.0	0.04150278041502781
chr5	MRNIP	179851242	179851424	153	183	306	7454	153	7271	0.8360655737704918	0.021042497593178378
chr5	MRNIP	179844151	179844227	0	77	306	7454	306	7377	0.0	0.0414802765351769
chr5	MRNIP	179847977	179848066	51	90	306	7454	255	7364	0.5666666666666667	0.0346279196089082
chr5	MAPK9	180247438	180247510	0	73	113356	8972	113356	8899	0.0	12.738060456231038
chr5	MAPK9	180247854	180247926	0	73	113356	8972	113356	8899	0.0	12.738060456231038
chr5	RACK1	181242173	181242213	0	41	0	5102	0	5061	0.0	0.0
chr5	RACK1	181242285	181242345	0	61	0	5102	0	5041	0.0	0.0
chr6	DUSP22	311879	311962	3021	84	143861	4077	140840	3993	35.964285714285715	35.271725519659405
chr6	DUSP22	335113	335163	1291	51	143861	4077	142570	4026	25.313725490196077	35.412319920516644
chr6	DUSP22	311879	311914	1670	36	143861	4077	142191	4041	46.388888888888886	35.18708240534521
chr6	GMDS-DT	2269697	2269799	255	103	13598	21506	13343	21403	2.4757281553398056	0.623417277951689
chr6	GMDS-DT	2397220	2397626	357	407	13598	21506	13241	21099	0.8771498771498771	0.6275652874543817
chr6	GMDS-DT	2329282	2329332	0	51	13598	21506	13598	21455	0.0	0.6337916569564204
chr6	GMDS-DT	2360543	2360630	51	88	13598	21506	13547	21418	0.5795454545454546	0.632505369315529
chr6	GMDS-DT	2263600	2263684	0	85	13598	21506	13598	21421	0.0	0.6347976284954017
chr6	GMDS-DT	2397543	2397626	154	84	13598	21506	13444	21422	1.8333333333333333	0.6275791242647746
chr6	NQO2	3003668	3003789	0	122	169190	4556	169190	4434	0.0	38.1574199368516
chr6	NQO2	3004494	3004651	255	158	169190	4556	168935	4398	1.6139240506329113	38.411778080945886
chr6	RIPK1	3080978	3081116	51	139	459507	10181	459456	10042	0.3669064748201439	45.753435570603465
chr6	RIPK1	3083084	3083313	2370	230	459507	10181	457137	9951	10.304347826086957	45.9388001205909
chr6	RIPK1	3082546	3082660	82	115	459507	10181	459425	10066	0.7130434782608696	45.64126763361812
chr6	RIPK1	3064487	3064721	867	235	459507	10181	458640	9946	3.6893617021276595	46.113010255379045
chr6	RIPK1	3073638	3073802	194	165	459507	10181	459313	10016	1.1757575757575758	45.85792731629393
chr6	LYRM4-AS1	5030772	5031022	0	251	19581	4630	19581	4379	0.0	4.471568851335921
chr6	LYRM4-AS1	5040629	5040687	0	59	19581	4630	19581	4571	0.0	4.283745351126668
chr6	LYRM4-AS1	5030748	5031022	0	275	19581	4630	19581	4355	0.0	4.496211251435132
chr6	RREB1	7240437	7240602	357	166	284743	16690	284386	16524	2.1506024096385543	17.21048172355362
chr6	RREB1	7246423	7247221	18181	799	284743	16690	266562	15891	22.754693366708384	16.774400604115538
chr6	AL355499.1	8260566	8260738	0	173	28666	4643	28666	4470	0.0	6.412975391498882
chr6	AL355499.1	8302933	8303118	0	186	28666	4643	28666	4457	0.0	6.431680502580211
chr6	AL355499.1	8323530	8323636	0	107	28666	4643	28666	4536	0.0	6.319664902998237
chr6	AL355499.1	8328004	8328277	0	274	28666	4643	28666	4369	0.0	6.561226825360494
chr6	HULC	8547116	8547214	0	99	13320	47611	13320	47512	0.0	0.2803502273109951
chr6	HULC	8558584	8558643	0	60	13320	47611	13320	47551	0.0	0.280120291897121
chr6	HULC	8577267	8577449	0	183	13320	47611	13320	47428	0.0	0.28084675718984564
chr6	HULC	8780248	8780367	0	120	13320	47611	13320	47491	0.0	0.2804741951106525
chr6	HULC	8607007	8607168	0	162	13320	47611	13320	47449	0.0	0.2807224599043183
chr6	HULC	8779886	8780007	0	122	13320	47611	13320	47489	0.0	0.2804860072858978
chr6	HULC	8760376	8760495	0	120	13320	47611	13320	47491	0.0	0.2804741951106525
chr6	HULC	8469990	8470132	51	143	13320	47611	13269	47468	0.35664335664335667	0.27953568719979777
chr6	HULC	8960706	8960815	0	110	13320	47611	13320	47501	0.0	0.28041514915475463
chr6	HULC	8961458	8961564	0	107	13320	47611	13320	47504	0.0	0.2803974402155608
chr6	HULC	8652286	8652390	0	105	13320	47611	13320	47506	0.0	0.28038563549867385
chr6	HULC	8652293	8652390	0	98	13320	47611	13320	47513	0.0	0.28034432681581883
chr6	HULC	8788821	8788946	0	126	13320	47611	13320	47485	0.0	0.2805096346214594
chr6	HULC	8789309	8789418	338	110	13320	47611	12982	47501	3.0727272727272728	0.2732995094840109
chr6	HULC	8961454	8961564	0	111	13320	47611	13320	47500	0.0	0.28042105263157896
chr6	HULC	8932841	8932885	0	45	13320	47611	13320	47566	0.0	0.2800319555985368
chr6	HULC	8937390	8937480	0	91	13320	47611	13320	47520	0.0	0.2803030303030303
chr6	TMEM14B	10749621	10749698	649	78	1049659	4830	1049010	4752	8.320512820512821	220.75126262626262
chr6	TMEM14B	10751132	10751234	1600	103	1049659	4830	1048059	4727	15.533980582524272	221.71757986037656
chr6	TMEM14B	10749201	10749268	397	68	1049659	4830	1049262	4762	5.838235294117647	220.34061318773624
chr6	CASC15	21978944	21979062	0	119	0	32553	0	32434	0.0	0.0
chr6	CASC15	22020338	22020542	0	205	0	32553	0	32348	0.0	0.0
chr6	CASC15	22056545	22056690	0	146	0	32553	0	32407	0.0	0.0
chr6	CASC15	22142900	22142951	0	52	0	32553	0	32501	0.0	0.0
chr6	CASC15	22173997	22174062	0	66	0	32553	0	32487	0.0	0.0
chr6	CASC15	22181322	22181475	0	154	0	32553	0	32399	0.0	0.0
chr6	CASC15	22191566	22191656	0	91	0	32553	0	32462	0.0	0.0
chr6	CASC15	22063019	22063240	0	222	0	32553	0	32331	0.0	0.0
chr6	CASC15	22083582	22083718	0	137	0	32553	0	32416	0.0	0.0
chr6	CASC15	22036830	22036941	0	112	0	32553	0	32441	0.0	0.0
chr6	CASC15	22043630	22043894	0	265	0	32553	0	32288	0.0	0.0
chr6	CASC15	22029424	22029562	0	139	0	32553	0	32414	0.0	0.0
chr6	CASC15	22051477	22051590	0	114	0	32553	0	32439	0.0	0.0
chr6	CASC15	22043646	22043894	0	249	0	32553	0	32304	0.0	0.0
chr6	CASC15	21915208	21915238	0	31	0	32553	0	32522	0.0	0.0
chr6	CASC15	21977321	21977530	0	210	0	32553	0	32343	0.0	0.0
chr6	CASC15	21977777	21977953	0	177	0	32553	0	32376	0.0	0.0
chr6	CASC15	22110746	22110920	0	175	0	32553	0	32378	0.0	0.0
chr6	CASC15	21900914	21901180	0	267	0	32553	0	32286	0.0	0.0
chr6	CASC15	21905544	21905605	0	62	0	32553	0	32491	0.0	0.0
chr6	CASC15	22181664	22181762	0	99	0	32553	0	32454	0.0	0.0
chr6	HFE	26090840	26091104	2187	265	156147	5638	153960	5373	8.252830188679246	28.65438302624232
chr6	HFE	26091313	26091589	3689	277	156147	5638	152458	5361	13.31768953068592	28.43835105390785
chr6	BTN3A2	26370321	26370603	2921	283	120376	5358	117455	5075	10.321554770318022	23.14384236453202
chr6	BTN3A2	26372896	26373097	2912	202	120376	5358	117464	5156	14.415841584158416	22.78200155159038
chr6	BTN2A2	26383791	26383915	13	125	147022	4365	147009	4240	0.104	34.67193396226415
chr6	BTN2A2	26388012	26388294	5872	283	147022	4365	141150	4082	20.749116607773853	34.578637922586964
chr6	BTN2A2	26385014	26385362	5855	349	147022	4365	141167	4016	16.77650429799427	35.15114541832669
chr6	PRSS16	27248846	27248946	0	101	149	3595	149	3494	0.0	0.04264453348597596
chr6	PRSS16	27249099	27249229	0	131	149	3595	149	3464	0.0	0.04301385681293302
chr6	PRSS16	27252807	27252949	47	143	149	3595	102	3452	0.32867132867132864	0.02954808806488992
chr6	PRSS16	27254692	27254872	0	181	149	3595	149	3414	0.0	0.04364381956649092
chr6	MOG	29659318	29659666	0	349	0	2643	0	2294	0.0	0.0
chr6	MOG	29666151	29666265	0	115	0	2643	0	2528	0.0	0.0
chr6	MOG	29670173	29670221	0	49	0	2643	0	2594	0.0	0.0
chr6	MOG	29670280	29670397	0	118	0	2643	0	2525	0.0	0.0
chr6	RPP21	30345297	30345398	0	102	51	1107	51	1005	0.0	0.050746268656716415
chr6	RPP21	30345490	30345573	0	84	51	1107	51	1023	0.0	0.04985337243401759
chr6	DDR1	30884537	30884710	3509	174	133998	8326	130489	8152	20.166666666666668	16.00699214916585
chr6	DDR1	30885624	30885680	145	57	133998	8326	133853	8269	2.543859649122807	16.187326157939292
chr6	LST1	31587640	31587733	570	94	39635	1224	39065	1130	6.0638297872340425	34.57079646017699
chr6	LST1	31587943	31587966	24	24	39635	1224	39611	1200	1.0	33.009166666666665
chr6	MSH5	31761817	31761865	294	49	350463	5859	350169	5810	6.0	60.27005163511188
chr6	MSH5	31761865	31761955	12	91	350463	5859	350451	5768	0.13186813186813187	60.757801664355064
chr6	C2	31933866	31933965	0	100	622662	5539	622662	5439	0.0	114.48097076668505
chr6	C2	31935922	31936061	645	140	622662	5539	622017	5399	4.607142857142857	115.2096684571217
chr6	TSBP1-AS1	32262611	32262809	0	199	153	8215	153	8016	0.0	0.01908682634730539
chr6	TSBP1-AS1	32365779	32365839	0	61	153	8215	153	8154	0.0	0.018763796909492272
chr6	TSBP1-AS1	32349511	32349997	0	487	153	8215	153	7728	0.0	0.019798136645962732
chr6	LHFPL5	35806848	35806967	1981	120	73141	7545	71160	7425	16.508333333333333	9.583838383838383
chr6	LHFPL5	35814545	35814782	1145	238	73141	7545	71996	7307	4.810924369747899	9.853017654304091
chr6	MAPK14	36095986	36096066	0	81	62677	6770	62677	6689	0.0	9.370159964120198
chr6	MAPK14	36100187	36100267	0	81	62677	6770	62677	6689	0.0	9.370159964120198
chr6	MAPK14	36072872	36072984	204	113	62677	6770	62473	6657	1.8053097345132743	9.384557608532372
chr6	MAPK14	36073045	36073105	0	61	62677	6770	62677	6709	0.0	9.34222685944254
chr6	BRPF3	36217916	36218010	0	95	42930	6627	42930	6532	0.0	6.572259644825475
chr6	BRPF3	36228901	36229056	0	156	42930	6627	42930	6471	0.0	6.634214186369959
chr6	BRPF3	36222167	36222265	0	99	42930	6627	42930	6528	0.0	6.576286764705882
chr6	BRPF3	36225266	36225364	0	99	42930	6627	42930	6528	0.0	6.576286764705882
chr6	KCTD20	36443417	36443530	98	114	80401	6251	80303	6137	0.8596491228070176	13.085057845853022
chr6	KCTD20	36465600	36465698	16946	99	80401	6251	63455	6152	171.17171717171718	10.314531859557867
chr6	C6ORF89	36892765	36892856	10034	92	18380	7343	8346	7251	109.06521739130434	1.1510136532892015
chr6	C6ORF89	36894503	36894603	7355	101	18380	7343	11025	7242	72.82178217821782	1.5223695111847555
chr6	UBR2	42617239	42617338	0	100	30364	8923	30364	8823	0.0	3.4414598209225886
chr6	UBR2	42617408	42617507	0	100	30364	8923	30364	8823	0.0	3.4414598209225886
chr6	KLC4	43071566	43071619	63	54	8006	5760	7943	5706	1.1666666666666667	1.392043463021381
chr6	KLC4	43071851	43071922	0	72	8006	5760	8006	5688	0.0	1.4075246132208157
chr6	KLC4	43061310	43061593	25	284	8006	5760	7981	5476	0.0880281690140845	1.4574506939371805
chr6	KLC4	43062916	43063147	0	232	8006	5760	8006	5528	0.0	1.4482633863965269
chr6	VEGFA	43780731	43780803	0	73	0	7921	0	7848	0.0	0.0
chr6	VEGFA	43781955	43782087	0	133	0	7921	0	7788	0.0	0.0
chr6	VEGFA	43781955	43782052	0	98	0	7921	0	7823	0.0	0.0
chr6	VEGFA	43778459	43778536	0	78	0	7921	0	7843	0.0	0.0
chr6	VEGFA	43782010	43782087	0	78	0	7921	0	7843	0.0	0.0
chr6	AL121974.1	49801706	49801760	0	55	0	1303	0	1248	0.0	0.0
chr6	AL121974.1	49802984	49803105	0	122	0	1303	0	1181	0.0	0.0
chr6	AL121974.1	49802984	49803073	0	90	0	1303	0	1213	0.0	0.0
chr6	AL121974.1	49802984	49803057	0	74	0	1303	0	1229	0.0	0.0
chr6	EFHC1	52429968	52430131	51	164	15377	16238	15326	16074	0.31097560975609756	0.9534652233420431
chr6	EFHC1	52437561	52437678	0	118	15377	16238	15377	16120	0.0	0.9539081885856079
chr6	AL445250.1	57962180	57962248	0	69	1020	10037	1020	9968	0.0	0.10232744783306581
chr6	AL445250.1	57971594	57971656	0	63	1020	10037	1020	9974	0.0	0.1022658913174253
chr6	PTP4A1	63532336	63532530	0	195	0	5534	0	5339	0.0	0.0
chr6	PTP4A1	63550299	63550493	0	195	0	5534	0	5339	0.0	0.0
chr6	PHF3	63679999	63680161	0	163	102	20948	102	20785	0.0	0.0049073851335097425
chr6	PHF3	63684128	63685911	0	1784	102	20948	102	19164	0.0	0.005322479649342517
chr6	FAM135A	70415290	70415376	43667	87	43667	9960	0	9873	501.91954022988506	0.0
chr6	FAM135A	70426438	70426532	0	95	43667	9960	43667	9865	0.0	4.426457171819564
chr6	FAM135A	70426569	70426709	0	141	43667	9960	43667	9819	0.0	4.447194215296873
chr6	RIMS1	72274348	72274432	0	85	204	12828	204	12743	0.0	0.016008789139135213
chr6	RIMS1	72284046	72284118	0	73	204	12828	204	12755	0.0	0.015993727949823597
chr6	RIMS1	72265959	72266049	0	91	204	12828	204	12737	0.0	0.01601633037606972
chr6	KCNQ5	73124485	73124512	0	28	204	8128	204	8100	0.0	0.025185185185185185
chr6	KCNQ5	73129792	73129849	0	58	204	8128	204	8070	0.0	0.025278810408921933
chr6	MYO6	75777452	75777570	0	119	6089	9887	6089	9768	0.0	0.6233619983619983
chr6	MYO6	75813598	75813688	0	91	6089	9887	6089	9796	0.0	0.6215802368313598
chr6	MYO6	75757998	75758120	0	123	6089	9887	6089	9764	0.0	0.6236173699303564
chr6	TBX18-AS1	84692289	84692626	0	338	0	2085	0	1747	0.0	0.0
chr6	TBX18-AS1	84694909	84695108	0	200	0	2085	0	1885	0.0	0.0
chr6	TBX18-AS1	84707305	84707614	0	310	0	2085	0	1775	0.0	0.0
chr6	TBX18-AS1	84695055	84695108	0	54	0	2085	0	2031	0.0	0.0
chr6	SLC35A1	87506381	87506448	0	68	0	2003	0	1935	0.0	0.0
chr6	SLC35A1	87508419	87508596	0	178	0	2003	0	1825	0.0	0.0
chr6	ANKRD6	89617953	89618031	0	79	102	8004	102	7925	0.0	0.012870662460567823
chr6	ANKRD6	89621921	89622026	0	106	102	8004	102	7898	0.0	0.012914661939731578
chr6	AL132996.1	90360767	90360825	0	59	247916	8959	247916	8900	0.0	27.85573033707865
chr6	AL132996.1	90361267	90361394	0	128	247916	8959	247916	8831	0.0	28.07337787340052
chr6	AL589740.1	97309981	97310059	0	79	16623	12047	16623	11968	0.0	1.3889538770053476
chr6	AL589740.1	97373847	97373914	0	68	16623	12047	16623	11979	0.0	1.3876784372652142
chr6	AL589740.1	97972525	97972670	0	146	16623	12047	16623	11901	0.0	1.3967733803882028
chr6	AL589740.1	98099185	98099270	0	86	16623	12047	16623	11961	0.0	1.3897667419112114
chr6	AL589740.1	97423468	97423566	0	99	16623	12047	16623	11948	0.0	1.391278875125544
chr6	AL589740.1	98041418	98041512	0	95	16623	12047	16623	11952	0.0	1.3908132530120483
chr6	AL589740.1	98076066	98076145	0	80	16623	12047	16623	11967	0.0	1.389069942341439
chr6	AL589740.1	97969405	97969466	0	62	16623	12047	16623	11985	0.0	1.3869837296620775
chr6	AL589740.1	97998858	97998907	0	50	16623	12047	16623	11997	0.0	1.3855963990997748
chr6	AL589740.1	97972576	97972670	0	95	16623	12047	16623	11952	0.0	1.3908132530120483
chr6	AL589740.1	98034494	98034562	0	69	16623	12047	16623	11978	0.0	1.3877942895308064
chr6	AL589740.1	98113798	98113860	0	63	16623	12047	16623	11984	0.0	1.387099465954606
chr6	AL589740.1	98270566	98270656	0	91	16623	12047	16623	11956	0.0	1.3903479424556708
chr6	AL589740.1	98117238	98117321	0	84	16623	12047	16623	11963	0.0	1.3895343977263228
chr6	AL589740.1	98133351	98133456	0	106	16623	12047	16623	11941	0.0	1.3920944644502136
chr6	AL589740.1	98270597	98270656	0	60	16623	12047	16623	11987	0.0	1.3867523150079253
chr6	AL589740.1	98279755	98279859	0	105	16623	12047	16623	11942	0.0	1.391977893150226
chr6	AL589740.1	98361337	98361412	0	76	16623	12047	16623	11971	0.0	1.3886057973435804
chr6	TSTD3	99526063	99526109	0	47	153	16121	153	16074	0.0	0.009518477043673012
chr6	TSTD3	99531362	99531536	0	175	153	16121	153	15946	0.0	0.009594882729211088
chr6	GRIK2	102063961	102064048	0	88	0	7955	0	7867	0.0	0.0
chr6	GRIK2	102065796	102065928	0	133	0	7955	0	7822	0.0	0.0
chr6	BVES-AS1	105154393	105154491	0	99	1989	6708	1989	6609	0.0	0.300953245574217
chr6	BVES-AS1	105166543	105166702	0	160	1989	6708	1989	6548	0.0	0.3037568723274282
chr6	CEP57L1	109100191	109100286	0	96	14299	16746	14299	16650	0.0	0.8587987987987988
chr6	CEP57L1	109106034	109106090	0	57	14299	16746	14299	16689	0.0	0.8567918988555336
chr6	CEP57L1	109124990	109125031	0	42	14299	16746	14299	16704	0.0	0.8560225095785441
chr6	CEP57L1	109145218	109145381	0	164	14299	16746	14299	16582	0.0	0.8623205885900374
chr6	CEP57L1	109140420	109140675	0	256	14299	16746	14299	16490	0.0	0.8671315949060037
chr6	CEP57L1	109129303	109129492	0	190	14299	16746	14299	16556	0.0	0.8636748006764919
chr6	FIG4	109695398	109695474	248	77	394464	19865	394216	19788	3.220779220779221	19.92197291287649
chr6	FIG4	109695829	109695904	2293	76	394464	19865	392171	19789	30.17105263157895	19.817625953812723
chr6	FIG4	109715077	109715176	0	100	394464	19865	394464	19765	0.0	19.95770301037187
chr6	FIG4	109727108	109727265	0	158	394464	19865	394464	19707	0.0	20.01644085857817
chr6	FIG4	109716444	109716568	0	125	394464	19865	394464	19740	0.0	19.982978723404255
chr6	LAMA4-AS1	112258357	112258552	0	196	0	4143	0	3947	0.0	0.0
chr6	LAMA4-AS1	112283053	112283192	0	140	0	4143	0	4003	0.0	0.0
chr6	AL365214.2	112343397	112343778	0	382	153	1443	153	1061	0.0	0.14420358152686144
chr6	AL365214.2	112345112	112345159	0	48	153	1443	153	1395	0.0	0.10967741935483871
chr6	RWDD1	116572857	116572985	11527	129	76601	5877	65074	5748	89.35658914728683	11.32115518441197
chr6	RWDD1	116574057	116574171	16368	115	76601	5877	60233	5762	142.3304347826087	10.453488372093023
chr6	RWDD1	116572421	116572478	7803	58	76601	5877	68798	5819	134.5344827586207	11.822993641519162
chr6	RSPH4A	116627628	116628369	0	742	0	2846	0	2104	0.0	0.0
chr6	RSPH4A	116629566	116629702	0	137	0	2846	0	2709	0.0	0.0
chr6	PKIB	122701061	122701224	0	164	0	3448	0	3284	0.0	0.0
chr6	PKIB	122701439	122701500	0	62	0	3448	0	3386	0.0	0.0
chr6	TPD52L1	125253716	125253755	0	40	78	4105	78	4065	0.0	0.01918819188191882
chr6	TPD52L1	125257097	125257158	0	62	78	4105	78	4043	0.0	0.01929260450160772
chr6	RNF146	127280515	127280604	0	90	0	3139	0	3049	0.0	0.0
chr6	RNF146	127282286	127282395	0	110	0	3139	0	3029	0.0	0.0
chr6	RNF146	127285207	127285348	0	142	0	3139	0	2997	0.0	0.0
chr6	AKAP7	131169112	131169273	0	162	4839	4154	4839	3992	0.0	1.2121743486973948
chr6	AKAP7	131199460	131199573	1394	114	4839	4154	3445	4040	12.228070175438596	0.8527227722772277
chr6	LINC01013	132154655	132154777	0	123	177	6796	177	6673	0.0	0.026524801438633297
chr6	LINC01013	132160766	132160914	0	149	177	6796	177	6647	0.0	0.02662855423499323
chr6	LINC01013	132163896	132164193	0	298	177	6796	177	6498	0.0	0.02723915050784857
chr6	LINC00326	133096509	133096563	0	55	1416	6021	1416	5966	0.0	0.23734495474354678
chr6	LINC00326	133100006	133100184	204	179	1416	6021	1212	5842	1.1396648044692737	0.2074631975350907
chr6	EYA4	133525014	133525115	0	102	0	7266	0	7164	0.0	0.0
chr6	EYA4	133525153	133525254	0	102	0	7266	0	7164	0.0	0.0
chr6	LINC01010	134476747	134476930	0	184	2339	4158	2339	3974	0.0	0.5885757423251132
chr6	LINC01010	134500433	134500574	0	142	2339	4158	2339	4016	0.0	0.5824203187250996
chr6	LINC01010	134476898	134476930	0	33	2339	4158	2339	4125	0.0	0.567030303030303
chr6	MYB	135196725	135196908	0	184	1466	5517	1466	5333	0.0	0.27489218076129757
chr6	MYB	135196960	135197323	0	364	1466	5517	1466	5153	0.0	0.2844944692412187
chr6	MYB	135194355	135194460	0	106	1466	5517	1466	5411	0.0	0.27092958787654775
chr6	MYB	135195747	135196002	0	256	1466	5517	1466	5261	0.0	0.27865424824177915
chr6	LINC00271	135498403	135498517	0	115	23374	13702	23374	13587	0.0	1.7203208949731361
chr6	LINC00271	135518592	135518830	0	239	23374	13702	23374	13463	0.0	1.7361657877144767
chr6	LINC00271	135518592	135518642	0	51	23374	13702	23374	13651	0.0	1.7122555124166727
chr6	FILNC1	139745385	139745439	0	55	0	1857	0	1802	0.0	0.0
chr6	FILNC1	139771072	139771123	0	52	0	1857	0	1805	0.0	0.0
chr6	FBXO30-DT	145828360	145828456	0	97	0	8517	0	8420	0.0	0.0
chr6	FBXO30-DT	145881578	145881648	0	71	0	8517	0	8446	0.0	0.0
chr6	FBXO30-DT	145828360	145828420	0	61	0	8517	0	8456	0.0	0.0
chr6	PCMT1	149772047	149772247	0	201	426	2845	426	2644	0.0	0.16111951588502268
chr6	PCMT1	149772554	149772684	18	131	426	2845	408	2714	0.13740458015267176	0.1503316138540899
chr6	PCMT1	149772013	149772247	0	235	426	2845	426	2610	0.0	0.1632183908045977
chr6	IYD	150395393	150395454	0	62	153	9466	153	9404	0.0	0.01626967247979583
chr6	IYD	150395454	150395566	0	113	153	9466	153	9353	0.0	0.01635838768309633
chr6	ARID1B	157110471	157110561	0	91	8976	37651	8976	37560	0.0	0.2389776357827476
chr6	ARID1B	157133027	157133207	0	181	8976	37651	8976	37470	0.0	0.23955164131305043
chr6	ZDHHC14	157628348	157628374	0	27	621	11143	621	11116	0.0	0.05586541921554516
chr6	ZDHHC14	157628447	157628486	0	40	621	11143	621	11103	0.0	0.05593082950553904
chr6	AL035530.2	159027143	159027230	0	88	81731	11394	81731	11306	0.0	7.22899345480276
chr6	AL035530.2	159040730	159040790	185	61	81731	11394	81546	11333	3.0327868852459017	7.1954469249095565
chr6	SLC22A1	160154797	160154910	763	114	5435	2297	4672	2183	6.692982456140351	2.1401740723774623
chr6	SLC22A1	160155974	160156074	210	101	5435	2297	5225	2196	2.0792079207920793	2.3793260473588345
chr6	ERMARD	169753037	169753181	0	145	600	4289	600	4144	0.0	0.14478764478764478
chr6	ERMARD	169753286	169753372	0	87	600	4289	600	4202	0.0	0.14278914802475012
chr6	ERMARD	169776333	169776411	0	79	600	4289	600	4210	0.0	0.14251781472684086
chr6	ERMARD	169776454	169776673	0	220	600	4289	600	4069	0.0	0.14745637748832638
chr6	ERMARD	169753316	169753372	0	57	600	4289	600	4232	0.0	0.14177693761814744
chr6	ERMARD	169755282	169755422	0	141	600	4289	600	4148	0.0	0.1446480231436837
chr6	ERMARD	169756337	169756439	0	103	600	4289	600	4186	0.0	0.1433349259436216
chr6	SERPINB6	2961893	2962029	4185	137	416205	6054	412020	5917	30.547445255474454	69.63326009802265
chr6	SERPINB6	2968778	2968913	4917	136	416205	6054	411288	5918	36.154411764705884	69.4978033119297
chr6	SERPINB6	2959167	2959342	0	176	416205	6054	416205	5878	0.0	70.80724736304866
chr6	SERPINB6	2966399	2966590	4165	192	416205	6054	412040	5862	21.692708333333332	70.29000341180485
chr6	SERPINB6	2968778	2969102	17431	325	416205	6054	398774	5729	53.63384615384616	69.6062139989527
chr6	SERPINB6	2968798	2968913	4634	116	416205	6054	411571	5938	39.94827586206897	69.31138430447962
chr6	SERPINB6	2960969	2961096	3691	128	416205	6054	412514	5926	28.8359375	69.61086736415795
chr6	SERPINB6	2970695	2970824	2121	130	416205	6054	414084	5924	16.315384615384616	69.89939230249831
chr6	AL033523.1	3595566	3595661	0	96	4735	14663	4735	14567	0.0	0.32504977002814583
chr6	AL033523.1	3663659	3663905	604	247	4735	14663	4131	14416	2.445344129554656	0.2865566037735849
chr6	AL033523.1	3623647	3623943	0	297	4735	14663	4735	14366	0.0	0.32959766114436867
chr6	AL033523.1	3634018	3634059	81	42	4735	14663	4654	14621	1.9285714285714286	0.31830928117091856
chr6	AL033523.1	3611056	3611152	0	97	4735	14663	4735	14566	0.0	0.32507208567897844
chr6	AL033523.1	3609379	3609549	0	171	4735	14663	4735	14492	0.0	0.3267319900634833
chr6	AL033523.1	3632028	3632189	0	162	4735	14663	4735	14501	0.0	0.3265292048824219
chr6	AL033523.1	3609026	3609109	0	84	4735	14663	4735	14579	0.0	0.3247822210028123
chr6	AL033523.1	3653220	3654795	306	1576	4735	14663	4429	13087	0.19416243654822335	0.3384274470848934
chr6	AL033523.1	3653600	3654795	306	1196	4735	14663	4429	13467	0.25585284280936454	0.3288779980693547
chr6	AL033523.1	3631925	3632189	0	265	4735	14663	4735	14398	0.0	0.3288651201555772
chr6	AL033523.1	3607104	3607594	0	491	4735	14663	4735	14172	0.0	0.3341095117132374
chr6	LYRM4	5113070	5113417	276	348	190011	3829	189735	3481	0.7931034482758621	54.50588911232404
chr6	LYRM4	5144137	5144262	0	126	190011	3829	190011	3703	0.0	51.31271941668917
chr6	LY86-AS1	6569417	6569489	0	73	0	9672	0	9599	0.0	0.0
chr6	LY86-AS1	6591155	6591479	0	325	0	9672	0	9347	0.0	0.0
chr6	LY86-AS1	6620754	6621383	0	630	0	9672	0	9042	0.0	0.0
chr6	OFCC1	9809576	9809714	0	139	0	4816	0	4677	0.0	0.0
chr6	OFCC1	9819403	9819424	0	22	0	4816	0	4794	0.0	0.0
chr6	OFCC1	9850397	9850469	0	73	0	4816	0	4743	0.0	0.0
chr6	OFCC1	9896870	9897003	0	134	0	4816	0	4682	0.0	0.0
chr6	C6ORF52	10686965	10687056	0	92	1879	892	1879	800	0.0	2.34875
chr6	C6ORF52	10687479	10687561	0	83	1879	892	1879	809	0.0	2.322620519159456
chr6	NEDD9	11251563	11251726	0	164	5480	8413	5480	8249	0.0	0.6643229482361498
chr6	NEDD9	11305065	11305159	0	95	5480	8413	5480	8318	0.0	0.6588122144746333
chr6	DEK	18258303	18258405	0	103	695559	4668	695559	4565	0.0	152.36779846659365
chr6	DEK	18263842	18263996	381	155	695559	4668	695178	4513	2.458064516129032	154.03899844892533
chr6	LNC-LBCS	19785392	19785440	0	49	11739	12676	11739	12627	0.0	0.9296745070087907
chr6	LNC-LBCS	19802086	19802156	0	71	11739	12676	11739	12605	0.0	0.9312971043236811
chr6	LNC-LBCS	19744030	19744134	0	105	11739	12676	11739	12571	0.0	0.9338159255429163
chr6	LNC-LBCS	19749647	19749758	0	112	11739	12676	11739	12564	0.0	0.9343361986628462
chr6	SLC17A1	25812830	25812992	0	163	0	2032	0	1869	0.0	0.0
chr6	SLC17A1	25813094	25813213	0	120	0	2032	0	1912	0.0	0.0
chr6	ZNF322	26643658	26643728	0	71	95513	5066	95513	4995	0.0	19.121721721721723
chr6	ZNF322	26658557	26658646	150	90	95513	5066	95363	4976	1.6666666666666667	19.16459003215434
chr6	ZSCAN31	28329302	28329778	0	477	12071	3678	12071	3201	0.0	3.7710090596688537
chr6	ZSCAN31	28332284	28332393	864	110	12071	3678	11207	3568	7.8545454545454545	3.14097533632287
chr6	ZSCAN31	28329302	28329714	0	413	12071	3678	12071	3265	0.0	3.6970903522205205
chr6	ZSCAN31	28337798	28337893	51	96	12071	3678	12020	3582	0.53125	3.3556672250139585
chr6	ZSCAN31	28341745	28341795	184	51	12071	3678	11887	3627	3.607843137254902	3.277364212848084
chr6	ZSCAN23	28435459	28435607	0	149	0	3288	0	3139	0.0	0.0
chr6	ZSCAN23	28435858	28436343	0	486	0	3288	0	2802	0.0	0.0
chr6	HLA-F-AS1	29745472	29745727	0	256	0	4187	0	3931	0.0	0.0
chr6	HLA-F-AS1	29747147	29747425	0	279	0	4187	0	3908	0.0	0.0
chr6	HCG18	30291536	30292599	890	1064	134925	15541	134035	14477	0.8364661654135338	9.258478966636734
chr6	HCG18	30294470	30294964	3298	495	134925	15541	131627	15046	6.6626262626262625	8.748305197394656
chr6	HCG18	30314268	30314482	26664	215	134925	15541	108261	15326	124.01860465116279	7.063878376614903
chr6	HCG18	30326150	30326263	0	114	134925	15541	134925	15427	0.0	8.746029688208985
chr6	NRM	30689275	30689452	1271	178	7539171	2051	7537900	1873	7.140449438202247	4024.5061398825414
chr6	NRM	30690046	30690243	6828	198	7539171	2051	7532343	1853	34.484848484848484	4064.9449541284403
chr6	LSM2	31798476	31798507	0	32	492649	1066	492649	1034	0.0	476.4497098646035
chr6	LSM2	31806074	31806142	4015	69	492649	1066	488634	997	58.18840579710145	490.10431293881646
chr6	AGER	32181350	32181477	0	128	0	1715	0	1587	0.0	0.0
chr6	AGER	32181523	32181632	0	110	0	1715	0	1605	0.0	0.0
chr6	TSBP1	32315771	32315792	0	22	34062	2235	34062	2213	0.0	15.391775869859918
chr6	TSBP1	32322485	32322506	0	22	34062	2235	34062	2213	0.0	15.391775869859918
chr6	HLA-DMB	32935341	32935377	185	37	6381	2610	6196	2573	5.0	2.408083948698018
chr6	HLA-DMB	32935535	32935652	0	118	6381	2610	6381	2492	0.0	2.560593900481541
chr6	TAPBP	33313216	33313477	0	262	0	4844	0	4582	0.0	0.0
chr6	TAPBP	33313693	33313864	0	172	0	4844	0	4672	0.0	0.0
chr6	IP6K3	33739132	33739261	29476	130	30795	2801	1319	2671	226.73846153846154	0.4938225383751404
chr6	IP6K3	33746587	33746633	44	47	30795	2801	30751	2754	0.9361702127659575	11.165940450254176
chr6	TCP11	35137690	35137852	0	163	0	3084	0	2921	0.0	0.0
chr6	TCP11	35140019	35140225	0	207	0	3084	0	2877	0.0	0.0
chr6	TCP11	35136106	35136203	0	98	0	3084	0	2986	0.0	0.0
chr6	TCP11	35136106	35136218	0	113	0	3084	0	2971	0.0	0.0
chr6	TCP11	35140746	35140884	0	139	0	3084	0	2945	0.0	0.0
chr6	TCP11	35128282	35128419	0	138	0	3084	0	2946	0.0	0.0
chr6	TCP11	35128579	35128791	0	213	0	3084	0	2871	0.0	0.0
chr6	TEAD3	35480059	35480122	0	64	0	3063	0	2999	0.0	0.0
chr6	TEAD3	35480311	35480374	0	64	0	3063	0	2999	0.0	0.0
chr6	ETV7	36375870	36376035	0	166	35	2383	35	2217	0.0	0.015787099684258007
chr6	ETV7	36385533	36385669	0	137	35	2383	35	2246	0.0	0.015583259127337488
chr6	TMEM217	37215197	37215282	42	86	727	2617	685	2531	0.4883720930232558	0.27064401422362705
chr6	TMEM217	37218425	37219041	0	617	727	2617	727	2000	0.0	0.3635
chr6	TMEM217	37213210	37213319	0	110	727	2617	727	2507	0.0	0.2899880335061827
chr6	TMEM217	37218474	37219041	0	568	727	2617	727	2049	0.0	0.3548072230356271
chr6	TMEM217	37215940	37215966	0	27	727	2617	727	2590	0.0	0.2806949806949807
chr6	BTBD9	38402816	38402903	29	88	185	9553	156	9465	0.32954545454545453	0.01648177496038035
chr6	BTBD9	38504493	38504562	0	70	185	9553	185	9483	0.0	0.019508594326689867
chr6	CCND3	41940369	41940585	0	217	42639	5772	42639	5555	0.0	7.675787578757876
chr6	CCND3	42030008	42030190	279	183	42639	5772	42360	5589	1.5245901639344261	7.5791733762748255
chr6	CCND3	41940951	41941161	0	211	42639	5772	42639	5561	0.0	7.667505844272613
chr6	SLC35B2	44256341	44256496	0	156	102	2369	102	2213	0.0	0.04609127880704925
chr6	SLC35B2	44256684	44256878	0	195	102	2369	102	2174	0.0	0.046918123275068994
chr6	CLIC5	45902924	45903255	0	332	51	6919	51	6587	0.0	0.007742523151662365
chr6	CLIC5	45913777	45913812	0	36	51	6919	51	6883	0.0	0.007409559784977481
chr6	ADGRF1	47027703	47027761	0	59	204	10686	204	10627	0.0	0.019196386562529408
chr6	ADGRF1	47028992	47029104	0	113	204	10686	204	10573	0.0	0.01929442920646931
chr6	GSTA1	52796181	52796314	0	134	51	1269	51	1135	0.0	0.044933920704845816
chr6	GSTA1	52797585	52797637	0	53	51	1269	51	1216	0.0	0.04194078947368421
chr6	MLIP-AS1	54041040	54041073	0	34	0	4048	0	4014	0.0	0.0
chr6	MLIP-AS1	54043351	54043427	0	77	0	4048	0	3971	0.0	0.0
chr6	MLIP-AS1	54032376	54032436	0	61	0	4048	0	3987	0.0	0.0
chr6	HMGCLL1	55563818	55563914	0	97	51	4792	51	4695	0.0	0.010862619808306708
chr6	HMGCLL1	55577077	55577167	0	91	51	4792	51	4701	0.0	0.010848755583918315
chr6	HMGCLL1	55566503	55566628	0	126	51	4792	51	4666	0.0	0.01093013287612516
chr6	ZNF451-AS1	57116425	57116547	0	123	204	4544	204	4421	0.0	0.04614340646912463
chr6	ZNF451-AS1	57134146	57134215	0	70	204	4544	204	4474	0.0	0.045596781403665625
chr6	ZNF451-AS1	57151027	57151195	0	169	204	4544	204	4375	0.0	0.04662857142857143
chr6	ZNF451-AS1	57151822	57151906	0	85	204	4544	204	4459	0.0	0.04575016819914779
chr6	ZNF451-AS1	57116839	57116921	0	83	204	4544	204	4461	0.0	0.04572965702757229
chr6	AL713998.1	67883603	67883876	0	274	51	5335	51	5061	0.0	0.01007705986959099
chr6	AL713998.1	67886967	67887398	0	432	51	5335	51	4903	0.0	0.010401794819498267
chr6	AL713998.1	67886967	67888821	51	1855	51	5335	0	3480	0.027493261455525605	0.0
chr6	AL713998.1	67886967	67887069	0	103	51	5335	51	5232	0.0	0.00974770642201835
chr6	AL713998.1	67886986	67887398	0	413	51	5335	51	4922	0.0	0.01036164160910199
chr6	LMBRD1	69705500	69705619	0	120	0	8302	0	8182	0.0	0.0
chr6	LMBRD1	69708849	69709231	0	383	0	8302	0	7919	0.0	0.0
chr6	LMBRD1	69743783	69743881	0	99	0	8302	0	8203	0.0	0.0
chr6	LMBRD1	69743987	69744047	0	61	0	8302	0	8241	0.0	0.0
chr6	LMBRD1	69748223	69748289	0	67	0	8302	0	8235	0.0	0.0
chr6	LMBRD1	69749340	69749408	0	69	0	8302	0	8233	0.0	0.0
chr6	LMBRD1	69752258	69752356	0	99	0	8302	0	8203	0.0	0.0
chr6	LMBRD1	69798114	69798289	0	176	0	8302	0	8126	0.0	0.0
chr6	LMBRD1	69824488	69824552	0	65	0	8302	0	8237	0.0	0.0
chr6	LMBRD1	69709156	69709231	0	76	0	8302	0	8226	0.0	0.0
chr6	LMBRD1	69710424	69710444	0	21	0	8302	0	8281	0.0	0.0
chr6	AL589935.1	71313053	71313146	0	94	7201	5018	7201	4924	0.0	1.4624289195775793
chr6	AL589935.1	71326329	71326620	0	292	7201	5018	7201	4726	0.0	1.5236986881083368
chr6	AL589935.1	71314706	71314785	0	80	7201	5018	7201	4938	0.0	1.4582827055488052
chr6	AL589935.1	71313844	71314189	0	346	7201	5018	7201	4672	0.0	1.5413099315068493
chr6	AL589935.1	71313844	71314164	0	321	7201	5018	7201	4697	0.0	1.5331062380242708
chr6	COX7A2	75240300	75240385	0	86	0	1928	0	1842	0.0	0.0
chr6	COX7A2	75241175	75241265	0	91	0	1928	0	1837	0.0	0.0
chr6	TMEM30A	75265230	75265338	0	109	101	5513	101	5404	0.0	0.018689859363434494
chr6	TMEM30A	75267640	75267748	0	109	101	5513	101	5404	0.0	0.018689859363434494
chr6	LINC02542	82146540	82146617	0	78	333	2815	333	2737	0.0	0.1216660577274388
chr6	LINC02542	82160630	82160754	0	125	333	2815	333	2690	0.0	0.12379182156133829
chr6	PGM3	83190808	83191014	0	207	153	5939	153	5732	0.0	0.026692254012561062
chr6	PGM3	83191186	83191323	0	138	153	5939	153	5801	0.0	0.026374762971901396
chr6	CEP162	84217798	84217860	0	63	0	5511	0	5448	0.0	0.0
chr6	CEP162	84219102	84219214	0	113	0	5511	0	5398	0.0	0.0
chr6	SNHG5	85666003	85666147	0	145	0	7815	0	7670	0.0	0.0
chr6	SNHG5	85677092	85677191	0	100	0	7815	0	7715	0.0	0.0
chr6	SNHG5	85668112	85668274	0	163	0	7815	0	7652	0.0	0.0
chr6	SNHG5	85677423	85677492	0	70	0	7815	0	7745	0.0	0.0
chr6	SNHG5	85677953	85678032	0	80	0	7815	0	7735	0.0	0.0
chr6	SNHG5	85676984	85677191	0	208	0	7815	0	7607	0.0	0.0
chr6	SNHG5	85677794	85677875	0	82	0	7815	0	7733	0.0	0.0
chr6	CGA	87088868	87089167	0	300	0	1990	0	1690	0.0	0.0
chr6	CGA	87094828	87094880	0	53	0	1990	0	1937	0.0	0.0
chr6	BACH2	90252512	90252590	0	79	298	9799	298	9720	0.0	0.03065843621399177
chr6	BACH2	90271848	90271941	0	94	298	9799	298	9705	0.0	0.030705821741370428
chr6	UFL1-AS1	96460485	96460612	0	128	0	6546	0	6418	0.0	0.0
chr6	UFL1-AS1	96519294	96519375	0	82	0	6546	0	6464	0.0	0.0
chr6	CCNC	99561596	99561681	0	86	0	5627	0	5541	0.0	0.0
chr6	CCNC	99562841	99562948	0	108	0	5627	0	5519	0.0	0.0
chr6	LINC02532	106725341	106725389	0	49	14827	11311	14827	11262	0.0	1.316551234239034
chr6	LINC02532	106733575	106733663	0	89	14827	11311	14827	11222	0.0	1.3212439850294064
chr6	LINC02532	106749633	106749788	0	156	14827	11311	14827	11155	0.0	1.3291797400268939
chr6	LINC02532	106772237	106772361	0	125	14827	11311	14827	11186	0.0	1.3254961559091722
chr6	LINC02532	106756104	106756261	1393	158	14827	11311	13434	11153	8.816455696202532	1.2045189635075764
chr6	LINC02532	106774776	106775000	0	225	14827	11311	14827	11086	0.0	1.3374526429731193
chr6	LINC02532	106765017	106765219	0	203	14827	11311	14827	11108	0.0	1.3348037450486137
chr6	LINC02532	106765017	106765196	0	180	14827	11311	14827	11131	0.0	1.3320456383074297
chr6	SCML4	107755570	107755664	0	95	153	8568	153	8473	0.0	0.01805735866871238
chr6	SCML4	107772171	107772386	0	216	153	8568	153	8352	0.0	0.018318965517241378
chr6	CD164	109370410	109370467	0	58	667	6868	667	6810	0.0	0.09794419970631424
chr6	CD164	109376073	109376112	0	40	667	6868	667	6828	0.0	0.09768599882835384
chr6	PPIL6	109403030	109403108	0	79	845	4492	845	4413	0.0	0.19147971901200997
chr6	PPIL6	109404928	109405048	0	121	845	4492	845	4371	0.0	0.193319606497369
chr6	WASF1	110160634	110160732	0	99	51	3135	51	3036	0.0	0.016798418972332016
chr6	WASF1	110178597	110178742	0	146	51	3135	51	2989	0.0	0.01706256273001004
chr6	DDO	110404773	110404950	0	178	0	2148	0	1970	0.0	0.0
chr6	DDO	110408333	110408442	0	110	0	2148	0	2038	0.0	0.0
chr6	CDK19	110632029	110632161	0	133	0	7662	0	7529	0.0	0.0
chr6	CDK19	110638648	110638706	0	59	0	7662	0	7603	0.0	0.0
chr6	TRAF3IP2	111595702	111595820	2006	119	21938	7884	19932	7765	16.857142857142858	2.5669027688345136
chr6	TRAF3IP2	111601195	111601306	3	112	21938	7884	21935	7772	0.026785714285714284	2.822310859495625
chr6	TRAF3IP2	111601195	111601318	3	124	21938	7884	21935	7760	0.024193548387096774	2.8266752577319587
chr6	FYN	111699514	111699670	0	157	11800	6971	11800	6814	0.0	1.7317287936601116
chr6	FYN	111700103	111700268	0	166	11800	6971	11800	6805	0.0	1.7340191036002939
chr6	FYN	111780565	111780635	0	71	11800	6971	11800	6900	0.0	1.710144927536232
chr6	FYN	111846588	111846629	0	42	11800	6971	11800	6929	0.0	1.702987444075624
chr6	FYN	111740980	111741093	0	114	11800	6971	11800	6857	0.0	1.7208691847746829
chr6	FYN	111754433	111754677	0	245	11800	6971	11800	6726	0.0	1.7543859649122806
chr6	FYN	111740980	111741097	0	118	11800	6971	11800	6853	0.0	1.7218736319859915
chr6	HDAC2	113962366	113962394	0	29	357	12521	357	12492	0.0	0.028578290105667627
chr6	HDAC2	113968633	113968696	0	64	357	12521	357	12457	0.0	0.02865858553423778
chr6	FAM184A	118960768	118960863	0	96	2462	7735	2462	7639	0.0	0.3222934939128158
chr6	FAM184A	118961760	118961963	0	204	2462	7735	2462	7531	0.0	0.3269154162793786
chr6	FAM184A	118961928	118961963	0	36	2462	7735	2462	7699	0.0	0.31978178984283673
chr6	FAM184A	118961928	118961996	0	69	2462	7735	2462	7666	0.0	0.32115836159666056
chr6	RNF217-AS1	124941389	124941524	0	136	0	11186	0	11050	0.0	0.0
chr6	RNF217-AS1	124945298	124945439	0	142	0	11186	0	11044	0.0	0.0
chr6	RNF217-AS1	124941389	124941604	0	216	0	11186	0	10970	0.0	0.0
chr6	HDDC2	125292840	125292909	0	70	918	4375	918	4305	0.0	0.2132404181184669
chr6	HDDC2	125298649	125298816	0	168	918	4375	918	4207	0.0	0.21820774898977893
chr6	AL450332.1	125408493	125408622	1857	130	60880	4796	59023	4666	14.284615384615385	12.649592798971282
chr6	AL450332.1	125438079	125438236	0	158	60880	4796	60880	4638	0.0	13.126347563605002
chr6	AL356534.1	126943385	126943608	0	224	1763	36890	1763	36666	0.0	0.04808269241258932
chr6	AL356534.1	127004184	127004398	130	215	1763	36890	1633	36675	0.6046511627906976	0.04452624403544649
chr6	AL356534.1	127000282	127000383	0	102	1763	36890	1763	36788	0.0	0.047923235837773186
chr6	AL356534.1	126701943	126702106	561	164	1763	36890	1202	36726	3.4207317073170733	0.03272885694058705
chr6	AL356534.1	126717332	126717474	0	143	1763	36890	1763	36747	0.0	0.047976705581408007
chr6	AL356534.1	126894281	126894385	0	105	1763	36890	1763	36785	0.0	0.047927144216392555
chr6	AL356534.1	126910950	126911018	0	69	1763	36890	1763	36821	0.0	0.047880285706526166
chr6	AL356534.1	127022010	127022081	0	72	1763	36890	1763	36818	0.0	0.04788418708240535
chr6	AL356534.1	126819391	126819514	0	124	1763	36890	1763	36766	0.0	0.04795191209269434
chr6	AL356534.1	126873151	126873270	0	120	1763	36890	1763	36770	0.0	0.04794669567582268
chr6	ECHDC1	127315134	127315138	0	5	0	5138	0	5133	0.0	0.0
chr6	ECHDC1	127316449	127316502	0	54	0	5138	0	5084	0.0	0.0
chr6	ECHDC1	127315933	127315974	0	42	0	5138	0	5096	0.0	0.0
chr6	PTPRK	128409293	128409332	0	40	6303	7983	6303	7943	0.0	0.7935288933652273
chr6	PTPRK	128491731	128491849	539	119	6303	7983	5764	7864	4.529411764705882	0.7329603255340793
chr6	EPB41L2	130869562	130870126	0	565	0	10058	0	9493	0.0	0.0
chr6	EPB41L2	130870327	130870381	0	55	0	10058	0	10003	0.0	0.0
chr6	EPB41L2	130867458	130867581	0	124	0	10058	0	9934	0.0	0.0
chr6	EPB41L2	130869811	130870126	0	316	0	10058	0	9742	0.0	0.0
chr6	EPB41L2	130872370	130872538	0	169	0	10058	0	9889	0.0	0.0
chr6	EPB41L2	130876673	130876775	0	103	0	10058	0	9955	0.0	0.0
chr6	VNN3	132726721	132727012	0	292	1467	5404	1467	5112	0.0	0.2869718309859155
chr6	VNN3	132728740	132728979	0	240	1467	5404	1467	5164	0.0	0.2840821068938807
chr6	VNN3	132726721	132726838	0	118	1467	5404	1467	5286	0.0	0.2775255391600454
chr6	VNN3	132728740	132728933	0	194	1467	5404	1467	5210	0.0	0.281573896353167
chr6	VNN2	132752672	132752749	0	78	0	2606	0	2528	0.0	0.0
chr6	VNN2	132753417	132753491	0	75	0	2606	0	2531	0.0	0.0
chr6	VNN2	132752460	132752749	0	290	0	2606	0	2316	0.0	0.0
chr6	HBS1L	135039572	135039767	0	196	30	10065	30	9869	0.0	0.003039821663795724
chr6	HBS1L	135042000	135042126	0	127	30	10065	30	9938	0.0	0.0030187160394445564
chr6	HBS1L	135050581	135050647	0	67	30	10065	30	9998	0.0	0.0030006001200240046
chr6	AL138828.1	136110995	136111101	0	107	612	7340	612	7233	0.0	0.08461219411032767
chr6	AL138828.1	136162017	136162144	0	128	612	7340	612	7212	0.0	0.08485856905158069
chr6	IFNGR1	137209849	137209972	0	124	6407	2945	6407	2821	0.0	2.271180432470755
chr6	IFNGR1	137215266	137215377	0	112	6407	2945	6407	2833	0.0	2.261560183551006
chr6	IFNGR1	137209849	137209984	0	136	6407	2945	6407	2809	0.0	2.2808828764684943
chr6	AL031772.1	139201674	139201783	0	110	4393	5167	4393	5057	0.0	0.8686968558433854
chr6	AL031772.1	139237379	139237505	166	127	4393	5167	4227	5040	1.3070866141732282	0.8386904761904762
chr6	LINC01277	142970987	142971041	44	55	44	4191	0	4136	0.8	0.0
chr6	LINC01277	142985468	142985581	0	114	44	4191	44	4077	0.0	0.010792249202845229
chr6	PLAGL1	143947984	143948460	0	477	0	8363	0	7886	0.0	0.0
chr6	PLAGL1	143960468	143960542	0	75	0	8363	0	8288	0.0	0.0
chr6	PLAGL1	143964786	143964818	0	33	0	8363	0	8330	0.0	0.0
chr6	PLAGL1	143966157	143966198	0	42	0	8363	0	8321	0.0	0.0
chr6	STXBP5-AS1	146860617	146860743	0	127	1218	11664	1218	11537	0.0	0.10557337262719944
chr6	STXBP5-AS1	146911551	146911663	0	113	1218	11664	1218	11551	0.0	0.10544541598130032
chr6	STXBP5-AS1	146911551	146911665	0	115	1218	11664	1218	11549	0.0	0.10546367650878864
chr6	STXBP5-AS1	146962390	146962566	0	177	1218	11664	1218	11487	0.0	0.10603290676416818
chr6	STXBP5-AS1	147001440	147001543	0	104	1218	11664	1218	11560	0.0	0.10536332179930796
chr6	STXBP5-AS1	146972044	146972070	0	27	1218	11664	1218	11637	0.0	0.10466615106986336
chr6	STXBP5-AS1	146864383	146864602	72	220	1218	11664	1146	11444	0.32727272727272727	0.10013981125480602
chr6	STXBP5-AS1	147074804	147074847	0	44	1218	11664	1218	11620	0.0	0.10481927710843374
chr6	NUP43	149738642	149738778	0	137	24204	4429	24204	4292	0.0	5.63932898415657
chr6	NUP43	149742389	149742570	0	182	24204	4429	24204	4247	0.0	5.699081704732753
chr6	SYNE1	152347058	152347235	0	178	780	42788	780	42610	0.0	0.01830556207463037
chr6	SYNE1	152350167	152350335	0	169	780	42788	780	42619	0.0	0.018301696426476454
chr6	LINC02840	152765987	152766062	0	76	0	8955	0	8879	0.0	0.0
chr6	LINC02840	152831052	152831268	0	217	0	8955	0	8738	0.0	0.0
chr6	SERAC1	158146781	158146913	0	133	0	9775	0	9642	0.0	0.0
chr6	SERAC1	158148864	158148954	0	91	0	9775	0	9684	0.0	0.0
chr6	SERAC1	158128107	158128270	0	164	0	9775	0	9611	0.0	0.0
chr6	SERAC1	158130372	158130486	0	115	0	9775	0	9660	0.0	0.0
chr6	SOD2	159684853	159685033	102	181	8459	6793	8357	6612	0.56353591160221	1.263914095583787
chr6	SOD2	159688125	159688242	0	118	8459	6793	8459	6675	0.0	1.2672659176029963
chr6	PRKN	162054090	162054174	0	85	1776	12056	1776	11971	0.0	0.1483585331217108
chr6	PRKN	162201130	162201252	0	123	1776	12056	1776	11933	0.0	0.14883097293220482
chr6	PRKN	162262524	162262765	0	242	1776	12056	1776	11814	0.0	0.15033011681056374
chr6	PRKN	162443309	162443473	0	165	1776	12056	1776	11891	0.0	0.14935665629467665
chr6	AL450345.2	164806065	164806198	0	134	0	3937	0	3803	0.0	0.0
chr6	AL450345.2	164813831	164814042	0	212	0	3937	0	3725	0.0	0.0
chr6	PDE10A	165454577	165454695	0	119	17	23062	17	22943	0.0	0.000740966743669093
chr6	PDE10A	165466419	165466532	0	114	17	23062	17	22948	0.0	0.0007408052989367265
chr6	MPC1	166369465	166369469	0	5	0	1554	0	1549	0.0	0.0
chr6	MPC1	166370217	166370221	0	5	0	1554	0	1549	0.0	0.0
chr6	MPC1	166366968	166367187	0	220	0	1554	0	1334	0.0	0.0
chr6	WDR27	169458220	169458464	0	245	4199	10533	4199	10288	0.0	0.40814541213063765
chr6	WDR27	169572418	169572540	408	123	4199	10533	3791	10410	3.317073170731707	0.36416906820365036
chr6	WDR27	169659085	169659207	0	123	4199	10533	4199	10410	0.0	0.40336215177713736
chr6	WDR27	169659450	169659518	0	69	4199	10533	4199	10464	0.0	0.40128058103975534
chr6	WDR27	169670568	169670693	0	126	4199	10533	4199	10407	0.0	0.4034784279811665
chr6	WDR27	169670878	169670957	0	80	4199	10533	4199	10453	0.0	0.40170286042284514
chr7	SUN1	817279	817499	478	221	181809	10878	181331	10657	2.16289592760181	17.015201276156517
chr7	SUN1	832019	832101	174	83	181809	10878	181635	10795	2.0963855421686746	16.82584529874942
chr7	PSMG3-AS1	1579286	1579404	246	119	6661	5168	6415	5049	2.0672268907563027	1.2705486234898
chr7	PSMG3-AS1	1583161	1583269	0	109	6661	5168	6661	5059	0.0	1.3166633722079462
chr7	UMAD1	7676101	7676208	1447	108	1877	3764	430	3656	13.398148148148149	0.11761487964989059
chr7	UMAD1	7738710	7738891	0	182	1877	3764	1877	3582	0.0	0.5240089335566722
chr7	SCIN	12571544	12571625	0	82	0	11649	0	11567	0.0	0.0
chr7	SCIN	12577541	12577759	0	219	0	11649	0	11430	0.0	0.0
chr7	CRPPA-AS1	16216332	16216569	0	238	105	2784	105	2546	0.0	0.04124116260801257
chr7	CRPPA-AS1	16235901	16235979	0	79	105	2784	105	2705	0.0	0.038817005545286505
chr7	CRPPA-AS1	16216383	16216569	0	187	105	2784	105	2597	0.0	0.04043126684636118
chr7	DNAH11	21681678	21681684	0	7	273	16261	273	16254	0.0	0.016795865633074936
chr7	DNAH11	21681721	21681727	0	7	273	16261	273	16254	0.0	0.016795865633074936
chr7	SNHG26	22856972	22857016	0	45	131681	5723	131681	5678	0.0	23.191440648115535
chr7	SNHG26	22858570	22858976	5202	407	131681	5723	126479	5316	12.781326781326781	23.792136945071483
chr7	SNHG26	22858570	22858830	3287	261	131681	5723	128394	5462	12.593869731800766	23.506774075430247
chr7	FAM221A	23692182	23692253	0	72	1663	5529	1663	5457	0.0	0.3047461975444383
chr7	FAM221A	23698191	23698299	0	109	1663	5529	1663	5420	0.0	0.30682656826568266
chr7	AC004540.1	26412184	26412239	46	56	46	6357	0	6301	0.8214285714285714	0.0
chr7	AC004540.1	26440369	26440505	0	137	46	6357	46	6220	0.0	0.007395498392282958
chr7	AC004540.1	26403395	26403517	0	123	46	6357	46	6234	0.0	0.007378889958293231
chr7	CHN2	29504743	29504821	0	79	0	6384	0	6305	0.0	0.0
chr7	CHN2	29509300	29509406	0	107	0	6384	0	6277	0.0	0.0
chr7	CHN2	29499866	29500040	0	175	0	6384	0	6209	0.0	0.0
chr7	GARS1	30606325	30606397	1156	73	76999	11228	75843	11155	15.835616438356164	6.799013895114299
chr7	GARS1	30608407	30608483	2234	77	76999	11228	74765	11151	29.01298701298701	6.70477984037306
chr7	ADCYAP1R1	31095666	31095750	0	85	28	7004	28	6919	0.0	0.004046827576239341
chr7	ADCYAP1R1	31100126	31100210	0	85	28	7004	28	6919	0.0	0.004046827576239341
chr7	BBS9	33351218	33351323	0	106	717	8800	717	8694	0.0	0.08247066942719117
chr7	BBS9	33352858	33352873	0	16	717	8800	717	8784	0.0	0.08162568306010928
chr7	BMPER	33976997	33977115	999	119	20571	8014	19572	7895	8.394957983193278	2.479037365421153
chr7	BMPER	34046305	34046405	0	101	20571	8014	20571	7913	0.0	2.5996461519019336
chr7	BMPER	34062001	34062047	0	47	20571	8014	20571	7967	0.0	2.582025856658717
chr7	BMPER	34078984	34079186	0	203	20571	8014	20571	7811	0.0	2.633593649980796
chr7	BMPER	33939951	33940021	0	71	20571	8014	20571	7943	0.0	2.5898275210877504
chr7	BMPER	33944191	33944308	0	118	20571	8014	20571	7896	0.0	2.605243161094225
chr7	NPSR1	34778461	34778565	0	105	0	2708	0	2603	0.0	0.0
chr7	NPSR1	34811769	34811863	0	95	0	2708	0	2613	0.0	0.0
chr7	GPR141	37685459	37685583	0	125	0	2321	0	2196	0.0	0.0
chr7	GPR141	37729915	37730038	0	124	0	2321	0	2197	0.0	0.0
chr7	STARD3NL	38179089	38179145	0	57	279	2309	279	2252	0.0	0.1238898756660746
chr7	STARD3NL	38202069	38202197	0	129	279	2309	279	2180	0.0	0.12798165137614678
chr7	STARD3NL	38201713	38201966	0	254	279	2309	279	2055	0.0	0.13576642335766423
chr7	STARD3NL	38198210	38198365	0	156	279	2309	279	2153	0.0	0.12958662331630283
chr7	LINC00265	39742049	39742177	651	129	4475	6805	3824	6676	5.046511627906977	0.572798082684242
chr7	LINC00265	39763547	39763671	0	125	4475	6805	4475	6680	0.0	0.6699101796407185
chr7	LINC00265	39744291	39744384	0	94	4475	6805	4475	6711	0.0	0.6668156757562211
chr7	DBNL	44050224	44050280	0	57	31858	12166	31858	12109	0.0	2.630935667685193
chr7	DBNL	44051829	44051942	3089	114	31858	12166	28769	12052	27.096491228070175	2.38707268503153
chr7	DBNL	44052866	44052941	1438	76	31858	12166	30420	12090	18.92105263157895	2.5161290322580645
chr7	DBNL	44056756	44056903	0	148	31858	12166	31858	12018	0.0	2.650857047761691
chr7	OGDH	44647443	44647534	0	92	11949	5234	11949	5142	0.0	2.323803967327888
chr7	OGDH	44647656	44647759	140	104	11949	5234	11809	5130	1.3461538461538463	2.3019493177387913
chr7	PPIA	44797519	44797621	13989	103	572968	5460	558979	5357	135.81553398058253	104.34552921411237
chr7	PPIA	44798747	44798904	5090	158	572968	5460	567878	5302	32.21518987341772	107.10637495284799
chr7	PPIA	44798747	44798814	537	68	572968	5460	572431	5392	7.897058823529412	106.16301928783383
chr7	CCM2	45038252	45038426	0	175	5771	7220	5771	7045	0.0	0.8191625266146203
chr7	CCM2	45063917	45064001	280	85	5771	7220	5491	7135	3.2941176470588234	0.7695865451997197
chr7	CCM2	45064462	45064646	0	185	5771	7220	5771	7035	0.0	0.8203269367448472
chr7	CCM2	45068442	45068579	0	138	5771	7220	5771	7082	0.0	0.8148828014685118
chr7	IKZF1	50368005	50368065	0	61	0	10578	0	10517	0.0	0.0
chr7	IKZF1	50376532	50376793	0	262	0	10578	0	10316	0.0	0.0
chr7	LINC01445	54334227	54334296	0	70	51	8479	51	8409	0.0	0.006064930431680342
chr7	LINC01445	54339129	54339220	0	92	51	8479	51	8387	0.0	0.006080839394300703
chr7	LINC01445	54343640	54344342	0	703	51	8479	51	7776	0.0	0.006558641975308642
chr7	SUMF2	56074173	56074218	0	46	73001	3936	73001	3890	0.0	18.766323907455014
chr7	SUMF2	56074585	56074736	0	152	73001	3936	73001	3784	0.0	19.292019027484145
chr7	SUMF2	56072996	56073111	0	116	73001	3936	73001	3820	0.0	19.11020942408377
chr7	SUMF2	56076833	56076889	0	57	73001	3936	73001	3879	0.0	18.819541118845063
chr7	AC237221.1	57407073	57407170	0	98	0	4007	0	3909	0.0	0.0
chr7	AC237221.1	57407482	57407550	0	69	0	4007	0	3938	0.0	0.0
chr7	ZNF138	64815571	64815653	140	83	2377	2856	2237	2773	1.6867469879518073	0.8067075369635773
chr7	ZNF138	64830939	64831076	153	138	2377	2856	2224	2718	1.108695652173913	0.8182487122884474
chr7	ZNF138	64815575	64815653	140	79	2377	2856	2237	2777	1.7721518987341771	0.8055455527547714
chr7	ZNF92	65387901	65388028	285	128	6169	3517	5884	3389	2.2265625	1.7362053703157274
chr7	ZNF92	65388805	65388901	102	97	6169	3517	6067	3420	1.0515463917525774	1.7739766081871344
chr7	TPST1	66205793	66205921	94	129	116056	2816	115962	2687	0.7286821705426356	43.1566803126163
chr7	TPST1	66209852	66209904	0	53	116056	2816	116056	2763	0.0	42.00361925443359
chr7	AUTS2	70787085	70787137	0	53	2998	24173	2998	24120	0.0	0.12429519071310116
chr7	AUTS2	70787208	70787431	0	224	2998	24173	2998	23949	0.0	0.12518267986137208
chr7	BUD23	73686998	73687095	0	98	1476	5292	1476	5194	0.0	0.2841740469772815
chr7	BUD23	73690915	73691012	0	98	1476	5292	1476	5194	0.0	0.2841740469772815
chr7	ELN	74043878	74043920	0	43	293	6338	293	6295	0.0	0.04654487688641779
chr7	ELN	74046187	74046217	0	31	293	6338	293	6307	0.0	0.046456318376407166
chr7	ELN	74042613	74042706	0	94	293	6338	293	6244	0.0	0.04692504804612428
chr7	EIF4H	74178655	74178826	0	172	57550	4839	57550	4667	0.0	12.331262052710521
chr7	EIF4H	74179337	74179418	0	82	57550	4839	57550	4757	0.0	12.097960899726719
chr7	DTX2	76470299	76470419	0	121	0	5061	0	4940	0.0	0.0
chr7	DTX2	76477113	76477178	0	66	0	5061	0	4995	0.0	0.0
chr7	DTX2	76463444	76463709	0	266	0	5061	0	4795	0.0	0.0
chr7	DTX2	76476942	76477178	0	237	0	5061	0	4824	0.0	0.0
chr7	DTX2	76463544	76463709	0	166	0	5061	0	4895	0.0	0.0
chr7	DTX2	76480420	76480777	0	358	0	5061	0	4703	0.0	0.0
chr7	PTPN12	77581426	77581503	0	78	6385	5154	6385	5076	0.0	1.257880220646178
chr7	PTPN12	77583554	77583650	0	97	6385	5154	6385	5057	0.0	1.2626062883132292
chr7	MAGI2-AS3	79453586	79453655	0	70	153	16832	153	16762	0.0	0.009127789046653144
chr7	MAGI2-AS3	79454865	79455007	0	143	153	16832	153	16689	0.0	0.009167715261549523
chr7	DMTF1	87154389	87154528	0	140	0	7275	0	7135	0.0	0.0
chr7	DMTF1	87163238	87163332	0	95	0	7275	0	7180	0.0	0.0
chr7	DMTF1	87164933	87165050	0	118	0	7275	0	7157	0.0	0.0
chr7	DMTF1	87166482	87166605	0	124	0	7275	0	7151	0.0	0.0
chr7	DMTF1	87155454	87155497	0	44	0	7275	0	7231	0.0	0.0
chr7	DMTF1	87163494	87163617	0	124	0	7275	0	7151	0.0	0.0
chr7	AC003991.1	88232919	88233114	0	196	0	4852	0	4656	0.0	0.0
chr7	AC003991.1	88271762	88271870	0	109	0	4852	0	4743	0.0	0.0
chr7	AC003991.1	88276955	88277169	0	215	0	4852	0	4637	0.0	0.0
chr7	AC003991.1	88283831	88283909	0	79	0	4852	0	4773	0.0	0.0
chr7	AC002383.1	89474894	89475043	0	150	0	2016	0	1866	0.0	0.0
chr7	AC002383.1	89490119	89490274	0	156	0	2016	0	1860	0.0	0.0
chr7	GTPBP10	90354457	90354549	0	93	0	10450	0	10357	0.0	0.0
chr7	GTPBP10	90355085	90355230	0	146	0	10450	0	10304	0.0	0.0
chr7	GTPBP10	90372154	90372228	0	75	0	10450	0	10375	0.0	0.0
chr7	CDK14	90608529	90608575	0	47	206	6964	206	6917	0.0	0.029781697267601562
chr7	CDK14	90666339	90666411	0	73	206	6964	206	6891	0.0	0.02989406472210129
chr7	VPS50	93240715	93240818	0	104	2191	9328	2191	9224	0.0	0.23753252385082393
chr7	VPS50	93246101	93246129	0	29	2191	9328	2191	9299	0.0	0.23561673298204108
chr7	COL1A2	94397747	94397758	0	12	0	8695	0	8683	0.0	0.0
chr7	COL1A2	94398373	94398378	0	6	0	8695	0	8689	0.0	0.0
chr7	CPSF4	99450275	99450371	0	97	51	3985	51	3888	0.0	0.013117283950617283
chr7	CPSF4	99450701	99450795	0	95	51	3985	51	3890	0.0	0.013110539845758355
chr7	ZNF655	99561887	99561973	0	87	1091	7216	1091	7129	0.0	0.15303689156964512
chr7	ZNF655	99571259	99571379	51	121	1091	7216	1040	7095	0.4214876033057851	0.14658210007047218
chr7	CYP3A43	99849978	99850099	0	122	62	2652	62	2530	0.0	0.02450592885375494
chr7	CYP3A43	99855590	99855718	0	129	62	2652	62	2523	0.0	0.024573919936583432
chr7	CYP3A43	99836452	99836546	0	95	62	2652	62	2557	0.0	0.024247164646069613
chr7	CYP3A43	99839119	99839172	0	54	62	2652	62	2598	0.0	0.02386451116243264
chr7	CYP3A43	99849545	99849694	51	150	62	2652	11	2502	0.34	0.004396482813749001
chr7	PILRB	100353209	100353270	0	62	0	3977	0	3915	0.0	0.0
chr7	PILRB	100355142	100355240	0	99	0	3977	0	3878	0.0	0.0
chr7	PILRB	100353372	100353483	0	112	0	3977	0	3865	0.0	0.0
chr7	PILRB	100353894	100354012	0	119	0	3977	0	3858	0.0	0.0
chr7	CUX1	101916114	101916225	0	112	138872	17804	138872	17692	0.0	7.84942346823423
chr7	CUX1	102028097	102028145	0	49	138872	17804	138872	17755	0.0	7.8215713883413125
chr7	ORAI2	102436224	102436333	375	110	10508	11112	10133	11002	3.409090909090909	0.9210143610252681
chr7	ORAI2	102438943	102439181	0	239	10508	11112	10508	10873	0.0	0.9664306079278948
chr7	ARMC10	103092476	103092653	0	178	0	4585	0	4407	0.0	0.0
chr7	ARMC10	103097276	103097348	0	73	0	4585	0	4512	0.0	0.0
chr7	ARMC10	103086868	103086937	0	70	0	4585	0	4515	0.0	0.0
chr7	RINT1	105536564	105536612	0	49	7433	3420	7433	3371	0.0	2.2049836843666566
chr7	RINT1	105536657	105536749	0	93	7433	3420	7433	3327	0.0	2.2341448752629995
chr7	CDHR3	105984191	105984289	0	99	86249	9741	86249	9642	0.0	8.945135863928645
chr7	CDHR3	106001461	106001582	0	122	86249	9741	86249	9619	0.0	8.96652458675538
chr7	CDHR3	106001461	106001610	0	150	86249	9741	86249	9591	0.0	8.992701490981128
chr7	LINC02577	106775958	106776022	0	65	4705	4128	4705	4063	0.0	1.158011321683485
chr7	LINC02577	106777541	106777732	0	192	4705	4128	4705	3936	0.0	1.1953760162601625
chr7	LINC02577	106779994	106780256	0	263	4705	4128	4705	3865	0.0	1.2173350582147477
chr7	AC002463.1	112701366	112701437	0	72	104220	5157	104220	5085	0.0	20.495575221238937
chr7	AC002463.1	112707736	112707861	0	126	104220	5157	104220	5031	0.0	20.71556350626118
chr7	AC002463.1	112640161	112640218	0	58	104220	5157	104220	5099	0.0	20.439301823887035
chr7	AC002463.1	112757086	112757316	98960	231	104220	5157	5260	4926	428.3982683982684	1.0678034916768169
chr7	AC002463.1	112699329	112699522	0	194	104220	5157	104220	4963	0.0	20.999395526899054
chr7	FOXP2	114538325	114538383	0	59	35018	16292	35018	16233	0.0	2.15721062034128
chr7	FOXP2	114570806	114570881	0	76	35018	16292	35018	16216	0.0	2.159472126295017
chr7	LINC01393	115118934	115119056	0	123	0	2309	0	2186	0.0	0.0
chr7	LINC01393	115122177	115122247	0	71	0	2309	0	2238	0.0	0.0
chr7	ST7	117219083	117219176	0	94	0	6497	0	6403	0.0	0.0
chr7	ST7	117221922	117222062	0	141	0	6497	0	6356	0.0	0.0
chr7	ST7	117022902	117022999	0	98	0	6497	0	6399	0.0	0.0
chr7	ST7	117090748	117090837	0	90	0	6497	0	6407	0.0	0.0
chr7	ST7	117098612	117098815	0	204	0	6497	0	6293	0.0	0.0
chr7	CPED1	120993900	120994081	150	182	139172	7713	139022	7531	0.8241758241758241	18.459965476032398
chr7	CPED1	121015664	121015848	408	185	139172	7713	138764	7528	2.2054054054054055	18.433049946865037
chr7	AC015983.2	122201253	122201396	0	144	0	1896	0	1752	0.0	0.0
chr7	AC015983.2	122216347	122216462	0	116	0	1896	0	1780	0.0	0.0
chr7	AC004594.1	122357355	122357409	0	55	0	3479	0	3424	0.0	0.0
chr7	AC004594.1	122366781	122366878	0	98	0	3479	0	3381	0.0	0.0
chr7	AC004594.1	122368069	122368204	0	136	0	3479	0	3343	0.0	0.0
chr7	AC004594.1	122412809	122413082	0	274	0	3479	0	3205	0.0	0.0
chr7	AC004594.1	122331900	122332053	0	154	0	3479	0	3325	0.0	0.0
chr7	AC004594.1	122338949	122338996	0	48	0	3479	0	3431	0.0	0.0
chr7	AC006148.1	124049131	124049224	0	94	225	17199	225	17105	0.0	0.013154048523823443
chr7	AC006148.1	124287288	124287386	0	99	225	17199	225	17100	0.0	0.013157894736842105
chr7	AC006148.1	124244449	124244724	0	276	225	17199	225	16923	0.0	0.013295514979613544
chr7	AC006148.1	124255215	124255256	0	42	225	17199	225	17157	0.0	0.013114180800839308
chr7	AC006148.1	124077246	124077372	0	127	225	17199	225	17072	0.0	0.013179475164011247
chr7	AC006148.1	124334246	124334390	0	145	225	17199	225	17054	0.0	0.013193385715961065
chr7	POT1-AS1	125080711	125080813	0	103	0	16759	0	16656	0.0	0.0
chr7	POT1-AS1	125116873	125117028	0	156	0	16759	0	16603	0.0	0.0
chr7	POT1-AS1	125125824	125125977	0	154	0	16759	0	16605	0.0	0.0
chr7	POT1-AS1	125186043	125186492	0	450	0	16759	0	16309	0.0	0.0
chr7	POT1-AS1	125347124	125347207	0	84	0	16759	0	16675	0.0	0.0
chr7	CALU	128754261	128754455	0	195	32594	6140	32594	5945	0.0	5.482590412111017
chr7	CALU	128754528	128754722	0	195	32594	6140	32594	5945	0.0	5.482590412111017
chr7	BPGM	134647134	134647259	159	126	1941	2545	1782	2419	1.2619047619047619	0.7366680446465481
chr7	BPGM	134658347	134658668	0	322	1941	2545	1941	2223	0.0	0.873144399460189
chr7	NUP205	135645467	135645596	0	130	279137	7667	279137	7537	0.0	37.035557914289505
chr7	NUP205	135645840	135645977	0	138	279137	7667	279137	7529	0.0	37.074910346659586
chr7	AC078845.1	136117070	136117188	0	119	0	3283	0	3164	0.0	0.0
chr7	AC078845.1	136177251	136177413	0	163	0	3283	0	3120	0.0	0.0
chr7	AC078845.1	136242149	136242371	0	223	0	3283	0	3060	0.0	0.0
chr7	NDUFB2	140698074	140698268	0	195	239222	4289	239222	4094	0.0	58.43234000977039
chr7	NDUFB2	140700873	140700959	0	87	239222	4289	239222	4202	0.0	56.93050928129462
chr7	AGK	141555452	141555567	0	116	369	9243	369	9127	0.0	0.04042949490522625
chr7	AGK	141593145	141593185	0	41	369	9243	369	9202	0.0	0.04009997826559444
chr7	AGK	141594674	141594928	0	255	369	9243	369	8988	0.0	0.041054739652870494
chr7	TMEM139	143285344	143285445	0	102	0	2569	0	2467	0.0	0.0
chr7	TMEM139	143285940	143286202	0	263	0	2569	0	2306	0.0	0.0
chr7	CLCN1	143323818	143323897	0	80	594	3346	594	3266	0.0	0.18187385180649113
chr7	CLCN1	143324413	143324492	0	80	594	3346	594	3266	0.0	0.18187385180649113
chr7	CLCN1	143323308	143323386	0	79	594	3346	594	3267	0.0	0.18181818181818182
chr7	CLCN1	143323572	143323627	0	56	594	3346	594	3290	0.0	0.18054711246200608
chr7	AC092666.1	150041951	150042012	0	62	2485	5281	2485	5219	0.0	0.4761448553362713
chr7	AC092666.1	150043178	150043239	0	62	2485	5281	2485	5219	0.0	0.4761448553362713
chr7	AC092666.1	150043588	150043660	0	73	2485	5281	2485	5208	0.0	0.4771505376344086
chr7	AC092666.1	150043138	150043239	0	102	2485	5281	2485	5179	0.0	0.4798223595288666
chr7	AC092666.1	150041362	150041461	0	100	2485	5281	2485	5181	0.0	0.4796371356880911
chr7	ABCB8	151032843	151033061	0	219	177864	9139	177864	8920	0.0	19.939910313901347
chr7	ABCB8	151034272	151034428	0	157	177864	9139	177864	8982	0.0	19.802271209084836
chr7	ABCB8	151028800	151028911	86	112	177864	9139	177778	9027	0.7678571428571429	19.694029024038993
chr7	ABCB8	151031240	151031291	0	52	177864	9139	177864	9087	0.0	19.573456586332124
chr7	ABCB8	151028779	151028852	79	74	177864	9139	177785	9065	1.0675675675675675	19.612244897959183
chr7	ABCB8	151033604	151033917	0	314	177864	9139	177864	8825	0.0	20.15456090651558
chr7	DAGLB	6432836	6432959	4306	124	14599	5365	10293	5241	34.725806451612904	1.9639381797366915
chr7	DAGLB	6436361	6436533	447	173	14599	5365	14152	5192	2.5838150289017343	2.725731895223421
chr7	ICA1	8223487	8223559	0	73	9846	4842	9846	4769	0.0	2.0645837701824283
chr7	ICA1	8227637	8227851	0	215	9846	4842	9846	4627	0.0	2.127944672574022
chr7	CRPPA	16308522	16308627	45	106	318	7208	273	7102	0.42452830188679247	0.0384398760912419
chr7	CRPPA	16376091	16376241	0	151	318	7208	318	7057	0.0	0.04506164092390534
chr7	AC073332.1	17291229	17291371	0	143	51	10260	51	10117	0.0	0.00504102006523673
chr7	AC073332.1	17292370	17292440	0	71	51	10260	51	10189	0.0	0.005005397978211797
chr7	CDCA7L	21911616	21911754	255	139	1657	3906	1402	3767	1.8345323741007193	0.3721794531457393
chr7	CDCA7L	21916753	21916894	0	142	1657	3906	1657	3764	0.0	0.4402231668437832
chr7	FAM126A	22983943	22984045	4373	103	78537	7672	74164	7569	42.45631067961165	9.798388162240718
chr7	FAM126A	22991060	22991139	408	80	78537	7672	78129	7592	5.1	10.290964172813489
chr7	TRA2A	23522131	23522432	51	302	14758	3350	14707	3048	0.16887417218543047	4.8251312335958
chr7	TRA2A	23531180	23531270	153	91	14758	3350	14605	3259	1.6813186813186813	4.481436023320037
chr7	TRA2A	23522353	23522432	0	80	14758	3350	14758	3270	0.0	4.513149847094801
chr7	HNRNPA2B1	26185198	26185279	0	82	2234	8930	2234	8848	0.0	0.25248643761301987
chr7	HNRNPA2B1	26190992	26192338	709	1347	2234	8930	1525	7583	0.526354862657758	0.20110774099960438
chr7	HNRNPA2B1	26190992	26191128	97	137	2234	8930	2137	8793	0.708029197080292	0.24303423177527578
chr7	HNRNPA2B1	26193574	26193652	0	79	2234	8930	2234	8851	0.0	0.2524008586600384
chr7	HNRNPA2B1	26195846	26195909	0	64	2234	8930	2234	8866	0.0	0.2519738326189939
chr7	HNRNPA2B1	26193574	26193598	0	25	2234	8930	2234	8905	0.0	0.25087029758562607
chr7	HNRNPA2B1	26193598	26193694	0	97	2234	8930	2234	8833	0.0	0.2529152043473339
chr7	HNRNPA2B1	26191421	26191650	0	230	2234	8930	2234	8700	0.0	0.25678160919540227
chr7	HNRNPA2B1	26192300	26192338	0	39	2234	8930	2234	8891	0.0	0.2512653244854347
chr7	JAZF1	27913391	27913453	0	63	70098	4271	70098	4208	0.0	16.658269961977187
chr7	JAZF1	27914729	27914808	0	80	70098	4271	70098	4191	0.0	16.72584108804581
chr7	NOD1	30463608	30463698	867	91	8437	6096	7570	6005	9.527472527472527	1.260616153205662
chr7	NOD1	30463985	30464061	153	77	8437	6096	8284	6019	1.9870129870129871	1.376308356869912
chr7	NOD1	30475847	30475988	663	142	8437	6096	7774	5954	4.669014084507042	1.3056768558951966
chr7	GGCT	30497740	30497896	0	157	5896	1599	5896	1442	0.0	4.08876560332871
chr7	GGCT	30498802	30498938	1463	137	5896	1599	4433	1462	10.678832116788321	3.0321477428180574
chr7	GGCT	30500535	30500681	357	147	5896	1599	5539	1452	2.4285714285714284	3.814738292011019
chr7	GARS1-DT	30584422	30584453	136	32	32726	12139	32590	12107	4.25	2.691831172049228
chr7	GARS1-DT	30584710	30584808	0	99	32726	12139	32726	12040	0.0	2.7181063122923588
chr7	KIAA0895	36336153	36336297	0	145	7697	4862	7697	4717	0.0	1.631757472970108
chr7	KIAA0895	36356901	36357590	0	690	7697	4862	7697	4172	0.0	1.8449185043144776
chr7	AMPH	38417824	38417950	0	127	4317	5513	4317	5386	0.0	0.8015224656516896
chr7	AMPH	38420911	38421016	0	106	4317	5513	4317	5407	0.0	0.7984094692065841
chr7	PSMA2	42926535	42926668	351	134	6087	8384	5736	8250	2.6194029850746268	0.6952727272727273
chr7	PSMA2	42927382	42927459	255	78	6087	8384	5832	8306	3.269230769230769	0.7021430291355647
chr7	COA1	43650611	43650712	66	102	140225	11833	140159	11731	0.6470588235294118	11.947745290256584
chr7	COA1	43665657	43665722	5650	66	140225	11833	134575	11767	85.60606060606061	11.436644854253421
chr7	COA1	43650492	43650712	204	221	140225	11833	140021	11612	0.9230769230769231	12.058301756803306
chr7	COA1	43711399	43711449	0	51	140225	11833	140225	11782	0.0	11.901629604481412
chr7	CAMK2B	44232821	44232866	0	46	14180	7658	14180	7612	0.0	1.8628481345244352
chr7	CAMK2B	44234389	44234461	0	73	14180	7658	14180	7585	0.0	1.869479235332894
chr7	H2AZ2	44840898	44841012	957123	115	962345	7009	5222	6894	8322.808695652175	0.7574702639976791
chr7	H2AZ2	44843276	44843354	0	79	962345	7009	962345	6930	0.0	138.86652236652236
chr7	H2AZ2	44835528	44835658	1132	131	962345	7009	961213	6878	8.641221374045802	139.7518173887758
chr7	SNHG15	44984356	44984426	0	71	102	3016	102	2945	0.0	0.03463497453310696
chr7	SNHG15	44986020	44986097	0	78	102	3016	102	2938	0.0	0.03471749489448604
chr7	AC004870.3	47026254	47026423	12	170	12	535	0	365	0.07058823529411765	0.0
chr7	AC004870.3	47037958	47038055	0	98	12	535	12	437	0.0	0.02745995423340961
chr7	DDC	50528136	50528280	42	145	980	3104	938	2959	0.2896551724137931	0.31699898614396754
chr7	DDC	50537859	50537979	0	121	980	3104	980	2983	0.0	0.3285283271873952
chr7	DDC	50529207	50529342	0	136	980	3104	980	2968	0.0	0.330188679245283
chr7	DDC	50539914	50540028	0	115	980	3104	980	2989	0.0	0.32786885245901637
chr7	GRB10	50710874	50710990	0	117	693	9680	693	9563	0.0	0.07246679912161455
chr7	GRB10	50732271	50732368	0	98	693	9680	693	9582	0.0	0.07232310582341892
chr7	GRB10	50705139	50705323	0	185	693	9680	693	9495	0.0	0.07298578199052133
chr7	LINC01446	53691926	53692089	0	164	0	7300	0	7136	0.0	0.0
chr7	LINC01446	53771433	53771607	0	175	0	7300	0	7125	0.0	0.0
chr7	LINC01446	53780156	53780230	0	75	0	7300	0	7225	0.0	0.0
chr7	LINC01446	53811507	53811574	0	68	0	7300	0	7232	0.0	0.0
chr7	LINC01446	53710831	53710894	0	64	0	7300	0	7236	0.0	0.0
chr7	LINC01446	53692330	53692473	0	144	0	7300	0	7156	0.0	0.0
chr7	LINC01446	53811507	53811571	0	65	0	7300	0	7235	0.0	0.0
chr7	LINC01446	53776487	53776628	0	142	0	7300	0	7158	0.0	0.0
chr7	VOPP1	55530828	55530911	1018	84	120273	5361	119255	5277	12.119047619047619	22.59901459162403
chr7	VOPP1	55561979	55562051	714	73	120273	5361	119559	5288	9.780821917808218	22.609493192133133
chr7	GUSB	65976014	65976202	0	189	3632	3830	3632	3641	0.0	0.9975281516067015
chr7	GUSB	65979833	65979911	0	79	3632	3830	3632	3751	0.0	0.9682751266328979
chr7	BCL7B	73542829	73542907	0	79	66754	3073	66754	2994	0.0	22.295925183700735
chr7	BCL7B	73543547	73543644	0	98	66754	3073	66754	2975	0.0	22.438319327731094
chr7	BCL7B	73539881	73540052	51	172	66754	3073	66703	2901	0.29651162790697677	22.993105825577388
chr7	BCL7B	73537933	73538013	0	81	66754	3073	66754	2992	0.0	22.31082887700535
chr7	RFC2	74246661	74246763	404	103	2195	2224	1791	2121	3.9223300970873787	0.8444130127298444
chr7	RFC2	74249011	74249118	0	108	2195	2224	2195	2116	0.0	1.037334593572779
chr7	RFC2	74249011	74249220	23	210	2195	2224	2172	2014	0.10952380952380952	1.0784508440913605
chr7	GSAP	77321332	77321403	42	72	47355	8592	47313	8520	0.5833333333333334	5.553169014084507
chr7	GSAP	77323646	77323742	0	97	47355	8592	47355	8495	0.0	5.57445556209535
chr7	APTR	77661197	77661333	0	137	153	5920	153	5783	0.0	0.02645685630295694
chr7	APTR	77684089	77684251	0	163	153	5920	153	5757	0.0	0.026576341844710787
chr7	MAGI2	78554566	78554671	0	106	204	25254	204	25148	0.0	0.008111977095594082
chr7	MAGI2	78583420	78583494	0	75	204	25254	204	25179	0.0	0.0081019897533659
chr7	AC008163.1	81590971	81591066	0	96	22090	5496	22090	5400	0.0	4.090740740740741
chr7	AC008163.1	81594520	81594656	0	137	22090	5496	22090	5359	0.0	4.122037693599552
chr7	PCLO	82848867	82848921	0	55	459	21068	459	21013	0.0	0.021843620615809262
chr7	PCLO	82868106	82868195	0	90	459	21068	459	20978	0.0	0.02188006482982172
chr7	TP53TG1	87326262	87326449	0	188	0	5876	0	5688	0.0	0.0
chr7	TP53TG1	87341522	87341684	0	163	0	5876	0	5713	0.0	0.0
chr7	TP53TG1	87341354	87341684	0	331	0	5876	0	5545	0.0	0.0
chr7	KRIT1	92244901	92245171	0	271	269252	5947	269252	5676	0.0	47.4369274136716
chr7	KRIT1	92245426	92245595	0	170	269252	5947	269252	5777	0.0	46.607581789856326
chr7	KRIT1	92245426	92245574	0	149	269252	5947	269252	5798	0.0	46.4387719903415
chr7	TMBIM7P	92428012	92428066	0	55	0	2049	0	1994	0.0	0.0
chr7	TMBIM7P	92429369	92429448	0	80	0	2049	0	1969	0.0	0.0
chr7	SGCE	94599696	94599723	0	28	162	11980	162	11952	0.0	0.01355421686746988
chr7	SGCE	94600645	94600857	0	213	162	11980	162	11767	0.0	0.013767315373502167
chr7	SGCE	94621848	94621995	0	148	162	11980	162	11832	0.0	0.013691683569979716
chr7	SGCE	94622545	94622626	0	82	162	11980	162	11898	0.0	0.01361573373676248
chr7	SGCE	94598774	94598963	0	190	162	11980	162	11790	0.0	0.013740458015267175
chr7	SGCE	94594431	94594546	0	116	162	11980	162	11864	0.0	0.013654753877275792
chr7	SGCE	94597929	94598004	0	76	162	11980	162	11904	0.0	0.013608870967741936
chr7	SGCE	94639340	94639448	0	109	162	11980	162	11871	0.0	0.013646702047005308
chr7	SGCE	94644605	94644667	0	63	162	11980	162	11917	0.0	0.013594025341948477
chr7	SGCE	94597748	94598004	78	257	162	11980	84	11723	0.3035019455252918	0.0071654013477778725
chr7	SGCE	94640896	94640964	0	69	162	11980	162	11911	0.0	0.013600873142473343
chr7	SGCE	94622515	94622626	0	112	162	11980	162	11868	0.0	0.013650151668351871
chr7	SGCE	94588688	94588732	0	45	162	11980	162	11935	0.0	0.013573523250942606
chr7	SGCE	94597923	94598004	0	82	162	11980	162	11898	0.0	0.01361573373676248
chr7	SGCE	94629718	94629841	0	124	162	11980	162	11856	0.0	0.013663967611336033
chr7	SGCE	94629718	94629821	0	104	162	11980	162	11876	0.0	0.013640956551027282
chr7	SGCE	94628201	94628359	0	159	162	11980	162	11821	0.0	0.013704424329582946
chr7	SEM1	96558116	96558256	0	141	51	11514	51	11373	0.0	0.004484304932735426
chr7	SEM1	96656456	96656585	0	130	51	11514	51	11384	0.0	0.004479971890372453
chr7	DLX6-AS1	96978346	96979591	0	1246	306	16178	306	14932	0.0	0.02049290115188856
chr7	DLX6-AS1	97011824	97012303	0	480	306	16178	306	15698	0.0	0.01949292903554593
chr7	DLX6-AS1	97012180	97012303	0	124	306	16178	306	16054	0.0	0.019060670237946928
chr7	AC004834.1	99299463	99299666	0	204	1989	4618	1989	4414	0.0	0.4506116900770276
chr7	AC004834.1	99305588	99305769	0	182	1989	4618	1989	4436	0.0	0.44837691614066727
chr7	ZNF3	100077302	100077433	0	132	184638	5432	184638	5300	0.0	34.83735849056604
chr7	ZNF3	100079535	100079656	0	122	184638	5432	184638	5310	0.0	34.77175141242938
chr7	TAF6	100116513	100116633	0	121	133	3852	133	3731	0.0	0.03564727954971857
chr7	TAF6	100118517	100118649	0	133	133	3852	133	3719	0.0	0.03576230169400377
chr7	CASTOR3	100222596	100222720	242	125	27956	4870	27714	4745	1.936	5.840674394099052
chr7	CASTOR3	100223569	100223698	1739	130	27956	4870	26217	4740	13.376923076923077	5.531012658227848
chr7	PMS2P1	100325690	100325779	0	90	153	5373	153	5283	0.0	0.028960817717206135
chr7	PMS2P1	100330181	100330284	0	104	153	5373	153	5269	0.0	0.029037768077434047
chr7	ACHE	100891168	100891338	0	171	15872	3736	15872	3565	0.0	4.452173913043478
chr7	ACHE	100892707	100892818	933	112	15872	3736	14939	3624	8.330357142857142	4.122240618101546
chr7	ACHE	100892333	100892554	140	222	15872	3736	15732	3514	0.6306306306306306	4.476949345475242
chr7	ACHE	100892686	100892818	1071	133	15872	3736	14801	3603	8.052631578947368	4.10796558423536
chr7	ACHE	100892333	100892643	140	311	15872	3736	15732	3425	0.45016077170418006	4.593284671532847
chr7	IFT22	101318123	101318213	0	91	51	3810	51	3719	0.0	0.013713363807475128
chr7	IFT22	101318955	101319032	0	78	51	3810	51	3732	0.0	0.013665594855305467
chr7	FBXL13	103046808	103047020	0	213	9642	4038	9642	3825	0.0	2.5207843137254904
chr7	FBXL13	103055087	103055178	0	92	9642	4038	9642	3946	0.0	2.4434870755195135
chr7	FBXL13	102822382	102822440	0	59	9642	4038	9642	3979	0.0	2.4232219150540337
chr7	FBXL13	102832839	102832974	0	136	9642	4038	9642	3902	0.0	2.4710404920553564
chr7	FBXL13	102854776	102854860	0	85	9642	4038	9642	3953	0.0	2.4391601315456617
chr7	SRPK2	105125781	105125874	0	94	35636	5398	35636	5304	0.0	6.718702865761689
chr7	SRPK2	105126247	105126340	161	94	35636	5398	35475	5304	1.7127659574468086	6.6883484162895925
chr7	SLC26A4-AS1	107655095	107655312	0	218	51	8534	51	8316	0.0	0.006132756132756133
chr7	SLC26A4-AS1	107661601	107661758	0	158	51	8534	51	8376	0.0	0.0060888252148997134
chr7	HRAT17	112973604	112973672	0	69	0	3836	0	3767	0.0	0.0
chr7	HRAT17	112977143	112977199	0	57	0	3836	0	3779	0.0	0.0
chr7	HRAT17	112980045	112980164	0	120	0	3836	0	3716	0.0	0.0
chr7	HRAT17	112980903	112981161	0	259	0	3836	0	3577	0.0	0.0
chr7	HRAT17	112986535	112986664	0	130	0	3836	0	3706	0.0	0.0
chr7	HRAT17	112956353	112956455	0	103	0	3836	0	3733	0.0	0.0
chr7	HRAT17	112956521	112956642	0	122	0	3836	0	3714	0.0	0.0
chr7	HRAT17	112956521	112956702	0	182	0	3836	0	3654	0.0	0.0
chr7	HRAT17	112956521	112956711	0	191	0	3836	0	3645	0.0	0.0
chr7	HRAT17	112982986	112983141	0	156	0	3836	0	3680	0.0	0.0
chr7	HRAT17	112956521	112956774	0	254	0	3836	0	3582	0.0	0.0
chr7	SLC13A1	123186695	123186749	374	55	20924	4420	20550	4365	6.8	4.707903780068729
chr7	SLC13A1	123190457	123190613	8575	157	20924	4420	12349	4263	54.617834394904456	2.8967863007271872
chr7	NDUFA5	123551367	123551576	0	210	663	7705	663	7495	0.0	0.08845897264843229
chr7	NDUFA5	123553669	123553756	0	88	663	7705	663	7617	0.0	0.08704214257581724
chr7	NDUFA5	123550469	123550586	0	118	663	7705	663	7587	0.0	0.08738631870304468
chr7	NDUFA5	123557403	123557448	0	46	663	7705	663	7659	0.0	0.08656482569526047
chr7	POT1	124865128	124865299	0	172	0	8237	0	8065	0.0	0.0
chr7	POT1	124870910	124871041	0	132	0	8237	0	8105	0.0	0.0
chr7	KCP	128904283	128904380	0	98	5806	12575	5806	12477	0.0	0.46533621864230185
chr7	KCP	128906278	128906363	0	86	5806	12575	5806	12489	0.0	0.4648891024101209
chr7	ZC3HC1	130040950	130041101	0	152	30236	3026	30236	2874	0.0	10.5205288796103
chr7	ZC3HC1	130043627	130043880	281	254	30236	3026	29955	2772	1.1062992125984252	10.806277056277056
chr7	CEP41	130416918	130416966	0	49	1002	12794	1002	12745	0.0	0.07861906630051001
chr7	CEP41	130427954	130428018	0	65	1002	12794	1002	12729	0.0	0.07871788828658968
chr7	CEP41	130426645	130426759	0	115	1002	12794	1002	12679	0.0	0.07902831453584667
chr7	CEP41	130427395	130427482	0	88	1002	12794	1002	12706	0.0	0.07886038092239887
chr7	CEP41	130426628	130426759	0	132	1002	12794	1002	12662	0.0	0.07913441794345286
chr7	LINC-PINT	130959868	130959970	0	103	6987	8484	6987	8381	0.0	0.8336713995943205
chr7	LINC-PINT	130978507	130978528	0	22	6987	8484	6987	8462	0.0	0.8256913259276767
chr7	LINC-PINT	130967388	130967517	0	130	6987	8484	6987	8354	0.0	0.8363658127842949
chr7	LINC-PINT	130993981	130994093	0	113	6987	8484	6987	8371	0.0	0.8346673037868833
chr7	LINC-PINT	131002196	131002320	480	125	6987	8484	6507	8359	3.84	0.7784423974159589
chr7	LINC-PINT	131009708	131009778	0	71	6987	8484	6987	8413	0.0	0.8305004160228219
chr7	AC009264.1	136785698	136785891	0	194	0	6929	0	6735	0.0	0.0
chr7	AC009264.1	137032793	137032913	0	121	0	6929	0	6808	0.0	0.0
chr7	AC009264.1	136752263	136752490	0	228	0	6929	0	6701	0.0	0.0
chr7	AC009264.1	137031904	137031963	0	60	0	6929	0	6869	0.0	0.0
chr7	DGKI	137689893	137690002	0	110	0	15589	0	15479	0.0	0.0
chr7	DGKI	137843387	137843462	0	76	0	15589	0	15513	0.0	0.0
chr7	SLC37A3	140358639	140358785	0	147	567987	8904	567987	8757	0.0	64.86091127098321
chr7	SLC37A3	140364407	140364491	43	85	567987	8904	567944	8819	0.5058823529411764	64.4000453566164
chr7	MKRN1	140472202	140472405	0	204	4876	5678	4876	5474	0.0	0.8907563025210085
chr7	MKRN1	140473774	140473827	0	54	4876	5678	4876	5624	0.0	0.8669985775248933
chr7	FAM131B	143359325	143359419	0	95	0	6306	0	6211	0.0	0.0
chr7	FAM131B	143359731	143359767	0	37	0	6306	0	6269	0.0	0.0
chr7	AC099548.2	143833246	143833883	0	638	0	3634	0	2996	0.0	0.0
chr7	AC099548.2	143836156	143836269	0	114	0	3634	0	3520	0.0	0.0
chr7	PRKAG2	151566572	151566613	0	42	21836	14143	21836	14101	0.0	1.5485426565491809
chr7	PRKAG2	151566613	151566699	0	87	21836	14143	21836	14056	0.0	1.5535002845759818
chr7	PRKAG2	151606093	151606183	0	91	21836	14143	21836	14052	0.0	1.5539424992883575
chr7	PRKAG2	151631637	151631768	0	132	21836	14143	21836	14011	0.0	1.5584897580472485
chr7	LINC01287	153401340	153401691	0	352	0	9603	0	9251	0.0	0.0
chr7	LINC01287	153404056	153404233	0	178	0	9603	0	9425	0.0	0.0
chr7	LINC01287	153403362	153403492	0	131	0	9603	0	9472	0.0	0.0
chr7	LINC01287	153406955	153407084	0	130	0	9603	0	9473	0.0	0.0
chr7	LINC01287	153412090	153413482	0	1393	0	9603	0	8210	0.0	0.0
chr7	LINC01287	153411581	153411724	0	144	0	9603	0	9459	0.0	0.0
chr7	LINC01287	153411585	153411724	0	140	0	9603	0	9463	0.0	0.0
chr7	LINC01287	153412090	153413220	0	1131	0	9603	0	8472	0.0	0.0
chr7	LINC01287	153412090	153412731	0	642	0	9603	0	8961	0.0	0.0
chr7	LINC01287	153404056	153404326	0	271	0	9603	0	9332	0.0	0.0
chr7	LINC01287	153404056	153404602	0	547	0	9603	0	9056	0.0	0.0
chr7	LINC01006	156471154	156472711	13181	1558	85089	11122	71908	9564	8.4602053915276	7.518611459640318
chr7	LINC01006	156605187	156605380	0	194	85089	11122	85089	10928	0.0	7.786328696925329
chr7	PTPRN2	158316818	158316932	0	115	15	3610	15	3495	0.0	0.004291845493562232
chr7	PTPRN2	158489734	158489785	15	52	15	3610	0	3558	0.28846153846153844	0.0
chr8	CSMD1	3598303	3598306	0	4	153	18788	153	18784	0.0	0.008145229982964224
chr8	CSMD1	3613275	3613278	0	4	153	18788	153	18784	0.0	0.008145229982964224
chr8	SPAG11B	7449132	7449236	0	105	0	1983	0	1878	0.0	0.0
chr8	SPAG11B	7450822	7450900	0	79	0	1983	0	1904	0.0	0.0
chr8	PINX1	10787623	10787825	0	203	51	2814	51	2611	0.0	0.019532746074301034
chr8	PINX1	10820192	10820269	51	78	51	2814	0	2736	0.6538461538461539	0.0
chr8	CTSB	11857857	11857940	0	84	0	8249	0	8165	0.0	0.0
chr8	CTSB	11861299	11861479	0	181	0	8249	0	8068	0.0	0.0
chr8	CTSB	11854679	11854914	0	236	0	8249	0	8013	0.0	0.0
chr8	CTSB	11862344	11862478	0	135	0	8249	0	8114	0.0	0.0
chr8	CTSB	11864375	11864463	0	89	0	8249	0	8160	0.0	0.0
chr8	CTSB	11864375	11864483	0	109	0	8249	0	8140	0.0	0.0
chr8	CTSB	11865463	11865584	0	122	0	8249	0	8127	0.0	0.0
chr8	CTSB	11861405	11861479	0	75	0	8249	0	8174	0.0	0.0
chr8	CTSB	11856395	11856585	0	191	0	8249	0	8058	0.0	0.0
chr8	CTSB	11861360	11861479	0	120	0	8249	0	8129	0.0	0.0
chr8	CTSB	11867253	11867391	0	139	0	8249	0	8110	0.0	0.0
chr8	CTSB	11866156	11866201	0	46	0	8249	0	8203	0.0	0.0
chr8	CTSB	11864696	11864903	0	208	0	8249	0	8041	0.0	0.0
chr8	CTSB	11865463	11865560	0	98	0	8249	0	8151	0.0	0.0
chr8	FAM86B1	12186699	12186833	0	135	0	4142	0	4007	0.0	0.0
chr8	FAM86B1	12191778	12191841	0	64	0	4142	0	4078	0.0	0.0
chr8	FAM86B1	12189807	12189888	0	82	0	4142	0	4060	0.0	0.0
chr8	ASAH1	18069791	18069878	88	88	2982	9281	2894	9193	1.0	0.3148047427390406
chr8	ASAH1	18071299	18071390	0	92	2982	9281	2982	9189	0.0	0.3245184459680052
chr8	ASAH1	18069791	18069872	88	82	2982	9281	2894	9199	1.0731707317073171	0.3145994129796717
chr8	CSGALNACT1	19585165	19585317	0	153	12205	6602	12205	6449	0.0	1.8925414792991162
chr8	CSGALNACT1	19591159	19591278	0	120	12205	6602	12205	6482	0.0	1.8829065103363158
chr8	REEP4	22138638	22138793	0	156	0	2273	0	2117	0.0	0.0
chr8	REEP4	22138925	22139061	0	137	0	2273	0	2136	0.0	0.0
chr8	LOXL2	23370642	23370762	0	121	217530	5755	217530	5634	0.0	38.61022364217252
chr8	LOXL2	23382390	23382513	0	124	217530	5755	217530	5631	0.0	38.630793819925415
chr8	ADRA1A	26770280	26770666	0	387	102	6719	102	6332	0.0	0.016108654453569172
chr8	ADRA1A	26859031	26859205	0	175	102	6719	102	6544	0.0	0.01558679706601467
chr8	CHRNA2	27475212	27475272	0	61	332217	5067	332217	5006	0.0	66.36376348381941
chr8	CHRNA2	27477167	27477228	0	62	332217	5067	332217	5005	0.0	66.37702297702297
chr8	CLU	27613577	27613683	0	107	28475	5788	28475	5681	0.0	5.012321774335504
chr8	CLU	27614172	27614370	13637	199	28475	5788	14838	5589	68.52763819095478	2.6548577563070315
chr8	CCDC25	27740471	27740517	0	47	272	4420	272	4373	0.0	0.06219986279442031
chr8	CCDC25	27748076	27748279	0	204	272	4420	272	4216	0.0	0.06451612903225806
chr8	SCARA5	27921570	27922245	0	676	102	4389	102	3713	0.0	0.02747104767034743
chr8	SCARA5	27966413	27966542	0	130	102	4389	102	4259	0.0	0.023949283869452925
chr8	ZNF395	28368448	28368565	0	118	25206	5747	25206	5629	0.0	4.477882394741517
chr8	ZNF395	28375261	28375382	0	122	25206	5747	25206	5625	0.0	4.481066666666667
chr8	FBXO16	28473771	28473807	0	37	1773	3825	1773	3788	0.0	0.4680570221752904
chr8	FBXO16	28483347	28483462	0	116	1773	3825	1773	3709	0.0	0.4780264222162308
chr8	INTS9	28812326	28812461	0	136	1928	4789	1928	4653	0.0	0.41435632924994625
chr8	INTS9	28813491	28813612	0	122	1928	4789	1928	4667	0.0	0.41311334904649666
chr8	INTS9	28835291	28835378	0	88	1928	4789	1928	4701	0.0	0.4101255052116571
chr8	GSR	30689160	30689319	0	160	255	3619	255	3459	0.0	0.07372072853425846
chr8	GSR	30692968	30693055	0	88	255	3619	255	3531	0.0	0.07221750212404418
chr8	FGFR1	38429246	38429390	0	145	323	11651	323	11506	0.0	0.02807231009907874
chr8	FGFR1	38429681	38429948	0	268	323	11651	323	11383	0.0	0.02837564789598524
chr8	FGFR1	38458846	38458894	0	49	323	11651	323	11602	0.0	0.027840027581451474
chr8	FGFR1	38461095	38461255	0	161	323	11651	323	11490	0.0	0.028111401218450828
chr8	FGFR1	38458846	38458984	0	139	323	11651	323	11512	0.0	0.02805767894371091
chr8	FGFR1	38440305	38440373	0	69	323	11651	323	11582	0.0	0.027888102227594542
chr8	FGFR1	38443396	38443492	0	97	323	11651	323	11554	0.0	0.027955686342392243
chr8	FGFR1	38421796	38421941	0	146	323	11651	323	11505	0.0	0.028074750108648412
chr8	FGFR1	38423024	38423175	0	152	323	11651	323	11499	0.0	0.028089399078180713
chr8	ZMAT4	40786688	40786782	0	95	0	3453	0	3358	0.0	0.0
chr8	ZMAT4	40808508	40808571	0	64	0	3453	0	3389	0.0	0.0
chr8	PLAT	42185080	42185158	51	79	285245	6705	285194	6626	0.6455696202531646	43.041654089948686
chr8	PLAT	42187397	42187572	4603	176	285245	6705	280642	6529	26.15340909090909	42.98391790473273
chr8	AC022034.3	53399569	53399837	0	269	47	3228	47	2959	0.0	0.015883744508279823
chr8	AC022034.3	53401479	53401569	0	91	47	3228	47	3137	0.0	0.014982467325470195
chr8	AC022034.3	53422696	53422835	47	140	47	3228	0	3088	0.3357142857142857	0.0
chr8	AC022034.3	53430310	53430462	0	153	47	3228	47	3075	0.0	0.015284552845528456
chr8	LYPLA1	54063327	54063375	0	49	0	4705	0	4656	0.0	0.0
chr8	LYPLA1	54065747	54065813	0	67	0	4705	0	4638	0.0	0.0
chr8	LYPLA1	54062253	54062324	0	72	0	4705	0	4633	0.0	0.0
chr8	TMEM68	55743480	55743620	0	141	0	6607	0	6466	0.0	0.0
chr8	TMEM68	55745060	55745121	0	62	0	6607	0	6545	0.0	0.0
chr8	RPS20	56073694	56073768	0	75	0	6105	0	6030	0.0	0.0
chr8	RPS20	56074059	56074150	0	92	0	6105	0	6013	0.0	0.0
chr8	RPS20	56074059	56074159	0	101	0	6105	0	6004	0.0	0.0
chr8	LINC00968	56534945	56535009	0	65	0	3316	0	3251	0.0	0.0
chr8	LINC00968	56544078	56544178	0	101	0	3316	0	3215	0.0	0.0
chr8	AC092819.1	58260524	58260753	0	230	0	2277	0	2047	0.0	0.0
chr8	AC092819.1	58271280	58271596	0	317	0	2277	0	1960	0.0	0.0
chr8	NSMAF	58637233	58637389	0	157	0	6094	0	5937	0.0	0.0
chr8	NSMAF	58639967	58640102	0	136	0	6094	0	5958	0.0	0.0
chr8	LINC01414	64166974	64167027	0	54	0	4070	0	4016	0.0	0.0
chr8	LINC01414	64230555	64230619	0	65	0	4070	0	4005	0.0	0.0
chr8	LINC01414	64151092	64151164	0	73	0	4070	0	3997	0.0	0.0
chr8	LINC01414	64230555	64230616	0	62	0	4070	0	4008	0.0	0.0
chr8	SNHG6	66922323	66922392	0	70	0	1198	0	1128	0.0	0.0
chr8	SNHG6	66922613	66922725	0	113	0	1198	0	1085	0.0	0.0
chr8	COPS5	67060496	67060545	0	50	0	6172	0	6122	0.0	0.0
chr8	COPS5	67061291	67061422	0	132	0	6172	0	6040	0.0	0.0
chr8	COPS5	67060320	67060545	0	226	0	6172	0	5946	0.0	0.0
chr8	C8ORF34-AS1	68308859	68308963	0	105	0	4657	0	4552	0.0	0.0
chr8	C8ORF34-AS1	68312143	68312217	0	75	0	4657	0	4582	0.0	0.0
chr8	C8ORF34-AS1	68316714	68317012	0	299	0	4657	0	4358	0.0	0.0
chr8	LINC01592	68998303	68998342	0	40	51	3717	51	3677	0.0	0.013870002719608376
chr8	LINC01592	69000058	69000122	0	65	51	3717	51	3652	0.0	0.013964950711938665
chr8	STAU2	73697307	73697442	0	136	0	8989	0	8853	0.0	0.0
chr8	STAU2	73709031	73709162	0	132	0	8989	0	8857	0.0	0.0
chr8	STAU2	73688653	73688813	0	161	0	8989	0	8828	0.0	0.0
chr8	UBE2W	73795790	73795914	0	125	816	9101	816	8976	0.0	0.09090909090909091
chr8	UBE2W	73796606	73796690	0	85	816	9101	816	9016	0.0	0.09050576752440107
chr8	ELOC	73964486	73964625	1120	140	42046	4943	40926	4803	8.0	8.520924422236103
chr8	ELOC	73969559	73969673	768	115	42046	4943	41278	4828	6.678260869565217	8.549710024855013
chr8	CASC9	75271313	75271433	0	121	10073	3373	10073	3252	0.0	3.0974784747847477
chr8	CASC9	75276986	75277090	1845	105	10073	3373	8228	3268	17.571428571428573	2.517747858017136
chr8	CASC9	75278356	75278481	2622	126	10073	3373	7451	3247	20.80952380952381	2.2947336002463814
chr8	CASC9	75324220	75324333	0	114	10073	3373	10073	3259	0.0	3.0908254065664313
chr8	IL7	78736473	78736527	0	55	0	3129	0	3074	0.0	0.0
chr8	IL7	78738503	78738635	0	133	0	3129	0	2996	0.0	0.0
chr8	TPD52	80044166	80044208	0	43	51	7967	51	7924	0.0	0.006436143361938415
chr8	TPD52	80050444	80050471	0	28	51	7967	51	7939	0.0	0.006423982869379015
chr8	IMPA1	81676233	81676279	0	47	0	4417	0	4370	0.0	0.0
chr8	IMPA1	81679125	81679230	0	106	0	4417	0	4311	0.0	0.0
chr8	CA1	85342748	85342825	0	78	241	3056	241	2978	0.0	0.0809267965077233
chr8	CA1	85351730	85351784	0	55	241	3056	241	3001	0.0	0.08030656447850716
chr8	CA1	85349810	85349885	0	76	241	3056	241	2980	0.0	0.08087248322147651
chr8	CA1	85341753	85341834	0	82	241	3056	241	2974	0.0	0.08103564223268325
chr8	CA1	85341753	85341808	0	56	241	3056	241	3000	0.0	0.08033333333333334
chr8	RMDN1	86494828	86494966	0	139	118	5558	118	5419	0.0	0.021775235283262594
chr8	RMDN1	86505299	86505379	0	81	118	5558	118	5477	0.0	0.02154464122694906
chr8	RUNX1T1	92075964	92076137	3542	174	102019	12864	98477	12690	20.35632183908046	7.7602048857368
chr8	RUNX1T1	92095027	92095171	120	145	102019	12864	101899	12719	0.8275862068965517	8.01155751238305
chr8	RUNX1T1	92075964	92076132	3542	169	102019	12864	98477	12695	20.958579881656803	7.757148483654983
chr8	RUNX1T1	92062545	92062709	0	165	102019	12864	102019	12699	0.0	8.033624694857863
chr8	RUNX1T1	92081233	92081293	5935	61	102019	12864	96084	12803	97.29508196721312	7.504803561665235
chr8	RUNX1T1	91994486	91994623	0	138	102019	12864	102019	12726	0.0	8.016580229451517
chr8	RUNX1T1	92003301	92003380	749	80	102019	12864	101270	12784	9.3625	7.921620775969963
chr8	TRIQK	92921502	92921660	112	159	622	4946	510	4787	0.7044025157232704	0.1065385418842699
chr8	TRIQK	92954405	92954564	0	160	622	4946	622	4786	0.0	0.1299623903050564
chr8	TRIQK	92916928	92917010	0	83	622	4946	622	4863	0.0	0.12790458564672014
chr8	TRIQK	92916928	92917007	0	80	622	4946	622	4866	0.0	0.12782572955199342
chr8	UQCRB	96231225	96231515	0	291	102	9892	102	9601	0.0	0.010623893344443287
chr8	UQCRB	96231531	96231621	0	91	102	9892	102	9801	0.0	0.010407101316192225
chr8	UQCRB	96231378	96231515	0	138	102	9892	102	9754	0.0	0.010457248308386303
chr8	AP003472.1	100395380	100395457	0	78	1071	1822	1071	1744	0.0	0.614105504587156
chr8	AP003472.1	100410734	100410771	0	38	1071	1822	1071	1784	0.0	0.6003363228699552
chr8	PABPC1	100712361	100712457	0	97	1532	8827	1532	8730	0.0	0.17548682703321877
chr8	PABPC1	100712651	100712789	0	139	1532	8827	1532	8688	0.0	0.17633517495395948
chr8	NCALD	101852571	101852670	0	100	22282	5763	22282	5663	0.0	3.934663605862617
chr8	NCALD	101887140	101887227	0	88	22282	5763	22282	5675	0.0	3.9263436123348017
chr8	NCALD	101750597	101750687	0	91	22282	5763	22282	5672	0.0	3.928420310296192
chr8	NCALD	101721212	101721351	3216	140	22282	5763	19066	5623	22.97142857142857	3.3907166992708517
chr8	RRM2B	102214053	102214158	1877	106	9092	4052	7215	3946	17.70754716981132	1.828433857070451
chr8	RRM2B	102232230	102232304	0	75	9092	4052	9092	3977	0.0	2.286145335680161
chr8	BAALC-AS1	103268390	103268472	122	83	129133	14006	129011	13923	1.4698795180722892	9.266034618975796
chr8	BAALC-AS1	103268691	103268843	747	153	129133	14006	128386	13853	4.882352941176471	9.267739839745904
chr8	SLC25A32	103403163	103403324	200	162	2182	3661	1982	3499	1.2345679012345678	0.5664475564446985
chr8	SLC25A32	103404775	103404861	41	87	2182	3661	2141	3574	0.47126436781609193	0.5990486849468383
chr8	ZFPM2-AS1	105927650	105927717	0	68	255	2451	255	2383	0.0	0.10700797314309694
chr8	ZFPM2-AS1	106059080	106059136	0	57	255	2451	255	2394	0.0	0.10651629072681704
chr8	ZFPM2-AS1	105927641	105927717	0	77	255	2451	255	2374	0.0	0.10741364785172704
chr8	EIF3E	108242111	108242346	0	236	102	27596	102	27360	0.0	0.0037280701754385964
chr8	EIF3E	108243292	108243463	0	172	102	27596	102	27424	0.0	0.003719369894982497
chr8	EIF3E	108242111	108242256	0	146	102	27596	102	27450	0.0	0.003715846994535519
chr8	EIF3E	108239957	108240075	0	119	102	27596	102	27477	0.0	0.00371219565454744
chr8	EIF3E	108241798	108241913	0	116	102	27596	102	27480	0.0	0.0037117903930131003
chr8	LINC01608	111005529	111005649	0	121	0	12963	0	12842	0.0	0.0
chr8	LINC01608	111014903	111015032	0	130	0	12963	0	12833	0.0	0.0
chr8	LINC01608	111004660	111004769	0	110	0	12963	0	12853	0.0	0.0
chr8	EIF3H	116697052	116697237	0	186	41	6450	41	6264	0.0	0.006545338441890166
chr8	EIF3H	116726015	116726172	0	158	41	6450	41	6292	0.0	0.006516211061665607
chr8	EIF3H	116734276	116734324	0	49	41	6450	41	6401	0.0	0.006405249179815654
chr8	EIF3H	116737236	116737287	0	52	41	6450	41	6398	0.0	0.006408252578930916
chr8	EIF3H	116734276	116734354	0	79	41	6450	41	6371	0.0	0.0064354104536179565
chr8	TATDN1	124518817	124518881	796	65	91964	4793	91168	4728	12.246153846153845	19.282571912013537
chr8	TATDN1	124522936	124523002	314	67	91964	4793	91650	4726	4.686567164179104	19.392721117223868
chr8	TATDN1	124522150	124522200	341	51	91964	4793	91623	4742	6.686274509803922	19.32159426402362
chr8	MTSS1	124557680	124557875	24	196	169201	7472	169177	7276	0.12244897959183673	23.25137438152831
chr8	MTSS1	124558712	124558832	0	121	169201	7472	169201	7351	0.0	23.01741259692559
chr8	WASHC5	125083712	125083776	0	65	0	4792	0	4727	0.0	0.0
chr8	WASHC5	125083834	125084022	0	189	0	4792	0	4603	0.0	0.0
chr8	CASC19	127189909	127189982	0	74	180	18096	180	18022	0.0	0.009987792697813783
chr8	CASC19	127197474	127197564	0	91	180	18096	180	18005	0.0	0.009997222993612885
chr8	CASC19	127202041	127202152	0	112	180	18096	180	17984	0.0	0.010008896797153026
chr8	CASC19	127203162	127203220	0	59	180	18096	180	18037	0.0	0.009979486610855464
chr8	CASC19	127191665	127191847	0	183	180	18096	180	17913	0.0	0.010048568079048735
chr8	CASC19	127188044	127188115	0	72	180	18096	180	18024	0.0	0.009986684420772303
chr8	CASC19	127208145	127208202	0	58	180	18096	180	18038	0.0	0.009978933362900544
chr8	CASC19	127208605	127208682	0	78	180	18096	180	18018	0.0	0.00999000999000999
chr8	CASC19	127191661	127191847	0	187	180	18096	180	17909	0.0	0.010050812440672288
chr8	CCDC26	129402215	129402251	0	37	28720	49644	28720	49607	0.0	0.5789505513334812
chr8	CCDC26	129480642	129480690	0	49	28720	49644	28720	49595	0.0	0.5790906341365057
chr8	CCDC26	129441180	129441310	0	131	28720	49644	28720	49513	0.0	0.5800496839213943
chr8	CCDC26	129443601	129443752	0	152	28720	49644	28720	49492	0.0	0.5802958053826881
chr8	CCDC26	129399513	129399684	0	172	28720	49644	28720	49472	0.0	0.5805304010349288
chr8	CCDC26	129399530	129399684	0	155	28720	49644	28720	49489	0.0	0.5803309826426074
chr8	CCDC26	129388044	129388118	0	75	28720	49644	28720	49569	0.0	0.579394379551736
chr8	CCDC26	129352803	129352980	0	178	28720	49644	28720	49466	0.0	0.5806008167225973
chr8	CCDC26	129370306	129370377	0	72	28720	49644	28720	49572	0.0	0.579359315742758
chr8	CCDC26	129284657	129284772	0	116	28720	49644	28720	49528	0.0	0.5798740106606364
chr8	CCDC26	129303204	129303301	0	98	28720	49644	28720	49546	0.0	0.5796633431558552
chr8	CCDC26	129254421	129254495	0	75	28720	49644	28720	49569	0.0	0.579394379551736
chr8	CCDC26	129276784	129276919	0	136	28720	49644	28720	49508	0.0	0.5801082653308556
chr8	CCDC26	129230768	129230861	0	94	28720	49644	28720	49550	0.0	0.5796165489404642
chr8	CCDC26	129266059	129266266	0	208	28720	49644	28720	49436	0.0	0.5809531515494781
chr8	CCDC26	129344628	129344774	0	147	28720	49644	28720	49497	0.0	0.5802371860920864
chr8	CCDC26	129267779	129267863	0	85	28720	49644	28720	49559	0.0	0.5795112895740431
chr8	CCDC26	129223220	129223369	0	150	28720	49644	28720	49494	0.0	0.5802723562452015
chr8	CCDC26	129554592	129554708	0	117	28720	49644	28720	49527	0.0	0.5798857189008015
chr8	CCDC26	129270161	129270300	0	140	28720	49644	28720	49504	0.0	0.5801551389786684
chr8	CCDC26	129554803	129554941	0	139	28720	49644	28720	49505	0.0	0.5801434198565801
chr8	CCDC26	129552681	129552810	0	130	28720	49644	28720	49514	0.0	0.580037969059256
chr8	CCDC26	129509649	129509721	0	73	28720	49644	28720	49571	0.0	0.5793710032075206
chr8	CCDC26	129550814	129550926	0	113	28720	49644	28720	49531	0.0	0.5798388887767257
chr8	CCDC26	129554909	129554941	0	33	28720	49644	28720	49611	0.0	0.5789038721251335
chr8	CCDC26	129491672	129491748	0	77	28720	49644	28720	49567	0.0	0.5794177577823956
chr8	CCDC26	129571402	129571433	0	32	28720	49644	28720	49612	0.0	0.5788922034991534
chr8	CCDC26	129494543	129494766	0	224	28720	49644	28720	49420	0.0	0.5811412383650344
chr8	CCDC26	129571402	129571460	0	59	28720	49644	28720	49585	0.0	0.579207421599274
chr8	CCDC26	129554667	129554941	0	275	28720	49644	28720	49369	0.0	0.5817415787234904
chr8	CCDC26	129573117	129573214	0	98	28720	49644	28720	49546	0.0	0.5796633431558552
chr8	CYRIB	129879596	129879789	0	194	102	7461	102	7267	0.0	0.014036053392046237
chr8	CYRIB	129896671	129896854	0	184	102	7461	102	7277	0.0	0.014016765150474097
chr8	CYRIB	129880375	129880458	0	84	102	7461	102	7377	0.0	0.013826758845058967
chr8	CYRIB	129894486	129894564	0	79	102	7461	102	7382	0.0	0.013817393660254673
chr8	CYRIB	129896748	129896854	0	107	102	7461	102	7354	0.0	0.013870002719608376
chr8	CYRIB	129862228	129862334	0	107	102	7461	102	7354	0.0	0.013870002719608376
chr8	CYRIB	129871374	129871496	0	123	102	7461	102	7338	0.0	0.013900245298446443
chr8	CYRIB	129912359	129912417	0	59	102	7461	102	7402	0.0	0.013780059443393677
chr8	CYRIB	129912469	129912515	0	47	102	7461	102	7414	0.0	0.013757755597518209
chr8	CYRIB	129904498	129904585	0	88	102	7461	102	7373	0.0	0.0138342601383426
chr8	TMEM71	132757233	132757294	102	62	249	3352	147	3290	1.6451612903225807	0.04468085106382979
chr8	TMEM71	132758839	132758915	0	77	249	3352	249	3275	0.0	0.07603053435114504
chr8	TMEM71	132759297	132759447	0	151	249	3352	249	3201	0.0	0.07778819119025304
chr8	TMEM71	132760291	132760369	0	79	249	3352	249	3273	0.0	0.076076993583868
chr8	SLA	133060099	133060200	0	102	0	7510	0	7408	0.0	0.0
chr8	SLA	133074852	133075130	0	279	0	7510	0	7231	0.0	0.0
chr8	SLA	133076655	133076755	0	101	0	7510	0	7409	0.0	0.0
chr8	SLA	133087717	133087840	0	124	0	7510	0	7386	0.0	0.0
chr8	SLA	133063579	133063728	0	150	0	7510	0	7360	0.0	0.0
chr8	SLA	133064110	133064179	0	70	0	7510	0	7440	0.0	0.0
chr8	NDRG1	133284756	133284896	51	141	51	10313	0	10172	0.3617021276595745	0.0
chr8	NDRG1	133288259	133288431	0	173	51	10313	51	10140	0.0	0.005029585798816568
chr8	ZFAT	134608728	134608879	0	152	17312	6733	17312	6581	0.0	2.630603251785443
chr8	ZFAT	134610469	134610655	0	187	17312	6733	17312	6546	0.0	2.644668499847235
chr8	PTK2	140925660	140925749	0	90	4068	12062	4068	11972	0.0	0.33979284998329434
chr8	PTK2	140984077	140984155	0	79	4068	12062	4068	11983	0.0	0.33948093131936913
chr8	PTK2	140948665	140948723	0	59	4068	12062	4068	12003	0.0	0.33891527118220444
chr8	PTK2	140746759	140746860	0	102	4068	12062	4068	11960	0.0	0.34013377926421406
chr8	PTK2	140752231	140752316	0	86	4068	12062	4068	11976	0.0	0.3396793587174349
chr8	TOP1MT	143332486	143332601	0	116	1210	6431	1210	6315	0.0	0.1916072842438638
chr8	TOP1MT	143334107	143334285	0	179	1210	6431	1210	6252	0.0	0.19353806781829813
chr8	TOP1MT	143332486	143332657	0	172	1210	6431	1210	6259	0.0	0.19332161687170474
chr8	TOP1MT	143327302	143327790	0	489	1210	6431	1210	5942	0.0	0.20363513968360822
chr8	TOP1MT	143328192	143328315	0	124	1210	6431	1210	6307	0.0	0.19185032503567465
chr8	EEF1D	143588990	143590092	0	1103	0	8812	0	7709	0.0	0.0
chr8	EEF1D	143592714	143592893	0	180	0	8812	0	8632	0.0	0.0
chr8	EEF1D	143593892	143594071	0	180	0	8812	0	8632	0.0	0.0
chr8	EEF1D	143592646	143592797	0	152	0	8812	0	8660	0.0	0.0
chr8	EEF1D	143592714	143592942	0	229	0	8812	0	8583	0.0	0.0
chr8	EEF1D	143590607	143590738	0	132	0	8812	0	8680	0.0	0.0
chr8	EEF1D	143592646	143592660	0	15	0	8812	0	8797	0.0	0.0
chr8	EEF1D	143590607	143590729	0	123	0	8812	0	8689	0.0	0.0
chr8	EEF1D	143590644	143590738	0	95	0	8812	0	8717	0.0	0.0
chr8	EEF1D	143590607	143590735	0	129	0	8812	0	8683	0.0	0.0
chr8	EEF1D	143590644	143590735	0	92	0	8812	0	8720	0.0	0.0
chr8	EEF1D	143592646	143592942	0	297	0	8812	0	8515	0.0	0.0
chr8	EEF1D	143592646	143592893	0	248	0	8812	0	8564	0.0	0.0
chr8	PARP10	143985720	143985975	0	256	0	5815	0	5559	0.0	0.0
chr8	PARP10	143986054	143986233	0	180	0	5815	0	5635	0.0	0.0
chr8	SPAG11A	7860645	7860723	0	79	0	1983	0	1904	0.0	0.0
chr8	SPAG11A	7862308	7862412	0	105	0	1983	0	1878	0.0	0.0
chr8	AC022784.1	9189347	9189597	0	251	9095	16960	9095	16709	0.0	0.5443174337183554
chr8	AC022784.1	9198923	9198991	0	69	9095	16960	9095	16891	0.0	0.5384524302883192
chr8	AC022784.1	9189347	9189586	0	240	9095	16960	9095	16720	0.0	0.5439593301435407
chr8	AC022784.1	9193059	9193089	0	31	9095	16960	9095	16929	0.0	0.5372437828578179
chr8	AC022784.1	9193409	9194032	0	624	9095	16960	9095	16336	0.0	0.5567458374142997
chr8	AC022784.1	9168110	9169177	0	1068	9095	16960	9095	15892	0.0	0.5723005285678329
chr8	AC022784.1	9189350	9189586	0	237	9095	16960	9095	16723	0.0	0.5438617472941458
chr8	AC022784.1	9189350	9189597	0	248	9095	16960	9095	16712	0.0	0.5442197223551939
chr8	AC022784.1	9193957	9194032	0	76	9095	16960	9095	16884	0.0	0.5386756692726842
chr8	AC022784.1	9389704	9389827	0	124	9095	16960	9095	16836	0.0	0.5402114516512235
chr8	AC022784.1	9391505	9391565	0	61	9095	16960	9095	16899	0.0	0.5381975264808568
chr8	AC022784.1	9363261	9363382	0	122	9095	16960	9095	16838	0.0	0.5401472859009383
chr8	NEIL2	11771445	11771585	0	141	0	3371	0	3230	0.0	0.0
chr8	NEIL2	11779597	11779950	0	354	0	3371	0	3017	0.0	0.0
chr8	VPS37A	17248309	17248417	0	109	102	5710	102	5601	0.0	0.01821103374397429
chr8	VPS37A	17265906	17265981	0	76	102	5710	102	5634	0.0	0.01810436634717785
chr8	SLC7A2	17554559	17554699	0	141	0	7920	0	7779	0.0	0.0
chr8	SLC7A2	17554945	17555082	0	138	0	7920	0	7782	0.0	0.0
chr8	NAT1	18212390	18212774	0	385	0	2896	0	2511	0.0	0.0
chr8	NAT1	18216876	18216994	0	119	0	2896	0	2777	0.0	0.0
chr8	INTS10	19819572	19819676	0	105	0	6356	0	6251	0.0	0.0
chr8	INTS10	19820378	19820518	0	141	0	6356	0	6215	0.0	0.0
chr8	AC015468.1	20955684	20955834	0	151	0	1056	0	905	0.0	0.0
chr8	AC015468.1	20955873	20956120	0	248	0	1056	0	808	0.0	0.0
chr8	SLC39A14	22409945	22410115	0	171	15725	6745	15725	6574	0.0	2.3919987830848797
chr8	SLC39A14	22412036	22412206	39	171	15725	6745	15686	6574	0.22807017543859648	2.386066321874049
chr8	SORBS3	22565825	22565872	0	48	1122	5808	1122	5760	0.0	0.19479166666666667
chr8	SORBS3	22566344	22566484	0	141	1122	5808	1122	5667	0.0	0.19798835362625727
chr8	PDLIM2	22585320	22585399	0	80	102	7319	102	7239	0.0	0.014090343970161625
chr8	PDLIM2	22589298	22589374	0	77	102	7319	102	7242	0.0	0.014084507042253521
chr8	CHMP7	23247986	23248197	1152	212	236340	3469	235188	3257	5.433962264150943	72.21000921093031
chr8	CHMP7	23249209	23249381	600	173	236340	3469	235740	3296	3.468208092485549	71.52305825242719
chr8	ADAM28	24321217	24321289	0	73	0	9346	0	9273	0.0	0.0
chr8	ADAM28	24321314	24321448	0	135	0	9346	0	9211	0.0	0.0
chr8	ELP3	28097218	28097318	0	101	51	5184	51	5083	0.0	0.010033444816053512
chr8	ELP3	28099827	28099966	0	140	51	5184	51	5044	0.0	0.010111022997620936
chr8	DCTN6	30175084	30175190	0	107	102	1969	102	1862	0.0	0.05477980665950591
chr8	DCTN6	30177125	30177214	0	90	102	1969	102	1879	0.0	0.054284193720063864
chr8	NRG1	32742007	32742075	0	69	27390	19683	27390	19614	0.0	1.3964515142245335
chr8	NRG1	32742674	32742733	0	60	27390	19683	27390	19623	0.0	1.3958110380675737
chr8	AC090204.1	32996200	32996316	0	117	0	1787	0	1670	0.0	0.0
chr8	AC090204.1	33041634	33041771	0	138	0	1787	0	1649	0.0	0.0
chr8	AC090204.1	33041634	33041743	0	110	0	1787	0	1677	0.0	0.0
chr8	AC124067.3	37561838	37561938	72	101	72	3546	0	3445	0.7128712871287128	0.0
chr8	AC124067.3	37564680	37564772	0	93	72	3546	72	3453	0.0	0.020851433536055605
chr8	ASH2L	38106030	38106139	343	110	136188	5501	135845	5391	3.118181818181818	25.198478946392136
chr8	ASH2L	38106377	38106444	31	68	136188	5501	136157	5433	0.45588235294117646	25.06110804343825
chr8	DDHD2	38238088	38238209	0	122	284229	7507	284229	7385	0.0	38.48733920108328
chr8	DDHD2	38240274	38240364	54	91	284229	7507	284175	7416	0.5934065934065934	38.31917475728155
chr8	ADAM9	39071297	39071403	807	107	19580	17281	18773	17174	7.542056074766355	1.0931058576918598
chr8	ADAM9	39076146	39076275	0	130	19580	17281	19580	17151	0.0	1.1416243950790042
chr8	ADAM9	39071297	39071413	816	117	19580	17281	18764	17164	6.9743589743589745	1.0932183640177116
chr8	ADAM9	39082967	39083073	0	107	19580	17281	19580	17174	0.0	1.1400954931873764
chr8	ADAM9	39090046	39090188	0	143	19580	17281	19580	17138	0.0	1.1424903722721438
chr8	ADAM9	39090135	39090188	0	54	19580	17281	19580	17227	0.0	1.1365879143205433
chr8	ADAM9	39046001	39046058	0	58	19580	17281	19580	17223	0.0	1.1368518841084596
chr8	ADAM9	39046953	39047046	0	94	19580	17281	19580	17187	0.0	1.1392331413277477
chr8	ADAM5	39325212	39325278	0	67	0	2870	0	2803	0.0	0.0
chr8	ADAM5	39345860	39346044	0	185	0	2870	0	2685	0.0	0.0
chr8	AC123767.1	39556310	39556449	0	140	33	2038	33	1898	0.0	0.01738672286617492
chr8	AC123767.1	39557302	39557495	0	194	33	2038	33	1844	0.0	0.01789587852494577
chr8	IDO1	39909178	39909348	0	171	0	3502	0	3331	0.0	0.0
chr8	IDO1	39913000	39913148	0	149	0	3502	0	3353	0.0	0.0
chr8	IKBKB	42272082	42272205	0	124	43858	8552	43858	8428	0.0	5.203844328429046
chr8	IKBKB	42288633	42288728	306	96	43858	8552	43552	8456	3.1875	5.15042573320719
chr8	POLB	42339011	42339069	204	59	10312	3749	10108	3690	3.457627118644068	2.7392953929539297
chr8	POLB	42344952	42345019	6	68	10312	3749	10306	3681	0.08823529411764706	2.7997826677533277
chr8	POMK	43102221	43102451	0	231	31920	8233	31920	8002	0.0	3.9890027493126716
chr8	POMK	43102504	43102600	0	97	31920	8233	31920	8136	0.0	3.9233038348082596
chr8	POMK	43109563	43109849	0	287	31920	8233	31920	7946	0.0	4.017115529826328
chr8	POMK	43117432	43117513	0	82	31920	8233	31920	8151	0.0	3.9160839160839163
chr8	POMK	43120230	43120498	0	269	31920	8233	31920	7964	0.0	4.008036162732295
chr8	LINC00293	46844188	46844296	0	109	0	8452	0	8343	0.0	0.0
chr8	LINC00293	46846028	46846081	0	54	0	8452	0	8398	0.0	0.0
chr8	LINC00293	46842276	46842352	0	77	0	8452	0	8375	0.0	0.0
chr8	LINC00293	46843349	46843426	0	78	0	8452	0	8374	0.0	0.0
chr8	LINC00293	46842967	46843128	0	162	0	8452	0	8290	0.0	0.0
chr8	SPIDR	47293866	47294030	0	165	117	7208	117	7043	0.0	0.016612239102655118
chr8	SPIDR	47396375	47396626	0	252	117	7208	117	6956	0.0	0.016820011500862566
chr8	SPIDR	47330779	47330895	0	117	117	7208	117	7091	0.0	0.01649978846425046
chr8	SPIDR	47407860	47407961	0	102	117	7208	117	7106	0.0	0.016464959189417393
chr8	SNTG1	50402209	50402344	0	136	17	9266	17	9130	0.0	0.0018619934282584885
chr8	SNTG1	50438542	50438599	0	58	17	9266	17	9208	0.0	0.0018462206776715898
chr8	NKAIN3	62953901	62953972	0	72	153	28741	153	28669	0.0	0.005336774913669818
chr8	NKAIN3	62990167	62991069	0	903	153	28741	153	27838	0.0	0.00549608448882822
chr8	YTHDF3	63175330	63175416	0	87	321	6172	321	6085	0.0	0.052752670501232536
chr8	YTHDF3	63186146	63187745	15	1600	321	6172	306	4572	0.009375	0.06692913385826772
chr8	YTHDF3	63172652	63172798	0	147	321	6172	321	6025	0.0	0.05327800829875519
chr8	YTHDF3	63173650	63173681	0	32	321	6172	321	6140	0.0	0.05228013029315961
chr8	ADHFE1	66440161	66440199	0	39	3	3221	3	3182	0.0	0.0009428032683846638
chr8	ADHFE1	66442797	66442844	0	48	3	3221	3	3173	0.0	0.0009454774661203908
chr8	VXN	66510095	66510157	2837	63	350168	4772	347331	4709	45.03174603174603	73.75897218093013
chr8	VXN	66513539	66513637	863	99	350168	4772	349305	4673	8.717171717171718	74.74962550823882
chr8	CSPP1	67078366	67078487	0	122	204	22998	204	22876	0.0	0.008917642944570729
chr8	CSPP1	67079350	67079462	0	113	204	22998	204	22885	0.0	0.008914135896875683
chr8	CSPP1	67137455	67137603	0	149	204	22998	204	22849	0.0	0.00892818066436168
chr8	CSPP1	67149782	67149935	0	154	204	22998	204	22844	0.0	0.008930134827525827
chr8	CSPP1	67120878	67121130	0	253	204	22998	204	22745	0.0	0.008969004176742141
chr8	CSPP1	67123087	67123159	0	73	204	22998	204	22925	0.0	0.008898582333696838
chr8	CSPP1	67103036	67103135	0	100	204	22998	204	22898	0.0	0.008909075028386759
chr8	CSPP1	67105568	67105661	0	94	204	22998	204	22904	0.0	0.00890674118057981
chr8	CSPP1	67192097	67192217	0	121	204	22998	204	22877	0.0	0.008917253136337807
chr8	CSPP1	67192688	67192803	0	116	204	22998	204	22882	0.0	0.008915304606240713
chr8	MSC-AS1	71965408	71965534	0	127	0	7084	0	6957	0.0	0.0
chr8	MSC-AS1	71973537	71973659	0	123	0	7084	0	6961	0.0	0.0
chr8	TERF1	73030335	73030395	0	61	2193	11467	2193	11406	0.0	0.19226722777485533
chr8	TERF1	73030794	73030955	17	162	2193	11467	2176	11305	0.10493827160493827	0.1924812030075188
chr8	GDAP1	74351273	74351466	0	194	31532	20769	31532	20575	0.0	1.532539489671932
chr8	GDAP1	74360136	74360310	50	175	31532	20769	31482	20594	0.2857142857142857	1.5286976789356124
chr8	GDAP1	74351273	74351321	0	49	31532	20769	31532	20720	0.0	1.521814671814672
chr8	GDAP1	74438623	74438743	0	121	31532	20769	31532	20648	0.0	1.5271212708252615
chr8	GDAP1	74494159	74494268	0	110	31532	20769	31532	20659	0.0	1.526308146570502
chr8	GDAP1	74361883	74361978	0	96	31532	20769	31532	20673	0.0	1.5252745126493494
chr8	AC034114.2	80274104	80274243	0	140	217007	4283	217007	4143	0.0	52.37919382090273
chr8	AC034114.2	80285682	80285804	0	123	217007	4283	217007	4160	0.0	52.16514423076923
chr8	AC034114.2	80303423	80303526	0	104	217007	4283	217007	4179	0.0	51.92797319932998
chr8	AC034114.2	80327144	80327207	0	64	217007	4283	217007	4219	0.0	51.43564825788101
chr8	AC034114.2	80285686	80285804	0	119	217007	4283	217007	4164	0.0	52.115033621517775
chr8	LINC02235	81844329	81844382	0	54	6561	4148	6561	4094	0.0	1.6025891548607718
chr8	LINC02235	81844450	81844571	0	122	6561	4148	6561	4026	0.0	1.6296572280178838
chr8	RALYL	84804769	84804802	0	34	153	4551	153	4517	0.0	0.0338720389639141
chr8	RALYL	84849979	84850027	0	49	153	4551	153	4502	0.0	0.03398489560195469
chr8	CPNE3	86524708	86524814	0	107	50	6676	50	6569	0.0	0.007611508601004719
chr8	CPNE3	86524876	86524997	0	122	50	6676	50	6554	0.0	0.007628928898382667
chr8	CPNE3	86521603	86521714	0	112	50	6676	50	6564	0.0	0.007617306520414382
chr8	DECR1	90005291	90005369	0	79	0	4418	0	4339	0.0	0.0
chr8	DECR1	90015540	90015666	0	127	0	4418	0	4291	0.0	0.0
chr8	DECR1	90005447	90005731	0	285	0	4418	0	4133	0.0	0.0
chr8	DECR1	90044848	90044995	0	148	0	4418	0	4270	0.0	0.0
chr8	DECR1	90045031	90045086	0	56	0	4418	0	4362	0.0	0.0
chr8	LRRC69	91118223	91118552	186	330	339	3030	153	2700	0.5636363636363636	0.056666666666666664
chr8	LRRC69	91124492	91124619	0	128	339	3030	339	2902	0.0	0.11681598897312198
chr8	CIBAR1	93707201	93707281	0	81	0	6800	0	6719	0.0	0.0
chr8	CIBAR1	93708010	93708016	0	7	0	6800	0	6793	0.0	0.0
chr8	CIBAR1	93702164	93702383	0	220	0	6800	0	6580	0.0	0.0
chr8	CIBAR1	93702519	93702543	0	25	0	6800	0	6775	0.0	0.0
chr8	TMEM67	93759859	93759993	0	135	0	7387	0	7252	0.0	0.0
chr8	TMEM67	93761984	93762023	0	40	0	7387	0	7347	0.0	0.0
chr8	TMEM67	93762949	93763065	0	117	0	7387	0	7270	0.0	0.0
chr8	ESRP1	94692676	94692827	612	152	672	4621	60	4469	4.026315789473684	0.013425822331617812
chr8	ESRP1	94696851	94696961	0	111	672	4621	672	4510	0.0	0.14900221729490024
chr8	INTS8	94824892	94825067	0	176	7002	7694	7002	7518	0.0	0.931364724660814
chr8	INTS8	94827262	94827403	629	142	7002	7694	6373	7552	4.429577464788732	0.8438824152542372
chr8	NDUFAF6	95036301	95036494	0	194	2914	6433	2914	6239	0.0	0.46706202917134154
chr8	NDUFAF6	95040705	95040927	917	223	2914	6433	1997	6210	4.112107623318385	0.3215780998389694
chr8	NDUFAF6	95036370	95036494	0	125	2914	6433	2914	6308	0.0	0.4619530754597337
chr8	CPQ	96659283	96659323	0	41	0	3459	0	3418	0.0	0.0
chr8	CPQ	96680442	96680547	0	106	0	3459	0	3353	0.0	0.0
chr8	MATN2	97941776	97941899	0	124	1847	6549	1847	6425	0.0	0.28747081712062256
chr8	MATN2	97961407	97961530	0	124	1847	6549	1847	6425	0.0	0.28747081712062256
chr8	VPS13B	99507136	99507203	0	68	92053	16783	92053	16715	0.0	5.507209093628477
chr8	VPS13B	99507769	99507911	0	143	92053	16783	92053	16640	0.0	5.53203125
chr8	FLJ42969	101054497	101054579	0	83	0	3136	0	3053	0.0	0.0
chr8	FLJ42969	101072334	101072435	0	102	0	3136	0	3034	0.0	0.0
chr8	RIMS2	103910133	103910201	0	69	4228	14005	4228	13936	0.0	0.30338691159586684
chr8	RIMS2	103910320	103910529	51	210	4228	14005	4177	13795	0.24285714285714285	0.3027908662558898
chr8	RIMS2	103998184	103998250	0	67	4228	14005	4228	13938	0.0	0.3033433778160425
chr8	RIMS2	104013441	104013621	0	181	4228	14005	4228	13824	0.0	0.3058449074074074
chr8	HAS2-AS1	121862925	121863009	0	85	0	5667	0	5582	0.0	0.0
chr8	HAS2-AS1	121888824	121888977	0	154	0	5667	0	5513	0.0	0.0
chr8	HAS2-AS1	121903438	121903540	0	103	0	5667	0	5564	0.0	0.0
chr8	HAS2-AS1	121907643	121907710	0	68	0	5667	0	5599	0.0	0.0
chr8	LINC00964	124944486	124944797	0	312	1897	10517	1897	10205	0.0	0.1858892699657031
chr8	LINC00964	124945637	124945746	0	110	1897	10517	1897	10407	0.0	0.18228115691361582
chr8	LINC00964	124944486	124945051	0	566	1897	10517	1897	9951	0.0	0.19063410712491208
chr8	LINC00964	124946054	124946159	0	106	1897	10517	1897	10411	0.0	0.18221112285083085
chr8	LINC00964	124945634	124945746	0	113	1897	10517	1897	10404	0.0	0.18233371780084584
chr8	LINC00964	124943188	124943269	0	82	1897	10517	1897	10435	0.0	0.1817920459990417
chr8	LINC00964	124943269	124945051	0	1783	1897	10517	1897	8734	0.0	0.21719716052209756
chr8	LINC00964	124943269	124943383	0	115	1897	10517	1897	10402	0.0	0.18236877523553163
chr8	LINC00964	124943269	124943501	0	233	1897	10517	1897	10284	0.0	0.18446129910540646
chr8	LINC00964	124944566	124945051	0	486	1897	10517	1897	10031	0.0	0.18911374738311235
chr8	LINC00964	124945952	124946159	0	208	1897	10517	1897	10309	0.0	0.18401396837714618
chr8	PCAT1	126878374	126878480	0	107	0	16754	0	16647	0.0	0.0
chr8	PCAT1	126926317	126926399	0	83	0	16754	0	16671	0.0	0.0
chr8	PCAT1	126938255	126938310	0	56	0	16754	0	16698	0.0	0.0
chr8	PVT1	127795893	127796008	0	116	55393	23370	55393	23254	0.0	2.382084802614604
chr8	PVT1	127890588	127890998	0	411	55393	23370	55393	22959	0.0	2.4126921904264123
chr8	PVT1	128031958	128032272	0	315	55393	23370	55393	23055	0.0	2.402645846887877
chr8	PVT1	128070159	128070272	0	114	55393	23370	55393	23256	0.0	2.38187994496044
chr8	PVT1	128009589	128009718	0	130	55393	23370	55393	23240	0.0	2.3835197934595524
chr8	PVT1	127795893	127796071	0	179	55393	23370	55393	23191	0.0	2.3885559053080936
chr8	PVT1	127855154	127855319	0	166	55393	23370	55393	23204	0.0	2.387217721082572
chr8	PVT1	127851933	127852347	0	415	55393	23370	55393	22955	0.0	2.413112611631453
chr8	PVT1	127902455	127902539	0	85	55393	23370	55393	23285	0.0	2.378913463603178
chr8	PVT1	127932052	127932198	0	147	55393	23370	55393	23223	0.0	2.3852646083623994
chr8	PVT1	128070159	128070361	0	203	55393	23370	55393	23167	0.0	2.391030344887124
chr8	PVT1	128070161	128070272	0	112	55393	23370	55393	23258	0.0	2.3816751225384816
chr8	PVT1	128091246	128091353	0	108	55393	23370	55393	23262	0.0	2.3812655833548275
chr8	PVT1	128082752	128082848	0	97	55393	23370	55393	23273	0.0	2.3801400764834786
chr8	PVT1	127816827	127816884	0	58	55393	23370	55393	23312	0.0	2.376158201784489
chr8	PVT1	127939507	127939676	0	170	55393	23370	55393	23200	0.0	2.3876293103448276
chr8	PVT1	127969415	127969537	0	123	55393	23370	55393	23247	0.0	2.382802081989074
chr8	PVT1	127983903	127984204	0	302	55393	23370	55393	23068	0.0	2.4012918328420323
chr8	PVT1	127803149	127803559	0	411	55393	23370	55393	22959	0.0	2.4126921904264123
chr8	PVT1	128095691	128095817	0	127	55393	23370	55393	23243	0.0	2.3832121498945917
chr8	PVT1	127881800	127881884	0	85	55393	23370	55393	23285	0.0	2.378913463603178
chr8	PVT1	127882061	127882185	0	125	55393	23370	55393	23245	0.0	2.38300709830071
chr8	PVT1	127932027	127932198	0	172	55393	23370	55393	23198	0.0	2.3878351582032935
chr8	PVT1	128038916	128038980	0	65	55393	23370	55393	23305	0.0	2.376871915897876
chr8	PVT1	128048447	128048609	0	163	55393	23370	55393	23207	0.0	2.3869091222475975
chr8	PVT1	128080302	128080430	0	129	55393	23370	55393	23241	0.0	2.3834172367798288
chr8	PVT1	128074069	128074291	0	223	55393	23370	55393	23147	0.0	2.39309629757636
chr8	PVT1	128074072	128074291	0	220	55393	23370	55393	23150	0.0	2.3927861771058314
chr8	PVT1	128049584	128049748	0	165	55393	23370	55393	23205	0.0	2.3871148459383753
chr8	CCN4	133212863	133213143	0	281	0	5195	0	4914	0.0	0.0
chr8	CCN4	133225389	133225583	0	195	0	5195	0	5000	0.0	0.0
chr8	LINC02055	136089035	136089206	0	172	198	24423	198	24251	0.0	0.008164611768586863
chr8	LINC02055	136153759	136153826	0	68	198	24423	198	24355	0.0	0.008129747485115992
chr8	LINC02055	136519147	136519239	0	93	198	24423	198	24330	0.0	0.00813810110974106
chr8	LINC02055	136529794	136529941	0	148	198	24423	198	24275	0.0	0.00815653964984552
chr8	LINC02055	136563076	136563240	0	165	198	24423	198	24258	0.0	0.008162255750680188
chr8	LINC02055	136645939	136646047	0	109	198	24423	198	24314	0.0	0.00814345644484659
chr8	DENND3	141160631	141160787	0	157	1170	13106	1170	12949	0.0	0.09035446752644992
chr8	DENND3	141163332	141163429	0	98	1170	13106	1170	13008	0.0	0.08994464944649447
chr8	ADGRB1	142524237	142524304	0	68	24	7183	24	7115	0.0	0.0033731553056921995
chr8	ADGRB1	142526541	142526627	0	87	24	7183	24	7096	0.0	0.0033821871476888386
chr8	LY6E	143018832	143019119	0	288	0	2646	0	2358	0.0	0.0
chr8	LY6E	143020261	143020377	0	117	0	2646	0	2529	0.0	0.0
chr8	ZNF707	143687380	143687478	0	99	204	6052	204	5953	0.0	0.0342684360826474
chr8	ZNF707	143689203	143689301	0	99	204	6052	204	5953	0.0	0.0342684360826474
chr8	ZNF707	143684755	143685067	0	313	204	6052	204	5739	0.0	0.03554626241505489
chr8	ZNF707	143684623	143684755	0	133	204	6052	204	5919	0.0	0.03446528129751647
chr8	ZNF707	143687993	143688067	0	75	204	6052	204	5977	0.0	0.03413083486699013
chr9	SMARCA2	2170418	2170472	0	55	516675	15566	516675	15511	0.0	33.31023144864935
chr9	SMARCA2	2181570	2181676	16436	107	516675	15566	500239	15459	153.60747663551402	32.359078853742155
chr9	SMARCA2	2159813	2159909	534	97	516675	15566	516141	15469	5.505154639175258	33.36615165815502
chr9	SMARCA2	2161000	2161035	45	36	516675	15566	516630	15530	1.25	33.2665808113329
chr9	SMARCA2	2160975	2161035	45	61	516675	15566	516630	15505	0.7377049180327869	33.3202192841019
chr9	IL33	6251139	6251265	0	127	0	3262	0	3135	0.0	0.0
chr9	IL33	6252865	6252991	0	127	0	3262	0	3135	0.0	0.0
chr9	CDKN2B-AS1	22056251	22056387	2319	137	426848	18594	424529	18457	16.927007299270073	23.000975239746438
chr9	CDKN2B-AS1	22097257	22097364	1251	108	426848	18594	425597	18486	11.583333333333334	23.022665801146815
chr9	CDKN2B-AS1	22112319	22112395	633	77	426848	18594	426215	18517	8.220779220779221	23.017497434789654
chr9	AL353811.1	24551962	24552129	0	168	0	1261	0	1093	0.0	0.0
chr9	AL353811.1	24561356	24561430	0	75	0	1261	0	1186	0.0	0.0
chr9	CYP4F26P	33604296	33604403	0	108	612	3903	612	3795	0.0	0.16126482213438736
chr9	CYP4F26P	33604479	33604570	0	92	612	3903	612	3811	0.0	0.16058777223825768
chr9	UBAP1	34220907	34220948	5719	42	803760	2780	798041	2738	136.16666666666666	291.46859021183343
chr9	UBAP1	34234215	34234340	29235	126	803760	2780	774525	2654	232.02380952380952	291.8330821401658
chr9	CNTFR-AS1	34569511	34569616	0	106	0	2607	0	2501	0.0	0.0
chr9	CNTFR-AS1	34580099	34580201	0	103	0	2607	0	2504	0.0	0.0
chr9	IL11RA	34655604	34655665	4258	62	212587	4224	208329	4162	68.6774193548387	50.05502162421912
chr9	IL11RA	34656738	34656908	13191	171	212587	4224	199396	4053	77.14035087719299	49.19713792252652
chr9	DNAJB5	34990347	34990611	62	265	144946	3656	144884	3391	0.2339622641509434	42.72603951636685
chr9	DNAJB5	34990667	34990812	204	146	144946	3656	144742	3510	1.3972602739726028	41.237037037037034
chr9	DNAJB5	34990498	34990611	62	114	144946	3656	144884	3542	0.543859649122807	40.904573687182385
chr9	CLTA	36209266	36209320	396	55	3043915	2526	3043519	2471	7.2	1231.6952650748685
chr9	CLTA	36210624	36210660	1270	37	3043915	2526	3042645	2489	34.32432432432432	1222.4367215749296
chr9	MELK	36581643	36581739	50107	97	1687362	3106	1637255	3009	516.5670103092783	544.1193087404454
chr9	MELK	36589535	36589652	79060	118	1687362	3106	1608302	2988	670.0	538.2536813922356
chr9	EBLN3P	37080341	37080536	23413	196	617447	7939	594034	7743	119.45408163265306	76.71884282577813
chr9	EBLN3P	37084198	37084292	914	95	617447	7939	616533	7844	9.621052631578948	78.59931157572667
chr9	FAM27C	62015007	62015293	0	287	0	12969	0	12682	0.0	0.0
chr9	FAM27C	62028426	62028527	0	102	0	12969	0	12867	0.0	0.0
chr9	FAM27C	61920302	61920435	0	134	0	12969	0	12835	0.0	0.0
chr9	FAM27C	61952972	61954499	0	1528	0	12969	0	11441	0.0	0.0
chr9	FAM27C	61920281	61920435	0	155	0	12969	0	12814	0.0	0.0
chr9	CBWD5	65704330	65704547	0	218	435	10606	435	10388	0.0	0.04187524066230266
chr9	CBWD5	65707012	65707152	0	141	435	10606	435	10465	0.0	0.041567128523650264
chr9	CBWD5	65704330	65704414	0	85	435	10606	435	10521	0.0	0.04134587966923296
chr9	CBWD5	65693385	65693473	0	89	435	10606	435	10517	0.0	0.041361605020443094
chr9	CBWD5	65694904	65695049	0	146	435	10606	435	10460	0.0	0.04158699808795411
chr9	CBWD5	65702969	65703014	0	46	435	10606	435	10560	0.0	0.041193181818181816
chr9	CBWD5	65708901	65708958	0	58	435	10606	435	10548	0.0	0.04124004550625711
chr9	CBWD3	68259346	68259434	0	89	15465	10070	15465	9981	0.0	1.549443943492636
chr9	CBWD3	68260856	68261001	0	146	15465	10070	15465	9924	0.0	1.5583434099153568
chr9	CBWD3	68269599	68269722	0	124	15465	10070	15465	9946	0.0	1.554896440780213
chr9	CBWD3	68270301	68270518	0	218	15465	10070	15465	9852	0.0	1.5697320341047503
chr9	AL358113.1	69053139	69053260	841	122	9999	8743	9158	8621	6.89344262295082	1.0622897575687276
chr9	AL358113.1	69064937	69065035	303	99	9999	8743	9696	8644	3.0606060606060606	1.1217029153169829
chr9	AL358113.1	69046384	69046482	0	99	9999	8743	9999	8644	0.0	1.1567561314206385
chr9	TJP2	69248011	69248224	51	214	21732	10925	21681	10711	0.2383177570093458	2.024180748762954
chr9	TJP2	69251034	69251364	255	331	21732	10925	21477	10594	0.770392749244713	2.0272795922220124
chr9	LINC01504	72314985	72315090	0	106	5057	4345	5057	4239	0.0	1.1929700401037981
chr9	LINC01504	72324988	72325054	1935	67	5057	4345	3122	4278	28.880597014925375	0.7297802711547452
chr9	PCA3	76703918	76703958	0	41	408	12897	408	12856	0.0	0.031736154324828875
chr9	PCA3	76733589	76733729	0	141	408	12897	408	12756	0.0	0.03198494825964252
chr9	TLE4	79706746	79706899	0	154	102	8082	102	7928	0.0	0.012865792129162463
chr9	TLE4	79707122	79707218	0	97	102	8082	102	7985	0.0	0.012773951158422042
chr9	AL162726.3	82396707	82396800	0	94	816	4452	816	4358	0.0	0.1872418540614961
chr9	AL162726.3	82426291	82426376	0	86	816	4452	816	4366	0.0	0.1868987631699496
chr9	AL162726.3	82451602	82451729	0	128	816	4452	816	4324	0.0	0.1887141535615171
chr9	AL162726.3	82453344	82453458	0	115	816	4452	816	4337	0.0	0.18814848973945122
chr9	AL162726.3	82426981	82427026	0	46	816	4452	816	4406	0.0	0.1852019972764412
chr9	AL162726.3	82349803	82349848	0	46	816	4452	816	4406	0.0	0.1852019972764412
chr9	AL161629.1	90000640	90001218	0	579	0	3536	0	2957	0.0	0.0
chr9	AL161629.1	90004948	90005141	0	194	0	3536	0	3342	0.0	0.0
chr9	AL161629.1	89988730	89988795	0	66	0	3536	0	3470	0.0	0.0
chr9	AL161629.1	89987951	89988057	0	107	0	3536	0	3429	0.0	0.0
chr9	AL161629.1	89988593	89988795	0	203	0	3536	0	3333	0.0	0.0
chr9	AL161629.1	89992609	89992764	0	156	0	3536	0	3380	0.0	0.0
chr9	AL442224.1	93825710	93826515	0	806	0	1617	0	811	0.0	0.0
chr9	AL442224.1	93845166	93845282	0	117	0	1617	0	1500	0.0	0.0
chr9	ERCC6L2	95928078	95928150	0	73	781	16706	781	16633	0.0	0.04695484879456502
chr9	ERCC6L2	95928150	95928277	0	128	781	16706	781	16578	0.0	0.0471106285438533
chr9	FKTN	105598505	105598701	0	197	204	17148	204	16951	0.0	0.012034688218984131
chr9	FKTN	105600917	105601041	0	125	204	17148	204	17023	0.0	0.011983786641602538
chr9	FKTN	105598630	105598701	0	72	204	17148	204	17076	0.0	0.011946591707659873
chr9	FKTN	105603698	105603816	0	119	204	17148	204	17029	0.0	0.011979564272711258
chr9	FKTN	105603863	105603947	0	85	204	17148	204	17063	0.0	0.011955693606048175
chr9	FKTN	105598085	105598183	0	99	204	17148	204	17049	0.0	0.011965511173675876
chr9	LINC01505	106572733	106572889	0	157	0	12891	0	12734	0.0	0.0
chr9	LINC01505	106588376	106588464	0	89	0	12891	0	12802	0.0	0.0
chr9	LINC01505	106500356	106500505	0	150	0	12891	0	12741	0.0	0.0
chr9	LINC01505	106558471	106558583	0	113	0	12891	0	12778	0.0	0.0
chr9	LINC01505	106456513	106456553	0	41	0	12891	0	12850	0.0	0.0
chr9	LINC01505	106464017	106464165	0	149	0	12891	0	12742	0.0	0.0
chr9	LINC01505	106588379	106588464	0	86	0	12891	0	12805	0.0	0.0
chr9	LINC01505	106588827	106588940	0	114	0	12891	0	12777	0.0	0.0
chr9	LINC01505	106598531	106598663	0	133	0	12891	0	12758	0.0	0.0
chr9	LINC01505	106588827	106589013	0	187	0	12891	0	12704	0.0	0.0
chr9	CUTALP	120849922	120850006	0	85	2176427	7206	2176427	7121	0.0	305.63502317090297
chr9	CUTALP	120850362	120850657	0	296	2176427	7206	2176427	6910	0.0	314.96772793053543
chr9	CUTALP	120848936	120848979	0	44	2176427	7206	2176427	7162	0.0	303.8853672158615
chr9	GSN	121282438	121282550	0	113	0	7205	0	7092	0.0	0.0
chr9	GSN	121300055	121300126	0	72	0	7205	0	7133	0.0	0.0
chr9	GAPVD1	125268935	125268984	0	50	153	13657	153	13607	0.0	0.011244212537664437
chr9	GAPVD1	125295457	125295574	0	118	153	13657	153	13539	0.0	0.011300686904498116
chr9	LRSAM1	127493750	127494081	357	332	12203	8123	11846	7791	1.0753012048192772	1.520472339879348
chr9	LRSAM1	127495319	127495418	306	100	12203	8123	11897	8023	3.06	1.4828617724043376
chr9	LRSAM1	127495319	127495414	306	96	12203	8123	11897	8027	3.1875	1.4821228354304223
chr9	LRSAM1	127454997	127455054	150	58	12203	8123	12053	8065	2.586206896551724	1.4944823310601363
chr9	LRSAM1	127455575	127455620	0	46	12203	8123	12203	8077	0.0	1.5108332301597127
chr9	STXBP1	127684367	127684493	0	127	131172	8749	131172	8622	0.0	15.213639526791928
chr9	STXBP1	127686457	127686537	0	81	131172	8749	131172	8668	0.0	15.13290263036456
chr9	STXBP1	127639427	127639617	101871	191	131172	8749	29301	8558	533.3560209424083	3.423813975227857
chr9	STXBP1	127642468	127642563	6292	96	131172	8749	124880	8653	65.54166666666667	14.431988905581878
chr9	FPGS	127806972	127807087	0	116	720	3747	720	3631	0.0	0.19829248141007988
chr9	FPGS	127807208	127807286	0	79	720	3747	720	3668	0.0	0.19629225736095965
chr9	DNM1	128224250	128224389	180	140	7596	9109	7416	8969	1.2857142857142858	0.8268480321106032
chr9	DNM1	128226034	128226173	0	140	7596	9109	7596	8969	0.0	0.846917159103579
chr9	DNM1	128226034	128226086	0	53	7596	9109	7596	9056	0.0	0.8387809187279152
chr9	PHYHD1	128936582	128936645	0	64	0	2479	0	2415	0.0	0.0
chr9	PHYHD1	128937756	128937778	0	23	0	2479	0	2456	0.0	0.0
chr9	PTPA	129123051	129123138	0	88	4202	5645	4202	5557	0.0	0.7561633975166456
chr9	PTPA	129128984	129129110	0	127	4202	5645	4202	5518	0.0	0.7615077926785067
chr9	LINC00963	129490843	129491128	0	286	102	11349	102	11063	0.0	0.009219922263400524
chr9	LINC00963	129493418	129493595	0	178	102	11349	102	11171	0.0	0.009130785068480888
chr9	LINC00963	129490810	129491128	0	319	102	11349	102	11030	0.0	0.009247506799637352
chr9	LINC00963	129502396	129503139	0	744	102	11349	102	10605	0.0	0.009618104667609617
chr9	LINC00963	129503322	129503672	0	351	102	11349	102	10998	0.0	0.009274413529732678
chr9	LINC00963	129493415	129493595	0	181	102	11349	102	11168	0.0	0.009133237822349571
chr9	LINC00963	129493477	129493595	0	119	102	11349	102	11230	0.0	0.009082813891362422
chr9	LINC00963	129503258	129503295	0	38	102	11349	102	11311	0.0	0.009017770312085581
chr9	LINC00963	129503325	129503672	0	348	102	11349	102	11001	0.0	0.009271884374147804
chr9	LINC00963	129502396	129502519	0	124	102	11349	102	11225	0.0	0.00908685968819599
chr9	LINC00963	129502909	129503139	0	231	102	11349	102	11118	0.0	0.009174311926605505
chr9	LINC00963	129504891	129505043	0	153	102	11349	102	11196	0.0	0.009110396570203644
chr9	ASS1	130450271	130450333	72	63	46029	2714	45957	2651	1.1428571428571428	17.33572236891739
chr9	ASS1	130451601	130452043	3340	443	46029	2714	42689	2271	7.539503386004514	18.797446059004844
chr9	POMT1	131504188	131504340	0	153	45660	6345	45660	6192	0.0	7.374031007751938
chr9	POMT1	131506402	131506453	35	52	45660	6345	45625	6293	0.6730769230769231	7.250119180041316
chr9	POMT1	131506113	131506220	0	108	45660	6345	45660	6237	0.0	7.320827320827321
chr9	POMT1	131507367	131507514	2233	148	45660	6345	43427	6197	15.087837837837839	7.007745683395191
chr9	POMT1	131508910	131509022	408	113	45660	6345	45252	6232	3.6106194690265485	7.261232349165597
chr9	POMT1	131504453	131504649	627	197	45660	6345	45033	6148	3.182741116751269	7.324821080026025
chr9	COL5A1	134829975	134830044	0	70	8998	11230	8998	11160	0.0	0.8062724014336917
chr9	COL5A1	134830107	134830176	0	70	8998	11230	8998	11160	0.0	0.8062724014336917
chr9	KCNT1	135750941	135751041	0	101	58359	15507	58359	15406	0.0	3.788069583279242
chr9	KCNT1	135752378	135752457	0	80	58359	15507	58359	15427	0.0	3.7829130744798083
chr9	PMPCA	136412809	136412892	0	84	0	6212	0	6128	0.0	0.0
chr9	PMPCA	136414552	136414647	0	96	0	6212	0	6116	0.0	0.0
chr9	EHMT1	137637501	137637624	165	124	73955	18118	73790	17994	1.3306451612903225	4.100811381571635
chr9	EHMT1	137650859	137651037	0	179	73955	18118	73955	17939	0.0	4.12258208372819
chr9	EHMT1	137802856	137803010	0	155	73955	18118	73955	17963	0.0	4.117073985414463
chr9	EHMT1	137803243	137803352	0	110	73955	18118	73955	18008	0.0	4.106785872945357
chr9	CACNA1B	138101103	138101200	0	98	499	9765	499	9667	0.0	0.051618909692769215
chr9	CACNA1B	138102710	138102807	0	98	499	9765	499	9667	0.0	0.051618909692769215
chr9	CBWD1	160000	160140	510	141	152803	10402	152293	10261	3.617021276595745	14.841925738232142
chr9	CBWD1	161566	161654	1084	89	152803	10402	151719	10313	12.179775280898877	14.711432172985552
chr9	CBWD1	147900	148040	393	141	152803	10402	152410	10261	2.7872340425531914	14.853328135659293
chr9	CBWD1	151304	151427	141	124	152803	10402	152662	10278	1.1370967741935485	14.853278848024907
chr9	CBWD1	150508	150725	218	218	152803	10402	152585	10184	1.0	14.982816182246662
chr9	CBWD1	150641	150725	186	85	152803	10402	152617	10317	2.1882352941176473	14.792769215857323
chr9	CBWD1	163977	164037	4096	61	152803	10402	148707	10341	67.14754098360656	14.380330722367276
chr9	CBWD1	164402	164448	32	47	152803	10402	152771	10355	0.6808510638297872	14.753355866731047
chr9	AL161725.1	465961	466069	0	109	0	4028	0	3919	0.0	0.0
chr9	AL161725.1	466687	466853	0	167	0	4028	0	3861	0.0	0.0
chr9	VLDLR-AS1	2493074	2493180	0	107	30234	6797	30234	6690	0.0	4.519282511210762
chr9	VLDLR-AS1	2493239	2493425	0	187	30234	6797	30234	6610	0.0	4.573978819969743
chr9	VLDLR-AS1	2525537	2525717	0	181	30234	6797	30234	6616	0.0	4.569830713422007
chr9	VLDLR-AS1	2539398	2539552	255	155	30234	6797	29979	6642	1.6451612903225807	4.513550135501355
chr9	SPATA6L	4626425	4626555	51	131	16117	5395	16066	5264	0.3893129770992366	3.052051671732523
chr9	SPATA6L	4627752	4627856	0	105	16117	5395	16117	5290	0.0	3.0466918714555766
chr9	SPATA6L	4629090	4629168	0	79	16117	5395	16117	5316	0.0	3.031790820165538
chr9	SPATA6L	4635274	4635399	255	126	16117	5395	15862	5269	2.0238095238095237	3.010438413361169
chr9	PTPRD	8526626	8526644	0	19	88108	8221	88108	8202	0.0	10.742257985857108
chr9	PTPRD	8527344	8527353	0	10	88108	8221	88108	8211	0.0	10.730483497746924
chr9	PTPRD	8437197	8437239	0	43	88108	8221	88108	8178	0.0	10.773783321105405
chr9	PTPRD	8438700	8438820	0	121	88108	8221	88108	8100	0.0	10.877530864197531
chr9	LINC01235	13431202	13431438	0	237	0	3029	0	2792	0.0	0.0
chr9	LINC01235	13432399	13432494	0	96	0	3029	0	2933	0.0	0.0
chr9	BNC2	16727796	16727997	9583	202	179063	6298	169480	6096	47.44059405940594	27.801837270341206
chr9	BNC2	16738359	16738485	2605	127	179063	6298	176458	6171	20.511811023622048	28.59471722573327
chr9	NDUFB6	32558909	32558954	80033	46	595122	1390	515089	1344	1739.8478260869565	383.25074404761904
chr9	NDUFB6	32570959	32571052	100539	94	595122	1390	494583	1296	1069.563829787234	381.62268518518516
chr9	APTX	32984630	32984857	115510	228	678291	14598	562781	14370	506.62280701754383	39.16360473208072
chr9	APTX	32985970	32986030	22622	61	678291	14598	655669	14537	370.8524590163934	45.10346013620417
chr9	APTX	32987543	32987731	56215	189	678291	14598	622076	14409	297.43386243386243	43.172739260184606
chr9	APTX	32987759	32987846	22542	88	678291	14598	655749	14510	256.15909090909093	45.19290144727774
chr9	APTX	32987543	32987729	55351	187	678291	14598	622940	14411	295.9946524064171	43.2267018249948
chr9	APTX	32988082	32988129	16035	48	678291	14598	662256	14550	334.0625	45.5158762886598
chr9	APTX	32989758	32989895	48434	138	678291	14598	629857	14460	350.9710144927536	43.55857538035961
chr9	AQP7	33386968	33387092	0	125	0	3491	0	3366	0.0	0.0
chr9	AQP7	33395077	33395195	0	119	0	3491	0	3372	0.0	0.0
chr9	AQP7	33394126	33394277	0	152	0	3491	0	3339	0.0	0.0
chr9	TPM2	35684731	35684807	231875	77	4089375	3010	3857500	2933	3011.3636363636365	1315.2062734401636
chr9	TPM2	35685063	35685139	33269	77	4089375	3010	4056106	2933	432.06493506493507	1382.9205591544494
chr9	PAX5	36882003	36882105	0	103	8817	9583	8817	9480	0.0	0.9300632911392405
chr9	PAX5	36923354	36923484	51	131	8817	9583	8766	9452	0.3893129770992366	0.9274227676682184
chr9	PAX5	36846842	36846929	0	88	8817	9583	8817	9495	0.0	0.9285939968404423
chr9	PAX5	37014996	37015194	510	199	8817	9583	8307	9384	2.562814070351759	0.885230179028133
chr9	PAX5	37020635	37020801	1071	167	8817	9583	7746	9416	6.413173652694611	0.822642310960068
chr9	PAX5	36930887	36930944	51	58	8817	9583	8766	9525	0.8793103448275862	0.9203149606299212
chr9	CNTNAP3	39109159	39109287	9138	129	253992	8468	244854	8339	70.83720930232558	29.362513490826238
chr9	CNTNAP3	39118102	39118259	4871	158	253992	8468	249121	8310	30.829113924050635	29.978459687123948
chr9	CBWD6	41170278	41170423	0	146	0	9106	0	8960	0.0	0.0
chr9	CBWD6	41171846	41171934	0	89	0	9106	0	9017	0.0	0.0
chr9	CBWD6	41170283	41170423	0	141	0	9106	0	8965	0.0	0.0
chr9	CBWD6	41160804	41161021	0	218	0	9106	0	8888	0.0	0.0
chr9	CBWD6	41161600	41161723	0	124	0	9106	0	8982	0.0	0.0
chr9	CBWD6	41160937	41161021	0	85	0	9106	0	9021	0.0	0.0
chr9	LERFS	62859071	62859193	0	123	0	5599	0	5476	0.0	0.0
chr9	LERFS	62866966	62867110	0	145	0	5599	0	5454	0.0	0.0
chr9	PRUNE2	76624451	76624490	0	40	766	13950	766	13910	0.0	0.05506829618979152
chr9	PRUNE2	76625022	76625058	0	37	766	13950	766	13913	0.0	0.05505642205131891
chr9	LNCARSR	79527609	79527864	0	256	306	4277	306	4021	0.0	0.0761004725192738
chr9	LNCARSR	79529003	79529171	0	169	306	4277	306	4108	0.0	0.07448880233690361
chr9	LINC02843	88640510	88640581	679	72	3966	1616	3287	1544	9.430555555555555	2.1288860103626943
chr9	LINC02843	88644362	88644506	307	145	3966	1616	3659	1471	2.117241379310345	2.487423521414004
chr9	SEMA4D	89418055	89418118	0	64	255	13525	255	13461	0.0	0.01894361488745264
chr9	SEMA4D	89455887	89455953	0	67	255	13525	255	13458	0.0	0.018947837717342843
chr9	SPTLC1	92070123	92070296	0	174	0	5615	0	5441	0.0	0.0
chr9	SPTLC1	92076797	92077035	0	239	0	5615	0	5376	0.0	0.0
chr9	SPTLC1	92079433	92079566	0	134	0	5615	0	5481	0.0	0.0
chr9	FANCC	95265595	95265754	0	160	21008	11365	21008	11205	0.0	1.8748772869254797
chr9	FANCC	95310241	95310355	0	115	21008	11365	21008	11250	0.0	1.8673777777777778
chr9	HSD17B3	96252802	96252910	0	109	522	2354	522	2245	0.0	0.23251670378619155
chr9	HSD17B3	96254867	96254943	0	77	522	2354	522	2277	0.0	0.22924901185770752
chr9	CDC14B	96509672	96509789	0	118	102	10496	102	10378	0.0	0.00982848333012141
chr9	CDC14B	96515648	96515792	0	145	102	10496	102	10351	0.0	0.00985412037484301
chr9	PTCSC2	97724412	97724530	0	119	494	2293	494	2174	0.0	0.22723091076356947
chr9	PTCSC2	97809894	97810039	0	146	494	2293	494	2147	0.0	0.23008849557522124
chr9	AL136084.1	98870432	98870771	0	340	0	4560	0	4220	0.0	0.0
chr9	AL136084.1	98870802	98870984	0	183	0	4560	0	4377	0.0	0.0
chr9	AL136084.1	98870890	98870984	0	95	0	4560	0	4465	0.0	0.0
chr9	AL136084.1	98871359	98871396	0	38	0	4560	0	4522	0.0	0.0
chr9	ABCA1	104817225	104817304	0	80	0	11395	0	11315	0.0	0.0
chr9	ABCA1	104817331	104817404	0	74	0	11395	0	11321	0.0	0.0
chr9	ELP1	108875632	108875735	0	104	612	16260	612	16156	0.0	0.037880663530576876
chr9	ELP1	108877612	108877800	0	189	612	16260	612	16071	0.0	0.0380810154937465
chr9	SUSD1	112052154	112052349	0	196	1185	4096	1185	3900	0.0	0.3038461538461538
chr9	SUSD1	112052398	112052438	0	41	1185	4096	1185	4055	0.0	0.2922318125770654
chr9	TNC	115048259	115048532	0	274	41658	9672	41658	9398	0.0	4.4326452436688655
chr9	TNC	115052739	115053015	40	277	41658	9672	41618	9395	0.1444043321299639	4.4298030867482705
chr9	GGTA1	121452143	121452281	0	139	0	4510	0	4371	0.0	0.0
chr9	GGTA1	121455654	121455841	0	188	0	4510	0	4322	0.0	0.0
chr9	SCAI	124974174	124974276	0	103	31420	13057	31420	12954	0.0	2.425505635324996
chr9	SCAI	124975246	124975389	0	144	31420	13057	31420	12913	0.0	2.4332068458142957
chr9	MAPKAP1	125484442	125484583	0	142	5583	6398	5583	6256	0.0	0.892423273657289
chr9	MAPKAP1	125506309	125506417	0	109	5583	6398	5583	6289	0.0	0.887740499284465
chr9	PTRH1	127714378	127714424	727	47	17408	3493	16681	3446	15.46808510638298	4.840684852002322
chr9	PTRH1	127714602	127714702	780	101	17408	3493	16628	3392	7.7227722772277225	4.902122641509434
chr9	PIP5KL1	127925866	127925979	0	114	2394	2806	2394	2692	0.0	0.8893016344725111
chr9	PIP5KL1	127927152	127927208	0	57	2394	2806	2394	2749	0.0	0.8708621316842489
chr9	CIZ1	128187862	128187934	0	73	70028	7924	70028	7851	0.0	8.91962807285696
chr9	CIZ1	128190328	128190444	0	117	70028	7924	70028	7807	0.0	8.969898808761368
chr9	CRAT	129108762	129108903	0	142	612	3826	612	3684	0.0	0.16612377850162866
chr9	CRAT	129109178	129109277	0	100	612	3826	612	3726	0.0	0.1642512077294686
chr9	CRAT	129108407	129108478	0	72	612	3826	612	3754	0.0	0.16302610548748003
chr9	ASB6	129638572	129638659	0	88	7890	4628	7890	4540	0.0	1.7378854625550662
chr9	ASB6	129639201	129639310	0	110	7890	4628	7890	4518	0.0	1.746347941567065
chr9	AL157938.2	131136721	131136822	0	102	20637	3038	20637	2936	0.0	7.028950953678474
chr9	AL157938.2	131153152	131153345	7573	194	20637	3038	13064	2844	39.0360824742268	4.593530239099859
chr9	AL157938.2	131141677	131141766	214	90	20637	3038	20423	2948	2.3777777777777778	6.92774762550882
chr9	AL157938.2	131133626	131133715	10500	90	20637	3038	10137	2948	116.66666666666667	3.4386024423337855
chr9	TSC1	132903650	132903817	0	168	614065	16580	614065	16412	0.0	37.41561052888131
chr9	TSC1	132904410	132904454	0	45	614065	16580	614065	16535	0.0	37.13728454792864
chr9	TSC1	132925586	132925739	0	154	614065	16580	614065	16426	0.0	37.383720930232556
chr9	TSC1	132927200	132927304	0	105	614065	16580	614065	16475	0.0	37.27253414264037
chr9	ENTR1	136408998	136409067	0	70	0	2733	0	2663	0.0	0.0
chr9	ENTR1	136410089	136410239	0	151	0	2733	0	2582	0.0	0.0
chr9	SEC16A	136445051	136445111	0	61	0	10006	0	9945	0.0	0.0
chr9	SEC16A	136445644	136445719	0	76	0	10006	0	9930	0.0	0.0
chr9	LCN10	136740835	136740943	0	109	2040	3360	2040	3251	0.0	0.6274992310058444
chr9	LCN10	136741251	136741361	0	111	2040	3360	2040	3249	0.0	0.6278855032317636
chr9	LCN10	136740835	136741014	0	180	2040	3360	2040	3180	0.0	0.6415094339622641
chr9	NSMF	137455238	137455307	0	70	55	3951	55	3881	0.0	0.014171605256377222
chr9	NSMF	137455628	137455634	0	7	55	3951	55	3944	0.0	0.013945233265720081
chr10	TUBB8	48614	48725	0	112	0	2879	0	2767	0.0	0.0
chr10	TUBB8	48803	48912	0	110	0	2879	0	2769	0.0	0.0
chr10	LINC02645	2454982	2455121	0	140	102	5534	102	5394	0.0	0.018909899888765295
chr10	LINC02645	2501557	2501809	0	253	102	5534	102	5281	0.0	0.019314523764438554
chr10	LINC02645	2485696	2485828	0	133	102	5534	102	5401	0.0	0.01888539159414923
chr10	LINC02645	2451203	2451331	0	129	102	5534	102	5405	0.0	0.01887141535615171
chr10	LINC02669	3487331	3488352	0	1022	462	6362	462	5340	0.0	0.08651685393258426
chr10	LINC02669	3496152	3496236	0	85	462	6362	462	6277	0.0	0.07360203919069619
chr10	LASTR	5596010	5596099	0	90	0	4818	0	4728	0.0	0.0
chr10	LASTR	5610822	5610961	0	140	0	4818	0	4678	0.0	0.0
chr10	CELF2-DT	10422597	10422774	0	178	0	6941	0	6763	0.0	0.0
chr10	CELF2-DT	10433923	10434031	0	109	0	6941	0	6832	0.0	0.0
chr10	LINC00710	10946785	10947122	0	338	0	6504	0	6166	0.0	0.0
chr10	LINC00710	10947445	10947556	0	112	0	6504	0	6392	0.0	0.0
chr10	LINC00710	10936623	10936716	0	94	0	6504	0	6410	0.0	0.0
chr10	LINC00710	10937437	10937561	0	125	0	6504	0	6379	0.0	0.0
chr10	LINC00710	10936623	10936704	0	82	0	6504	0	6422	0.0	0.0
chr10	FRMD4A	13753055	13753100	0	46	49822	13266	49822	13220	0.0	3.7686838124054463
chr10	FRMD4A	13759164	13759506	0	343	49822	13266	49822	12923	0.0	3.8552967577187958
chr10	DCLRE1C	14945104	14945189	2077	86	105127	9612	103050	9526	24.151162790697676	10.817761914759606
chr10	DCLRE1C	14949035	14949087	2082	53	105127	9612	103045	9559	39.283018867924525	10.779893294277644
chr10	DCLRE1C	14945434	14945565	7525	132	105127	9612	97602	9480	57.00757575757576	10.295569620253165
chr10	DCLRE1C	14947524	14947609	1576	86	105127	9612	103551	9526	18.325581395348838	10.87035481839177
chr10	TRDMT1	17161482	17161548	42	67	195	15469	153	15402	0.6268656716417911	0.009933774834437087
chr10	TRDMT1	17162165	17162237	0	73	195	15469	195	15396	0.0	0.012665627435697584
chr10	TRDMT1	17168840	17168917	0	78	195	15469	195	15391	0.0	0.012669742057046325
chr10	DNAJC1	21920797	21920963	0	167	1274	2503	1274	2336	0.0	0.5453767123287672
chr10	DNAJC1	21928505	21928552	0	48	1274	2503	1274	2455	0.0	0.5189409368635438
chr10	SELENOOLP	26667566	26667646	0	81	487	1401	487	1320	0.0	0.36893939393939396
chr10	SELENOOLP	26668406	26668494	0	89	487	1401	487	1312	0.0	0.3711890243902439
chr10	ABI1	26755654	26755741	0	88	90	4231	90	4143	0.0	0.02172338884866039
chr10	ABI1	26759061	26759235	0	175	90	4231	90	4056	0.0	0.022189349112426034
chr10	ABI1	26759061	26759238	0	178	90	4231	90	4053	0.0	0.02220577350111029
chr10	ANKRD26	27060817	27060881	0	65	193293	13297	193293	13232	0.0	14.60799576783555
chr10	ANKRD26	27061143	27061242	204	100	193293	13297	193089	13197	2.04	14.631279836326438
chr10	ANKRD26	27080031	27080153	0	123	193293	13297	193293	13174	0.0	14.672309093669348
chr10	ANKRD26	27080648	27080771	0	124	193293	13297	193293	13173	0.0	14.673422910498747
chr10	ACBD5	27215534	27215641	0	108	724	11777	724	11669	0.0	0.062044733910360785
chr10	ACBD5	27217979	27218183	0	205	724	11777	724	11572	0.0	0.06256481161424127
chr10	ACBD5	27220372	27220464	0	93	724	11777	724	11684	0.0	0.06196508045190004
chr10	ACBD5	27221695	27221746	0	52	724	11777	724	11725	0.0	0.061748400852878464
chr10	ARMC4	27835980	27836040	0	61	2870	6364	2870	6303	0.0	0.4553387275900365
chr10	ARMC4	27853241	27853363	0	123	2870	6364	2870	6241	0.0	0.4598622015702612
chr10	ZNF438	30857679	30857778	0	100	51	4283	51	4183	0.0	0.012192206550322734
chr10	ZNF438	30875330	30875509	0	180	51	4283	51	4103	0.0	0.012429929320009749
chr10	ITGB1	32906464	32906580	0	117	150	12473	150	12356	0.0	0.012139851084493364
chr10	ITGB1	32907062	32907143	0	82	150	12473	150	12391	0.0	0.012105560487450569
chr10	ITGB1	32906464	32906562	0	99	150	12473	150	12374	0.0	0.01212219169225796
chr10	ITGB1	32936349	32936423	0	75	150	12473	150	12398	0.0	0.012098725600903372
chr10	ITGB1	32938553	32938730	0	178	150	12473	150	12295	0.0	0.012200081333875559
chr10	ITGB1	32953592	32953809	0	218	150	12473	150	12255	0.0	0.012239902080783354
chr10	ITGB1	32936241	32936423	0	183	150	12473	150	12290	0.0	0.012205044751830757
chr10	ITGB1	32951674	32951758	0	85	150	12473	150	12388	0.0	0.012108492089118501
chr10	ZNF33B	42632294	42632439	0	146	0	2830	0	2684	0.0	0.0
chr10	ZNF33B	42636919	42636972	0	54	0	2830	0	2776	0.0	0.0
chr10	TMEM72-AS1	44834065	44835319	0	1255	51	9465	51	8210	0.0	0.006211936662606578
chr10	TMEM72-AS1	44885207	44885300	0	94	51	9465	51	9371	0.0	0.005442322057411162
chr10	TMEM72-AS1	44923080	44923226	0	147	51	9465	51	9318	0.0	0.005473277527366388
chr10	TMEM72-AS1	44830999	44831245	0	247	51	9465	51	9218	0.0	0.0055326535040138855
chr10	TMEM72-AS1	44845339	44845407	0	69	51	9465	51	9396	0.0	0.005427841634738187
chr10	TMEM72-AS1	44873634	44874087	0	454	51	9465	51	9011	0.0	0.005659749195427811
chr10	TMEM72-AS1	44834065	44835315	0	1251	51	9465	51	8214	0.0	0.00620891161431702
chr10	CEP164P1	45070477	45070982	0	506	51	4368	51	3862	0.0	0.01320559295701709
chr10	CEP164P1	45071246	45071309	0	64	51	4368	51	4304	0.0	0.011849442379182156
chr10	CEP164P1	45066332	45066522	0	191	51	4368	51	4177	0.0	0.01220971989466124
chr10	AGAP4	45844325	45844394	183	70	892	3384	709	3314	2.6142857142857143	0.21394085697042847
chr10	AGAP4	45846686	45846755	0	70	892	3384	892	3314	0.0	0.2691611345805673
chr10	AGAP4	45841652	45841687	0	36	892	3384	892	3348	0.0	0.26642771804062126
chr10	A1CF	50859841	50859985	0	145	0	9619	0	9474	0.0	0.0
chr10	A1CF	50864032	50864080	0	49	0	9619	0	9570	0.0	0.0
chr10	ANK3	60145967	60146021	20573	55	87829	22486	67256	22431	374.05454545454546	2.998350497079934
chr10	ANK3	60166590	60166653	96	64	87829	22486	87733	22422	1.5	3.912808848452413
chr10	LRRC20	70323862	70324030	0	169	0	3632	0	3463	0.0	0.0
chr10	LRRC20	70340552	70340702	0	151	0	3632	0	3481	0.0	0.0
chr10	LRRC20	70376451	70376596	0	146	0	3632	0	3486	0.0	0.0
chr10	ASCC1	72133056	72133181	0	126	17435	5932	17435	5806	0.0	3.00292800551154
chr10	ASCC1	72152868	72152988	0	121	17435	5932	17435	5811	0.0	3.0003441748408193
chr10	ASCC1	72102333	72102412	0	80	17435	5932	17435	5852	0.0	2.9793233082706765
chr10	ASCC1	72102849	72102967	765	119	17435	5932	16670	5813	6.428571428571429	2.867710304489936
chr10	ASCC1	72204421	72204505	0	85	17435	5932	17435	5847	0.0	2.981871044980332
chr10	ASCC1	72208024	72208146	0	123	17435	5932	17435	5809	0.0	3.001377173351696
chr10	P4HA1	73043886	73043957	0	72	43	3109	43	3037	0.0	0.01415870925255186
chr10	P4HA1	73044980	73045051	0	72	43	3109	43	3037	0.0	0.01415870925255186
chr10	ECD	73152292	73152421	0	130	0	2757	0	2627	0.0	0.0
chr10	ECD	73154255	73154448	0	194	0	2757	0	2563	0.0	0.0
chr10	CAMK2G	73825278	73825347	0	70	838	6806	838	6736	0.0	0.1244061757719715
chr10	CAMK2G	73828088	73828121	0	34	838	6806	838	6772	0.0	0.12374483165977555
chr10	CAMK2G	73825320	73825347	0	28	838	6806	838	6778	0.0	0.12363529064620832
chr10	DUSP13	75105660	75105868	0	209	0	2053	0	1844	0.0	0.0
chr10	DUSP13	75107991	75108209	0	219	0	2053	0	1834	0.0	0.0
chr10	DUSP13	75107991	75108283	0	293	0	2053	0	1760	0.0	0.0
chr10	DUSP13	75101866	75101961	0	96	0	2053	0	1957	0.0	0.0
chr10	KCNMA1	77108285	77108377	0	93	42679	29771	42679	29678	0.0	1.4380686030055934
chr10	KCNMA1	77108480	77108572	0	93	42679	29771	42679	29678	0.0	1.4380686030055934
chr10	KCNMA1	77001406	77001580	48	175	42679	29771	42631	29596	0.2742857142857143	1.4404311393431546
chr10	KCNMA1	77008184	77008193	0	10	42679	29771	42679	29761	0.0	1.434057995363059
chr10	KCNMA1	76974486	76974573	0	88	42679	29771	42679	29683	0.0	1.4378263652595762
chr10	KCNMA1	76977542	76977638	0	97	42679	29771	42679	29674	0.0	1.4382624519781626
chr10	ZMIZ1-AS1	79050281	79050417	228	137	8166	4634	7938	4497	1.6642335766423357	1.7651767845230153
chr10	ZMIZ1-AS1	79054595	79054728	0	134	8166	4634	8166	4500	0.0	1.8146666666666667
chr10	SFTPA2	79559667	79559730	0	64	80034	2541	80034	2477	0.0	32.31085991118288
chr10	SFTPA2	79559968	79559998	0	31	80034	2541	80034	2510	0.0	31.88605577689243
chr10	SFTPA2	79559968	79560163	408	196	80034	2541	79626	2345	2.0816326530612246	33.955650319829424
chr10	NUTM2B-AS1	79806038	79806122	0	85	1780319	19359	1780319	19274	0.0	92.36894261699699
chr10	NUTM2B-AS1	79808758	79808832	133	75	1780319	19359	1780186	19284	1.7733333333333334	92.31414644264676
chr10	NUTM2A-AS1	87291935	87292533	0	599	51	19888	51	19289	0.0	0.002643993986209757
chr10	NUTM2A-AS1	87307956	87308060	0	105	51	19888	51	19783	0.0	0.002577970985189304
chr10	IDE	92478644	92478789	0	146	1764	14554	1764	14408	0.0	0.12243198223209328
chr10	IDE	92479276	92479421	0	146	1764	14554	1764	14408	0.0	0.12243198223209328
chr10	IDE	92479276	92480916	0	1641	1764	14554	1764	12913	0.0	0.1366065205606753
chr10	SORBS1	95322745	95322805	0	61	1829	10991	1829	10930	0.0	0.16733760292772187
chr10	SORBS1	95336520	95336805	0	286	1829	10991	1829	10705	0.0	0.17085474077533863
chr10	SORBS1	95336520	95337294	0	775	1829	10991	1829	10216	0.0	0.17903288958496477
chr10	SORBS1	95386990	95387119	0	130	1829	10991	1829	10861	0.0	0.1684006997514041
chr10	SORBS1	95394610	95394673	0	64	1829	10991	1829	10927	0.0	0.1673835453463897
chr10	SORBS1	95371325	95371427	0	103	1829	10991	1829	10888	0.0	0.16798310066127847
chr10	SORBS1	95371983	95372049	0	67	1829	10991	1829	10924	0.0	0.1674295129989015
chr10	SORBS1	95414493	95414862	0	370	1829	10991	1829	10621	0.0	0.17220600696732888
chr10	SORBS1	95415468	95416185	0	718	1829	10991	1829	10273	0.0	0.17803952107466173
chr10	SORBS1	95414493	95414655	0	163	1829	10991	1829	10828	0.0	0.1689139268562985
chr10	ENTPD1-AS1	95904829	95904935	0	107	35357	22304	35357	22197	0.0	1.5928729107537054
chr10	ENTPD1-AS1	95941221	95941292	0	72	35357	22304	35357	22232	0.0	1.5903652392947103
chr10	ENTPD1-AS1	95878224	95878263	0	40	35357	22304	35357	22264	0.0	1.5880794107078693
chr10	ENTPD1-AS1	95904829	95904938	0	110	35357	22304	35357	22194	0.0	1.5930882220419933
chr10	ENTPD1-AS1	95897557	95897679	1800	123	35357	22304	33557	22181	14.634146341463415	1.512871376403228
chr10	OPALIN	96351377	96351410	0	34	32755	3882	32755	3848	0.0	8.512214137214137
chr10	OPALIN	96355254	96355290	0	37	32755	3882	32755	3845	0.0	8.51885565669701
chr10	CWF19L1	100256261	100256476	0	216	204	3999	204	3783	0.0	0.05392545598731166
chr10	CWF19L1	100260217	100260319	0	103	204	3999	204	3896	0.0	0.052361396303901436
chr10	MRPL43	100983947	100984074	0	128	51	2672	51	2544	0.0	0.020047169811320754
chr10	MRPL43	100986748	100986975	0	228	51	2672	51	2444	0.0	0.020867430441898527
chr10	POLL	101585861	101586156	0	296	5033	5429	5033	5133	0.0	0.9805182154685369
chr10	POLL	101587245	101587406	102	162	5033	5429	4931	5267	0.6296296296296297	0.9362065692044808
chr10	POLL	101587121	101587200	51	80	5033	5429	4982	5349	0.6375	0.9313890446812488
chr10	POLL	101587245	101587382	102	138	5033	5429	4931	5291	0.7391304347826086	0.931959931959932
chr10	KCNIP2	101828150	101828258	0	109	95	2412	95	2303	0.0	0.04125054277029961
chr10	KCNIP2	101828388	101828459	0	72	95	2412	95	2340	0.0	0.0405982905982906
chr10	NT5C2	103111744	103111805	0	62	2680	8572	2680	8510	0.0	0.31492361927144535
chr10	NT5C2	103139405	103139479	0	75	2680	8572	2680	8497	0.0	0.315405437213134
chr10	NT5C2	103181184	103181328	0	145	2680	8572	2680	8427	0.0	0.3180253945650884
chr10	NT5C2	103197764	103197857	0	94	2680	8572	2680	8478	0.0	0.3161122906345836
chr10	NT5C2	103136248	103136372	510	125	2680	8572	2170	8447	4.08	0.2568959393867645
chr10	NT5C2	103111692	103111805	0	114	2680	8572	2680	8458	0.0	0.31685977772523055
chr10	PCGF6	103339501	103339769	9972	269	27805	3020	17833	2751	37.07063197026022	6.482370047255543
chr10	PCGF6	103345023	103345132	4860	110	27805	3020	22945	2910	44.18181818181818	7.884879725085911
chr10	ATP5MD	103394198	103394394	612	197	612	930	0	733	3.1065989847715736	0.0
chr10	ATP5MD	103395745	103396032	0	288	612	930	612	642	0.0	0.9532710280373832
chr10	LINC01435	107854434	107854483	0	50	195	6685	195	6635	0.0	0.0293896006028636
chr10	LINC01435	107901008	107901087	0	80	195	6685	195	6605	0.0	0.029523088569265707
chr10	LINC01435	108053430	108053489	0	60	195	6685	195	6625	0.0	0.02943396226415094
chr10	LINC01435	108058845	108058917	0	73	195	6685	195	6612	0.0	0.029491833030852996
chr10	XPNPEP1	109893011	109893075	0	65	369	6715	369	6650	0.0	0.055488721804511275
chr10	XPNPEP1	109907690	109907815	0	126	369	6715	369	6589	0.0	0.05600242828957353
chr10	XPNPEP1	109915010	109915099	0	90	369	6715	369	6625	0.0	0.05569811320754717
chr10	BBIP1	110907679	110907836	0	158	0	7695	0	7537	0.0	0.0
chr10	BBIP1	110918120	110918213	0	94	0	7695	0	7601	0.0	0.0
chr10	BBIP1	110908523	110908551	0	29	0	7695	0	7666	0.0	0.0
chr10	BBIP1	110910749	110911039	0	291	0	7695	0	7404	0.0	0.0
chr10	BBIP1	110901537	110901612	0	76	0	7695	0	7619	0.0	0.0
chr10	BBIP1	110901537	110901585	0	49	0	7695	0	7646	0.0	0.0
chr10	ABLIM1	114481478	114481526	0	49	7103	10244	7103	10195	0.0	0.6967140755272192
chr10	ABLIM1	114485296	114485380	0	85	7103	10244	7103	10159	0.0	0.6991829904518161
chr10	HSPA12A	116707199	116707285	0	87	22311	21134	22311	21047	0.0	1.0600560649973867
chr10	HSPA12A	116834934	116835022	0	89	22311	21134	22311	21045	0.0	1.0601568068424805
chr10	AL513324.1	117827598	117828198	0	601	153	2042	153	1441	0.0	0.10617626648161
chr10	AL513324.1	117828804	117828915	0	112	153	2042	153	1930	0.0	0.07927461139896373
chr10	WDR11-AS1	120791727	120791926	0	200	37440	6721	37440	6521	0.0	5.741450697745744
chr10	WDR11-AS1	120830218	120830343	76	126	37440	6721	37364	6595	0.6031746031746031	5.665504169825626
chr10	FGFR2	121515116	121515319	0	204	137099	7609	137099	7405	0.0	18.514382174206617
chr10	FGFR2	121519978	121520169	0	192	137099	7609	137099	7417	0.0	18.48442766617231
chr10	FGFR2	121517466	121517472	0	7	137099	7609	137099	7602	0.0	18.03459615890555
chr10	FGFR2	121518681	121518829	0	149	137099	7609	137099	7460	0.0	18.377882037533514
chr10	FGFR2	121517318	121517463	0	146	137099	7609	137099	7463	0.0	18.370494439233553
chr10	ATE1	121898840	121898969	0	130	0	5400	0	5270	0.0	0.0
chr10	ATE1	121899865	121899994	0	130	0	5400	0	5270	0.0	0.0
chr10	CTBP2	125110989	125111093	51	105	2193	9202	2142	9097	0.4857142857142857	0.23546224029899968
chr10	CTBP2	125133511	125133612	0	102	2193	9202	2193	9100	0.0	0.240989010989011
chr10	UROS	125789282	125789528	0	247	284	8118	284	7871	0.0	0.036081819336805994
chr10	UROS	125794021	125794388	0	368	284	8118	284	7750	0.0	0.03664516129032258
chr10	UROS	125789282	125789363	0	82	284	8118	284	8036	0.0	0.0353409656545545
chr10	AL359094.1	127016497	127016581	0	85	0	4247	0	4162	0.0	0.0
chr10	AL359094.1	127018587	127018657	0	71	0	4247	0	4176	0.0	0.0
chr10	AL359094.1	127018587	127018960	0	374	0	4247	0	3873	0.0	0.0
chr10	PFKP	3119891	3120044	1143	154	4246	6142	3103	5988	7.422077922077922	0.5182030728122913
chr10	PFKP	3125096	3125249	0	154	4246	6142	4246	5988	0.0	0.7090848363393454
chr10	TASOR2	5714134	5714207	0	74	39262	10604	39262	10530	0.0	3.728584995251662
chr10	TASOR2	5717658	5717750	0	93	39262	10604	39262	10511	0.0	3.7353248977261915
chr10	PFKFB3	6224505	6224623	0	119	11553	6138	11553	6019	0.0	1.919421830868915
chr10	PFKFB3	6225160	6225248	0	89	11553	6138	11553	6049	0.0	1.9099024632170607
chr10	PFKFB3	6229108	6229180	0	73	11553	6138	11553	6065	0.0	1.9048639736191262
chr10	PFKFB3	6231262	6231314	0	53	11553	6138	11553	6085	0.0	1.8986031224322104
chr10	PRKCQ-AS1	6585797	6585846	0	50	0	5311	0	5261	0.0	0.0
chr10	PRKCQ-AS1	6586762	6586880	0	119	0	5311	0	5192	0.0	0.0
chr10	PRKCQ-AS1	6608347	6608408	0	62	0	5311	0	5249	0.0	0.0
chr10	PRKCQ-AS1	6615369	6615637	0	269	0	5311	0	5042	0.0	0.0
chr10	ITIH2	7705107	7705182	0	76	0	3352	0	3276	0.0	0.0
chr10	ITIH2	7707200	7707233	0	34	0	3352	0	3318	0.0	0.0
chr10	ITIH2	7709021	7709191	0	171	0	3352	0	3181	0.0	0.0
chr10	SEC61A2	12149851	12149961	28678	111	466722	3933	438044	3822	258.36036036036035	114.61119832548404
chr10	SEC61A2	12156906	12157067	288	162	466722	3933	466434	3771	1.7777777777777777	123.68973747016706
chr10	AL157392.3	13648084	13648230	0	147	13373	9029	13373	8882	0.0	1.505629362756136
chr10	AL157392.3	13652407	13652489	0	83	13373	9029	13373	8946	0.0	1.4948580371115583
chr10	AL157392.3	13648619	13648768	0	150	13373	9029	13373	8879	0.0	1.5061380786124563
chr10	AL157392.3	13652845	13652882	0	38	13373	9029	13373	8991	0.0	1.487376265154043
chr10	AL157392.3	13648625	13648768	0	144	13373	9029	13373	8885	0.0	1.5051209904333145
chr10	AL157392.3	13652845	13652929	0	85	13373	9029	13373	8944	0.0	1.4951923076923077
chr10	AL157392.3	13654088	13654258	0	171	13373	9029	13373	8858	0.0	1.5097087378640777
chr10	AL157392.3	13652845	13653148	0	304	13373	9029	13373	8725	0.0	1.5327220630372493
chr10	CACNB2	18514235	18514369	0	135	1326	11186	1326	11051	0.0	0.11998914125418514
chr10	CACNB2	18514979	18515041	0	63	1326	11186	1326	11123	0.0	0.11921244268632564
chr10	CACNB2	18514510	18514530	0	21	1326	11186	1326	11165	0.0	0.11876399462606359
chr10	CACNB2	18506470	18506547	0	78	1326	11186	1326	11108	0.0	0.11937342455887648
chr10	MALRD1	19450306	19450490	0	185	28	7797	28	7612	0.0	0.0036784025223331584
chr10	MALRD1	19488959	19489173	0	215	28	7797	28	7582	0.0	0.0036929570034291742
chr10	MLLT10	21541262	21541361	0	100	51	8958	51	8858	0.0	0.005757507337999549
chr10	MLLT10	21557620	21557824	0	205	51	8958	51	8753	0.0	0.005826573746144179
chr10	MLLT10	21571974	21572026	0	53	51	8958	51	8905	0.0	0.005727119595732734
chr10	MLLT10	21538832	21538912	0	81	51	8958	51	8877	0.0	0.005745184183845894
chr10	MLLT10	21586293	21586348	0	56	51	8958	51	8902	0.0	0.005729049651763648
chr10	LINC00836	25695866	25695953	0	88	0	9665	0	9577	0.0	0.0
chr10	LINC00836	25716744	25716981	0	238	0	9665	0	9427	0.0	0.0
chr10	LINC00836	25716797	25716981	0	185	0	9665	0	9480	0.0	0.0
chr10	LINC00836	25652868	25653042	0	175	0	9665	0	9490	0.0	0.0
chr10	LINC00836	25682520	25683482	0	963	0	9665	0	8702	0.0	0.0
chr10	LINC00836	25668215	25668330	0	116	0	9665	0	9549	0.0	0.0
chr10	RAB18	27526827	27526889	0	63	4897	6111	4897	6048	0.0	0.8096891534391535
chr10	RAB18	27533734	27533853	0	120	4897	6111	4897	5991	0.0	0.8173927558003672
chr10	LINC01517	28847118	28847263	0	146	91692	8684	91692	8538	0.0	10.739283204497541
chr10	LINC01517	28864874	28864950	0	77	91692	8684	91692	8607	0.0	10.65318926455211
chr10	LINC01517	28795951	28796124	84	174	91692	8684	91608	8510	0.4827586206896552	10.764747356051704
chr10	LINC01517	28801786	28801964	0	179	91692	8684	91692	8505	0.0	10.780952380952382
chr10	ZEB1	31461036	31461237	0	202	651	8673	651	8471	0.0	0.07685043088183213
chr10	ZEB1	31495778	31495838	0	61	651	8673	651	8612	0.0	0.07559219693450998
chr10	CREM	35137781	35137879	0	99	186	5551	186	5452	0.0	0.03411592076302274
chr10	CREM	35148367	35148491	0	125	186	5551	186	5426	0.0	0.03427939550313306
chr10	CREM	35188199	35188388	0	190	186	5551	186	5361	0.0	0.03469501958589815
chr10	CREM	35201450	35201486	0	37	186	5551	186	5514	0.0	0.03373231773667029
chr10	ANKRD30A	37166604	37166695	0	92	14	5122	14	5030	0.0	0.002783300198807157
chr10	ANKRD30A	37177665	37177756	0	92	14	5122	14	5030	0.0	0.002783300198807157
chr10	FXYD4	43372726	43372772	0	47	0	842	0	795	0.0	0.0
chr10	FXYD4	43373461	43373783	0	323	0	842	0	519	0.0	0.0
chr10	LINC00840	43867156	43867339	0	184	34681	7297	34681	7113	0.0	4.875720511739069
chr10	LINC00840	43874189	43874412	0	224	34681	7297	34681	7073	0.0	4.903294217446628
chr10	PTPN20	46932376	46932533	0	158	26526	4523	26526	4365	0.0	6.076975945017182
chr10	PTPN20	46940622	46940717	0	96	26526	4523	26526	4427	0.0	5.991868082222724
chr10	PTPN20	46940581	46940717	0	137	26526	4523	26526	4386	0.0	6.047879616963065
chr10	PTPN20	46967956	46968047	1393	92	26526	4523	25133	4431	15.141304347826088	5.67208305122997
chr10	PTPN20	46987339	46987555	0	217	26526	4523	26526	4306	0.0	6.160241523455643
chr10	PTPN20	46947840	46947955	0	116	26526	4523	26526	4407	0.0	6.019060585432267
chr10	PTPN20	46955095	46955203	249	109	26526	4523	26277	4414	2.2844036697247705	5.9531037607612145
chr10	MAPK8	48424087	48424159	0	73	153	8831	153	8758	0.0	0.017469741950216944
chr10	MAPK8	48424513	48424585	0	73	153	8831	153	8758	0.0	0.017469741950216944
chr10	TIMM23B-AGAP6	49976083	49976185	0	103	0	4318	0	4215	0.0	0.0
chr10	TIMM23B-AGAP6	49981188	49981281	0	94	0	4318	0	4224	0.0	0.0
chr10	ASAH2B	50743672	50743741	0	70	153	5888	153	5818	0.0	0.026297696803025093
chr10	ASAH2B	50744696	50744732	0	37	153	5888	153	5851	0.0	0.02614937617501282
chr10	LINC00844	59013681	59013771	0	91	0	6009	0	5918	0.0	0.0
chr10	LINC00844	59022568	59022642	0	75	0	6009	0	5934	0.0	0.0
chr10	LINC00844	59000133	59000245	0	113	0	6009	0	5896	0.0	0.0
chr10	LINC00844	59000345	59000512	0	168	0	6009	0	5841	0.0	0.0
chr10	LINC00844	59001228	59001349	0	122	0	6009	0	5887	0.0	0.0
chr10	LINC00844	59001228	59001314	0	87	0	6009	0	5922	0.0	0.0
chr10	LINC00844	59000345	59000503	0	159	0	6009	0	5850	0.0	0.0
chr10	LINC01515	65679351	65679412	0	62	510	17753	510	17691	0.0	0.028828217737832798
chr10	LINC01515	65689502	65689611	0	110	510	17753	510	17643	0.0	0.028906648529161708
chr10	LINC01515	65579882	65579948	0	67	510	17753	510	17686	0.0	0.02883636774850164
chr10	LINC01515	65581611	65581673	0	63	510	17753	510	17690	0.0	0.02882984737139627
chr10	LINC01515	65689507	65689611	0	105	510	17753	510	17648	0.0	0.028898458748866727
chr10	CCAR1	68756272	68756483	0	212	0	6086	0	5874	0.0	0.0
chr10	CCAR1	68756525	68756632	0	108	0	6086	0	5978	0.0	0.0
chr10	KIFBP	69006841	69006929	0	89	0	6370	0	6281	0.0	0.0
chr10	KIFBP	69007626	69007751	0	126	0	6370	0	6244	0.0	0.0
chr10	KIFBP	68989716	68989859	0	144	0	6370	0	6226	0.0	0.0
chr10	KIFBP	68999714	68999814	0	101	0	6370	0	6269	0.0	0.0
chr10	KIFBP	68995203	68995278	0	76	0	6370	0	6294	0.0	0.0
chr10	VPS26A	69132897	69133047	0	151	32	5127	32	4976	0.0	0.006430868167202572
chr10	VPS26A	69155811	69155887	0	77	32	5127	32	5050	0.0	0.006336633663366337
chr10	VPS26A	69157006	69157163	0	158	32	5127	32	4969	0.0	0.006439927550815053
chr10	VPS26A	69158046	69158211	0	166	32	5127	32	4961	0.0	0.006450312437008668
chr10	HK1	69271006	69271096	0	91	102	6322	102	6231	0.0	0.01636976408281175
chr10	HK1	69278523	69278785	0	263	102	6322	102	6059	0.0	0.016834461132200034
chr10	COL13A1	69875127	69875163	0	37	54222	9922	54222	9885	0.0	5.485280728376328
chr10	COL13A1	69878038	69878065	0	28	54222	9922	54222	9894	0.0	5.480291085506368
chr10	COL13A1	69897474	69897531	0	58	54222	9922	54222	9864	0.0	5.496958637469587
chr10	COL13A1	69898696	69898762	0	67	54222	9922	54222	9855	0.0	5.5019786910197865
chr10	COL13A1	69952881	69952968	0	88	54222	9922	54222	9834	0.0	5.5137278828554
chr10	COL13A1	69953947	69954025	0	79	54222	9922	54222	9843	0.0	5.508686376104846
chr10	COL13A1	69932559	69932604	0	46	54222	9922	54222	9876	0.0	5.4902794653705955
chr10	COL13A1	69935349	69935391	86	43	54222	9922	54136	9879	2.0	5.4799068731653
chr10	COL13A1	69940987	69941023	0	37	54222	9922	54222	9885	0.0	5.485280728376328
chr10	COL13A1	69941235	69941347	0	113	54222	9922	54222	9809	0.0	5.527780609644204
chr10	MACROH2A2	70055066	70055177	0	112	1154095	11836	1154095	11724	0.0	98.43867280791538
chr10	MACROH2A2	70065053	70065189	0	137	1154095	11836	1154095	11699	0.0	98.64902983160954
chr10	MACROH2A2	70091756	70091954	32136	199	1154095	11836	1121959	11637	161.48743718592965	96.41307897224371
chr10	MACROH2A2	70093734	70093845	7548	112	1154095	11836	1146547	11724	67.39285714285714	97.79486523370863
chr10	MACROH2A2	70100207	70100297	1355	91	1154095	11836	1152740	11745	14.89010989010989	98.14729672200937
chr10	MACROH2A2	70109032	70109207	0	176	1154095	11836	1154095	11660	0.0	98.97898799313894
chr10	MACROH2A2	70092336	70092642	3312	307	1154095	11836	1150783	11529	10.788273615635179	99.81637609506463
chr10	MACROH2A2	70093019	70093507	18192	489	1154095	11836	1135903	11347	37.20245398773006	100.10601921212655
chr10	MACROH2A2	70093222	70093507	12783	286	1154095	11836	1141312	11550	44.69580419580419	98.81489177489178
chr10	MACROH2A2	70105951	70106250	2421	300	1154095	11836	1151674	11536	8.07	99.83304438280166
chr10	MACROH2A2	70108545	70108631	668	87	1154095	11836	1153427	11749	7.67816091954023	98.17235509405056
chr10	SLC29A3	71344208	71344291	0	84	306	5448	306	5364	0.0	0.05704697986577181
chr10	SLC29A3	71351561	71351788	0	228	306	5448	306	5220	0.0	0.05862068965517241
chr10	ANAPC16	72223887	72224056	0	170	104	4329	104	4159	0.0	0.025006011060351045
chr10	ANAPC16	72230365	72230440	0	76	104	4329	104	4253	0.0	0.024453327063249472
chr10	MCU	72861678	72861776	0	99	0	4536	0	4437	0.0	0.0
chr10	MCU	72868702	72868863	0	162	0	4536	0	4374	0.0	0.0
chr10	MCU	72736484	72736571	0	88	0	4536	0	4448	0.0	0.0
chr10	MCU	72760550	72760672	0	123	0	4536	0	4413	0.0	0.0
chr10	PPP3CB-AS1	73515827	73515925	0	99	0	5347	0	5248	0.0	0.0
chr10	PPP3CB-AS1	73518743	73518864	0	122	0	5347	0	5225	0.0	0.0
chr10	ADK	74680411	74680514	0	104	126	4677	126	4573	0.0	0.0275530286464028
chr10	ADK	74686698	74686820	0	123	126	4677	126	4554	0.0	0.02766798418972332
chr10	KAT6B	74985079	74985241	0	163	65073	24867	65073	24704	0.0	2.6341078367875648
chr10	KAT6B	74989018	74989112	418	95	65073	24867	64655	24772	4.4	2.610003229452608
chr10	ZNF503-AS1	75298951	75299074	0	124	16636	5296	16636	5172	0.0	3.216550657385924
chr10	ZNF503-AS1	75343223	75343340	0	118	16636	5296	16636	5178	0.0	3.212823483970645
chr10	ZNF503-AS1	75350351	75350470	0	120	16636	5296	16636	5176	0.0	3.214064914992272
chr10	ZNF503-AS1	75343223	75343330	0	108	16636	5296	16636	5188	0.0	3.2066306861989204
chr10	RPS24	78037438	78037441	0	4	0	7223	0	7219	0.0	0.0
chr10	RPS24	78037964	78037982	0	19	0	7223	0	7204	0.0	0.0
chr10	RPS24	78037964	78037993	0	30	0	7223	0	7193	0.0	0.0
chr10	LINC00595	78250276	78250451	0	176	0	10323	0	10147	0.0	0.0
chr10	LINC00595	78380392	78380754	0	363	0	10323	0	9960	0.0	0.0
chr10	SFTPA1	79611318	79611389	132	72	67542	2454	67410	2382	1.8333333333333333	28.299748110831235
chr10	SFTPA1	79611581	79611641	24	61	67542	2454	67518	2393	0.39344262295081966	28.21479314667781
chr10	NRG3	81889189	81889665	102	477	102	5209	0	4732	0.2138364779874214	0.0
chr10	NRG3	82166726	82166826	0	101	102	5209	102	5108	0.0	0.019968676585747847
chr10	LINC00858	84291406	84292137	0	732	0	4591	0	3859	0.0	0.0
chr10	LINC00858	84292191	84292378	0	188	0	4591	0	4403	0.0	0.0
chr10	LDB3	86681435	86681803	0	369	153	6639	153	6270	0.0	0.024401913875598084
chr10	LDB3	86685677	86685700	0	24	153	6639	153	6615	0.0	0.02312925170068027
chr10	FAS	89011998	89012081	44	84	9300	5421	9256	5337	0.5238095238095238	1.7343076634813566
chr10	FAS	89013342	89013367	0	26	9300	5421	9300	5395	0.0	1.7238183503243745
chr10	FAS	89010752	89010815	224	64	9300	5421	9076	5357	3.5	1.694231846182565
chr10	LGI1	93780281	93780332	0	52	85940	8705	85940	8653	0.0	9.93181555529874
chr10	LGI1	93782742	93783043	0	302	85940	8705	85940	8403	0.0	10.227299773890277
chr10	CC2D2B	96009824	96009923	0	100	3532	7596	3532	7496	0.0	0.47118463180362863
chr10	CC2D2B	96012184	96012367	777	184	3532	7596	2755	7412	4.2228260869565215	0.3716945493793848
chr10	ZNF518A	96151415	96151566	0	152	6070	10378	6070	10226	0.0	0.593584979464111
chr10	ZNF518A	96155325	96155398	0	74	6070	10378	6070	10304	0.0	0.5890916149068323
chr10	LCOR	96833776	96833841	0	66	3745	26377	3745	26311	0.0	0.14233590513473451
chr10	LCOR	96858291	96858416	0	126	3745	26377	3745	26251	0.0	0.14266123195306846
chr10	ZDHHC16	97448189	97448350	3087	162	79890	2995	76803	2833	19.055555555555557	27.110130603600425
chr10	ZDHHC16	97450356	97450536	5893	181	79890	2995	73997	2814	32.55801104972376	26.296019900497512
chr10	ZFYVE27	97738476	97738674	0	199	255	3913	255	3714	0.0	0.06865912762520193
chr10	ZFYVE27	97744728	97744915	0	188	255	3913	255	3725	0.0	0.06845637583892618
chr10	OLMALINC	100394285	100394377	0	93	51	12654	51	12561	0.0	0.004060186290900406
chr10	OLMALINC	100394497	100394622	0	126	51	12654	51	12528	0.0	0.0040708812260536395
chr10	BTRC	101430344	101430452	0	109	8959	6630	8959	6521	0.0	1.373869038491029
chr10	BTRC	101461980	101462058	0	79	8959	6630	8959	6551	0.0	1.3675774690886888
chr10	GBF1	102284952	102285070	10311	119	16712	19267	6401	19148	86.6470588235294	0.33429078754961356
chr10	GBF1	102335562	102335743	472	182	16712	19267	16240	19085	2.5934065934065935	0.850930049777312
chr10	GBF1	102332407	102332526	0	120	16712	19267	16712	19147	0.0	0.8728260301874967
chr10	GBF1	102328810	102328952	0	143	16712	19267	16712	19124	0.0	0.8738757582095796
chr10	GBF1	102326359	102326420	0	62	16712	19267	16712	19205	0.0	0.8701900546732622
chr10	GBF1	102314330	102314424	23	95	16712	19267	16689	19172	0.24210526315789474	0.8704882119757981
chr10	GBF1	102314807	102314860	48	54	16712	19267	16664	19213	0.8888888888888888	0.8673294123770364
chr10	GBF1	102314810	102314860	42	51	16712	19267	16670	19216	0.8235294117647058	0.8675062447960034
chr10	GBF1	102359269	102359435	0	167	16712	19267	16712	19100	0.0	0.8749738219895288
chr10	GBF1	102360183	102360395	0	213	16712	19267	16712	19054	0.0	0.8770861761309962
chr10	GBF1	102361717	102361912	0	196	16712	19267	16712	19071	0.0	0.8763043364270359
chr10	GBF1	102363255	102363396	0	142	16712	19267	16712	19125	0.0	0.8738300653594772
chr10	GBF1	102363709	102363798	0	90	16712	19267	16712	19177	0.0	0.87146060384836
chr10	SFXN2	102716233	102716329	5039	97	139483	7940	134444	7843	51.94845360824742	17.14190998342471
chr10	SFXN2	102716613	102716711	0	99	139483	7940	139483	7841	0.0	17.78892998342048
chr10	SFXN2	102715222	102715328	434	107	139483	7940	139049	7833	4.05607476635514	17.751691561343037
chr10	SFXN2	102716588	102716711	0	124	139483	7940	139483	7816	0.0	17.845829068577277
chr10	SFXN2	102724935	102724996	5	62	139483	7940	139478	7878	0.08064516129032258	17.704747397816703
chr10	MXI1	110245742	110245818	0	77	121	5912	121	5835	0.0	0.0207369323050557
chr10	MXI1	110260998	110261145	0	148	121	5912	121	5764	0.0	0.02099236641221374
chr10	PDCD4	110894090	110894198	51	109	51	4079	0	3970	0.46788990825688076	0.0
chr10	PDCD4	110894411	110894522	0	112	51	4079	51	3967	0.0	0.012856062515754978
chr10	TCF7L2	113159919	113159992	0	74	0	6478	0	6404	0.0	0.0
chr10	TCF7L2	113160618	113160691	0	74	0	6478	0	6404	0.0	0.0
chr10	TCF7L2	113158666	113158717	0	52	0	6478	0	6426	0.0	0.0
chr10	TCF7L2	113161578	113161603	0	26	0	6478	0	6452	0.0	0.0
chr10	PNLIPRP2	116637127	116637132	0	6	5895	1588	5895	1582	0.0	3.7262958280657394
chr10	PNLIPRP2	116638368	116638370	0	3	5895	1588	5895	1585	0.0	3.719242902208202
chr10	CASC2	118052130	118052196	0	67	51	14207	51	14140	0.0	0.0036067892503536068
chr10	CASC2	118206521	118206621	0	101	51	14207	51	14106	0.0	0.0036154827732879625
chr10	INPP5F	119759856	119760068	0	213	4090	7441	4090	7228	0.0	0.5658550083010515
chr10	INPP5F	119781060	119781242	424	183	4090	7441	3666	7258	2.3169398907103824	0.5050978230917608
chr10	DMBT1	122607158	122607188	0	31	33448	9431	33448	9400	0.0	3.5582978723404257
chr10	DMBT1	122611217	122611247	0	31	33448	9431	33448	9400	0.0	3.5582978723404257
chr10	DMBT1	122603099	122603129	0	31	33448	9431	33448	9400	0.0	3.5582978723404257
chr10	DMBT1	122601796	122602120	0	325	33448	9431	33448	9106	0.0	3.673182517021744
chr10	DMBT1	122605855	122606179	51	325	33448	9431	33397	9106	0.15692307692307692	3.667581814188447
chr10	C10ORF88B	122883724	122883931	0	208	51	2143	51	1935	0.0	0.02635658914728682
chr10	C10ORF88B	122884716	122884852	51	137	51	2143	0	2006	0.3722627737226277	0.0
chr11	PSMD13	238997	239076	142891	80	1526979	2848	1384088	2768	1786.1375	500.03179190751445
chr11	PSMD13	244040	244075	58557	36	1526979	2848	1468422	2812	1626.5833333333333	522.1984352773826
chr11	EPS8L2	706676	706801	366	126	16540	4588	16174	4462	2.9047619047619047	3.6248319139399374
chr11	EPS8L2	708574	708643	0	70	16540	4588	16540	4518	0.0	3.66091190792386
chr11	EPS8L2	706673	706801	368	129	16540	4588	16172	4459	2.852713178294574	3.626822157434402
chr11	EPS8L2	706595	706801	978	207	16540	4588	15562	4381	4.72463768115942	3.552157041771285
chr11	EPS8L2	721902	721991	302	90	16540	4588	16238	4498	3.3555555555555556	3.6100489106269453
chr11	EPS8L2	722090	722165	401	76	16540	4588	16139	4512	5.276315789473684	3.576906028368794
chr11	TSPAN4	847200	847300	41403	101	826493	4889	785090	4788	409.9306930693069	163.9703425229741
chr11	TSPAN4	850287	850367	49459	81	826493	4889	777034	4808	610.604938271605	161.61272878535775
chr11	TSPAN4	862549	862741	179343	193	826493	4889	647150	4696	929.2383419689119	137.8087734241908
chr11	BRSK2	1456954	1457049	0	96	1862	6414	1862	6318	0.0	0.29471351693573916
chr11	BRSK2	1459191	1459239	0	49	1862	6414	1862	6365	0.0	0.29253731343283584
chr11	BRSK2	1459191	1459236	0	46	1862	6414	1862	6368	0.0	0.2923994974874372
chr11	TNNT3	1936213	1936254	0	42	0	2739	0	2697	0.0	0.0
chr11	TNNT3	1936962	1937003	0	42	0	2739	0	2697	0.0	0.0
chr11	TNNT3	1923554	1923572	0	19	0	2739	0	2720	0.0	0.0
chr11	TNNT3	1925098	1925116	0	19	0	2739	0	2720	0.0	0.0
chr11	MRGPRG-AS1	3219699	3219788	0	90	0	2016	0	1926	0.0	0.0
chr11	MRGPRG-AS1	3220226	3220359	0	134	0	2016	0	1882	0.0	0.0
chr11	PGAP2	3817431	3817535	0	105	752	3571	752	3466	0.0	0.21696480092325446
chr11	PGAP2	3822908	3822993	0	86	752	3571	752	3485	0.0	0.2157819225251076
chr11	PGAP2	3817352	3817535	0	184	752	3571	752	3387	0.0	0.22202539120165338
chr11	PGAP2	3811249	3811424	0	176	752	3571	752	3395	0.0	0.2215022091310751
chr11	PGAP2	3823882	3824135	0	254	752	3571	752	3317	0.0	0.22671088332830872
chr11	PGAP2	3823612	3823740	0	129	752	3571	752	3442	0.0	0.21847762928529924
chr11	RRM1	4101992	4102081	0	90	131814	4257	131814	4167	0.0	31.632829373650107
chr11	RRM1	4106045	4106223	510	179	131814	4257	131304	4078	2.8491620111731844	32.1981363413438
chr11	IPO7	9392197	9392320	19	124	59420	6872	59401	6748	0.1532258064516129	8.802756372258447
chr11	IPO7	9403289	9403371	0	83	59420	6872	59420	6789	0.0	8.752393577846517
chr11	ARNTL	13326412	13326467	0	56	24812	6957	24812	6901	0.0	3.5954209534850023
chr11	ARNTL	13349944	13350070	0	127	24812	6957	24812	6830	0.0	3.632796486090776
chr11	ARNTL	13309986	13310059	0	74	24812	6957	24812	6883	0.0	3.6048234781345343
chr11	LINC02548	13810241	13810346	0	106	0	2483	0	2377	0.0	0.0
chr11	LINC02548	13840654	13840851	0	198	0	2483	0	2285	0.0	0.0
chr11	LINC02548	13844922	13845095	0	174	0	2483	0	2309	0.0	0.0
chr11	LINC02682	15918301	15918462	0	162	0	3435	0	3273	0.0	0.0
chr11	LINC02682	15922585	15922655	0	71	0	3435	0	3364	0.0	0.0
chr11	C11ORF58	16744600	16744684	0	85	306	9224	306	9139	0.0	0.03348287558813875
chr11	C11ORF58	16748096	16748157	0	62	306	9224	306	9162	0.0	0.03339882121807466
chr11	NUCB2	17286633	17286717	0	85	191245	9053	191245	8968	0.0	21.325267618198037
chr11	NUCB2	17291239	17291365	0	127	191245	9053	191245	8926	0.0	21.425610575845845
chr11	NUCB2	17315385	17315475	559	91	191245	9053	190686	8962	6.142857142857143	21.277170274492303
chr11	NUCB2	17330126	17330297	0	172	191245	9053	191245	8881	0.0	21.534174079495553
chr11	LDHA	18399430	18399548	0	119	408	4566	408	4447	0.0	0.09174724533393298
chr11	LDHA	18400836	18401010	0	175	408	4566	408	4391	0.0	0.09291733090412206
chr11	LDHC	18415183	18415301	0	119	2392	2097	2392	1978	0.0	1.2093023255813953
chr11	LDHC	18429736	18429910	2392	175	2392	2097	0	1922	13.668571428571429	0.0
chr11	NELL1	21534373	21534514	0	142	197	5341	197	5199	0.0	0.03789190228890171
chr11	NELL1	21560188	21560382	0	195	197	5341	197	5146	0.0	0.0382821609016712
chr11	LINC02699	25740475	25740560	0	86	0	1304	0	1218	0.0	0.0
chr11	LINC02699	25770470	25770568	0	99	0	1304	0	1205	0.0	0.0
chr11	LINC02699	25743060	25743099	0	40	0	1304	0	1264	0.0	0.0
chr11	LINC02699	25767211	25767288	0	78	0	1304	0	1226	0.0	0.0
chr11	BDNF-AS	27665260	27665392	39	133	122520	12372	122481	12239	0.2932330827067669	10.007435247977776
chr11	BDNF-AS	27675576	27676140	0	565	122520	12372	122520	11807	0.0	10.376895062251206
chr11	BDNF-AS	27540019	27540116	0	98	122520	12372	122520	12274	0.0	9.982075932866222
chr11	BDNF-AS	27584268	27584337	0	70	122520	12372	122520	12302	0.0	9.959356202243537
chr11	BDNF-AS	27675296	27676140	918	845	122520	12372	121602	11527	1.0863905325443788	10.549318990196928
chr11	DNAJC24	31396282	31396394	0	113	1173	6529	1173	6416	0.0	0.18282418952618454
chr11	DNAJC24	31408109	31408330	0	222	1173	6529	1173	6307	0.0	0.18598382749326145
chr11	ELP4	31687660	31687702	0	43	19299	23173	19299	23130	0.0	0.8343709468223087
chr11	ELP4	31763410	31763549	31	140	19299	23173	19268	23033	0.22142857142857142	0.836538878999696
chr11	ELP4	31541430	31541476	0	47	19299	23173	19299	23126	0.0	0.8345152642047912
chr11	ELP4	31580682	31580800	0	119	19299	23173	19299	23054	0.0	0.837121540730459
chr11	ELP4	31573586	31573624	0	39	19299	23173	19299	23134	0.0	0.8342266793464165
chr11	ELP4	31780678	31780761	0	84	19299	23173	19299	23089	0.0	0.8358525704881112
chr11	CD44	35198120	35198246	1019297	127	2183374	9710	1164077	9583	8025.96062992126	121.47312950015653
chr11	CD44	35206111	35206243	480	133	2183374	9710	2182894	9577	3.6090225563909772	227.93087605722042
chr11	CD44	35211245	35211449	833247	205	2183374	9710	1350127	9505	4064.619512195122	142.04387164650183
chr11	PRR5L	36446299	36446440	0	142	14506	6635	14506	6493	0.0	2.234098259664254
chr11	PRR5L	36451208	36451335	0	128	14506	6635	14506	6507	0.0	2.2292915321960964
chr11	IFTAP	36636050	36636117	0	68	1173	10397	1173	10329	0.0	0.11356375254138833
chr11	IFTAP	36648015	36648155	0	141	1173	10397	1173	10256	0.0	0.11437207488299532
chr11	IFTAP	36633283	36633438	0	156	1173	10397	1173	10241	0.0	0.11453959574260326
chr11	LINC01493	38648423	38648604	0	182	0	2429	0	2247	0.0	0.0
chr11	LINC01493	38648768	38648934	0	167	0	2429	0	2262	0.0	0.0
chr11	ALKBH3	43892040	43892129	56	90	60763	2155	60707	2065	0.6222222222222222	29.398062953995158
chr11	ALKBH3	43897194	43897354	0	161	60763	2155	60763	1994	0.0	30.472918756268808
chr11	CD82	44566272	44566330	0	59	1762	3641	1762	3582	0.0	0.4919039642657733
chr11	CD82	44585142	44585292	0	151	1762	3641	1762	3490	0.0	0.5048710601719197
chr11	LINC02685	44974795	44974893	0	99	0	1608	0	1509	0.0	0.0
chr11	LINC02685	44977308	44977402	0	95	0	1608	0	1513	0.0	0.0
chr11	AC044839.1	45740900	45740963	0	64	0	6744	0	6680	0.0	0.0
chr11	AC044839.1	45741663	45741862	0	200	0	6744	0	6544	0.0	0.0
chr11	AC044839.1	45734540	45734799	0	260	0	6744	0	6484	0.0	0.0
chr11	AC044839.1	45739409	45739542	0	134	0	6744	0	6610	0.0	0.0
chr11	AC044839.1	45741544	45741862	0	319	0	6744	0	6425	0.0	0.0
chr11	AC044839.1	45741724	45741862	0	139	0	6744	0	6605	0.0	0.0
chr11	AC044839.1	45742423	45742670	0	248	0	6744	0	6496	0.0	0.0
chr11	MDK	46382056	46382133	0	78	4089	2201	4089	2123	0.0	1.9260480452190296
chr11	MDK	46382293	46382461	0	169	4089	2201	4089	2032	0.0	2.012303149606299
chr11	ATG13	46630896	46630991	0	96	8037	5435	8037	5339	0.0	1.5053380782918149
chr11	ATG13	46632322	46632459	165	138	8037	5435	7872	5297	1.1956521739130435	1.4861242212573154
chr11	ATG13	46618324	46618375	200	52	8037	5435	7837	5383	3.8461538461538463	1.4558796210291658
chr11	ATG13	46621041	46621157	0	117	8037	5435	8037	5318	0.0	1.5112824370063933
chr11	ATG13	46618259	46618375	408	117	8037	5435	7629	5318	3.4871794871794872	1.4345618653629184
chr11	ATG13	46621059	46621157	0	99	8037	5435	8037	5336	0.0	1.506184407796102
chr11	ATG13	46630044	46630100	0	57	8037	5435	8037	5378	0.0	1.494421718110822
chr11	ATG13	46638498	46638610	76	113	8037	5435	7961	5322	0.672566371681416	1.4958662157083804
chr11	C11ORF49	47004364	47004456	0	93	5354	5413	5354	5320	0.0	1.006390977443609
chr11	C11ORF49	47023338	47023394	0	57	5354	5413	5354	5356	0.0	0.9996265870052278
chr11	C11ORF49	46991542	46991647	0	106	5354	5413	5354	5307	0.0	1.008856227623893
chr11	C11ORF49	46987207	46987310	0	104	5354	5413	5354	5309	0.0	1.008476172537201
chr11	C11ORF49	47052387	47052518	0	132	5354	5413	5354	5281	0.0	1.0138231395569022
chr11	DDB2	47216857	47217049	0	193	11485	4822	11485	4629	0.0	2.481097429250378
chr11	DDB2	47232813	47232959	0	147	11485	4822	11485	4675	0.0	2.4566844919786095
chr11	TMX2	57737835	57738026	0	192	0	2143	0	1951	0.0	0.0
chr11	TMX2	57738353	57738430	0	78	0	2143	0	2065	0.0	0.0
chr11	STX3	59795371	59795482	0	112	0	6815	0	6703	0.0	0.0
chr11	STX3	59795601	59795712	0	112	0	6815	0	6703	0.0	0.0
chr11	MS4A3	60061489	60061554	0	66	0	2090	0	2024	0.0	0.0
chr11	MS4A3	60062467	60062605	0	139	0	2090	0	1951	0.0	0.0
chr11	MS4A4A	60282593	60282739	0	147	0	2959	0	2812	0.0	0.0
chr11	MS4A4A	60290048	60290242	0	195	0	2959	0	2764	0.0	0.0
chr11	MS4A14	60404545	60404666	0	122	26	4014	26	3892	0.0	0.006680369989722507
chr11	MS4A14	60405888	60405987	0	100	26	4014	26	3914	0.0	0.006642820643842616
chr11	MS4A15	60763705	60763958	0	254	408	2290	408	2036	0.0	0.20039292730844793
chr11	MS4A15	60767566	60767655	0	90	408	2290	408	2200	0.0	0.18545454545454546
chr11	CD6	61013918	61014014	0	97	204	4331	204	4234	0.0	0.048181388757675955
chr11	CD6	61015712	61015835	0	124	204	4331	204	4207	0.0	0.04849061088661754
chr11	PPP1R32	61486343	61486403	0	61	3510	2415	3510	2354	0.0	1.4910790144435004
chr11	PPP1R32	61486523	61486610	0	88	3510	2415	3510	2327	0.0	1.5083798882681565
chr11	POLR2G	62762541	62762866	0	326	0	1552	0	1226	0.0	0.0
chr11	POLR2G	62762866	62763026	0	161	0	1552	0	1391	0.0	0.0
chr11	RTN3	63704850	63704907	0	58	208487	5524	208487	5466	0.0	38.142517380168314
chr11	RTN3	63746946	63747024	0	79	208487	5524	208487	5445	0.0	38.289623507805324
chr11	RTN3	63718701	63721032	125983	2332	208487	5524	82504	3192	54.02358490566038	25.847117794486216
chr11	RTN3	63718980	63721032	125269	2053	208487	5524	83218	3471	61.01753531417438	23.975223278594065
chr11	MARK2	63906087	63906114	20	28	7176	8854	7156	8826	0.7142857142857143	0.810786313165647
chr11	MARK2	63908259	63908304	0	46	7176	8854	7176	8808	0.0	0.8147138964577657
chr11	SLC22A11	64568669	64568778	0	110	344589	5168	344589	5058	0.0	68.12752075919336
chr11	SLC22A11	64569651	64569858	450	208	344589	5168	344139	4960	2.1634615384615383	69.38286290322581
chr11	SAC3D1	65041285	65041866	0	582	3057	1673	3057	1091	0.0	2.8020164986251146
chr11	SAC3D1	65043024	65043164	0	141	3057	1673	3057	1532	0.0	1.9954308093994777
chr11	VPS51	65096997	65097127	336	131	200815	4595	200479	4464	2.564885496183206	44.91017025089606
chr11	VPS51	65107580	65107727	0	148	200815	4595	200815	4447	0.0	45.15740948954351
chr11	TM7SF2	65112810	65112865	500	56	139494	2460	138994	2404	8.928571428571429	57.81780366056572
chr11	TM7SF2	65113368	65113414	1996	47	139494	2460	137498	2413	42.46808510638298	56.98217985909656
chr11	TM7SF2	65113219	65113414	12659	196	139494	2460	126835	2264	64.58673469387755	56.022526501766784
chr11	TM7SF2	65115313	65115394	48	82	139494	2460	139446	2378	0.5853658536585366	58.640033641715725
chr11	TM7SF2	65115475	65115598	153	124	139494	2460	139341	2336	1.2338709677419355	59.64940068493151
chr11	TM7SF2	65113490	65113594	14548	105	139494	2460	124946	2355	138.55238095238096	53.0556263269639
chr11	TM7SF2	65112514	65112711	2397	198	139494	2460	137097	2262	12.106060606060606	60.60875331564987
chr11	FRMD8	65389360	65389528	356	169	83407	4080	83051	3911	2.106508875739645	21.2352339555101
chr11	FRMD8	65393572	65393674	2183	103	83407	4080	81224	3977	21.194174757281555	20.423434749811417
chr11	FRMD8	65389384	65389528	306	145	83407	4080	83101	3935	2.110344827586207	21.118424396442187
chr11	DPP3	66482192	66482470	663	279	3854	3901	3191	3622	2.3763440860215055	0.8810049696300386
chr11	DPP3	66485172	66485262	0	91	3854	3901	3854	3810	0.0	1.0115485564304463
chr11	DPP3	66482195	66482470	663	276	3854	3901	3191	3625	2.402173913043478	0.8802758620689655
chr11	BBS1	66511204	66511239	0	36	13407	5850	13407	5814	0.0	2.305985552115583
chr11	BBS1	66514405	66514678	372	274	13407	5850	13035	5576	1.3576642335766422	2.337697274031564
chr11	BBS1	66515539	66515586	815	48	13407	5850	12592	5802	16.979166666666668	2.1702861082385385
chr11	RBM14	66618495	66618561	98	67	268761	6382	268663	6315	1.462686567164179	42.54362628661916
chr11	RBM14	66623900	66623968	0	69	268761	6382	268761	6313	0.0	42.57262791066054
chr11	C11ORF80	66788159	66788269	35	111	2853	3974	2818	3863	0.3153153153153153	0.7294848563292777
chr11	C11ORF80	66796280	66796364	0	85	2853	3974	2853	3889	0.0	0.7336076112111083
chr11	PPP6R3	68505144	68505249	565	106	257968	8173	257403	8067	5.330188679245283	31.9081442915582
chr11	PPP6R3	68515027	68515166	0	140	257968	8173	257968	8033	0.0	32.113531681812525
chr11	PPP6R3	68505144	68505271	646	128	257968	8173	257322	8045	5.046875	31.98533250466128
chr11	PPP6R3	68519500	68519651	0	152	257968	8173	257968	8021	0.0	32.161575863358685
chr11	PPP6R3	68537658	68537891	1068	234	257968	8173	256900	7939	4.564102564102564	32.35923919889155
chr11	IGHMBP2	68917160	68917301	0	142	3517	8643	3517	8501	0.0	0.41371603340783436
chr11	IGHMBP2	68917521	68917552	0	32	3517	8643	3517	8611	0.0	0.40843107653001975
chr11	IGHMBP2	68917163	68917301	0	139	3517	8643	3517	8504	0.0	0.4135700846660395
chr11	PPFIA1	70349922	70350039	0	118	17259	10724	17259	10606	0.0	1.6272864416368094
chr11	PPFIA1	70350993	70351023	0	31	17259	10724	17259	10693	0.0	1.6140465725240811
chr11	FAM86C1P	71791735	71791819	714	85	26749	3381	26035	3296	8.4	7.898968446601942
chr11	FAM86C1P	71793379	71793481	68	103	26749	3381	26681	3278	0.6601941747572816	8.139414276998169
chr11	FAM86C1P	71791738	71791819	681	82	26749	3381	26068	3299	8.304878048780488	7.901788420733555
chr11	RNF121	71962151	71962289	0	139	11427	3262	11427	3123	0.0	3.658981748318924
chr11	RNF121	71978085	71978235	0	151	11427	3262	11427	3111	0.0	3.673095467695275
chr11	LRTOMT	72088296	72088380	61	85	673	3353	612	3268	0.7176470588235294	0.18727050183598531
chr11	LRTOMT	72089028	72089165	102	138	673	3353	571	3215	0.7391304347826086	0.1776049766718507
chr11	P2RY6	73272306	73272466	0	161	1059	3193	1059	3032	0.0	0.3492744063324538
chr11	P2RY6	73295729	73295815	39	87	1059	3193	1020	3106	0.4482758620689655	0.3283966516419833
chr11	PLEKHB1	73653369	73653461	0	93	2054	3884	2054	3791	0.0	0.5418095489316803
chr11	PLEKHB1	73655802	73655907	0	106	2054	3884	2054	3778	0.0	0.5436739015352038
chr11	MRPL48	73817822	73817947	0	126	11235	3843	11235	3717	0.0	3.022598870056497
chr11	MRPL48	73823012	73823070	13	59	11235	3843	11222	3784	0.22033898305084745	2.9656448202959833
chr11	MRPL48	73808312	73808350	0	39	11235	3843	11235	3804	0.0	2.9534700315457414
chr11	MRPL48	73825707	73825796	0	90	11235	3843	11235	3753	0.0	2.993605115907274
chr11	MRPL48	73844806	73844976	0	171	11235	3843	11235	3672	0.0	3.059640522875817
chr11	RPS3	75402351	75402379	0	29	0	4632	0	4603	0.0	0.0
chr11	RPS3	75404019	75404207	0	189	0	4632	0	4443	0.0	0.0
chr11	RPS3	75402351	75402446	0	96	0	4632	0	4536	0.0	0.0
chr11	ACER3	76958978	76959031	43	54	49148	8264	49105	8210	0.7962962962962963	5.981120584652863
chr11	ACER3	76959076	76959200	43	125	49148	8264	49105	8139	0.344	6.033296473768276
chr11	ACER3	76926556	76926667	0	112	49148	8264	49148	8152	0.0	6.028949950932287
chr11	CAPN5	77071609	77071682	0	74	745	5580	745	5506	0.0	0.1353069378859426
chr11	CAPN5	77072990	77073137	0	148	745	5580	745	5432	0.0	0.13715022091310752
chr11	AAMDC	77876949	77877049	0	101	8578	1874	8578	1773	0.0	4.838127467569092
chr11	AAMDC	77884779	77884916	6777	138	8578	1874	1801	1736	49.108695652173914	1.037442396313364
chr11	AAMDC	77878701	77878756	0	56	8578	1874	8578	1818	0.0	4.718371837183718
chr11	KCTD21-AS1	78141594	78141702	0	109	4415	4417	4415	4308	0.0	1.0248375116063138
chr11	KCTD21-AS1	78148976	78149093	0	118	4415	4417	4415	4299	0.0	1.0269830193068155
chr11	TMEM126B	85629131	85629262	0	132	11	2156	11	2024	0.0	0.005434782608695652
chr11	TMEM126B	85631144	85631316	0	173	11	2156	11	1983	0.0	0.005547150781643974
chr11	TMEM126B	85629131	85629203	0	73	11	2156	11	2083	0.0	0.00528084493518963
chr11	NAALAD2	90158144	90158238	0	95	263	6651	263	6556	0.0	0.040115924344112264
chr11	NAALAD2	90159238	90159337	0	100	263	6651	263	6551	0.0	0.040146542512593496
chr11	DISC1FP1	90602804	90602908	0	105	566	3223	566	3118	0.0	0.18152661962796665
chr11	DISC1FP1	90716396	90716440	0	45	566	3223	566	3178	0.0	0.17809943360604152
chr11	C11ORF54	93747296	93747448	0	153	204	5944	204	5791	0.0	0.03522707649801416
chr11	C11ORF54	93750345	93750444	0	100	204	5944	204	5844	0.0	0.03490759753593429
chr11	C11ORF54	93755209	93755386	0	178	204	5944	204	5766	0.0	0.03537981269510926
chr11	C11ORF54	93757315	93757465	0	151	204	5944	204	5793	0.0	0.03521491455204557
chr11	MED17	93797534	93797719	0	186	0	8731	0	8545	0.0	0.0
chr11	MED17	93801834	93801972	0	139	0	8731	0	8592	0.0	0.0
chr11	MED17	93807517	93807635	0	119	0	8731	0	8612	0.0	0.0
chr11	MED17	93809716	93809876	0	161	0	8731	0	8570	0.0	0.0
chr11	MED17	93788000	93788167	0	168	0	8731	0	8563	0.0	0.0
chr11	CEP57	95794220	95794359	0	140	23130	6568	23130	6428	0.0	3.5983198506533913
chr11	CEP57	95795515	95795559	0	45	23130	6568	23130	6523	0.0	3.5459144565384024
chr11	GRIA4	105965946	105966061	0	116	1236	10106	1236	9990	0.0	0.12372372372372373
chr11	GRIA4	105971913	105972028	0	116	1236	10106	1236	9990	0.0	0.12372372372372373
chr11	ATM	108224783	108224871	0	89	85809	19441	85809	19352	0.0	4.434115336916081
chr11	ATM	108225500	108225574	1723	75	85809	19441	84086	19366	22.973333333333333	4.341939481565631
chr11	ATM	108226163	108226247	0	85	85809	19441	85809	19356	0.0	4.433199008059517
chr11	LINC02732	110366360	110366534	102	175	102	2329	0	2154	0.5828571428571429	0.0
chr11	LINC02732	110381925	110382021	0	97	102	2329	102	2232	0.0	0.0456989247311828
chr11	LINC02732	110366360	110366538	102	179	102	2329	0	2150	0.5698324022346368	0.0
chr11	HOATZ	111519008	111519188	0	181	58	983	58	802	0.0	0.07231920199501247
chr11	HOATZ	111524882	111524963	17	82	58	983	41	901	0.2073170731707317	0.04550499445061043
chr11	SDHD	112091078	112091132	306	55	6674	2799	6368	2744	5.5636363636363635	2.3206997084548107
chr11	SDHD	112093079	112093209	40	131	6674	2799	6634	2668	0.3053435114503817	2.4865067466266866
chr11	SDHD	112087856	112087973	1182	118	6674	2799	5492	2681	10.016949152542374	2.0484893696381947
chr11	SDHD	112088866	112089011	533	146	6674	2799	6141	2653	3.6506849315068495	2.3147380324161326
chr11	NCAM1	113236300	113236315	0	16	2349	12494	2349	12478	0.0	0.18825132232729605
chr11	NCAM1	113246367	113246370	0	4	2349	12494	2349	12490	0.0	0.18807045636509206
chr11	NCAM1	113242804	113242846	0	43	2349	12494	2349	12451	0.0	0.1886595454180387
chr11	CEP164	117335604	117335680	0	77	153	12616	153	12539	0.0	0.012201929978467183
chr11	CEP164	117338565	117338668	0	104	153	12616	153	12512	0.0	0.012228260869565218
chr11	TMPRSS4	118098984	118099098	0	115	51	7122	51	7007	0.0	0.007278435849864422
chr11	TMPRSS4	118103100	118103253	0	154	51	7122	51	6968	0.0	0.007319173363949483
chr11	TMEM25	118532149	118532461	0	313	0	4816	0	4503	0.0	0.0
chr11	TMEM25	118532916	118533207	0	292	0	4816	0	4524	0.0	0.0
chr11	HMBS	119091162	119091256	0	95	597	3568	597	3473	0.0	0.17189749496112872
chr11	HMBS	119091412	119091526	0	115	597	3568	597	3453	0.0	0.17289313640312773
chr11	HMBS	119091860	119091874	15	15	597	3568	582	3553	1.0	0.16380523501266536
chr11	HMBS	119092124	119092163	0	40	597	3568	597	3528	0.0	0.16921768707482993
chr11	HMBS	119092403	119092523	0	121	597	3568	597	3447	0.0	0.1731940818102698
chr11	USP2-AS1	119469808	119469975	0	168	102	9657	102	9489	0.0	0.010749288650015808
chr11	USP2-AS1	119509113	119509225	0	113	102	9657	102	9544	0.0	0.01068734283319363
chr11	ROBO3	124877160	124877184	0	25	10160	6444	10160	6419	0.0	1.5828010593550397
chr11	ROBO3	124877266	124877309	0	44	10160	6444	10160	6400	0.0	1.5875
chr11	ROBO3	124877936	124878131	357	196	10160	6444	9803	6248	1.8214285714285714	1.5689820742637643
chr11	ROBO3	124878297	124878436	124	140	10160	6444	10036	6304	0.8857142857142857	1.592005076142132
chr11	ROBO3	124877284	124877309	0	26	10160	6444	10160	6418	0.0	1.5830476784044873
chr11	PKNOX2	125351283	125351392	0	110	200	5946	200	5836	0.0	0.03427004797806717
chr11	PKNOX2	125367845	125367985	0	141	200	5946	200	5805	0.0	0.034453057708871665
chr11	PKNOX2	125331818	125331925	0	108	200	5946	200	5838	0.0	0.0342583076396026
chr11	PKNOX2	125385550	125385722	0	173	200	5946	200	5773	0.0	0.034644032565390614
chr11	STT3A	125593637	125593725	0	89	425	7052	425	6963	0.0	0.06103690937814161
chr11	STT3A	125594049	125594097	0	49	425	7052	425	7003	0.0	0.06068827645294873
chr11	FAM118B	126229224	126229293	164	70	7194	3544	7030	3474	2.342857142857143	2.0236039147956246
chr11	FAM118B	126234994	126235087	0	94	7194	3544	7194	3450	0.0	2.0852173913043477
chr11	ST3GAL4	126407573	126407634	0	62	0	5834	0	5772	0.0	0.0
chr11	ST3GAL4	126408098	126408194	0	97	0	5834	0	5737	0.0	0.0
chr11	ST3GAL4	126408306	126408496	0	191	0	5834	0	5643	0.0	0.0
chr11	APLP2	130100269	130100425	2092	157	16012	7164	13920	7007	13.32484076433121	1.986584843727701
chr11	APLP2	130101925	130102000	1326	76	16012	7164	14686	7088	17.44736842105263	2.0719525959367946
chr11	ACAD8	134256547	134256648	0	102	0	6406	0	6304	0.0	0.0
chr11	ACAD8	134257087	134257257	0	171	0	6406	0	6235	0.0	0.0
chr11	ACAD8	134258514	134258624	0	111	0	6406	0	6295	0.0	0.0
chr11	SIGIRR	408694	408893	0	200	126442	2873	126442	2673	0.0	47.303404414515526
chr11	SIGIRR	409867	410027	0	161	126442	2873	126442	2712	0.0	46.62315634218289
chr11	SIGIRR	408072	408206	0	135	126442	2873	126442	2738	0.0	46.18042366691015
chr11	IRF7	613950	614037	573	88	64800	2356	64227	2268	6.511363636363637	28.31878306878307
chr11	IRF7	614173	614399	4422	227	64800	2356	60378	2129	19.480176211453745	28.359793330201974
chr11	CHID1	884067	884169	62987	103	707943	4078	644956	3975	611.5242718446602	162.25308176100629
chr11	CHID1	893426	893519	43948	94	707943	4078	663995	3984	467.531914893617	166.66541164658634
chr11	MUC6	1013795	1013898	0	104	1964	8471	1964	8367	0.0	0.2347316839966535
chr11	MUC6	1013898	1014001	0	104	1964	8471	1964	8367	0.0	0.2347316839966535
chr11	TOLLIP	1290226	1290409	0	184	74708	5727	74708	5543	0.0	13.477900054122317
chr11	TOLLIP	1295644	1295794	8681	151	74708	5727	66027	5576	57.49006622516556	11.841284074605452
chr11	NAP1L4	2983745	2983813	221	69	9882	5136	9661	5067	3.2028985507246377	1.9066508782316953
chr11	NAP1L4	2988076	2988126	0	51	9882	5136	9882	5085	0.0	1.943362831858407
chr11	CARS1	3047752	3048001	24550	250	105140	7131	80590	6881	98.2	11.711960470861793
chr11	CARS1	3054876	3055039	0	164	105140	7131	105140	6967	0.0	15.091143964403617
chr11	ZNF195	3360719	3360788	0	70	5428	7243	5428	7173	0.0	0.7567266136902272
chr11	ZNF195	3361742	3361889	0	148	5428	7243	5428	7095	0.0	0.765045806906272
chr11	ZNF195	3362545	3362602	0	58	5428	7243	5428	7185	0.0	0.7554627696590118
chr11	ZNF195	3361975	3362032	0	58	5428	7243	5428	7185	0.0	0.7554627696590118
chr11	ZNF195	3361975	3362073	0	99	5428	7243	5428	7144	0.0	0.7597984322508399
chr11	ZNF195	3373576	3373675	237	100	5428	7243	5191	7143	2.37	0.7267254654906902
chr11	ZNF195	3377616	3377802	459	187	5428	7243	4969	7056	2.4545454545454546	0.7042233560090703
chr11	ZNF195	3373576	3373656	219	81	5428	7243	5209	7162	2.7037037037037037	0.7273108070371405
chr11	TRIM68	4603244	4603340	0	97	0	3796	0	3699	0.0	0.0
chr11	TRIM68	4605078	4605561	0	484	0	3796	0	3312	0.0	0.0
chr11	TRIM5	5665980	5666081	0	102	16953	4811	16953	4709	0.0	3.6001274155871736
chr11	TRIM5	5667688	5667711	0	24	16953	4811	16953	4787	0.0	3.5414664716941715
chr11	AC107884.1	7451812	7451963	0	152	0	5841	0	5689	0.0	0.0
chr11	AC107884.1	7456817	7456849	0	33	0	5841	0	5808	0.0	0.0
chr11	CYB5R2	7665826	7665939	0	114	867	5718	867	5604	0.0	0.15471092077087795
chr11	CYB5R2	7666450	7666550	0	101	867	5718	867	5617	0.0	0.1543528573971871
chr11	STK33	8480533	8480614	0	82	1086	7588	1086	7506	0.0	0.14468425259792167
chr11	STK33	8567250	8567293	0	44	1086	7588	1086	7544	0.0	0.14395546129374337
chr11	DENND2B	8811246	8811335	0	90	208720	10617	208720	10527	0.0	19.827111237769547
chr11	DENND2B	8839309	8839350	100	42	208720	10617	208620	10575	2.380952380952381	19.727659574468085
chr11	DENND2B	8831555	8831688	0	134	208720	10617	208720	10483	0.0	19.910331012114852
chr11	DENND2B	8870953	8871088	0	136	208720	10617	208720	10481	0.0	19.914130331075278
chr11	SBF2	9828125	9828221	0	97	19548	15076	19548	14979	0.0	1.3050270378529942
chr11	SBF2	9828595	9828632	0	38	19548	15076	19548	15038	0.0	1.299906902513632
chr11	SBF2	9819228	9819303	0	76	19548	15076	19548	15000	0.0	1.3032
chr11	IRAG1	10633967	10634071	0	105	0	7711	0	7606	0.0	0.0
chr11	IRAG1	10652024	10652182	0	159	0	7711	0	7552	0.0	0.0
chr11	IRAG1	10658383	10658579	0	197	0	7711	0	7514	0.0	0.0
chr11	IRAG1	10690264	10690369	0	106	0	7711	0	7605	0.0	0.0
chr11	EIF4G2	10806819	10806885	0	67	31748	7294	31748	7227	0.0	4.392970803929708
chr11	EIF4G2	10807254	10807381	0	128	31748	7294	31748	7166	0.0	4.430365615406084
chr11	LINC00958	12965107	12965214	12526	108	131401	5127	118875	5019	115.98148148148148	23.684997011356845
chr11	LINC00958	12980409	12980909	51	501	131401	5127	131350	4626	0.10179640718562874	28.393860786856894
chr11	LINC00958	12984225	12984338	0	114	131401	5127	131401	5013	0.0	26.212048673449033
chr11	LINC00958	12986039	12986144	0	106	131401	5127	131401	5021	0.0	26.17028480382394
chr11	RRAS2	14308206	14308317	0	112	3052	3469	3052	3357	0.0	0.9091450700029788
chr11	RRAS2	14356685	14356769	0	85	3052	3469	3052	3384	0.0	0.9018912529550828
chr11	ABCC8	17470100	17470222	0	123	51038	9821	51038	9698	0.0	5.262734584450402
chr11	ABCC8	17474885	17475027	0	143	51038	9821	51038	9678	0.0	5.2736102500516635
chr11	SERGEF	17926737	17926846	0	110	9464	3044	9464	2934	0.0	3.225630538513974
chr11	SERGEF	17959469	17959636	0	168	9464	3044	9464	2876	0.0	3.290681502086231
chr11	HPS5	18291441	18292019	0	579	26850	6458	26850	5879	0.0	4.567103248851845
chr11	HPS5	18292898	18292976	50	79	26850	6458	26800	6379	0.6329113924050633	4.201285467941684
chr11	UEVLD	18575346	18575412	1	67	49524	5531	49523	5464	0.014925373134328358	9.063506588579795
chr11	UEVLD	18578723	18578808	0	86	49524	5531	49524	5445	0.0	9.095316804407714
chr11	UEVLD	18570213	18570377	0	165	49524	5531	49524	5366	0.0	9.229221021244875
chr11	CSRP3	19186215	19186348	97	134	4465	1641	4368	1507	0.7238805970149254	2.898473788984738
chr11	CSRP3	19188135	19188304	127	170	4465	1641	4338	1471	0.7470588235294118	2.9490142760027194
chr11	DCDC1	30943581	30943674	0	94	0	12605	0	12511	0.0	0.0
chr11	DCDC1	30952444	30952568	0	125	0	12605	0	12480	0.0	0.0
chr11	IMMP1L	31463171	31463305	0	135	12906	3848	12906	3713	0.0	3.475895502289254
chr11	IMMP1L	31477500	31477759	0	260	12906	3848	12906	3588	0.0	3.596989966555184
chr11	IMMP1L	31469757	31469797	0	41	12906	3848	12906	3807	0.0	3.3900709219858154
chr11	IMMP1L	31473723	31473786	0	64	12906	3848	12906	3784	0.0	3.410676532769556
chr11	IMMP1L	31437075	31437154	0	80	12906	3848	12906	3768	0.0	3.4251592356687897
chr11	IMMP1L	31447982	31449091	4465	1110	12906	3848	8441	2738	4.0225225225225225	3.0829072315558803
chr11	AC131571.1	31655933	31656969	0	1037	99	6618	99	5581	0.0	0.017738756495251747
chr11	AC131571.1	31727786	31727895	0	110	99	6618	99	6508	0.0	0.015212046711739398
chr11	WT1	32392665	32392755	0	91	0	6874	0	6783	0.0	0.0
chr11	WT1	32396256	32396407	0	152	0	6874	0	6722	0.0	0.0
chr11	CSTF3	33144869	33144973	0	105	23526	4539	23526	4434	0.0	5.305818673883627
chr11	CSTF3	33156707	33156803	154	97	23526	4539	23372	4442	1.5876288659793814	5.261593876632148
chr11	CD59	33713378	33713469	0	92	113802	10567	113802	10475	0.0	10.864152744630072
chr11	CD59	33716825	33716868	0	44	113802	10567	113802	10523	0.0	10.814596597928347
chr11	CD59	33711383	33711505	0	123	113802	10567	113802	10444	0.0	10.896399846801991
chr11	CD59	33722916	33723029	0	114	113802	10567	113802	10453	0.0	10.887018080933704
chr11	CD59	33731423	33731468	104316	46	113802	10567	9486	10521	2267.7391304347825	0.9016253207869974
chr11	CD59	33733494	33733610	40	117	113802	10567	113762	10450	0.3418803418803419	10.886315789473684
chr11	SLC1A2	35292286	35292520	0	235	7793529	13109	7793529	12874	0.0	605.3696597794003
chr11	SLC1A2	35301518	35301645	0	128	7793529	13109	7793529	12981	0.0	600.3797088051768
chr11	SLC1A2	35322560	35322679	0	120	7793529	13109	7793529	12989	0.0	600.0099314804835
chr11	SLC1A2	35380380	35380541	0	162	7793529	13109	7793529	12947	0.0	601.9563605468448
chr11	SLC1A2	35370940	35371096	0	157	7793529	13109	7793529	12952	0.0	601.723980852378
chr11	SLC1A2	35418949	35419007	0	59	7793529	13109	7793529	13050	0.0	597.2052873563218
chr11	LINC02740	42250270	42250416	0	147	0	2061	0	1914	0.0	0.0
chr11	LINC02740	42253058	42253129	0	72	0	2061	0	1989	0.0	0.0
chr11	TP53I11	44939113	44939190	0	78	0	7153	0	7075	0.0	0.0
chr11	TP53I11	44941002	44941077	0	76	0	7153	0	7077	0.0	0.0
chr11	TP53I11	44939165	44939281	0	117	0	7153	0	7036	0.0	0.0
chr11	PHF21A	45945839	45946003	0	165	76881	9390	76881	9225	0.0	8.333983739837398
chr11	PHF21A	45946075	45946098	0	24	76881	9390	76881	9366	0.0	8.208520179372197
chr11	PHF21A	46117921	46118114	0	194	76881	9390	76881	9196	0.0	8.360265332753372
chr11	PHF21A	46118741	46118800	0	60	76881	9390	76881	9330	0.0	8.240192926045015
chr11	AMBRA1	46508190	46508370	0	181	140410	7626	140410	7445	0.0	18.859637340496977
chr11	AMBRA1	46512726	46512813	682	88	140410	7626	139728	7538	7.75	18.536481825417884
chr11	ARFGAP2	47173758	47173840	34	83	45245	5269	45211	5186	0.40963855421686746	8.71789433089086
chr11	ARFGAP2	47175014	47175098	183	85	45245	5269	45062	5184	2.152941176470588	8.692515432098766
chr11	ARFGAP2	47175850	47175923	288	74	45245	5269	44957	5195	3.891891891891892	8.653897978825794
chr11	ARFGAP2	47176515	47176634	1600	120	45245	5269	43645	5149	13.333333333333334	8.476403185084482
chr11	AC090559.1	47395489	47395577	0	89	153	2935	153	2846	0.0	0.05375966268446943
chr11	AC090559.1	47405509	47405547	0	39	153	2935	153	2896	0.0	0.05283149171270718
chr11	CELF1	47506857	47506897	0	41	37678	9012	37678	8971	0.0	4.199977705941366
chr11	CELF1	47564350	47564469	0	120	37678	9012	37678	8892	0.0	4.237291947818264
chr11	FNBP4	47754527	47754664	0	138	100478	6583	100478	6445	0.0	15.590069821567106
chr11	FNBP4	47765269	47765362	222	94	100478	6583	100256	6489	2.3617021276595747	15.450146401602712
chr11	FOLH1	49206279	49206332	0	54	0	5358	0	5304	0.0	0.0
chr11	FOLH1	49206777	49206874	0	98	0	5358	0	5260	0.0	0.0
chr11	FOLH1	49207763	49207901	0	139	0	5358	0	5219	0.0	0.0
chr11	MS4A4E	60224964	60225093	0	130	100	2892	100	2762	0.0	0.036205648081100654
chr11	MS4A4E	60228593	60228627	0	35	100	2892	100	2857	0.0	0.03500175008750438
chr11	SLC15A3	60941121	60941290	0	170	204	4224	204	4054	0.0	0.05032067094227923
chr11	SLC15A3	60942034	60942145	0	112	204	4224	204	4112	0.0	0.04961089494163424
chr11	CPSF7	61420469	61420530	0	62	1321	4905	1321	4843	0.0	0.2727648151971918
chr11	CPSF7	61420546	61420573	0	28	1321	4905	1321	4877	0.0	0.27086323559565306
chr11	CPSF7	61421053	61421127	0	75	1321	4905	1321	4830	0.0	0.27349896480331265
chr11	CPSF7	61421191	61421257	0	67	1321	4905	1321	4838	0.0	0.27304671351798265
chr11	CPSF7	61421053	61421130	0	78	1321	4905	1321	4827	0.0	0.2736689455148125
chr11	SYT7	61546030	61546255	0	226	19743	7567	19743	7341	0.0	2.6894156109521865
chr11	SYT7	61546534	61546659	0	126	19743	7567	19743	7441	0.0	2.6532724096223625
chr11	SYT7	61547176	61547308	0	133	19743	7567	19743	7434	0.0	2.655770782889427
chr11	SNHG1	62854887	62854938	0	52	0	3736	0	3684	0.0	0.0
chr11	SNHG1	62855132	62855216	0	85	0	3736	0	3651	0.0	0.0
chr11	SNHG1	62854017	62854064	0	48	0	3736	0	3688	0.0	0.0
chr11	SNHG1	62854518	62854551	0	34	0	3736	0	3702	0.0	0.0
chr11	PLAAT5	63468356	63468465	12	110	4762	3274	4750	3164	0.10909090909090909	1.5012642225031605
chr11	PLAAT5	63490242	63490333	19	92	4762	3274	4743	3182	0.20652173913043478	1.4905719673161533
chr11	NRXN2	64690404	64690476	0	73	158895	9747	158895	9674	0.0	16.42495348356419
chr11	NRXN2	64692846	64692876	5	31	158895	9747	158890	9716	0.16129032258064516	16.35343762865377
chr11	SYVN1	65132247	65132351	0	105	454	5209	454	5104	0.0	0.0889498432601881
chr11	SYVN1	65132731	65132780	82	50	454	5209	372	5159	1.64	0.07210699748013182
chr11	SLC25A45	65379375	65379561	1442	187	320273	4923	318831	4736	7.711229946524064	67.32073479729729
chr11	SLC25A45	65379866	65379938	341	73	320273	4923	319932	4850	4.671232876712328	65.96536082474226
chr11	RELA	65660123	65660215	175334	93	1911399	4483	1736065	4390	1885.3118279569892	395.45899772209566
chr11	RELA	65661686	65661835	5746	150	1911399	4483	1905653	4333	38.306666666666665	439.79990768520656
chr11	RELA	65661936	65662088	20112	153	1911399	4483	1891287	4330	131.45098039215685	436.7868360277136
chr11	RELA	65662178	65662205	3142	28	1911399	4483	1908257	4455	112.21428571428571	428.34051627384963
chr11	EFEMP2	65866844	65866934	0	91	4023	4066	4023	3975	0.0	1.0120754716981133
chr11	EFEMP2	65867020	65867079	0	60	4023	4066	4023	4006	0.0	1.0042436345481778
chr11	YIF1A	66287811	66287916	255	106	13169	2353	12914	2247	2.4056603773584904	5.747218513573654
chr11	YIF1A	66288080	66288292	3886	213	13169	2353	9283	2140	18.24413145539906	4.337850467289719
chr11	PC	66954248	66954436	0	189	7868	7336	7868	7147	0.0	1.1008814887365328
chr11	PC	66957868	66957996	340	129	7868	7336	7528	7207	2.635658914728682	1.0445400305258776
chr11	PC	66957739	66957996	340	258	7868	7336	7528	7078	1.317829457364341	1.0635772817179994
chr11	PC	66952429	66952468	110	40	7868	7336	7758	7296	2.75	1.0633223684210527
chr11	TMEM134	67464802	67464856	0	55	0	1799	0	1744	0.0	0.0
chr11	TMEM134	67465055	67465100	0	46	0	1799	0	1753	0.0	0.0
chr11	LTO1	69671748	69671819	0	72	0	5823	0	5751	0.0	0.0
chr11	LTO1	69673215	69673321	0	107	0	5823	0	5716	0.0	0.0
chr11	SHANK2	70500569	70500599	0	31	2103	19063	2103	19032	0.0	0.11049810844892811
chr11	SHANK2	70501922	70501931	0	10	2103	19063	2103	19053	0.0	0.11037631868997008
chr11	SHANK2	70500569	70500596	0	28	2103	19063	2103	19035	0.0	0.11048069345941687
chr11	NUMA1	72049418	72049539	0	122	248740	15188	248740	15066	0.0	16.51002256737024
chr11	NUMA1	72062588	72062686	0	99	248740	15188	248740	15089	0.0	16.48485651799324
chr11	NUMA1	72050661	72050833	0	173	248740	15188	248740	15015	0.0	16.566100566100566
chr11	NUMA1	72068104	72068231	55	128	248740	15188	248685	15060	0.4296875	16.512948207171316
chr11	NUMA1	72068495	72068617	0	123	248740	15188	248740	15065	0.0	16.511118486558246
chr11	NUMA1	72068078	72068231	81	154	248740	15188	248659	15034	0.525974025974026	16.539776506585074
chr11	PDE2A	72631077	72631139	0	63	22969	7220	22969	7157	0.0	3.209305574961576
chr11	PDE2A	72642253	72642326	0	74	22969	7220	22969	7146	0.0	3.214245731877974
chr11	STARD10	72755700	72755753	0	54	51	2748	51	2694	0.0	0.01893095768374165
chr11	STARD10	72757766	72757884	0	119	51	2748	51	2629	0.0	0.019399011030810195
chr11	RAB6A	73718612	73718718	0	107	5363	4907	5363	4800	0.0	1.1172916666666666
chr11	RAB6A	73718784	73718890	255	107	5363	4907	5108	4800	2.383177570093458	1.0641666666666667
chr11	KCNE3	74462747	74462855	0	109	2123926	3605	2123926	3496	0.0	607.5303203661327
chr11	KCNE3	74464261	74464325	27	65	2123926	3605	2123899	3540	0.4153846153846154	599.9714689265537
chr11	XRRA1	74940784	74940882	0	99	153	8801	153	8702	0.0	0.017582165019535738
chr11	XRRA1	74945017	74945085	0	69	153	8801	153	8732	0.0	0.017521759047182776
chr11	XRRA1	74851988	74852082	0	95	153	8801	153	8706	0.0	0.01757408683666437
chr11	XRRA1	74906238	74906456	0	219	153	8801	153	8582	0.0	0.01782801211838732
chr11	PAK1	77397026	77397158	0	133	77038	5942	77038	5809	0.0	13.261835083491134
chr11	PAK1	77408153	77408232	102	80	77038	5942	76936	5862	1.275	13.124530876833845
chr11	CLNS1A	77625716	77625818	0	103	23819	4489	23819	4386	0.0	5.430688554491564
chr11	CLNS1A	77629762	77629899	2324	138	23819	4489	21495	4351	16.840579710144926	4.940243622155826
chr11	ALG8	78135229	78135347	561	119	1326	3191	765	3072	4.714285714285714	0.2490234375
chr11	ALG8	78138709	78138767	0	59	1326	3191	1326	3132	0.0	0.42337164750957856
chr11	KCTD21	78177738	78177985	10	248	10529	3974	10519	3726	0.04032258064516129	2.8231347289318305
chr11	KCTD21	78186680	78186816	0	137	10529	3974	10529	3837	0.0	2.744070888715142
chr11	RAB30	83034171	83034272	0	102	71094	11843	71094	11741	0.0	6.055191210288732
chr11	RAB30	83060076	83060178	0	103	71094	11843	71094	11740	0.0	6.055706984667802
chr11	DLG2	83483252	83483298	0	47	226	16296	226	16249	0.0	0.013908548218351899
chr11	DLG2	83484128	83484228	0	101	226	16296	226	16195	0.0	0.013954924359370176
chr11	SYTL2	85716346	85716428	181	83	205524	11277	205343	11194	2.180722891566265	18.344023584062892
chr11	SYTL2	85717044	85717140	108	97	205524	11277	205416	11180	1.1134020618556701	18.373524150268338
chr11	CTSC	88309162	88309318	0	157	51	15798	51	15641	0.0	0.0032606610830509556
chr11	CTSC	88312387	88312554	0	168	51	15798	51	15630	0.0	0.0032629558541266796
chr11	CTSC	88328111	88328196	0	86	51	15798	51	15712	0.0	0.003245926680244399
chr11	CTSC	88334936	88335082	0	147	51	15798	51	15651	0.0	0.003258577726662833
chr11	CTSC	88327243	88327358	0	116	51	15798	51	15682	0.0	0.003252136207116439
chr11	CTSC	88327928	88328016	0	89	51	15798	51	15709	0.0	0.003246546565662996
chr11	SESN3	95201236	95201355	51	120	408	10592	357	10472	0.425	0.03409090909090909
chr11	SESN3	95224451	95224484	0	34	408	10592	408	10558	0.0	0.03864368251562796
chr11	MTMR2	95866402	95866486	1071	85	3022	10675	1951	10590	12.6	0.1842304060434372
chr11	MTMR2	95882373	95882496	51	124	3022	10675	2971	10551	0.4112903225806452	0.2815846839162165
chr11	MTMR2	95887611	95887684	0	74	3022	10675	3022	10601	0.0	0.2850674464673144
chr11	MTMR2	95866383	95866486	1071	104	3022	10675	1951	10571	10.298076923076923	0.18456153627849778
chr11	MTMR2	95888155	95888261	51	107	3022	10675	2971	10568	0.4766355140186916	0.28113171839515516
chr11	MTMR2	95887325	95887373	0	49	3022	10675	3022	10626	0.0	0.2843967626576322
chr11	MTMR2	95914241	95914312	58	72	3022	10675	2964	10603	0.8055555555555556	0.27954352541733474
chr11	MTMR2	95887611	95887759	0	149	3022	10675	3022	10526	0.0	0.28709861295838873
chr11	CCDC82	96388694	96388829	0	136	0	14215	0	14079	0.0	0.0
chr11	CCDC82	96389364	96389523	0	160	0	14215	0	14055	0.0	0.0
chr11	PGR	101062446	101062752	0	307	208	14342	208	14035	0.0	0.01482009262557891
chr11	PGR	101091759	101091876	0	118	208	14342	208	14224	0.0	0.014623172103487065
chr11	MMP8	102722990	102723078	0	89	38865	3451	38865	3362	0.0	11.560083283759667
chr11	MMP8	102723479	102723546	0	68	38865	3451	38865	3383	0.0	11.488323972805203
chr11	LINC02552	104572075	104572222	0	148	0	15741	0	15593	0.0	0.0
chr11	LINC02552	104572556	104572597	0	42	0	15741	0	15699	0.0	0.0
chr11	LINC02552	104595481	104595533	0	53	0	15741	0	15688	0.0	0.0
chr11	LINC02552	104607022	104607136	0	115	0	15741	0	15626	0.0	0.0
chr11	CASP5	105003273	105003383	0	111	0	1603	0	1492	0.0	0.0
chr11	CASP5	105007082	105007334	0	253	0	1603	0	1350	0.0	0.0
chr11	PPP2R1B	111760818	111761051	0	234	31825	6705	31825	6471	0.0	4.918096121155926
chr11	PPP2R1B	111761118	111761291	0	174	31825	6705	31825	6531	0.0	4.8729137957433775
chr11	AP001781.1	111769358	111769452	0	95	0	890	0	795	0.0	0.0
chr11	AP001781.1	111770978	111771036	0	59	0	890	0	831	0.0	0.0
chr11	ALG9	111788440	111788569	0	130	4268	7995	4268	7865	0.0	0.5426573426573427
chr11	ALG9	111805093	111805315	0	223	4268	7995	4268	7772	0.0	0.5491507977354606
chr11	ALG9	111798093	111798195	57	103	4268	7995	4211	7892	0.5533980582524272	0.5335783071464775
chr11	ALG9	111853648	111853736	0	89	4268	7995	4268	7906	0.0	0.5398431570958766
chr11	ALG9	111857601	111857737	2316	137	4268	7995	1952	7858	16.905109489051096	0.24840926444387884
chr11	PCSK7	117207066	117207109	79	44	126985	20140	126906	20096	1.7954545454545454	6.3149880573248405
chr11	PCSK7	117207969	117208064	220	96	126985	20140	126765	20044	2.2916666666666665	6.324336459788466
chr11	FXYD6	117840318	117840368	0	51	0	4097	0	4046	0.0	0.0
chr11	FXYD6	117841147	117841184	0	38	0	4097	0	4059	0.0	0.0
chr11	FXYD6	117844109	117844206	0	98	0	4097	0	3999	0.0	0.0
chr11	FXYD6	117858210	117858286	0	77	0	4097	0	4020	0.0	0.0
chr11	CD3D	118339774	118339906	51	133	3643	775	3592	642	0.38345864661654133	5.595015576323988
chr11	CD3D	118340374	118340593	0	220	3643	775	3643	555	0.0	6.563963963963964
chr11	SLC37A4	119027627	119027872	263	246	2425	4259	2162	4013	1.0691056910569106	0.5387490655370047
chr11	SLC37A4	119028193	119028426	51	234	2425	4259	2374	4025	0.21794871794871795	0.5898136645962733
chr11	MIR100HG	122033313	122033462	784	150	1420	24445	636	24295	5.226666666666667	0.02617822597242231
chr11	MIR100HG	122040216	122040249	0	34	1420	24445	1420	24411	0.0	0.05817049690713203
chr11	MIR100HG	122066135	122066434	0	300	1420	24445	1420	24145	0.0	0.05881134810519777
chr11	MIR100HG	122067382	122067511	0	130	1420	24445	1420	24315	0.0	0.05840016450750565
chr11	MIR100HG	122038026	122038243	81	218	1420	24445	1339	24227	0.37155963302752293	0.05526891484707145
chr11	MIR100HG	122064179	122066434	51	2256	1420	24445	1369	22189	0.022606382978723406	0.06169723736986795
chr11	MIR100HG	122189453	122189525	0	73	1420	24445	1420	24372	0.0	0.05826358115870671
chr11	MIR100HG	122202763	122202909	0	147	1420	24445	1420	24298	0.0	0.05844102395258869
chr11	MIR100HG	122180335	122180398	0	64	1420	24445	1420	24381	0.0	0.05824207374594972
chr11	MIR100HG	122292283	122292403	0	121	1420	24445	1420	24324	0.0	0.05837855615852656
chr11	MIR100HG	122293306	122293606	0	301	1420	24445	1420	24144	0.0	0.05881378396288933
chr11	MIR100HG	122384365	122384621	0	257	1420	24445	1420	24188	0.0	0.05870679675872333
chr11	SCN3B	123638776	123638829	0	54	51	7226	51	7172	0.0	0.007110987172336865
chr11	SCN3B	123641341	123641817	0	477	51	7226	51	6749	0.0	0.007556675062972292
chr11	TMEM218	125110490	125110549	0	60	0	4681	0	4621	0.0	0.0
chr11	TMEM218	125110643	125110746	0	104	0	4681	0	4577	0.0	0.0
chr11	ETS1	128463508	128463627	0	120	0	7163	0	7043	0.0	0.0
chr11	ETS1	128480400	128480451	0	52	0	7163	0	7111	0.0	0.0
chr11	KCNJ1	128850720	128850890	0	171	87325	4642	87325	4471	0.0	19.53142473719526
chr11	KCNJ1	128866522	128866655	0	134	87325	4642	87325	4508	0.0	19.37111801242236
chr12	CACNA1C	2504435	2504539	0	105	41248	19162	41248	19057	0.0	2.164454006401847
chr12	CACNA1C	2504841	2504945	0	105	41248	19162	41248	19057	0.0	2.164454006401847
chr12	CACNA1C	2597229	2597289	0	61	41248	19162	41248	19101	0.0	2.159468090675881
chr12	CACNA1C	2597436	2597496	11	61	41248	19162	41237	19101	0.18032786885245902	2.158892204596618
chr12	CACNA1C	2633628	2633712	0	85	41248	19162	41248	19077	0.0	2.1621848298998794
chr12	CACNA1C	2634296	2634380	22	85	41248	19162	41226	19077	0.25882352941176473	2.1610316087435133
chr12	CACNA1C	2680362	2680575	0	214	41248	19162	41248	18948	0.0	2.1769052142706355
chr12	CACNA1C	2681949	2682054	0	106	41248	19162	41248	19056	0.0	2.1645675902602854
chr12	CACNA1C	2648474	2648507	0	34	41248	19162	41248	19128	0.0	2.1564199079882895
chr12	TEAD4	2994737	2994992	281	256	16150	2289	15869	2033	1.09765625	7.805705853418593
chr12	TEAD4	3011003	3011068	49	66	16150	2289	16101	2223	0.7424242424242424	7.242914979757085
chr12	TSPAN9	3083652	3083719	0	68	857	6917	857	6849	0.0	0.12512775587677033
chr12	TSPAN9	3201176	3201256	0	81	857	6917	857	6836	0.0	0.12536571094207138
chr12	RAD51AP1	4545218	4545312	0	95	0	2491	0	2396	0.0	0.0
chr12	RAD51AP1	4545781	4545832	0	52	0	2491	0	2439	0.0	0.0
chr12	DYRK4	4573329	4573356	0	28	9867	7067	9867	7039	0.0	1.401761613865606
chr12	DYRK4	4580823	4580977	0	155	9867	7067	9867	6912	0.0	1.4275173611111112
chr12	CD9	6200892	6200973	0	82	0	4900	0	4818	0.0	0.0
chr12	CD9	6205958	6206084	0	127	0	4900	0	4773	0.0	0.0
chr12	COPS7A	6725864	6725959	0	96	255	2633	255	2537	0.0	0.10051241623965314
chr12	COPS7A	6727670	6727800	0	131	255	2633	255	2502	0.0	0.10191846522781775
chr12	CD4	6798879	6799074	0	196	1531	3864	1531	3668	0.0	0.4173936750272628
chr12	CD4	6799537	6799623	0	87	1531	3864	1531	3777	0.0	0.4053481599152767
chr12	PEX5	7190361	7190524	0	164	2178	5387	2178	5223	0.0	0.4170017231476163
chr12	PEX5	7190887	7190923	0	37	2178	5387	2178	5350	0.0	0.40710280373831775
chr12	CLEC4A	8125560	8125677	0	118	0	1287	0	1169	0.0	0.0
chr12	CLEC4A	8135584	8135736	0	153	0	1287	0	1134	0.0	0.0
chr12	CLEC4A	8129263	8129362	0	100	0	1287	0	1187	0.0	0.0
chr12	AC092745.1	8322860	8323108	0	249	0	855	0	606	0.0	0.0
chr12	AC092745.1	8323552	8323724	0	173	0	855	0	682	0.0	0.0
chr12	CLEC2D	9693033	9693115	0	83	102	6863	102	6780	0.0	0.01504424778761062
chr12	CLEC2D	9693824	9693948	0	125	102	6863	102	6738	0.0	0.015138023152270703
chr12	KLRF1	9833302	9833452	1720	151	3362	1266	1642	1115	11.390728476821192	1.472645739910314
chr12	KLRF1	9841811	9841951	0	141	3362	1266	3362	1125	0.0	2.9884444444444442
chr12	KLRF1	9842320	9842433	651	114	3362	1266	2711	1152	5.7105263157894735	2.353298611111111
chr12	KLRD1	10309387	10309480	0	94	204	15814	204	15720	0.0	0.012977099236641221
chr12	KLRD1	10309625	10309688	0	64	204	15814	204	15750	0.0	0.012952380952380953
chr12	LINC02366	10775864	10775984	0	121	349	966	349	845	0.0	0.41301775147928993
chr12	LINC02366	10776511	10776801	63	291	349	966	286	675	0.21649484536082475	0.4237037037037037
chr12	BCL2L14	12068128	12068222	0	95	11	5083	11	4988	0.0	0.0022052927024859663
chr12	BCL2L14	12072224	12072499	0	276	11	5083	11	4807	0.0	0.002288329519450801
chr12	BCL2L14	12077705	12077978	0	274	11	5083	11	4809	0.0	0.0022873778332293615
chr12	GPRC5D-AS1	12966758	12966857	25	100	88580	3432	88555	3332	0.25	26.577130852340936
chr12	GPRC5D-AS1	12978940	12979021	33422	82	88580	3432	55158	3350	407.5853658536585	16.465074626865672
chr12	PTPRO	15560192	15560276	0	85	51	18862	51	18777	0.0	0.002716088832081802
chr12	PTPRO	15565592	15565628	0	37	51	18862	51	18825	0.0	0.0027091633466135457
chr12	DERA	15911690	15911753	84	64	1868	2827	1784	2763	1.3125	0.6456749909518639
chr12	DERA	15916116	15916316	0	201	1868	2827	1868	2626	0.0	0.7113480578827114
chr12	SLCO1C1	20699551	20699705	0	155	67590	4794	67590	4639	0.0	14.569950420349214
chr12	SLCO1C1	20705948	20706081	67590	134	67590	4794	0	4660	504.4029850746269	0.0
chr12	AC022335.1	21089907	21089929	0	23	0	865	0	842	0.0	0.0
chr12	AC022335.1	21119603	21119627	0	25	0	865	0	840	0.0	0.0
chr12	IAPP	21373641	21373733	0	93	0	2157	0	2064	0.0	0.0
chr12	IAPP	21376322	21376364	0	43	0	2157	0	2114	0.0	0.0
chr12	GOLT1B	21506884	21506976	0	93	204	3657	204	3564	0.0	0.05723905723905724
chr12	GOLT1B	21508382	21508561	0	180	204	3657	204	3477	0.0	0.058671268334771355
chr12	GOLT1B	21507116	21507151	0	36	204	3657	204	3621	0.0	0.056338028169014086
chr12	GOLT1B	21507943	21508109	0	167	204	3657	204	3490	0.0	0.05845272206303725
chr12	SOX5-AS1	24227710	24227818	0	109	0	3161	0	3052	0.0	0.0
chr12	SOX5-AS1	24230558	24230615	0	58	0	3161	0	3103	0.0	0.0
chr12	AC023796.1	24760129	24760194	0	66	0	2536	0	2470	0.0	0.0
chr12	AC023796.1	24760615	24760783	0	169	0	2536	0	2367	0.0	0.0
chr12	ARNTL2	27370128	27370230	0	103	1734	7001	1734	6898	0.0	0.251377210785735
chr12	ARNTL2	27376345	27376387	0	43	1734	7001	1734	6958	0.0	0.24920954297211842
chr12	ARNTL2	27370167	27370230	0	64	1734	7001	1734	6937	0.0	0.24996396136658497
chr12	FAR2	29270411	29270638	0	228	1122	5429	1122	5201	0.0	0.2157277446644876
chr12	FAR2	29293299	29293475	0	177	1122	5429	1122	5252	0.0	0.21363290175171362
chr12	AC010198.2	30796982	30797210	0	229	97577	18419	97577	18190	0.0	5.364321055525013
chr12	AC010198.2	30798144	30798315	0	172	97577	18419	97577	18247	0.0	5.347563983120513
chr12	FGD4	32576265	32576449	0	185	3865	7667	3865	7482	0.0	0.51657310879444
chr12	FGD4	32581959	32582467	0	509	3865	7667	3865	7158	0.0	0.5399552947750769
chr12	DNM1L	32737864	32737942	0	79	684	7139	684	7060	0.0	0.09688385269121813
chr12	DNM1L	32738263	32738296	0	34	684	7139	684	7105	0.0	0.09627023223082336
chr12	DNM1L	32705824	32705863	0	40	684	7139	684	7099	0.0	0.09635159881673475
chr12	DNM1L	32706689	32706814	0	126	684	7139	684	7013	0.0	0.09753315271638385
chr12	DNM1L	32708152	32708224	0	73	684	7139	684	7066	0.0	0.09680158505519389
chr12	DNM1L	32710928	32711015	0	88	684	7139	684	7051	0.0	0.09700751666430293
chr12	DNM1L	32713208	32713371	0	164	684	7139	684	6975	0.0	0.09806451612903226
chr12	DNM1L	32707366	32707413	0	48	684	7139	684	7091	0.0	0.09646030179100268
chr12	TMEM117	43944209	43944342	0	134	2142	3451	2142	3317	0.0	0.6457642447995177
chr12	TMEM117	44143524	44143624	0	101	2142	3451	2142	3350	0.0	0.6394029850746269
chr12	LINC02156	47405079	47405201	0	123	153	2804	153	2681	0.0	0.057068258112644536
chr12	LINC02156	47415083	47415232	0	150	153	2804	153	2654	0.0	0.05764883195177091
chr12	LINC02156	47408430	47408514	0	85	153	2804	153	2719	0.0	0.05627068775285031
chr12	CACNB3	48824948	48824968	0	21	102	6342	102	6321	0.0	0.01613668723303275
chr12	CACNB3	48825162	48825243	0	82	102	6342	102	6260	0.0	0.016293929712460065
chr12	CACNB3	48823680	48823803	0	124	102	6342	102	6218	0.0	0.016403988420714055
chr12	CACNB3	48824257	48824373	0	117	102	6342	102	6225	0.0	0.0163855421686747
chr12	TUBA1C	49256396	49256511	0	116	27164	3750	27164	3634	0.0	7.474958723170061
chr12	TUBA1C	49257883	49258001	0	119	27164	3750	27164	3631	0.0	7.481134673643624
chr12	SPATS2	49371227	49371290	0	64	27818	6730	27818	6666	0.0	4.173117311731173
chr12	SPATS2	49454224	49454385	458	162	27818	6730	27360	6568	2.8271604938271606	4.165651644336175
chr12	SPATS2	49406472	49406565	474	94	27818	6730	27344	6636	5.042553191489362	4.120554550934298
chr12	SPATS2	49441729	49441816	2546	88	27818	6730	25272	6642	28.931818181818183	3.8048780487804876
chr12	SPATS2	49387053	49387137	0	85	27818	6730	27818	6645	0.0	4.186305492851768
chr12	TMBIM6	49743416	49743565	186	150	2757	5925	2571	5775	1.24	0.4451948051948052
chr12	TMBIM6	49744412	49744542	0	131	2757	5925	2757	5794	0.0	0.47583707283396615
chr12	TMBIM6	49741956	49742280	0	325	2757	5925	2757	5600	0.0	0.4923214285714286
chr12	TMBIM6	49741956	49742115	0	160	2757	5925	2757	5765	0.0	0.4782307025151778
chr12	TMBIM6	49742437	49742607	0	171	2757	5925	2757	5754	0.0	0.4791449426485923
chr12	TMBIM6	49749617	49749856	51	240	2757	5925	2706	5685	0.2125	0.47598944591029024
chr12	LINC02395	49926080	49926145	0	66	85306	6673	85306	6607	0.0	12.911457545028
chr12	LINC02395	49926947	49927083	0	137	85306	6673	85306	6536	0.0	13.05171358629131
chr12	COX14	50112831	50112903	0	73	0	974	0	901	0.0	0.0
chr12	COX14	50118492	50118552	0	61	0	974	0	913	0.0	0.0
chr12	LARP4	50402674	50402813	0	140	97448	8113	97448	7973	0.0	12.222250094067478
chr12	LARP4	50416345	50416434	168	90	97448	8113	97280	8023	1.8666666666666667	12.125140221862146
chr12	LARP4	50412404	50412453	253	50	97448	8113	97195	8063	5.06	12.054446235892348
chr12	LETMD1	51052091	51052207	0	117	564	3857	564	3740	0.0	0.15080213903743314
chr12	LETMD1	51053777	51053860	0	84	564	3857	564	3773	0.0	0.14948316989133315
chr12	LETMD1	51053811	51053860	0	50	564	3857	564	3807	0.0	0.14814814814814814
chr12	LETMD1	51055986	51056021	0	36	564	3857	564	3821	0.0	0.147605338916514
chr12	LETMD1	51056143	51056245	0	103	564	3857	564	3754	0.0	0.1502397442727757
chr12	LETMD1	51056349	51056502	156	154	564	3857	408	3703	1.0129870129870129	0.11018093437753174
chr12	DAZAP2	51240342	51240461	0	120	84	3807	84	3687	0.0	0.022782750203417412
chr12	DAZAP2	51240870	51241116	84	247	84	3807	0	3560	0.340080971659919	0.0
chr12	SCN8A	51688757	51688849	0	93	6609	16021	6609	15928	0.0	0.4149296835760924
chr12	SCN8A	51689004	51689096	12	93	6609	16021	6597	15928	0.12903225806451613	0.4141762933199397
chr12	SCN8A	51780201	51780271	0	71	6609	16021	6609	15950	0.0	0.41435736677115986
chr12	SCN8A	51780648	51780771	0	124	6609	16021	6609	15897	0.0	0.4157388186450274
chr12	LINC00592	52212043	52212156	0	114	328	2261	328	2147	0.0	0.1527713088029809
chr12	LINC00592	52212598	52213027	0	430	328	2261	328	1831	0.0	0.1791370835608957
chr12	LINC00592	52213479	52213688	0	210	328	2261	328	2051	0.0	0.1599219892735251
chr12	LINC00592	52222685	52223074	0	390	328	2261	328	1871	0.0	0.17530732228754678
chr12	LINC00592	52221976	52222028	0	53	328	2261	328	2208	0.0	0.14855072463768115
chr12	LINC00592	52222689	52222943	0	255	328	2261	328	2006	0.0	0.16350947158524426
chr12	LINC00592	52222689	52223074	0	386	328	2261	328	1875	0.0	0.17493333333333333
chr12	EIF4B	53022492	53022627	0	136	0	5369	0	5233	0.0	0.0
chr12	EIF4B	53027781	53027919	0	139	0	5369	0	5230	0.0	0.0
chr12	PFDN5	53295838	53295941	0	104	9874	2927	9874	2823	0.0	3.497697484945094
chr12	PFDN5	53296218	53296275	0	58	9874	2927	9874	2869	0.0	3.441617288253747
chr12	AC073611.1	53303033	53303193	0	161	0	2859	0	2698	0.0	0.0
chr12	AC073611.1	53305907	53306060	0	154	0	2859	0	2705	0.0	0.0
chr12	PFDN5	53296243	53296275	0	33	9874	2927	9874	2894	0.0	3.4118866620594335
chr12	PFDN5	53296429	53296467	0	39	9874	2927	9874	2888	0.0	3.4189750692520775
chr12	PFDN5	53296429	53296551	0	123	9874	2927	9874	2804	0.0	3.521398002853067
chr12	PFDN5	53296453	53296551	0	99	9874	2927	9874	2828	0.0	3.4915134370579914
chr12	PCBP2	53464759	53464852	0	94	60444	6885	60444	6791	0.0	8.900603740244442
chr12	PCBP2	53465931	53465973	41	43	60444	6885	60403	6842	0.9534883720930233	8.82826658871675
chr12	AC076968.2	53860783	53860878	306	96	88160	3598	87854	3502	3.1875	25.0868075385494
chr12	AC076968.2	53875154	53875248	78	95	88160	3598	88082	3503	0.8210526315789474	25.144733085926347
chr12	AC023794.2	54085644	54085845	0	202	0	1667	0	1465	0.0	0.0
chr12	AC023794.2	54093590	54093646	0	57	0	1667	0	1610	0.0	0.0
chr12	HNRNPA1	54284517	54284601	0	85	0	4239	0	4154	0.0	0.0
chr12	HNRNPA1	54285973	54286112	0	140	0	4239	0	4099	0.0	0.0
chr12	HNRNPA1	54285984	54286112	0	129	0	4239	0	4110	0.0	0.0
chr12	HNRNPA1	54285950	54286112	0	163	0	4239	0	4076	0.0	0.0
chr12	COPZ1	54343224	54343316	0	93	64857	3204	64857	3111	0.0	20.847637415621985
chr12	COPZ1	54345459	54345515	0	57	64857	3204	64857	3147	0.0	20.609151572926596
chr12	OR9K2	55126827	55126911	0	85	0	3123	0	3038	0.0	0.0
chr12	OR9K2	55129825	55129897	0	73	0	3123	0	3050	0.0	0.0
chr12	TMEM198B	55831256	55831349	0	94	0	4040	0	3946	0.0	0.0
chr12	TMEM198B	55832958	55833014	0	57	0	4040	0	3983	0.0	0.0
chr12	TMEM198B	55832958	55833038	0	81	0	4040	0	3959	0.0	0.0
chr12	DGKA	55938510	55938560	0	51	93	7520	93	7469	0.0	0.012451466059713482
chr12	DGKA	55938637	55938698	0	62	93	7520	93	7458	0.0	0.01246983105390185
chr12	RAB5B	55989946	55990098	0	153	149	6535	149	6382	0.0	0.023346913193356314
chr12	RAB5B	55990681	55990804	0	124	149	6535	149	6411	0.0	0.023241304008734986
chr12	RAB5B	55980888	55980922	0	35	149	6535	149	6500	0.0	0.022923076923076924
chr12	RAB5B	55985599	55985723	47	125	149	6535	102	6410	0.376	0.01591263650546022
chr12	SUOX	55997614	55997723	0	110	51	4350	51	4240	0.0	0.012028301886792454
chr12	SUOX	55999332	55999458	0	127	51	4350	51	4223	0.0	0.012076722708974662
chr12	SUOX	56001308	56001472	0	165	51	4350	51	4185	0.0	0.012186379928315413
chr12	SUOX	56001885	56001948	0	64	51	4350	51	4286	0.0	0.01189920671955203
chr12	SUOX	55999332	55999590	0	259	51	4350	51	4091	0.0	0.012466389635785871
chr12	MYL6	56159586	56159622	10	37	2762	3310	2752	3273	0.2702702702702703	0.8408188206538344
chr12	MYL6	56159622	56159730	187	109	2762	3310	2575	3201	1.7155963302752293	0.8044361137144642
chr12	SLC39A5	56230239	56230295	0	57	306	2914	306	2857	0.0	0.1071053552677634
chr12	SLC39A5	56230830	56230873	0	44	306	2914	306	2870	0.0	0.10662020905923345
chr12	RBMS2	56562416	56562583	0	168	91014	8931	91014	8763	0.0	10.386169120164327
chr12	RBMS2	56568974	56569033	0	60	91014	8931	91014	8871	0.0	10.259722691917483
chr12	RBMS2	56571697	56571855	17391	159	91014	8931	73623	8772	109.37735849056604	8.392954856361149
chr12	RBMS2	56580277	56580375	51	99	91014	8931	90963	8832	0.5151515151515151	10.299252717391305
chr12	MARS1	57489266	57489345	8390	80	247514	6060	239124	5980	104.875	39.98729096989967
chr12	MARS1	57489895	57489971	5026	77	247514	6060	242488	5983	65.27272727272727	40.52950025071035
chr12	DTX3	57605343	57605731	12431	389	46673	3005	34242	2616	31.956298200514137	13.089449541284404
chr12	DTX3	57605988	57606029	3345	42	46673	3005	43328	2963	79.64285714285714	14.623017212284847
chr12	DTX3	57605570	57605731	4118	162	46673	3005	42555	2843	25.419753086419753	14.968343299331693
chr12	TSPAN31	57745744	57745873	0	130	51	4546	51	4416	0.0	0.01154891304347826
chr12	TSPAN31	57746588	57746720	0	133	51	4546	51	4413	0.0	0.011556764106050306
chr12	SRGAP1	64091275	64091378	0	104	20549	26252	20549	26148	0.0	0.7858727244913569
chr12	SRGAP1	64091892	64091926	0	35	20549	26252	20549	26217	0.0	0.7838044017240722
chr12	TBK1	64475639	64475845	0	207	23165	12697	23165	12490	0.0	1.854683746997598
chr12	TBK1	64479711	64479918	51	208	23165	12697	23114	12489	0.24519230769230768	1.8507486588197615
chr12	TBK1	64468572	64468672	0	101	23165	12697	23165	12596	0.0	1.8390758971101937
chr12	TBK1	64468875	64469289	48	415	23165	12697	23117	12282	0.11566265060240964	1.8821853118384628
chr12	TBK1	64471743	64471995	0	253	23165	12697	23165	12444	0.0	1.8615396978463516
chr12	TBK1	64499066	64499280	0	215	23165	12697	23165	12482	0.0	1.8558724563371254
chr12	TBK1	64500104	64500313	15	210	23165	12697	23150	12487	0.07142857142857142	1.853928085208617
chr12	TBK1	64499066	64499144	0	79	23165	12697	23165	12618	0.0	1.835869392930734
chr12	LINC02389	64885193	64885300	383	108	2862	7783	2479	7675	3.5462962962962963	0.32299674267100975
chr12	LINC02389	64900576	64900698	0	123	2862	7783	2862	7660	0.0	0.37362924281984333
chr12	LINC02389	64981619	64981789	0	171	2862	7783	2862	7612	0.0	0.3759852863899107
chr12	LINC02389	64947315	64947462	0	148	2862	7783	2862	7635	0.0	0.374852652259332
chr12	RAP1B	68624507	68624873	0	367	51	16213	51	15846	0.0	0.003218477849299508
chr12	RAP1B	68641033	68641153	0	121	51	16213	51	16092	0.0	0.003169276659209545
chr12	RAP1B	68624670	68624873	0	204	51	16213	51	16009	0.0	0.0031857080392279345
chr12	RAP1B	68624674	68624873	0	200	51	16213	51	16013	0.0	0.0031849122587897334
chr12	RAP1B	68641037	68641153	0	117	51	16213	51	16096	0.0	0.003168489065606362
chr12	RAP1B	68651994	68652051	0	58	51	16213	51	16155	0.0	0.003156917363045497
chr12	RAP1B	68654111	68654252	0	142	51	16213	51	16071	0.0	0.0031734179578122084
chr12	RAP1B	68656305	68656449	0	145	51	16213	51	16068	0.0	0.0031740104555638537
chr12	RAP1B	68657100	68657217	0	118	51	16213	51	16095	0.0	0.003168685927306617
chr12	SLC35E3	68747929	68748040	0	112	291	22386	291	22274	0.0	0.013064559576187483
chr12	SLC35E3	68748075	68748245	0	171	291	22386	291	22215	0.0	0.013099257258609049
chr12	MDM2	68814602	68814689	0	88	0	10870	0	10782	0.0	0.0
chr12	MDM2	68815627	68815720	0	94	0	10870	0	10776	0.0	0.0
chr12	MDM2	68813553	68813628	0	76	0	10870	0	10794	0.0	0.0
chr12	MDM2	68816811	68816945	0	135	0	10870	0	10735	0.0	0.0
chr12	MDM2	68824554	68824651	0	98	0	10870	0	10772	0.0	0.0
chr12	MDM2	68828770	68828931	0	162	0	10870	0	10708	0.0	0.0
chr12	MDM2	68820324	68820374	0	51	0	10870	0	10819	0.0	0.0
chr12	MDM2	68819952	68819997	0	46	0	10870	0	10824	0.0	0.0
chr12	MDM2	68820884	68820910	0	27	0	10870	0	10843	0.0	0.0
chr12	MDM2	68823414	68823514	0	101	0	10870	0	10769	0.0	0.0
chr12	MDM2	68835828	68835984	0	157	0	10870	0	10713	0.0	0.0
chr12	FRS2	69480298	69480359	0	62	0	7260	0	7198	0.0	0.0
chr12	FRS2	69486201	69486297	0	97	0	7260	0	7163	0.0	0.0
chr12	FRS2	69491537	69491651	0	115	0	7260	0	7145	0.0	0.0
chr12	CNOT2	70285399	70285586	51	188	1946	10263	1895	10075	0.2712765957446808	0.1880893300248139
chr12	CNOT2	70294236	70294294	0	59	1946	10263	1946	10204	0.0	0.19070952567620542
chr12	CNOT2	70301704	70301865	0	162	1946	10263	1946	10101	0.0	0.19265419265419265
chr12	CNOT2	70294070	70294294	0	225	1946	10263	1946	10038	0.0	0.19386331938633194
chr12	CNOT2	70319297	70319364	0	68	1946	10263	1946	10195	0.0	0.19087788131436978
chr12	CNOT2	70332766	70332846	0	81	1946	10263	1946	10182	0.0	0.19112158711451582
chr12	CNOT2	70290726	70290803	0	78	1946	10263	1946	10185	0.0	0.19106529209621992
chr12	TBC1D15	71841100	71841231	0	132	0	8252	0	8120	0.0	0.0
chr12	TBC1D15	71854784	71854853	0	70	0	8252	0	8182	0.0	0.0
chr12	TBC1D15	71880468	71880607	0	140	0	8252	0	8112	0.0	0.0
chr12	TBC1D15	71884810	71885021	0	212	0	8252	0	8040	0.0	0.0
chr12	TBC1D15	71861404	71861496	0	93	0	8252	0	8159	0.0	0.0
chr12	ZDHHC17	76769072	76769201	6049	130	9808	7820	3759	7690	46.53076923076923	0.48881664499349803
chr12	ZDHHC17	76781628	76781683	0	56	9808	7820	9808	7764	0.0	1.263266357547656
chr12	AC128707.1	78423191	78423286	0	96	663	3254	663	3158	0.0	0.20994300189993667
chr12	AC128707.1	78464956	78465080	0	125	663	3254	663	3129	0.0	0.21188878235858102
chr12	OTOGL	80361067	80361185	0	119	16535	12344	16535	12225	0.0	1.3525562372188138
chr12	OTOGL	80366267	80366353	0	87	16535	12344	16535	12257	0.0	1.3490250469119687
chr12	VEZT	95256549	95256622	0	74	959	7893	959	7819	0.0	0.12264995523724262
chr12	VEZT	95262905	95263081	0	177	959	7893	959	7716	0.0	0.12428719543805081
chr12	VEZT	95257149	95257239	0	91	959	7893	959	7802	0.0	0.12291720071776467
chr12	VEZT	95224179	95224236	0	58	959	7893	959	7835	0.0	0.12239948947032546
chr12	VEZT	95243940	95244009	0	70	959	7893	959	7823	0.0	0.12258724274574971
chr12	VEZT	95257153	95257239	0	87	959	7893	959	7806	0.0	0.12285421470663592
chr12	METAP2	95476073	95476178	0	106	3743	4434	3743	4328	0.0	0.8648336414048059
chr12	METAP2	95483214	95483280	0	67	3743	4434	3743	4367	0.0	0.8571101442637966
chr12	NEDD1	96924832	96924942	0	111	153	4482	153	4371	0.0	0.035003431708991076
chr12	NEDD1	96934975	96935205	0	231	153	4482	153	4251	0.0	0.03599153140437544
chr12	RMST	97483430	97483488	0	59	65	10114	65	10055	0.0	0.006464445549477871
chr12	RMST	97491643	97491712	0	70	65	10114	65	10044	0.0	0.006471525288729589
chr12	SLC25A3	98595432	98595557	0	126	306	7682	306	7556	0.0	0.04049761778718899
chr12	SLC25A3	98595726	98595848	0	123	306	7682	306	7559	0.0	0.04048154517793359
chr12	SLC25A3	98595432	98595661	0	230	306	7682	306	7452	0.0	0.04106280193236715
chr12	MYBPC1	101614495	101614531	0	37	5459	7493	5459	7456	0.0	0.7321620171673819
chr12	MYBPC1	101626871	101626910	0	40	5459	7493	5459	7453	0.0	0.7324567288340266
chr12	MYBPC1	101617201	101617243	0	43	5459	7493	5459	7450	0.0	0.732751677852349
chr12	MYBPC1	101682603	101682662	0	60	5459	7493	5459	7433	0.0	0.7344275528050586
chr12	MYBPC1	101684381	101684424	0	44	5459	7493	5459	7449	0.0	0.7328500469861726
chr12	CHPT1	101717236	101717394	0	159	2281	4140	2281	3981	0.0	0.5729716151720673
chr12	CHPT1	101719489	101719516	126	28	2281	4140	2155	4112	4.5	0.5240758754863813
chr12	PARPBP	102153868	102153989	3916	122	29611	4762	25695	4640	32.09836065573771	5.537715517241379
chr12	PARPBP	102164437	102164608	1108	172	29611	4762	28503	4590	6.441860465116279	6.209803921568628
chr12	TDG	103967853	103967971	0	119	0	4696	0	4577	0.0	0.0
chr12	TDG	103972959	103973033	0	75	0	4696	0	4621	0.0	0.0
chr12	TXNRD1	104289465	104289542	0	78	195270	6737	195270	6659	0.0	29.324222856284727
chr12	TXNRD1	104290992	104291104	0	113	195270	6737	195270	6624	0.0	29.479166666666668
chr12	TXNRD1	104309758	104310099	81	342	195270	6737	195189	6395	0.23684210526315788	30.522126661454262
chr12	TXNRD1	104288930	104289040	0	111	195270	6737	195270	6626	0.0	29.470268638696044
chr12	TXNRD1	104311289	104311412	0	124	195270	6737	195270	6613	0.0	29.52820202631181
chr12	TXNRD1	104309758	104309950	81	193	195270	6737	195189	6544	0.41968911917098445	29.827169926650367
chr12	RIC8B	106873031	106873174	0	144	1504	7787	1504	7643	0.0	0.19678136857255005
chr12	RIC8B	106874480	106874567	0	88	1504	7787	1504	7699	0.0	0.1953500454604494
chr12	ISCU	108567657	108567743	0	87	0	2718	0	2631	0.0	0.0
chr12	ISCU	108567919	108568016	0	98	0	2718	0	2620	0.0	0.0
chr12	ISCU	108567657	108567757	0	101	0	2718	0	2617	0.0	0.0
chr12	DAO	108887449	108887564	0	116	0	2970	0	2854	0.0	0.0
chr12	DAO	108889468	108889545	0	78	0	2970	0	2892	0.0	0.0
chr12	MVK	109579801	109579946	0	146	1020	6501	1020	6355	0.0	0.16050354051927615
chr12	MVK	109581394	109581550	0	157	1020	6501	1020	6344	0.0	0.16078184110970997
chr12	ANKRD13A	110021107	110021301	51	195	47958	6836	47907	6641	0.26153846153846155	7.213823219394669
chr12	ANKRD13A	110024045	110024112	0	68	47958	6836	47958	6768	0.0	7.085992907801418
chr12	TCTN1	110634395	110634463	0	69	6981	5815	6981	5746	0.0	1.2149321266968325
chr12	TCTN1	110634669	110634779	0	111	6981	5815	6981	5704	0.0	1.2238779803646564
chr12	TCTN1	110616276	110616352	0	77	6981	5815	6981	5738	0.0	1.216626002091321
chr12	TCTN1	110616720	110616904	0	185	6981	5815	6981	5630	0.0	1.2399644760213144
chr12	TCTN1	110616747	110616904	0	158	6981	5815	6981	5657	0.0	1.2340463143008662
chr12	ACAD10	111712497	111712657	0	161	51	8026	51	7865	0.0	0.006484424666242848
chr12	ACAD10	111715820	111715962	0	143	51	8026	51	7883	0.0	0.006469618165672967
chr12	ACAD10	111727961	111728143	0	183	51	8026	51	7843	0.0	0.006502613795741426
chr12	ACAD10	111729805	111729956	0	152	51	8026	51	7874	0.0	0.006477012954025908
chr12	RPH3A	112718005	112718087	0	83	103767	9716	103767	9633	0.0	10.772033634381813
chr12	RPH3A	112792142	112792263	0	122	103767	9716	103767	9594	0.0	10.815822388993121
chr12	RPH3A	112828300	112828389	0	90	103767	9716	103767	9626	0.0	10.77986702680241
chr12	RPH3A	112836490	112836502	0	13	103767	9716	103767	9703	0.0	10.694321343914254
chr12	RPH3A	112847695	112847842	0	148	103767	9716	103767	9568	0.0	10.845213210702342
chr12	AC026765.3	114749843	114750024	0	182	0	2312	0	2130	0.0	0.0
chr12	AC026765.3	114752899	114753011	0	113	0	2312	0	2199	0.0	0.0
chr12	RFC5	118017689	118017815	0	127	0	3264	0	3137	0.0	0.0
chr12	RFC5	118017994	118018053	0	60	0	3264	0	3204	0.0	0.0
chr12	RNF10	120566824	120566980	102	157	481108	5535	481006	5378	0.6496815286624203	89.43956861286723
chr12	RNF10	120571190	120571291	1224	102	481108	5535	479884	5433	12.0	88.32762746180747
chr12	RNF10	120574467	120574537	13682	71	481108	5535	467426	5464	192.70422535211267	85.54648609077599
chr12	ACADS	120737836	120737988	0	153	51	2400	51	2247	0.0	0.022696929238985315
chr12	ACADS	120738048	120738188	0	141	51	2400	51	2259	0.0	0.02257636122177955
chr12	HNF1A	120993519	120993706	0	188	191671	4197	191671	4009	0.0	47.810177101521575
chr12	HNF1A	120994163	120994405	0	243	191671	4197	191671	3954	0.0	48.47521497218007
chr12	HNF1A	120988832	120989032	0	201	191671	4197	191671	3996	0.0	47.96571571571572
chr12	P2RX7	121160901	121160974	15228	74	80309	5559	65081	5485	205.78378378378378	11.865268915223336
chr12	P2RX7	121162423	121162520	0	98	80309	5559	80309	5461	0.0	14.705914667643288
chr12	OGFOD2	122975810	122975867	0	58	44735	3734	44735	3676	0.0	12.169477693144723
chr12	OGFOD2	122976653	122976767	588	115	44735	3734	44147	3619	5.113043478260869	12.198673666758774
chr12	GTF2H3	123659429	123659475	0	47	9642	3941	9642	3894	0.0	2.4761171032357474
chr12	GTF2H3	123659515	123659584	0	70	9642	3941	9642	3871	0.0	2.490829243089641
chr12	AC007368.1	126225264	126225314	0	51	51	5841	51	5790	0.0	0.008808290155440414
chr12	AC007368.1	126350458	126350613	51	156	51	5841	0	5685	0.3269230769230769	0.0
chr12	LINC02347	126457932	126458541	0	610	0	5846	0	5236	0.0	0.0
chr12	LINC02347	126460882	126461000	0	119	0	5846	0	5727	0.0	0.0
chr12	LINC02347	126457932	126458130	0	199	0	5846	0	5647	0.0	0.0
chr12	LINC00943	126735184	126735249	0	66	0	8509	0	8443	0.0	0.0
chr12	LINC00943	126742739	126743480	0	742	0	8509	0	7767	0.0	0.0
chr12	AC078878.2	126876106	126876215	0	110	0	1291	0	1181	0.0	0.0
chr12	AC078878.2	126882562	126882703	0	142	0	1291	0	1149	0.0	0.0
chr12	LINC00507	127934289	127934349	0	61	0	6567	0	6506	0.0	0.0
chr12	LINC00507	127944717	127944799	0	83	0	6567	0	6484	0.0	0.0
chr12	LINC00507	127918915	127919115	0	201	0	6567	0	6366	0.0	0.0
chr12	LINC00507	127942381	127942980	0	600	0	6567	0	5967	0.0	0.0
chr12	LINC00507	127944717	127944787	0	71	0	6567	0	6496	0.0	0.0
chr12	LINC00507	127948823	127948958	0	136	0	6567	0	6431	0.0	0.0
chr12	LINC01257	131212204	131212286	0	83	0	4249	0	4166	0.0	0.0
chr12	LINC01257	131215406	131215548	0	143	0	4249	0	4106	0.0	0.0
chr12	PUS1	131932721	131932833	0	113	0	5331	0	5218	0.0	0.0
chr12	PUS1	131939172	131939275	0	104	0	5331	0	5227	0.0	0.0
chr12	EP400P1	132121689	132121765	0	77	0	11921	0	11844	0.0	0.0
chr12	EP400P1	132121924	132121980	0	57	0	11921	0	11864	0.0	0.0
chr12	P2RX2	132619438	132619574	810	137	35491	1867	34681	1730	5.912408759124087	20.046820809248555
chr12	P2RX2	132619843	132619919	238	77	35491	1867	35253	1790	3.090909090909091	19.69441340782123
chr12	ZNF140	133093414	133093505	0	92	1325	4746	1325	4654	0.0	0.2847013321873657
chr12	ZNF140	133100986	133101053	612	68	1325	4746	713	4678	9.0	0.15241556220607097
chr12	ZNF10	133130836	133131014	1974	179	40038	5508	38064	5329	11.027932960893855	7.142803527866391
chr12	ZNF10	133139198	133139249	0	52	40038	5508	40038	5456	0.0	7.338343108504398
chr12	ZNF268	133187871	133188072	0	202	564660	14004	564660	13802	0.0	40.91146210694102
chr12	ZNF268	133191907	133192003	0	97	564660	14004	564660	13907	0.0	40.602574243186886
chr12	ZNF268	133191488	133191615	0	128	564660	14004	564660	13876	0.0	40.69328336696454
chr12	AC005865.1	3306763	3306868	0	106	459	4670	459	4564	0.0	0.10056967572304995
chr12	AC005865.1	3307209	3307476	459	268	459	4670	0	4402	1.712686567164179	0.0
chr12	ANO2	5836777	5836780	0	4	0	5698	0	5694	0.0	0.0
chr12	ANO2	5851956	5851959	0	4	0	5698	0	5694	0.0	0.0
chr12	TNFRSF1A	6333736	6333865	0	130	41294	3562	41294	3432	0.0	12.032051282051283
chr12	TNFRSF1A	6334090	6334244	0	155	41294	3562	41294	3407	0.0	12.120340475491634
chr12	CD27-AS1	6448639	6448757	71	119	421931	3028	421860	2909	0.5966386554621849	145.01890684083878
chr12	CD27-AS1	6450340	6450980	45209	641	421931	3028	376722	2387	70.52886115444618	157.82237117720987
chr12	ING4	6653229	6653396	0	168	435	2186	435	2018	0.0	0.2155599603567889
chr12	ING4	6656726	6656798	0	73	435	2186	435	2113	0.0	0.2058684335068623
chr12	LPCAT3	6981003	6981182	4801	180	4462196	4160	4457395	3980	26.67222222222222	1119.9484924623116
chr12	LPCAT3	6981594	6981632	451	39	4462196	4160	4461745	4121	11.564102564102564	1082.685027905848
chr12	CLEC4C	7741420	7741531	0	112	0	1574	0	1462	0.0	0.0
chr12	CLEC4C	7746330	7746423	0	94	0	1574	0	1480	0.0	0.0
chr12	SLC2A14	7839716	7839920	0	205	64	5594	64	5389	0.0	0.011876043792911486
chr12	SLC2A14	7863368	7863457	0	90	64	5594	64	5504	0.0	0.011627906976744186
chr12	M6PR	8942415	8942542	0	128	612	2693	612	2565	0.0	0.23859649122807017
chr12	M6PR	8943800	8943910	0	111	612	2693	612	2582	0.0	0.2370255615801704
chr12	OLR1	10160346	10160462	0	117	0	1852	0	1735	0.0	0.0
chr12	OLR1	10160785	10160925	0	141	0	1852	0	1711	0.0	0.0
chr12	KLRC4-KLRK1	10393809	10393867	0	59	11309	2526	11309	2467	0.0	4.584110255370896
chr12	KLRC4-KLRK1	10405849	10405950	0	102	11309	2526	11309	2424	0.0	4.66542904290429
chr12	KLRC4-KLRK1	10391834	10391891	0	58	11309	2526	11309	2468	0.0	4.582252836304701
chr12	KLRC2	10434485	10434530	0	46	0	1510	0	1464	0.0	0.0
chr12	KLRC2	10434994	10435039	0	46	0	1510	0	1464	0.0	0.0
chr12	STYK1	10637070	10637196	0	127	0	3454	0	3327	0.0	0.0
chr12	STYK1	10667288	10667455	0	168	0	3454	0	3286	0.0	0.0
chr12	EPS8	15713265	15713325	0	61	3754	8578	3754	8517	0.0	0.44076552776799344
chr12	EPS8	15787962	15788010	0	49	3754	8578	3754	8529	0.0	0.4401453863289952
chr12	EPS8	15684196	15684302	0	107	3754	8578	3754	8471	0.0	0.4431590131035297
chr12	EPS8	15684168	15684302	0	135	3754	8578	3754	8443	0.0	0.44462868648584625
chr12	PLCZ1	18713736	18713825	0	90	0	2968	0	2878	0.0	0.0
chr12	PLCZ1	18719430	18719632	0	203	0	2968	0	2765	0.0	0.0
chr12	SLCO1A2	21314548	21314681	0	134	0	11312	0	11178	0.0	0.0
chr12	SLCO1A2	21318781	21318923	0	143	0	11312	0	11169	0.0	0.0
chr12	C2CD5	22517985	22518137	0	153	0	6790	0	6637	0.0	0.0
chr12	C2CD5	22519114	22519239	0	126	0	6790	0	6664	0.0	0.0
chr12	CFAP94	25158471	25158563	0	93	68	3013	68	2920	0.0	0.023287671232876714
chr12	CFAP94	25161112	25161197	0	86	68	3013	68	2927	0.0	0.023231978134608814
chr12	CFAP94	25190613	25190631	0	19	68	3013	68	2994	0.0	0.022712090848363394
chr12	CFAP94	25192693	25192826	0	134	68	3013	68	2879	0.0	0.023619312261201807
chr12	INTS13	26914407	26914532	0	126	81	3078	81	2952	0.0	0.027439024390243903
chr12	INTS13	26916001	26916180	0	180	81	3078	81	2898	0.0	0.027950310559006212
chr12	ERGIC2	29372463	29372520	0	58	663	5842	663	5784	0.0	0.1146265560165975
chr12	ERGIC2	29372854	29372967	0	114	663	5842	663	5728	0.0	0.11574720670391062
chr12	CAPRIN2	30719078	30719225	0	148	204	8052	204	7904	0.0	0.025809716599190284
chr12	CAPRIN2	30720810	30720915	0	106	204	8052	204	7946	0.0	0.025673294739491568
chr12	DENND5B	31499605	31499671	0	67	6112	11371	6112	11304	0.0	0.5406935598018401
chr12	DENND5B	31540919	31541031	0	113	6112	11371	6112	11258	0.0	0.542902824658021
chr12	KIF21A	39315931	39315970	0	40	12	10156	12	10116	0.0	0.0011862396204033216
chr12	KIF21A	39318072	39318201	0	130	12	10156	12	10026	0.0	0.0011968880909634949
chr12	YAF2	42199135	42199235	0	101	0	6459	0	6358	0.0	0.0
chr12	YAF2	42210547	42210619	0	73	0	6459	0	6386	0.0	0.0
chr12	PRICKLE1	42550207	42550329	0	123	2753	8022	2753	7899	0.0	0.34852512976326117
chr12	PRICKLE1	42584358	42584480	0	123	2753	8022	2753	7899	0.0	0.34852512976326117
chr12	TWF1	43805523	43805637	0	115	0	3656	0	3541	0.0	0.0
chr12	TWF1	43805830	43805885	0	56	0	3656	0	3600	0.0	0.0
chr12	TWF1	43805830	43806002	0	173	0	3656	0	3483	0.0	0.0
chr12	SLC38A4	46803602	46803794	0	193	212883	2622	212883	2429	0.0	87.64223960477563
chr12	SLC38A4	46824305	46824385	0	81	212883	2622	212883	2541	0.0	83.77922077922078
chr12	PCED1B-AS1	47206510	47206588	0	79	0	1838	0	1759	0.0	0.0
chr12	PCED1B-AS1	47209280	47209482	0	203	0	1838	0	1635	0.0	0.0
chr12	VDR	47882693	47882774	0	82	153	5295	153	5213	0.0	0.029349702666410897
chr12	VDR	47899836	47899958	0	123	153	5295	153	5172	0.0	0.029582366589327145
chr12	SENP1	48099061	48099154	108	94	1493	5824	1385	5730	1.148936170212766	0.24171029668411867
chr12	SENP1	48101468	48101516	0	49	1493	5824	1493	5775	0.0	0.25852813852813855
chr12	KANSL2	48660365	48660619	0	255	0	3188	0	2933	0.0	0.0
chr12	KANSL2	48662559	48662654	0	96	0	3188	0	3092	0.0	0.0
chr12	KANSL2	48660467	48660619	0	153	0	3188	0	3035	0.0	0.0
chr12	PRKAG1	49005667	49005742	0	76	51	3614	51	3538	0.0	0.014414923685698135
chr12	PRKAG1	49005742	49005852	0	111	51	3614	51	3503	0.0	0.014558949471881244
chr12	PRKAG1	49005742	49005881	0	140	51	3614	51	3474	0.0	0.01468048359240069
chr12	PRKAG1	49016606	49016839	0	234	51	3614	51	3380	0.0	0.015088757396449704
chr12	PRKAG1	49017156	49017550	0	395	51	3614	51	3219	0.0	0.015843429636533086
chr12	LMBR1L	49104745	49104885	36	141	5090	4888	5054	4747	0.2553191489361702	1.0646724246892774
chr12	LMBR1L	49106960	49107045	0	86	5090	4888	5090	4802	0.0	1.0599750104123282
chr12	RACGAP1	50018515	50018589	0	75	20521	4511	20521	4436	0.0	4.626014427412083
chr12	RACGAP1	50019743	50019806	0	64	20521	4511	20521	4447	0.0	4.614571621317742
chr12	RACGAP1	50006433	50006636	452	204	20521	4511	20069	4307	2.215686274509804	4.659623868121662
chr12	RACGAP1	50016630	50016719	0	90	20521	4511	20521	4421	0.0	4.641710020357385
chr12	RACGAP1	50021061	50021177	153	117	20521	4511	20368	4394	1.3076923076923077	4.635411925352754
chr12	CERS5	50144768	50144969	243	202	7353	5888	7110	5686	1.202970297029703	1.2504396763981709
chr12	CERS5	50154227	50154320	5	94	7353	5888	7348	5794	0.05319148936170213	1.2682084915429754
chr12	CERS5	50153828	50153951	0	124	7353	5888	7353	5764	0.0	1.275676613462873
chr12	CERS5	50148471	50148588	0	118	7353	5888	7353	5770	0.0	1.2743500866551127
chr12	CERS5	50165821	50165943	0	123	7353	5888	7353	5765	0.0	1.275455333911535
chr12	SLC11A2	51008475	51008544	0	70	2170	9310	2170	9240	0.0	0.23484848484848486
chr12	SLC11A2	51008585	51008624	0	40	2170	9310	2170	9270	0.0	0.23408845738942827
chr12	SMAGP	51251464	51251583	0	120	51	2875	51	2755	0.0	0.018511796733212342
chr12	SMAGP	51253573	51253593	0	21	51	2875	51	2854	0.0	0.017869656622284513
chr12	KRT4	52811762	52811977	0	216	0	2886	0	2670	0.0	0.0
chr12	KRT4	52813596	52813728	0	133	0	2886	0	2753	0.0	0.0
chr12	AC068888.1	53043097	53043147	0	51	0	5374	0	5323	0.0	0.0
chr12	AC068888.1	53045064	53045186	0	123	0	5374	0	5251	0.0	0.0
chr12	CSAD	53179620	53179666	0	47	0	4328	0	4281	0.0	0.0
chr12	CSAD	53179776	53180012	0	237	0	4328	0	4091	0.0	0.0
chr12	CSAD	53173727	53173767	0	41	0	4328	0	4287	0.0	0.0
chr12	CSAD	53179772	53180012	0	241	0	4328	0	4087	0.0	0.0
chr12	ITGB7	53200242	53200446	0	205	0	4220	0	4015	0.0	0.0
chr12	ITGB7	53201071	53201194	0	124	0	4220	0	4096	0.0	0.0
chr12	CALCOCO1	53725689	53725759	0	71	142072	7583	142072	7512	0.0	18.912673056443026
chr12	CALCOCO1	53726243	53726334	0	92	142072	7583	142072	7491	0.0	18.96569216393005
chr12	SMUG1	54187818	54187905	0	88	0	4520	0	4432	0.0	0.0
chr12	SMUG1	54188514	54188596	0	83	0	4520	0	4437	0.0	0.0
chr12	SMUG1	54186846	54187011	0	166	0	4520	0	4354	0.0	0.0
chr12	ITGA5	54409484	54409597	643	114	428189	7121	427546	7007	5.640350877192983	61.01698301698302
chr12	ITGA5	54411833	54411964	62	132	428189	7121	428127	6989	0.4696969696969697	61.25726141078838
chr12	PPP1R1A	54581975	54582131	2566	157	162541	2983	159975	2826	16.343949044585987	56.60828025477707
chr12	PPP1R1A	54582731	54582795	759	65	162541	2983	161782	2918	11.676923076923076	55.44276901987663
chr12	ITGA7	55699869	55699989	0	121	64	6257	64	6136	0.0	0.010430247718383311
chr12	ITGA7	55700261	55700393	0	133	64	6257	64	6124	0.0	0.010450685826257348
chr12	MMP19	55839495	55839741	0	247	0	4340	0	4093	0.0	0.0
chr12	MMP19	55840666	55840882	0	217	0	4340	0	4123	0.0	0.0
chr12	PMEL	55955778	55955863	0	86	180	3339	180	3253	0.0	0.05533353827236397
chr12	PMEL	55956948	55957671	51	724	180	3339	129	2615	0.07044198895027624	0.04933078393881453
chr12	PMEL	55961316	55961463	0	148	180	3339	180	3191	0.0	0.05640864932623002
chr12	PMEL	55961621	55961732	0	112	180	3339	180	3227	0.0	0.05577936163619461
chr12	CS	56291219	56291306	0	88	198	5231	198	5143	0.0	0.03849893058526152
chr12	CS	56298608	56298691	0	84	198	5231	198	5147	0.0	0.03846901107441228
chr12	CS	56291630	56291793	0	164	198	5231	198	5067	0.0	0.03907637655417407
chr12	CS	56283791	56283857	0	67	198	5231	198	5164	0.0	0.0383423702556158
chr12	CS	56285915	56286023	0	109	198	5231	198	5122	0.0	0.038656774697383836
chr12	PTGES3	56670274	56670364	0	91	1252079	3408	1252079	3317	0.0	377.4733192643955
chr12	PTGES3	56671748	56671847	420	100	1252079	3408	1251659	3308	4.2	378.37333736396613
chr12	PTGES3	56671748	56671809	420	62	1252079	3408	1251659	3346	6.774193548387097	374.0762104004782
chr12	PTGES3	56672739	56672809	0	71	1252079	3408	1252079	3337	0.0	375.2109679352712
chr12	PTGES3	56666203	56666266	202467	64	1252079	3408	1049612	3344	3163.546875	313.8791866028708
chr12	NACA	56715870	56716110	6302	241	95495	7785	89193	7544	26.149377593360995	11.823038176033934
chr12	NACA	56719536	56719596	255	61	95495	7785	95240	7724	4.180327868852459	12.330398757120664
chr12	STAT6	57107604	57107743	1791	140	416367	7192	414576	7052	12.792857142857143	58.78842881452071
chr12	STAT6	57108162	57108299	280612	138	416367	7192	135755	7054	2033.4202898550725	19.24510915792458
chr12	R3HDM2	57289008	57289040	0	33	1142	5933	1142	5900	0.0	0.1935593220338983
chr12	R3HDM2	57292571	57292667	0	97	1142	5933	1142	5836	0.0	0.19568197395476353
chr12	ARHGAP9	57473602	57473708	0	107	36177	4871	36177	4764	0.0	7.593828715365239
chr12	ARHGAP9	57474041	57474176	23	136	36177	4871	36154	4735	0.16911764705882354	7.635480464625132
chr12	ARHGAP9	57474422	57474476	0	55	36177	4871	36177	4816	0.0	7.5118355481727574
chr12	DCTN2	57538252	57538347	0	96	34174	6940	34174	6844	0.0	4.9932787843366455
chr12	DCTN2	57538518	57538524	0	7	34174	6940	34174	6933	0.0	4.929179287465743
chr12	CDK4	57750441	57750563	239	123	2680	2948	2441	2825	1.943089430894309	0.864070796460177
chr12	CDK4	57750655	57750765	0	111	2680	2948	2680	2837	0.0	0.9446598519562919
chr12	CDK4	57751206	57751342	110	137	2680	2948	2570	2811	0.8029197080291971	0.9142653859836357
chr12	CDK4	57751499	57751736	2293	238	2680	2948	387	2710	9.634453781512605	0.14280442804428045
chr12	METTL1	57769771	57769956	153	186	1054	1954	901	1768	0.8225806451612904	0.5096153846153846
chr12	METTL1	57771093	57771257	102	165	1054	1954	952	1789	0.6181818181818182	0.5321408608160983
chr12	AC083805.1	57872852	57872976	0	125	165128	5555	165128	5430	0.0	30.410313075506444
chr12	AC083805.1	57886527	57886696	199	170	165128	5555	164929	5385	1.1705882352941177	30.627483751160632
chr12	TMBIM4	66160164	66160305	0	142	153	2161	153	2019	0.0	0.07578008915304606
chr12	TMBIM4	66168914	66169353	0	440	153	2161	153	1721	0.0	0.08890180127832656
chr12	TMBIM4	66169289	66169353	0	65	153	2161	153	2096	0.0	0.07299618320610687
chr12	GRIP1	66456186	66456342	0	157	4528	6603	4528	6446	0.0	0.7024511324852621
chr12	GRIP1	66462923	66463093	0	171	4528	6603	4528	6432	0.0	0.7039800995024875
chr12	MDM1	68325440	68325575	0	136	104	5181	104	5045	0.0	0.020614469772051537
chr12	MDM1	68326656	68327021	0	366	104	5181	104	4815	0.0	0.021599169262720666
chr12	PRANCR	70229851	70230018	0	168	1341	5036	1341	4868	0.0	0.2754724732949877
chr12	PRANCR	70242180	70242229	0	50	1341	5036	1341	4986	0.0	0.26895306859205775
chr12	TRHDE-AS1	72259385	72259540	0	156	591	8148	591	7992	0.0	0.07394894894894895
chr12	TRHDE-AS1	72264481	72264621	0	141	591	8148	591	8007	0.0	0.07381041588609966
chr12	TRHDE-AS1	72261197	72264621	612	3425	591	8148	-21	4723	0.17868613138686132	-0.004446326487402075
chr12	TRHDE-AS1	72264481	72264616	0	136	591	8148	591	8012	0.0	0.0737643534697953
chr12	LINC02882	74321534	74321694	0	161	4	8438	4	8277	0.0	0.00048326688413676455
chr12	LINC02882	74339664	74339795	0	132	4	8438	4	8306	0.0	0.0004815795810257645
chr12	LINC02882	74325997	74326171	0	175	4	8438	4	8263	0.0	0.00048408568316592036
chr12	LINC02882	74332233	74332395	0	163	4	8438	4	8275	0.0	0.00048338368580060423
chr12	LINC02882	74377562	74377632	4	71	4	8438	0	8367	0.056338028169014086	0.0
chr12	LINC02882	74402003	74402137	0	135	4	8438	4	8303	0.0	0.0004817535830422739
chr12	KCNC2	75042279	75042374	0	96	204	5547	204	5451	0.0	0.03742432581177765
chr12	KCNC2	75048152	75048317	0	166	204	5547	204	5381	0.0	0.037911168927708606
chr12	CAPS2	75323176	75323222	0	47	21	6680	21	6633	0.0	0.003165988240615106
chr12	CAPS2	75371078	75371482	0	405	21	6680	21	6275	0.0	0.003346613545816733
chr12	NAP1L1	76056573	76056672	0	100	0	4739	0	4639	0.0	0.0
chr12	NAP1L1	76059797	76059878	0	82	0	4739	0	4657	0.0	0.0
chr12	NAP1L1	76067370	76067473	0	104	0	4739	0	4635	0.0	0.0
chr12	NAP1L1	76074202	76074239	0	38	0	4739	0	4701	0.0	0.0
chr12	NAP1L1	76068908	76068994	0	87	0	4739	0	4652	0.0	0.0
chr12	NAP1L1	76059776	76059878	0	103	0	4739	0	4636	0.0	0.0
chr12	PPP1R12A	79805591	79805768	0	178	7802	10162	7802	9984	0.0	0.7814503205128205
chr12	PPP1R12A	79806165	79806333	0	169	7802	10162	7802	9993	0.0	0.780746522565796
chr12	TSPAN19	85024651	85024772	0	122	0	1576	0	1454	0.0	0.0
chr12	TSPAN19	85027898	85028023	0	126	0	1576	0	1450	0.0	0.0
chr12	MGAT4C	86022448	86022544	0	97	0	3695	0	3598	0.0	0.0
chr12	MGAT4C	86028087	86028207	0	121	0	3695	0	3574	0.0	0.0
chr12	MGAT4C	86028103	86028204	0	102	0	3695	0	3593	0.0	0.0
chr12	CEP290	88059897	88060020	0	124	102	21189	102	21065	0.0	0.004842155233800142
chr12	CEP290	88060829	88060994	0	166	102	21189	102	21023	0.0	0.004851828949246064
chr12	CEP290	88130544	88130565	0	22	102	21189	102	21167	0.0	0.004818821750838569
chr12	CEP290	88131164	88131218	0	55	102	21189	102	21134	0.0	0.004826346172045046
chr12	CEP290	88115477	88115570	0	94	102	21189	102	21095	0.0	0.004835269021095046
chr12	CEP290	88115765	88116533	0	769	102	21189	102	20420	0.0	0.004995102840352595
chr12	LINC01619	91987555	91987643	0	89	0	4212	0	4123	0.0	0.0
chr12	LINC01619	91987643	91987794	0	152	0	4212	0	4060	0.0	0.0
chr12	LINC01619	91987532	91987643	0	112	0	4212	0	4100	0.0	0.0
chr12	NR2C1	95031348	95031488	0	141	0	5319	0	5178	0.0	0.0
chr12	NR2C1	95040475	95040597	0	123	0	5319	0	5196	0.0	0.0
chr12	AC084879.1	95377234	95377369	0	136	15392	3186	15392	3050	0.0	5.04655737704918
chr12	AC084879.1	95380857	95380958	0	102	15392	3186	15392	3084	0.0	4.990920881971466
chr12	HAL	95993643	95993674	0	32	104	5065	104	5033	0.0	0.020663620107291874
chr12	HAL	95993771	95993838	0	68	104	5065	104	4997	0.0	0.020812487492495497
chr12	ANKS1B	98781489	98781498	0	10	630	9547	630	9537	0.0	0.06605850896508336
chr12	ANKS1B	98782125	98782137	0	13	630	9547	630	9534	0.0	0.06607929515418502
chr12	ANKS1B	98807843	98807915	0	73	630	9547	630	9474	0.0	0.06649778340721976
chr12	ANKS1B	98829173	98829353	0	181	630	9547	630	9366	0.0	0.06726457399103139
chr12	ANKS1B	98807843	98807918	0	76	630	9547	630	9471	0.0	0.06651884700665188
chr12	ANKS1B	98832028	98832136	0	109	630	9547	630	9438	0.0	0.06675143038779402
chr12	WASHC3	102017719	102017805	0	87	0	2668	0	2581	0.0	0.0
chr12	WASHC3	102019276	102019371	0	96	0	2668	0	2572	0.0	0.0
chr12	WASHC3	102048289	102048397	0	109	0	2668	0	2559	0.0	0.0
chr12	WASHC3	102050188	102050291	0	104	0	2668	0	2564	0.0	0.0
chr12	WASHC3	102050517	102050639	0	123	0	2668	0	2545	0.0	0.0
chr12	TTC41P	103883603	103883814	0	212	0	5454	0	5242	0.0	0.0
chr12	TTC41P	103885867	103885943	0	77	0	5454	0	5377	0.0	0.0
chr12	C12ORF73	103953413	103953534	0	122	0	2983	0	2861	0.0	0.0
chr12	C12ORF73	103956630	103956748	0	119	0	2983	0	2864	0.0	0.0
chr12	CMKLR1	108293588	108293664	0	77	0	5672	0	5595	0.0	0.0
chr12	CMKLR1	108329994	108330207	0	214	0	5672	0	5458	0.0	0.0
chr12	KCTD10	109457991	109458078	0	88	0	7167	0	7079	0.0	0.0
chr12	KCTD10	109460635	109460805	0	171	0	7167	0	6996	0.0	0.0
chr12	GIT2	109965759	109965765	57	7	29637	13482	29580	13475	8.142857142857142	2.1951762523191096
chr12	GIT2	109967313	109967319	0	7	29637	13482	29637	13475	0.0	2.1994063079777364
chr12	GIT2	109947255	109947504	6652	250	29637	13482	22985	13232	26.608	1.737076783555018
chr12	GIT2	109951211	109951316	0	106	29637	13482	29637	13376	0.0	2.21568480861244
chr12	VPS29	110498819	110498859	0	41	502	3202	502	3161	0.0	0.15881050300537805
chr12	VPS29	110499534	110499546	0	13	502	3202	502	3189	0.0	0.15741611790529947
chr12	VPS29	110499456	110499546	246	91	502	3202	256	3111	2.7032967032967035	0.0822886531661845
chr12	ATXN2	111461138	111461305	0	168	0	13978	0	13810	0.0	0.0
chr12	ATXN2	111464661	111464715	0	55	0	13978	0	13923	0.0	0.0
chr12	ATXN2	111479069	111479102	0	34	0	13978	0	13944	0.0	0.0
chr12	ATXN2	111482786	111482831	0	46	0	13978	0	13932	0.0	0.0
chr12	TMEM116	111943264	111943369	0	106	2696	5425	2696	5319	0.0	0.50686219214138
chr12	TMEM116	111965594	111965759	510	166	2696	5425	2186	5259	3.072289156626506	0.4156683780186347
chr12	TAOK3	118295239	118295381	0	143	551	9442	551	9299	0.0	0.05925368319174105
chr12	TAOK3	118296941	118297163	0	223	551	9442	551	9219	0.0	0.05976787070181148
chr12	RPLP0	120198553	120198739	0	187	5008	2408	5008	2221	0.0	2.254840162089149
chr12	RPLP0	120198853	120199000	526	148	5008	2408	4482	2260	3.554054054054054	1.9831858407079646
chr12	COQ5	120516566	120516788	0	223	38542	2512	38542	2289	0.0	16.837920489296636
chr12	COQ5	120522213	120522363	124	151	38542	2512	38418	2361	0.8211920529801324	16.27191867852605
chr12	DIABLO	122218265	122218397	9815	133	88805	5932	78990	5799	73.796992481203	13.621314019658563
chr12	DIABLO	122224511	122224644	612	134	88805	5932	88193	5798	4.567164179104478	15.21093480510521
chr12	DIABLO	122224644	122224748	0	105	88805	5932	88805	5827	0.0	15.240260854642182
chr12	VPS33A	122264711	122264804	0	94	23099	5708	23099	5614	0.0	4.114535090844318
chr12	VPS33A	122265635	122265725	5703	91	23099	5708	17396	5617	62.67032967032967	3.0970268826775857
chr12	ABCB9	122940806	122940995	0	190	36075	13134	36075	12944	0.0	2.787005562422744
chr12	ABCB9	122944390	122944519	0	130	36075	13134	36075	13004	0.0	2.7741464164872345
chr12	MPHOSPH9	123223037	123223127	0	91	13302	8436	13302	8345	0.0	1.594008388256441
chr12	MPHOSPH9	123227462	123227616	0	155	13302	8436	13302	8281	0.0	1.60632773819587
chr12	MPHOSPH9	123202623	123203084	1122	462	13302	8436	12180	7974	2.4285714285714284	1.527464258841234
chr12	MPHOSPH9	123203113	123203375	0	263	13302	8436	13302	8173	0.0	1.6275541416860393
chr12	CCDC92	123944271	123944364	898	94	12908	6039	12010	5945	9.553191489361701	2.0201850294365014
chr12	CCDC92	123956283	123956444	7733	162	12908	6039	5175	5877	47.73456790123457	0.8805513016845329
chr12	LINC00944	126747930	126748127	0	198	0	4790	0	4592	0.0	0.0
chr12	LINC00944	126770192	126770254	0	63	0	4790	0	4727	0.0	0.0
chr12	LINC00944	126760931	126761057	0	127	0	4790	0	4663	0.0	0.0
chr12	LINC00944	126763414	126763498	0	85	0	4790	0	4705	0.0	0.0
chr12	LINC02405	126923029	126923205	0	177	0	7641	0	7464	0.0	0.0
chr12	LINC02405	126975838	126975917	0	80	0	7641	0	7561	0.0	0.0
chr12	CHFR	132862332	132862425	0	94	0	16627	0	16533	0.0	0.0
chr12	CHFR	132869618	132869798	0	181	0	16627	0	16446	0.0	0.0
chr12	CHFR	132848084	132848155	0	72	0	16627	0	16555	0.0	0.0
chr12	CHFR	132848181	132848257	0	77	0	16627	0	16550	0.0	0.0
chr12	CHFR	132869618	132869834	0	217	0	16627	0	16410	0.0	0.0
chr13	TPTE2	19425706	19425833	0	128	1636	2310	1636	2182	0.0	0.7497708524289642
chr13	TPTE2	19426424	19426517	0	94	1636	2310	1636	2216	0.0	0.7382671480144405
chr13	TPTE2	19473913	19474075	0	163	1636	2310	1636	2147	0.0	0.7619934792734048
chr13	TPTE2	19482487	19482547	0	61	1636	2310	1636	2249	0.0	0.727434415295687
chr13	GJB6	20230697	20230807	0	111	24488	3279	24488	3168	0.0	7.72979797979798
chr13	GJB6	20230865	20231061	384	197	24488	3279	24104	3082	1.9492385786802031	7.82089552238806
chr13	GJB6	20230697	20230813	0	117	24488	3279	24488	3162	0.0	7.744465528146742
chr13	GJB6	20230741	20230813	0	73	24488	3279	24488	3206	0.0	7.638178415470992
chr13	CRYL1	20513450	20513681	0	232	5210	4343	5210	4111	0.0	1.267331549501338
chr13	CRYL1	20515720	20515820	0	101	5210	4343	5210	4242	0.0	1.2281942479962282
chr13	N4BP2L1	32404202	32404271	0	70	0	5266	0	5196	0.0	0.0
chr13	N4BP2L1	32404320	32404397	0	78	0	5266	0	5188	0.0	0.0
chr13	N4BP2L2	32537005	32537027	0	23	102	10496	102	10473	0.0	0.0097393297049556
chr13	N4BP2L2	32538617	32538684	0	68	102	10496	102	10428	0.0	0.009781357882623706
chr13	N4BP2L2	32535768	32537027	0	1260	102	10496	102	9236	0.0	0.01104374187960156
chr13	N4BP2L2	32527407	32527532	0	126	102	10496	102	10370	0.0	0.009836065573770493
chr13	N4BP2L2	32536932	32537027	0	96	102	10496	102	10400	0.0	0.009807692307692307
chr13	N4BP2L2	32521372	32521449	0	78	102	10496	102	10418	0.0	0.009790746784411596
chr13	TRPC4	37691998	37692335	0	338	364	3351	364	3013	0.0	0.1208098240955858
chr13	TRPC4	37745936	37746455	0	520	364	3351	364	2831	0.0	0.12857647474390674
chr13	LINC00598	40466506	40466677	0	172	8794	19717	8794	19545	0.0	0.4499360450243029
chr13	LINC00598	40469995	40470162	0	168	8794	19717	8794	19549	0.0	0.4498439817893498
chr13	TPTE2P5	40855754	40855815	0	62	0	2529	0	2467	0.0	0.0
chr13	TPTE2P5	40908158	40908212	0	55	0	2529	0	2474	0.0	0.0
chr13	MTRF1	41262047	41262331	51	285	88	3854	37	3569	0.17894736842105263	0.010367049593723731
chr13	MTRF1	41262410	41262481	37	72	88	3854	51	3782	0.5138888888888888	0.013484928609201481
chr13	SLC25A30	45408926	45409074	0	149	0	5015	0	4866	0.0	0.0
chr13	SLC25A30	45411361	45411480	0	120	0	5015	0	4895	0.0	0.0
chr13	RUBCNL	46371940	46372078	0	139	252	15943	252	15804	0.0	0.015945330296127564
chr13	RUBCNL	46377889	46378005	0	117	252	15943	252	15826	0.0	0.01592316441299128
chr13	RUBCNL	46371940	46372597	0	658	252	15943	252	15285	0.0	0.01648675171736997
chr13	RUBCNL	46371940	46372210	0	271	252	15943	252	15672	0.0	0.016079632465543645
chr13	SUCLA2	47956839	47956878	0	40	103	8002	103	7962	0.0	0.012936448128610901
chr13	SUCLA2	47965577	47965640	0	64	103	8002	103	7938	0.0	0.012975560594608214
chr13	EBPL	49663056	49663195	15	140	199	1567	184	1427	0.10714285714285714	0.1289418360196216
chr13	EBPL	49669776	49669846	0	71	199	1567	199	1496	0.0	0.13302139037433156
chr13	DLEU2	50070581	50070641	0	61	20270	11660	20270	11599	0.0	1.7475644452107941
chr13	DLEU2	50071515	50071629	18	115	20270	11660	20252	11545	0.1565217391304348	1.7541792983975748
chr13	RNASEH2B-AS1	50889608	50889735	0	128	1326	7830	1326	7702	0.0	0.1721630745260971
chr13	RNASEH2B-AS1	50904720	50904863	0	144	1326	7830	1326	7686	0.0	0.1725214676034348
chr13	ATP7B	51944108	51944291	0	184	102820	13652	102820	13468	0.0	7.6343926343926345
chr13	ATP7B	51946283	51946478	0	196	102820	13652	102820	13456	0.0	7.641200951248513
chr13	ATP7B	51958310	51958544	0	235	102820	13652	102820	13417	0.0	7.6634120891406425
chr13	ATP7B	51960147	51960322	409	176	102820	13652	102411	13476	2.3238636363636362	7.599510240427427
chr13	ATP7B	51949661	51949796	146	136	102820	13652	102674	13516	1.0735294117647058	7.596478248002367
chr13	MRPS31P5	52183975	52184114	0	140	1956	3514	1956	3374	0.0	0.5797273266152935
chr13	MRPS31P5	52184272	52184408	204	137	1956	3514	1752	3377	1.489051094890511	0.5188036718981345
chr13	DIAPH3	60093627	60093732	0	106	0	7262	0	7156	0.0	0.0
chr13	DIAPH3	60112009	60112186	0	178	0	7262	0	7084	0.0	0.0
chr13	LINC00448	62733046	62733146	0	101	0	1274	0	1173	0.0	0.0
chr13	LINC00448	62740300	62740460	0	161	0	1274	0	1113	0.0	0.0
chr13	DIS3	72780845	72781003	0	159	0	3982	0	3823	0.0	0.0
chr13	DIS3	72781288	72781356	0	69	0	3982	0	3913	0.0	0.0
chr13	LINC00331	78792353	78792492	0	140	0	1833	0	1693	0.0	0.0
chr13	LINC00331	78824743	78824856	0	114	0	1833	0	1719	0.0	0.0
chr13	LINC00331	78795974	78796099	0	126	0	1833	0	1707	0.0	0.0
chr13	LINC00331	78792160	78792302	0	143	0	1833	0	1690	0.0	0.0
chr13	MIR4500HG	87619262	87619393	0	132	0	16086	0	15954	0.0	0.0
chr13	MIR4500HG	87621007	87621158	0	152	0	16086	0	15934	0.0	0.0
chr13	ABCC4	95266098	95266264	325	167	33188	8667	32863	8500	1.9461077844311376	3.866235294117647
chr13	ABCC4	95269309	95269422	590	114	33188	8667	32598	8553	5.175438596491228	3.811294282707822
chr13	ABCC4	95266111	95266264	301	154	33188	8667	32887	8513	1.9545454545454546	3.8631504757429815
chr13	DOCK9	98845328	98845372	0	45	4962	10506	4962	10461	0.0	0.4743332377401778
chr13	DOCK9	98845923	98845991	0	69	4962	10506	4962	10437	0.0	0.47542397240586376
chr13	DOCK9	98845923	98846060	0	138	4962	10506	4962	10368	0.0	0.47858796296296297
chr13	CARS2	110688784	110688904	0	121	51	8121	51	8000	0.0	0.006375
chr13	CARS2	110697917	110697967	0	51	51	8121	51	8070	0.0	0.006319702602230483
chr13	ANKRD10	110894108	110894202	96	95	504	4241	408	4146	1.0105263157894737	0.09840810419681621
chr13	ANKRD10	110900529	110900661	0	133	504	4241	504	4108	0.0	0.12268743914313535
chr13	PCID2	113185484	113185560	384	77	10874	4056	10490	3979	4.987012987012987	2.636340789143001
chr13	PCID2	113190871	113190975	153	105	10874	4056	10721	3951	1.457142857142857	2.7134902556314855
chr13	LINC00408	18907634	18907802	0	169	0	2363	0	2194	0.0	0.0
chr13	LINC00408	18908969	18909086	0	118	0	2363	0	2245	0.0	0.0
chr13	LINC00408	18907634	18907817	0	184	0	2363	0	2179	0.0	0.0
chr13	ZMYM2	19965219	19965281	0	63	70	12671	70	12608	0.0	0.005552030456852792
chr13	ZMYM2	19970024	19970071	0	48	70	12671	70	12623	0.0	0.005545432939871663
chr13	WASF3	26676548	26676724	0	177	66	5194	66	5017	0.0	0.013155272074945186
chr13	WASF3	26680034	26680201	0	168	66	5194	66	5026	0.0	0.013131715081575806
chr13	STARD13-AS	33272605	33272894	102	290	11189	3839	11087	3549	0.35172413793103446	3.123978585517047
chr13	STARD13-AS	33273935	33274058	3431	124	11189	3839	7758	3715	27.669354838709676	2.0882907133243607
chr13	STARD13-AS	33275686	33275850	767	165	11189	3839	10422	3674	4.648484848484848	2.8366902558519325
chr13	STARD13-AS	33276076	33276189	0	114	11189	3839	11189	3725	0.0	3.003758389261745
chr13	STARD13-AS	33276670	33276747	306	78	11189	3839	10883	3761	3.923076923076923	2.8936453070991757
chr13	STARD13-AS	33279532	33279656	0	125	11189	3839	11189	3714	0.0	3.012654819601508
chr13	STARD13-AS	33279896	33280076	0	181	11189	3839	11189	3658	0.0	3.0587752870420997
chr13	STARD13-AS	33279460	33279656	26	197	11189	3839	11163	3642	0.1319796954314721	3.0650741350906094
chr13	STARD13-AS	33279532	33279570	0	39	11189	3839	11189	3800	0.0	2.9444736842105264
chr13	STARD13-AS	33279460	33279570	26	111	11189	3839	11163	3728	0.23423423423423423	2.9943669527896994
chr13	STARD13-AS	33280789	33280920	0	132	11189	3839	11189	3707	0.0	3.0183436741300245
chr13	COG6	39656116	39656275	51	160	1938	8068	1887	7908	0.31875	0.23861911987860396
chr13	COG6	39656825	39656890	0	66	1938	8068	1938	8002	0.0	0.2421894526368408
chr13	NRAD1	43919384	43919433	0	50	1	3248	1	3198	0.0	0.00031269543464665416
chr13	NRAD1	43942422	43942613	0	192	1	3248	1	3056	0.0	0.0003272251308900524
chr13	SERP2	44390356	44390578	0	223	714	1951	714	1728	0.0	0.4131944444444444
chr13	SERP2	44395783	44396083	408	301	714	1951	306	1650	1.3554817275747508	0.18545454545454546
chr13	TPT1-AS1	45344304	45344446	0	143	51	8229	51	8086	0.0	0.0063071976255256
chr13	TPT1-AS1	45369958	45370182	51	225	51	8229	0	8004	0.22666666666666666	0.0
chr13	TPT1-AS1	45379925	45380001	0	77	51	8229	51	8152	0.0	0.0062561334641805695
chr13	TPT1-AS1	45381141	45381217	0	77	51	8229	51	8152	0.0	0.0062561334641805695
chr13	TPT1-AS1	45379898	45380001	0	104	51	8229	51	8125	0.0	0.006276923076923077
chr13	TPT1-AS1	45378529	45378671	0	143	51	8229	51	8086	0.0	0.0063071976255256
chr13	TPT1-AS1	45379194	45379335	0	142	51	8229	51	8087	0.0	0.006306417707431681
chr13	TPT1-AS1	45344328	45344446	0	119	51	8229	51	8110	0.0	0.006288532675709001
chr13	TPT1-AS1	45351896	45352014	0	119	51	8229	51	8110	0.0	0.006288532675709001
chr13	TPT1-AS1	45370079	45370182	51	104	51	8229	0	8125	0.49038461538461536	0.0
chr13	CPB2-AS1	46113183	46113507	0	325	31164	17234	31164	16909	0.0	1.8430421668933703
chr13	CPB2-AS1	46118027	46118053	0	27	31164	17234	31164	17207	0.0	1.8111233800197595
chr13	LRRC63	46213001	46213119	0	119	51	5177	51	5058	0.0	0.010083036773428233
chr13	LRRC63	46227511	46228189	0	679	51	5177	51	4498	0.0	0.01133837261004891
chr13	LRRC63	46252028	46252293	0	266	51	5177	51	4911	0.0	0.010384850335980453
chr13	LRRC63	46252999	46253232	0	234	51	5177	51	4943	0.0	0.010317620878009305
chr13	DLEU1	50338675	50338834	0	160	131553	22973	131553	22813	0.0	5.766580458510498
chr13	DLEU1	50390197	50390291	0	95	131553	22973	131553	22878	0.0	5.750196695515342
chr13	DLEU1	50415088	50415202	0	115	131553	22973	131553	22858	0.0	5.755227928952665
chr13	DLEU1	50433412	50433550	0	139	131553	22973	131553	22834	0.0	5.761277043006044
chr13	DLEU1	50458002	50458113	12	112	131553	22973	131541	22861	0.10714285714285714	5.753947771313591
chr13	DLEU1	50492650	50492761	0	112	131553	22973	131553	22861	0.0	5.7544726827347885
chr13	DLEU1	50156826	50158076	102	1251	131553	22973	131451	21722	0.0815347721822542	6.051514593499678
chr13	DLEU1	50274931	50275046	15645	116	131553	22973	115908	22857	134.8706896551724	5.071006693791836
chr13	DLEU1	50527865	50528064	0	200	131553	22973	131553	22773	0.0	5.776709260966935
chr13	RNASEH2B	50956357	50956441	0	85	1275	19088	1275	19003	0.0	0.06709466926274799
chr13	RNASEH2B	50960144	50960171	0	28	1275	19088	1275	19060	0.0	0.06689401888772298
chr13	RNASEH2B	50953904	50953985	0	82	1275	19088	1275	19006	0.0	0.06708407871198568
chr13	RNASEH2B	50929474	50929582	0	109	1275	19088	1275	18979	0.0	0.06717951419990516
chr13	RNASEH2B	50930682	50930759	0	78	1275	19088	1275	19010	0.0	0.06706996317727512
chr13	RNASEH2B	50934884	50934999	0	116	1275	19088	1275	18972	0.0	0.06720430107526881
chr13	RNASEH2B	50915274	50915475	0	202	1275	19088	1275	18886	0.0	0.06751032510854602
chr13	RNASEH2B	50921177	50921331	0	155	1275	19088	1275	18933	0.0	0.0673427349073047
chr13	RNASEH2B	50960148	50960171	0	24	1275	19088	1275	19064	0.0	0.06687998321443558
chr13	INTS6-AS1	51468771	51468894	0	124	31523	14164	31523	14040	0.0	2.2452279202279204
chr13	INTS6-AS1	51479008	51479064	0	57	31523	14164	31523	14107	0.0	2.2345644006521583
chr13	INTS6-AS1	51454149	51454329	0	181	31523	14164	31523	13983	0.0	2.2543803189587357
chr13	INTS6-AS1	51467508	51467684	0	177	31523	14164	31523	13987	0.0	2.2537356116393794
chr13	INTS6-AS1	51454002	51454329	0	328	31523	14164	31523	13836	0.0	2.2783318878288523
chr13	AL390964.1	54953651	54953889	0	239	0	4150	0	3911	0.0	0.0
chr13	AL390964.1	54970742	54970897	0	156	0	4150	0	3994	0.0	0.0
chr13	AL390964.1	54960587	54960653	0	67	0	4150	0	4083	0.0	0.0
chr13	AL390964.1	54952300	54952393	0	94	0	4150	0	4056	0.0	0.0
chr13	LINC00348	71101144	71101273	0	130	0	1793	0	1663	0.0	0.0
chr13	LINC00348	71143185	71143236	0	52	0	1793	0	1741	0.0	0.0
chr13	LINC00348	71041467	71041554	0	88	0	1793	0	1705	0.0	0.0
chr13	LINC00348	71023488	71023588	0	101	0	1793	0	1692	0.0	0.0
chr13	LINC00348	71157578	71157764	0	187	0	1793	0	1606	0.0	0.0
chr13	LINC00348	71157578	71157799	0	222	0	1793	0	1571	0.0	0.0
chr13	LINC00348	71145195	71145289	0	95	0	1793	0	1698	0.0	0.0
chr13	LINC00348	71145209	71145289	0	81	0	1793	0	1712	0.0	0.0
chr13	BORA	72731280	72731387	0	108	0	3201	0	3093	0.0	0.0
chr13	BORA	72734959	72735005	0	47	0	3201	0	3154	0.0	0.0
chr13	BORA	72728925	72729093	0	169	0	3201	0	3032	0.0	0.0
chr13	AL353660.1	74331951	74332013	0	63	0	3166	0	3103	0.0	0.0
chr13	AL353660.1	74356146	74356322	0	177	0	3166	0	2989	0.0	0.0
chr13	CLN5	76998042	76998085	0	44	204	21845	204	21801	0.0	0.009357368928030824
chr13	CLN5	76999929	76999995	0	67	204	21845	204	21778	0.0	0.009367251354578015
chr13	OBI1-AS1	78363571	78363731	0	161	102	8801	102	8640	0.0	0.011805555555555555
chr13	OBI1-AS1	78578476	78578663	0	188	102	8801	102	8613	0.0	0.011842563566701497
chr13	OBI1-AS1	78274252	78274337	0	86	102	8801	102	8715	0.0	0.0117039586919105
chr13	LINC00382	79914715	79914860	44	146	1743	1525	1699	1379	0.3013698630136986	1.2320522117476431
chr13	LINC00382	79916533	79916622	0	90	1743	1525	1743	1435	0.0	1.2146341463414634
chr13	MBNL2	97365135	97365171	0	37	102	4919	102	4882	0.0	0.020893076607947564
chr13	MBNL2	97366458	97366553	0	96	102	4919	102	4823	0.0	0.02114866265809662
chr13	IPO5	97981241	97981400	0	160	9322	9701	9322	9541	0.0	0.977046431191699
chr13	IPO5	97982054	97982143	0	90	9322	9701	9322	9611	0.0	0.9699302882114245
chr13	ITGBL1	101453882	101454100	0	219	0	6189	0	5970	0.0	0.0
chr13	ITGBL1	101567698	101567845	0	148	0	6189	0	6041	0.0	0.0
chr13	BIVM	102805057	102805239	0	183	0	7930	0	7747	0.0	0.0
chr13	BIVM	102805306	102805390	0	85	0	7930	0	7845	0.0	0.0
chr13	BIVM	102831564	102831697	0	134	0	7930	0	7796	0.0	0.0
chr13	BIVM	102834465	102834552	0	88	0	7930	0	7842	0.0	0.0
chr13	LINC00343	105730314	105730458	0	145	0	12772	0	12627	0.0	0.0
chr13	LINC00343	105751097	105751171	0	75	0	12772	0	12697	0.0	0.0
chr13	LINC00343	105707713	105707837	0	125	0	12772	0	12647	0.0	0.0
chr13	LINC00343	105728589	105728727	0	139	0	12772	0	12633	0.0	0.0
chr13	LINC00343	105729843	105729959	0	117	0	12772	0	12655	0.0	0.0
chr13	LINC00343	105728650	105728727	0	78	0	12772	0	12694	0.0	0.0
chr13	LINC00343	105729826	105729959	0	134	0	12772	0	12638	0.0	0.0
chr13	LINC00343	105718474	105718852	0	379	0	12772	0	12393	0.0	0.0
chr13	LINC00343	105718474	105718559	0	86	0	12772	0	12686	0.0	0.0
chr13	LINC00343	105718647	105718852	0	206	0	12772	0	12566	0.0	0.0
chr13	LINC00343	105758080	105758187	0	108	0	12772	0	12664	0.0	0.0
chr13	LINC00343	105719046	105719106	0	61	0	12772	0	12711	0.0	0.0
chr13	LINC00343	105733919	105734205	0	287	0	12772	0	12485	0.0	0.0
chr13	LINC00343	105751102	105751171	0	70	0	12772	0	12702	0.0	0.0
chr13	TNFSF13B	108286802	108286859	0	58	0	2978	0	2920	0.0	0.0
chr13	TNFSF13B	108303252	108303365	0	114	0	2978	0	2864	0.0	0.0
chr13	ATP11A	112878216	112878303	51	88	51	12639	0	12551	0.5795454545454546	0.0
chr13	ATP11A	112880545	112880649	0	105	51	12639	51	12534	0.0	0.0040689325035902345
chr13	MCF2L	113090067	113090160	0	94	204	16966	204	16872	0.0	0.01209103840682788
chr13	MCF2L	113091120	113091195	0	76	204	16966	204	16890	0.0	0.012078152753108348
chr14	APEX1	20455577	20455703	0	127	0	1679	0	1552	0.0	0.0
chr14	APEX1	20455737	20455773	0	37	0	1679	0	1642	0.0	0.0
chr14	APEX1	20455734	20455773	0	40	0	1679	0	1639	0.0	0.0
chr14	TPPP2	21032319	21032380	0	62	0	2314	0	2252	0.0	0.0
chr14	TPPP2	21035793	21036092	0	300	0	2314	0	2014	0.0	0.0
chr14	ABHD4	22603389	22603457	0	69	0	3045	0	2976	0.0	0.0
chr14	ABHD4	22603587	22603762	0	176	0	3045	0	2869	0.0	0.0
chr14	MRPL52	22830963	22831037	0	75	0	2769	0	2694	0.0	0.0
chr14	MRPL52	22833417	22833482	0	66	0	2769	0	2703	0.0	0.0
chr14	MRPL52	22833417	22833489	0	73	0	2769	0	2696	0.0	0.0
chr14	PRMT5-AS1	22922971	22923204	0	234	120	2524	120	2290	0.0	0.05240174672489083
chr14	PRMT5-AS1	22924300	22924441	0	142	120	2524	120	2382	0.0	0.05037783375314862
chr14	AL132780.1	22933642	22933692	0	51	0	1807	0	1756	0.0	0.0
chr14	AL132780.1	22954330	22954486	0	157	0	1807	0	1650	0.0	0.0
chr14	CMTM5	23378348	23378501	379	154	51374	2586	50995	2432	2.461038961038961	20.968338815789473
chr14	CMTM5	23379030	23379123	203	94	51374	2586	51171	2492	2.1595744680851063	20.53410914927769
chr14	DHRS4	23959901	23960003	0	103	0	2042	0	1939	0.0	0.0
chr14	DHRS4	23965761	23965832	0	72	0	2042	0	1970	0.0	0.0
chr14	DHRS4L2	23995031	23995133	102	103	7618	2428	7516	2325	0.9902912621359223	3.232688172043011
chr14	DHRS4L2	24001383	24001517	0	135	7618	2428	7618	2293	0.0	3.3222852158744005
chr14	PCK2	24094765	24094845	0	81	0	3751	0	3670	0.0	0.0
chr14	PCK2	24096891	24097137	0	247	0	3751	0	3504	0.0	0.0
chr14	MIR4307HG	26880369	26880455	0	87	2422	3583	2422	3496	0.0	0.6927917620137299
chr14	MIR4307HG	26901044	26901177	0	134	2422	3583	2422	3449	0.0	0.7022325311684546
chr14	MIR4307HG	26880369	26880635	0	267	2422	3583	2422	3316	0.0	0.7303980699638118
chr14	MIR4307HG	26896245	26896380	0	136	2422	3583	2422	3447	0.0	0.7026399767914128
chr14	LINC02327	28870302	28870416	0	115	102	5076	102	4961	0.0	0.020560370892965127
chr14	LINC02327	28881090	28881141	0	52	102	5076	102	5024	0.0	0.020302547770700636
chr14	SCFD1	30707816	30707914	0	99	0	20324	0	20225	0.0	0.0
chr14	SCFD1	30707989	30708065	0	77	0	20324	0	20247	0.0	0.0
chr14	SCFD1	30633946	30634037	0	92	0	20324	0	20232	0.0	0.0
chr14	SCFD1	30639776	30639864	0	89	0	20324	0	20235	0.0	0.0
chr14	SCFD1	30638124	30638247	0	124	0	20324	0	20200	0.0	0.0
chr14	SCFD1	30630476	30630565	0	90	0	20324	0	20234	0.0	0.0
chr14	SCFD1	30628208	30628279	0	72	0	20324	0	20252	0.0	0.0
chr14	SCFD1	30638183	30638247	0	65	0	20324	0	20259	0.0	0.0
chr14	SCFD1	30643315	30643405	0	91	0	20324	0	20233	0.0	0.0
chr14	AP4S1	31080572	31080644	0	73	52900	9348	52900	9275	0.0	5.703504043126685
chr14	AP4S1	31124828	31124969	0	142	52900	9348	52900	9206	0.0	5.746252444058223
chr14	SRP54	34999557	34999649	25	93	11261	8450	11236	8357	0.26881720430107525	1.3445016154122293
chr14	SRP54	35000935	35001020	0	86	11261	8450	11261	8364	0.0	1.3463653754184601
chr14	SRP54	34999557	34999644	20	88	11261	8450	11241	8362	0.22727272727272727	1.344295623056685
chr14	PSMA6	35312880	35313059	0	180	1020	2284	1020	2104	0.0	0.4847908745247148
chr14	PSMA6	35314360	35314455	0	96	1020	2284	1020	2188	0.0	0.46617915904936014
chr14	GEMIN2	39124991	39125036	0	46	0	2501	0	2455	0.0	0.0
chr14	GEMIN2	39128279	39128348	0	70	0	2501	0	2431	0.0	0.0
chr14	AL049828.1	39485016	39485257	0	242	2549	12973	2549	12731	0.0	0.20021993559029141
chr14	AL049828.1	39492254	39492556	0	303	2549	12973	2549	12670	0.0	0.20118389897395422
chr14	KLHDC1	49723873	49723952	0	80	0	3019	0	2939	0.0	0.0
chr14	KLHDC1	49725685	49725769	0	85	0	3019	0	2934	0.0	0.0
chr14	KLHDC2	49782369	49782457	0	89	116	6332	116	6243	0.0	0.018580810507768702
chr14	KLHDC2	49782541	49782594	0	54	116	6332	116	6278	0.0	0.018477222045237336
chr14	GNG2	51841505	51841572	0	68	542	6394	542	6326	0.0	0.08567815365159659
chr14	GNG2	51877616	51877657	0	42	542	6394	542	6352	0.0	0.08532745591939547
chr14	GNG2	51913008	51913128	0	121	542	6394	542	6273	0.0	0.08640204049099315
chr14	GNG2	51939780	51940091	0	312	542	6394	542	6082	0.0	0.08911542255836896
chr14	AL365295.1	53170433	53170501	0	69	95704	14298	95704	14229	0.0	6.725982149132054
chr14	AL365295.1	53188031	53188153	1128	123	95704	14298	94576	14175	9.170731707317072	6.672028218694885
chr14	AL365295.1	53304807	53305053	0	247	95704	14298	95704	14051	0.0	6.811187815813821
chr14	AL365295.1	53313715	53313790	0	76	95704	14298	95704	14222	0.0	6.729292645197582
chr14	CDKN3	54399893	54399912	0	20	5312	1842	5312	1822	0.0	2.915477497255763
chr14	CDKN3	54401523	54401579	0	57	5312	1842	5312	1785	0.0	2.9759103641456583
chr14	PSMA3	58247749	58247832	0	84	99	3041	99	2957	0.0	0.03347987825498817
chr14	PSMA3	58252118	58252242	0	125	99	3041	99	2916	0.0	0.033950617283950615
chr14	KIAA0586	58440069	58440160	0	92	51	17469	51	17377	0.0	0.0029349139667376417
chr14	KIAA0586	58441220	58441343	0	124	51	17469	51	17345	0.0	0.0029403286249639667
chr14	KIAA0586	58520710	58520861	0	152	51	17469	51	17317	0.0	0.0029450828665473234
chr14	KIAA0586	58540070	58540136	0	67	51	17469	51	17402	0.0	0.0029306976209631077
chr14	LINC01500	59009030	59009150	0	121	26561	6780	26561	6659	0.0	3.9887370476047455
chr14	LINC01500	59079574	59079776	0	203	26561	6780	26561	6577	0.0	4.038467386346358
chr14	LINC01500	58913762	58913861	100	100	26561	6780	26461	6680	1.0	3.9612275449101797
chr14	LINC01500	58948312	58948341	0	30	26561	6780	26561	6750	0.0	3.9349629629629628
chr14	LINC01500	59125171	59125402	51	232	26561	6780	26510	6548	0.21982758620689655	4.048564447159438
chr14	LINC01500	58958535	58958619	0	85	26561	6780	26561	6695	0.0	3.9672890216579537
chr14	LINC01500	58989533	58989633	0	101	26561	6780	26561	6679	0.0	3.9767929330738134
chr14	LINC01500	58848593	58848742	0	150	26561	6780	26561	6630	0.0	4.006184012066365
chr14	LINC01500	58877608	58877692	22262	85	26561	6780	4299	6695	261.90588235294115	0.6421209858103062
chr14	FUT8	65455620	65455718	259	99	34925	6997	34666	6898	2.6161616161616164	5.025514641925196
chr14	FUT8	65561336	65561766	196	431	34925	6997	34729	6566	0.4547563805104408	5.289217179409077
chr14	FUT8	65479706	65479784	444	79	34925	6997	34481	6918	5.620253164556962	4.984244001156403
chr14	FUT8	65516242	65516388	0	147	34925	6997	34925	6850	0.0	5.098540145985401
chr14	LINC02290	66125768	66125889	0	122	408	4521	408	4399	0.0	0.09274835189815868
chr14	LINC02290	66126466	66126509	0	44	408	4521	408	4477	0.0	0.0911324547688184
chr14	LINC02290	66117907	66118054	0	148	408	4521	408	4373	0.0	0.09329979419163045
chr14	LINC02290	66123143	66123313	0	171	408	4521	408	4350	0.0	0.09379310344827586
chr14	CCDC196	66492811	66492900	0	90	51	2841	51	2751	0.0	0.018538713195201745
chr14	CCDC196	66495661	66495771	0	111	51	2841	51	2730	0.0	0.01868131868131868
chr14	GPHN	66824473	66824566	0	94	561	5667	561	5573	0.0	0.10066391530593935
chr14	GPHN	66842677	66842716	0	40	561	5667	561	5627	0.0	0.09969788519637462
chr14	FAM71D	67189697	67189754	0	58	1684	4520	1684	4462	0.0	0.3774092335275661
chr14	FAM71D	67196953	67197029	0	77	1684	4520	1684	4443	0.0	0.37902318253432365
chr14	FAM71D	67198971	67199130	0	160	1684	4520	1684	4360	0.0	0.38623853211009174
chr14	FAM71D	67201430	67201747	0	318	1684	4520	1684	4202	0.0	0.4007615421227987
chr14	SLC39A9	69442068	69442266	0	199	306	7148	306	6949	0.0	0.04403511296589437
chr14	SLC39A9	69453240	69453309	0	70	306	7148	306	7078	0.0	0.043232551568239616
chr14	PCNX1	71053296	71053412	901	117	5327	16758	4426	16641	7.700854700854701	0.2659695931734872
chr14	PCNX1	71055503	71055562	35	60	5327	16758	5292	16698	0.5833333333333334	0.31692418253683075
chr14	RBM25	73064971	73065093	0	123	2179	11083	2179	10960	0.0	0.19881386861313868
chr14	RBM25	73069852	73069920	0	69	2179	11083	2179	11014	0.0	0.1978391138550935
chr14	PSEN1	73137124	73137223	4031	100	35813	9942	31782	9842	40.31	3.2292217029059134
chr14	PSEN1	73139296	73139398	280	103	35813	9942	35533	9839	2.7184466019417477	3.6114442524646813
chr14	PSEN1	73138111	73138152	329	42	35813	9942	35484	9900	7.833333333333333	3.5842424242424245
chr14	ZNF410	73924701	73924819	0	119	508	5246	508	5127	0.0	0.09908328457187439
chr14	ZNF410	73927106	73927228	0	123	508	5246	508	5123	0.0	0.09916064805777865
chr14	DLST	74882590	74882624	0	35	0	4551	0	4516	0.0	0.0
chr14	DLST	74885585	74885634	0	50	0	4551	0	4501	0.0	0.0
chr14	DLST	74889094	74889147	0	54	0	4551	0	4497	0.0	0.0
chr14	FLVCR2	75624611	75624752	0	142	4138	4925	4138	4783	0.0	0.865147397031152
chr14	FLVCR2	75633628	75633696	0	69	4138	4925	4138	4856	0.0	0.8521416803953872
chr14	GPATCH2L	76177891	76177931	0	41	15297	20948	15297	20907	0.0	0.7316688190558186
chr14	GPATCH2L	76177987	76178042	0	56	15297	20948	15297	20892	0.0	0.7321941412981046
chr14	GSTZ1	77327471	77327552	0	82	0	5473	0	5391	0.0	0.0
chr14	GSTZ1	77327911	77328037	0	127	0	5473	0	5346	0.0	0.0
chr14	AHSA1	77462641	77462759	0	119	11	2865	11	2746	0.0	0.004005826656955572
chr14	AHSA1	77468082	77468184	11	103	11	2865	0	2762	0.10679611650485436	0.0
chr14	ADCK1	77859075	77859279	0	205	322993	4083	322993	3878	0.0	83.28855079938113
chr14	ADCK1	77887090	77887249	0	160	322993	4083	322993	3923	0.0	82.3331633953607
chr14	AL355838.1	81768419	81768548	0	130	0	2374	0	2244	0.0	0.0
chr14	AL355838.1	81777757	81777914	0	158	0	2374	0	2216	0.0	0.0
chr14	LINC02301	82680150	82680368	0	219	0	6218	0	5999	0.0	0.0
chr14	LINC02301	82685379	82685431	0	53	0	6218	0	6165	0.0	0.0
chr14	LINC02328	86000860	86000953	0	94	0	4788	0	4694	0.0	0.0
chr14	LINC02328	86028368	86028458	0	91	0	4788	0	4697	0.0	0.0
chr14	LINC01146	88044614	88044848	0	235	0	9300	0	9065	0.0	0.0
chr14	LINC01146	88079103	88079368	0	266	0	9300	0	9034	0.0	0.0
chr14	LINC01146	88044685	88044848	0	164	0	9300	0	9136	0.0	0.0
chr14	LINC01146	88025406	88025481	0	76	0	9300	0	9224	0.0	0.0
chr14	LINC01146	88037350	88037439	0	90	0	9300	0	9210	0.0	0.0
chr14	LINC01146	88084036	88084155	0	120	0	9300	0	9180	0.0	0.0
chr14	LINC01146	88086827	88087023	0	197	0	9300	0	9103	0.0	0.0
chr14	LINC01146	88090022	88090210	0	189	0	9300	0	9111	0.0	0.0
chr14	LINC01146	88086827	88087037	0	211	0	9300	0	9089	0.0	0.0
chr14	LINC01146	88091335	88091449	0	115	0	9300	0	9185	0.0	0.0
chr14	SPATA7	88414673	88414732	0	60	2237	6106	2237	6046	0.0	0.36999669202778696
chr14	SPATA7	88415204	88415266	51	63	2237	6106	2186	6043	0.8095238095238095	0.3617408571901373
chr14	SPATA7	88406682	88406736	0	55	2237	6106	2237	6051	0.0	0.3696909601718724
chr14	ZC3H14	88568038	88568153	0	116	0	20176	0	20060	0.0	0.0
chr14	ZC3H14	88571083	88571124	0	42	0	20176	0	20134	0.0	0.0
chr14	ZC3H14	88563650	88563693	0	44	0	20176	0	20132	0.0	0.0
chr14	TTC8	88833692	88833722	0	31	0	6251	0	6220	0.0	0.0
chr14	TTC8	88836907	88837066	0	160	0	6251	0	6091	0.0	0.0
chr14	TTC8	88841424	88841557	0	134	0	6251	0	6117	0.0	0.0
chr14	TTC8	88843805	88843850	0	46	0	6251	0	6205	0.0	0.0
chr14	TTC8	88841424	88841514	0	91	0	6251	0	6160	0.0	0.0
chr14	TDP1	89956577	89956800	0	224	204	6245	204	6021	0.0	0.03388141504733433
chr14	TDP1	89963107	89963673	0	567	204	6245	204	5678	0.0	0.03592814371257485
chr14	TDP1	89963224	89963673	0	450	204	6245	204	5795	0.0	0.035202761000862816
chr14	CHGA	92924198	92924245	0	48	0	3033	0	2985	0.0	0.0
chr14	CHGA	92926604	92926698	0	95	0	3033	0	2938	0.0	0.0
chr14	AL132642.1	93941562	93941692	0	131	0	841	0	710	0.0	0.0
chr14	AL132642.1	93941746	93941905	0	160	0	841	0	681	0.0	0.0
chr14	IFI27	94111624	94111773	0	150	0	3825	0	3675	0.0	0.0
chr14	IFI27	94114850	94114880	0	31	0	3825	0	3794	0.0	0.0
chr14	TCL6	95662479	95662664	0	186	2040	10388	2040	10202	0.0	0.19996079200156833
chr14	TCL6	95663255	95663635	102	381	2040	10388	1938	10007	0.2677165354330709	0.1936644348955731
chr14	TCL6	95668125	95668580	0	456	2040	10388	2040	9932	0.0	0.2053966975432944
chr14	TCL6	95669550	95669617	0	68	2040	10388	2040	10320	0.0	0.19767441860465115
chr14	C14ORF132	96040274	96040367	0	94	0	1112	0	1018	0.0	0.0
chr14	C14ORF132	96051123	96051222	0	100	0	1112	0	1012	0.0	0.0
chr14	PAPOLA	96525309	96525391	0	83	29336	10053	29336	9970	0.0	2.9424272818455366
chr14	PAPOLA	96527429	96527539	0	111	29336	10053	29336	9942	0.0	2.9507141420237377
chr14	AL137786.1	96593120	96593249	0	130	102	2863	102	2733	0.0	0.03732162458836443
chr14	AL137786.1	96593489	96593699	0	211	102	2863	102	2652	0.0	0.038461538461538464
chr14	AL137786.1	96593489	96593695	0	207	102	2863	102	2656	0.0	0.038403614457831324
chr14	LINC02325	97525673	97525818	0	146	897	5246	897	5100	0.0	0.17588235294117646
chr14	LINC02325	97536637	97536678	0	42	897	5246	897	5204	0.0	0.1723674096848578
chr14	MEG3	100831420	100831534	510	115	138632	9744	138122	9629	4.434782608695652	14.344376363069893
chr14	MEG3	100832511	100832641	262	131	138632	9744	138370	9613	2.0	14.394049724331634
chr14	MEG3	100830967	100831094	102	128	138632	9744	138530	9616	0.796875	14.406198003327788
chr14	MEG3	100857338	100857388	0	51	138632	9744	138632	9693	0.0	14.302279995873311
chr14	MEG3	100859790	100859884	0	95	138632	9744	138632	9649	0.0	14.36749922271738
chr14	MEG3	100855890	100856268	0	379	138632	9744	138632	9365	0.0	14.80320341697811
chr14	MEG3	100857647	100857797	0	151	138632	9744	138632	9593	0.0	14.451370791201919
chr14	MEG3	100831015	100831094	102	80	138632	9744	138530	9664	1.275	14.3346440397351
chr14	MEG3	100835735	100835879	612	145	138632	9744	138020	9599	4.220689655172414	14.378581102198146
chr14	MEG3	100834683	100834751	765	69	138632	9744	137867	9675	11.08695652173913	14.249819121447029
chr14	MEG3	100835369	100835549	46332	181	138632	9744	92300	9563	255.97790055248618	9.651782913311722
chr14	MEG3	100834631	100834751	765	121	138632	9744	137867	9623	6.322314049586777	14.326821157643147
chr14	MEG3	100835738	100835879	612	142	138632	9744	138020	9602	4.309859154929577	14.374088731514268
chr14	PPP2R5C	101786017	101786183	0	167	153	13164	153	12997	0.0	0.01177194737247057
chr14	PPP2R5C	101818991	101819085	0	95	153	13164	153	13069	0.0	0.01170709312112633
chr14	PPP2R5C	101889981	101890192	0	212	153	13164	153	12952	0.0	0.011812847436689315
chr14	PPP2R5C	101890236	101890296	0	61	153	13164	153	13103	0.0	0.011676715256048234
chr14	PPP2R5C	101883256	101883349	0	94	153	13164	153	13070	0.0	0.0117061973986228
chr14	PPP2R5C	101883431	101883562	0	132	153	13164	153	13032	0.0	0.011740331491712707
chr14	WDR20	102193462	102193475	0	14	0	7270	0	7256	0.0	0.0
chr14	WDR20	102194937	102195120	0	184	0	7270	0	7086	0.0	0.0
chr14	MARK3	103438020	103438333	10755	314	68861	15808	58106	15494	34.2515923566879	3.750225893894411
chr14	MARK3	103448918	103448967	150	50	68861	15808	68711	15758	3.0	4.360388374159157
chr14	MARK3	103441469	103441563	0	95	68861	15808	68861	15713	0.0	4.382422198179851
chr14	MARK3	103438024	103438333	10755	310	68861	15808	58106	15498	34.693548387096776	3.7492579687701637
chr14	MARK3	103438184	103438333	10755	150	68861	15808	58106	15658	71.7	3.7109464810320603
chr14	MARK3	103487378	103487707	0	330	68861	15808	68861	15478	0.0	4.448959813929449
chr14	MARK3	103490951	103491107	0	157	68861	15808	68861	15651	0.0	4.3997827614848894
chr14	MARK3	103498501	103498528	0	28	68861	15808	68861	15780	0.0	4.36381495564005
chr14	MARK3	103500155	103500200	0	46	68861	15808	68861	15762	0.0	4.36879837584063
chr14	MARK3	103429192	103429373	0	182	68861	15808	68861	15626	0.0	4.406821963394343
chr14	MARK3	103451917	103451983	0	67	68861	15808	68861	15741	0.0	4.374626770853186
chr14	MARK3	103498826	103498901	25	76	68861	15808	68836	15732	0.32894736842105265	4.375540300025426
chr14	MARK3	103405075	103405267	351	193	68861	15808	68510	15615	1.8186528497409327	4.387447966698687
chr14	MARK3	103428386	103428440	91	55	68861	15808	68770	15753	1.6545454545454545	4.365517679172221
chr14	MARK3	103490977	103491107	0	131	68861	15808	68861	15677	0.0	4.392485807233527
chr14	MARK3	103489052	103491107	64	2056	68861	15808	68797	13752	0.0311284046692607	5.002690517742874
chr14	MARK3	103457141	103457212	247	72	68861	15808	68614	15736	3.4305555555555554	4.360320284697509
chr14	COA8	103579370	103579491	0	122	102	3927	102	3805	0.0	0.026806833114323258
chr14	COA8	103581568	103581656	0	89	102	3927	102	3838	0.0	0.026576341844710787
chr14	COA8	103574106	103574170	0	65	102	3927	102	3862	0.0	0.02641118591403418
chr14	INF2	104706909	104707051	0	143	51	13399	51	13256	0.0	0.003847314423657212
chr14	INF2	104707252	104708002	51	751	51	13399	0	12648	0.06790945406125166	0.0
chr14	INF2	104707847	104708002	0	156	51	13399	51	13243	0.0	0.0038510911424903724
chr14	INF2	104710087	104710188	0	102	51	13399	51	13297	0.0	0.003835451605625329
chr14	INF2	104710936	104711007	0	72	51	13399	51	13327	0.0	0.003826817738425752
chr14	INF2	104715832	104716017	0	186	51	13399	51	13213	0.0	0.0038598350109740405
chr14	INF2	104717562	104717646	0	85	51	13399	51	13314	0.0	0.0038305543037404238
chr14	INF2	104717547	104717646	0	100	51	13399	51	13299	0.0	0.003834874802616738
chr14	MTA1	105445417	105445511	0	95	120151	6787	120151	6692	0.0	17.95442319187089
chr14	MTA1	105449358	105449409	0	52	120151	6787	120151	6735	0.0	17.839792130660726
chr14	TEDC1	105492578	105492734	0	157	306	3476	306	3319	0.0	0.09219644471226272
chr14	TEDC1	105493834	105493933	0	100	306	3476	306	3376	0.0	0.09063981042654029
chr14	CCNB1IP1	20317793	20317974	0	182	0	3695	0	3513	0.0	0.0
chr14	CCNB1IP1	20318255	20318470	0	216	0	3695	0	3479	0.0	0.0
chr14	CCNB1IP1	20317794	20317974	0	181	0	3695	0	3514	0.0	0.0
chr14	CCNB1IP1	20315484	20315618	0	135	0	3695	0	3560	0.0	0.0
chr14	CCNB1IP1	20315780	20315850	0	71	0	3695	0	3624	0.0	0.0
chr14	CCNB1IP1	20320287	20320392	0	106	0	3695	0	3589	0.0	0.0
chr14	RNASE9	20559581	20559633	0	53	0	2714	0	2661	0.0	0.0
chr14	RNASE9	20560336	20560371	0	36	0	2714	0	2678	0.0	0.0
chr14	HNRNPC	21236372	21236460	0	89	102	5164	102	5075	0.0	0.020098522167487684
chr14	HNRNPC	21262600	21262768	0	169	102	5164	102	4995	0.0	0.02042042042042042
chr14	HNRNPC	21234768	21234831	0	64	102	5164	102	5100	0.0	0.02
chr14	HNRNPC	21254546	21254593	0	48	102	5164	102	5116	0.0	0.0199374511336982
chr14	HNRNPC	21263666	21263829	0	164	102	5164	102	5000	0.0	0.0204
chr14	HNRNPC	21268622	21268668	0	47	102	5164	102	5117	0.0	0.019933554817275746
chr14	AC244502.1	22418663	22418935	0	273	204	8937	204	8664	0.0	0.023545706371191136
chr14	AC244502.1	22427688	22427822	0	135	204	8937	204	8802	0.0	0.023176550783912748
chr14	SLC7A7	22821121	22821440	102	320	255	4786	153	4466	0.31875	0.03425884460367219
chr14	SLC7A7	22823023	22823072	0	50	255	4786	255	4736	0.0	0.05384290540540541
chr14	SLC7A7	22819637	22819756	0	120	255	4786	255	4666	0.0	0.0546506643806258
chr14	SLC7A7	22821121	22821232	0	112	255	4786	255	4674	0.0	0.05455712451861361
chr14	RBM23	22908332	22908380	0	49	0	12458	0	12409	0.0	0.0
chr14	RBM23	22909482	22909595	0	114	0	12458	0	12344	0.0	0.0
chr14	RBM23	22911327	22911403	0	77	0	12458	0	12381	0.0	0.0
chr14	RBM23	22911785	22911903	0	119	0	12458	0	12339	0.0	0.0
chr14	RBM23	22913723	22913845	0	123	0	12458	0	12335	0.0	0.0
chr14	RBM23	22917027	22917166	0	140	0	12458	0	12318	0.0	0.0
chr14	RBM23	22913723	22913821	0	99	0	12458	0	12359	0.0	0.0
chr14	PRMT5	22927525	22927614	0	90	0	3100	0	3010	0.0	0.0
chr14	PRMT5	22928125	22928211	0	87	0	3100	0	3013	0.0	0.0
chr14	C14ORF93	22999956	23000117	0	162	0	3210	0	3048	0.0	0.0
chr14	C14ORF93	23000958	23001037	0	80	0	3210	0	3130	0.0	0.0
chr14	C14ORF93	23000958	23001031	0	74	0	3210	0	3136	0.0	0.0
chr14	AL160237.1	23715257	23715436	0	180	51	2800	51	2620	0.0	0.019465648854961833
chr14	AL160237.1	23729276	23729424	0	149	51	2800	51	2651	0.0	0.01923802338740098
chr14	SDR39U1	24441673	24441795	0	123	0	2120	0	1997	0.0	0.0
chr14	SDR39U1	24442177	24442260	0	84	0	2120	0	2036	0.0	0.0
chr14	SDR39U1	24442097	24442260	0	164	0	2120	0	1956	0.0	0.0
chr14	SDR39U1	24442108	24442260	0	153	0	2120	0	1967	0.0	0.0
chr14	GZMB	24632323	24632459	4367	137	25570	1418	21203	1281	31.875912408759124	16.55191256830601
chr14	GZMB	24632718	24632719	14	2	25570	1418	25556	1416	7.0	18.048022598870055
chr14	STXBP6	24987885	24987972	0	88	360	8079	360	7991	0.0	0.04505068201726943
chr14	STXBP6	25010524	25010640	0	117	360	8079	360	7962	0.0	0.0452147701582517
chr14	NOVA1	26549679	26549781	0	103	69	10340	69	10237	0.0	0.006740255934355769
chr14	NOVA1	26568419	26568465	0	47	69	10340	69	10293	0.0	0.006703584960652871
chr14	AL133166.1	29307380	29307470	0	91	3673	11324	3673	11233	0.0	0.3269829965280869
chr14	AL133166.1	29346444	29346525	0	82	3673	11324	3673	11242	0.0	0.32672122398149794
chr14	STRN3	30918965	30919106	0	142	0	4985	0	4843	0.0	0.0
chr14	STRN3	30929200	30929311	0	112	0	4985	0	4873	0.0	0.0
chr14	PPP2R3C	35109818	35109847	0	30	51580	3757	51580	3727	0.0	13.839549235309901
chr14	PPP2R3C	35109847	35109931	0	85	51580	3757	51580	3672	0.0	14.046840958605664
chr14	RALGAPA1	35542026	35542029	0	4	8964	14305	8964	14301	0.0	0.6268093140339837
chr14	RALGAPA1	35548507	35548538	0	32	8964	14305	8964	14273	0.0	0.628038954669656
chr14	LINC00639	38916781	38916882	0	102	0	9470	0	9368	0.0	0.0
chr14	LINC00639	38941519	38941695	0	177	0	9470	0	9293	0.0	0.0
chr14	LINC00639	38890740	38890798	0	59	0	9470	0	9411	0.0	0.0
chr14	LINC00639	38941353	38941373	0	21	0	9470	0	9449	0.0	0.0
chr14	KLHL28	44953622	44953709	0	88	60	7833	60	7745	0.0	0.007746933505487412
chr14	KLHL28	44959340	44959514	0	175	60	7833	60	7658	0.0	0.007834943849569079
chr14	LINC02303	45711898	45711953	23	56	2681	1149	2658	1093	0.4107142857142857	2.431838975297347
chr14	LINC02303	45714283	45714431	220	149	2681	1149	2461	1000	1.476510067114094	2.461
chr14	LINC02303	45707835	45707898	0	64	2681	1149	2681	1085	0.0	2.470967741935484
chr14	NEMF	49840717	49840866	11628	150	11781	8972	153	8822	77.52	0.017343006121060985
chr14	NEMF	49846139	49846265	0	127	11781	8972	11781	8845	0.0	1.3319389485585076
chr14	NIN	50794435	50794525	3883	91	28389	13565	24506	13474	42.67032967032967	1.8187620602642125
chr14	NIN	50806207	50806276	0	70	28389	13565	28389	13495	0.0	2.1036680251945166
chr14	DDHD1	53096116	53096218	0	103	25416	16629	25416	16526	0.0	1.537940215418129
chr14	DDHD1	53103030	53103051	1038	22	25416	16629	24378	16607	47.18181818181818	1.4679352080448005
chr14	CNIH1	54430260	54430404	0	145	102	5026	102	4881	0.0	0.02089735709895513
chr14	CNIH1	54432107	54432220	0	114	102	5026	102	4912	0.0	0.020765472312703582
chr14	CNIH1	54436368	54436437	0	70	102	5026	102	4956	0.0	0.020581113801452784
chr14	GCH1	54843781	54843869	0	89	1183	2205	1183	2116	0.0	0.5590737240075614
chr14	GCH1	54844000	54844143	0	144	1183	2205	1183	2061	0.0	0.5739932071809801
chr14	PSMA3-AS1	58293065	58293138	0	74	0	6704	0	6630	0.0	0.0
chr14	PSMA3-AS1	58293765	58295811	0	2047	0	6704	0	4657	0.0	0.0
chr14	PSMA3-AS1	58293313	58293544	0	232	0	6704	0	6472	0.0	0.0
chr14	TIMM9	58411906	58411971	0	66	0	1038	0	972	0.0	0.0
chr14	TIMM9	58424007	58424095	0	89	0	1038	0	949	0.0	0.0
chr14	AL355916.2	61538972	61539187	896	216	14123	4009	13227	3793	4.148148148148148	3.487213287635117
chr14	AL355916.2	61542622	61542717	0	96	14123	4009	14123	3913	0.0	3.6092512139023767
chr14	ESR2	64249545	64249679	0	135	2376	7242	2376	7107	0.0	0.3343182777543267
chr14	ESR2	64257225	64257364	0	140	2376	7242	2376	7102	0.0	0.3345536468600394
chr14	GPX2	64939992	64940198	125	207	1976	1444	1851	1237	0.6038647342995169	1.496362166531932
chr14	GPX2	64941316	64941521	0	206	1976	1444	1976	1238	0.0	1.5961227786752827
chr14	MAX	65093707	65093815	0	109	0	5511	0	5402	0.0	0.0
chr14	MAX	65101545	65101572	0	28	0	5511	0	5483	0.0	0.0
chr14	PLEK2	67390662	67390746	0	85	548	1579	548	1494	0.0	0.3668005354752343
chr14	PLEK2	67392325	67392427	0	103	548	1579	548	1476	0.0	0.3712737127371274
chr14	RDH11	67692437	67692593	0	157	573	3089	573	2932	0.0	0.19542974079126876
chr14	RDH11	67692933	67693052	51	120	573	3089	522	2969	0.425	0.17581677332435164
chr14	ACTN1	68878457	68878523	225	67	2026	9387	1801	9320	3.3582089552238807	0.19324034334763948
chr14	ACTN1	68878988	68879069	0	82	2026	9387	2026	9305	0.0	0.21773240193444385
chr14	SLC8A3	70060835	70060939	0	105	50	8457	50	8352	0.0	0.0059865900383141765
chr14	SLC8A3	70063822	70063929	0	108	50	8457	50	8349	0.0	0.005988741166606779
chr14	ABCD4	74299547	74299675	80	129	357	8153	277	8024	0.6201550387596899	0.03452143569292124
chr14	ABCD4	74300149	74300268	0	120	357	8153	357	8033	0.0	0.044441678077928544
chr14	ABCD4	74293153	74293248	0	96	357	8153	357	8057	0.0	0.044309296264118156
chr14	ABCD4	74295147	74295198	0	52	357	8153	357	8101	0.0	0.04406863350203678
chr14	NPC2	74480701	74480779	0	79	1734	2591	1734	2512	0.0	0.6902866242038217
chr14	NPC2	74484414	74484587	0	174	1734	2591	1734	2417	0.0	0.7174182871328093
chr14	LTBP2	74507178	74507310	81	133	8077	9114	7996	8981	0.6090225563909775	0.8903240173700033
chr14	LTBP2	74507972	74508095	0	124	8077	9114	8077	8990	0.0	0.8984427141268075
chr14	AREL1	74683295	74683533	0	239	11629	7250	11629	7011	0.0	1.658679218371131
chr14	AREL1	74684453	74684680	0	228	11629	7250	11629	7022	0.0	1.6560808886357163
chr14	MLH3	75033418	75033490	0	73	29983	6620	29983	6547	0.0	4.579654803726898
chr14	MLH3	75039910	75040015	0	106	29983	6620	29983	6514	0.0	4.602855388394228
chr14	NEK9	75121118	75121174	38	57	4964	13134	4926	13077	0.6666666666666666	0.3766919018123423
chr14	NEK9	75124045	75124223	0	179	4964	13134	4964	12955	0.0	0.3831725202624469
chr14	DIO2	80205601	80205735	0	135	0	2204	0	2069	0.0	0.0
chr14	DIO2	80206230	80206338	0	109	0	2204	0	2095	0.0	0.0
chr14	FOXN3	89284427	89284522	0	96	23	11177	23	11081	0.0	0.002075624943597148
chr14	FOXN3	89333113	89333259	0	147	23	11177	23	11030	0.0	0.002085222121486854
chr14	TTC7B	90602005	90602200	0	196	8850	21297	8850	21101	0.0	0.4194114023032084
chr14	TTC7B	90603252	90603303	0	52	8850	21297	8850	21245	0.0	0.4165686043775006
chr14	CATSPERB	91736693	91736849	0	157	16636	5666	16636	5509	0.0	3.019785805046288
chr14	CATSPERB	91778974	91779070	0	97	16636	5666	16636	5569	0.0	2.987250852935895
chr14	TC2N	91792366	91792558	648	193	19899	6166	19251	5973	3.3575129533678756	3.2230035158211954
chr14	TC2N	91797784	91797901	0	118	19899	6166	19899	6048	0.0	3.2901785714285716
chr14	FBLN5	91938329	91938452	0	124	21809	4991	21809	4867	0.0	4.480994452434765
chr14	FBLN5	91939849	91939950	2152	102	21809	4991	19657	4889	21.098039215686274	4.020658621394968
chr14	ATXN3	92079414	92079468	0	55	153	9265	153	9210	0.0	0.016612377850162865
chr14	ATXN3	92080540	92080567	0	28	153	9265	153	9237	0.0	0.016563819421890225
chr14	ATXN3	92093745	92093831	0	87	153	9265	153	9178	0.0	0.016670298539986927
chr14	ATXN3	92096092	92096137	0	46	153	9265	153	9219	0.0	0.01659616010413277
chr14	ATXN3	92096673	92096838	0	166	153	9265	153	9099	0.0	0.016815034619188922
chr14	ATXN3	92093251	92093318	0	68	153	9265	153	9197	0.0	0.0166358595194085
chr14	ATXN3	92088729	92088817	0	89	153	9265	153	9176	0.0	0.016673931996512643
chr14	ATXN3	92096092	92096134	0	43	153	9265	153	9222	0.0	0.016590761223162005
chr14	LGMN	92733681	92733810	0	130	0	3797	0	3667	0.0	0.0
chr14	LGMN	92741061	92741179	0	119	0	3797	0	3678	0.0	0.0
chr14	LGMN	92741717	92741859	0	143	0	3797	0	3654	0.0	0.0
chr14	LGMN	92741704	92741859	0	156	0	3797	0	3641	0.0	0.0
chr14	LGMN	92742908	92743021	0	114	0	3797	0	3683	0.0	0.0
chr14	ITPK1	93016675	93016801	0	127	12	6805	12	6678	0.0	0.0017969451931716084
chr14	ITPK1	93076594	93076619	0	26	12	6805	12	6779	0.0	0.0017701725918277031
chr14	WARS1	100373979	100374064	12198	86	38826	6022	26628	5936	141.8372093023256	4.485849056603773
chr14	WARS1	100374135	100374265	476	131	38826	6022	38350	5891	3.633587786259542	6.509930402308607
chr14	WARS1	100369086	100369258	0	173	38826	6022	38826	5849	0.0	6.63805778765601
chr14	WARS1	100375282	100375406	0	125	38826	6022	38826	5897	0.0	6.584025775818213
chr14	WARS1	100374135	100374179	24	45	38826	6022	38802	5977	0.5333333333333333	6.491885561318387
chr14	WARS1	100374135	100374244	119	110	38826	6022	38707	5912	1.0818181818181818	6.547192151556157
chr14	WARS1	100375282	100375350	0	69	38826	6022	38826	5953	0.0	6.522089702670923
chr14	WARS1	100365474	100365576	0	103	38826	6022	38826	5919	0.0	6.5595539787126205
chr14	WARS1	100365953	100366067	0	115	38826	6022	38826	5907	0.0	6.572879634332148
chr14	WARS1	100375282	100375403	0	122	38826	6022	38826	5900	0.0	6.580677966101695
chr14	WARS1	100374135	100374149	0	15	38826	6022	38826	6007	0.0	6.463459297486266
chr14	WARS1	100368373	100368465	0	93	38826	6022	38826	5929	0.0	6.548490470568392
chr14	WARS1	100374135	100374220	51	86	38826	6022	38775	5936	0.5930232558139535	6.5321765498652296
chr14	AL132709.7	101074480	101074561	0	82	87	2750	87	2668	0.0	0.03260869565217391
chr14	AL132709.7	101076054	101076138	0	85	87	2750	87	2665	0.0	0.03264540337711069
chr14	MOK	102263545	102263616	0	72	41382	7725	41382	7653	0.0	5.4072912583300665
chr14	MOK	102265822	102265912	612	91	41382	7725	40770	7634	6.725274725274725	5.340581608593136
chr14	MOK	102278605	102278694	34	90	41382	7725	41348	7635	0.37777777777777777	5.415586116568435
chr14	MOK	102277298	102277450	36	153	41382	7725	41346	7572	0.23529411764705882	5.460380348652932
chr14	ATP5MPL	103918004	103918124	0	121	5159	3421	5159	3300	0.0	1.5633333333333332
chr14	ATP5MPL	103920939	103921208	1181	270	5159	3421	3978	3151	4.374074074074074	1.2624563630593462
chr15	LINC01193	20972105	20972149	0	45	983	6672	983	6627	0.0	0.14833257884412254
chr15	LINC01193	20990619	20990728	0	110	983	6672	983	6562	0.0	0.1498018896677842
chr15	LINC01193	20991290	20991437	0	148	983	6672	983	6524	0.0	0.15067443286327406
chr15	LINC01193	20996854	20997026	0	173	983	6672	983	6499	0.0	0.15125403908293583
chr15	LINC01193	20942600	20942740	0	141	983	6672	983	6531	0.0	0.15051293829428877
chr15	LINC01193	20942374	20942560	0	187	983	6672	983	6485	0.0	0.1515805705474171
chr15	LINC01193	20981822	20981980	23	159	983	6672	960	6513	0.14465408805031446	0.14739751266697373
chr15	LINC01193	20979275	20979357	0	83	983	6672	983	6589	0.0	0.14918804067385036
chr15	AC134980.1	22044436	22044825	0	390	444	2337	444	1947	0.0	0.2280431432973806
chr15	AC134980.1	22051534	22051687	0	154	444	2337	444	2183	0.0	0.2033898305084746
chr15	NIPA1	22813632	22813714	0	83	0	8696	0	8613	0.0	0.0
chr15	NIPA1	22814082	22814153	0	72	0	8696	0	8624	0.0	0.0
chr15	NIPA2	22839654	22839790	0	137	40305	4741	40305	4604	0.0	8.754344048653344
chr15	NIPA2	22845145	22845267	670	123	40305	4741	39635	4618	5.4471544715447155	8.5827197921178
chr15	PWRN1	24567891	24568182	0	292	51	22178	51	21886	0.0	0.002330256785159463
chr15	PWRN1	24568530	24568563	0	34	51	22178	51	22144	0.0	0.002303106936416185
chr15	PWRN1	24567896	24568182	0	287	51	22178	51	21891	0.0	0.0023297245443332877
chr15	PWRN1	24580226	24580330	0	105	51	22178	51	22073	0.0	0.002310515108956644
chr15	PWRN1	24587566	24587735	0	170	51	22178	51	22008	0.0	0.002317339149400218
chr15	SNRPN	24942274	24942462	0	189	0	3407	0	3218	0.0	0.0
chr15	SNRPN	24958737	24958868	0	132	0	3407	0	3275	0.0	0.0
chr15	SNHG14	25091589	25091719	0	131	1162	110104	1162	109973	0.0	0.010566229892791866
chr15	SNHG14	25091768	25091931	0	164	1162	110104	1162	109940	0.0	0.010569401491722757
chr15	SNHG14	25089613	25089866	0	254	1162	110104	1162	109850	0.0	0.010578060992262175
chr15	SNHG14	25089911	25090010	0	100	1162	110104	1162	110004	0.0	0.010563252245372896
chr15	SNHG14	25079825	25080079	0	255	1162	110104	1162	109849	0.0	0.010578157288641681
chr15	SNHG14	25080124	25080229	0	106	1162	110104	1162	109998	0.0	0.010563828433244242
chr15	SNHG14	25076856	25076990	0	135	1162	110104	1162	109969	0.0	0.010566614227645973
chr15	SNHG14	25077033	25077316	0	284	1162	110104	1162	109820	0.0	0.010580950646512474
chr15	SNHG14	25086330	25086464	0	135	1162	110104	1162	109969	0.0	0.010566614227645973
chr15	SNHG14	25086509	25086614	0	106	1162	110104	1162	109998	0.0	0.010563828433244242
chr15	SNHG14	25111764	25111894	0	131	1162	110104	1162	109973	0.0	0.010566229892791866
chr15	SNHG14	25115298	25115656	0	359	1162	110104	1162	109745	0.0	0.01058818169392683
chr15	SNHG14	25247866	25248003	0	138	1162	110104	1162	109966	0.0	0.010566902497135478
chr15	SNHG14	25249013	25249147	0	135	1162	110104	1162	109969	0.0	0.010566614227645973
chr15	SNHG14	25381268	25381389	0	122	1162	110104	1162	109982	0.0	0.010565365241584987
chr15	SNHG14	25391595	25391791	0	197	1162	110104	1162	109907	0.0	0.010572574995223235
chr15	CHRNA7	32112239	32112363	0	125	102	13012	102	12887	0.0	0.007914953053464732
chr15	CHRNA7	32153906	32153986	0	81	102	13012	102	12931	0.0	0.00788802103472276
chr15	CHRNA7	32111789	32111899	0	111	102	13012	102	12901	0.0	0.007906363847763739
chr15	CHRNA7	32159568	32159655	0	88	102	13012	102	12924	0.0	0.007892293407613741
chr15	CHRNA7	32163225	32163335	0	111	102	13012	102	12901	0.0	0.007906363847763739
chr15	RYR3	33815833	33815933	0	101	14	19804	14	19703	0.0	0.0007105516926356393
chr15	RYR3	33816861	33816958	0	98	14	19804	14	19706	0.0	0.0007104435197401806
chr15	EMC4	34225535	34225650	0	116	102	2766	102	2650	0.0	0.038490566037735846
chr15	EMC4	34227692	34227846	0	155	102	2766	102	2611	0.0	0.03906549214860207
chr15	CDIN1	36658260	36658294	0	35	102	9162	102	9127	0.0	0.01117563273803002
chr15	CDIN1	36668110	36668219	0	110	102	9162	102	9052	0.0	0.011268228015908087
chr15	RAD51	40701805	40701926	1884	122	7900	2952	6016	2830	15.442622950819672	2.1257950530035337
chr15	RAD51	40706176	40706294	204	119	7900	2952	7696	2833	1.7142857142857142	2.7165548888104483
chr15	ZFYVE19	40809118	40809240	51	123	1383	3308	1332	3185	0.4146341463414634	0.4182103610675039
chr15	ZFYVE19	40809407	40809458	0	52	1383	3308	1383	3256	0.0	0.42475429975429974
chr15	SPINT1	40854059	40854086	0	28	5450	3461	5450	3433	0.0	1.5875327701718613
chr15	SPINT1	40854396	40854522	408	127	5450	3461	5042	3334	3.2125984251968505	1.5122975404919017
chr15	CHP1	41270556	41270618	0	63	31500	3959	31500	3896	0.0	8.085215605749486
chr15	CHP1	41278766	41278889	620	124	31500	3959	30880	3835	5.0	8.052151238591916
chr15	MAPKBP1	41814549	41814739	134	191	256313	9752	256179	9561	0.7015706806282722	26.794163790398493
chr15	MAPKBP1	41815258	41815405	0	148	256313	9752	256313	9604	0.0	26.688150770512287
chr15	CAPN3	42405925	42405943	0	19	102	10244	102	10225	0.0	0.009975550122249389
chr15	CAPN3	42408210	42408324	0	115	102	10244	102	10129	0.0	0.010070095764636192
chr15	CAPN3	42408210	42408437	0	228	102	10244	102	10016	0.0	0.01018370607028754
chr15	HAUS2	42559338	42559408	0	71	18456	4312	18456	4241	0.0	4.351803819853808
chr15	HAUS2	42560781	42560870	0	90	18456	4312	18456	4222	0.0	4.371387967787778
chr15	HAUS2	42558197	42558290	0	94	18456	4312	18456	4218	0.0	4.375533428165007
chr15	HAUS2	42561269	42561402	0	134	18456	4312	18456	4178	0.0	4.417424605074198
chr15	PDIA3	43751583	43751758	0	176	24916	4235	24916	4059	0.0	6.138457748213845
chr15	PDIA3	43752801	43752946	51	146	24916	4235	24865	4089	0.3493150684931507	6.080948887258498
chr15	BLOC1S6	45592134	45592276	0	143	0	6784	0	6641	0.0	0.0
chr15	BLOC1S6	45603099	45603187	0	89	0	6784	0	6695	0.0	0.0
chr15	BLOC1S6	45597879	45597891	0	13	0	6784	0	6771	0.0	0.0
chr15	BLOC1S6	45603103	45603187	0	85	0	6784	0	6699	0.0	0.0
chr15	BLOC1S6	45597879	45597996	0	118	0	6784	0	6666	0.0	0.0
chr15	BLOC1S6	45605427	45605514	0	88	0	6784	0	6696	0.0	0.0
chr15	BLOC1S6	45601233	45601407	0	175	0	6784	0	6609	0.0	0.0
chr15	BLOC1S6	45602356	45602375	0	20	0	6784	0	6764	0.0	0.0
chr15	SEMA6D	47767036	47767093	0	58	0	8530	0	8472	0.0	0.0
chr15	SEMA6D	47768580	47768615	0	36	0	8530	0	8494	0.0	0.0
chr15	SLC12A1	48226475	48226571	0	97	0	8819	0	8722	0.0	0.0
chr15	SLC12A1	48227078	48227174	0	97	0	8819	0	8722	0.0	0.0
chr15	GALK2	49158844	49158968	0	125	156067	7192	156067	7067	0.0	22.083911136267158
chr15	GALK2	49161763	49161861	0	99	156067	7192	156067	7093	0.0	22.002960665444803
chr15	GALK2	49161739	49161861	0	123	156067	7192	156067	7069	0.0	22.07766303579007
chr15	GALK2	49195084	49195214	0	131	156067	7192	156067	7061	0.0	22.10267667469197
chr15	GALK2	49225204	49225349	0	146	156067	7192	156067	7046	0.0	22.149730343457282
chr15	GALK2	49235624	49235739	0	116	156067	7192	156067	7076	0.0	22.05582249858677
chr15	USP8	50424595	50424654	0	60	51	20665	51	20605	0.0	0.002475127396263043
chr15	USP8	50432337	50432499	0	163	51	20665	51	20502	0.0	0.0024875621890547263
chr15	USP8	50441348	50441493	0	146	51	20665	51	20519	0.0	0.0024855012427506215
chr15	USP8	50449399	50449485	0	87	51	20665	51	20578	0.0	0.0024783749635533094
chr15	TCF12	57063749	57063823	0	75	1008	9218	1008	9143	0.0	0.11024827737066609
chr15	TCF12	57072652	57072714	0	63	1008	9218	1008	9155	0.0	0.11010376843255051
chr15	GCOM1	57661449	57661533	0	85	102	8788	102	8703	0.0	0.011720096518441917
chr15	GCOM1	57674967	57675068	0	102	102	8788	102	8686	0.0	0.011743034768593138
chr15	GCOM1	57691898	57691972	0	75	102	8788	102	8713	0.0	0.011706645242740732
chr15	GCOM1	57711983	57712188	0	206	102	8788	102	8582	0.0	0.011885341412258214
chr15	GCOM1	57709184	57709358	0	175	102	8788	102	8613	0.0	0.011842563566701497
chr15	LIPC	58538332	58538517	0	186	51	5004	51	4818	0.0	0.010585305105853052
chr15	LIPC	58541784	58541967	0	184	51	5004	51	4820	0.0	0.01058091286307054
chr15	TPM1	63043468	63043831	51	364	15989	12357	15938	11993	0.1401098901098901	1.3289418827649462
chr15	TPM1	63044026	63044152	0	127	15989	12357	15989	12230	0.0	1.3073589533932952
chr15	TPM1	63043705	63043831	0	127	15989	12357	15989	12230	0.0	1.3073589533932952
chr15	TPM1	63061197	63061273	0	77	15989	12357	15989	12280	0.0	1.3020358306188926
chr15	TPM1	63061712	63061788	32	77	15989	12357	15957	12280	0.4155844155844156	1.29942996742671
chr15	APH1B	63287423	63287546	0	124	0	5418	0	5294	0.0	0.0
chr15	APH1B	63302344	63302472	0	129	0	5418	0	5289	0.0	0.0
chr15	USP3	63529013	63529166	0	154	39125	4757	39125	4603	0.0	8.499891375190094
chr15	USP3	63530497	63530590	0	94	39125	4757	39125	4663	0.0	8.390521123740081
chr15	ZWILCH	66508745	66508892	0	148	0	4786	0	4638	0.0	0.0
chr15	ZWILCH	66513987	66514083	0	97	0	4786	0	4689	0.0	0.0
chr15	IQCH	67304338	67304455	0	118	55177	7149	55177	7031	0.0	7.847674583985208
chr15	IQCH	67336974	67337095	0	122	55177	7149	55177	7027	0.0	7.852141739006688
chr15	EWSAT1	69081185	69081376	49	192	19156	3583	19107	3391	0.2552083333333333	5.634621055735771
chr15	EWSAT1	69089537	69089597	573	61	19156	3583	18583	3522	9.39344262295082	5.276263486655309
chr15	KIF23	69446282	69446364	0	83	0	6339	0	6256	0.0	0.0
chr15	KIF23	69446430	69446587	0	158	0	6339	0	6181	0.0	0.0
chr15	KIF23	69446285	69446364	0	80	0	6339	0	6259	0.0	0.0
chr15	KIF23	69440767	69441079	0	313	0	6339	0	6026	0.0	0.0
chr15	KIF23	69444789	69445041	0	253	0	6339	0	6086	0.0	0.0
chr15	DRAIC	69466099	69466235	0	137	128281	25376	128281	25239	0.0	5.082649867268909
chr15	DRAIC	69467429	69467620	0	192	128281	25376	128281	25184	0.0	5.09375
chr15	DRAIC	69578325	69578461	0	137	128281	25376	128281	25239	0.0	5.082649867268909
chr15	DRAIC	69619508	69619671	0	164	128281	25376	128281	25212	0.0	5.088092971600825
chr15	DRAIC	69464832	69464891	0	60	128281	25376	128281	25316	0.0	5.0671907094327695
chr15	LRRC49	70898366	70898455	0	90	4840	9178	4840	9088	0.0	0.5325704225352113
chr15	LRRC49	70900456	70900582	0	127	4840	9178	4840	9051	0.0	0.5347475417080986
chr15	LRRC49	70963784	70963932	0	149	4840	9178	4840	9029	0.0	0.5360505039317753
chr15	LRRC49	70980100	70980184	291	85	4840	9178	4549	9093	3.4235294117647057	0.5002749367645442
chr15	TMEM202	72398652	72398908	0	257	0	1397	0	1140	0.0	0.0
chr15	TMEM202	72405969	72406039	0	71	0	1397	0	1326	0.0	0.0
chr15	BBS4	72697991	72698037	0	47	51	4162	51	4115	0.0	0.012393681652490888
chr15	BBS4	72704423	72704481	0	59	51	4162	51	4103	0.0	0.012429929320009749
chr15	CD276	73690670	73690776	15	107	66	5220	51	5113	0.14018691588785046	0.00997457461372971
chr15	CD276	73697595	73697702	0	108	66	5220	66	5112	0.0	0.012910798122065728
chr15	SCAMP5	75007587	75007728	0	142	8255	4634	8255	4492	0.0	1.8377114870881568
chr15	SCAMP5	75009890	75009940	0	51	8255	4634	8255	4583	0.0	1.8012219070477853
chr15	SCAMP5	75007660	75007728	0	69	8255	4634	8255	4565	0.0	1.8083242059145674
chr15	SCAMP5	74997233	74997316	0	84	8255	4634	8255	4550	0.0	1.8142857142857143
chr15	PPCDC	75043440	75043536	0	97	153	3493	153	3396	0.0	0.045053003533568906
chr15	PPCDC	75044385	75044514	0	130	153	3493	153	3363	0.0	0.045495093666369314
chr15	AC019294.2	75761168	75761347	33071	180	229473	6185	196402	6005	183.7277777777778	32.70641132389675
chr15	AC019294.2	75761461	75761519	14	59	229473	6185	229459	6126	0.23728813559322035	37.45657851779301
chr15	RCN2	76938725	76938815	51	91	1734	8781	1683	8690	0.5604395604395604	0.19367088607594937
chr15	RCN2	76941636	76941690	0	55	1734	8781	1734	8726	0.0	0.1987164794865918
chr15	PSTPIP1	76999460	76999614	0	155	208	4597	208	4442	0.0	0.04682575416479064
chr15	PSTPIP1	77007846	77008065	0	220	208	4597	208	4377	0.0	0.04752113319625314
chr15	IDH3A	78150803	78150960	0	158	306	5879	306	5721	0.0	0.053487152595700055
chr15	IDH3A	78151288	78151544	0	257	306	5879	306	5622	0.0	0.054429028815368194
chr15	IDH3A	78157547	78157631	0	85	306	5879	306	5794	0.0	0.052813255091473936
chr15	IDH3A	78160091	78160206	0	116	306	5879	306	5763	0.0	0.05309734513274336
chr15	IDH3A	78154434	78154819	0	386	306	5879	306	5493	0.0	0.05570726379027854
chr15	PSMA4	78542176	78542219	0	44	0	5745	0	5701	0.0	0.0
chr15	PSMA4	78542482	78542645	0	164	0	5745	0	5581	0.0	0.0
chr15	PSMA4	78544189	78544267	0	79	0	5745	0	5666	0.0	0.0
chr15	ZFAND6	80075163	80075242	0	80	120388	3588	120388	3508	0.0	34.31812998859749
chr15	ZFAND6	80115026	80115070	0	45	120388	3588	120388	3543	0.0	33.97911374541349
chr15	ZFAND6	80098415	80098578	0	164	120388	3588	120388	3424	0.0	35.16004672897196
chr15	ZFAND6	80073265	80073330	0	66	120388	3588	120388	3522	0.0	34.181714934696195
chr15	ZFAND6	80075163	80075315	0	153	120388	3588	120388	3435	0.0	35.04745269286754
chr15	PDE8A	85089337	85089416	171	80	6403	8029	6232	7949	2.1375	0.7839979871681972
chr15	PDE8A	85091043	85091181	84	139	6403	8029	6319	7890	0.60431654676259	0.8008871989860583
chr15	AKAP13	85658536	85658590	70	55	92711	16938	92641	16883	1.2727272727272727	5.487235680862406
chr15	AKAP13	85662387	85662453	110	67	92711	16938	92601	16871	1.6417910447761195	5.4887677079011326
chr15	ACAN	88860325	88860439	0	115	0	10933	0	10818	0.0	0.0
chr15	ACAN	88868215	88868329	0	115	0	10933	0	10818	0.0	0.0
chr15	MIR9-3HG	89379047	89379269	0	223	0	8103	0	7880	0.0	0.0
chr15	MIR9-3HG	89387430	89387538	0	109	0	8103	0	7994	0.0	0.0
chr15	MIR9-3HG	89379752	89379917	0	166	0	8103	0	7937	0.0	0.0
chr15	MIR9-3HG	89378041	89378165	0	125	0	8103	0	7978	0.0	0.0
chr15	MIR9-3HG	89387430	89387497	0	68	0	8103	0	8035	0.0	0.0
chr15	MIR9-3HG	89386788	89386902	0	115	0	8103	0	7988	0.0	0.0
chr15	CRTC3	90614452	90614488	0	37	19428	10839	19428	10802	0.0	1.7985558229957415
chr15	CRTC3	90617882	90617968	672	87	19428	10839	18756	10752	7.724137931034483	1.7444196428571428
chr15	ST8SIA2	92430048	92430111	0	64	102	5856	102	5792	0.0	0.01761049723756906
chr15	ST8SIA2	92434246	92434375	0	130	102	5856	102	5726	0.0	0.01781348236115962
chr15	CHD2	92991346	92991430	2657	85	53276	16852	50619	16767	31.258823529411764	3.0189658257291105
chr15	CHD2	92991475	92991517	1539	43	53276	16852	51737	16809	35.7906976744186	3.077934439883396
chr15	AC091078.1	93323598	93323651	507	54	10960	7503	10453	7449	9.38888888888889	1.403275607464089
chr15	AC091078.1	93331266	93331432	109	167	10960	7503	10851	7336	0.6526946107784432	1.479143947655398
chr15	AC091078.1	93322222	93322346	0	125	10960	7503	10960	7378	0.0	1.4854974247763622
chr15	AC091078.1	93373509	93373585	0	77	10960	7503	10960	7426	0.0	1.475895502289254
chr15	AC110023.1	93593299	93593359	0	61	0	673	0	612	0.0	0.0
chr15	AC110023.1	93656313	93656437	0	125	0	673	0	548	0.0	0.0
chr15	LINC02207	93844225	93844338	0	114	153	7807	153	7693	0.0	0.0198882100610945
chr15	LINC02207	93864929	93865045	0	117	153	7807	153	7690	0.0	0.01989596879063719
chr15	LINC02207	93839485	93839660	0	176	153	7807	153	7631	0.0	0.02004979688114271
chr15	LINC02207	93844225	93845206	0	982	153	7807	153	6825	0.0	0.02241758241758242
chr15	LINC02207	93844225	93844861	0	637	153	7807	153	7170	0.0	0.021338912133891212
chr15	LINC02207	93874933	93875110	0	178	153	7807	153	7629	0.0	0.02005505308690523
chr15	LINC02207	93877227	93877294	0	68	153	7807	153	7739	0.0	0.01976999612353017
chr15	LINC02207	93858955	93859332	0	378	153	7807	153	7429	0.0	0.020594965675057208
chr15	LINC00924	95497680	95497807	0	128	0	4125	0	3997	0.0	0.0
chr15	LINC00924	95501507	95501651	0	145	0	4125	0	3980	0.0	0.0
chr15	AC087477.2	96361141	96361289	0	149	51	4301	51	4152	0.0	0.012283236994219654
chr15	AC087477.2	96372408	96372608	0	201	51	4301	51	4100	0.0	0.012439024390243903
chr15	MEF2A	99671322	99671454	2932	133	37908	5257	34976	5124	22.045112781954888	6.82591725214676
chr15	MEF2A	99671519	99671657	8764	139	37908	5257	29144	5118	63.05035971223022	5.694411879640485
chr15	MEF2A	99598429	99598511	0	83	37908	5257	37908	5174	0.0	7.326633165829146
chr15	MEF2A	99620890	99621080	0	191	37908	5257	37908	5066	0.0	7.482826687722069
chr15	HERC2P3	20483402	20483517	0	116	3097	9444	3097	9328	0.0	0.33201114922813035
chr15	HERC2P3	20501545	20501714	0	170	3097	9444	3097	9274	0.0	0.3339443605779599
chr15	HERC2P3	20466194	20466370	0	177	3097	9444	3097	9267	0.0	0.3341966116326751
chr15	CYFIP1	22916476	22916630	0	155	202017	10198	202017	10043	0.0	20.115204620133426
chr15	CYFIP1	22916881	22917029	0	149	202017	10198	202017	10049	0.0	20.103194347696288
chr15	UBE3A	25407066	25407262	0	197	0	16169	0	15972	0.0	0.0
chr15	UBE3A	25408619	25408684	0	66	0	16169	0	16103	0.0	0.0
chr15	UBE3A	25409087	25409207	0	121	0	16169	0	16048	0.0	0.0
chr15	UBE3A	25411907	25411971	0	65	0	16169	0	16104	0.0	0.0
chr15	KATNBL1	34165929	34166115	0	187	10641	4853	10641	4666	0.0	2.280540077153879
chr15	KATNBL1	34177820	34177999	0	180	10641	4853	10641	4673	0.0	2.277123903274128
chr15	KATNBL1	34198259	34198331	0	73	10641	4853	10641	4780	0.0	2.2261506276150627
chr15	INO80	41016087	41016215	78	129	61412	5943	61334	5814	0.6046511627906976	10.549363605091159
chr15	INO80	41020899	41021125	18990	227	61412	5943	42422	5716	83.65638766519824	7.421623512946116
chr15	TMEM87A	42231191	42231260	0	70	145172	5620	145172	5550	0.0	26.157117117117117
chr15	TMEM87A	42231843	42231915	0	73	145172	5620	145172	5547	0.0	26.1712637461691
chr15	TTBK2	42840359	42840433	9722	75	75337	12943	65615	12868	129.62666666666667	5.099082996580665
chr15	TTBK2	42872610	42872696	0	87	75337	12943	75337	12856	0.0	5.860065339141257
chr15	PPIP5K1	43560412	43560595	359	184	489	7736	130	7552	1.951086956521739	0.017213983050847457
chr15	PPIP5K1	43564102	43564165	0	64	489	7736	489	7672	0.0	0.06373826903023984
chr15	FRMD5	43891980	43892069	0	90	25088	6396	25088	6306	0.0	3.978433238185855
chr15	FRMD5	43902174	43902262	0	89	25088	6396	25088	6307	0.0	3.9778024417314097
chr15	PATL2	44674149	44674230	0	82	3309	4065	3309	3983	0.0	0.8307808184785338
chr15	PATL2	44674292	44674411	0	120	3309	4065	3309	3945	0.0	0.8387832699619772
chr15	LINC01491	47791106	47791250	0	145	0	1932	0	1787	0.0	0.0
chr15	LINC01491	47803383	47803435	0	53	0	1932	0	1879	0.0	0.0
chr15	FAM227B	49577171	49577305	0	135	24449	5713	24449	5578	0.0	4.383112226604518
chr15	FAM227B	49577628	49577664	0	37	24449	5713	24449	5676	0.0	4.307434813248767
chr15	GABPB1	50314415	50314670	0	256	102	5585	102	5329	0.0	0.01914055169825483
chr15	GABPB1	50346371	50346395	0	25	102	5585	102	5560	0.0	0.018345323741007193
chr15	CYP19A1	51255517	51255761	0	245	5463	7380	5463	7135	0.0	0.7656622284512964
chr15	CYP19A1	51323815	51323924	0	110	5463	7380	5463	7270	0.0	0.7514442916093536
chr15	CYP19A1	51255517	51255708	0	192	5463	7380	5463	7188	0.0	0.760016694490818
chr15	CYP19A1	51278007	51278162	0	156	5463	7380	5463	7224	0.0	0.7562292358803987
chr15	ARPP19	52564189	52564246	0	58	0	6840	0	6782	0.0	0.0
chr15	ARPP19	52568847	52568902	0	56	0	6840	0	6784	0.0	0.0
chr15	ARPP19	52557099	52557222	0	124	0	6840	0	6716	0.0	0.0
chr15	ARPP19	52568847	52568900	0	54	0	6840	0	6786	0.0	0.0
chr15	RSL24D1	55193169	55193231	0	63	21	6103	21	6040	0.0	0.00347682119205298
chr15	RSL24D1	55194152	55194183	21	32	21	6103	0	6071	0.65625	0.0
chr15	RAB27A	55238402	55238491	0	90	61	5247	61	5157	0.0	0.011828582509210782
chr15	RAB27A	55259920	55260023	0	104	61	5247	61	5143	0.0	0.011860781644954306
chr15	ADAM10	58682195	58682314	0	120	102	6078	102	5958	0.0	0.017119838872104734
chr15	ADAM10	58698279	58698404	0	126	102	6078	102	5952	0.0	0.017137096774193547
chr15	GTF2A2	59642135	59642262	255	128	4335	2929	4080	2801	1.9921875	1.4566226347732953
chr15	GTF2A2	59650668	59650773	10	106	4335	2929	4325	2823	0.09433962264150944	1.5320580942260007
chr15	GTF2A2	59650668	59650764	10	97	4335	2929	4325	2832	0.10309278350515463	1.5271892655367232
chr15	GTF2A2	59652205	59652326	68	122	4335	2929	4267	2807	0.5573770491803278	1.5201282508015674
chr15	ANXA2	60390212	60390317	0	106	0	11528	0	11422	0.0	0.0
chr15	ANXA2	60393238	60393440	0	203	0	11528	0	11325	0.0	0.0
chr15	ANXA2	60393012	60393440	0	429	0	11528	0	11099	0.0	0.0
chr15	ANXA2	60396279	60396427	0	149	0	11528	0	11379	0.0	0.0
chr15	ANXA2	60396372	60396427	0	56	0	11528	0	11472	0.0	0.0
chr15	ANXA2	60393037	60393440	0	404	0	11528	0	11124	0.0	0.0
chr15	ANXA2	60397257	60397338	0	82	0	11528	0	11446	0.0	0.0
chr15	ANXA2	60396150	60396427	0	278	0	11528	0	11250	0.0	0.0
chr15	ANXA2	60364428	60364523	0	96	0	11528	0	11432	0.0	0.0
chr15	ANXA2	60386027	60386086	0	60	0	11528	0	11468	0.0	0.0
chr15	ICE2	60477936	60478069	0	134	102	10708	102	10574	0.0	0.00964630225080386
chr15	ICE2	60478567	60478650	0	84	102	10708	102	10624	0.0	0.009600903614457831
chr15	HERC1	63779582	63780009	23	428	31914	16742	31891	16314	0.053738317757009345	1.9548240774794654
chr15	HERC1	63780461	63780552	0	92	31914	16742	31914	16650	0.0	1.9167567567567567
chr15	CSNK1G1	64251511	64251581	0	71	214	9347	214	9276	0.0	0.023070288917636912
chr15	CSNK1G1	64259200	64259241	40	42	214	9347	174	9305	0.9523809523809523	0.018699623858140786
chr15	AC087632.2	64365973	64366075	1243	103	108400	3306	107157	3203	12.067961165048544	33.45519825163909
chr15	AC087632.2	64376742	64376905	0	164	108400	3306	108400	3142	0.0	34.50031826861871
chr15	AC087632.2	64365985	64366075	1111	91	108400	3306	107289	3215	12.208791208791208	33.371384136858474
chr15	AC087632.2	64380957	64381038	84083	82	108400	3306	24317	3224	1025.4024390243903	7.542493796526054
chr15	SPG21	64974601	64974747	10963	147	173158	3998	162195	3851	74.578231292517	42.11763178395222
chr15	SPG21	64976474	64976555	10157	82	173158	3998	163001	3916	123.86585365853658	41.624361593462716
chr15	DPP8	65454262	65454415	143	154	115640	9869	115497	9715	0.9285714285714286	11.888522902727741
chr15	DPP8	65456224	65456371	517	148	115640	9869	115123	9721	3.4932432432432434	11.842711655179508
chr15	INTS14	65605128	65605236	0	109	1689	4223	1689	4114	0.0	0.4105493437044239
chr15	INTS14	65607158	65607442	51	285	1689	4223	1638	3938	0.17894736842105263	0.4159471813103098
chr15	IQCH-AS1	67430320	67430400	0	81	4576	9116	4576	9035	0.0	0.5064748201438849
chr15	IQCH-AS1	67459691	67459975	0	285	4576	9116	4576	8831	0.0	0.5181746121617031
chr15	IQCH-AS1	67466493	67466711	387	219	4576	9116	4189	8897	1.7671232876712328	0.4708328650106778
chr15	CALML4	68199540	68199681	0	142	0	5043	0	4901	0.0	0.0
chr15	CALML4	68205120	68205151	0	32	0	5043	0	5011	0.0	0.0
chr15	CLN6	68211555	68211643	0	89	51	7108	51	7019	0.0	0.007265992306596381
chr15	CLN6	68211674	68211863	51	190	51	7108	0	6918	0.26842105263157895	0.0
chr15	CLN6	68211674	68211921	51	248	51	7108	0	6860	0.2056451612903226	0.0
chr15	CLN6	68214289	68214388	0	100	51	7108	51	7008	0.0	0.007277397260273972
chr15	CLN6	68218535	68218650	0	116	51	7108	51	6992	0.0	0.007294050343249428
chr15	CLN6	68211648	68211863	51	216	51	7108	0	6892	0.2361111111111111	0.0
chr15	PKM	72202453	72202620	0	168	2988	7878	2988	7710	0.0	0.38754863813229573
chr15	PKM	72203021	72203188	0	168	2988	7878	2988	7710	0.0	0.38754863813229573
chr15	CELF6	72288537	72288618	0	82	787	3631	787	3549	0.0	0.221752606367991
chr15	CELF6	72288867	72288930	0	64	787	3631	787	3567	0.0	0.22063358564620128
chr15	HEXA	72346526	72346710	0	185	51	12182	51	11997	0.0	0.0042510627656914225
chr15	HEXA	72347685	72347758	0	74	51	12182	51	12108	0.0	0.00421209117938553
chr15	STRA6	74195301	74195468	0	168	8425	6568	8425	6400	0.0	1.31640625
chr15	STRA6	74195651	74195675	0	25	8425	6568	8425	6543	0.0	1.2876356411432064
chr15	EDC3	74676940	74677022	0	83	49	5102	49	5019	0.0	0.009762900976290097
chr15	EDC3	74687090	74687179	49	90	49	5102	0	5012	0.5444444444444444	0.0
chr15	EDC3	74679801	74679925	0	125	49	5102	49	4977	0.0	0.009845288326300985
chr15	MAN2C1	75365600	75365698	51	99	3097	7504	3046	7405	0.5151515151515151	0.4113436866981769
chr15	MAN2C1	75365961	75366009	0	49	3097	7504	3097	7455	0.0	0.41542588866532526
chr15	SIN3A	75436345	75436443	0	99	4904	12419	4904	12320	0.0	0.39805194805194805
chr15	SIN3A	75443592	75443707	49	116	4904	12419	4855	12303	0.4224137931034483	0.3946191985694546
chr15	SIN3A	75446228	75446395	0	168	4904	12419	4904	12251	0.0	0.4002938535629745
chr15	AC105036.3	75570229	75570346	0	118	0	1101	0	983	0.0	0.0
chr15	AC105036.3	75597339	75597480	0	142	0	1101	0	959	0.0	0.0
chr15	SNUPN	75622341	75622490	0	150	51	3528	51	3378	0.0	0.015097690941385435
chr15	SNUPN	75624714	75624935	0	222	51	3528	51	3306	0.0	0.015426497277676952
chr15	SNUPN	75622341	75622408	0	68	51	3528	51	3460	0.0	0.014739884393063583
chr15	NRG4	76053238	76053369	0	132	15022	3050	15022	2918	0.0	5.14804660726525
chr15	NRG4	76056953	76057019	0	67	15022	3050	15022	2983	0.0	5.0358699296010725
chr15	ETFA	76292618	76292700	0	83	38163	5050	38163	4967	0.0	7.683309844976847
chr15	ETFA	76295590	76295737	0	148	38163	5050	38163	4902	0.0	7.785189718482252
chr15	ETFA	76284364	76284460	0	97	38163	5050	38163	4953	0.0	7.705027256208359
chr15	ETFA	76284804	76284927	0	124	38163	5050	38163	4926	0.0	7.7472594397076735
chr15	TSPAN3	77055788	77055863	0	76	620	6899	620	6823	0.0	0.09086911915579657
chr15	TSPAN3	77056063	77056255	0	193	620	6899	620	6706	0.0	0.09245451834178348
chr15	PEAK1	77252366	77252526	0	161	113021	23394	113021	23233	0.0	4.864675246416735
chr15	PEAK1	77286422	77286504	0	83	113021	23394	113021	23311	0.0	4.8483977521341854
chr15	CIB2	78111164	78111276	0	113	72	2145	72	2032	0.0	0.03543307086614173
chr15	CIB2	78123704	78123739	72	36	72	2145	0	2109	2.0	0.0
chr15	ACSBG1	78208001	78208102	0	102	2448	8170	2448	8068	0.0	0.3034209221616262
chr15	ACSBG1	78226454	78226605	0	152	2448	8170	2448	8018	0.0	0.3053130456472936
chr15	CTSH	78942840	78942930	0	91	136	11133	136	11042	0.0	0.012316609309907625
chr15	CTSH	78944537	78944631	0	95	136	11133	136	11038	0.0	0.012321072658090234
chr15	CTSH	78926781	78926830	0	50	136	11133	136	11083	0.0	0.012271045745736713
chr15	CTSH	78927367	78927436	0	70	136	11133	136	11063	0.0	0.012293229684534033
chr15	CTSH	78926781	78926939	0	159	136	11133	136	10974	0.0	0.012392928740659741
chr15	CTSH	78926781	78926868	0	88	136	11133	136	11045	0.0	0.01231326392032594
chr15	ANKRD34C-AS1	79213186	79213359	0	174	762076	10687	762076	10513	0.0	72.48891848187958
chr15	ANKRD34C-AS1	79260704	79260846	0	143	762076	10687	762076	10544	0.0	72.2757966616085
chr15	AP3B2	82688987	82689112	255	126	1015751	8150	1015496	8024	2.0238095238095237	126.55732801595214
chr15	AP3B2	82689157	82689232	25	76	1015751	8150	1015726	8074	0.32894736842105265	125.80208075303443
chr15	UBE2Q2P1	84561959	84562061	0	103	150	2432	150	2329	0.0	0.064405324173465
chr15	UBE2Q2P1	84569504	84569683	0	180	150	2432	150	2252	0.0	0.06660746003552398
chr15	SEC11A	84670724	84670782	0	59	0	4847	0	4788	0.0	0.0
chr15	SEC11A	84680712	84680832	0	121	0	4847	0	4726	0.0	0.0
chr15	SEC11A	84679225	84679287	0	63	0	4847	0	4784	0.0	0.0
chr15	SEC11A	84679931	84679969	0	39	0	4847	0	4808	0.0	0.0
chr15	SEC11A	84687624	84687774	0	151	0	4847	0	4696	0.0	0.0
chr15	SEC11A	84691969	84692120	0	152	0	4847	0	4695	0.0	0.0
chr15	SEC11A	84714730	84714866	0	137	0	4847	0	4710	0.0	0.0
chr15	LINC01584	86109772	86109919	64	148	199	3080	135	2932	0.43243243243243246	0.04604365620736699
chr15	LINC01584	86110442	86110539	0	98	199	3080	199	2982	0.0	0.06673373574782025
chr15	LINC01584	86109772	86109861	64	90	199	3080	135	2990	0.7111111111111111	0.0451505016722408
chr15	POLG	89320765	89320869	0	105	29	6927	29	6822	0.0	0.0042509527997654645
chr15	POLG	89321961	89322015	29	55	29	6927	0	6872	0.5272727272727272	0.0
chr15	AP3S2	89877305	89877424	2461	120	27629	3566	25168	3446	20.508333333333333	7.303540336622171
chr15	AP3S2	89878264	89878300	0	37	27629	3566	27629	3529	0.0	7.829130065174271
chr15	IDH2	90088586	90088747	0	162	0	2799	0	2637	0.0	0.0
chr15	IDH2	90091552	90091644	0	93	0	2799	0	2706	0.0	0.0
chr15	PRC1	90984017	90984140	0	124	15855	5528	15855	5404	0.0	2.933937823834197
chr15	PRC1	90984692	90984825	8731	134	15855	5528	7124	5394	65.15671641791045	1.3207267334074897
chr15	VPS33B	91016962	91017024	3129	63	25854	3572	22725	3509	49.666666666666664	6.476204046736962
chr15	VPS33B	91017804	91017885	7051	82	25854	3572	18803	3490	85.98780487804878	5.387679083094556
chr15	LINC01197	95257025	95257202	0	178	0	13078	0	12900	0.0	0.0
chr15	LINC01197	95260470	95260574	0	105	0	13078	0	12973	0.0	0.0
chr15	LINC00923	97758489	97758661	0	173	45	13269	45	13096	0.0	0.003436163714111179
chr15	LINC00923	97808991	97809081	45	91	45	13269	0	13178	0.4945054945054945	0.0
chr15	PGPEP1L	98998110	98998163	0	54	0	1634	0	1580	0.0	0.0
chr15	PGPEP1L	99001186	99001279	0	94	0	1634	0	1540	0.0	0.0
chr15	TTC23	99139136	99139266	0	131	1481	5136	1481	5005	0.0	0.2959040959040959
chr15	TTC23	99139316	99139467	0	152	1481	5136	1481	4984	0.0	0.29715088282504015
chr15	TTC23	99139316	99139399	0	84	1481	5136	1481	5052	0.0	0.2931512272367379
chr15	TTC23	99245388	99245510	28	123	1481	5136	1453	5013	0.22764227642276422	0.2898463993616597
chr15	TTC23	99249621	99249799	0	179	1481	5136	1481	4957	0.0	0.2987694169860803
chr15	TTC23	99249170	99249799	0	630	1481	5136	1481	4506	0.0	0.3286728806036396
chr15	TTC23	99241364	99241559	0	196	1481	5136	1481	4940	0.0	0.2997975708502024
chr15	LINS1	100580443	100580736	0	294	102	7512	102	7218	0.0	0.014131338320864505
chr15	LINS1	100580800	100580945	0	146	102	7512	102	7366	0.0	0.013847407005158838
chr16	FAM234A	246956	247069	0	114	45819	5109	45819	4995	0.0	9.172972972972973
chr16	FAM234A	248243	248397	198	155	45819	5109	45621	4954	1.2774193548387096	9.208922083165119
chr16	NME4	397878	397902	25	25	47153	3175	47128	3150	1.0	14.961269841269841
chr16	NME4	398207	398394	0	188	47153	3175	47153	2987	0.0	15.786072982926013
chr16	DECR2	405145	405224	0	80	459	2636	459	2556	0.0	0.1795774647887324
chr16	DECR2	406345	406361	0	17	459	2636	459	2619	0.0	0.17525773195876287
chr16	DECR2	406345	406397	0	53	459	2636	459	2583	0.0	0.17770034843205576
chr16	PIGQ	580182	580263	100	82	22332	6456	22232	6374	1.2195121951219512	3.487919673674302
chr16	PIGQ	580857	580972	40	116	22332	6456	22292	6340	0.3448275862068966	3.5160883280757096
chr16	PIGQ	582247	582309	197	63	22332	6456	22135	6393	3.126984126984127	3.4623807289222586
chr16	HAGHL	728793	728895	0	103	218775	4949	218775	4846	0.0	45.14548080891457
chr16	HAGHL	732657	733159	110358	503	218775	4949	108417	4446	219.39960238568588	24.385290148448043
chr16	UBE2I	1314019	1314096	0	78	0	8510	0	8432	0.0	0.0
chr16	UBE2I	1314292	1314376	0	85	0	8510	0	8425	0.0	0.0
chr16	JPT2	1685438	1685587	0	150	9604	3868	9604	3718	0.0	2.5831091984938137
chr16	JPT2	1691842	1691985	362	144	9604	3868	9242	3724	2.513888888888889	2.4817400644468313
chr16	NUBP2	1783876	1784066	918	191	14368	3124	13450	2933	4.806282722513089	4.585748380497784
chr16	NUBP2	1785638	1785902	3878	265	14368	3124	10490	2859	14.633962264150943	3.6691150752011192
chr16	RNF151	1967724	1967821	0	98	0	983	0	885	0.0	0.0
chr16	RNF151	1967872	1968002	0	131	0	983	0	852	0.0	0.0
chr16	AMDHD2	2527560	2527615	162	56	8096	3044	7934	2988	2.892857142857143	2.6552878179384205
chr16	AMDHD2	2527772	2527985	247	214	8096	3044	7849	2830	1.1542056074766356	2.773498233215548
chr16	IL32	3067553	3067613	0	61	459	2993	459	2932	0.0	0.15654843110504774
chr16	IL32	3067983	3068010	0	28	459	2993	459	2965	0.0	0.1548060708263069
chr16	IL32	3068179	3068239	0	61	459	2993	459	2932	0.0	0.15654843110504774
chr16	IL32	3067376	3067415	0	40	459	2993	459	2953	0.0	0.15543515069420927
chr16	IL32	3067442	3067613	0	172	459	2993	459	2821	0.0	0.16270825948245304
chr16	NAA60	3448470	3448540	714	71	23096	6190	22382	6119	10.056338028169014	3.6577872201340087
chr16	NAA60	3476221	3476337	0	117	23096	6190	23096	6073	0.0	3.8030627367034415
chr16	NAA60	3479470	3479600	0	131	23096	6190	23096	6059	0.0	3.8118501402871763
chr16	NAA60	3462597	3462683	6	87	23096	6190	23090	6103	0.06896551724137931	3.783385220383418
chr16	NAA60	3472158	3472385	0	228	23096	6190	23096	5962	0.0	3.873867829587387
chr16	NAA60	3482501	3482598	0	98	23096	6190	23096	6092	0.0	3.7912015758371633
chr16	CLUAP1	3506330	3506415	0	86	69480	4556	69480	4470	0.0	15.543624161073826
chr16	CLUAP1	3508288	3508468	0	181	69480	4556	69480	4375	0.0	15.881142857142857
chr16	CLUAP1	3504719	3504831	0	113	69480	4556	69480	4443	0.0	15.63808237677245
chr16	HMOX2	4483636	4483754	13	119	51530	3349	51517	3230	0.1092436974789916	15.94953560371517
chr16	HMOX2	4488643	4488742	0	100	51530	3349	51530	3249	0.0	15.860264696829793
chr16	HMOX2	4483636	4483738	0	103	51530	3349	51530	3246	0.0	15.874922982131855
chr16	RBFOX1	6775732	6776011	0	280	51	14371	51	14091	0.0	0.003619331488183947
chr16	RBFOX1	6876661	6876743	0	83	51	14371	51	14288	0.0	0.00356942889137738
chr16	RBFOX1	7664928	7664968	0	41	51	14371	51	14330	0.0	0.003558967201674808
chr16	RBFOX1	7671556	7671599	0	44	51	14371	51	14327	0.0	0.0035597124310741955
chr16	PMM2	8806315	8806407	0	93	0	4133	0	4040	0.0	0.0
chr16	PMM2	8811078	8811178	0	101	0	4133	0	4032	0.0	0.0
chr16	AC012178.1	9468472	9468541	0	70	0	4432	0	4362	0.0	0.0
chr16	AC012178.1	9501723	9501787	0	65	0	4432	0	4367	0.0	0.0
chr16	NUBP1	10752609	10752678	0	70	0	1968	0	1898	0.0	0.0
chr16	NUBP1	10755720	10755753	0	34	0	1968	0	1934	0.0	0.0
chr16	NUBP1	10761756	10761859	0	104	0	1968	0	1864	0.0	0.0
chr16	NUBP1	10767948	10768032	0	85	0	1968	0	1883	0.0	0.0
chr16	MIR193BHG	14323296	14323383	0	88	3194	6057	3194	5969	0.0	0.5350980063662255
chr16	MIR193BHG	14325550	14325590	0	41	3194	6057	3194	6016	0.0	0.5309175531914894
chr16	MIR193BHG	14323224	14323383	0	160	3194	6057	3194	5897	0.0	0.5416313379684585
chr16	MIR193BHG	14325554	14325590	0	37	3194	6057	3194	6020	0.0	0.5305647840531561
chr16	BFAR	14648387	14648592	0	206	72	3298	72	3092	0.0	0.02328589909443726
chr16	BFAR	14649803	14649973	0	171	72	3298	72	3127	0.0	0.023025263831148064
chr16	NDE1	15651468	15651584	0	117	11014	8104	11014	7987	0.0	1.37899086014774
chr16	NDE1	15651930	15652050	0	121	11014	8104	11014	7983	0.0	1.379681823875736
chr16	NDE1	15694164	15694256	0	93	11014	8104	11014	8011	0.0	1.3748595680938709
chr16	NDE1	15696708	15696860	408	153	11014	8104	10606	7951	2.6666666666666665	1.3339202616023143
chr16	NDE1	15699728	15699854	0	127	11014	8104	11014	7977	0.0	1.3807195687601854
chr16	ABCC1	16083365	16083542	0	178	52407	8561	52407	8383	0.0	6.251580579744721
chr16	ABCC1	16086823	16086991	0	169	52407	8561	52407	8392	0.0	6.244876072449952
chr16	NOMO3	16287742	16287862	0	121	24287	10120	24287	9999	0.0	2.428942894289429
chr16	NOMO3	16293651	16293744	0	94	24287	10120	24287	10026	0.0	2.4224017554358666
chr16	TMC5	19487192	19487326	51	135	2294	6198	2243	6063	0.37777777777777777	0.3699488701962725
chr16	TMC5	19490394	19490568	0	175	2294	6198	2294	6023	0.0	0.3808733189440478
chr16	IQCK	19735352	19735450	0	99	174633	5005	174633	4906	0.0	35.59580105992662
chr16	IQCK	19763847	19764112	0	266	174633	5005	174633	4739	0.0	36.85017936273476
chr16	ACSM5	20423915	20424069	0	155	51	3976	51	3821	0.0	0.013347291285003926
chr16	ACSM5	20427787	20427867	0	81	51	3976	51	3895	0.0	0.013093709884467265
chr16	ACSM2A	20452387	20452466	0	80	51	8018	51	7938	0.0	0.006424792139077854
chr16	ACSM2A	20460106	20460291	0	186	51	8018	51	7832	0.0	0.006511746680286006
chr16	REXO5	20806951	20807091	306	141	24784	3857	24478	3716	2.1702127659574466	6.58719052744887
chr16	REXO5	20808787	20808880	917	94	24784	3857	23867	3763	9.75531914893617	6.342545841084242
chr16	LYRM1	20902485	20902717	102	233	3501	3603	3399	3370	0.43776824034334766	1.0086053412462908
chr16	LYRM1	20915555	20915714	204	160	3501	3603	3297	3443	1.275	0.9575951205344176
chr16	TMEM159	21177136	21177327	51	192	600	2567	549	2375	0.265625	0.23115789473684212
chr16	TMEM159	21178796	21178932	255	137	600	2567	345	2430	1.8613138686131387	0.1419753086419753
chr16	VWA3A	22103474	22103529	0	56	4159	5073	4159	5017	0.0	0.8289814630257126
chr16	VWA3A	22109481	22109580	0	100	4159	5073	4159	4973	0.0	0.8363161069776794
chr16	POLR3E	22298952	22299036	3175	85	103930	6743	100755	6658	37.35294117647059	15.132922799639532
chr16	POLR3E	22302930	22303004	0	75	103930	6743	103930	6668	0.0	15.586382723455309
chr16	NPIPB5	22513423	22513521	2222	99	106344	8940	104122	8841	22.444444444444443	11.777174527768352
chr16	NPIPB5	22513521	22513610	1485	90	106344	8940	104859	8850	16.5	11.848474576271187
chr16	NPIPB5	22513521	22513600	1122	80	106344	8940	105222	8860	14.025	11.87607223476298
chr16	NPIPB5	22519137	22519269	3871	133	106344	8940	102473	8807	29.105263157894736	11.635403656182582
chr16	NPIPB5	22519328	22519414	2308	87	106344	8940	104036	8853	26.528735632183906	11.751496667796227
chr16	TNRC6A	24815146	24815305	180	160	41704	12322	41524	12162	1.125	3.414241078769939
chr16	TNRC6A	24815354	24815475	0	122	41704	12322	41704	12200	0.0	3.418360655737705
chr16	LCMT1	25170713	25170805	0	93	23015	2603	23015	2510	0.0	9.169322709163346
chr16	LCMT1	25174936	25175034	534	99	23015	2603	22481	2504	5.393939393939394	8.978035143769969
chr16	IL4R	27318634	27318767	0	134	28368	5144	28368	5010	0.0	5.662275449101797
chr16	IL4R	27330065	27330198	250	134	28368	5144	28118	5010	1.8656716417910448	5.612375249500998
chr16	ALDOA	30065875	30065927	555	53	9775	2724	9220	2671	10.471698113207546	3.4518906776488207
chr16	ALDOA	30066884	30067038	1990	155	9775	2724	7785	2569	12.838709677419354	3.0303620085636434
chr16	AC093512.2	30054783	30054927	0	145	2956	3371	2956	3226	0.0	0.9163050216986981
chr16	AC093512.2	30055171	30055327	0	157	2956	3371	2956	3214	0.0	0.9197261978842564
chr16	CORO1A	30186597	30186720	0	124	68	3668	68	3544	0.0	0.019187358916478554
chr16	CORO1A	30186815	30186945	0	131	68	3668	68	3537	0.0	0.019225332202431437
chr16	TGFB1I1	31473440	31473556	4791	117	62014	4233	57223	4116	40.94871794871795	13.902575315840622
chr16	TGFB1I1	31473681	31473734	822	54	62014	4233	61192	4179	15.222222222222221	14.642737497008854
chr16	TGFB1I1	31473834	31473977	3132	144	62014	4233	58882	4089	21.75	14.40009782342871
chr16	TGFB1I1	31474151	31474239	925	89	62014	4233	61089	4144	10.393258426966293	14.741554054054054
chr16	PHKB	47664884	47664975	0	92	8053	10959	8053	10867	0.0	0.7410508880095703
chr16	PHKB	47665941	47666032	0	92	8053	10959	8053	10867	0.0	0.7410508880095703
chr16	AC007614.1	49285482	49285520	0	39	51	24089	51	24050	0.0	0.0021205821205821204
chr16	AC007614.1	49285520	49285623	0	104	51	24089	51	23985	0.0	0.0021263289555972483
chr16	LINC02180	52092262	52092338	0	77	0	2068	0	1991	0.0	0.0
chr16	LINC02180	52094958	52095073	0	116	0	2068	0	1952	0.0	0.0
chr16	LINC02180	52092526	52092649	0	124	0	2068	0	1944	0.0	0.0
chr16	LINC02180	52092262	52092336	0	75	0	2068	0	1993	0.0	0.0
chr16	LINC02180	52092262	52092342	0	81	0	2068	0	1987	0.0	0.0
chr16	CHD9	53319812	53319951	690	140	7725	15474	7035	15334	4.928571428571429	0.4587844006782314
chr16	CHD9	53321162	53321217	0	56	7725	15474	7725	15418	0.0	0.5010377480866519
chr16	FTO	53933984	53934109	0	126	2298	14928	2298	14802	0.0	0.1552492906364005
chr16	FTO	54013377	54013511	0	135	2298	14928	2298	14793	0.0	0.15534374366254308
chr16	FTO	53984937	53984954	0	18	2298	14928	2298	14910	0.0	0.15412474849094568
chr16	FTO	54061661	54061720	0	60	2298	14928	2298	14868	0.0	0.15456012913640033
chr16	GNAO1	56328630	56328791	0	162	122	13840	122	13678	0.0	0.008919432665594385
chr16	GNAO1	56334728	56334857	0	130	122	13840	122	13710	0.0	0.008898614150255288
chr16	GNAO1	56235012	56235384	0	373	122	13840	122	13467	0.0	0.009059181703423182
chr16	GNAO1	56255520	56255591	0	72	122	13840	122	13768	0.0	0.008861127251597907
chr16	OGFOD1	56454773	56454921	154	149	59909	5793	59755	5644	1.0335570469798658	10.587349397590362
chr16	OGFOD1	56458547	56458594	0	48	59909	5793	59909	5745	0.0	10.428024369016535
chr16	OGFOD1	56458512	56458594	0	83	59909	5793	59909	5710	0.0	10.491943957968477
chr16	HERPUD1	56939236	56939359	0	124	765	4885	765	4761	0.0	0.16068052930056712
chr16	HERPUD1	56942131	56942237	0	107	765	4885	765	4778	0.0	0.16010883214734198
chr16	HERPUD1	56939894	56940088	0	195	765	4885	765	4690	0.0	0.1631130063965885
chr16	HERPUD1	56940176	56940245	0	70	765	4885	765	4815	0.0	0.1588785046728972
chr16	NLRC5	57055435	57055519	0	85	18664	12006	18664	11921	0.0	1.5656404664038253
chr16	NLRC5	57058064	57058148	0	85	18664	12006	18664	11921	0.0	1.5656404664038253
chr16	RSPRY1	57204503	57205008	1455	506	190126	5008	188671	4502	2.875494071146245	41.90826299422479
chr16	RSPRY1	57207592	57207685	14848	94	190126	5008	175278	4914	157.95744680851064	35.66910866910867
chr16	ADGRG1	57621690	57621845	0	156	809	7445	809	7289	0.0	0.11098916175058307
chr16	ADGRG1	57641590	57641708	0	119	809	7445	809	7326	0.0	0.11042861042861044
chr16	ADGRG1	57641586	57641708	0	123	809	7445	809	7322	0.0	0.11048893744878449
chr16	ADGRG1	57628659	57628802	0	144	809	7445	809	7301	0.0	0.11080673880290372
chr16	ADGRG1	57628636	57628802	0	167	809	7445	809	7278	0.0	0.11115691123935147
chr16	DRC7	57696402	57696594	0	193	36999	4027	36999	3834	0.0	9.650234741784038
chr16	DRC7	57697912	57698152	18952	241	36999	4027	18047	3786	78.6390041493776	4.766772319070259
chr16	USB1	58009928	58010112	0	185	1308	4598	1308	4413	0.0	0.2963970088375255
chr16	USB1	58014272	58014326	0	55	1308	4598	1308	4543	0.0	0.28791547435615233
chr16	AC009107.2	58138416	58138509	0	94	102239	4798	102239	4704	0.0	21.734481292517007
chr16	AC009107.2	58157066	58157188	0	123	102239	4798	102239	4675	0.0	21.869304812834226
chr16	NDRG4	58464821	58465071	0	251	204	7151	204	6900	0.0	0.029565217391304348
chr16	NDRG4	58475611	58475657	0	47	204	7151	204	7104	0.0	0.028716216216216218
chr16	NDRG4	58509153	58509189	0	37	204	7151	204	7114	0.0	0.028675850435760472
chr16	NDRG4	58509300	58509352	0	53	204	7151	204	7098	0.0	0.028740490278951817
chr16	NDRG4	58500987	58501077	0	91	204	7151	204	7060	0.0	0.028895184135977338
chr16	NDRG4	58501947	58502147	0	201	204	7151	204	6950	0.0	0.02935251798561151
chr16	NDRG4	58501944	58502147	0	204	204	7151	204	6947	0.0	0.02936519360875198
chr16	CKLF	66558189	66558348	0	160	102	1167	102	1007	0.0	0.1012909632571996
chr16	CKLF	66563121	66563217	0	97	102	1167	102	1070	0.0	0.09532710280373832
chr16	CMTM1	66574939	66575137	700	199	2039	1471	1339	1272	3.5175879396984926	1.0526729559748427
chr16	CMTM1	66577103	66577202	0	100	2039	1471	2039	1371	0.0	1.487235594456601
chr16	CMTM1	66571136	66571270	0	135	2039	1471	2039	1336	0.0	1.526197604790419
chr16	CMTM1	66569935	66570094	400	160	2039	1471	1639	1311	2.5	1.250190694126621
chr16	CMTM1	66571150	66571270	0	121	2039	1471	2039	1350	0.0	1.5103703703703704
chr16	HSF4	67167302	67167402	0	101	27639	2898	27639	2797	0.0	9.88165892027172
chr16	HSF4	67167474	67167599	1	126	27639	2898	27638	2772	0.007936507936507936	9.97041847041847
chr16	HSF4	67167823	67167947	0	125	27639	2898	27639	2773	0.0	9.967183555715831
chr16	HSF4	67167460	67167599	1	140	27639	2898	27638	2758	0.007142857142857143	10.02102973168963
chr16	ELMO3	67199950	67200001	166	52	63032	2551	62866	2499	3.1923076923076925	25.156462585034014
chr16	ELMO3	67200191	67200361	9194	171	63032	2551	53838	2380	53.76608187134503	22.621008403361344
chr16	TSNAXIP1	67821098	67821225	0	128	255	3696	255	3568	0.0	0.07146860986547085
chr16	TSNAXIP1	67824582	67824779	0	198	255	3696	255	3498	0.0	0.07289879931389365
chr16	NFATC3	68214328	68214432	416	105	28113	8798	27697	8693	3.961904761904762	3.1861267686644426
chr16	NFATC3	68221195	68221284	0	90	28113	8798	28113	8708	0.0	3.2284106568672484
chr16	PRMT7	68321425	68321462	650	38	96056	8534	95406	8496	17.105263157894736	11.2295197740113
chr16	PRMT7	68324682	68324832	3466	151	96056	8534	92590	8383	22.95364238410596	11.044971967076226
chr16	PRMT7	68312041	68312176	255	136	96056	8534	95801	8398	1.875	11.407597046915932
chr16	PRMT7	68315896	68316074	4859	179	96056	8534	91197	8355	27.145251396648046	10.915260323159785
chr16	PRMT7	68329065	68329174	565	110	96056	8534	95491	8424	5.136363636363637	11.335588793922128
chr16	CDH1	68808692	68808848	0	157	64	5466	64	5309	0.0	0.01205500094179695
chr16	CDH1	68810196	68810341	0	146	64	5466	64	5320	0.0	0.012030075187969926
chr16	SNTB2	69260049	69260127	0	79	28812	9427	28812	9348	0.0	3.0821566110397947
chr16	SNTB2	69260170	69260260	0	91	28812	9427	28812	9336	0.0	3.0861182519280206
chr16	CYB5B	69447149	69447278	0	130	1871	6812	1871	6682	0.0	0.28000598623166717
chr16	CYB5B	69459092	69459121	205	30	1871	6812	1666	6782	6.833333333333333	0.24565025066352109
chr16	DDX19A	70356111	70356247	156	137	12443	5294	12287	5157	1.1386861313868613	2.3825867752569323
chr16	DDX19A	70361417	70361510	0	94	12443	5294	12443	5200	0.0	2.3928846153846153
chr16	FCSK	70457912	70457975	0	64	4898	7256	4898	7192	0.0	0.6810344827586207
chr16	FCSK	70462172	70462292	255	121	4898	7256	4643	7135	2.1074380165289255	0.6507358093903294
chr16	IST1	71923287	71923384	0	98	66666	7331	66666	7233	0.0	9.216922438822065
chr16	IST1	71924768	71924817	0	50	66666	7331	66666	7281	0.0	9.15615986814998
chr16	HP	72056529	72056631	1070	103	104142	3591	103072	3488	10.388349514563107	29.55045871559633
chr16	HP	72058253	72058355	13680	103	104142	3591	90462	3488	132.81553398058253	25.93520642201835
chr16	HP	72057391	72057466	9803	76	104142	3591	94339	3515	128.98684210526315	26.838975817923185
chr16	HP	72059113	72059188	3508	76	104142	3591	100634	3515	46.1578947368421	28.6298719772404
chr16	LINC01568	73408186	73408393	0	208	0	6893	0	6685	0.0	0.0
chr16	LINC01568	73420092	73420230	0	139	0	6893	0	6754	0.0	0.0
chr16	LINC01568	73404397	73404533	0	137	0	6893	0	6756	0.0	0.0
chr16	LINC01568	73420098	73420230	0	133	0	6893	0	6760	0.0	0.0
chr16	LINC01568	73400138	73400269	0	132	0	6893	0	6761	0.0	0.0
chr16	LINC01568	73409680	73409942	0	263	0	6893	0	6630	0.0	0.0
chr16	ZFP1	75152908	75152966	0	59	153	3766	153	3707	0.0	0.04127326679255463
chr16	ZFP1	75166769	75166896	0	128	153	3766	153	3638	0.0	0.04205607476635514
chr16	NUDT7	77735393	77735507	0	115	0	1645	0	1530	0.0	0.0
chr16	NUDT7	77735827	77735986	0	160	0	1645	0	1485	0.0	0.0
chr16	WWOX	78164182	78164289	0	108	204	4894	204	4786	0.0	0.04262432093606352
chr16	WWOX	78756939	78757015	0	77	204	4894	204	4817	0.0	0.042350010379904504
chr16	LINC01229	79687509	79687635	0	127	0	9960	0	9833	0.0	0.0
chr16	LINC01229	79713835	79714134	0	300	0	9960	0	9660	0.0	0.0
chr16	LINC01229	79726356	79726676	0	321	0	9960	0	9639	0.0	0.0
chr16	LINC01229	79795102	79795297	0	196	0	9960	0	9764	0.0	0.0
chr16	CDH13	82639359	82639465	0	107	0	11050	0	10943	0.0	0.0
chr16	CDH13	82705061	82705274	0	214	0	11050	0	10836	0.0	0.0
chr16	CDH13	82719361	82719475	0	115	0	11050	0	10935	0.0	0.0
chr16	CDH13	83032009	83032218	0	210	0	11050	0	10840	0.0	0.0
chr16	CDH13	83125384	83125501	0	118	0	11050	0	10932	0.0	0.0
chr16	USP10	84704739	84704860	0	122	107200	4768	107200	4646	0.0	23.073611708996985
chr16	USP10	84733052	84733105	0	54	107200	4768	107200	4714	0.0	22.74077216801018
chr16	USP10	84732467	84732589	0	123	107200	4768	107200	4645	0.0	23.078579117330463
chr16	USP10	84772540	84772685	92	146	107200	4768	107108	4622	0.6301369863013698	23.173517957594115
chr16	USP10	84775159	84775225	0	67	107200	4768	107200	4701	0.0	22.80365879600085
chr16	ZNF778	89223156	89223283	1	128	5739	11351	5738	11223	0.0078125	0.5112714960349283
chr16	ZNF778	89224718	89224802	0	85	5739	11351	5739	11266	0.0	0.5094088407598083
chr16	ZNF778	89222091	89222183	306	93	5739	11351	5433	11258	3.2903225806451615	0.4825901581097886
chr16	SPG7	89536764	89536948	0	185	25176	18796	25176	18611	0.0	1.3527483746171618
chr16	SPG7	89540943	89541384	769	442	25176	18796	24407	18354	1.739819004524887	1.3297918709818024
chr16	SPG7	89524005	89524247	575	243	25176	18796	24601	18553	2.366255144032922	1.3259850159003934
chr16	SPG7	89529134	89529524	30	391	25176	18796	25146	18405	0.07672634271099744	1.3662591687041565
chr16	SPG7	89526328	89526468	0	141	25176	18796	25176	18655	0.0	1.3495577593138568
chr16	SPG7	89540943	89542279	769	1337	25176	18796	24407	17459	0.575168287210172	1.397960937052523
chr16	SPG7	89540943	89541346	769	404	25176	18796	24407	18392	1.9034653465346534	1.3270443671161374
chr16	SPG7	89548979	89549336	164	358	25176	18796	25012	18438	0.4581005586592179	1.3565462631521856
chr16	SPG7	89549499	89549713	153	215	25176	18796	25023	18581	0.7116279069767442	1.3466982401377752
chr16	SPG7	89549080	89549336	102	257	25176	18796	25074	18539	0.3968871595330739	1.352500134850855
chr16	CDK10	89687448	89687548	0	101	189	5398	189	5297	0.0	0.03568057390976024
chr16	CDK10	89687588	89687815	0	228	189	5398	189	5170	0.0	0.03655705996131528
chr16	CDK10	89689251	89689324	0	74	189	5398	189	5324	0.0	0.035499624342599546
chr16	DEF8	89949416	89949513	748	98	142694	5553	141946	5455	7.63265306122449	26.021264894592118
chr16	DEF8	89954242	89954376	1071	135	142694	5553	141623	5418	7.933333333333334	26.13935031376892
chr16	DEF8	89954288	89954376	621	89	142694	5553	142073	5464	6.977528089887641	26.001647144948755
chr16	DEF8	89949564	89949638	112	75	142694	5553	142582	5478	1.4933333333333334	26.028112449799195
chr16	DEF8	89950066	89950306	390	241	142694	5553	142304	5312	1.6182572614107884	26.789156626506024
chr16	DEF8	89952557	89952682	51	126	142694	5553	142643	5427	0.40476190476190477	26.28395061728395
chr16	DEF8	89950066	89950328	561	263	142694	5553	142133	5290	2.1330798479087454	26.868241965973535
chr16	DEF8	89952561	89952682	51	122	142694	5553	142643	5431	0.4180327868852459	26.264592156140672
chr16	AFG3L1P	89977638	89977802	8632	165	4130458	8480	4121826	8315	52.31515151515151	495.7096812988575
chr16	AFG3L1P	89978809	89978878	296	70	4130458	8480	4130162	8410	4.228571428571429	491.1013079667063
chr16	NPRL3	119125	119255	0	131	35931	5493	35931	5362	0.0	6.701044386422977
chr16	NPRL3	130521	130591	171	71	35931	5493	35760	5422	2.408450704225352	6.595352268535596
chr16	NPRL3	117300	117375	133	76	35931	5493	35798	5417	1.75	6.608454864316042
chr16	NPRL3	123506	123545	0	40	35931	5493	35931	5453	0.0	6.589216944801027
chr16	NPRL3	124936	125073	49	138	35931	5493	35882	5355	0.35507246376811596	6.700653594771242
chr16	RGS11	274213	274265	0	53	26270	4272	26270	4219	0.0	6.226593979616022
chr16	RGS11	274956	275082	0	127	26270	4272	26270	4145	0.0	6.337756332931242
chr16	METTL26	635280	635340	0	61	3671	1123	3671	1062	0.0	3.4566854990583806
chr16	METTL26	635611	635774	1275	164	3671	1123	2396	959	7.774390243902439	2.4984358706986445
chr16	METTL26	634888	634956	0	69	3671	1123	3671	1054	0.0	3.48292220113852
chr16	METTL26	635517	635774	1425	258	3671	1123	2246	865	5.523255813953488	2.5965317919075144
chr16	LMF1	931641	931793	0	153	1722	8238	1722	8085	0.0	0.21298701298701297
chr16	LMF1	933990	934145	0	156	1722	8238	1722	8082	0.0	0.21306607275426875
chr16	RPS2	1962735	1962909	0	175	51	1934	51	1759	0.0	0.028993746446844798
chr16	RPS2	1963148	1963256	0	109	51	1934	51	1825	0.0	0.027945205479452055
chr16	RPS2	1962496	1962656	0	161	51	1934	51	1773	0.0	0.028764805414551606
chr16	ERVK13-1	2663083	2663407	612	325	42024	6668	41412	6343	1.883076923076923	6.528771874507331
chr16	ERVK13-1	2669410	2669561	1894	152	42024	6668	40130	6516	12.460526315789474	6.158686310620013
chr16	ERVK13-1	2663083	2663430	612	348	42024	6668	41412	6320	1.7586206896551724	6.55253164556962
chr16	ERVK13-1	2670863	2670974	112	112	42024	6668	41912	6556	1.0	6.392922513727883
chr16	ERVK13-1	2671023	2671231	380	209	42024	6668	41644	6459	1.8181818181818181	6.447437683851989
chr16	ERVK13-1	2670809	2670974	257	166	42024	6668	41767	6502	1.5481927710843373	6.423715779760074
chr16	ERVK13-1	2671344	2672570	5944	1227	42024	6668	36080	5441	4.844335778321108	6.631133982723764
chr16	ERVK13-1	2672706	2672859	3619	154	42024	6668	38405	6514	23.5	5.8957629720601785
chr16	ERVK13-1	2669410	2672570	12467	3161	42024	6668	29557	3507	3.9440050616893387	8.42800114057599
chr16	ERVK13-1	2671594	2672570	2438	977	42024	6668	39586	5691	2.49539406345957	6.955895273238447
chr16	ZSCAN10	3092048	3092316	0	269	34	3080	34	2811	0.0	0.012095339736748489
chr16	ZSCAN10	3092541	3093004	0	464	34	3080	34	2616	0.0	0.012996941896024464
chr16	ZSCAN10	3092676	3093004	0	329	34	3080	34	2751	0.0	0.012359142130134497
chr16	MEFV	3251956	3252049	306	94	2408	4838	2102	4744	3.25531914893617	0.4430860033726813
chr16	MEFV	3254157	3254790	0	634	2408	4838	2408	4204	0.0	0.5727878211227403
chr16	LINC01569	4248251	4248428	0	178	51	2431	51	2253	0.0	0.022636484687083888
chr16	LINC01569	4251321	4252034	0	714	51	2431	51	1717	0.0	0.0297029702970297
chr16	NMRAL1	4469226	4469465	0	240	5841	3199	5841	2959	0.0	1.9739776951672863
chr16	NMRAL1	4469503	4469698	0	196	5841	3199	5841	3003	0.0	1.945054945054945
chr16	ANKS3	4726658	4726780	999	123	48341	6948	47342	6825	8.121951219512194	6.936556776556777
chr16	ANKS3	4726978	4727177	468	200	48341	6948	47873	6748	2.34	7.094398340248962
chr16	ANKS3	4724749	4724831	20	83	48341	6948	48321	6865	0.24096385542168675	7.038747268754552
chr16	ANKS3	4729979	4730151	9475	173	48341	6948	38866	6775	54.76878612716763	5.736678966789668
chr16	NAGPA	5028879	5029008	0	130	204	4883	204	4753	0.0	0.0429202608878603
chr16	NAGPA	5031744	5031884	0	141	204	4883	204	4742	0.0	0.04301982285955293
chr16	EEF2KMT	5091793	5091895	0	103	51	2853	51	2750	0.0	0.018545454545454546
chr16	EEF2KMT	5093483	5093564	0	82	51	2853	51	2771	0.0	0.018404907975460124
chr16	TVP23A	10774951	10775547	0	597	0	5785	0	5188	0.0	0.0
chr16	TVP23A	10808536	10808606	0	71	0	5785	0	5714	0.0	0.0
chr16	TVP23A	10774951	10775096	0	146	0	5785	0	5639	0.0	0.0
chr16	TVP23A	10770271	10770331	0	61	0	5785	0	5724	0.0	0.0
chr16	TVP23A	10771669	10771798	0	130	0	5785	0	5655	0.0	0.0
chr16	LITAF	11556510	11556735	0	226	561	4952	561	4726	0.0	0.11870503597122302
chr16	LITAF	11575405	11575586	0	182	561	4952	561	4770	0.0	0.11761006289308176
chr16	LITAF	11561145	11561574	0	430	561	4952	561	4522	0.0	0.12406015037593984
chr16	LITAF	11584189	11584332	0	144	561	4952	561	4808	0.0	0.11668053244592345
chr16	TXNDC11	11703669	11703750	0	82	580	3727	580	3645	0.0	0.15912208504801098
chr16	TXNDC11	11721313	11721435	0	123	580	3727	580	3604	0.0	0.1609322974472808
chr16	BCAR4	11821637	11821755	0	119	22353	1241	22353	1122	0.0	19.922459893048128
chr16	BCAR4	11828321	11828391	0	71	22353	1241	22353	1170	0.0	19.105128205128207
chr16	BCAR4	11828321	11828606	204	286	22353	1241	22149	955	0.7132867132867133	23.19267015706806
chr16	PARN	14588097	14588172	0	76	31291	8816	31291	8740	0.0	3.5802059496567504
chr16	PARN	14591912	14592033	0	122	31291	8816	31291	8694	0.0	3.599148838279273
chr16	PARN	14558372	14558489	0	118	31291	8816	31291	8698	0.0	3.597493676707289
chr16	PARN	14578530	14578628	0	99	31291	8816	31291	8717	0.0	3.5896524033497763
chr16	PARN	14604145	14604226	14	82	31291	8816	31277	8734	0.17073170731707318	3.5810625143118844
chr16	PARN	14606483	14606526	0	44	31291	8816	31291	8772	0.0	3.5671454628362973
chr16	PKD1P6	15135648	15135755	0	108	469759	6041	469759	5933	0.0	79.17731333220968
chr16	PKD1P6	15135973	15136131	0	159	469759	6041	469759	5882	0.0	79.86382182930976
chr16	CEP20	15879803	15879888	0	86	51	2398	51	2312	0.0	0.022058823529411766
chr16	CEP20	15884007	15884205	0	199	51	2398	51	2199	0.0	0.023192360163710776
chr16	CEP20	15873490	15873627	0	138	51	2398	51	2260	0.0	0.02256637168141593
chr16	GP2	20323380	20323389	0	10	0	4061	0	4051	0.0	0.0
chr16	GP2	20323815	20324256	0	442	0	4061	0	3619	0.0	0.0
chr16	GP2	20323815	20324202	0	388	0	4061	0	3673	0.0	0.0
chr16	GP2	20326337	20326467	0	131	0	4061	0	3930	0.0	0.0
chr16	GP2	20323815	20324061	0	247	0	4061	0	3814	0.0	0.0
chr16	ACSM2B	20564668	20564853	0	186	51	7431	51	7245	0.0	0.007039337474120083
chr16	ACSM2B	20575421	20575500	0	80	51	7431	51	7351	0.0	0.0069378315875391105
chr16	NPIPB3	21419489	21419575	299	87	47286	4575	46987	4488	3.4367816091954024	10.469474153297682
chr16	NPIPB3	21419634	21419766	1500	133	47286	4575	45786	4442	11.278195488721805	10.307519135524538
chr16	NPIPB4	21851769	21851855	617	87	47981	7314	47364	7227	7.091954022988506	6.553756745537568
chr16	NPIPB4	21851914	21852046	939	133	47981	7314	47042	7181	7.06015037593985	6.550898203592815
chr16	NPIPB4	21857579	21857658	167	80	47981	7314	47814	7234	2.0875	6.609621233066077
chr16	NPIPB4	21857658	21857756	38	99	47981	7314	47943	7215	0.3838383838383838	6.644906444906445
chr16	EARS2	23553043	23553123	0	81	166472	4213	166472	4132	0.0	40.288480154888674
chr16	EARS2	23556889	23556927	0	39	166472	4213	166472	4174	0.0	39.88308576904648
chr16	EARS2	23553006	23553123	0	118	166472	4213	166472	4095	0.0	40.65250305250305
chr16	ARHGAP17	24927683	24927732	32	50	357245	9674	357213	9624	0.64	37.116895261845386
chr16	ARHGAP17	24929612	24929660	120	49	357245	9674	357125	9625	2.4489795918367347	37.103896103896105
chr16	CLN3	28479461	28479586	0	126	183736	5985	183736	5859	0.0	31.359617682198326
chr16	CLN3	28479643	28479765	171	123	183736	5985	183565	5862	1.3902439024390243	31.3143978164449
chr16	CLN3	28487661	28487741	0	81	183736	5985	183736	5904	0.0	31.12059620596206
chr16	CLN3	28488590	28488662	30808	73	183736	5985	152928	5912	422.027397260274	25.867388362652232
chr16	CLN3	28479643	28479741	151	99	183736	5985	183585	5886	1.5252525252525253	31.190112130479104
chr16	CLN3	28486346	28486490	561	145	183736	5985	183175	5840	3.8689655172413793	31.36558219178082
chr16	CLN3	28486577	28486650	561	74	183736	5985	183175	5911	7.581081081081081	30.988834376586027
chr16	CLN3	28489289	28489386	0	98	183736	5985	183736	5887	0.0	31.210463733650418
chr16	CLN3	28491481	28491560	816	80	183736	5985	182920	5905	10.2	30.97713801862828
chr16	NPIPB12	29488022	29488091	51	70	48626	4334	48575	4264	0.7285714285714285	11.39188555347092
chr16	NPIPB12	29488408	29488510	0	103	48626	4334	48626	4231	0.0	11.492791302292602
chr16	NPIPB12	29499997	29500083	586	87	48626	4334	48040	4247	6.735632183908046	11.311514009889335
chr16	NPIPB12	29500142	29500274	2001	133	48626	4334	46625	4201	15.045112781954888	11.098547964770292
chr16	AKTIP	53501520	53501570	0	51	36041	4978	36041	4927	0.0	7.314998985183681
chr16	AKTIP	53502699	53503044	0	346	36041	4978	36041	4632	0.0	7.78087219343696
chr16	AC040168.1	56161887	56162106	0	220	153	8683	153	8463	0.0	0.018078695498050336
chr16	AC040168.1	56187602	56187700	0	99	153	8683	153	8584	0.0	0.01782385834109972
chr16	PSME3IP1	57174619	57174688	261	70	71894	3087	71633	3017	3.7285714285714286	23.74312230692741
chr16	PSME3IP1	57175538	57175590	972	53	71894	3087	70922	3034	18.339622641509433	23.37574159525379
chr16	PSME3IP1	57174168	57174286	0	119	71894	3087	71894	2968	0.0	24.223045822102424
chr16	PSME3IP1	57178501	57178852	293	352	71894	3087	71601	2735	0.8323863636363636	26.179524680073126
chr16	PSME3IP1	57178805	57178852	188	48	71894	3087	71706	3039	3.9166666666666665	23.595261599210268
chr16	CIAPIN1	57431150	57431266	0	117	0	3392	0	3275	0.0	0.0
chr16	CIAPIN1	57432486	57432560	0	75	0	3392	0	3317	0.0	0.0
chr16	KIFC3	57785463	57785666	18101	204	120266	7697	102165	7493	88.73039215686275	13.63472574402776
chr16	KIFC3	57788574	57788713	0	140	120266	7697	120266	7557	0.0	15.91451634246394
chr16	KIFC3	57797964	57798022	470	59	120266	7697	119796	7638	7.966101694915254	15.68421052631579
chr16	KIFC3	57798071	57798282	36833	212	120266	7697	83433	7485	173.74056603773585	11.146693386773547
chr16	KIFC3	57797704	57798022	980	319	120266	7697	119286	7378	3.072100313479624	16.167796150718353
chr16	CNOT1	58623281	58623409	0	129	51765	10398	51765	10269	0.0	5.040899795501023
chr16	CNOT1	58624672	58624794	0	123	51765	10398	51765	10275	0.0	5.0379562043795625
chr16	GOT2	58722118	58722278	0	161	4464	3760	4464	3599	0.0	1.2403445401500417
chr16	GOT2	58723745	58723902	0	158	4464	3760	4464	3602	0.0	1.2393114936146585
chr16	BEAN1-AS1	66471376	66471564	0	189	0	1739	0	1550	0.0	0.0
chr16	BEAN1-AS1	66473989	66474173	0	185	0	1739	0	1554	0.0	0.0
chr16	BEAN1-AS1	66471514	66471564	0	51	0	1739	0	1688	0.0	0.0
chr16	TK2	66546146	66546226	0	81	23401	8924	23401	8843	0.0	2.646273888951713
chr16	TK2	66547970	66548065	112	96	23401	8924	23289	8828	1.1666666666666667	2.63808337109198
chr16	TK2	66546104	66546221	0	118	23401	8924	23401	8806	0.0	2.6573926868044517
chr16	TK2	66546146	66546221	0	76	23401	8924	23401	8848	0.0	2.6447784810126582
chr16	TK2	66536963	66537017	0	55	23401	8924	23401	8869	0.0	2.638516179952644
chr16	TK2	66541878	66541953	468	76	23401	8924	22933	8848	6.157894736842105	2.591885171790235
chr16	DYNC1LI2	66742437	66742668	0	232	3080	6030	3080	5798	0.0	0.5312176612625044
chr16	DYNC1LI2	66749196	66749313	0	118	3080	6030	3080	5912	0.0	0.5209742895805142
chr16	TERB1	66796767	66796830	0	64	229202	3451	229202	3387	0.0	67.67109536462947
chr16	TERB1	66800047	66800196	0	150	229202	3451	229202	3301	0.0	69.43411087549228
chr16	NAE1	66827459	66827564	0	106	153	4416	153	4310	0.0	0.035498839907192575
chr16	NAE1	66827979	66828077	0	99	153	4416	153	4317	0.0	0.035441278665740095
chr16	NAE1	66827979	66828142	0	164	153	4416	153	4252	0.0	0.03598306679209784
chr16	NAE1	66827934	66828077	0	144	153	4416	153	4272	0.0	0.03581460674157303
chr16	ATP6V0D1	67445811	67445965	51	155	13854	6487	13803	6332	0.32903225806451614	2.1798799747315223
chr16	ATP6V0D1	67452237	67452360	0	124	13854	6487	13854	6363	0.0	2.1772748703441773
chr16	ATP6V0D1	67444527	67444706	125	180	13854	6487	13729	6307	0.6944444444444444	2.17678769621056
chr16	ATP6V0D1	67453543	67453715	0	173	13854	6487	13854	6314	0.0	2.19417168197656
chr16	ENKD1	67663936	67664062	500	127	17307	2573	16807	2446	3.937007874015748	6.871218315617335
chr16	ENKD1	67664995	67665168	0	174	17307	2573	17307	2399	0.0	7.21425593997499
chr16	RANBP10	67738012	67738035	456	24	42106	6474	41650	6450	19.0	6.457364341085271
chr16	RANBP10	67744264	67744455	51	192	42106	6474	42055	6282	0.265625	6.694524036930914
chr16	RANBP10	67744287	67744455	51	169	42106	6474	42055	6305	0.30177514792899407	6.670103092783505
chr16	RANBP10	67772033	67772086	0	54	42106	6474	42106	6420	0.0	6.558566978193147
chr16	RANBP10	67805427	67805539	0	113	42106	6474	42106	6361	0.0	6.619399465492847
chr16	NQO1	69713027	69713129	0	103	18444	2978	18444	2875	0.0	6.415304347826087
chr16	NQO1	69714963	69715077	0	115	18444	2978	18444	2863	0.0	6.442193503318197
chr16	COG4	70517625	70517740	1169	116	47623	4424	46454	4308	10.077586206896552	10.783194057567316
chr16	COG4	70519648	70519731	0	84	47623	4424	47623	4340	0.0	10.973041474654378
chr16	ZNF19	71478878	71479005	0	128	11609	8775	11609	8647	0.0	1.3425465479357002
chr16	ZNF19	71482081	71482143	2338	63	11609	8775	9271	8712	37.111111111111114	1.0641643709825528
chr16	AP1G1	71808014	71808150	51	137	93793	10941	93742	10804	0.3722627737226277	8.67660125879304
chr16	AP1G1	71808504	71808677	5	174	93793	10941	93788	10767	0.028735632183908046	8.710690071514813
chr16	ZNF821	71864902	71865048	0	147	64247	3268	64247	3121	0.0	20.585389298301827
chr16	ZNF821	71867911	71868037	0	127	64247	3268	64247	3141	0.0	20.454313912766636
chr16	ZNF821	71867892	71868037	0	146	64247	3268	64247	3122	0.0	20.578795643818065
chr16	AC138627.1	74230833	74230886	0	54	102	7414	102	7360	0.0	0.013858695652173913
chr16	AC138627.1	74271720	74271818	0	99	102	7414	102	7315	0.0	0.013943950786056048
chr16	RFWD3	74660931	74661451	1602	521	98553	6472	96951	5951	3.074856046065259	16.29154763905226
chr16	RFWD3	74664623	74664745	28170	123	98553	6472	70383	6349	229.02439024390245	11.085682784690503
chr16	BCAR1	75252234	75252398	0	165	7240	8469	7240	8304	0.0	0.871868978805395
chr16	BCAR1	75264350	75264601	1091	252	7240	8469	6149	8217	4.329365079365079	0.7483266398929049
chr16	KARS1	75642752	75642835	12311	84	211095	3670	198784	3586	146.5595238095238	55.43335192414947
chr16	KARS1	75644282	75644462	0	181	211095	3670	211095	3489	0.0	60.503009458297505
chr16	MAFTRR	79751213	79751276	0	64	102	3915	102	3851	0.0	0.02648662685016879
chr16	MAFTRR	79757650	79757715	0	66	102	3915	102	3849	0.0	0.026500389711613406
chr16	AC105411.1	80160231	80160321	0	91	0	7114	0	7023	0.0	0.0
chr16	AC105411.1	80491216	80491571	0	356	0	7114	0	6758	0.0	0.0
chr16	AC105411.1	80160231	80160306	0	76	0	7114	0	7038	0.0	0.0
chr16	CDYL2	80662744	80662747	0	4	0	8838	0	8834	0.0	0.0
chr16	CDYL2	80679733	80679736	0	4	0	8838	0	8834	0.0	0.0
chr16	CDYL2	80670943	80670946	0	4	0	8838	0	8834	0.0	0.0
chr16	ARLNC1	80841297	80841320	0	24	0	5783	0	5759	0.0	0.0
chr16	ARLNC1	80841894	80842042	0	149	0	5783	0	5634	0.0	0.0
chr16	CMC2	80998284	80998354	0	71	876	11900	876	11829	0.0	0.07405528785188942
chr16	CMC2	81001247	81001334	49	88	876	11900	827	11812	0.5568181818181818	0.07001354554690145
chr16	CMC2	80998284	80998351	0	68	876	11900	876	11832	0.0	0.07403651115618662
chr16	CMC2	80998284	80998473	0	190	876	11900	876	11710	0.0	0.07480785653287789
chr16	ARLNC1	80841061	80841129	0	69	0	5783	0	5714	0.0	0.0
chr16	ARLNC1	80830740	80830757	0	18	0	5783	0	5765	0.0	0.0
chr16	ARLNC1	80837931	80838045	0	115	0	5783	0	5668	0.0	0.0
chr16	ARLNC1	80840899	80840964	0	66	0	5783	0	5717	0.0	0.0
chr16	ARLNC1	80831692	80831876	0	185	0	5783	0	5598	0.0	0.0
chr16	ARLNC1	80840118	80840222	0	105	0	5783	0	5678	0.0	0.0
chr16	CMC2	80980769	80980879	0	111	876	11900	876	11789	0.0	0.07430655695987785
chr16	CMC2	80981805	80981877	0	73	876	11900	876	11827	0.0	0.07406781094106706
chr16	CMC2	80978241	80978415	0	175	876	11900	876	11725	0.0	0.07471215351812367
chr16	CMC2	80997313	80997429	0	117	876	11900	876	11783	0.0	0.07434439446660443
chr16	CMC2	80988539	80988596	0	58	876	11900	876	11842	0.0	0.07397399087991893
chr16	CMC2	80996922	80997020	0	99	876	11900	876	11801	0.0	0.07423099737310397
chr16	CMC2	80991753	80991957	0	205	876	11900	876	11695	0.0	0.07490380504489098
chr16	GCSH	81087600	81087664	6408	65	8547	2011	2139	1946	98.58461538461539	1.0991778006166495
chr16	GCSH	81090600	81090680	52	81	8547	2011	8495	1930	0.6419753086419753	4.401554404145077
chr16	GCSH	81084462	81084594	0	133	8547	2011	8547	1878	0.0	4.55111821086262
chr16	PKD1L2	81177806	81177983	0	178	17821	15813	17821	15635	0.0	1.1398145187080269
chr16	PKD1L2	81179644	81179786	0	143	17821	15813	17821	15670	0.0	1.1372686662412252
chr16	AC009142.1	83396595	83396728	0	134	0	723	0	589	0.0	0.0
chr16	AC009142.1	83397345	83397492	0	148	0	723	0	575	0.0	0.0
chr16	TAF1C	84183696	84183778	0	83	2163	4997	2163	4914	0.0	0.44017094017094016
chr16	TAF1C	84184850	84185060	0	211	2163	4997	2163	4786	0.0	0.45194316757208525
chr16	MEAK7	84502720	84502862	3738	143	31091	7544	27353	7401	26.13986013986014	3.6958519119037967
chr16	MEAK7	84503957	84504147	2303	191	31091	7544	28788	7353	12.057591623036648	3.9151366789065687
chr16	LINC00917	86334903	86334994	0	92	0	5647	0	5555	0.0	0.0
chr16	LINC00917	86335677	86335872	0	196	0	5647	0	5451	0.0	0.0
chr16	LINC00917	86335677	86335853	0	177	0	5647	0	5470	0.0	0.0
chr16	FENDRR	86477885	86478132	0	248	0	6492	0	6244	0.0	0.0
chr16	FENDRR	86478700	86478756	0	57	0	6492	0	6435	0.0	0.0
chr16	MTHFSD	86552032	86552146	0	115	3209	6866	3209	6751	0.0	0.4753369871130203
chr16	MTHFSD	86552178	86552292	0	115	3209	6866	3209	6751	0.0	0.4753369871130203
chr16	MTHFSD	86551972	86552146	0	175	3209	6866	3209	6691	0.0	0.479599461963832
chr16	MTHFSD	86554644	86554748	0	105	3209	6866	3209	6761	0.0	0.4746339298920278
chr16	MTHFSD	86554644	86554751	0	108	3209	6866	3209	6758	0.0	0.47484462858833976
chr16	KLHDC4	87730551	87730644	588	94	38175	8827	37587	8733	6.25531914893617	4.304019237375472
chr16	KLHDC4	87748672	87748809	835	138	38175	8827	37340	8689	6.050724637681159	4.2973875014386005
chr16	PABPN1L	88864852	88864940	0	89	102	1321	102	1232	0.0	0.08279220779220779
chr16	PABPN1L	88865021	88865128	0	108	102	1321	102	1213	0.0	0.08408903544929926
chr16	FANCA	89752137	89752222	1317	86	192118	7815	190801	7729	15.313953488372093	24.686375986544185
chr16	FANCA	89758576	89758705	673	130	192118	7815	191445	7685	5.176923076923077	24.911515940143136
chr16	FANCA	89749729	89749902	0	174	192118	7815	192118	7641	0.0	25.143044104174844
chr17	GLOD4	778621	778661	0	41	979	3270	979	3229	0.0	0.3031898420563642
chr17	GLOD4	778694	778744	213	51	979	3270	766	3219	4.176470588235294	0.23796210003106555
chr17	GLOD4	780683	780738	0	56	979	3270	979	3214	0.0	0.3046048537647791
chr17	GLOD4	781862	782043	0	182	979	3270	979	3088	0.0	0.3170336787564767
chr17	GLOD4	778694	778810	245	117	979	3270	734	3153	2.094017094017094	0.2327941642879797
chr17	INPP5K	1515426	1515585	0	160	55804	5034	55804	4874	0.0	11.449322938038572
chr17	INPP5K	1515887	1516118	0	232	55804	5034	55804	4802	0.0	11.620991253644315
chr17	PITPNA	1541641	1541649	0	9	432790	4776	432790	4767	0.0	90.78875603104677
chr17	PITPNA	1543019	1543027	25	9	432790	4776	432765	4767	2.7777777777777777	90.78351164254248
chr17	ATP2A3	3927980	3928038	0	59	87282	6298	87282	6239	0.0	13.989741945824651
chr17	ATP2A3	3928226	3928327	8347	102	87282	6298	78935	6196	81.83333333333333	12.739670755326017
chr17	ATP2A3	3928239	3928327	7629	89	87282	6298	79653	6209	85.71910112359551	12.828635851183765
chr17	DERL2	5480386	5480582	0	197	1154	5129	1154	4932	0.0	0.23398215733982158
chr17	DERL2	5481100	5481142	0	43	1154	5129	1154	5086	0.0	0.22689736531655524
chr17	AIPL1	6428317	6428506	0	190	102	3150	102	2960	0.0	0.03445945945945946
chr17	AIPL1	6433918	6434098	0	181	102	3150	102	2969	0.0	0.03435500168406871
chr17	KIAA0753	6623508	6623571	0	64	204	5573	204	5509	0.0	0.03703031403158468
chr17	KIAA0753	6623606	6623688	0	83	204	5573	204	5490	0.0	0.03715846994535519
chr17	KIAA0753	6623606	6624006	0	401	204	5573	204	5172	0.0	0.03944315545243619
chr17	ALOX12-AS1	6880909	6881062	0	154	255	5591	255	5437	0.0	0.0469008644473055
chr17	ALOX12-AS1	6926160	6926283	0	124	255	5591	255	5467	0.0	0.0466434973477227
chr17	PIK3R5	8889972	8890126	0	155	56	7453	56	7298	0.0	0.007673335160317895
chr17	PIK3R5	8890737	8890912	0	176	56	7453	56	7277	0.0	0.007695478906142641
chr17	COX10-AS1	13898608	13898732	0	125	0	11234	0	11109	0.0	0.0
chr17	COX10-AS1	14033939	14034416	0	478	0	11234	0	10756	0.0	0.0
chr17	PMP22	15232368	15232613	0	246	0	6135	0	5889	0.0	0.0
chr17	PMP22	15233188	15233355	0	168	0	6135	0	5967	0.0	0.0
chr17	PMP22	15235218	15235284	0	67	0	6135	0	6068	0.0	0.0
chr17	TRIM16	15658801	15658876	0	76	5359	4831	5359	4755	0.0	1.1270241850683491
chr17	TRIM16	15677175	15677280	0	106	5359	4831	5359	4725	0.0	1.1341798941798942
chr17	ZSWIM7	15981039	15981144	22	106	6388	2082	6366	1976	0.20754716981132076	3.22165991902834
chr17	ZSWIM7	15986799	15986892	0	94	6388	2082	6388	1988	0.0	3.2132796780684103
chr17	TOM1L2	17884633	17884768	35	136	12598	7882	12563	7746	0.25735294117647056	1.6218693519235734
chr17	TOM1L2	17893660	17893810	0	151	12598	7882	12598	7731	0.0	1.6295433967145259
chr17	TOM1L2	17882704	17882863	0	160	12598	7882	12598	7722	0.0	1.6314426314426314
chr17	FAM106A	18523776	18523877	216	102	4864	8673	4648	8571	2.1176470588235294	0.5422937813557345
chr17	FAM106A	18528572	18528747	919	176	4864	8673	3945	8497	5.221590909090909	0.46428151112157234
chr17	FAM106A	18527569	18527760	51	192	4864	8673	4813	8481	0.265625	0.5675038320952718
chr17	FAM106A	18521078	18521145	78	68	4864	8673	4786	8605	1.1470588235294117	0.5561882626380011
chr17	FAM106A	18542868	18542987	0	120	4864	8673	4864	8553	0.0	0.5686893487665147
chr17	FAM106A	18542987	18543094	0	108	4864	8673	4864	8565	0.0	0.5678925861062464
chr17	B9D1	19360319	19360388	0	70	785	6772	785	6702	0.0	0.11712921515965384
chr17	B9D1	19371548	19371633	368	86	785	6772	417	6686	4.27906976744186	0.0623691295243793
chr17	LINC02693	21550995	21551116	0	122	3181	11034	3181	10912	0.0	0.2915139296187683
chr17	LINC02693	21573225	21573735	0	511	3181	11034	3181	10523	0.0	0.3022902214197472
chr17	LINC02693	21529021	21529110	0	90	3181	11034	3181	10944	0.0	0.29066154970760233
chr17	LINC02693	21533391	21533510	0	120	3181	11034	3181	10914	0.0	0.2914605094374198
chr17	RAB34	28715194	28715214	0	21	816	3005	816	2984	0.0	0.2734584450402145
chr17	RAB34	28715218	28715276	0	59	816	3005	816	2946	0.0	0.2769857433808554
chr17	RAB34	28715992	28716058	0	67	816	3005	816	2938	0.0	0.27773995915588834
chr17	RAB34	28716902	28716994	0	93	816	3005	816	2912	0.0	0.2802197802197802
chr17	FAM222B	28790377	28790425	0	49	14290	5523	14290	5474	0.0	2.610522469857508
chr17	FAM222B	28834292	28834326	0	35	14290	5523	14290	5488	0.0	2.603862973760933
chr17	FLOT2	28884224	28884315	0	92	0	3397	0	3305	0.0	0.0
chr17	FLOT2	28885856	28885947	0	92	0	3397	0	3305	0.0	0.0
chr17	FLOT2	28888944	28889026	0	83	0	3397	0	3314	0.0	0.0
chr17	MYO18A	29124652	29124688	32	37	136437	15087	136405	15050	0.8648648648648649	9.063455149501662
chr17	MYO18A	29137015	29137084	0	70	136437	15087	136437	15017	0.0	9.085503096490644
chr17	CORO6	29617499	29617619	0	121	261	4103	261	3982	0.0	0.06554495228528377
chr17	CORO6	29618047	29618167	0	121	261	4103	261	3982	0.0	0.06554495228528377
chr17	RFFL	35017522	35017606	0	85	255	6708	255	6623	0.0	0.03850218934017817
chr17	RFFL	35021370	35021781	0	412	255	6708	255	6296	0.0	0.04050190597204574
chr17	RAD51D	35116858	35117037	0	180	153	11317	153	11137	0.0	0.013737990482176528
chr17	RAD51D	35118500	35118619	0	120	153	11317	153	11197	0.0	0.013664374385996249
chr17	RAD51D	35107365	35107447	0	83	153	11317	153	11234	0.0	0.01361936977034004
chr17	RAD51D	35106987	35107122	0	136	153	11317	153	11181	0.0	0.013683928092299437
chr17	SLFN13	35446716	35446753	532	38	63464	9056	62932	9018	14.0	6.978487469505434
chr17	SLFN13	35446839	35446932	467	94	63464	9056	62997	8962	4.968085106382978	7.029346128096407
chr17	RDM1	35922576	35922675	0	100	1556	1650	1556	1550	0.0	1.0038709677419355
chr17	RDM1	35924603	35924772	102	170	1556	1650	1454	1480	0.6	0.9824324324324324
chr17	LHX1-DT	36909455	36909571	211638	117	309834	2527	98196	2410	1808.871794871795	40.74522821576763
chr17	LHX1-DT	36927699	36927805	153	107	309834	2527	309681	2420	1.4299065420560748	127.96735537190082
chr17	DDX52	37635550	37635604	0	55	5309	8334	5309	8279	0.0	0.6412610218625437
chr17	DDX52	37639453	37639568	0	116	5309	8334	5309	8218	0.0	0.6460209296665855
chr17	SRCIN1	38568210	38568231	0	22	297261	11692	297261	11670	0.0	25.472236503856042
chr17	SRCIN1	38574875	38574974	55	100	297261	11692	297206	11592	0.55	25.63888888888889
chr17	CACNB1	39185130	39185150	0	21	51	5588	51	5567	0.0	0.009161128076163105
chr17	CACNB1	39185949	39186104	0	156	51	5588	51	5432	0.0	0.00938880706921944
chr17	PGAP3	39684596	39684749	0	154	1076	3628	1076	3474	0.0	0.3097294185377087
chr17	PGAP3	39685921	39686019	0	99	1076	3628	1076	3529	0.0	0.3049022385945027
chr17	PGAP3	39674616	39674679	78	64	1076	3628	998	3564	1.21875	0.28002244668911336
chr17	IKZF3	39791415	39791583	0	169	0	10138	0	9969	0.0	0.0
chr17	IKZF3	39792672	39792933	0	262	0	10138	0	9876	0.0	0.0
chr17	IKZF3	39777650	39777767	0	118	0	10138	0	10020	0.0	0.0
chr17	IKZF3	39829386	39829488	0	103	0	10138	0	10035	0.0	0.0
chr17	IKZF3	39788257	39788374	0	118	0	10138	0	10020	0.0	0.0
chr17	GSDMB	39906960	39906987	0	28	25530	4922	25530	4894	0.0	5.21659174499387
chr17	GSDMB	39908957	39909042	0	86	25530	4922	25530	4836	0.0	5.279156327543424
chr17	GSDMB	39908175	39908214	0	40	25530	4922	25530	4882	0.0	5.22941417451864
chr17	GSDMB	39909755	39909924	0	170	25530	4922	25530	4752	0.0	5.372474747474747
chr17	MED24	40035721	40035795	0	75	702805	6850	702805	6775	0.0	103.73505535055351
chr17	MED24	40036115	40036154	0	40	702805	6850	702805	6810	0.0	103.20190895741557
chr17	SMARCE1	40642454	40642559	21053	106	93994	10517	72941	10411	198.61320754716982	7.00614734415522
chr17	SMARCE1	40645795	40645847	0	53	93994	10517	93994	10464	0.0	8.982607033639145
chr17	SMARCE1	40645575	40645619	0	45	93994	10517	93994	10472	0.0	8.975744843391903
chr17	KRT23	40936207	40936953	3707	747	102686	2919	98979	2172	4.962516733601071	45.57044198895028
chr17	KRT23	40937127	40937259	122	133	102686	2919	102564	2786	0.9172932330827067	36.814070351758794
chr17	NT5C3B	41827425	41827626	0	202	0	2859	0	2657	0.0	0.0
chr17	NT5C3B	41828789	41828952	0	164	0	2859	0	2695	0.0	0.0
chr17	NT5C3B	41830800	41830890	0	91	0	2859	0	2768	0.0	0.0
chr17	DNAJC7	42000955	42001066	0	112	408	9268	408	9156	0.0	0.04456094364351245
chr17	DNAJC7	42003358	42003557	0	200	408	9268	408	9068	0.0	0.044993383325981476
chr17	RAB5C	42131606	42131822	0	217	2001	2590	2001	2373	0.0	0.843236409608091
chr17	RAB5C	42137761	42137878	41	118	2001	2590	1960	2472	0.3474576271186441	0.7928802588996764
chr17	RETREG3	42586764	42586891	0	128	2779	4732	2779	4604	0.0	0.6036055603822763
chr17	RETREG3	42587833	42587864	0	32	2779	4732	2779	4700	0.0	0.5912765957446808
chr17	RETREG3	42596532	42596627	0	96	2779	4732	2779	4636	0.0	0.5994391716997411
chr17	RETREG3	42609497	42609727	0	231	2779	4732	2779	4501	0.0	0.6174183514774495
chr17	EZH1	42722794	42722915	0	122	482	6587	482	6465	0.0	0.0745552977571539
chr17	EZH1	42727634	42727763	0	130	482	6587	482	6457	0.0	0.07464766919622115
chr17	EZH1	42728824	42728952	0	129	482	6587	482	6458	0.0	0.07463611025085165
chr17	EZH1	42730827	42730918	0	92	482	6587	482	6495	0.0	0.07421093148575827
chr17	EZH1	42724304	42724424	0	121	482	6587	482	6466	0.0	0.0745437673987009
chr17	BECN1	42811654	42811797	1179	144	38488	5109	37309	4965	8.1875	7.514400805639476
chr17	BECN1	42813947	42814008	28	62	38488	5109	38460	5047	0.45161290322580644	7.62036853576382
chr17	LINC00671	42895376	42895493	0	118	119978	2175	119978	2057	0.0	58.32668935342732
chr17	LINC00671	42897686	42897918	340	233	119978	2175	119638	1942	1.4592274678111588	61.605561277033985
chr17	PTGES3L-AARSD1	42971606	42971696	765	91	33710	2312	32945	2221	8.406593406593407	14.833408374606034
chr17	PTGES3L-AARSD1	42979169	42979268	0	100	33710	2312	33710	2212	0.0	15.239602169981916
chr17	BRCA1	43119120	43119265	51	146	26109	8555	26058	8409	0.3493150684931507	3.0988226899750266
chr17	BRCA1	43121557	43121676	0	120	26109	8555	26109	8435	0.0	3.0953171310017784
chr17	BRCA1	43106455	43106533	402	79	26109	8555	25707	8476	5.0886075949367084	3.0329164700330344
chr17	BRCA1	43115725	43115779	372	55	26109	8555	25737	8500	6.763636363636364	3.0278823529411767
chr17	BRCA1	43110464	43110580	0	117	26109	8555	26109	8438	0.0	3.0942166390139842
chr17	BRCA1	43112486	43112606	372	121	26109	8555	25737	8434	3.074380165289256	3.0515769504387005
chr17	CCDC200	43223740	43223835	0	96	96869	3210	96869	3114	0.0	31.10757867694284
chr17	CCDC200	43223900	43224026	0	127	96869	3210	96869	3083	0.0	31.420369769704834
chr17	LINC00910	43381272	43381660	1340	389	248238	8593	246898	8204	3.4447300771208225	30.09483178937104
chr17	LINC00910	43387935	43388057	255	123	248238	8593	247983	8470	2.073170731707317	29.27780401416765
chr17	MPP2	43898261	43898380	0	120	67	6133	67	6013	0.0	0.0111425245301846
chr17	MPP2	43904429	43904493	0	65	67	6133	67	6068	0.0	0.011041529334212262
chr17	MPP2	43898279	43898380	0	102	67	6133	67	6031	0.0	0.011109268777980434
chr17	HDAC5	44092171	44092284	0	114	3691	7417	3691	7303	0.0	0.5054087361358346
chr17	HDAC5	44092380	44092527	0	148	3691	7417	3691	7269	0.0	0.507772733525932
chr17	GPATCH8	44467096	44467114	0	19	6831	9750	6831	9731	0.0	0.7019833521734662
chr17	GPATCH8	44473724	44473759	0	36	6831	9750	6831	9714	0.0	0.7032118591723286
chr17	EFTUD2	44868286	44868350	0	65	2	9782	2	9717	0.0	0.00020582484305855717
chr17	EFTUD2	44868381	44868479	0	99	2	9782	2	9683	0.0	0.00020654755757513167
chr17	GFAP	44913727	44913823	0	97	51	7492	51	7395	0.0	0.006896551724137931
chr17	GFAP	44914027	44914088	0	62	51	7492	51	7430	0.0	0.006864064602960969
chr17	AC005670.3	47035043	47035126	0	84	436388	10495	436388	10411	0.0	41.91605033138027
chr17	AC005670.3	47054117	47054213	0	97	436388	10495	436388	10398	0.0	41.968455472206195
chr17	AC005670.3	47033319	47033381	0	63	436388	10495	436388	10432	0.0	41.831671779141104
chr17	AC005670.3	47033277	47033381	0	105	436388	10495	436388	10390	0.0	42.00076997112608
chr17	COPZ2	48032155	48032233	0	79	170	1877	170	1798	0.0	0.09454949944382647
chr17	COPZ2	48032685	48032741	0	57	170	1877	170	1820	0.0	0.09340659340659341
chr17	SKAP1	48231826	48231902	0	77	19044	2371	19044	2294	0.0	8.301656495204883
chr17	SKAP1	48248886	48249029	66	144	19044	2371	18978	2227	0.4583333333333333	8.521778176919623
chr17	SNF8	48933204	48933346	0	143	27396	4805	27396	4662	0.0	5.876447876447877
chr17	SNF8	48940923	48941062	27105	140	27396	4805	291	4665	193.60714285714286	0.062379421221864954
chr17	SPOP	49636758	49636809	0	52	8	6342	8	6290	0.0	0.0012718600953895071
chr17	SPOP	49675894	49676016	0	123	8	6342	8	6219	0.0	0.0012863804470172053
chr17	SPOP	49668026	49668078	0	53	8	6342	8	6289	0.0	0.0012720623310542216
chr17	SPOP	49646925	49647122	0	198	8	6342	8	6144	0.0	0.0013020833333333333
chr17	TAC4	49839849	49839909	0	61	0	1002	0	941	0.0	0.0
chr17	TAC4	49841551	49841584	0	34	0	1002	0	968	0.0	0.0
chr17	MKS1	58214258	58214387	0	130	30663	8985	30663	8855	0.0	3.462789384528515
chr17	MKS1	58214740	58214838	0	99	30663	8985	30663	8886	0.0	3.450708980418636
chr17	SEPTIN4	58526681	58526978	0	298	59483	6797	59483	6499	0.0	9.15263886751808
chr17	SEPTIN4	58531479	58531551	0	73	59483	6797	59483	6724	0.0	8.846371207614515
chr17	SEPTIN4	58526931	58526978	0	48	59483	6797	59483	6749	0.0	8.81360201511335
chr17	SKA2	59119318	59119495	0	178	2668	3064	2668	2886	0.0	0.9244629244629244
chr17	SKA2	59131280	59131367	0	88	2668	3064	2668	2976	0.0	0.896505376344086
chr17	LINC01476	59451973	59452103	0	131	612	6515	612	6384	0.0	0.09586466165413533
chr17	LINC01476	59502978	59503094	0	117	612	6515	612	6398	0.0	0.09565489215379806
chr17	LINC01476	59434416	59434521	0	106	612	6515	612	6409	0.0	0.09549071618037135
chr17	LINC01476	59433653	59433765	0	113	612	6515	612	6402	0.0	0.09559512652296158
chr17	LINC01476	59449741	59449776	0	36	612	6515	612	6479	0.0	0.09445902145392808
chr17	TUBD1	59886082	59886230	396	149	6604	3345	6208	3196	2.6577181208053693	1.9424280350438048
chr17	TUBD1	59890830	59891041	0	212	6604	3345	6604	3133	0.0	2.107883817427386
chr17	HEATR6	60073961	60074159	102	199	24598	7067	24496	6868	0.5125628140703518	3.5666860803727434
chr17	HEATR6	60075704	60075833	2571	130	24598	7067	22027	6937	19.776923076923076	3.175291912930662
chr17	STRADA	63707246	63707418	0	173	1296	9568	1296	9395	0.0	0.13794571580627993
chr17	STRADA	63710490	63710614	0	125	1296	9568	1296	9443	0.0	0.13724451975007942
chr17	STRADA	63717074	63717154	0	81	1296	9568	1296	9487	0.0	0.13660798988088965
chr17	STRADA	63723297	63723326	0	30	1296	9568	1296	9538	0.0	0.13587754246173203
chr17	STRADA	63726637	63726695	0	59	1296	9568	1296	9509	0.0	0.1362919339573036
chr17	STRADA	63714005	63714108	0	104	1296	9568	1296	9464	0.0	0.13693998309382924
chr17	STRADA	63737395	63737436	0	42	1296	9568	1296	9526	0.0	0.1360487087969767
chr17	STRADA	63741167	63741253	0	87	1296	9568	1296	9481	0.0	0.13669444151460816
chr17	STRADA	63741453	63741663	0	211	1296	9568	1296	9357	0.0	0.13850593138826547
chr17	DDX5	64504221	64504318	518	98	9763	7977	9245	7879	5.285714285714286	1.1733722553623556
chr17	DDX5	64504676	64504842	765	167	9763	7977	8998	7810	4.580838323353293	1.152112676056338
chr17	CASC17	71168613	71168687	0	75	2762	2897	2762	2822	0.0	0.9787384833451452
chr17	CASC17	71185595	71185655	0	61	2762	2897	2762	2836	0.0	0.9739069111424542
chr17	CASC17	71136876	71137010	0	135	2762	2897	2762	2762	0.0	1.0
chr17	CASC17	71132361	71132470	0	110	2762	2897	2762	2787	0.0	0.9910297811266595
chr17	CASC17	71132389	71132470	0	82	2762	2897	2762	2815	0.0	0.9811722912966252
chr17	CASC17	71168603	71168687	0	85	2762	2897	2762	2812	0.0	0.9822190611664295
chr17	SOX9-AS1	72074548	72076733	0	2186	102	11672	102	9486	0.0	0.010752688172043012
chr17	SOX9-AS1	72081359	72081401	0	43	102	11672	102	11629	0.0	0.008771175509502106
chr17	SOX9-AS1	72084989	72085045	0	57	102	11672	102	11615	0.0	0.00878174773999139
chr17	SOX9-AS1	72114205	72114400	0	196	102	11672	102	11476	0.0	0.008888114325548972
chr17	SOX9-AS1	72090726	72091104	0	379	102	11672	102	11293	0.0	0.00903214380589746
chr17	LINC00511	72325792	72325946	0	155	344	21819	344	21664	0.0	0.01587887740029542
chr17	LINC00511	72428235	72428298	29	64	344	21819	315	21755	0.453125	0.014479430016088255
chr17	LINC00511	72431127	72431224	0	98	344	21819	344	21721	0.0	0.01583720823166521
chr17	LINC00511	72469574	72469656	0	83	344	21819	344	21736	0.0	0.01582627898417372
chr17	LINC00511	72507173	72507278	0	106	344	21819	344	21713	0.0	0.01584304333809239
chr17	LINC00511	72533309	72533371	0	63	344	21819	344	21756	0.0	0.015811730097444382
chr17	LINC00511	72586653	72586825	0	173	344	21819	344	21646	0.0	0.01589208167790816
chr17	LINC00511	72583043	72583138	0	96	344	21819	344	21723	0.0	0.015835750126593932
chr17	LINC00511	72599088	72599144	0	57	344	21819	344	21762	0.0	0.015807370646080322
chr17	CD300LF	74696194	74696217	0	24	3440	2170	3440	2146	0.0	1.602982292637465
chr17	CD300LF	74698368	74698481	478	114	3440	2170	2962	2056	4.192982456140351	1.4406614785992218
chr17	NAT9	74773865	74773939	45	75	16833	2692	16788	2617	0.6	6.414978983568972
chr17	NAT9	74773992	74774055	43	64	16833	2692	16790	2628	0.671875	6.388888888888889
chr17	ATP5PD	75039871	75040041	0	171	0	2588	0	2417	0.0	0.0
chr17	ATP5PD	75040091	75040163	0	73	0	2588	0	2515	0.0	0.0
chr17	SLC25A19	75288387	75288461	0	75	204	2966	204	2891	0.0	0.07056381874783813
chr17	SLC25A19	75288501	75288591	0	91	204	2966	204	2875	0.0	0.07095652173913043
chr17	SLC25A19	75288497	75288591	0	95	204	2966	204	2871	0.0	0.07105538140020899
chr17	GRB2	75321658	75321827	914	170	4842	3442	3928	3272	5.376470588235295	1.2004889975550121
chr17	GRB2	75325897	75326020	0	124	4842	3442	4842	3318	0.0	1.4593128390596746
chr17	WBP2	75847795	75847930	0	136	0	4661	0	4525	0.0	0.0
chr17	WBP2	75848569	75848662	0	94	0	4661	0	4567	0.0	0.0
chr17	ACOX1	75960214	75960375	0	162	711	6842	711	6680	0.0	0.10643712574850299
chr17	ACOX1	75973624	75973785	0	162	711	6842	711	6680	0.0	0.10643712574850299
chr17	EXOC7	76090328	76090397	0	70	22545	5674	22545	5604	0.0	4.023019271948608
chr17	EXOC7	76091142	76091235	0	94	22545	5674	22545	5580	0.0	4.040322580645161
chr17	QRICH2	76291014	76294021	102	3008	124	5795	22	2787	0.0339095744680851	0.007893792608539648
chr17	QRICH2	76301442	76301540	0	99	124	5795	124	5696	0.0	0.021769662921348316
chr17	ST6GALNAC1	76626288	76626392	0	105	0	3207	0	3102	0.0	0.0
chr17	ST6GALNAC1	76626650	76626789	0	140	0	3207	0	3067	0.0	0.0
chr17	ST6GALNAC1	76637599	76637736	0	138	0	3207	0	3069	0.0	0.0
chr17	ST6GALNAC1	76641807	76641904	0	98	0	3207	0	3109	0.0	0.0
chr17	SCAT1	78627917	78628035	0	119	20317	4114	20317	3995	0.0	5.0856070087609515
chr17	SCAT1	78628317	78628438	270	122	20317	4114	20047	3992	2.2131147540983607	5.021793587174349
chr17	SCAT1	78618029	78618208	0	180	20317	4114	20317	3934	0.0	5.164463650228774
chr17	SCAT1	78621666	78621733	0	68	20317	4114	20317	4046	0.0	5.021502718734553
chr17	SCAT1	78630031	78630280	0	250	20317	4114	20317	3864	0.0	5.258022774327122
chr17	SCAT1	78630316	78630430	0	115	20317	4114	20317	3999	0.0	5.080520130032508
chr17	USP36	78796316	78796494	0	179	34927	7560	34927	7381	0.0	4.732014632163663
chr17	USP36	78797785	78797879	0	95	34927	7560	34927	7465	0.0	4.678767582049565
chr17	LGALS3BP	78977403	78977473	25	71	38996	2991	38971	2920	0.352112676056338	13.346232876712328
chr17	LGALS3BP	78979445	78979586	101	142	38996	2991	38895	2849	0.7112676056338029	13.652158652158652
chr17	CANT1	78998147	78998286	0	140	8954	4029	8954	3889	0.0	2.30239136024685
chr17	CANT1	79000099	79000270	31	172	8954	4029	8923	3857	0.18023255813953487	2.3134560539279234
chr17	CANT1	79005371	79005481	1340	111	8954	4029	7614	3918	12.072072072072071	1.9433384379785605
chr17	SGSH	80214614	80214765	1679	152	297589	3964	295910	3812	11.046052631578947	77.62591815320042
chr17	SGSH	80215032	80215138	847	107	297589	3964	296742	3857	7.91588785046729	76.93596059113301
chr17	AC110285.1	81381876	81381940	0	65	0	2396	0	2331	0.0	0.0
chr17	AC110285.1	81384945	81385032	0	88	0	2396	0	2308	0.0	0.0
chr17	NPLOC4	81560561	81560629	0	69	0	7339	0	7270	0.0	0.0
chr17	NPLOC4	81563920	81563979	0	60	0	7339	0	7279	0.0	0.0
chr17	NPLOC4	81563412	81563568	0	157	0	7339	0	7182	0.0	0.0
chr17	NPLOC4	81608727	81608822	0	96	0	7339	0	7243	0.0	0.0
chr17	NPLOC4	81610209	81610258	0	50	0	7339	0	7289	0.0	0.0
chr17	P4HB	81855452	81855586	0	135	0	4717	0	4582	0.0	0.0
chr17	P4HB	81859178	81859387	0	210	0	4717	0	4507	0.0	0.0
chr17	PYCR1	81934325	81934489	0	165	0	2584	0	2419	0.0	0.0
chr17	PYCR1	81934652	81934745	0	94	0	2584	0	2490	0.0	0.0
chr17	CCDC57	82107401	82107621	0	221	0	9455	0	9234	0.0	0.0
chr17	CCDC57	82108767	82108954	0	188	0	9455	0	9267	0.0	0.0
chr17	CSNK1D	82255428	82255577	0	150	0	8237	0	8087	0.0	0.0
chr17	CSNK1D	82265685	82265796	0	112	0	8237	0	8125	0.0	0.0
chr17	CSNK1D	82253015	82253244	0	230	0	8237	0	8007	0.0	0.0
chr17	CYBC1	82447850	82447927	0	78	0	3566	0	3488	0.0	0.0
chr17	CYBC1	82449169	82449292	0	124	0	3566	0	3442	0.0	0.0
chr17	CYBC1	82446622	82446696	0	75	0	3566	0	3491	0.0	0.0
chr17	CYBC1	82447579	82447621	0	43	0	3566	0	3523	0.0	0.0
chr17	CYBC1	82449430	82449480	0	51	0	3566	0	3515	0.0	0.0
chr17	CYBC1	82450198	82450254	0	57	0	3566	0	3509	0.0	0.0
chr17	CYBC1	82449173	82449292	0	120	0	3566	0	3446	0.0	0.0
chr17	TLCD3A	737845	738047	0	203	628	2606	628	2403	0.0	0.26133999167707034
chr17	TLCD3A	740504	740600	16	97	628	2606	612	2509	0.16494845360824742	0.2439218812275807
chr17	PAFAH1B1	2677515	2677639	0	125	113619	9736	113619	9611	0.0	11.821766725626885
chr17	PAFAH1B1	2680163	2680320	0	158	113619	9736	113619	9578	0.0	11.862497389851743
chr17	PAFAH1B1	2605760	2605837	115	78	113619	9736	113504	9658	1.4743589743589745	11.752329674880928
chr17	PAFAH1B1	2613657	2613862	1336	206	113619	9736	112283	9530	6.485436893203883	11.782056663168941
chr17	PAFAH1B1	2638098	2638320	62	223	113619	9736	113557	9513	0.27802690582959644	11.937033533060022
chr17	PAFAH1B1	2665371	2665456	0	86	113619	9736	113619	9650	0.0	11.7739896373057
chr17	PAFAH1B1	2653853	2653951	0	99	113619	9736	113619	9637	0.0	11.789872366919166
chr17	PAFAH1B1	2662780	2662834	0	55	113619	9736	113619	9681	0.0	11.73628757359777
chr17	PAFAH1B1	2635382	2635510	0	129	113619	9736	113619	9607	0.0	11.826688872696991
chr17	CTNS	3640187	3640267	0	81	153	4697	153	4616	0.0	0.033145580589254764
chr17	CTNS	3654997	3655101	0	105	153	4697	153	4592	0.0	0.03331881533101045
chr17	ARRB2	4715972	4716033	319	62	109835	3784	109516	3722	5.145161290322581	29.42396560988716
chr17	ARRB2	4716146	4716191	292	46	109835	3784	109543	3738	6.3478260869565215	29.305243445692884
chr17	RPAIN	5426235	5426299	0	65	0	7435	0	7370	0.0	0.0
chr17	RPAIN	5428070	5428211	0	142	0	7435	0	7293	0.0	0.0
chr17	RPAIN	5425970	5426082	0	113	0	7435	0	7322	0.0	0.0
chr17	XAF1	6760405	6760601	0	197	102	6341	102	6144	0.0	0.0166015625
chr17	XAF1	6762154	6762240	0	87	102	6341	102	6254	0.0	0.016309561880396548
chr17	XAF1	6759255	6759718	0	464	102	6341	102	5877	0.0	0.017355793772332824
chr17	XAF1	6759840	6759881	0	42	102	6341	102	6299	0.0	0.016193046515319894
chr17	XAF1	6759661	6759718	0	58	102	6341	102	6283	0.0	0.01623428298583479
chr17	XAF1	6758861	6758959	0	99	102	6341	102	6242	0.0	0.016340916372957384
chr17	XAF1	6759255	6759519	0	265	102	6341	102	6076	0.0	0.016787360105332456
chr17	ACADVL	7220923	7221058	7899	136	162847	3886	154948	3750	58.080882352941174	41.31946666666666
chr17	ACADVL	7221537	7221682	20198	146	162847	3886	142649	3740	138.34246575342465	38.14144385026738
chr17	TNFSF13	7559623	7559702	0	80	831	2282	831	2202	0.0	0.3773841961852861
chr17	TNFSF13	7559847	7559893	396	47	831	2282	435	2235	8.425531914893616	0.19463087248322147
chr17	TNFSF13	7559850	7559893	360	44	831	2282	471	2238	8.181818181818182	0.21045576407506703
chr17	MPDU1	7586691	7586838	51	148	51333	2956	51282	2808	0.34459459459459457	18.262820512820515
chr17	MPDU1	7586898	7587017	525	120	51333	2956	50808	2836	4.375	17.915373765867418
chr17	MPDU1	7586691	7586777	12	87	51333	2956	51321	2869	0.13793103448275862	17.888114325548973
chr17	MPDU1	7585945	7586078	725	134	51333	2956	50608	2822	5.41044776119403	17.93338058114812
chr17	MAP2K4	12054888	12054991	0	104	234	4535	234	4431	0.0	0.052809749492213946
chr17	MAP2K4	12081355	12081530	0	176	234	4535	234	4359	0.0	0.053682037164487266
chr17	MYOCD	12756413	12756557	0	145	120	8891	120	8746	0.0	0.01372055796935742
chr17	MYOCD	12758084	12758213	6	130	120	8891	114	8761	0.046153846153846156	0.013012213217669216
chr17	COX10	14076734	14077056	0	323	9661	6769	9661	6446	0.0	1.4987589202606268
chr17	COX10	14102117	14102242	0	126	9661	6769	9661	6643	0.0	1.454312810477194
chr17	ZNF286A	15701151	15701240	94	90	215	3177	121	3087	1.0444444444444445	0.03919663103336573
chr17	ZNF286A	15706476	15706501	0	26	215	3177	215	3151	0.0	0.0682323072040622
chr17	ZNF286A	15700047	15700168	2	122	215	3177	213	3055	0.01639344262295082	0.06972176759410802
chr17	ZNF286A	15700207	15700366	11	160	215	3177	204	3017	0.06875	0.06761683791846204
chr17	TRPV2	16433573	16433698	0	126	51	3397	51	3271	0.0	0.0155915622133904
chr17	TRPV2	16434889	16434969	0	81	51	3397	51	3316	0.0	0.015379975874547648
chr17	SNHG29	16441073	16441130	0	58	42991	5724	42991	5666	0.0	7.587539710554183
chr17	SNHG29	16460892	16461245	0	354	42991	5724	42991	5370	0.0	8.005772811918064
chr17	SNHG29	16439326	16439414	0	89	42991	5724	42991	5635	0.0	7.629281277728483
chr17	SNHG29	16439659	16439703	0	45	42991	5724	42991	5679	0.0	7.57017080471914
chr17	SNHG29	16439326	16439393	0	68	42991	5724	42991	5656	0.0	7.600954738330976
chr17	PRPSAP2	18859339	18859475	0	137	5997	4727	5997	4590	0.0	1.3065359477124183
chr17	PRPSAP2	18864867	18864941	0	75	5997	4727	5997	4652	0.0	1.2891229578675838
chr17	EPN2	19249370	19249526	1155	157	107116	7670	105961	7513	7.356687898089172	14.10368694263277
chr17	EPN2	19276396	19276538	0	143	107116	7670	107116	7527	0.0	14.230902085824365
chr17	EPN2	19279861	19279980	0	120	107116	7670	107116	7550	0.0	14.187549668874173
chr17	ALDH3A2	19664947	19665047	0	101	9762	10618	9762	10517	0.0	0.9282114671484264
chr17	ALDH3A2	19671720	19671956	0	237	9762	10618	9762	10381	0.0	0.9403718331567287
chr17	SPECC1	20124899	20124997	0	99	67459	19316	67459	19217	0.0	3.510381433106104
chr17	SPECC1	20204332	20205912	2161	1581	67459	19316	65298	17735	1.3668564199873499	3.681872004510854
chr17	SPECC1	20296960	20297077	0	118	67459	19316	67459	19198	0.0	3.513855609959371
chr17	SPECC1	20306022	20306082	337	61	67459	19316	67122	19255	5.524590163934426	3.48595170085692
chr17	SPECC1	20017986	20018102	255	117	67459	19316	67204	19199	2.1794871794871793	3.500390645346112
chr17	SPECC1	20067193	20067378	0	186	67459	19316	67459	19130	0.0	3.5263460533193935
chr17	USP32P3	20418182	20418391	0	210	1841	7899	1841	7689	0.0	0.2394329561711536
chr17	USP32P3	20419855	20420113	0	259	1841	7899	1841	7640	0.0	0.24096858638743454
chr17	MAP2K3	21295674	21295769	0	96	918	3685	918	3589	0.0	0.2557815547506269
chr17	MAP2K3	21296085	21296210	0	126	918	3685	918	3559	0.0	0.2579376229277887
chr17	PIPOX	29010959	29011146	0	188	19446	3797	19446	3609	0.0	5.388196176226101
chr17	PIPOX	29040682	29040790	10	109	19446	3797	19436	3688	0.09174311926605505	5.2700650759219085
chr17	NSRP1	30156539	30156662	0	124	353030	4823	353030	4699	0.0	75.12875079804213
chr17	NSRP1	30168813	30168925	0	113	353030	4823	353030	4710	0.0	74.95329087048832
chr17	NSRP1	30118079	30118173	0	95	353030	4823	353030	4728	0.0	74.66793570219966
chr17	NSRP1	30163066	30163162	0	97	353030	4823	353030	4726	0.0	74.69953449005502
chr17	ADAP2	30949286	30949370	0	85	51	3738	51	3653	0.0	0.013961127840131399
chr17	ADAP2	30953287	30953350	0	64	51	3738	51	3674	0.0	0.013881328252585737
chr17	ADAP2	30926826	30926918	51	93	51	3738	0	3645	0.5483870967741935	0.0
chr17	ADAP2	30931888	30931968	0	81	51	3738	51	3657	0.0	0.01394585726004922
chr17	RNF135	30984616	30984760	0	145	0	2253	0	2108	0.0	0.0
chr17	RNF135	30987943	30988106	0	164	0	2253	0	2089	0.0	0.0
chr17	NF1	31252937	31253000	0	64	102	20076	102	20012	0.0	0.00509694183489906
chr17	NF1	31257686	31257726	0	41	102	20076	102	20035	0.0	0.005091090591464936
chr17	RHOT1	32209349	32209445	0	97	102	5502	102	5405	0.0	0.01887141535615171
chr17	RHOT1	32211115	32211238	0	124	102	5502	102	5378	0.0	0.01896615842320565
chr17	RHOT1	32221048	32221186	0	139	102	5502	102	5363	0.0	0.019019205668469142
chr17	RHOT1	32222758	32222902	0	145	102	5502	102	5357	0.0	0.01904050774687325
chr17	RHOT1	32222828	32222902	0	75	102	5502	102	5427	0.0	0.018794914317302378
chr17	RHBDL3	32284658	32284817	0	160	0	5756	0	5596	0.0	0.0
chr17	RHBDL3	32288231	32288369	0	139	0	5756	0	5617	0.0	0.0
chr17	AP2B1	35600936	35601071	0	136	11180	7621	11180	7485	0.0	1.4936539746158985
chr17	AP2B1	35605704	35605840	0	137	11180	7621	11180	7484	0.0	1.4938535542490647
chr17	TADA2A	37423508	37423615	0	108	3218	5170	3218	5062	0.0	0.6357171078625049
chr17	TADA2A	37426949	37427009	19	61	3218	5170	3199	5109	0.3114754098360656	0.6261499314934429
chr17	CSF3	40015690	40015845	51	156	204	2223	153	2067	0.3269230769230769	0.07402031930333818
chr17	CSF3	40016232	40016340	0	109	204	2223	204	2114	0.0	0.09649952696310313
chr17	CSF3	40015690	40015854	51	165	204	2223	153	2058	0.3090909090909091	0.07434402332361516
chr17	TTC25	41935470	41935543	0	74	6487	3383	6487	3309	0.0	1.9604110003022062
chr17	TTC25	41935598	41935749	0	152	6487	3383	6487	3231	0.0	2.007737542556484
chr17	NKIRAS2	42021563	42021671	0	109	41	4020	41	3911	0.0	0.01048325236512401
chr17	NKIRAS2	42022398	42022640	0	243	41	4020	41	3777	0.0	0.010855176065660577
chr17	ATP6V0A1	42468009	42468107	0	99	42688	7310	42688	7211	0.0	5.919844681736237
chr17	ATP6V0A1	42470089	42470218	0	130	42688	7310	42688	7180	0.0	5.945403899721448
chr17	ATP6V0A1	42508571	42508589	0	19	42688	7310	42688	7291	0.0	5.854889589905363
chr17	ATP6V0A1	42510058	42510183	0	126	42688	7310	42688	7184	0.0	5.942093541202673
chr17	PSME3	42838092	42838205	0	114	67484	4720	67484	4606	0.0	14.651324359531046
chr17	PSME3	42838730	42838799	0	70	67484	4720	67484	4650	0.0	14.51268817204301
chr17	PSME3	42833775	42833939	0	165	67484	4720	67484	4555	0.0	14.81536772777168
chr17	PSME3	42834093	42834256	91	164	67484	4720	67393	4556	0.5548780487804879	14.79214223002634
chr17	GRN	44345565	44345605	0	41	821	3085	821	3044	0.0	0.2697109067017083
chr17	GRN	44345609	44345741	0	133	821	3085	821	2952	0.0	0.27811653116531165
chr17	GRN	44345530	44345605	0	76	821	3085	821	3009	0.0	0.27284812229976735
chr17	GRN	44346088	44346228	107	141	821	3085	714	2944	0.7588652482269503	0.2425271739130435
chr17	CRHR1	45816462	45816582	0	121	1017	3298	1017	3177	0.0	0.32011331444759206
chr17	CRHR1	45821354	45821440	0	87	1017	3298	1017	3211	0.0	0.3167237620678916
chr17	CRHR1	45833713	45833849	0	137	1017	3298	1017	3161	0.0	0.32173362859854476
chr17	CRHR1	45834006	45834048	0	43	1017	3298	1017	3255	0.0	0.31244239631336407
chr17	CRHR1	45833451	45833537	0	87	1017	3298	1017	3211	0.0	0.3167237620678916
chr17	GOSR2	46955500	46955712	0	213	187163	11566	187163	11353	0.0	16.48577468510526
chr17	GOSR2	46963696	46963779	36	84	187163	11566	187127	11482	0.42857142857142855	16.297422051907333
chr17	GOSR2	46923508	46923632	51	125	187163	11566	187112	11441	0.408	16.354514465518747
chr17	GOSR2	46923816	46923865	559	50	187163	11566	186604	11516	11.18	16.20389023966655
chr17	GOSR2	46924260	46924468	1503	209	187163	11566	185660	11357	7.1913875598086126	16.34762701417628
chr17	PNPO	47945558	47945612	0	55	0	4987	0	4932	0.0	0.0
chr17	PNPO	47945860	47945989	0	130	0	4987	0	4857	0.0	0.0
chr17	CDK5RAP3	47971273	47971309	0	37	0	4158	0	4121	0.0	0.0
chr17	CDK5RAP3	47971361	47971407	0	47	0	4158	0	4111	0.0	0.0
chr17	LINC02086	48687496	48687710	0	215	24	3504	24	3289	0.0	0.007297050775311645
chr17	LINC02086	48700611	48700696	0	86	24	3504	24	3418	0.0	0.007021650087770626
chr17	CALCOCO2	48843902	48844026	0	125	17632	7200	17632	7075	0.0	2.492155477031802
chr17	CALCOCO2	48846033	48846096	0	64	17632	7200	17632	7136	0.0	2.4708520179372195
chr17	CALCOCO2	48846442	48846514	0	73	17632	7200	17632	7127	0.0	2.473972218324681
chr17	AC015909.1	50210620	50210802	0	183	0	2615	0	2432	0.0	0.0
chr17	AC015909.1	50211945	50212121	0	177	0	2615	0	2438	0.0	0.0
chr17	AC015909.1	50210467	50210802	0	336	0	2615	0	2279	0.0	0.0
chr17	ACSF2	50426904	50426979	0	76	0	5152	0	5076	0.0	0.0
chr17	ACSF2	50460201	50460363	0	163	0	5152	0	4989	0.0	0.0
chr17	CACNA1G	50619682	50619826	0	145	356	10101	356	9956	0.0	0.035757332261952594
chr17	CACNA1G	50621659	50621794	0	136	356	10101	356	9965	0.0	0.03572503763171099
chr17	LUC7L3	50749223	50749344	51	122	1581	7501	1530	7379	0.4180327868852459	0.20734516872204906
chr17	LUC7L3	50750500	50750641	0	142	1581	7501	1581	7359	0.0	0.2148389726865063
chr17	LUC7L3	50722663	50722745	0	83	1581	7501	1581	7418	0.0	0.2131302237799946
chr17	LUC7L3	50723818	50723965	0	148	1581	7501	1581	7353	0.0	0.2150142798857609
chr17	LUC7L3	50737286	50737479	0	194	1581	7501	1581	7307	0.0	0.21636786642945122
chr17	LUC7L3	50738140	50738199	0	60	1581	7501	1581	7441	0.0	0.21247144201048246
chr17	UTP18	51288547	51288591	0	45	7	2719	7	2674	0.0	0.002617801047120419
chr17	UTP18	51293902	51294045	0	144	7	2719	7	2575	0.0	0.0027184466019417475
chr17	TOM1L1	54903707	54903792	36	86	13392	7265	13356	7179	0.4186046511627907	1.8604262432093606
chr17	TOM1L1	54905488	54905567	0	80	13392	7265	13392	7185	0.0	1.8638830897703549
chr17	TOM1L1	54912665	54912815	282	151	13392	7265	13110	7114	1.8675496688741722	1.8428450941804893
chr17	SCPEP1	56981081	56981230	0	150	1603	2897	1603	2747	0.0	0.5835456862031307
chr17	SCPEP1	56985377	56985467	0	91	1603	2897	1603	2806	0.0	0.5712758374910906
chr17	AKAP1	57086372	57086537	517	166	34241	5359	33724	5193	3.1144578313253013	6.494126709031389
chr17	AKAP1	57096590	57096763	0	174	34241	5359	34241	5185	0.0	6.603857280617165
chr17	MSI2	57263487	57263569	147	83	109986	16085	109839	16002	1.7710843373493976	6.864079490063742
chr17	MSI2	57370948	57370991	0	44	109986	16085	109986	16041	0.0	6.856555077613615
chr17	MSI2	57310130	57310326	0	197	109986	16085	109986	15888	0.0	6.9225830815709966
chr17	TSPOAP1-AS1	58339242	58339447	255	206	781	3888	526	3682	1.2378640776699028	0.14285714285714285
chr17	TSPOAP1-AS1	58346279	58346343	0	65	781	3888	781	3823	0.0	0.20428982474496468
chr17	RAD51C	58720745	58720812	0	68	7456	5705	7456	5637	0.0	1.3226893737803795
chr17	RAD51C	58724039	58724100	0	62	7456	5705	7456	5643	0.0	1.3212830054935318
chr17	RAD51C	58694930	58695189	765	260	7456	5705	6691	5445	2.9423076923076925	1.228833792470156
chr17	RAD51C	58696692	58696859	0	168	7456	5705	7456	5537	0.0	1.3465775690807296
chr17	RAD51C	58705877	58706022	0	146	7456	5705	7456	5559	0.0	1.341248425975895
chr17	RAD51C	58706488	58706608	0	121	7456	5705	7456	5584	0.0	1.335243553008596
chr17	PRR11	59160758	59160876	0	119	3968	4818	3968	4699	0.0	0.8444349861672696
chr17	PRR11	59163598	59163664	0	67	3968	4818	3968	4751	0.0	0.8351925910334667
chr17	DHX40	59566626	59566794	0	169	248	5857	248	5688	0.0	0.04360056258790436
chr17	DHX40	59570517	59570663	0	147	248	5857	248	5710	0.0	0.043432574430823115
chr17	DHX40	59566626	59566709	0	84	248	5857	248	5773	0.0	0.04295860038108436
chr17	VMP1	59735337	59735473	0	137	118	5500	118	5363	0.0	0.022002610479209397
chr17	VMP1	59737452	59737543	0	92	118	5500	118	5408	0.0	0.021819526627218935
chr17	RPS6KB1	59930357	59930432	0	76	26686	5329	26686	5253	0.0	5.080144679230916
chr17	RPS6KB1	59930799	59931052	0	254	26686	5329	26686	5075	0.0	5.2583251231527095
chr17	BCAS3	60688019	60688195	0	177	10553	8054	10553	7877	0.0	1.3397232448901866
chr17	BCAS3	60688931	60689046	0	116	10553	8054	10553	7938	0.0	1.3294280675233057
chr17	AC005821.1	62707431	62707607	0	177	33490	3916	33490	3739	0.0	8.956940358384594
chr17	AC005821.1	62726255	62726600	0	346	33490	3916	33490	3570	0.0	9.380952380952381
chr17	DDX42	63799479	63799523	0	45	233	6612	233	6567	0.0	0.035480432465357085
chr17	DDX42	63799588	63799625	0	38	233	6612	233	6574	0.0	0.03544265287496197
chr17	PRR29	64001083	64001308	0	226	459	3570	459	3344	0.0	0.13726076555023922
chr17	PRR29	64001466	64001537	0	72	459	3570	459	3498	0.0	0.1312178387650086
chr17	MILR1	64452596	64452866	1020	271	1207	1826	187	1555	3.763837638376384	0.1202572347266881
chr17	MILR1	64457399	64457684	0	286	1207	1826	1207	1540	0.0	0.7837662337662338
chr17	BPTF	67875555	67875744	0	190	51	14493	51	14303	0.0	0.0035656855205201707
chr17	BPTF	67886127	67886316	0	190	51	14493	51	14303	0.0	0.0035656855205201707
chr17	AMZ2	68248639	68248705	0	67	0	3654	0	3587	0.0	0.0
chr17	AMZ2	68249010	68249096	0	87	0	3654	0	3567	0.0	0.0
chr17	AMZ2	68250017	68250128	0	112	0	3654	0	3542	0.0	0.0
chr17	AMZ2	68250187	68250470	0	284	0	3654	0	3370	0.0	0.0
chr17	AMZ2	68250359	68250470	0	112	0	3654	0	3542	0.0	0.0
chr17	LINC01497	69982145	69982245	0	101	0	1827	0	1726	0.0	0.0
chr17	LINC01497	69982328	69982462	0	135	0	1827	0	1692	0.0	0.0
chr17	C17ORF80	73235475	73236995	74041	1521	168752	4671	94711	3150	48.67915844838922	30.066984126984128
chr17	C17ORF80	73242243	73242351	30	109	168752	4671	168722	4562	0.27522935779816515	36.984217448487506
chr17	TMEM104	74777577	74777738	518	162	2734	3545	2216	3383	3.197530864197531	0.6550399054093999
chr17	TMEM104	74785481	74785603	975	123	2734	3545	1759	3422	7.926829268292683	0.5140268848626535
chr17	NUP85	75218184	75218306	0	123	35616	4297	35616	4174	0.0	8.53282223287015
chr17	NUP85	75225102	75225237	0	136	35616	4297	35616	4161	0.0	8.559480894015861
chr17	LLGL2	75533641	75533705	0	65	51	6610	51	6545	0.0	0.007792207792207792
chr17	LLGL2	75538530	75538636	0	107	51	6610	51	6503	0.0	0.007842534214977702
chr17	MYO15B	75590625	75590689	0	65	29	12656	29	12591	0.0	0.0023032324676356126
chr17	MYO15B	75590906	75591016	0	111	29	12656	29	12545	0.0	0.002311677959346353
chr17	SAP30BP	75668515	75668625	0	111	51	7603	51	7492	0.0	0.006807261078483716
chr17	SAP30BP	75671815	75671863	0	49	51	7603	51	7554	0.0	0.006751389992057188
chr17	TEN1	75984580	75984718	0	139	2283	1289	2283	1150	0.0	1.9852173913043478
chr17	TEN1	75984891	75985012	0	122	2283	1289	2283	1167	0.0	1.9562982005141387
chr17	SNHG16	76557969	76558600	0	632	0	5256	0	4624	0.0	0.0
chr17	SNHG16	76558944	76559043	0	100	0	5256	0	5156	0.0	0.0
chr17	SNHG16	76558373	76558600	0	228	0	5256	0	5028	0.0	0.0
chr17	METTL23	76726969	76727178	0	210	450	1838	450	1628	0.0	0.2764127764127764
chr17	METTL23	76729689	76729794	0	106	450	1838	450	1732	0.0	0.25981524249422633
chr17	AC021683.3	77529291	77529349	0	59	0	5420	0	5361	0.0	0.0
chr17	AC021683.3	77533180	77533266	0	87	0	5420	0	5333	0.0	0.0
chr17	SYNGR2	78170611	78171054	0	444	51	2669	51	2225	0.0	0.02292134831460674
chr17	SYNGR2	78171509	78171649	0	141	51	2669	51	2528	0.0	0.020174050632911392
chr17	SYNGR2	78170816	78171054	0	239	51	2669	51	2430	0.0	0.020987654320987655
chr17	AFMID	78204827	78204900	0	74	19354	4061	19354	3987	0.0	4.854276398294457
chr17	AFMID	78205439	78205518	117	80	19354	4061	19237	3981	1.4625	4.832202964079377
chr17	PGS1	78392475	78392665	2748	191	7166	4741	4418	4550	14.387434554973822	0.970989010989011
chr17	PGS1	78396307	78396385	0	79	7166	4741	7166	4662	0.0	1.5371085371085371
chr17	PGS1	78392513	78392665	1563	153	7166	4741	5603	4588	10.215686274509803	1.221229293809939
chr17	ENDOV	80417780	80417945	16278	166	105383	6269	89105	6103	98.06024096385542	14.600196624610847
chr17	ENDOV	80422205	80422245	15854	41	105383	6269	89529	6228	386.6829268292683	14.3752408477842
chr17	ENDOV	80417810	80417945	16278	136	105383	6269	89105	6133	119.69117647058823	14.52877873797489
chr17	ENDOV	80422139	80422245	34369	107	105383	6269	71014	6162	321.2056074766355	11.524505030834145
chr17	HGS	81684812	81684891	0	80	0	8542	0	8462	0.0	0.0
chr17	HGS	81684970	81685069	0	100	0	8542	0	8442	0.0	0.0
chr17	HGS	81697865	81698116	0	252	0	8542	0	8290	0.0	0.0
chr17	HGS	81699741	81699837	0	97	0	8542	0	8445	0.0	0.0
chr17	HEXD	82424393	82424503	0	111	0	4126	0	4015	0.0	0.0
chr17	HEXD	82428029	82428127	0	99	0	4126	0	4027	0.0	0.0
chr17	HEXD	82424418	82424503	0	86	0	4126	0	4040	0.0	0.0
chr17	HEXD	82440262	82440334	0	73	0	4126	0	4053	0.0	0.0
chr17	HEXD	82440472	82440613	0	142	0	4126	0	3984	0.0	0.0
chr17	NARF	82472563	82472698	0	136	0	6641	0	6505	0.0	0.0
chr17	NARF	82478570	82478667	0	98	0	6641	0	6543	0.0	0.0
chr18	USP14	166786	166819	33684	34	1599935	6004	1566251	5970	990.7058823529412	262.3536013400335
chr18	USP14	178932	179037	81781	106	1599935	6004	1518154	5898	771.5188679245283	257.401492031197
chr18	USP14	178900	179037	82242	138	1599935	6004	1517693	5866	595.9565217391304	258.7270712580975
chr18	AP005262.1	1626238	1626367	0	130	51	9198	51	9068	0.0	0.0056241729157476845
chr18	AP005262.1	1649685	1649793	0	109	51	9198	51	9089	0.0	0.005611178347452965
chr18	AP005262.1	1690602	1690676	0	75	51	9198	51	9123	0.0	0.005590266359750082
chr18	AP005262.1	1824777	1824852	0	76	51	9198	51	9122	0.0	0.005590879193159395
chr18	AP005262.1	1531497	1531557	0	61	51	9198	51	9137	0.0	0.005581700777060304
chr18	AP005262.1	1562773	1562861	0	89	51	9198	51	9109	0.0	0.005598858272038643
chr18	DLGAP1-AS1	3594419	3594484	986	66	10733	1621	9747	1555	14.93939393939394	6.268167202572347
chr18	DLGAP1-AS1	3596578	3596675	1123	98	10733	1621	9610	1523	11.459183673469388	6.309914642153644
chr18	DLGAP1-AS5	4275300	4275379	0	80	0	2882	0	2802	0.0	0.0
chr18	DLGAP1-AS5	4280729	4280766	0	38	0	2882	0	2844	0.0	0.0
chr18	LINC00667	5240647	5241255	3166	609	190677	9559	187511	8950	5.198686371100164	20.95094972067039
chr18	LINC00667	5241698	5241812	2462	115	190677	9559	188215	9444	21.408695652173915	19.92958492164337
chr18	LINC00667	5241698	5241889	2565	192	190677	9559	188112	9367	13.359375	20.082416995836446
chr18	LINC00667	5240542	5240615	165	74	190677	9559	190512	9485	2.22972972972973	20.085608856088562
chr18	LINC00667	5240647	5240819	1690	173	190677	9559	188987	9386	9.76878612716763	20.134988280417645
chr18	MIR3976HG	5750779	5750904	0	126	0	12474	0	12348	0.0	0.0
chr18	MIR3976HG	5760987	5761047	0	61	0	12474	0	12413	0.0	0.0
chr18	MIR3976HG	5784482	5784575	0	94	0	12474	0	12380	0.0	0.0
chr18	MIR3976HG	5789017	5789220	0	204	0	12474	0	12270	0.0	0.0
chr18	MIR3976HG	5779944	5780024	0	81	0	12474	0	12393	0.0	0.0
chr18	MIR3976HG	5751334	5751594	0	261	0	12474	0	12213	0.0	0.0
chr18	MIR3976HG	5758118	5758321	0	204	0	12474	0	12270	0.0	0.0
chr18	MIR3976HG	5758263	5758321	0	59	0	12474	0	12415	0.0	0.0
chr18	PTPRM	8248149	8248176	0	28	51	9910	51	9882	0.0	0.0051608986035215545
chr18	PTPRM	8253226	8253414	0	189	51	9910	51	9721	0.0	0.005246373829852896
chr18	ANKRD12	9200513	9200644	216	132	75494	12266	75278	12134	1.6363636363636365	6.203889896159552
chr18	ANKRD12	9204475	9204544	0	70	75494	12266	75494	12196	0.0	6.190062315513283
chr18	LINC01255	11504827	11505057	0	231	0	8070	0	7839	0.0	0.0
chr18	LINC01255	11505781	11505924	0	144	0	8070	0	7926	0.0	0.0
chr18	LINC01255	11503733	11503884	0	152	0	8070	0	7918	0.0	0.0
chr18	LINC01255	11505781	11505956	0	176	0	8070	0	7894	0.0	0.0
chr18	LINC01255	11490379	11490647	0	269	0	8070	0	7801	0.0	0.0
chr18	LINC01255	11503740	11503884	0	145	0	8070	0	7925	0.0	0.0
chr18	LINC01255	11505486	11505956	0	471	0	8070	0	7599	0.0	0.0
chr18	LINC01255	11503133	11503299	0	167	0	8070	0	7903	0.0	0.0
chr18	TUBB6	12308686	12308795	128672	110	3872549	3691	3743877	3581	1169.7454545454545	1045.4836637810668
chr18	TUBB6	12310942	12311053	281164	112	3872549	3691	3591385	3579	2510.3928571428573	1003.4604638167086
chr18	SEH1L	12951854	12951905	22435	52	1101064	8031	1078629	7979	431.4423076923077	135.18348163930318
chr18	SEH1L	12955462	12955609	58742	148	1101064	8031	1042322	7883	396.9054054054054	132.2240263858937
chr18	LDLRAD4	13464990	13465111	0	122	918	29113	918	28991	0.0	0.03166499948259805
chr18	LDLRAD4	13583828	13584049	0	222	918	29113	918	28891	0.0	0.03177460108684366
chr18	RBBP8	22915419	22915485	0	67	150	5107	150	5040	0.0	0.02976190476190476
chr18	RBBP8	22929382	22929437	0	56	150	5107	150	5051	0.0	0.02969708968521085
chr18	RBBP8	23006362	23006432	0	71	150	5107	150	5036	0.0	0.029785544082605243
chr18	RBBP8	23016827	23016924	0	98	150	5107	150	5009	0.0	0.029946097025354362
chr18	RMC1	23506969	23507054	0	86	95	3000	95	2914	0.0	0.03260123541523679
chr18	RMC1	23509192	23509279	0	88	95	3000	95	2912	0.0	0.032623626373626376
chr18	CABYR	24148574	24148725	0	152	0	3482	0	3330	0.0	0.0
chr18	CABYR	24150537	24150624	0	88	0	3482	0	3394	0.0	0.0
chr18	CABYR	24150537	24150631	0	95	0	3482	0	3387	0.0	0.0
chr18	AC018697.1	24726674	24726757	0	84	0	8294	0	8210	0.0	0.0
chr18	AC018697.1	24766480	24766734	0	255	0	8294	0	8039	0.0	0.0
chr18	AC068408.1	27396705	27396726	0	22	0	1112	0	1090	0.0	0.0
chr18	AC068408.1	27396758	27396832	0	75	0	1112	0	1037	0.0	0.0
chr18	RNF138	32092699	32092886	0	188	0	3785	0	3597	0.0	0.0
chr18	RNF138	32111753	32111919	0	167	0	3785	0	3618	0.0	0.0
chr18	ASXL3	33626872	33627070	471	199	323536	13548	323065	13349	2.3668341708542715	24.201438309985768
chr18	ASXL3	33641820	33641823	0	4	323536	13548	323536	13544	0.0	23.88777318369758
chr18	ASXL3	33626861	33627070	537	210	323536	13548	322999	13338	2.557142857142857	24.216449242765034
chr18	DTNA	34683481	34683694	0	214	1234	10501	1234	10287	0.0	0.11995722756877612
chr18	DTNA	34708173	34708226	0	54	1234	10501	1234	10447	0.0	0.1181200344596535
chr18	DTNA	34829399	34829489	0	91	1234	10501	1234	10410	0.0	0.11853986551392891
chr18	DTNA	34838093	34838171	0	79	1234	10501	1234	10422	0.0	0.11840337747073498
chr18	ELP2	36138794	36138872	0	79	0	11088	0	11009	0.0	0.0
chr18	ELP2	36139418	36139613	0	196	0	11088	0	10892	0.0	0.0
chr18	LINC00907	42289503	42289594	0	92	4239	10985	4239	10893	0.0	0.38914899476728176
chr18	LINC00907	42335083	42335303	0	221	4239	10985	4239	10764	0.0	0.39381270903010035
chr18	SLC14A1	45729985	45730120	0	136	0	6081	0	5945	0.0	0.0
chr18	SLC14A1	45730299	45730471	0	173	0	6081	0	5908	0.0	0.0
chr18	SLC14A1	45727260	45727418	0	159	0	6081	0	5922	0.0	0.0
chr18	SLC14A1	45731014	45731204	0	191	0	6081	0	5890	0.0	0.0
chr18	SLC14A1	45736455	45736648	0	194	0	6081	0	5887	0.0	0.0
chr18	SLC14A1	45739162	45739310	0	149	0	6081	0	5932	0.0	0.0
chr18	HAUS1	46122466	46122590	0	125	51	2132	51	2007	0.0	0.025411061285500747
chr18	HAUS1	46123298	46123364	0	67	51	2132	51	2065	0.0	0.024697336561743343
chr18	HAUS1	46106704	46106833	0	130	51	2132	51	2002	0.0	0.025474525474525476
chr18	HAUS1	46109646	46109784	0	139	51	2132	51	1993	0.0	0.025589563472152535
chr18	ME2	50942699	50942736	0	38	102	15460	102	15422	0.0	0.00661392815458436
chr18	ME2	50945137	50945260	0	124	102	15460	102	15336	0.0	0.006651017214397496
chr18	ME2	50916167	50916243	0	77	102	15460	102	15383	0.0	0.006630696223103426
chr18	ME2	50917346	50917508	0	163	102	15460	102	15297	0.0	0.006667974112571092
chr18	DCC	52809298	52809422	0	125	4935	13013	4935	12888	0.0	0.3829143389199255
chr18	DCC	52892407	52892532	4323	126	4935	13013	612	12887	34.30952380952381	0.04748971832078839
chr18	LINC01919	53571259	53571295	0	37	0	3770	0	3733	0.0	0.0
chr18	LINC01919	53577418	53577962	0	545	0	3770	0	3225	0.0	0.0
chr18	LINC01905	56091947	56092057	0	111	1497	3707	1497	3596	0.0	0.4162958843159066
chr18	LINC01905	56095920	56095990	0	71	1497	3707	1497	3636	0.0	0.41171617161716173
chr18	NEDD4L	58245426	58245508	0	83	51	30352	51	30269	0.0	0.001684892133866332
chr18	NEDD4L	58248898	58248937	0	40	51	30352	51	30312	0.0	0.0016825019794140933
chr18	ZNF532	58865303	58865385	0	83	0	9593	0	9510	0.0	0.0
chr18	ZNF532	58865469	58865579	0	111	0	9593	0	9482	0.0	0.0
chr18	RELCH	62279773	62279856	0	84	100	10758	100	10674	0.0	0.00936855911560802
chr18	RELCH	62280359	62280442	0	84	100	10758	100	10674	0.0	0.00936855911560802
chr18	CCDC102B	68734733	68734766	0	34	36	5794	36	5760	0.0	0.00625
chr18	CCDC102B	68823365	68823416	0	52	36	5794	36	5742	0.0	0.006269592476489028
chr18	CNDP2	74505848	74506011	51	164	37641	7642	37590	7478	0.31097560975609756	5.0267451190157795
chr18	CNDP2	74510812	74511013	1584	202	37641	7642	36057	7440	7.841584158415841	4.846370967741936
chr18	LINC00683	76570910	76571178	0	269	102	14982	102	14713	0.0	0.0069326446000135935
chr18	LINC00683	76610844	76610974	0	131	102	14982	102	14851	0.0	0.006868224361995825
chr18	LINC00683	76620487	76621194	0	708	102	14982	102	14274	0.0	0.007145859604875998
chr18	LINC00683	76622213	76622336	0	124	102	14982	102	14858	0.0	0.006864988558352402
chr18	ZNF236	76931066	76931228	0	163	48	11185	48	11022	0.0	0.004354926510615134
chr18	ZNF236	76935979	76936061	0	83	48	11185	48	11102	0.0	0.0043235453071518645
chr18	ATP9B	79361738	79361992	0	255	0	11884	0	11629	0.0	0.0
chr18	ATP9B	79372558	79372685	0	128	0	11884	0	11756	0.0	0.0
chr18	CTDP1	79728906	79729069	0	164	0	5318	0	5154	0.0	0.0
chr18	CTDP1	79736354	79736521	0	168	0	5318	0	5150	0.0	0.0
chr18	LINC00470	1278567	1278633	0	67	0	7735	0	7668	0.0	0.0
chr18	LINC00470	1358725	1358760	0	36	0	7735	0	7699	0.0	0.0
chr18	LINC00470	1353406	1353462	0	57	0	7735	0	7678	0.0	0.0
chr18	LINC00470	1278567	1278651	0	85	0	7735	0	7650	0.0	0.0
chr18	LINC00470	1361735	1361834	0	100	0	7735	0	7635	0.0	0.0
chr18	LINC00470	1365916	1366225	0	310	0	7735	0	7425	0.0	0.0
chr18	AP005230.1	2111643	2111736	0	94	9078	6672	9078	6578	0.0	1.3800547278808148
chr18	AP005230.1	2126199	2126377	816	179	9078	6672	8262	6493	4.558659217877095	1.272447250885569
chr18	LINC01895	3368560	3368688	0	129	0	2092	0	1963	0.0	0.0
chr18	LINC01895	3374763	3374959	0	197	0	2092	0	1895	0.0	0.0
chr18	EPB41L3	5400496	5400595	0	100	204	9610	204	9510	0.0	0.02145110410094637
chr18	EPB41L3	5400968	5401043	0	76	204	9610	204	9534	0.0	0.021397105097545627
chr18	EPB41L3	5508164	5508278	0	115	204	9610	204	9495	0.0	0.021484992101105844
chr18	EPB41L3	5518524	5518607	0	84	204	9610	204	9526	0.0	0.02141507453285744
chr18	MPPE1	11897525	11897620	7329	96	385619	5862	378290	5766	76.34375	65.60700659035727
chr18	MPPE1	11905737	11905953	17425	217	385619	5862	368194	5645	80.29953917050692	65.22480070859167
chr18	MPPE1	11902266	11902358	3331	93	385619	5862	382288	5769	35.81720430107527	66.26590396949211
chr18	MPPE1	11905911	11905953	2815	43	385619	5862	382804	5819	65.46511627906976	65.78518645815433
chr18	LINC01882	12749293	12749533	0	241	51	1336	51	1095	0.0	0.04657534246575343
chr18	LINC01882	12765276	12765455	0	180	51	1336	51	1156	0.0	0.04411764705882353
chr18	PTPN2	12788064	12788150	384	87	338938	7407	338554	7320	4.413793103448276	46.250546448087434
chr18	PTPN2	12793481	12793574	4395	94	338938	7407	334543	7313	46.755319148936174	45.74634213045262
chr18	PTPN2	12819213	12819282	42	70	338938	7407	338896	7337	0.6	46.18999591113534
chr18	PTPN2	12821335	12821425	763	91	338938	7407	338175	7316	8.384615384615385	46.224029524330234
chr18	FAM210A	13687742	13687882	1836	141	465396	4688	463560	4547	13.02127659574468	101.94853749725094
chr18	FAM210A	13697546	13697674	0	129	465396	4688	465396	4559	0.0	102.08291291949989
chr18	TMEM241	23399565	23399647	0	83	60	3480	60	3397	0.0	0.01766264350897851
chr18	TMEM241	23421366	23421444	0	79	60	3480	60	3401	0.0	0.017641870038224053
chr18	TMEM241	23430630	23430677	0	48	60	3480	60	3432	0.0	0.017482517482517484
chr18	TMEM241	23370215	23370261	0	47	60	3480	60	3433	0.0	0.01747742499271774
chr18	TMEM241	23371421	23371470	60	50	60	3480	0	3430	1.2	0.0
chr18	TMEM241	23368714	23368750	0	37	60	3480	60	3443	0.0	0.017426662794074933
chr18	OSBPL1A	24341546	24341658	0	113	35137	7984	35137	7871	0.0	4.464108753652649
chr18	OSBPL1A	24366891	24366966	0	76	35137	7984	35137	7908	0.0	4.443222053616591
chr18	SS18	26080304	26080423	0	120	51	6099	51	5979	0.0	0.008529854490717512
chr18	SS18	26082362	26082528	0	167	51	6099	51	5932	0.0	0.008597437626432907
chr18	SS18	26079010	26079125	0	116	51	6099	51	5983	0.0	0.008524151763329433
chr18	SS18	26081224	26081365	0	142	51	6099	51	5957	0.0	0.008561356387443344
chr18	SS18	26078075	26078160	0	86	51	6099	51	6013	0.0	0.00848162314984201
chr18	SS18	26087500	26087577	0	78	51	6099	51	6021	0.0	0.008470353761833582
chr18	SS18	26084051	26084175	0	125	51	6099	51	5974	0.0	0.008536993639102779
chr18	SS18	26079010	26079146	0	137	51	6099	51	5962	0.0	0.008554176450855417
chr18	NOL4	34121233	34121316	0	84	809	5584	809	5500	0.0	0.14709090909090908
chr18	NOL4	34128848	34128889	0	42	809	5584	809	5542	0.0	0.14597618188379646
chr18	ZNF396	35374469	35374823	0	355	0	4789	0	4434	0.0	0.0
chr18	ZNF396	35376126	35376270	0	145	0	4789	0	4644	0.0	0.0
chr18	TPGS2	36820967	36821129	0	163	5074	9685	5074	9522	0.0	0.532871245536652
chr18	TPGS2	36823802	36823871	0	70	5074	9685	5074	9615	0.0	0.5277171086843474
chr18	MIR924HG	39214127	39214269	21	143	416	11691	395	11548	0.14685314685314685	0.03420505715275372
chr18	MIR924HG	39233108	39233530	0	423	416	11691	416	11268	0.0	0.03691870784522542
chr18	MIR924HG	39233402	39233530	0	129	416	11691	416	11562	0.0	0.03597993426742778
chr18	MIR924HG	39327765	39327951	0	187	416	11691	416	11504	0.0	0.03616133518776078
chr18	MIR924HG	39388428	39388527	0	100	416	11691	416	11591	0.0	0.035889914588905183
chr18	MIR924HG	39535457	39535615	176	159	416	11691	240	11532	1.1069182389937107	0.02081165452653486
chr18	MIR924HG	39208598	39208789	0	192	416	11691	416	11499	0.0	0.03617705887468475
chr18	MIR924HG	39293185	39293304	0	120	416	11691	416	11571	0.0	0.03595194883761127
chr18	MIR924HG	39751328	39751360	0	33	416	11691	416	11658	0.0	0.035683650711957456
chr18	MIR924HG	39699548	39699635	0	88	416	11691	416	11603	0.0	0.03585279669051108
chr18	MIR924HG	39712655	39712803	0	149	416	11691	416	11542	0.0	0.03604228036735401
chr18	KC6	41525354	41525526	0	173	0	4708	0	4535	0.0	0.0
chr18	KC6	41594345	41594468	0	124	0	4708	0	4584	0.0	0.0
chr18	LINC01478	44383295	44383428	394	134	2643	4614	2249	4480	2.9402985074626864	0.5020089285714285
chr18	LINC01478	44423932	44423973	0	42	2643	4614	2643	4572	0.0	0.5780839895013123
chr18	LINC01478	44518224	44518363	243	140	2643	4614	2400	4474	1.7357142857142858	0.5364327223960662
chr18	LINC01478	44373284	44373483	153	200	2643	4614	2490	4414	0.765	0.5641141821477118
chr18	LINC01478	44518224	44518368	258	145	2643	4614	2385	4469	1.7793103448275862	0.5336764376818081
chr18	LINC01478	44419854	44419892	0	39	2643	4614	2643	4575	0.0	0.5777049180327869
chr18	LINC01478	44393822	44393889	276	68	2643	4614	2367	4546	4.0588235294117645	0.5206775186977562
chr18	AC090376.1	45169095	45169139	0	45	349	3400	349	3355	0.0	0.10402384500745157
chr18	AC090376.1	45169431	45169521	0	91	349	3400	349	3309	0.0	0.10546993049259595
chr18	PIAS2	46864163	46864248	0	86	26488	17092	26488	17006	0.0	1.5575679172056922
chr18	PIAS2	46890579	46891054	0	476	26488	17092	26488	16616	0.0	1.5941261434761675
chr18	HDHD2	47137234	47137338	0	105	0	4612	0	4507	0.0	0.0
chr18	HDHD2	47149048	47149108	0	61	0	4612	0	4551	0.0	0.0
chr18	HDHD2	47137234	47137296	0	63	0	4612	0	4549	0.0	0.0
chr18	ZBTB7C	48087669	48087798	0	130	0	7629	0	7499	0.0	0.0
chr18	ZBTB7C	48162347	48162397	0	51	0	7629	0	7578	0.0	0.0
chr18	ZBTB7C	48076935	48077003	0	69	0	7629	0	7560	0.0	0.0
chr18	ZBTB7C	48165130	48165257	0	128	0	7629	0	7501	0.0	0.0
chr18	ZBTB7C	48180386	48180477	0	92	0	7629	0	7537	0.0	0.0
chr18	ZBTB7C	48072459	48072610	0	152	0	7629	0	7477	0.0	0.0
chr18	ZBTB7C	48180329	48180477	0	149	0	7629	0	7480	0.0	0.0
chr18	ZBTB7C	48165130	48165253	0	124	0	7629	0	7505	0.0	0.0
chr18	ZBTB7C	48338173	48338398	0	226	0	7629	0	7403	0.0	0.0
chr18	ZBTB7C	48408357	48408655	0	299	0	7629	0	7330	0.0	0.0
chr18	ZBTB7C	48185323	48185455	0	133	0	7629	0	7496	0.0	0.0
chr18	ZBTB7C	48364153	48364214	0	62	0	7629	0	7567	0.0	0.0
chr18	ZBTB7C	48374221	48374313	0	93	0	7629	0	7536	0.0	0.0
chr18	DYM	49393644	49393742	0	99	161	12141	161	12042	0.0	0.013369872114266733
chr18	DYM	49417934	49418057	0	124	161	12141	161	12017	0.0	0.013397686610634934
chr18	MBD1	50274185	50274353	0	169	0	5812	0	5643	0.0	0.0
chr18	MBD1	50274976	50275045	0	70	0	5812	0	5742	0.0	0.0
chr18	TCF4	55482149	55482256	0	108	106663	22459	106663	22351	0.0	4.772180215650306
chr18	TCF4	55518981	55519024	0	44	106663	22459	106663	22415	0.0	4.758554539370957
chr18	TCF4	55232508	55232671	247	164	106663	22459	106416	22295	1.5060975609756098	4.773088136353443
chr18	TCF4	55234416	55234459	0	44	106663	22459	106663	22415	0.0	4.758554539370957
chr18	TCF4	55232520	55232671	187	152	106663	22459	106476	22307	1.230263157894737	4.773210203075267
chr18	TCF4	55596105	55596226	0	122	106663	22459	106663	22337	0.0	4.775171240542598
chr18	TCF4	55631297	55631388	0	92	106663	22459	106663	22367	0.0	4.768766486341486
chr18	TCF4	55587044	55587136	0	93	106663	22459	106663	22366	0.0	4.76897970133238
chr18	LINC01539	56121622	56121957	0	336	147	4888	147	4552	0.0	0.032293497363796136
chr18	LINC01539	56122292	56122529	45	238	147	4888	102	4650	0.18907563025210083	0.02193548387096774
chr18	LINC01539	56121622	56121722	0	101	147	4888	147	4787	0.0	0.030708167954877793
chr18	LINC01539	56087638	56087760	0	123	147	4888	147	4765	0.0	0.030849947534102834
chr18	LINC01539	56102690	56102829	0	140	147	4888	147	4748	0.0	0.030960404380791912
chr18	LINC01539	56090184	56090303	0	120	147	4888	147	4768	0.0	0.03083053691275168
chr18	LINC01539	56095829	56096096	0	268	147	4888	147	4620	0.0	0.031818181818181815
chr18	LINC01539	56122292	56122488	45	197	147	4888	102	4691	0.22842639593908629	0.021743764655723728
chr18	LINC01539	56129800	56129973	0	174	147	4888	147	4714	0.0	0.031183708103521425
chr18	LINC01539	56121277	56121446	0	170	147	4888	147	4718	0.0	0.03115727002967359
chr18	LINC01539	56096006	56096096	0	91	147	4888	147	4797	0.0	0.030644152595372107
chr18	LINC-ROR	57058886	57059243	0	358	90	3868	90	3510	0.0	0.02564102564102564
chr18	LINC-ROR	57060352	57060516	0	165	90	3868	90	3703	0.0	0.024304617877396704
chr18	LINC-ROR	57059202	57059243	0	42	90	3868	90	3826	0.0	0.023523261892315735
chr18	ATP8B1	57704554	57704668	0	115	9495	7060	9495	6945	0.0	1.367170626349892
chr18	ATP8B1	57706489	57706587	0	99	9495	7060	9495	6961	0.0	1.3640281568740125
chr18	PIGN	62162252	62162329	0	78	0	17779	0	17701	0.0	0.0
chr18	PIGN	62163530	62163656	0	127	0	17779	0	17652	0.0	0.0
chr18	PIGN	62058815	62059020	0	206	0	17779	0	17573	0.0	0.0
chr18	PIGN	62059047	62059168	0	122	0	17779	0	17657	0.0	0.0
chr18	PIGN	62103588	62103599	0	12	0	17779	0	17767	0.0	0.0
chr18	PIGN	62103718	62103799	0	82	0	17779	0	17697	0.0	0.0
chr18	BCL2	63280886	63281214	0	329	51	8671	51	8342	0.0	0.0061136418125149845
chr18	BCL2	63301661	63301865	0	205	51	8671	51	8466	0.0	0.006024096385542169
chr18	KDSR	63366249	63366308	0	60	0	8861	0	8801	0.0	0.0
chr18	KDSR	63366404	63366674	0	271	0	8861	0	8590	0.0	0.0
chr18	TMX3	68701744	68701790	0	47	1531	7188	1531	7141	0.0	0.21439574289315222
chr18	TMX3	68710020	68710144	0	125	1531	7188	1531	7063	0.0	0.2167634149794705
chr18	TMX3	68700404	68700485	0	82	1531	7188	1531	7106	0.0	0.2154517309316071
chr18	MBP	76990826	76990914	0	89	0	6992	0	6903	0.0	0.0
chr18	MBP	77009848	77009926	0	79	0	6992	0	6913	0.0	0.0
chr18	LINC01029	77979494	77979629	0	136	765	4456	765	4320	0.0	0.17708333333333334
chr18	LINC01029	77990092	77990174	0	83	765	4456	765	4373	0.0	0.17493711410930712
chr18	SLC66A2	79930227	79930311	0	85	0	4902	0	4817	0.0	0.0
chr18	SLC66A2	79933968	79934022	0	55	0	4902	0	4847	0.0	0.0
chr18	SLC66A2	79949518	79949655	0	138	0	4902	0	4764	0.0	0.0
chr18	SLC66A2	79949686	79949838	0	153	0	4902	0	4749	0.0	0.0
chr18	SLC66A2	79949518	79949636	0	119	0	4902	0	4783	0.0	0.0
chr18	SLC66A2	79947266	79947341	0	76	0	4902	0	4826	0.0	0.0
chr18	TXNL4A	79979332	79979640	0	309	0	5227	0	4918	0.0	0.0
chr18	TXNL4A	79986601	79986750	0	150	0	5227	0	5077	0.0	0.0
chr19	TMEM259	1010990	1011095	1688	106	949744	3940	948056	3834	15.924528301886792	247.27595200834637
chr19	TMEM259	1011095	1011195	56564	101	949744	3940	893180	3839	560.039603960396	232.65954675696796
chr19	POLR2E	1093755	1093903	984	149	762390	2591	761406	2442	6.604026845637584	311.7960687960688
chr19	POLR2E	1093903	1094078	119767	176	762390	2591	642623	2415	680.4943181818181	266.09648033126297
chr19	TCF3	1612206	1612433	68701	228	1381814	5864	1313113	5636	301.3201754385965	232.98669268985097
chr19	TCF3	1615284	1615520	71993	237	1381814	5864	1309821	5627	303.7679324894515	232.7743024702328
chr19	TCF3	1612206	1612430	68351	225	1381814	5864	1313463	5639	303.78222222222223	232.9248093633623
chr19	TCF3	1615284	1615485	63380	202	1381814	5864	1318434	5662	313.76237623762376	232.85658777817025
chr19	MFSD12	3550983	3551194	71959	212	623954	4683	551995	4471	339.4292452830189	123.46119436367702
chr19	MFSD12	3567144	3567242	0	99	623954	4683	623954	4584	0.0	136.1156195462478
chr19	SIRT6	4179103	4179286	42443	184	181126	2675	138683	2491	230.66847826086956	55.673625050180654
chr19	SIRT6	4180781	4180909	21115	129	181126	2675	160011	2546	163.68217054263565	62.847996857816185
chr19	DPP9	4715528	4715726	1934	199	1361843	6781	1359909	6582	9.71859296482412	206.61030082041933
chr19	DPP9	4719202	4719324	0	123	1361843	6781	1361843	6658	0.0	204.54235506158005
chr19	RANBP3	5965732	5965922	444	191	967748	7119	967304	6928	2.324607329842932	139.62240184757505
chr19	RANBP3	5974349	5974431	168	83	967748	7119	967580	7036	2.0240963855421685	137.51847640704946
chr19	RANBP3	5976380	5976574	0	195	967748	7119	967748	6924	0.0	139.76718659734257
chr19	RFX2	6044192	6044282	2003	91	76789	7521	74786	7430	22.01098901098901	10.065410497981157
chr19	RFX2	6047406	6047504	965	99	76789	7521	75824	7422	9.747474747474747	10.216114254917812
chr19	RFX2	6042043	6042123	826	81	76789	7521	75963	7440	10.197530864197532	10.210080645161291
chr19	SLC25A23	6438190	6438312	0	123	431784	3621	431784	3498	0.0	123.43739279588337
chr19	SLC25A23	6438446	6438534	357	89	431784	3621	431427	3532	4.01123595505618	122.14807474518686
chr19	SLC25A23	6438723	6438771	0	49	431784	3621	431784	3572	0.0	120.88017917133259
chr19	SLC25A23	6438723	6438821	144	99	431784	3621	431640	3522	1.4545454545454546	122.55536626916525
chr19	TUBB4A	6496369	6496463	0	95	59742	1824	59742	1729	0.0	34.55292076344708
chr19	TUBB4A	6500615	6500742	0	128	59742	1824	59742	1696	0.0	35.2252358490566
chr19	GPR108	6735621	6735704	11982	84	307609	2886	295627	2802	142.64285714285714	105.505710206995
chr19	GPR108	6735907	6735958	7376	52	307609	2886	300233	2834	141.84615384615384	105.93966125617501
chr19	ELAVL1	7967564	7967790	352	227	55142	4626	54790	4399	1.550660792951542	12.455103432598317
chr19	ELAVL1	7973558	7973625	1161	68	55142	4626	53981	4558	17.073529411764707	11.843132953049583
chr19	ADAMTS10	8605622	8605809	0	188	3150	5729	3150	5541	0.0	0.568489442338928
chr19	ADAMTS10	8608133	8608248	0	116	3150	5729	3150	5613	0.0	0.5611972207375735
chr19	ZNF426	9533839	9533966	15	128	328588	7553	328573	7425	0.1171875	44.252255892255896
chr19	ZNF426	9535187	9535279	2250	93	328588	7553	326338	7460	24.193548387096776	43.745040214477214
chr19	ZNF561	9614020	9614103	0	84	51	5565	51	5481	0.0	0.009304871373836891
chr19	ZNF561	9617044	9617171	0	128	51	5565	51	5437	0.0	0.0093801728894611
chr19	ZNF561	9618090	9618179	0	90	51	5565	51	5475	0.0	0.009315068493150684
chr19	ZNF562	9658008	9658135	51	128	44676	2122	44625	1994	0.3984375	22.379638916750253
chr19	ZNF562	9659378	9659467	0	90	44676	2122	44676	2032	0.0	21.986220472440944
chr19	FBXL12	9813230	9813274	0	45	0	2784	0	2739	0.0	0.0
chr19	FBXL12	9814571	9814669	0	99	0	2784	0	2685	0.0	0.0
chr19	FBXL12	9814137	9814339	0	203	0	2784	0	2581	0.0	0.0
chr19	FBXL12	9814137	9814342	0	206	0	2784	0	2578	0.0	0.0
chr19	KEAP1	10489191	10489368	0	178	4225	3562	4225	3384	0.0	1.2485224586288417
chr19	KEAP1	10489647	10489853	0	207	4225	3562	4225	3355	0.0	1.2593144560357674
chr19	TMED1	10834933	10835117	51	185	2700	1889	2649	1704	0.2756756756756757	1.5545774647887325
chr19	TMED1	10835255	10835353	0	99	2700	1889	2700	1790	0.0	1.5083798882681565
chr19	YIPF2	10927629	10927769	235	141	92640	2417	92405	2276	1.6666666666666667	40.599736379613354
chr19	YIPF2	10927798	10927959	0	162	92640	2417	92640	2255	0.0	41.08203991130821
chr19	DOCK6	11229297	11229390	221	94	308169	9585	307948	9491	2.351063829787234	32.446317564008005
chr19	DOCK6	11232184	11232289	0	106	308169	9585	308169	9479	0.0	32.51070788057812
chr19	TMEM205	11345251	11345415	0	165	12586	1389	12586	1224	0.0	10.282679738562091
chr19	TMEM205	11345519	11345628	0	110	12586	1389	12586	1279	0.0	9.840500390930414
chr19	ECSIT	11519843	11519966	0	124	0	2365	0	2241	0.0	0.0
chr19	ECSIT	11525639	11525737	0	99	0	2365	0	2266	0.0	0.0
chr19	ACP5	11578023	11578194	0	172	0	2095	0	1923	0.0	0.0
chr19	ACP5	11578584	11578657	0	74	0	2095	0	2021	0.0	0.0
chr19	ACP5	11578479	11578657	0	179	0	2095	0	1916	0.0	0.0
chr19	ACP5	11578584	11578764	0	181	0	2095	0	1914	0.0	0.0
chr19	ZNF823	11724193	11724254	5	62	7493	2463	7488	2401	0.08064516129032258	3.1187005414410662
chr19	ZNF823	11725200	11725327	0	128	7493	2463	7493	2335	0.0	3.2089935760171304
chr19	ZNF433	12030139	12030198	1	60	21145	3086	21144	3026	0.016666666666666666	6.987442167878387
chr19	ZNF433	12034827	12034874	0	48	21145	3086	21145	3038	0.0	6.96017116524029
chr19	ZNF433	12021929	12022189	792	261	21145	3086	20353	2825	3.0344827586206895	7.204601769911505
chr19	ZNF564	12541424	12541537	1212	114	3295	3626	2083	3512	10.631578947368421	0.5931093394077449
chr19	ZNF564	12550462	12550652	0	191	3295	3626	3295	3435	0.0	0.9592430858806404
chr19	CACNA1A	13236448	13236618	0	171	1105115	33625	1105115	33454	0.0	33.03386740001196
chr19	CACNA1A	13241520	13241526	56	7	1105115	33625	1105059	33618	8.0	32.871051222559345
chr19	CACNA1A	13227430	13227527	29049	98	1105115	33625	1076066	33527	296.4183673469388	32.09550511528022
chr19	CACNA1A	13228698	13228795	837	98	1105115	33625	1104278	33527	8.540816326530612	32.93697616846124
chr19	PODNL1	13935720	13935830	0	111	48802	3221	48802	3110	0.0	15.691961414790997
chr19	PODNL1	13935979	13936044	0	66	48802	3221	48802	3155	0.0	15.468145800316957
chr19	ASF1B	14121531	14121708	0	178	663	1717	663	1539	0.0	0.43079922027290446
chr19	ASF1B	14126121	14126237	0	117	663	1717	663	1600	0.0	0.414375
chr19	DDX39A	14413979	14414014	0	36	157	3413	157	3377	0.0	0.04649096831507255
chr19	DDX39A	14415947	14415988	4	42	157	3413	153	3371	0.09523809523809523	0.0453871254820528
chr19	DDX39A	14416268	14416405	153	138	157	3413	4	3275	1.108695652173913	0.0012213740458015267
chr19	GIPC1	14482688	14483006	0	319	0	2445	0	2126	0.0	0.0
chr19	GIPC1	14491655	14491743	0	89	0	2445	0	2356	0.0	0.0
chr19	DNAJB1	14518138	14518268	102	131	66706	7011	66604	6880	0.7786259541984732	9.680813953488371
chr19	DNAJB1	14526122	14526198	713	77	66706	7011	65993	6934	9.25974025974026	9.517306028266512
chr19	ADGRE2	14754953	14755127	0	175	4431343	8203	4431343	8028	0.0	551.9859242650723
chr19	ADGRE2	14755653	14755877	0	225	4431343	8203	4431343	7978	0.0	555.4453497117072
chr19	AKAP8L	15403474	15403555	0	82	7065	4512	7065	4430	0.0	1.5948081264108351
chr19	AKAP8L	15403657	15403715	200	59	7065	4512	6865	4453	3.389830508474576	1.5416573096788682
chr19	CYP4F2	15893736	15893881	0	146	0	2924	0	2778	0.0	0.0
chr19	CYP4F2	15895505	15895650	0	146	0	2924	0	2778	0.0	0.0
chr19	CYP4F2	15897413	15897612	0	200	0	2924	0	2724	0.0	0.0
chr19	CIB3	16168136	16168284	0	149	0	717	0	568	0.0	0.0
chr19	CIB3	16173161	16173196	0	36	0	717	0	681	0.0	0.0
chr19	SMIM7	16655237	16655368	51	132	247567	4512	247516	4380	0.38636363636363635	56.510502283105026
chr19	SMIM7	16659157	16659255	0	99	247567	4512	247567	4413	0.0	56.09947881259914
chr19	ISYNA1	18436683	18436877	0	195	0	3012	0	2817	0.0	0.0
chr19	ISYNA1	18437598	18437760	0	163	0	3012	0	2849	0.0	0.0
chr19	SUGP2	18991339	18991553	408	215	231411	6566	231003	6351	1.8976744186046512	36.37269721303732
chr19	SUGP2	18993637	18993740	0	104	231411	6566	231411	6462	0.0	35.81104921077066
chr19	SUGP2	18993647	18993740	0	94	231411	6566	231411	6472	0.0	35.75571693448702
chr19	SUGP1	19310096	19310200	66	105	61876	4861	61810	4756	0.6285714285714286	12.996215306980655
chr19	SUGP1	19316421	19316593	0	173	61876	4861	61876	4688	0.0	13.198805460750853
chr19	ZNF826P	20375959	20376009	0	51	707	6017	707	5966	0.0	0.11850486087831043
chr19	ZNF826P	20408949	20409045	0	97	707	6017	707	5920	0.0	0.11942567567567568
chr19	ZNF708	21310500	21310627	0	128	59096	4331	59096	4203	0.0	14.060433024030454
chr19	ZNF708	21327959	21328141	18	183	59096	4331	59078	4148	0.09836065573770492	14.242526518804244
chr19	ZNF208	21991438	21991737	5935	300	7692	6782	1757	6482	19.783333333333335	0.2710583153347732
chr19	ZNF208	22009487	22009581	196	95	7692	6782	7496	6687	2.0631578947368423	1.1209810079258262
chr19	AC092329.4	23270217	23270292	0	76	102	4965	102	4889	0.0	0.02086316220085907
chr19	AC092329.4	23272618	23272723	0	106	102	4965	102	4859	0.0	0.020991973657131097
chr19	LINC00662	27684694	27685275	0	582	204	28747	204	28165	0.0	0.007243032132078821
chr19	LINC00662	27686871	27686998	0	128	204	28747	204	28619	0.0	0.007128131660784793
chr19	LINC00662	27685056	27685275	0	220	204	28747	204	28527	0.0	0.007151119991586918
chr19	LINC00662	27775792	27775906	0	115	204	28747	204	28632	0.0	0.007124895222129086
chr19	LINC00662	27778710	27779043	0	334	204	28747	204	28413	0.0	0.007179812057860838
chr19	AC005381.1	28453843	28453935	0	93	0	1279	0	1186	0.0	0.0
chr19	AC005381.1	28461286	28461497	0	212	0	1279	0	1067	0.0	0.0
chr19	LINC01837	31941620	31941662	0	43	400	7200	400	7157	0.0	0.05588933910856504
chr19	LINC01837	31942309	31942447	0	139	400	7200	400	7061	0.0	0.0566491998300524
chr19	LINC01837	31930287	31930421	0	135	400	7200	400	7065	0.0	0.056617126680820945
chr19	LINC01837	31930851	31930946	0	96	400	7200	400	7104	0.0	0.05630630630630631
chr19	LINC01837	31922728	31922910	0	183	400	7200	400	7017	0.0	0.05700441784238278
chr19	DMKN	35506125	35506185	45	61	109511	4934	109466	4873	0.7377049180327869	22.463780012312743
chr19	DMKN	35507457	35507511	9	55	109511	4934	109502	4879	0.16363636363636364	22.443533510965363
chr19	DMKN	35508204	35508240	111	37	109511	4934	109400	4897	3.0	22.34020829079028
chr19	DMKN	35506509	35506665	1123	157	109511	4934	108388	4777	7.1528662420382165	22.689554113460332
chr19	DMKN	35505938	35505986	213	49	109511	4934	109298	4885	4.346938775510204	22.374206755373592
chr19	DMKN	35509910	35509961	131	52	109511	4934	109380	4882	2.519230769230769	22.404752150757886
chr19	DMKN	35505938	35506049	241	112	109511	4934	109270	4822	2.1517857142857144	22.660721692243882
chr19	U2AF1L4	35744625	35744738	0	114	153	2606	153	2492	0.0	0.06139646869983949
chr19	U2AF1L4	35745124	35745187	0	64	153	2606	153	2542	0.0	0.06018882769472856
chr19	U2AF1L4	35745124	35745212	0	89	153	2606	153	2517	0.0	0.060786650774731825
chr19	SYNE4	36005332	36005437	0	106	0	2554	0	2448	0.0	0.0
chr19	SYNE4	36008216	36008367	0	152	0	2554	0	2402	0.0	0.0
chr19	ALKBH6	36011403	36011464	0	62	0	2256	0	2194	0.0	0.0
chr19	ALKBH6	36013000	36013089	0	90	0	2256	0	2166	0.0	0.0
chr19	ZNF260	36517285	36517393	312	109	42788	5512	42476	5403	2.8623853211009176	7.861558393485101
chr19	ZNF260	36518029	36518143	7870	115	42788	5512	34918	5397	68.43478260869566	6.469890680007412
chr19	ZNF585B	37195880	37196019	0	140	8610	4304	8610	4164	0.0	2.0677233429394812
chr19	ZNF585B	37198938	37199054	0	117	8610	4304	8610	4187	0.0	2.0563649390972056
chr19	AC016582.1	37853001	37853121	15782	121	160850	4924	145068	4803	130.4297520661157	30.20362273579013
chr19	AC016582.1	37853898	37853962	3846	65	160850	4924	157004	4859	59.16923076923077	32.311998353570694
chr19	CAPN12	38733702	38733781	0	80	1327	4591	1327	4511	0.0	0.29416980713810686
chr19	CAPN12	38734812	38734870	0	59	1327	4591	1327	4532	0.0	0.29280670785525154
chr19	SIRT2	38898378	38898425	0	48	14048	4562	14048	4514	0.0	3.1120957022596367
chr19	SIRT2	38898793	38898918	0	126	14048	4562	14048	4436	0.0	3.1668169522091976
chr19	SIRT2	38890564	38890662	47	99	14048	4562	14001	4463	0.47474747474747475	3.137127492717903
chr19	SIRT2	38891793	38891966	939	174	14048	4562	13109	4388	5.396551724137931	2.9874658158614404
chr19	GMFG	39335260	39335310	2964	51	731932	1395	728968	1344	58.11764705882353	542.3869047619048
chr19	GMFG	39335434	39335531	1622	98	731932	1395	730310	1297	16.551020408163264	563.0763299922899
chr19	COQ8B	40713739	40713869	0	131	19490	11023	19490	10892	0.0	1.789386705839148
chr19	COQ8B	40714066	40714133	0	68	19490	11023	19490	10955	0.0	1.7790963030579643
chr19	COQ8B	40710058	40710136	807	79	19490	11023	18683	10944	10.215189873417721	1.7071454678362572
chr19	COQ8B	40705324	40705447	697	124	19490	11023	18793	10899	5.620967741935484	1.7242866318010828
chr19	COQ8B	40714106	40714133	0	28	19490	11023	19490	10995	0.0	1.7726239199636198
chr19	COQ8B	40714066	40714153	0	88	19490	11023	19490	10935	0.0	1.7823502514860539
chr19	C19ORF54	40742072	40742189	13311	118	286489	2845	273178	2727	112.80508474576271	100.17528419508618
chr19	C19ORF54	40742514	40742770	2262	257	286489	2845	284227	2588	8.801556420233464	109.82496136012365
chr19	PCAT19	41456615	41456918	0	304	0	5541	0	5237	0.0	0.0
chr19	PCAT19	41474465	41474539	0	75	0	5541	0	5466	0.0	0.0
chr19	PCAT19	41456590	41456923	0	334	0	5541	0	5207	0.0	0.0
chr19	PCAT19	41456615	41456923	0	309	0	5541	0	5232	0.0	0.0
chr19	PCAT19	41479080	41479284	0	205	0	5541	0	5336	0.0	0.0
chr19	PCAT19	41495301	41495427	0	127	0	5541	0	5414	0.0	0.0
chr19	PCAT19	41494539	41495427	0	889	0	5541	0	4652	0.0	0.0
chr19	PCAT19	41494539	41494648	0	110	0	5541	0	5431	0.0	0.0
chr19	RABAC1	41957017	41957119	0	103	0	1564	0	1461	0.0	0.0
chr19	RABAC1	41958285	41958383	0	99	0	1564	0	1465	0.0	0.0
chr19	POU2F2	42091866	42091940	0	75	51	8966	51	8891	0.0	0.0057361376673040155
chr19	POU2F2	42092068	42092270	0	203	51	8966	51	8763	0.0	0.005819924683327628
chr19	POU2F2	42092068	42092134	0	67	51	8966	51	8899	0.0	0.0057309810091021466
chr19	GSK3A	42231046	42231192	0	147	0	5487	0	5340	0.0	0.0
chr19	GSK3A	42231562	42231764	0	203	0	5487	0	5284	0.0	0.0
chr19	GSK3A	42233842	42233866	0	25	0	5487	0	5462	0.0	0.0
chr19	GSK3A	42233995	42234191	0	197	0	5487	0	5290	0.0	0.0
chr19	GSK3A	42233842	42233869	0	28	0	5487	0	5459	0.0	0.0
chr19	GSK3A	42233842	42233931	0	90	0	5487	0	5397	0.0	0.0
chr19	GSK3A	42235001	42235119	0	119	0	5487	0	5368	0.0	0.0
chr19	GSK3A	42236006	42236141	0	136	0	5487	0	5351	0.0	0.0
chr19	GSK3A	42235001	42235115	0	115	0	5487	0	5372	0.0	0.0
chr19	CEACAM1	42515010	42515103	0	94	0	5542	0	5448	0.0	0.0
chr19	CEACAM1	42518947	42519235	0	289	0	5542	0	5253	0.0	0.0
chr19	CEACAM1	42516772	42516865	0	94	0	5542	0	5448	0.0	0.0
chr19	PSG8	42758601	42758911	1020	311	190282	3697	189262	3386	3.279742765273312	55.89545186060248
chr19	PSG8	42763915	42764281	51	367	190282	3697	190231	3330	0.13896457765667575	57.12642642642643
chr19	PSG8	42758601	42758941	1020	341	190282	3697	189262	3356	2.9912023460410557	56.395113230035754
chr19	PSG1	42868755	42869034	476	280	50091	4967	49615	4687	1.7	10.585662470663538
chr19	PSG1	42871766	42872045	0	280	50091	4967	50091	4687	0.0	10.687219970130148
chr19	PSG11	43015766	43016045	0	280	51	3090	51	2810	0.0	0.018149466192170817
chr19	PSG11	43018769	43019048	0	280	51	3090	51	2810	0.0	0.018149466192170817
chr19	PSG11	43024690	43025056	0	367	51	3090	51	2723	0.0	0.01872934263679765
chr19	PSG4	43198597	43198937	0	341	0	5236	0	4895	0.0	0.0
chr19	PSG4	43203885	43204251	0	367	0	5236	0	4869	0.0	0.0
chr19	PSG4	43197996	43198275	0	280	0	5236	0	4956	0.0	0.0
chr19	PSG4	43197996	43198130	0	135	0	5236	0	5101	0.0	0.0
chr19	PSG4	43194994	43195273	0	280	0	5236	0	4956	0.0	0.0
chr19	PSG9	43258856	43259135	0	280	2382	5055	2382	4775	0.0	0.49884816753926703
chr19	PSG9	43261859	43262138	0	280	2382	5055	2382	4775	0.0	0.49884816753926703
chr19	XRCC1	43560909	43561020	0	112	102	2762	102	2650	0.0	0.038490566037735846
chr19	XRCC1	43574909	43575002	0	94	102	2762	102	2668	0.0	0.03823088455772114
chr19	PLAUR	43652224	43652371	0	148	1020	4200	1020	4052	0.0	0.25172754195459035
chr19	PLAUR	43655438	43655573	0	136	1020	4200	1020	4064	0.0	0.25098425196850394
chr19	ZNF180	44479282	44479409	94	128	23257	4714	23163	4586	0.734375	5.050806803314435
chr19	ZNF180	44484360	44484435	0	76	23257	4714	23257	4638	0.0	5.0144458818456235
chr19	EML2	45617629	45617697	120	69	36470	6562	36350	6493	1.7391304347826086	5.59833667026028
chr19	EML2	45619059	45619191	0	133	36470	6562	36470	6429	0.0	5.67273292891585
chr19	EML2	45621482	45621637	336	156	36470	6562	36134	6406	2.1538461538461537	5.640649391195754
chr19	EML2	45624718	45624818	204	101	36470	6562	36266	6461	2.01980198019802	5.613062993344683
chr19	SNRPD2	45689232	45689347	54	116	447	1443	393	1327	0.46551724137931033	0.2961567445365486
chr19	SNRPD2	45690571	45690667	0	97	447	1443	447	1346	0.0	0.33209509658246655
chr19	DMPK	45780213	45780381	0	169	12161	4865	12161	4696	0.0	2.5896507666098807
chr19	DMPK	45782192	45782250	0	59	12161	4865	12161	4806	0.0	2.5303786933000416
chr19	IGFL2-AS1	46190284	46190414	306	131	92395	3342	92089	3211	2.33587786259542	28.679227654936156
chr19	IGFL2-AS1	46195677	46195838	357	162	92395	3342	92038	3180	2.2037037037037037	28.942767295597484
chr19	IGFL2-AS1	46190223	46190414	306	192	92395	3342	92089	3150	1.59375	29.234603174603176
chr19	STRN4	46740163	46740285	0	123	9700	7060	9700	6937	0.0	1.398298976502811
chr19	STRN4	46746148	46746211	0	64	9700	7060	9700	6996	0.0	1.3865065751858205
chr19	AP2S1	46839464	46839578	0	115	136	1456	136	1341	0.0	0.10141685309470544
chr19	AP2S1	46845992	46846142	0	151	136	1456	136	1305	0.0	0.10421455938697317
chr19	NAPA	47500632	47500749	1709	118	73632	4857	71923	4739	14.483050847457626	15.176830554969403
chr19	NAPA	47503422	47503502	459	81	73632	4857	73173	4776	5.666666666666667	15.320979899497488
chr19	ZNF541	47538141	47538439	357	299	65149	4670	64792	4371	1.193979933110368	14.823152596659803
chr19	ZNF541	47539704	47539878	0	175	65149	4670	65149	4495	0.0	14.493659621802003
chr19	CARD8	48242539	48242644	102	106	309364	11518	309262	11412	0.9622641509433962	27.099719593410445
chr19	CARD8	48246074	48246381	147363	308	309364	11518	162001	11210	478.4512987012987	14.451471900089206
chr19	TMEM143	48345159	48345354	0	196	51	3499	51	3303	0.0	0.015440508628519528
chr19	TMEM143	48360071	48360176	0	106	51	3499	51	3393	0.0	0.015030946065428824
chr19	TMEM143	48360318	48360568	0	251	51	3499	51	3248	0.0	0.015701970443349755
chr19	TEAD2	49348956	49349059	0	104	39611	2995	39611	2891	0.0	13.701487374610862
chr19	TEAD2	49351300	49351365	48	66	39611	2995	39563	2929	0.7272727272727273	13.507340389211334
chr19	IRF3	49660712	49660828	0	117	28716	3464	28716	3347	0.0	8.579623543471765
chr19	IRF3	49661947	49662328	8203	382	28716	3464	20513	3082	21.473821989528794	6.655743024010383
chr19	IRF3	49664442	49664673	428	232	28716	3464	28288	3232	1.8448275862068966	8.752475247524753
chr19	IRF3	49664673	49664846	14	174	28716	3464	28702	3290	0.08045977011494253	8.72401215805471
chr19	IRF3	49664552	49664673	38	122	28716	3464	28678	3342	0.3114754098360656	8.581089168162777
chr19	IRF3	49664673	49664950	524	278	28716	3464	28192	3186	1.8848920863309353	8.84871311989956
chr19	IRF3	49664586	49664673	38	88	28716	3464	28678	3376	0.4318181818181818	8.494668246445498
chr19	IRF3	49663342	49663514	0	173	28716	3464	28716	3291	0.0	8.725615314494075
chr19	FUZ	49812250	49812335	2357	86	16551	2967	14194	2881	27.406976744186046	4.926761541131552
chr19	FUZ	49812614	49812736	1838	123	16551	2967	14713	2844	14.94308943089431	5.173347398030942
chr19	FUZ	49812637	49812736	1648	100	16551	2967	14903	2867	16.48	5.198116498081618
chr19	PNKP	49862184	49862281	0	98	38801	3802	38801	3704	0.0	10.475431965442764
chr19	PNKP	49862370	49862463	126	94	38801	3802	38675	3708	1.3404255319148937	10.430151024811218
chr19	IL4I1	49896147	49896182	0	36	38	2507	38	2471	0.0	0.01537838931606637
chr19	IL4I1	49901638	49901821	0	184	38	2507	38	2323	0.0	0.016358157554885924
chr19	IL4I1	49901638	49901879	0	242	38	2507	38	2265	0.0	0.016777041942604858
chr19	NUP62	49911104	49911370	0	267	0	2772	0	2505	0.0	0.0
chr19	NUP62	49927693	49927815	0	123	0	2772	0	2649	0.0	0.0
chr19	NUP62	49911104	49911366	0	263	0	2772	0	2509	0.0	0.0
chr19	NUP62	49927693	49927848	0	156	0	2772	0	2616	0.0	0.0
chr19	NUP62	49918507	49918621	0	115	0	2772	0	2657	0.0	0.0
chr19	NUP62	49911104	49911343	0	240	0	2772	0	2532	0.0	0.0
chr19	KLK6	50967168	50967325	0	158	0	1983	0	1825	0.0	0.0
chr19	KLK6	50968064	50968112	0	49	0	1983	0	1934	0.0	0.0
chr19	KLK7	50981766	50981914	0	149	56990	2454	56990	2305	0.0	24.724511930585685
chr19	KLK7	50982326	50982457	17	132	56990	2454	56973	2322	0.12878787878787878	24.536175710594314
chr19	NKG7	51371939	51372074	0	136	0	924	0	788	0.0	0.0
chr19	NKG7	51372160	51372202	0	43	0	924	0	881	0.0	0.0
chr19	AC018755.2	51629832	51630216	0	385	0	2320	0	1935	0.0	0.0
chr19	AC018755.2	51646256	51646640	0	385	0	2320	0	1935	0.0	0.0
chr19	ZNF615	52004416	52004723	0	308	0	4909	0	4601	0.0	0.0
chr19	ZNF615	52007292	52007330	0	39	0	4909	0	4870	0.0	0.0
chr19	ZNF615	52003696	52003900	0	205	0	4909	0	4704	0.0	0.0
chr19	ZNF611	52707468	52707542	52	75	498257	6713	498205	6638	0.6933333333333334	75.05347996384454
chr19	ZNF611	52714014	52714141	1041	128	498257	6713	497216	6585	8.1328125	75.50736522399393
chr19	ZNF611	52707420	52707542	204	123	498257	6713	498053	6590	1.6585365853658536	75.57708649468893
chr19	ZNF611	52707391	52707538	204	148	498257	6713	498053	6565	1.3783783783783783	75.86488956587966
chr19	ZNF611	52708176	52708326	0	151	498257	6713	498257	6562	0.0	75.93066138372447
chr19	ZNF611	52711206	52711304	117	99	498257	6713	498140	6614	1.1818181818181819	75.31599637133354
chr19	ZNF28	52805144	52805262	0	119	2088	1934	2088	1815	0.0	1.1504132231404958
chr19	ZNF28	52808006	52808133	0	128	2088	1934	2088	1806	0.0	1.1561461794019934
chr19	ZNF468	52845178	52845296	0	119	2494	4990	2494	4871	0.0	0.512009854239376
chr19	ZNF468	52846557	52846611	0	55	2494	4990	2494	4935	0.0	0.5053698074974671
chr19	ZNF816	52956191	52956265	0	75	558	3076	558	3001	0.0	0.18593802065978007
chr19	ZNF816	52960026	52960177	558	152	558	3076	0	2924	3.6710526315789473	0.0
chr19	ZNF415	53115209	53115307	0	99	70477	3790	70477	3691	0.0	19.09428339203468
chr19	ZNF415	53115703	53115924	24774	222	70477	3790	45703	3568	111.5945945945946	12.809136771300448
chr19	ZNF415	53122403	53122612	0	210	70477	3790	70477	3580	0.0	19.68631284916201
chr19	ZNF415	53122661	53122743	0	83	70477	3790	70477	3707	0.0	19.01186943620178
chr19	ZNF415	53122403	53122616	0	214	70477	3790	70477	3576	0.0	19.708333333333332
chr19	ZNF415	53123500	53123655	0	156	70477	3790	70477	3634	0.0	19.393780957622454
chr19	ZNF415	53123792	53123906	0	115	70477	3790	70477	3675	0.0	19.177414965986394
chr19	NLRP12	53795858	53796029	0	172	0	4961	0	4789	0.0	0.0
chr19	NLRP12	53798239	53798413	0	175	0	4961	0	4786	0.0	0.0
chr19	VSTM1	54042168	54042196	0	29	454	1416	454	1387	0.0	0.32732516222062
chr19	VSTM1	54042226	54042369	0	144	454	1416	454	1272	0.0	0.35691823899371067
chr19	RDH13	55064295	55064412	0	118	0	7482	0	7364	0.0	0.0
chr19	RDH13	55068412	55068530	0	119	0	7482	0	7363	0.0	0.0
chr19	TMEM150B	55320038	55320166	0	129	0	1723	0	1594	0.0	0.0
chr19	TMEM150B	55320390	55320458	0	69	0	1723	0	1654	0.0	0.0
chr19	COX6B2	55352414	55352502	0	89	0	2992	0	2903	0.0	0.0
chr19	COX6B2	55352532	55352736	0	205	0	2992	0	2787	0.0	0.0
chr19	ZNF667	56444130	56444281	0	152	11	8817	11	8665	0.0	0.0012694748990190422
chr19	ZNF667	56449556	56449657	0	102	11	8817	11	8715	0.0	0.0012621916236374069
chr19	PEG3	56829782	56829921	21	140	14091	8725	14070	8585	0.15	1.638905066977286
chr19	PEG3	56833289	56833420	0	132	14091	8725	14091	8593	0.0	1.6398231118352147
chr19	PEG3	56827133	56827246	0	114	14091	8725	14091	8611	0.0	1.636395308326559
chr19	ZNF814	57870721	57870812	2201	92	106075	9024	103874	8932	23.92391304347826	11.629422301836096
chr19	ZNF814	57875155	57875226	51	72	106075	9024	106024	8952	0.7083333333333334	11.84361036639857
chr19	ZNF417	57915337	57915531	0	195	38014	5283	38014	5088	0.0	7.471305031446541
chr19	ZNF417	57915564	57915665	0	102	38014	5283	38014	5181	0.0	7.337193591970662
chr19	PTBP1	805491	805569	65999	79	5035324	6449	4969325	6370	835.4303797468355	780.1138147566719
chr19	PTBP1	805831	805902	1220	72	5035324	6449	5034104	6377	16.944444444444443	789.4157127175788
chr19	PTBP1	805512	805569	48566	58	5035324	6449	4986758	6391	837.3448275862069	780.2782037239868
chr19	IZUMO4	2097928	2097955	216	28	4993	2228	4777	2200	7.714285714285714	2.1713636363636364
chr19	IZUMO4	2098051	2098127	448	77	4993	2228	4545	2151	5.818181818181818	2.1129707112970713
chr19	ANKRD24	4202868	4202926	0	59	1000	4499	1000	4440	0.0	0.22522522522522523
chr19	ANKRD24	4207107	4207134	0	28	1000	4499	1000	4471	0.0	0.22366360993066428
chr19	MIR7-3HG	4770084	4770221	0	138	0	2134	0	1996	0.0	0.0
chr19	MIR7-3HG	4770282	4770449	0	168	0	2134	0	1966	0.0	0.0
chr19	MIR7-3HG	4770087	4770221	0	135	0	2134	0	1999	0.0	0.0
chr19	HSD11B1L	5684818	5684905	1748	88	69686	2790	67938	2702	19.863636363636363	25.14359733530718
chr19	HSD11B1L	5684964	5685119	5152	156	69686	2790	64534	2634	33.02564102564103	24.500379650721335
chr19	HSD11B1L	5684992	5685119	4736	128	69686	2790	64950	2662	37.0	24.39894815927874
chr19	HSD11B1L	5686415	5686527	224	113	69686	2790	69462	2677	1.9823008849557522	25.947702652222638
chr19	HSD11B1L	5684988	5685119	4816	132	69686	2790	64870	2658	36.484848484848484	24.40556809631302
chr19	HSD11B1L	5686899	5686991	1067	93	69686	2790	68619	2697	11.473118279569892	25.442714126807562
chr19	PNPLA6	7556965	7557082	0	118	73313	6495	73313	6377	0.0	11.496471695154462
chr19	PNPLA6	7557167	7557284	0	118	73313	6495	73313	6377	0.0	11.496471695154462
chr19	CLEC4M	7763392	7763476	0	85	40	3275	40	3190	0.0	0.012539184952978056
chr19	CLEC4M	7765184	7765268	0	85	40	3275	40	3190	0.0	0.012539184952978056
chr19	CERS4	8210705	8210862	0	158	102	3466	102	3308	0.0	0.03083434099153567
chr19	CERS4	8251075	8251249	0	175	102	3466	102	3291	0.0	0.03099361896080219
chr19	HNRNPM	8462528	8462589	14	62	19490	4301	19476	4239	0.22580645161290322	4.59447983014862
chr19	HNRNPM	8463496	8463504	0	9	19490	4301	19490	4292	0.0	4.5410065237651445
chr19	HNRNPM	8463496	8463500	0	5	19490	4301	19490	4296	0.0	4.536778398510242
chr19	ZNF559-ZNF177	9333014	9333113	0	100	0	3733	0	3633	0.0	0.0
chr19	ZNF559-ZNF177	9337795	9337858	0	64	0	3733	0	3669	0.0	0.0
chr19	ZNF561-AS1	9626783	9626860	0	78	46434	6441	46434	6363	0.0	7.297501178689298
chr19	ZNF561-AS1	9627715	9627806	0	92	46434	6441	46434	6349	0.0	7.313592691762483
chr19	DNM2	10796060	10796199	149965	140	2080184	9503	1930219	9363	1071.1785714285713	206.15390366335575
chr19	DNM2	10797379	10797518	1017	140	2080184	9503	2079167	9363	7.264285714285714	222.06205276086723
chr19	SMARCA4	10977652	10977815	0	164	1031494	15628	1031494	15464	0.0	66.70292291774444
chr19	SMARCA4	10980776	10980852	0	77	1031494	15628	1031494	15551	0.0	66.32975371358755
chr19	SMARCA4	10965306	10965309	0	4	1031494	15628	1031494	15624	0.0	66.01984126984127
chr19	SMARCA4	10983479	10983711	285	233	1031494	15628	1031209	15395	1.2231759656652361	66.98337122442351
chr19	SMARCA4	11047594	11047795	116	202	1031494	15628	1031378	15426	0.5742574257425742	66.85971736030079
chr19	SMARCA4	11056216	11056382	0	167	1031494	15628	1031494	15461	0.0	66.7158657266671
chr19	LDLR	11102663	11102786	798	124	155534	6361	154736	6237	6.435483870967742	24.809363476030143
chr19	LDLR	11105219	11105600	94978	382	155534	6361	60556	5979	248.63350785340313	10.128115069409601
chr19	ZNF136	12164465	12164874	0	410	95924	5383	95924	4973	0.0	19.28896038608486
chr19	ZNF136	12169281	12169391	0	111	95924	5383	95924	5272	0.0	18.194992412746586
chr19	ZNF791	12623699	12623826	0	128	19085	6647	19085	6519	0.0	2.9275962570946463
chr19	ZNF791	12624649	12624710	170	62	19085	6647	18915	6585	2.7419354838709675	2.8724373576309796
chr19	GCDH	12892115	12892178	0	64	1377	4015	1377	3951	0.0	0.34851936218678814
chr19	GCDH	12892316	12892434	0	119	1377	4015	1377	3896	0.0	0.3534394250513347
chr19	CLEC17A	14600030	14600182	3698	153	15762	3130	12064	2977	24.169934640522875	4.0524017467248905
chr19	CLEC17A	14606992	14607102	92	111	15762	3130	15670	3019	0.8288288288288288	5.190460417356741
chr19	CYP4F3	15643906	15644051	0	146	14	5101	14	4955	0.0	0.0028254288597376388
chr19	CYP4F3	15645718	15645863	0	146	14	5101	14	4955	0.0	0.0028254288597376388
chr19	UCA1	15831254	15831356	0	103	0	2973	0	2870	0.0	0.0
chr19	UCA1	15834501	15835114	0	614	0	2973	0	2359	0.0	0.0
chr19	UCA1	15831254	15831337	0	84	0	2973	0	2889	0.0	0.0
chr19	UCA1	15831207	15831356	0	150	0	2973	0	2823	0.0	0.0
chr19	UCA1	15831197	15831356	0	160	0	2973	0	2813	0.0	0.0
chr19	UCA1	15835217	15835280	0	64	0	2973	0	2909	0.0	0.0
chr19	UCA1	15832512	15832588	0	77	0	2973	0	2896	0.0	0.0
chr19	UCA1	15833570	15833632	0	63	0	2973	0	2910	0.0	0.0
chr19	TPM4	16077956	16078149	0	194	102	9477	102	9283	0.0	0.010987827211030917
chr19	TPM4	16081019	16081075	0	57	102	9477	102	9420	0.0	0.010828025477707006
chr19	HSH2D	16148723	16148875	0	153	0	3407	0	3254	0.0	0.0
chr19	HSH2D	16151446	16151578	0	133	0	3407	0	3274	0.0	0.0
chr19	HSH2D	16148723	16148800	0	78	0	3407	0	3329	0.0	0.0
chr19	MYO9B	17177796	17177886	0	91	247569	9359	247569	9268	0.0	26.712235649546827
chr19	MYO9B	17180926	17181040	94	115	247569	9359	247475	9244	0.8173913043478261	26.77141929900476
chr19	ARMC6	19034130	19034238	0	109	65154	4030	65154	3921	0.0	16.616679418515684
chr19	ARMC6	19037551	19037707	654	157	65154	4030	64500	3873	4.165605095541402	16.65375677769171
chr19	ARMC6	19039321	19039414	10407	94	65154	4030	54747	3936	110.7127659574468	13.909298780487806
chr19	ARMC6	19040689	19040792	51	104	65154	4030	65103	3926	0.49038461538461536	16.582526744778402
chr19	ZNF85	20934023	20934150	0	128	0	4677	0	4549	0.0	0.0
chr19	ZNF85	20934948	20935047	0	100	0	4677	0	4577	0.0	0.0
chr19	ZNF431	21169802	21169882	18	81	6923	8821	6905	8740	0.2222222222222222	0.790045766590389
chr19	ZNF431	21175452	21175474	20	23	6923	8821	6903	8798	0.8695652173913043	0.7846101386678791
chr19	ZNF257	22081553	22081670	0	118	255	5178	255	5060	0.0	0.05039525691699605
chr19	ZNF257	22087530	22087595	0	66	255	5178	255	5112	0.0	0.04988262910798122
chr19	AC092279.1	24047050	24047146	0	97	3569	11997	3569	11900	0.0	0.2999159663865546
chr19	AC092279.1	24047707	24047850	765	144	3569	11997	2804	11853	5.3125	0.23656458280604067
chr19	AC092279.1	24034522	24034712	0	191	3569	11997	3569	11806	0.0	0.30230391326444184
chr19	AC092279.1	24036252	24036382	0	131	3569	11997	3569	11866	0.0	0.3007753244564301
chr19	AC092279.1	24057930	24058106	38	177	3569	11997	3531	11820	0.21468926553672316	0.2987309644670051
chr19	AC092279.1	24063815	24063941	0	127	3569	11997	3569	11870	0.0	0.30067396798652063
chr19	AC092279.1	24057930	24058300	38	371	3569	11997	3531	11626	0.10242587601078167	0.3037158093927404
chr19	AC092279.1	24057930	24058230	38	301	3569	11997	3531	11696	0.12624584717607973	0.3018980848153215
chr19	AC092279.1	24042442	24042722	0	281	3569	11997	3569	11716	0.0	0.30462615227039946
chr19	AC092279.1	24049661	24049839	0	179	3569	11997	3569	11818	0.0	0.3019969537992892
chr19	AC092279.1	24050184	24050302	0	119	3569	11997	3569	11878	0.0	0.3004714598417242
chr19	AC092279.1	24049404	24049548	0	145	3569	11997	3569	11852	0.0	0.30113061086736415
chr19	AC092279.1	24049409	24049548	0	140	3569	11997	3569	11857	0.0	0.30100362654971746
chr19	LINC00906	28965929	28966627	0	699	144	6203	144	5504	0.0	0.02616279069767442
chr19	LINC00906	28968946	28969042	0	97	144	6203	144	6106	0.0	0.023583360628889615
chr19	LINC00906	28965929	28966663	0	735	144	6203	144	5468	0.0	0.026335040234089245
chr19	LINC00906	28965929	28966472	0	544	144	6203	144	5659	0.0	0.025446191906697297
chr19	LINC01532	29004173	29004252	0	80	0	4140	0	4060	0.0	0.0
chr19	LINC01532	29010730	29010946	0	217	0	4140	0	3923	0.0	0.0
chr19	POP4	29610408	29610457	0	50	51	4182	51	4132	0.0	0.012342691190706679
chr19	POP4	29611861	29611939	0	79	51	4182	51	4103	0.0	0.012429929320009749
chr19	LINC01791	31178723	31178816	0	94	0	3441	0	3347	0.0	0.0
chr19	LINC01791	31195589	31195703	0	115	0	3441	0	3326	0.0	0.0
chr19	LINC01791	31168344	31168656	0	313	0	3441	0	3128	0.0	0.0
chr19	LINC01791	31170179	31170265	0	87	0	3441	0	3354	0.0	0.0
chr19	LINC01791	31195586	31195703	0	118	0	3441	0	3323	0.0	0.0
chr19	LINC01791	31204745	31204920	0	176	0	3441	0	3265	0.0	0.0
chr19	AC011525.2	31588627	31588680	0	54	612	3123	612	3069	0.0	0.19941348973607037
chr19	AC011525.2	31588817	31588948	0	132	612	3123	612	2991	0.0	0.2046138415245737
chr19	AC011525.2	31588600	31588680	0	81	612	3123	612	3042	0.0	0.20118343195266272
chr19	AC011525.2	31591219	31591310	0	92	612	3123	612	3031	0.0	0.2019135598812273
chr19	AC011525.2	31588786	31588948	0	163	612	3123	612	2960	0.0	0.20675675675675675
chr19	AC011525.2	31588761	31588948	0	188	612	3123	612	2935	0.0	0.20851788756388415
chr19	AC011525.2	31590355	31590478	0	124	612	3123	612	2999	0.0	0.20406802267422475
chr19	AC011525.2	31590039	31590116	0	78	612	3123	612	3045	0.0	0.20098522167487684
chr19	AC011525.2	31589981	31590116	0	136	612	3123	612	2987	0.0	0.20488784733846668
chr19	AC011525.2	31589857	31590116	0	260	612	3123	612	2863	0.0	0.2137617883339155
chr19	AC011525.2	31589862	31590116	0	255	612	3123	612	2868	0.0	0.21338912133891214
chr19	AC011525.2	31591212	31591310	0	99	612	3123	612	3024	0.0	0.20238095238095238
chr19	AC011525.2	31591073	31591310	0	238	612	3123	612	2885	0.0	0.2121317157712305
chr19	AC011525.2	31590355	31590452	0	98	612	3123	612	3025	0.0	0.20231404958677687
chr19	AC011525.2	31589908	31590116	0	209	612	3123	612	2914	0.0	0.21002059025394645
chr19	LINC01533	32040365	32040570	0	206	0	3749	0	3543	0.0	0.0
chr19	LINC01533	32042899	32043071	0	173	0	3749	0	3576	0.0	0.0
chr19	LINC01533	32039492	32040570	0	1079	0	3749	0	2670	0.0	0.0
chr19	LINC01533	32039492	32039619	0	128	0	3749	0	3621	0.0	0.0
chr19	DPY19L3	32480704	32480756	0	53	0	10805	0	10752	0.0	0.0
chr19	DPY19L3	32481040	32481940	0	901	0	10805	0	9904	0.0	0.0
chr19	LSM14A	34208928	34209051	0	124	0	4760	0	4636	0.0	0.0
chr19	LSM14A	34215123	34215300	0	178	0	4760	0	4582	0.0	0.0
chr19	GPI	34368582	34368702	0	121	0	7809	0	7688	0.0	0.0
chr19	GPI	34377502	34377586	0	85	0	7809	0	7724	0.0	0.0
chr19	LSR	35261924	35261981	671	58	2164	2695	1493	2637	11.568965517241379	0.5661736822146378
chr19	LSR	35262545	35262692	402	148	2164	2695	1762	2547	2.7162162162162162	0.6917942677659992
chr19	MAG	35295385	35295454	0	70	0	2972	0	2902	0.0	0.0
chr19	MAG	35295454	35295510	0	57	0	2972	0	2915	0.0	0.0
chr19	ARHGAP33	35778463	35778601	0	139	0	4441	0	4302	0.0	0.0
chr19	ARHGAP33	35778654	35778699	0	46	0	4441	0	4395	0.0	0.0
chr19	TBCB	36117790	36117928	62	139	78786	3141	78724	3002	0.4460431654676259	26.223850766155895
chr19	TBCB	36118527	36118664	0	138	78786	3141	78786	3003	0.0	26.235764235764236
chr19	ZNF790-AS1	36812509	36812606	0	98	97040	7129	97040	7031	0.0	13.801735172806143
chr19	ZNF790-AS1	36812909	36813032	4081	124	97040	7129	92959	7005	32.91129032258065	13.27037830121342
chr19	ZNF790-AS1	36823730	36823821	100	92	97040	7129	96940	7037	1.0869565217391304	13.775756714509024
chr19	ZNF345	36854449	36854594	0	146	26414	4030	26414	3884	0.0	6.800720906282184
chr19	ZNF345	36872550	36872748	0	199	26414	4030	26414	3831	0.0	6.894805533803185
chr19	ZNF345	36862916	36863011	0	96	26414	4030	26414	3934	0.0	6.714285714285714
chr19	ZNF345	36876784	36876876	2662	93	26414	4030	23752	3937	28.623655913978496	6.033020066040132
chr19	ZNF568	36976326	36976367	0	42	15675	9232	15675	9190	0.0	1.705658324265506
chr19	ZNF568	36991175	36991299	90	125	15675	9232	15585	9107	0.72	1.7113209618974414
chr19	LINC01535	37257230	37257394	153	165	2495	2437	2342	2272	0.9272727272727272	1.0308098591549295
chr19	LINC01535	37262354	37262434	0	81	2495	2437	2495	2356	0.0	1.0589983022071308
chr19	ZNF875	37358540	37358661	0	122	18915	6750	18915	6628	0.0	2.853802051901026
chr19	ZNF875	37359425	37359546	0	122	18915	6750	18915	6628	0.0	2.853802051901026
chr19	ZNF875	37335168	37335257	662	90	18915	6750	18253	6660	7.355555555555555	2.7406906906906907
chr19	ZNF875	37346422	37346492	0	71	18915	6750	18915	6679	0.0	2.8320107800568945
chr19	ZNF875	37335199	37335257	435	59	18915	6750	18480	6691	7.372881355932203	2.7619189956658197
chr19	ZNF875	37344609	37344774	0	166	18915	6750	18915	6584	0.0	2.8728736330498177
chr19	ZNF875	37346887	37347052	0	166	18915	6750	18915	6584	0.0	2.8728736330498177
chr19	ZNF571-AS1	37566439	37566484	0	46	19237	6494	19237	6448	0.0	2.9834057071960296
chr19	ZNF571-AS1	37567617	37567750	27	134	19237	6494	19210	6360	0.20149253731343283	3.020440251572327
chr19	ZNF571-AS1	37566030	37566089	11	60	19237	6494	19226	6434	0.18333333333333332	2.9881877525645013
chr19	ZNF571-AS1	37569849	37569996	663	148	19237	6494	18574	6346	4.47972972972973	2.9268830759533566
chr19	ZNF571-AS1	37583482	37583834	515	353	19237	6494	18722	6141	1.4589235127478755	3.048689138576779
chr19	ZNF571-AS1	37585083	37585161	848	79	19237	6494	18389	6415	10.734177215189874	2.8665627435697583
chr19	ZNF540	37599625	37599752	0	128	1361	3869	1361	3741	0.0	0.36380646885859397
chr19	ZNF540	37601009	37601105	44	97	1361	3869	1317	3772	0.4536082474226804	0.34915164369034996
chr19	SPINT2	38283626	38283797	51	172	2732	3644	2681	3472	0.29651162790697677	0.7721774193548387
chr19	SPINT2	38287875	38287935	0	61	2732	3644	2732	3583	0.0	0.7624895339101312
chr19	ACTN4	38710256	38710342	0	87	8270	5961	8270	5874	0.0	1.407899216887981
chr19	ACTN4	38711275	38711361	50	87	8270	5961	8220	5874	0.5747126436781609	1.3993871297242084
chr19	ACTN4	38727945	38728026	0	82	8270	5961	8270	5879	0.0	1.4067018200374213
chr19	ACTN4	38728315	38728381	0	67	8270	5961	8270	5894	0.0	1.4031218187987784
chr19	TIMM50	39482884	39482916	0	33	0	5589	0	5556	0.0	0.0
chr19	TIMM50	39485543	39485602	0	60	0	5589	0	5529	0.0	0.0
chr19	PLD3	40365552	40365585	0	34	102	4360	102	4326	0.0	0.023578363384188627
chr19	PLD3	40365717	40365930	0	214	102	4360	102	4146	0.0	0.024602026049204053
chr19	PLD3	40365661	40365930	0	270	102	4360	102	4090	0.0	0.02493887530562347
chr19	LTBP4	40616888	40617020	0	133	1155	7848	1155	7715	0.0	0.14970836033700582
chr19	LTBP4	40617099	40617225	0	127	1155	7848	1155	7721	0.0	0.14959202175883954
chr19	RAB4B	40783777	40783840	1918	64	76086	2971	74168	2907	29.96875	25.51358789129687
chr19	RAB4B	40783920	40784075	5068	156	76086	2971	71018	2815	32.48717948717949	25.22841918294849
chr19	CYP2B6	41012673	41012815	0	143	102	3744	102	3601	0.0	0.02832546514856984
chr19	CYP2B6	41012972	41013030	0	59	102	3744	102	3685	0.0	0.0276797829036635
chr19	ARHGEF1	41904948	41905036	0	89	204820	8522	204820	8433	0.0	24.287916518439463
chr19	ARHGEF1	41905174	41905261	0	88	204820	8522	204820	8434	0.0	24.28503675598767
chr19	CEACAM19	44666957	44667321	0	365	46707	4281	46707	3916	0.0	11.927221654749745
chr19	CEACAM19	44671303	44671436	240	134	46707	4281	46467	4147	1.791044776119403	11.204967446346757
chr19	GIPR	45671284	45671392	102	109	61655	4844	61553	4735	0.9357798165137615	12.999577613516367
chr19	GIPR	45671579	45671757	0	179	61655	4844	61655	4665	0.0	13.216505894962486
chr19	FKRP	46747233	46747305	0	73	102	5171	102	5098	0.0	0.02000784621420165
chr19	FKRP	46747578	46747732	0	155	102	5171	102	5016	0.0	0.02033492822966507
chr19	FKRP	46747233	46747294	0	62	102	5171	102	5109	0.0	0.01996476805637111
chr19	FKRP	46748774	46748884	0	111	102	5171	102	5060	0.0	0.02015810276679842
chr19	FKRP	46754101	46754181	0	81	102	5171	102	5090	0.0	0.020039292730844795
chr19	FKRP	46747578	46747681	0	104	102	5171	102	5067	0.0	0.020130254588513915
chr19	SAE1	47156568	47156661	0	94	446615	3760	446615	3666	0.0	121.82624113475177
chr19	SAE1	47156986	47157181	240	196	446615	3760	446375	3564	1.2244897959183674	125.24551066217732
chr19	DHDH	48939448	48939701	1050	254	2422	1071	1372	817	4.133858267716535	1.6793145654834762
chr19	DHDH	48942439	48942564	0	126	2422	1071	2422	945	0.0	2.562962962962963
chr19	BAX	48955547	48955599	175	53	182482	1767	182307	1714	3.30188679245283	106.36347724620771
chr19	BAX	48955686	48955833	51	148	182482	1767	182431	1619	0.34459459459459457	112.68128474366893
chr19	TRPM4	49166040	49166215	0	176	3570	6483	3570	6307	0.0	0.5660377358490566
chr19	TRPM4	49168259	49168423	0	165	3570	6483	3570	6318	0.0	0.5650522317188984
chr19	KASH5	49391680	49391781	0	102	313326	5515	313326	5413	0.0	57.88398300387955
chr19	KASH5	49393345	49393419	1	75	313326	5515	313325	5440	0.013333333333333334	57.596507352941174
chr19	KASH5	49393345	49393400	1	56	313326	5515	313325	5459	0.017857142857142856	57.396043231361055
chr19	FLT3LG	49478962	49479047	0	86	152987	2805	152987	2719	0.0	56.26590658330269
chr19	FLT3LG	49480297	49480476	70	180	152987	2805	152917	2625	0.3888888888888889	58.25409523809524
chr19	FCGRT	49520668	49521201	1556	534	385117	3363	383561	2829	2.9138576779026217	135.58183103570167
chr19	FCGRT	49521694	49521813	0	120	385117	3363	385117	3243	0.0	118.75331483194573
chr19	CPT1C	49691660	49691770	0	111	34491	5093	34491	4982	0.0	6.923123243677238
chr19	CPT1C	49691820	49691889	0	70	34491	5093	34491	5023	0.0	6.8666135775433
chr19	CPT1C	49691820	49691953	1044	134	34491	5093	33447	4959	7.791044776119403	6.744706594071386
chr19	CPT1C	49700683	49700855	102	173	34491	5093	34389	4920	0.5895953757225434	6.989634146341463
chr19	CPT1C	49701316	49701418	0	103	34491	5093	34491	4990	0.0	6.9120240480961925
chr19	FPR2	51762416	51762535	0	120	51	3632	51	3512	0.0	0.014521640091116172
chr19	FPR2	51763361	51763517	0	157	51	3632	51	3475	0.0	0.014676258992805755
chr19	ZNF613	51929731	51929896	0	166	154	3225	154	3059	0.0	0.05034324942791762
chr19	ZNF613	51936027	51936235	0	209	154	3225	154	3016	0.0	0.05106100795755968
chr19	ZNF480	52314152	52314279	0	128	0	3049	0	2921	0.0	0.0
chr19	ZNF480	52315833	52315962	0	130	0	3049	0	2919	0.0	0.0
chr19	ZNF528	52414203	52414368	51	166	3695	7868	3644	7702	0.3072289156626506	0.4731238639314464
chr19	ZNF528	52414938	52415039	0	102	3695	7868	3695	7766	0.0	0.4757919134689673
chr19	ZNF525	53372214	53372296	180	83	49623	3416	49443	3333	2.1686746987951806	14.834383438343835
chr19	ZNF525	53372341	53372396	0	56	49623	3416	49623	3360	0.0	14.76875
chr19	ZNF331	53522616	53522684	246	69	20657	8057	20411	7988	3.5652173913043477	2.5552078117175765
chr19	ZNF331	53539215	53539282	39	68	20657	8057	20618	7989	0.5735294117647058	2.5807985980723496
chr19	LILRA2	54577464	54577723	92	260	184	5359	92	5099	0.35384615384615387	0.01804275348107472
chr19	LILRA2	54587009	54587060	0	52	184	5359	184	5307	0.0	0.034671188995666104
chr19	KIR2DL4	54808832	54808883	0	52	51	1732	51	1680	0.0	0.030357142857142857
chr19	KIR2DL4	54813124	54813228	0	105	51	1732	51	1627	0.0	0.0313460356484327
chr19	FCAR	54885234	54885525	0	292	0	3333	0	3041	0.0	0.0
chr19	FCAR	54888006	54888294	0	289	0	3333	0	3044	0.0	0.0
chr19	NCR1	54906298	54906334	0	37	12	1901	12	1864	0.0	0.006437768240343348
chr19	NCR1	54906522	54906807	0	286	12	1901	12	1615	0.0	0.007430340557275541
chr19	NLRP2	54977751	54977823	0	73	117189	6333	117189	6260	0.0	18.720287539936102
chr19	NLRP2	54981616	54981682	0	67	117189	6333	117189	6266	0.0	18.702361953399297
chr19	NLRP5	56018611	56018746	0	136	534	4093	534	3957	0.0	0.13495072024260804
chr19	NLRP5	56019341	56019398	0	58	534	4093	534	4035	0.0	0.13234200743494423
chr19	ZNF548	57390721	57390845	0	125	306	6008	306	5883	0.0	0.05201427842937277
chr19	ZNF548	57392800	57392948	0	149	306	6008	306	5859	0.0	0.05222734254992319
chr19	ZNF17	57413595	57413636	0	42	0	3186	0	3144	0.0	0.0
chr19	ZNF17	57417911	57418038	0	128	0	3186	0	3058	0.0	0.0
chr19	ZNF274	58185711	58185838	0	128	44542	6244	44542	6116	0.0	7.282864617396991
chr19	ZNF274	58186946	58187042	0	97	44542	6244	44542	6147	0.0	7.246136326663413
chr19	ZNF324B	58452127	58452782	15564	656	31627	4041	16063	3385	23.725609756097562	4.745347119645495
chr19	ZNF324B	58453186	58453266	1672	81	31627	4041	29955	3960	20.641975308641975	7.5643939393939394
chr20	SDCBP2-AS1	1359698	1359820	1540	123	864935	5316	863395	5193	12.520325203252032	166.26131330637398
chr20	SDCBP2-AS1	1373077	1373178	1324	102	864935	5316	863611	5214	12.980392156862745	165.6331031837361
chr20	SHLD1	5756711	5756848	0	138	0	2191	0	2053	0.0	0.0
chr20	SHLD1	5765093	5765184	0	92	0	2191	0	2099	0.0	0.0
chr20	MCM8	5972006	5972037	0	32	237891	7711	237891	7679	0.0	30.979424404219298
chr20	MCM8	5972575	5972726	612	152	237891	7711	237279	7559	4.026315789473684	31.390263262336287
chr20	SNAP25	10292881	10292999	0	119	1705	3367	1705	3248	0.0	0.5249384236453202
chr20	SNAP25	10293160	10293278	0	119	1705	3367	1705	3248	0.0	0.5249384236453202
chr20	BANF2	17712160	17712540	51	381	51	1365	0	984	0.13385826771653545	0.0
chr20	BANF2	17722715	17722878	0	164	51	1365	51	1201	0.0	0.042464612822647796
chr20	ZNF133	18297984	18298062	0	79	2901	5437	2901	5358	0.0	0.5414333706606943
chr20	ZNF133	18305007	18305178	0	172	2901	5437	2901	5265	0.0	0.550997150997151
chr20	ZNF133	18306705	18306747	0	43	2901	5437	2901	5394	0.0	0.5378197997775306
chr20	ZNF133	18310168	18310306	0	139	2901	5437	2901	5298	0.0	0.5475651189127972
chr20	RIN2	19815222	19815298	0	77	61013	8294	61013	8217	0.0	7.425216015577462
chr20	RIN2	19871081	19871295	0	215	61013	8294	61013	8079	0.0	7.552048520856542
chr20	CFAP61	20277165	20277458	0	294	52	7956	52	7662	0.0	0.006786739754633255
chr20	CFAP61	20288608	20288936	0	329	52	7956	52	7627	0.0	0.006817883833748525
chr20	KIZ	21132096	21132159	2	64	2481	3152	2479	3088	0.03125	0.8027849740932642
chr20	KIZ	21145564	21145654	297	91	2481	3152	2184	3061	3.2637362637362637	0.7134923227703365
chr20	AL118508.1	23180603	23180793	0	191	0	3797	0	3606	0.0	0.0
chr20	AL118508.1	23186222	23186313	0	92	0	3797	0	3705	0.0	0.0
chr20	AL118508.1	23185869	23185950	0	82	0	3797	0	3715	0.0	0.0
chr20	AL118508.1	23186399	23186550	0	152	0	3797	0	3645	0.0	0.0
chr20	AL118508.1	23187212	23187640	0	429	0	3797	0	3368	0.0	0.0
chr20	AL118508.1	23186453	23186550	0	98	0	3797	0	3699	0.0	0.0
chr20	AL118508.1	23186402	23186550	0	149	0	3797	0	3648	0.0	0.0
chr20	AL118508.1	23180931	23181216	0	286	0	3797	0	3511	0.0	0.0
chr20	AL591074.2	23728676	23728798	0	123	0	1285	0	1162	0.0	0.0
chr20	AL591074.2	23743322	23743440	0	119	0	1285	0	1166	0.0	0.0
chr20	ZNF337-AS1	25634728	25634827	0	100	36614	3182	36614	3082	0.0	11.879948085658663
chr20	ZNF337-AS1	25645530	25645648	0	119	36614	3182	36614	3063	0.0	11.953640222004571
chr20	HM13	31564118	31564218	0	101	561	7787	561	7686	0.0	0.07298985167837627
chr20	HM13	31566209	31566295	0	87	561	7787	561	7700	0.0	0.07285714285714286
chr20	HM13	31567639	31567740	0	102	561	7787	561	7685	0.0	0.07299934938191281
chr20	HM13	31568077	31568280	0	204	561	7787	561	7583	0.0	0.07398127390214955
chr20	HM13	31568077	31568224	0	148	561	7787	561	7639	0.0	0.07343893179735568
chr20	TTLL9	31925872	31925960	0	89	2126	5733	2126	5644	0.0	0.3766832034018427
chr20	TTLL9	31926048	31926091	0	44	2126	5733	2126	5689	0.0	0.3737036386008086
chr20	TTLL9	31871121	31871195	0	75	2126	5733	2126	5658	0.0	0.375751148815836
chr20	TTLL9	31879555	31879897	0	343	2126	5733	2126	5390	0.0	0.39443413729128013
chr20	HCK	32054215	32054281	0	67	1027	3098	1027	3031	0.0	0.33883206862421644
chr20	HCK	32069687	32069751	0	65	1027	3098	1027	3033	0.0	0.3386086383119024
chr20	RALY	34033163	34033239	0	77	136095	7527	136095	7450	0.0	18.26778523489933
chr20	RALY	34065043	34065160	0	118	136095	7527	136095	7409	0.0	18.368875691726277
chr20	RALY	34073562	34073635	0	74	136095	7527	136095	7453	0.0	18.260432040788945
chr20	RALY	34073818	34073866	0	49	136095	7527	136095	7478	0.0	18.199384862262637
chr20	ITCH	34393790	34393881	0	92	25998	10673	25998	10581	0.0	2.4570456478593705
chr20	ITCH	34408650	34408792	102	143	25998	10673	25896	10530	0.7132867132867133	2.4592592592592593
chr20	ACSS2	34893568	34893622	0	55	0	5112	0	5057	0.0	0.0
chr20	ACSS2	34908904	34908943	0	40	0	5112	0	5072	0.0	0.0
chr20	ERGIC3	35549162	35549207	0	46	31771	4803	31771	4757	0.0	6.678789152827412
chr20	ERGIC3	35554371	35554386	0	16	31771	4803	31771	4787	0.0	6.636933361186547
chr20	PHF20	35782327	35782609	0	283	84485	8400	84485	8117	0.0	10.408402119009486
chr20	PHF20	35800093	35800173	0	81	84485	8400	84485	8319	0.0	10.155667748527467
chr20	EPB41L1	36112425	36112480	0	56	574	9712	574	9656	0.0	0.05944490472245236
chr20	EPB41L1	36173763	36173954	0	192	574	9712	574	9520	0.0	0.060294117647058824
chr20	EPB41L1	36121659	36121816	84	158	574	9712	490	9554	0.5316455696202531	0.0512874188821436
chr20	EPB41L1	36125422	36125527	247	106	574	9712	327	9606	2.330188679245283	0.034041224234853215
chr20	DLGAP4	36499241	36499321	1579	81	47078	7378	45499	7297	19.493827160493826	6.235302178977662
chr20	DLGAP4	36499587	36499676	867	90	47078	7378	46211	7288	9.633333333333333	6.34069703622393
chr20	DLGAP4	36465264	36465367	0	104	47078	7378	47078	7274	0.0	6.4720923838328295
chr20	DLGAP4	36493057	36493185	714	129	47078	7378	46364	7249	5.534883720930233	6.395916678162505
chr20	RAB5IF	36607889	36608000	90	112	8007	1286	7917	1174	0.8035714285714286	6.743611584327087
chr20	RAB5IF	36609600	36609730	0	131	8007	1286	8007	1155	0.0	6.932467532467532
chr20	RAB5IF	36609600	36609758	0	159	8007	1286	8007	1127	0.0	7.104702750665483
chr20	RPN2	37198396	37198492	812	97	29828	2720	29016	2623	8.371134020618557	11.062142584826535
chr20	RPN2	37199049	37199225	1785	177	29828	2720	28043	2543	10.084745762711865	11.027526543452614
chr20	CTNNBL1	37694926	37695033	0	108	0	4173	0	4065	0.0	0.0
chr20	CTNNBL1	37727301	37727402	0	102	0	4173	0	4071	0.0	0.0
chr20	RPRD1B	38040434	38040564	0	131	0	5344	0	5213	0.0	0.0
chr20	RPRD1B	38048347	38048481	0	135	0	5344	0	5209	0.0	0.0
chr20	PLCG1	41174123	41174311	0	189	102	9334	102	9145	0.0	0.011153635866593768
chr20	PLCG1	41180503	41180664	0	162	102	9334	102	9172	0.0	0.011120802442215439
chr20	PLCG1	41175752	41175820	0	69	102	9334	102	9265	0.0	0.011009174311926606
chr20	AL021395.1	43194976	43195054	35	79	749	2448	714	2369	0.4430379746835443	0.30139299282397636
chr20	AL021395.1	43198848	43198957	0	110	749	2448	749	2338	0.0	0.3203592814371258
chr20	OSER1-DT	44217366	44217682	0	317	102	9245	102	8928	0.0	0.0114247311827957
chr20	OSER1-DT	44223718	44223872	0	155	102	9245	102	9090	0.0	0.011221122112211221
chr20	PABPC1L	44931832	44932026	0	195	0	3854	0	3659	0.0	0.0
chr20	PABPC1L	44932341	44932432	0	92	0	3854	0	3762	0.0	0.0
chr20	PIGT	45418851	45418979	0	129	51	11655	51	11526	0.0	0.004424778761061947
chr20	PIGT	45419294	45419395	0	102	51	11655	51	11553	0.0	0.004414437808361465
chr20	PIGT	45416516	45416694	0	179	51	11655	51	11476	0.0	0.004444057162774486
chr20	PIGT	45416516	45416654	0	139	51	11655	51	11516	0.0	0.004428621048975338
chr20	PIGT	45419277	45419395	0	119	51	11655	51	11536	0.0	0.004420943134535367
chr20	PIGT	45419142	45419395	0	254	51	11655	51	11401	0.0	0.004473291816507324
chr20	PIGT	45418771	45418979	0	209	51	11655	51	11446	0.0	0.004455705049799056
chr20	UBE2C	45814383	45814470	0	88	0	1293	0	1205	0.0	0.0
chr20	UBE2C	45815389	45815540	0	152	0	1293	0	1141	0.0	0.0
chr20	UBE2C	45815540	45815745	0	206	0	1293	0	1087	0.0	0.0
chr20	CD40	46123125	46123219	0	95	3417	2531	3417	2436	0.0	1.4027093596059113
chr20	CD40	46126639	46126701	0	63	3417	2531	3417	2468	0.0	1.3845218800648298
chr20	LINC01524	52304954	52304991	0	38	63358	14925	63358	14887	0.0	4.255927990864513
chr20	LINC01524	52442499	52442638	0	140	63358	14925	63358	14785	0.0	4.285289144403111
chr20	LINC01524	52340489	52340652	0	164	63358	14925	63358	14761	0.0	4.292256622180069
chr20	LINC01524	52281833	52281964	16	132	63358	14925	63342	14793	0.12121212121212122	4.2818900831474345
chr20	LINC01524	52416125	52416218	0	94	63358	14925	63358	14831	0.0	4.271997842357225
chr20	LINC01524	52438858	52438993	0	136	63358	14925	63358	14789	0.0	4.284130096693488
chr20	LINC01524	52285096	52285170	51	75	63358	14925	63307	14850	0.68	4.263097643097643
chr20	LINC01524	52234768	52234932	0	165	63358	14925	63358	14760	0.0	4.292547425474255
chr20	LINC01524	52355321	52355359	0	39	63358	14925	63358	14886	0.0	4.256213892247749
chr20	AL031674.1	52687948	52688165	0	218	0	3306	0	3088	0.0	0.0
chr20	AL031674.1	52690521	52690614	0	94	0	3306	0	3212	0.0	0.0
chr20	AL031674.1	52677019	52677108	0	90	0	3306	0	3216	0.0	0.0
chr20	AL031674.1	52681404	52681550	0	147	0	3306	0	3159	0.0	0.0
chr20	AL031674.1	52675209	52675310	0	102	0	3306	0	3204	0.0	0.0
chr20	STX16	58659622	58659634	0	13	0	5049	0	5036	0.0	0.0
chr20	STX16	58667200	58667318	0	119	0	5049	0	4930	0.0	0.0
chr20	MIR646HG	60100170	60100219	0	50	1329	22150	1329	22100	0.0	0.06013574660633484
chr20	MIR646HG	60121027	60121121	0	95	1329	22150	1329	22055	0.0	0.06025844479709817
chr20	MIR646HG	60123491	60123606	0	116	1329	22150	1329	22034	0.0	0.06031587546519016
chr20	MIR646HG	60138493	60138644	0	152	1329	22150	1329	21998	0.0	0.060414583143922174
chr20	MIR646HG	60253358	60253498	0	141	1329	22150	1329	22009	0.0	0.0603843882048253
chr20	MIR646HG	60272066	60272240	0	175	1329	22150	1329	21975	0.0	0.0604778156996587
chr20	MIR646HG	60088596	60088721	0	126	1329	22150	1329	22024	0.0	0.06034326189611333
chr20	MIR646HG	60098928	60098963	0	36	1329	22150	1329	22114	0.0	0.06009767568056435
chr20	MIR646HG	60096534	60097664	0	1131	1329	22150	1329	21019	0.0	0.06322850754079642
chr20	MIR646HG	60117743	60117807	0	65	1329	22150	1329	22085	0.0	0.060176590446004076
chr20	MIR646HG	60098928	60099032	0	105	1329	22150	1329	22045	0.0	0.06028577908822862
chr20	MIR646HG	60091977	60092062	0	86	1329	22150	1329	22064	0.0	0.060233865119651925
chr20	MIR646HG	60280982	60281124	0	143	1329	22150	1329	22007	0.0	0.06038987594856182
chr20	MIR646HG	60117357	60117507	0	151	1329	22150	1329	21999	0.0	0.06041183690167735
chr20	MIR646HG	60098928	60099069	0	142	1329	22150	1329	22008	0.0	0.06038713195201745
chr20	MIR646HG	60096534	60097521	0	988	1329	22150	1329	21162	0.0	0.06280124751913808
chr20	MIR646HG	60101690	60101798	0	109	1329	22150	1329	22041	0.0	0.060296719749557644
chr20	MIR646HG	60117361	60117507	0	147	1329	22150	1329	22003	0.0	0.06040085442894151
chr20	MIR646HG	60098665	60098726	0	62	1329	22150	1329	22088	0.0	0.06016841724013039
chr20	MIR646HG	60284476	60284593	0	118	1329	22150	1329	22032	0.0	0.06032135076252723
chr20	MIR646HG	60313309	60313387	0	79	1329	22150	1329	22071	0.0	0.06021476145167867
chr20	MTG2	62197851	62197967	51	117	131005	5139	130954	5022	0.4358974358974359	26.076065312624454
chr20	MTG2	62198633	62198852	26670	220	131005	5139	104335	4919	121.22727272727273	21.210611912990444
chr20	OSBPL2	62264628	62264718	0	91	126363	10826	126363	10735	0.0	11.771122496506754
chr20	OSBPL2	62271633	62271731	11762	99	126363	10826	114601	10727	118.8080808080808	10.683415680059662
chr20	OSBPL2	62256056	62256221	306	166	126363	10826	126057	10660	1.8433734939759037	11.825234521575984
chr20	OSBPL2	62259980	62260125	3898	146	126363	10826	122465	10680	26.698630136986303	11.466760299625468
chr20	CSNK2A1	526695	526942	0	248	99299	19650	99299	19402	0.0	5.117977528089888
chr20	CSNK2A1	527932	528049	0	118	99299	19650	99299	19532	0.0	5.083913577718616
chr20	CSNK2A1	510167	510338	0	172	99299	19650	99299	19478	0.0	5.098008009035835
chr20	CSNK2A1	499254	499305	0	52	99299	19650	99299	19598	0.0	5.066792529849985
chr20	CSNK2A1	499832	499934	612	103	99299	19650	98687	19547	5.941747572815534	5.0487031257993555
chr20	CSNK2A1	508450	508660	6505	211	99299	19650	92794	19439	30.829383886255926	4.7735994649930555
chr20	CSNK2A1	508450	508605	2279	156	99299	19650	97020	19494	14.60897435897436	4.976915974145891
chr20	CSNK2A1	508450	508621	3240	172	99299	19650	96059	19478	18.837209302325583	4.931666495533422
chr20	CSNK2A1	492253	492364	0	112	99299	19650	99299	19538	0.0	5.0823523390316305
chr20	CSNK2A1	495718	495802	0	85	99299	19650	99299	19565	0.0	5.075338614873498
chr20	CSNK2A1	540889	541099	0	211	99299	19650	99299	19439	0.0	5.108236020371418
chr20	CSNK2A1	540827	541099	0	273	99299	19650	99299	19377	0.0	5.1245806884450635
chr20	FKBP1A	1375490	1375603	0	114	47778	4404	47778	4290	0.0	11.137062937062938
chr20	FKBP1A	1392833	1392881	1243	49	47778	4404	46535	4355	25.367346938775512	10.685419058553387
chr20	TMEM230	5111056	5111174	0	119	744431	3050	744431	2931	0.0	253.98532923916753
chr20	TMEM230	5111763	5111808	0	46	744431	3050	744431	3004	0.0	247.81324900133157
chr20	TMEM230	5111499	5111605	51	107	744431	3050	744380	2943	0.4766355140186916	252.9323819232076
chr20	LINC00658	5433788	5433962	0	175	102	2892	102	2717	0.0	0.03754140596245859
chr20	LINC00658	5433962	5434092	0	131	102	2892	102	2761	0.0	0.03694313654473017
chr20	LINC00658	5433962	5434070	0	109	102	2892	102	2783	0.0	0.03665109593963349
chr20	LINC01713	6733127	6733255	0	129	0	1342	0	1213	0.0	0.0
chr20	LINC01713	6735038	6735124	0	87	0	1342	0	1255	0.0	0.0
chr20	PAK5	9784357	9784506	0	150	0	4995	0	4845	0.0	0.0
chr20	PAK5	9818679	9818785	0	107	0	4995	0	4888	0.0	0.0
chr20	SNAP25-AS1	10125181	10125291	0	111	11611	11293	11611	11182	0.0	1.0383652298336612
chr20	SNAP25-AS1	10190056	10190152	0	97	11611	11293	11611	11196	0.0	1.037066809574848
chr20	MACROD2-AS1	14888095	14888304	0	210	0	1891	0	1681	0.0	0.0
chr20	MACROD2-AS1	14909648	14909737	0	90	0	1891	0	1801	0.0	0.0
chr20	SNX5	17955364	17955475	12017	112	287252	6160	275235	6048	107.29464285714286	45.50843253968254
chr20	SNX5	17956932	17957037	0	106	287252	6160	287252	6054	0.0	47.44829864552362
chr20	AL049646.1	18345489	18345546	0	58	3162	3242	3162	3184	0.0	0.9930904522613065
chr20	AL049646.1	18347484	18347542	0	59	3162	3242	3162	3183	0.0	0.9934024505183789
chr20	NAPB	23395138	23395185	0	48	28413	4598	28413	4550	0.0	6.2446153846153845
chr20	NAPB	23397071	23397188	0	118	28413	4598	28413	4480	0.0	6.3421875
chr20	VSX1	25072535	25072643	0	109	0	3605	0	3496	0.0	0.0
chr20	VSX1	25077684	25077865	0	182	0	3605	0	3423	0.0	0.0
chr20	ABHD12	25301248	25301294	5	47	48666	4504	48661	4457	0.10638297872340426	10.917881983396903
chr20	ABHD12	25301718	25302034	0	317	48666	4504	48666	4187	0.0	11.623119178409363
chr20	ABHD12	25301331	25301378	70	48	48666	4504	48596	4456	1.4583333333333333	10.905745062836624
chr20	ABHD12	25309445	25309575	616	131	48666	4504	48050	4373	4.702290076335878	10.987880173793734
chr20	ABHD12	25314924	25314970	0	47	48666	4504	48666	4457	0.0	10.919003814224816
chr20	ABHD12	25302218	25302346	0	129	48666	4504	48666	4375	0.0	11.123657142857143
chr20	ABHD12	25303549	25303628	0	80	48666	4504	48666	4424	0.0	11.000452079566003
chr20	ABHD12	25301718	25301833	0	116	48666	4504	48666	4388	0.0	11.09070191431176
chr20	ABHD12	25317047	25317078	0	32	48666	4504	48666	4472	0.0	10.882379248658319
chr20	ABHD12	25319051	25319155	0	105	48666	4504	48666	4399	0.0	11.062968856558308
chr20	ABHD12	25306832	25306915	0	84	48666	4504	48666	4420	0.0	11.010407239819004
chr20	FAM182B	25786744	25786988	0	245	10542	6640	10542	6395	0.0	1.6484753713838938
chr20	FAM182B	25848704	25848948	510	245	10542	6640	10032	6395	2.0816326530612246	1.568725566849101
chr20	MIR663AHG	26191670	26191763	0	94	252	6568	252	6474	0.0	0.03892493049119555
chr20	MIR663AHG	26191792	26191900	0	109	252	6568	252	6459	0.0	0.03901532745006967
chr20	MIR663AHG	26191792	26191861	0	70	252	6568	252	6498	0.0	0.038781163434903045
chr20	MIR663AHG	26191792	26191896	0	105	252	6568	252	6463	0.0	0.03899118056630048
chr20	MIR663AHG	26192132	26192232	0	101	252	6568	252	6467	0.0	0.03896706355342508
chr20	MIR663AHG	26199448	26199523	0	76	252	6568	252	6492	0.0	0.038817005545286505
chr20	MIR663AHG	26194297	26194444	0	148	252	6568	252	6420	0.0	0.03925233644859813
chr20	MIR663AHG	26200195	26200316	0	122	252	6568	252	6446	0.0	0.039094011790257524
chr20	MIR663AHG	26200457	26200542	0	86	252	6568	252	6482	0.0	0.038876889848812095
chr20	BCL2L1	31666990	31667147	0	158	0	3964	0	3806	0.0	0.0
chr20	BCL2L1	31684366	31684588	0	223	0	3964	0	3741	0.0	0.0
chr20	FO393400.1	32651732	32651981	204	250	6753	4720	6549	4470	0.816	1.4651006711409396
chr20	FO393400.1	32656575	32657968	3111	1394	6753	4720	3642	3326	2.231707317073171	1.095009019843656
chr20	SUN5	33001211	33001278	0	68	1633	1488	1633	1420	0.0	1.15
chr20	SUN5	33002586	33002661	611	76	1633	1488	1022	1412	8.039473684210526	0.7237960339943342
chr20	CDK5RAP1	33379460	33379691	0	232	6277	4575	6277	4343	0.0	1.4453142988717476
chr20	CDK5RAP1	33394031	33394066	0	36	6277	4575	6277	4539	0.0	1.3829037232870676
chr20	GSS	34942487	34942627	0	141	62	5144	62	5003	0.0	0.012392564461323205
chr20	GSS	34942930	34943006	0	77	62	5144	62	5067	0.0	0.012236037102822183
chr20	GSS	34945952	34946098	0	147	62	5144	62	4997	0.0	0.012407444466680007
chr20	UQCC1	35384558	35384644	51	87	156139	4188	156088	4101	0.5862068965517241	38.060960741282614
chr20	UQCC1	35392235	35392277	103	43	156139	4188	156036	4145	2.395348837209302	37.64439083232811
chr20	UQCC1	35384037	35384133	32598	97	156139	4188	123541	4091	336.0618556701031	30.198240039110242
chr20	UQCC1	35386276	35386389	0	114	156139	4188	156139	4074	0.0	38.32572410407462
chr20	CEP250-AS1	35477825	35477945	354	121	4226	843	3872	722	2.925619834710744	5.362880886426593
chr20	CEP250-AS1	35481132	35481251	385	120	4226	843	3841	723	3.2083333333333335	5.312586445366528
chr20	CPNE1	35632794	35632923	0	130	50298	2948	50298	2818	0.0	17.848828956706885
chr20	CPNE1	35655201	35655344	8	144	50298	2948	50290	2804	0.05555555555555555	17.93509272467903
chr20	RBM39	35739392	35739547	0	156	5698	11032	5698	10876	0.0	0.523905847738139
chr20	RBM39	35740524	35740597	0	74	5698	11032	5698	10958	0.0	0.5199853987954006
chr20	RBM39	35734185	35734257	0	73	5698	11032	5698	10959	0.0	0.5199379505429328
chr20	RBM39	35736512	35736567	0	56	5698	11032	5698	10976	0.0	0.5191326530612245
chr20	DSN1	36770872	36771193	612	322	122812	2481	122200	2159	1.9006211180124224	56.600277906438166
chr20	DSN1	36771424	36771473	0	50	122812	2481	122812	2431	0.0	50.51912793089264
chr20	DSN1	36770872	36771024	306	153	122812	2481	122506	2328	2.0	52.62285223367697
chr20	SNHG17	38422086	38422241	0	156	199	11084	199	10928	0.0	0.018210102489019032
chr20	SNHG17	38422290	38422368	0	79	199	11084	199	11005	0.0	0.018082689686506132
chr20	SNHG17	38422091	38422241	0	151	199	11084	199	10933	0.0	0.018201774444342816
chr20	SNHG17	38422095	38422241	0	147	199	11084	199	10937	0.0	0.018195117491085308
chr20	SNHG17	38425934	38426048	0	115	199	11084	199	10969	0.0	0.018142036648737352
chr20	SNHG17	38425934	38426052	0	119	199	11084	199	10965	0.0	0.018148654810761514
chr20	ZHX3	41239597	41239704	0	108	0	4825	0	4717	0.0	0.0
chr20	ZHX3	41254587	41254635	0	49	0	4825	0	4776	0.0	0.0
chr20	CHD6	41551304	41551360	0	57	56	14072	56	14015	0.0	0.003995718872636461
chr20	CHD6	41564010	41564151	0	142	56	14072	56	13930	0.0	0.004020100502512563
chr20	WFDC3	45777074	45777206	0	133	50	2416	50	2283	0.0	0.021901007446342532
chr20	WFDC3	45787835	45787982	0	148	50	2416	50	2268	0.0	0.02204585537918871
chr20	WFDC3	45777074	45777209	0	136	50	2416	50	2280	0.0	0.021929824561403508
chr20	ZNF334	46506306	46506458	0	153	0	6001	0	5848	0.0	0.0
chr20	ZNF334	46509604	46509751	0	148	0	6001	0	5853	0.0	0.0
chr20	UBE2V1	50084128	50084254	0	127	675	4832	675	4705	0.0	0.1434643995749203
chr20	UBE2V1	50096671	50096820	0	150	675	4832	675	4682	0.0	0.14416915847928236
chr20	UBE2V1	50098881	50098981	0	101	675	4832	675	4731	0.0	0.14267596702599875
chr20	UBE2V1	50111288	50111562	0	275	675	4832	675	4557	0.0	0.14812376563528637
chr20	UBE2V1	50108972	50109111	0	140	675	4832	675	4692	0.0	0.1438618925831202
chr20	UBE2V1	50098881	50098964	0	84	675	4832	675	4748	0.0	0.14216512215669755
chr20	ADNP	50904765	50904849	0	85	0	7594	0	7509	0.0	0.0
chr20	ADNP	50918738	50918781	0	44	0	7594	0	7550	0.0	0.0
chr20	DPM1	50941128	50941209	0	82	0	1217	0	1135	0.0	0.0
chr20	DPM1	50942030	50942126	0	97	0	1217	0	1120	0.0	0.0
chr20	BCAS1	53966905	53967073	0	169	51	8200	51	8031	0.0	0.00635039223010833
chr20	BCAS1	53975388	53975430	0	43	51	8200	51	8157	0.0	0.00625229863920559
chr20	AURKA	56388686	56388784	0	99	0	2904	0	2805	0.0	0.0
chr20	AURKA	56390555	56390665	0	111	0	2904	0	2793	0.0	0.0
chr20	AURKA	56388311	56388506	0	196	0	2904	0	2708	0.0	0.0
chr21	CU633967.1	5566124	5566183	0	60	0	5133	0	5073	0.0	0.0
chr21	CU633967.1	5584809	5584975	0	167	0	5133	0	4966	0.0	0.0
chr21	CU633967.1	5584809	5585063	0	255	0	5133	0	4878	0.0	0.0
chr21	CU634019.1	7080035	7080207	0	173	0	3064	0	2891	0.0	0.0
chr21	CU634019.1	7081048	7081213	0	166	0	3064	0	2898	0.0	0.0
chr21	CU634019.1	7061346	7061405	0	60	0	3064	0	3004	0.0	0.0
chr21	CU634019.1	7080035	7080289	0	255	0	3064	0	2809	0.0	0.0
chr21	CU633904.1	7443124	7443183	0	60	0	3394	0	3334	0.0	0.0
chr21	CU633904.1	7461813	7462067	0	255	0	3394	0	3139	0.0	0.0
chr21	CU633904.1	7461813	7461985	0	173	0	3394	0	3221	0.0	0.0
chr21	CU633904.1	7462826	7462991	0	166	0	3394	0	3228	0.0	0.0
chr21	CR381653.1	9325630	9325823	0	194	0	1910	0	1716	0.0	0.0
chr21	CR381653.1	9325873	9325961	0	89	0	1910	0	1821	0.0	0.0
chr21	TPTE	10542394	10542448	0	55	353	2620	353	2565	0.0	0.13762183235867445
chr21	TPTE	10543328	10543382	0	55	353	2620	353	2565	0.0	0.13762183235867445
chr21	LINC01674	13556392	13556511	0	120	0	1252	0	1132	0.0	0.0
chr21	LINC01674	13565664	13565781	0	118	0	1252	0	1134	0.0	0.0
chr21	MIR99AHG	16257392	16257454	0	63	517	42307	517	42244	0.0	0.01223842439162958
chr21	MIR99AHG	16391613	16391685	0	73	517	42307	517	42234	0.0	0.012241322157503433
chr21	MIR99AHG	16564773	16564809	0	37	517	42307	517	42270	0.0	0.012230896616986042
chr21	MIR99AHG	16589352	16589557	0	206	517	42307	517	42101	0.0	0.01227999334932662
chr21	MIR99AHG	16521718	16521816	0	99	517	42307	517	42208	0.0	0.012248862774829417
chr21	MIR99AHG	16535033	16535709	0	677	517	42307	517	41630	0.0	0.012418928657218352
chr21	MIR99AHG	16594339	16594454	0	116	517	42307	517	42191	0.0	0.012253798203408309
chr21	MIR99AHG	16560446	16560498	0	53	517	42307	517	42254	0.0	0.012235527997349364
chr21	MIR99AHG	16231055	16231115	0	61	517	42307	517	42246	0.0	0.012237845003077214
chr21	MIR99AHG	16352128	16352273	7	146	517	42307	510	42161	0.04794520547945205	0.012096487274969758
chr21	MIR99AHG	16383159	16383304	0	146	517	42307	517	42161	0.0	0.012262517492469344
chr21	MIR99AHG	16589352	16589467	0	116	517	42307	517	42191	0.0	0.012253798203408309
chr21	MIR99AHG	16589352	16589540	0	189	517	42307	517	42118	0.0	0.012275036801367586
chr21	MIR99AHG	16214256	16214378	0	123	517	42307	517	42184	0.0	0.012255831594917504
chr21	MIR99AHG	16223523	16223574	0	52	517	42307	517	42255	0.0	0.012235238433321501
chr21	MIR99AHG	16537378	16537439	0	62	517	42307	517	42245	0.0	0.012238134690495917
chr21	MIR99AHG	16596384	16596402	0	19	517	42307	517	42288	0.0	0.012225690503216043
chr21	MIR99AHG	16606225	16606273	0	49	517	42307	517	42258	0.0	0.01223436982346538
chr21	MIR99AHG	16477844	16478039	0	196	517	42307	517	42111	0.0	0.01227707724822493
chr21	MIR99AHG	16485711	16485816	0	106	517	42307	517	42201	0.0	0.012250894528565674
chr21	MIR99AHG	16589352	16589413	0	62	517	42307	517	42245	0.0	0.012238134690495917
chr21	LINC01684	24485622	24485685	0	64	34	9534	34	9470	0.0	0.003590285110876452
chr21	LINC01684	24522888	24522999	0	112	34	9534	34	9422	0.0	0.0036085756739545746
chr21	USP16	29025708	29025771	0	64	102	5713	102	5649	0.0	0.018056293149229952
chr21	USP16	29026566	29026661	0	96	102	5713	102	5617	0.0	0.01815915969378672
chr21	BACH1	29218860	29218926	0	67	0	7684	0	7617	0.0	0.0
chr21	BACH1	29270356	29270456	0	101	0	7684	0	7583	0.0	0.0
chr21	C21ORF62-AS1	32784796	32784919	0	124	1625	9197	1625	9073	0.0	0.17910283258018295
chr21	C21ORF62-AS1	32788611	32788701	0	91	1625	9197	1625	9106	0.0	0.17845376674719965
chr21	LINC00310	34182707	34183192	0	486	663	3286	663	2800	0.0	0.2367857142857143
chr21	LINC00310	34188216	34188662	0	447	663	3286	663	2839	0.0	0.23353293413173654
chr21	LINC00310	34182707	34183118	0	412	663	3286	663	2874	0.0	0.23068893528183715
chr21	MORC3	36380230	36380318	0	89	2483	6433	2483	6344	0.0	0.39139344262295084
chr21	MORC3	36380625	36380682	0	58	2483	6433	2483	6375	0.0	0.3894901960784314
chr21	DSCR9	37210004	37210114	0	111	0	1584	0	1473	0.0	0.0
chr21	DSCR9	37214095	37214153	0	59	0	1584	0	1525	0.0	0.0
chr21	DSCR9	37216404	37216493	0	90	0	1584	0	1494	0.0	0.0
chr21	DYRK1A	37410569	37410670	961	102	233084	22440	232123	22338	9.42156862745098	10.391395827737488
chr21	DYRK1A	37415489	37415565	154	77	233084	22440	232930	22363	2.0	10.4158654921075
chr21	DYRK1A	37421773	37421866	0	94	233084	22440	233084	22346	0.0	10.430681106238254
chr21	DYRK1A	37430268	37430400	0	133	233084	22440	233084	22307	0.0	10.448917380194558
chr21	DYRK1A	37456129	37456308	0	180	233084	22440	233084	22260	0.0	10.470979335130279
chr21	KCNJ15	38285586	38285689	52	104	21554	10358	21502	10254	0.5	2.096937780378389
chr21	KCNJ15	38291605	38291747	306	143	21554	10358	21248	10215	2.13986013986014	2.0800783162016643
chr21	KCNJ15	38169168	38169268	0	101	21554	10358	21554	10257	0.0	2.1013941698352343
chr21	KCNJ15	38257045	38257185	528	141	21554	10358	21026	10217	3.74468085106383	2.0579426446119213
chr21	GET1	39393165	39393280	0	116	0	8656	0	8540	0.0	0.0
chr21	GET1	39405913	39406058	0	146	0	8656	0	8510	0.0	0.0
chr21	SH3BGR	39475134	39475215	0	82	0	1493	0	1411	0.0	0.0
chr21	SH3BGR	39499822	39499915	0	94	0	1493	0	1399	0.0	0.0
chr21	BACE2	41250751	41250901	0	151	102	9570	102	9419	0.0	0.01082917507166366
chr21	BACE2	41257157	41257326	0	170	102	9570	102	9400	0.0	0.010851063829787235
chr21	MX2	41363268	41363389	0	122	204	11393	204	11271	0.0	0.01809954751131222
chr21	MX2	41372933	41372999	0	67	204	11393	204	11326	0.0	0.01801165460003532
chr21	PDE9A	42731769	42731949	0	181	14845	5304	14845	5123	0.0	2.8977161819246535
chr21	PDE9A	42732069	42732124	0	56	14845	5304	14845	5248	0.0	2.8286966463414633
chr21	PDE9A	42698967	42699011	0	45	14845	5304	14845	5259	0.0	2.8227799961969957
chr21	PDE9A	42686191	42686262	0	72	14845	5304	14845	5232	0.0	2.837347094801223
chr21	PDE9A	42687916	42687994	0	79	14845	5304	14845	5225	0.0	2.841148325358852
chr21	MCM3AP-AS1	46230326	46230527	284	202	15028	9232	14744	9030	1.4059405940594059	1.632779623477298
chr21	MCM3AP-AS1	46236223	46236326	153	104	15028	9232	14875	9128	1.4711538461538463	1.6296012269938651
chr21	PRMT2	46658744	46658920	0	177	10776	5492	10776	5315	0.0	2.0274694261523987
chr21	PRMT2	46663382	46663554	0	173	10776	5492	10776	5319	0.0	2.0259447264523405
chr21	CU633906.1	6235988	6236160	0	173	0	2884	0	2711	0.0	0.0
chr21	CU633906.1	6254790	6254849	0	60	0	2884	0	2824	0.0	0.0
chr21	CU633906.1	6234982	6235147	0	166	0	2884	0	2718	0.0	0.0
chr21	U2AF1L5	6492130	6492197	0	68	0	7422	0	7354	0.0	0.0
chr21	U2AF1L5	6493043	6493110	0	68	0	7422	0	7354	0.0	0.0
chr21	U2AF1L5	6492254	6492292	0	39	0	7422	0	7383	0.0	0.0
chr21	NRIP1	15014343	15014466	0	124	102	8505	102	8381	0.0	0.012170385395537525
chr21	NRIP1	15043494	15043574	0	81	102	8505	102	8424	0.0	0.012108262108262107
chr21	AJ009632.2	15393970	15394043	0	74	22574	18447	22574	18373	0.0	1.2286507374952376
chr21	AJ009632.2	15394999	15395129	0	131	22574	18447	22574	18316	0.0	1.2324743393754094
chr21	AJ009632.2	15571191	15571356	0	166	22574	18447	22574	18281	0.0	1.2348339806356325
chr21	AJ009632.2	15573972	15574034	0	63	22574	18447	22574	18384	0.0	1.2279155787641427
chr21	LINC00320	20778642	20778762	0	121	378	16661	378	16540	0.0	0.022853688029020557
chr21	LINC00320	20780810	20780907	0	98	378	16661	378	16563	0.0	0.022821952544828834
chr21	LINC00320	20778642	20778796	0	155	378	16661	378	16506	0.0	0.022900763358778626
chr21	LINC00320	20757310	20757417	0	108	378	16661	378	16553	0.0	0.02283573974506132
chr21	LINC00320	20778183	20778344	0	162	378	16661	378	16499	0.0	0.022910479422995334
chr21	LINC00320	20757218	20757417	0	200	378	16661	378	16461	0.0	0.022963367960634227
chr21	LINC00158	25388913	25389082	0	170	0	4142	0	3972	0.0	0.0
chr21	LINC00158	25396448	25396684	0	237	0	4142	0	3905	0.0	0.0
chr21	LINC00158	25420707	25420800	0	94	0	4142	0	4048	0.0	0.0
chr21	LINC00158	25424553	25424649	0	97	0	4142	0	4045	0.0	0.0
chr21	LINC00158	25428890	25429030	0	141	0	4142	0	4001	0.0	0.0
chr21	APP	25997359	25997416	0	58	0	5908	0	5850	0.0	0.0
chr21	APP	26000014	26000182	0	169	0	5908	0	5739	0.0	0.0
chr21	CFAP298-TCP10L	32584160	32584305	0	146	25849	19230	25849	19084	0.0	1.3544854328233076
chr21	CFAP298-TCP10L	32587312	32587477	0	166	25849	19230	25849	19064	0.0	1.3559064204783886
chr21	CFAP298-TCP10L	32602271	32602367	0	97	25849	19230	25849	19133	0.0	1.351016568232896
chr21	DONSON	33583487	33583666	0	180	0	2762	0	2582	0.0	0.0
chr21	DONSON	33584589	33584768	0	180	0	2762	0	2582	0.0	0.0
chr21	ATP5PO	33906448	33906500	177	53	210	1528	33	1475	3.339622641509434	0.022372881355932205
chr21	ATP5PO	33906725	33906821	0	97	210	1528	210	1431	0.0	0.14675052410901468
chr21	CBR3-AS1	36133686	36133761	0	76	0	8894	0	8818	0.0	0.0
chr21	CBR3-AS1	36137093	36137176	0	84	0	8894	0	8810	0.0	0.0
chr21	CBR3-AS1	36137093	36137229	0	137	0	8894	0	8757	0.0	0.0
chr21	HLCS	36946008	36946154	0	147	0	10535	0	10388	0.0	0.0
chr21	HLCS	36947332	36948287	0	956	0	10535	0	9579	0.0	0.0
chr21	HLCS	36948165	36948287	0	123	0	10535	0	10412	0.0	0.0
chr21	ERG	38392375	38392444	0	70	7247	7601	7247	7531	0.0	0.9622892046209003
chr21	ERG	38400573	38400645	0	73	7247	7601	7247	7528	0.0	0.9626726886291179
chr21	AP001042.1	38880591	38880708	75	118	69893	10133	69818	10015	0.635593220338983	6.9713429855217175
chr21	AP001042.1	38893960	38894285	0	326	69893	10133	69893	9807	0.0	7.126848169674722
chr21	HMGN1	39345829	39345958	0	130	51	4327	51	4197	0.0	0.012151536812008578
chr21	HMGN1	39347378	39347483	0	106	51	4327	51	4221	0.0	0.012082444918265814
chr21	HMGN1	39347246	39347292	0	47	51	4327	51	4280	0.0	0.01191588785046729
chr21	HMGN1	39347378	39347478	0	101	51	4327	51	4226	0.0	0.012068149550402271
chr21	LCA5L	39439633	39439773	0	141	0	4442	0	4301	0.0	0.0
chr21	LCA5L	39444134	39444201	0	68	0	4442	0	4374	0.0	0.0
chr21	LCA5L	39435419	39435573	0	155	0	4442	0	4287	0.0	0.0
chr21	LCA5L	39438683	39438718	0	36	0	4442	0	4406	0.0	0.0
chr21	LCA5L	39435419	39435542	0	124	0	4442	0	4318	0.0	0.0
chr21	LCA5L	39436096	39436167	0	72	0	4442	0	4370	0.0	0.0
chr21	LINC00323	41145076	41145335	0	260	357	2574	357	2314	0.0	0.15427830596369924
chr21	LINC00323	41147348	41147499	0	152	357	2574	357	2422	0.0	0.14739884393063585
chr21	U2AF1	43100452	43100519	0	68	357	7408	357	7340	0.0	0.04863760217983651
chr21	U2AF1	43101365	43101432	0	68	357	7408	357	7340	0.0	0.04863760217983651
chr21	U2AF1	43100576	43100614	0	39	357	7408	357	7369	0.0	0.048446193513366806
chr22	AC007666.1	17582250	17582372	326	123	23107	1965	22781	1842	2.6504065040650406	12.367535287730728
chr22	AC007666.1	17585264	17585386	76	123	23107	1965	23031	1842	0.6178861788617886	12.503257328990228
chr22	BID	17743802	17744013	0	212	221	4429	221	4217	0.0	0.05240692435380603
chr22	BID	17750104	17750174	0	71	221	4429	221	4358	0.0	0.050711335474988524
chr22	MICAL3	17826453	17826516	0	64	571	22491	571	22427	0.0	0.02546038257457529
chr22	MICAL3	17827643	17827781	0	139	571	22491	571	22352	0.0	0.025545812455261274
chr22	MICAL3	17793728	17793794	0	67	571	22491	571	22424	0.0	0.02546378879771673
chr22	MICAL3	17803810	17803861	0	52	571	22491	571	22439	0.0	0.025446766789963902
chr22	TXNRD2	19919542	19919599	39	58	13934	6767	13895	6709	0.6724137931034483	2.071098524370249
chr22	TXNRD2	19931029	19931098	969	70	13934	6767	12965	6697	13.842857142857143	1.9359414663282066
chr22	SMPD4P1	20621926	20622126	0	201	0	3882	0	3681	0.0	0.0
chr22	SMPD4P1	20622484	20622559	0	76	0	3882	0	3806	0.0	0.0
chr22	TOP3B	21975904	21975953	15530	50	425353	6344	409823	6294	310.6	65.11328249126151
chr22	TOP3B	21982413	21982449	13517	37	425353	6344	411836	6307	365.3243243243243	65.29824005073728
chr22	TOP3B	21975980	21976187	157925	208	425353	6344	267428	6136	759.2548076923077	43.583441981747065
chr22	TOP3B	21975904	21976187	196781	284	425353	6344	228572	6060	692.8908450704225	37.71815181518152
chr22	GUSBP11	23695172	23695517	0	346	10883	7702	10883	7356	0.0	1.4794725394235997
chr22	GUSBP11	23700725	23700845	0	121	10883	7702	10883	7581	0.0	1.4355625906872445
chr22	GUSBP11	23683724	23683867	0	144	10883	7702	10883	7558	0.0	1.4399311987298227
chr22	GUSBP11	23686837	23686995	0	159	10883	7702	10883	7543	0.0	1.4427946440408326
chr22	ADORA2A-AS1	24460452	24460771	23623	320	48243	4042	24620	3722	73.821875	6.61472326706072
chr22	ADORA2A-AS1	24471767	24471895	0	129	48243	4042	48243	3913	0.0	12.32890365448505
chr22	MYO18B-AS1	25895110	25895370	0	261	4763	5997	4763	5736	0.0	0.8303695955369595
chr22	MYO18B-AS1	25899715	25899884	0	170	4763	5997	4763	5827	0.0	0.817401750471941
chr22	MYO18B-AS1	25895110	25895268	0	159	4763	5997	4763	5838	0.0	0.815861596437136
chr22	MYO18B-AS1	25898383	25898441	0	59	4763	5997	4763	5938	0.0	0.8021219265746042
chr22	CHEK2	28724885	28724923	0	39	190	4425	190	4386	0.0	0.04331965344277246
chr22	CHEK2	28724976	28725124	0	149	190	4425	190	4276	0.0	0.04443405051449953
chr22	CHEK2	28724564	28724923	0	360	190	4425	190	4065	0.0	0.046740467404674045
chr22	CHEK2	28737884	28738038	0	155	190	4425	190	4270	0.0	0.04449648711943794
chr22	CHEK2	28738081	28738197	0	117	190	4425	190	4308	0.0	0.04410399257195915
chr22	ASCC2	29833540	29833614	0	75	15791	5178	15791	5103	0.0	3.094454242602391
chr22	ASCC2	29834488	29834550	0	63	15791	5178	15791	5115	0.0	3.0871945259042035
chr22	ASCC2	29832244	29832342	0	99	15791	5178	15791	5079	0.0	3.1090765898798978
chr22	ASCC2	29836437	29836500	37	64	15791	5178	15754	5114	0.578125	3.08056315995307
chr22	GAL3ST1	30558278	30558388	0	111	0	3105	0	2994	0.0	0.0
chr22	GAL3ST1	30565076	30565201	0	126	0	3105	0	2979	0.0	0.0
chr22	DUSP18	30663403	30664080	0	678	510	2739	510	2061	0.0	0.24745269286754004
chr22	DUSP18	30666806	30666938	0	133	510	2739	510	2606	0.0	0.19570222563315426
chr22	LARGE1	33316084	33316248	0	165	635	14082	635	13917	0.0	0.04562764963713444
chr22	LARGE1	33337645	33337801	0	157	635	14082	635	13925	0.0	0.04560143626570916
chr22	LARGE1	33304228	33304507	51	280	635	14082	584	13802	0.18214285714285713	0.04231270830314447
chr22	LARGE1	33381918	33382044	0	127	635	14082	635	13955	0.0	0.04550340379792189
chr22	LARGE1	33283201	33283348	0	148	635	14082	635	13934	0.0	0.045571982201808525
chr22	LARGE1	33761370	33761558	0	189	635	14082	635	13893	0.0	0.045706470884618156
chr22	LARGE1	33856739	33856802	0	64	635	14082	635	14018	0.0	0.04529890141246968
chr22	RBFOX2	35752612	35752655	0	44	219287	10064	219287	10020	0.0	21.88493013972056
chr22	RBFOX2	35756104	35756144	0	41	219287	10064	219287	10023	0.0	21.878379726628754
chr22	APOL3	36149258	36149371	364	114	120451	5914	120087	5800	3.192982456140351	20.704655172413794
chr22	APOL3	36156843	36157006	126	164	120451	5914	120325	5750	0.7682926829268293	20.92608695652174
chr22	APOL3	36149770	36149964	495	195	120451	5914	119956	5719	2.5384615384615383	20.9749956286064
chr22	APOL3	36153284	36153423	262	140	120451	5914	120189	5774	1.8714285714285714	20.815552476619327
chr22	APOL2	36234235	36234335	125566	101	126768	3251	1202	3150	1243.2277227722773	0.3815873015873016
chr22	APOL2	36237060	36237185	0	126	126768	3251	126768	3125	0.0	40.56576
chr22	ANKRD54	37832957	37833109	0	153	0	4400	0	4247	0.0	0.0
chr22	ANKRD54	37833158	37833206	0	49	0	4400	0	4351	0.0	0.0
chr22	PLA2G6	38147349	38147475	51	127	23420	8089	23369	7962	0.4015748031496063	2.9350665661893998
chr22	PLA2G6	38148492	38148623	0	132	23420	8089	23420	7957	0.0	2.9433203468643963
chr22	PLA2G6	38139981	38140169	25	189	23420	8089	23395	7900	0.13227513227513227	2.961392405063291
chr22	PLA2G6	38143104	38143288	0	185	23420	8089	23420	7904	0.0	2.963056680161943
chr22	PLA2G6	38145437	38145653	0	217	23420	8089	23420	7872	0.0	2.97510162601626
chr22	PLA2G6	38145562	38145653	0	92	23420	8089	23420	7997	0.0	2.928598224334125
chr22	SGSM3-AS1	40378169	40378263	0	95	0	898	0	803	0.0	0.0
chr22	SGSM3-AS1	40379351	40379466	0	116	0	898	0	782	0.0	0.0
chr22	SLC25A17	40792524	40792676	21	153	1668	3372	1647	3219	0.13725490196078433	0.5116495806150979
chr22	SLC25A17	40794513	40794580	21	68	1668	3372	1647	3304	0.3088235294117647	0.4984866828087167
chr22	SLC25A17	40799022	40799083	252	62	1668	3372	1416	3310	4.064516129032258	0.42779456193353477
chr22	SLC25A17	40779757	40779894	0	138	1668	3372	1668	3234	0.0	0.5157699443413729
chr22	SLC25A17	40784512	40784604	183	93	1668	3372	1485	3279	1.967741935483871	0.45288197621225984
chr22	SNU13	41682355	41682587	232	233	24858	2935	24626	2702	0.9957081545064378	9.1139896373057
chr22	SNU13	41688078	41688327	0	250	24858	2935	24858	2685	0.0	9.258100558659217
chr22	SNU13	41688151	41688327	0	177	24858	2935	24858	2758	0.0	9.013052936910805
chr22	SNU13	41687721	41688327	44	607	24858	2935	24814	2328	0.07248764415156507	10.65893470790378
chr22	PNPLA5	43889328	43889495	0	168	0	2553	0	2385	0.0	0.0
chr22	PNPLA5	43891061	43891294	0	234	0	2553	0	2319	0.0	0.0
chr22	BCL2L13	17688985	17689142	51	158	13098	7270	13047	7112	0.3227848101265823	1.8345050618672667
chr22	BCL2L13	17702242	17702386	0	145	13098	7270	13098	7125	0.0	1.8383157894736841
chr22	BCL2L13	17696140	17696210	0	71	13098	7270	13098	7199	0.0	1.8194193638005278
chr22	BCL2L13	17683213	17683321	0	109	13098	7270	13098	7161	0.0	1.8290741516547968
chr22	COMT	19966625	19966718	213	94	40758	6477	40545	6383	2.265957446808511	6.352028826570578
chr22	COMT	19967163	19967621	4773	459	40758	6477	35985	6018	10.398692810457517	5.979561316051845
chr22	TANGO2	20053436	20053551	1953	116	31465	4941	29512	4825	16.836206896551722	6.116476683937824
chr22	TANGO2	20061529	20061683	200	155	31465	4941	31265	4786	1.2903225806451613	6.532595068951108
chr22	TANGO2	20055942	20056013	0	72	31465	4941	31465	4869	0.0	6.46231258985418
chr22	TANGO2	20063337	20063442	0	106	31465	4941	31465	4835	0.0	6.50775594622544
chr22	LZTR1	20985840	20985897	0	58	204	6931	204	6873	0.0	0.02968136185072021
chr22	LZTR1	20987503	20987583	0	81	204	6931	204	6850	0.0	0.02978102189781022
chr22	RGL4	23698414	23698548	0	135	0	4727	0	4592	0.0	0.0
chr22	RGL4	23698554	23698645	0	92	0	4727	0	4635	0.0	0.0
chr22	C22ORF15	23764792	23764902	0	111	0	1345	0	1234	0.0	0.0
chr22	C22ORF15	23765376	23765457	0	82	0	1345	0	1263	0.0	0.0
chr22	SEZ6L	26351051	26351243	0	193	0	7179	0	6986	0.0	0.0
chr22	SEZ6L	26365371	26365566	0	196	0	7179	0	6983	0.0	0.0
chr22	MIAT	26647173	26647311	0	139	0	13610	0	13471	0.0	0.0
chr22	MIAT	26660698	26660816	0	119	0	13610	0	13491	0.0	0.0
chr22	MIAT	26656031	26656154	0	124	0	13610	0	13486	0.0	0.0
chr22	MIAT	26658182	26658339	0	158	0	13610	0	13452	0.0	0.0
chr22	MIATNB	26693680	26693836	0	157	27	5101	27	4944	0.0	0.0054611650485436895
chr22	MIATNB	26711829	26712008	27	180	27	5101	0	4921	0.15	0.0
chr22	MIATNB	26717252	26717459	0	208	27	5101	27	4893	0.0	0.005518087063151441
chr22	MIATNB	26738061	26738240	0	180	27	5101	27	4921	0.0	0.005486689697216013
chr22	TTC28-AS1	27935150	27935230	0	81	153	11188	153	11107	0.0	0.01377509678581075
chr22	TTC28-AS1	27993123	27993535	0	413	153	11188	153	10775	0.0	0.01419953596287703
chr22	TTC28-AS1	27994472	27994653	0	182	153	11188	153	11006	0.0	0.013901508268217335
chr22	TTC28-AS1	27940019	27940171	0	153	153	11188	153	11035	0.0	0.013864975079293159
chr22	CCDC117	28773724	28773778	0	55	153	4332	153	4277	0.0	0.03577273790039748
chr22	CCDC117	28780947	28781172	0	226	153	4332	153	4106	0.0	0.03726254262055528
chr22	EMID1	29254202	29254287	0	86	63	3322	63	3236	0.0	0.01946847960444994
chr22	EMID1	29255270	29255361	0	92	63	3322	63	3230	0.0	0.019504643962848296
chr22	EWSR1	29288605	29288786	0	182	1411	6389	1411	6207	0.0	0.22732398904462703
chr22	EWSR1	29288986	29289062	0	77	1411	6389	1411	6312	0.0	0.2235424588086185
chr22	NF2	29636750	29636876	0	127	251405	5395	251405	5268	0.0	47.72304479878512
chr22	NF2	29639089	29639212	0	124	251405	5395	251405	5271	0.0	47.69588313413015
chr22	MTMR3	29957035	29957088	284	54	11255	9913	10971	9859	5.2592592592592595	1.1127903438482605
chr22	MTMR3	29970975	29971062	1011	88	11255	9913	10244	9825	11.488636363636363	1.04264631043257
chr22	CCDC157	30361960	30362114	0	155	7379	6596	7379	6441	0.0	1.1456295606272318
chr22	CCDC157	30365989	30366248	0	260	7379	6596	7379	6336	0.0	1.164614898989899
chr22	DRG1	31400619	31400743	0	125	123	2211	123	2086	0.0	0.05896452540747843
chr22	DRG1	31403028	31403204	0	177	123	2211	123	2034	0.0	0.06047197640117994
chr22	SFI1	31531057	31531129	0	73	45866	12126	45866	12053	0.0	3.8053596614950633
chr22	SFI1	31546860	31546971	0	112	45866	12126	45866	12014	0.0	3.8177126685533542
chr22	SFI1	31603743	31603819	0	77	45866	12126	45866	12049	0.0	3.8066229562619305
chr22	SFI1	31604308	31604404	0	97	45866	12126	45866	12029	0.0	3.8129520325879125
chr22	YWHAH	31945499	31945678	0	180	10132	2398	10132	2218	0.0	4.568079350766456
chr22	YWHAH	31950307	31950422	0	116	10132	2398	10132	2282	0.0	4.439964943032428
chr22	YWHAH	31945556	31945678	0	123	10132	2398	10132	2275	0.0	4.453626373626373
chr22	LARGE-AS1	33725611	33725756	0	146	666	2871	666	2725	0.0	0.24440366972477065
chr22	LARGE-AS1	33726115	33726197	0	83	666	2871	666	2788	0.0	0.23888091822094693
chr22	LARGE-AS1	33746414	33746457	0	44	666	2871	666	2827	0.0	0.23558542624690484
chr22	LARGE-AS1	33747669	33747824	12	156	666	2871	654	2715	0.07692307692307693	0.2408839779005525
chr22	LINC01643	34147995	34148132	0	138	0	3786	0	3648	0.0	0.0
chr22	LINC01643	34161595	34161791	0	197	0	3786	0	3589	0.0	0.0
chr22	LINC01643	34109325	34109434	0	110	0	3786	0	3676	0.0	0.0
chr22	LINC01643	34188184	34188425	0	242	0	3786	0	3544	0.0	0.0
chr22	LINC01643	34206081	34206194	0	114	0	3786	0	3672	0.0	0.0
chr22	LINC01643	34206081	34206163	0	83	0	3786	0	3703	0.0	0.0
chr22	LINC01643	34175389	34175440	0	52	0	3786	0	3734	0.0	0.0
chr22	LINC01643	34205472	34205558	0	87	0	3786	0	3699	0.0	0.0
chr22	LINC01643	34151864	34151927	0	64	0	3786	0	3722	0.0	0.0
chr22	HMOX1	35386684	35387176	0	493	0	2254	0	1761	0.0	0.0
chr22	HMOX1	35389863	35389963	0	101	0	2254	0	2153	0.0	0.0
chr22	MCM5	35401370	35401466	0	97	148	5194	148	5097	0.0	0.029036688247989013
chr22	MCM5	35401665	35401814	0	150	148	5194	148	5044	0.0	0.029341792228390166
chr22	CBY1	38665545	38665685	0	141	617	2355	617	2214	0.0	0.2786811201445348
chr22	CBY1	38667568	38667662	20	95	617	2355	597	2260	0.21052631578947367	0.26415929203539823
chr22	APOBEC3D	39022821	39023014	0	194	5821	2536	5821	2342	0.0	2.485482493595218
chr22	APOBEC3D	39029362	39029519	399	158	5821	2536	5422	2378	2.5253164556962027	2.280067283431455
chr22	TNRC6B	40264687	40267036	0	2350	255	20027	255	17677	0.0	0.014425524693104033
chr22	TNRC6B	40270121	40270280	0	160	255	20027	255	19867	0.0	0.012835355111491418
chr22	ADSL	40353072	40353117	0	46	1168	7463	1168	7417	0.0	0.15747606849130377
chr22	ADSL	40354247	40354327	0	81	1168	7463	1168	7382	0.0	0.1582227038742888
chr22	ADSL	40353332	40353419	0	88	1168	7463	1168	7375	0.0	0.1583728813559322
chr22	ACO2	41517942	41518408	0	467	52146	9940	52146	9473	0.0	5.504697561490552
chr22	ACO2	41518480	41518572	179	93	52146	9940	51967	9847	1.924731182795699	5.277444907078298
chr22	ACO2	41469347	41469508	277	162	52146	9940	51869	9778	1.7098765432098766	5.3046635303743095
chr22	ACO2	41499725	41499862	0	138	52146	9940	52146	9802	0.0	5.319934707202612
chr22	ACO2	41502629	41502771	0	143	52146	9940	52146	9797	0.0	5.322649790752271
chr22	ACO2	41507445	41507606	140	162	52146	9940	52006	9778	0.8641975308641975	5.318674575577828
chr22	ACO2	41522829	41522982	51	154	52146	9940	52095	9786	0.33116883116883117	5.323421213979154
chr22	ACO2	41523204	41523278	0	75	52146	9940	52146	9865	0.0	5.285960466294982
chr22	ACO2	41518495	41518572	154	78	52146	9940	51992	9862	1.9743589743589745	5.271952950719935
chr22	NDUFA6-DT	42120035	42120128	0	94	14794	5096	14794	5002	0.0	2.9576169532187127
chr22	NDUFA6-DT	42123525	42123591	0	67	14794	5096	14794	5029	0.0	2.941737920063631
chr22	ARHGAP8	44808671	44808732	0	62	158	4776	158	4714	0.0	0.03351718285956724
chr22	ARHGAP8	44809005	44809098	0	94	158	4776	158	4682	0.0	0.03374626228107646
chr22	ARHGAP8	44802076	44802164	0	89	158	4776	158	4687	0.0	0.03371026242799232
chr22	ARHGAP8	44808306	44808438	0	133	158	4776	158	4643	0.0	0.034029722162395006
chr22	TBC1D22A	46913333	46913446	0	114	6870	5336	6870	5222	0.0	1.3155878973573343
chr22	TBC1D22A	46974289	46974399	0	111	6870	5336	6870	5225	0.0	1.3148325358851676
chr22	TBC1D22A	46797443	46797620	0	178	6870	5336	6870	5158	0.0	1.331911593640946
chr22	TBC1D22A	46878652	46878723	0	72	6870	5336	6870	5264	0.0	1.3050911854103344
chr22	AL117329.1	47687140	47687206	0	67	102	31762	102	31695	0.0	0.003218173213440606
chr22	AL117329.1	47704588	47704747	0	160	102	31762	102	31602	0.0	0.0032276438200113918
chr22	AL117329.1	47728828	47728995	0	168	102	31762	102	31594	0.0	0.0032284611002089004
chr22	AL117329.1	47724273	47724325	0	53	102	31762	102	31709	0.0	0.003216752341606484
chr22	AL117329.1	47637512	47637604	0	93	102	31762	102	31669	0.0	0.0032208153083457007
chr22	AL117329.1	47641984	47642173	0	190	102	31762	102	31572	0.0	0.0032307107563664004
chr22	AL117329.1	47637509	47637604	0	96	102	31762	102	31666	0.0	0.00322112044464094
chr22	AL117329.1	47685316	47685477	0	162	102	31762	102	31600	0.0	0.0032278481012658227
chr22	AL117329.1	47637502	47637604	0	103	102	31762	102	31659	0.0	0.0032218326542215485
chr22	AL117329.1	47861991	47862122	0	132	102	31762	102	31630	0.0	0.0032247865950047424
chr22	CRELD2	49923233	49923317	0	85	0	3667	0	3582	0.0	0.0
chr22	CRELD2	49924359	49924455	0	97	0	3667	0	3570	0.0	0.0
chr22	MOV10L1	50160687	50160825	0	139	220	6832	220	6693	0.0	0.03287016285671597
chr22	MOV10L1	50160963	50161055	0	93	220	6832	220	6739	0.0	0.03264579314438344
chrX	CSF2RA	1300490	1300626	0	137	0	3562	0	3425	0.0	0.0
chrX	CSF2RA	1303922	1304019	0	98	0	3562	0	3464	0.0	0.0
chrX	GYG2	2843212	2843354	0	143	467	3634	467	3491	0.0	0.13377255800630192
chrX	GYG2	2853979	2854154	0	176	467	3634	467	3458	0.0	0.13504916136495085
chrX	MSL3	11759792	11759875	0	84	0	7299	0	7215	0.0	0.0
chrX	MSL3	11760402	11760498	0	97	0	7299	0	7202	0.0	0.0
chrX	GLRA2	14574372	14574400	0	29	490	3717	490	3688	0.0	0.13286334056399132
chrX	GLRA2	14574491	14574559	0	69	490	3717	490	3648	0.0	0.13432017543859648
chrX	GLRA2	14574332	14574400	0	69	490	3717	490	3648	0.0	0.13432017543859648
chrX	CDKL5	18443818	18443959	0	142	4711	18806	4711	18664	0.0	0.25241105872267466
chrX	CDKL5	18457482	18457534	0	53	4711	18806	4711	18753	0.0	0.25121313923105637
chrX	PDHA1	19345735	19345819	0	85	102	4235	102	4150	0.0	0.02457831325301205
chrX	PDHA1	19346509	19346623	0	115	102	4235	102	4120	0.0	0.02475728155339806
chrX	MAGEB16	35800516	35800568	0	53	0	1991	0	1938	0.0	0.0
chrX	MAGEB16	35801320	35801374	0	55	0	1991	0	1936	0.0	0.0
chrX	TSPAN7	38622902	38623033	0	132	735	2953	735	2821	0.0	0.26054590570719605
chrX	TSPAN7	38655995	38656155	735	161	735	2953	0	2792	4.565217391304348	0.0
chrX	TSPAN7	38646261	38646312	0	52	735	2953	735	2901	0.0	0.2533609100310238
chrX	DDX3X	41347639	41347915	0	277	1939	11657	1939	11380	0.0	0.17038664323374342
chrX	DDX3X	41357832	41357939	0	108	1939	11657	1939	11549	0.0	0.16789332409732444
chrX	DDX3X	41357832	41358000	0	169	1939	11657	1939	11488	0.0	0.16878481894150418
chrX	DDX3X	41343215	41343351	0	137	1939	11657	1939	11520	0.0	0.16831597222222222
chrX	DDX3X	41343736	41343822	0	87	1939	11657	1939	11570	0.0	0.1675885911840968
chrX	DDX3X	41344029	41344128	0	100	1939	11657	1939	11557	0.0	0.16777710478497881
chrX	Z93403.1	42582513	42582688	0	176	0	1318	0	1142	0.0	0.0
chrX	Z93403.1	42677755	42677827	0	73	0	1318	0	1245	0.0	0.0
chrX	KDM6A	45060021	45060156	0	136	51	19804	51	19668	0.0	0.0025930445393532644
chrX	KDM6A	45060608	45060764	0	157	51	19804	51	19647	0.0	0.002595816155138189
chrX	LINC01204	45510496	45510595	0	100	2082	6442	2082	6342	0.0	0.3282876064333018
chrX	LINC01204	45518953	45519178	0	226	2082	6442	2082	6216	0.0	0.33494208494208494
chrX	FTSJ1	48479037	48479116	0	80	1683	2878	1683	2798	0.0	0.6015010721944246
chrX	FTSJ1	48481150	48481203	0	54	1683	2878	1683	2824	0.0	0.5959631728045326
chrX	PORCN	48512834	48512852	0	19	142	2636	142	2617	0.0	0.054260603744745894
chrX	PORCN	48514126	48514141	0	16	142	2636	142	2620	0.0	0.05419847328244275
chrX	AL050309.1	55985998	55986224	0	227	357	12309	357	12082	0.0	0.02954808806488992
chrX	AL050309.1	56002824	56002983	0	160	357	12309	357	12149	0.0	0.029385134578977692
chrX	DLG3	70493375	70493475	0	101	184399	7893	184399	7792	0.0	23.665169404517453
chrX	DLG3	70495407	70495453	42	47	184399	7893	184357	7846	0.8936170212765957	23.49694111649248
chrX	GJB1	71222583	71222766	0	184	0	4661	0	4477	0.0	0.0
chrX	GJB1	71223186	71223335	0	150	0	4661	0	4511	0.0	0.0
chrX	NONO	71294226	71294348	0	123	0	9256	0	9133	0.0	0.0
chrX	NONO	71296564	71296660	0	97	0	9256	0	9159	0.0	0.0
chrX	NONO	71284983	71285097	0	115	0	9256	0	9141	0.0	0.0
chrX	NONO	71288426	71288534	0	109	0	9256	0	9147	0.0	0.0
chrX	NONO	71294397	71294528	0	132	0	9256	0	9124	0.0	0.0
chrX	JPX	73946998	73947374	0	377	306	19827	306	19450	0.0	0.015732647814910027
chrX	JPX	73994839	73994961	0	123	306	19827	306	19704	0.0	0.015529841656516443
chrX	JPX	73962730	73962801	0	72	306	19827	306	19755	0.0	0.015489749430523917
chrX	JPX	73962734	73962801	0	68	306	19827	306	19759	0.0	0.015486613695025051
chrX	JPX	73984443	73984541	0	99	306	19827	306	19728	0.0	0.01551094890510949
chrX	JPX	73998767	73998844	0	78	306	19827	306	19749	0.0	0.015494455415464074
chrX	JPX	73999354	74000496	0	1143	306	19827	306	18684	0.0	0.016377649325626204
chrX	JPX	73944583	73944662	0	80	306	19827	306	19747	0.0	0.015496024712614574
chrX	JPX	73994863	73994961	0	99	306	19827	306	19728	0.0	0.01551094890510949
chrX	DACH2	86184232	86184350	0	119	105	2770	105	2651	0.0	0.03960769520935496
chrX	DACH2	86376823	86376862	0	40	105	2770	105	2730	0.0	0.038461538461538464
chrX	PCDH11X	92287966	92288002	0	37	0	11642	0	11605	0.0	0.0
chrX	PCDH11X	92387734	92387933	0	200	0	11642	0	11442	0.0	0.0
chrX	CENPI	101098711	101098843	0	133	0	4333	0	4200	0.0	0.0
chrX	CENPI	101099808	101100065	0	258	0	4333	0	4075	0.0	0.0
chrX	LINC00630	102770351	102770420	0	70	295252	11012	295252	10942	0.0	26.983366843355878
chrX	LINC00630	102816991	102817082	0	92	295252	11012	295252	10920	0.0	27.03772893772894
chrX	PRPS1	107640901	107641000	0	100	828	3405	828	3305	0.0	0.25052950075642966
chrX	PRPS1	107642365	107642490	0	126	828	3405	828	3279	0.0	0.252516010978957
chrX	PRPS1	107639294	107639478	165	185	828	3405	663	3220	0.8918918918918919	0.2059006211180124
chrX	PRPS1	107636587	107636679	0	93	828	3405	828	3312	0.0	0.25
chrX	PRPS1	107636993	107637095	0	103	828	3405	828	3302	0.0	0.25075711689884916
chrX	PRPS1	107643222	107643286	0	65	828	3405	828	3340	0.0	0.24790419161676647
chrX	PRPS1	107644360	107644428	0	69	828	3405	828	3336	0.0	0.24820143884892087
chrX	PAK3	111144859	111144922	0	64	2091	10441	2091	10377	0.0	0.20150332466030646
chrX	PAK3	111146520	111146565	0	46	2091	10441	2091	10395	0.0	0.20115440115440114
chrX	ALG13	111682131	111682235	0	105	0	8141	0	8036	0.0	0.0
chrX	ALG13	111682235	111682294	0	60	0	8141	0	8081	0.0	0.0
chrX	PLS3	115610802	115610921	0	120	204	4122	204	4002	0.0	0.050974512743628186
chrX	PLS3	115614152	115614534	0	383	204	4122	204	3739	0.0	0.05456004279219043
chrX	PLS3	115624340	115624380	0	41	204	4122	204	4081	0.0	0.049987748100955645
chrX	PLS3	115629197	115629327	0	131	204	4122	204	3991	0.0	0.0511150087697319
chrX	WDR44	118378418	118378452	4474	35	4824	4223	350	4188	127.82857142857142	0.08357211079274117
chrX	WDR44	118387339	118387414	0	76	4824	4223	4824	4147	0.0	1.1632505425608874
chrX	LINC01285	118841814	118841865	0	52	1478	5759	1478	5707	0.0	0.2589801997546872
chrX	LINC01285	118845240	118845285	0	46	1478	5759	1478	5713	0.0	0.2587082093471031
chrX	GRIA3	123465673	123465788	56	116	3106	6507	3050	6391	0.4827586206896552	0.47723360976373025
chrX	GRIA3	123480062	123480177	0	116	3106	6507	3106	6391	0.0	0.4859959317790643
chrX	XIAP	123860166	123860293	0	128	152	3270	152	3142	0.0	0.0483768300445576
chrX	XIAP	123885630	123886539	102	910	152	3270	50	2360	0.11208791208791209	0.0211864406779661
chrX	STAG2	123961785	123961856	0	72	0	8243	0	8171	0.0	0.0
chrX	STAG2	124021366	124021431	0	66	0	8243	0	8177	0.0	0.0
chrX	STAG2	123962078	123962106	0	29	0	8243	0	8214	0.0	0.0
chrX	OCRL	129575653	129575719	0	67	4948	6110	4948	6043	0.0	0.8187986099619394
chrX	OCRL	129575896	129576062	0	167	4948	6110	4948	5943	0.0	0.8325761399966347
chrX	FAM122C	134849166	134849228	0	63	0	7535	0	7472	0.0	0.0
chrX	FAM122C	134852799	134852896	0	98	0	7535	0	7437	0.0	0.0
chrX	FAM122C	134847882	134847971	0	90	0	7535	0	7445	0.0	0.0
chrX	FAM122C	134847382	134847475	0	94	0	7535	0	7441	0.0	0.0
chrX	FHL1	136167844	136168035	0	192	476	5097	476	4905	0.0	0.09704383282364934
chrX	FHL1	136168129	136168288	0	160	476	5097	476	4937	0.0	0.09641482681790561
chrX	FHL1	136167903	136168035	0	133	476	5097	476	4964	0.0	0.0958904109589041
chrX	LINC00632	140713428	140713489	0	62	2038	14900	2038	14838	0.0	0.1373500471761693
chrX	LINC00632	140713516	140716289	0	2774	2038	14900	2038	12126	0.0	0.16806861289790534
chrX	LINC00632	140730922	140731044	0	123	2038	14900	2038	14777	0.0	0.13791703322731272
chrX	MTMR1	150712943	150712970	0	28	43	4511	43	4483	0.0	0.009591791211242472
chrX	MTMR1	150714478	150714529	0	52	43	4511	43	4459	0.0	0.009643417806683112
chrX	MTMR1	150714478	150714532	0	55	43	4511	43	4456	0.0	0.009649910233393177
chrX	MTMR1	150712341	150712365	0	25	43	4511	43	4486	0.0	0.009585376727596968
chrX	MTMR1	150712729	150712753	0	25	43	4511	43	4486	0.0	0.009585376727596968
chrX	MAGEA2B	152715956	152716062	166	107	18605	2427	18439	2320	1.5514018691588785	7.947844827586207
chrX	MAGEA2B	152716895	152716961	914	67	18605	2427	17691	2360	13.64179104477612	7.496186440677966
chrX	TAZ	154414100	154414190	0	91	161	3645	161	3554	0.0	0.04530106921778278
chrX	TAZ	154418545	154418602	0	58	161	3645	161	3587	0.0	0.04488430443267354
chrX	ATP6AP1	154429291	154429452	0	162	273	5136	273	4974	0.0	0.0548854041013269
chrX	ATP6AP1	154431829	154431904	0	76	273	5136	273	5060	0.0	0.053952569169960475
chrX	ATP6AP1	154432265	154432376	0	112	273	5136	273	5024	0.0	0.054339171974522295
chrX	ATP6AP1	154433659	154433720	0	62	273	5136	273	5074	0.0	0.05380370516357903
chrX	CRLF2	1198561	1198724	0	164	0	1993	0	1829	0.0	0.0
chrX	CRLF2	1198800	1199145	0	346	0	1993	0	1647	0.0	0.0
chrX	BX890604.1	3818656	3818703	0	48	43393	13199	43393	13151	0.0	3.2995969888221426
chrX	BX890604.1	3822373	3822580	2659	208	43393	13199	40734	12991	12.783653846153847	3.1355553844969593
chrX	BX890604.1	3822072	3822285	2052	214	43393	13199	41341	12985	9.588785046728972	3.1837504813246054
chrX	FAM9B	9030121	9030206	0	86	0	6904	0	6818	0.0	0.0
chrX	FAM9B	9030260	9030360	0	101	0	6904	0	6803	0.0	0.0
chrX	AC073529.1	10963881	10963943	0	63	0	3512	0	3449	0.0	0.0
chrX	AC073529.1	11038602	11038655	0	54	0	3512	0	3458	0.0	0.0
chrX	PIGA	15325913	15326046	0	134	0	5184	0	5050	0.0	0.0
chrX	PIGA	15331589	15331992	0	404	0	5184	0	4780	0.0	0.0
chrX	AP1S2	15828191	15828200	10	10	53339	5359	53329	5349	1.0	9.969900916059077
chrX	AP1S2	15840496	15840591	612	96	53339	5359	52727	5263	6.375	10.018430552916588
chrX	AP1S2	15831451	15831568	123	118	53339	5359	53216	5241	1.0423728813559323	10.153787445144056
chrX	RBBP7	16852415	16852550	10041	136	475093	7223	465052	7087	73.83088235294117	65.62043177649217
chrX	RBBP7	16852550	16852628	100	79	475093	7223	474993	7144	1.2658227848101267	66.48838185890257
chrX	ADGRG2	19037466	19037490	0	25	1025	5324	1025	5299	0.0	0.19343272315531232
chrX	ADGRG2	19037588	19037636	0	49	1025	5324	1025	5275	0.0	0.1943127962085308
chrX	AL807742.1	21029768	21029835	0	68	0	5068	0	5000	0.0	0.0
chrX	AL807742.1	21061972	21062120	0	149	0	5068	0	4919	0.0	0.0
chrX	RPGR	38287093	38287245	0	153	45	8385	45	8232	0.0	0.005466472303206997
chrX	RPGR	38287864	38288041	0	178	45	8385	45	8207	0.0	0.005483124162300475
chrX	CASK	41555599	41555635	0	37	20301	19740	20301	19703	0.0	1.030350708014008
chrX	CASK	41557031	41557100	150	70	20301	19740	20151	19670	2.142857142857143	1.0244534824606
chrX	WDR45	49076429	49076524	0	96	663	3931	663	3835	0.0	0.17288135593220338
chrX	WDR45	49077642	49077747	0	106	663	3931	663	3825	0.0	0.17333333333333334
chrX	WDR45	49076644	49076750	0	107	663	3931	663	3824	0.0	0.17337866108786612
chrX	WDR45	49076644	49076753	0	110	663	3931	663	3821	0.0	0.17351478670505102
chrX	PHF8	53993600	53993903	0	304	24833	9217	24833	8913	0.0	2.7861550544148996
chrX	PHF8	53995130	53995205	0	76	24833	9217	24833	9141	0.0	2.716661196805601
chrX	LINC01278	63509943	63510079	0	137	1173	13947	1173	13810	0.0	0.08493845039826213
chrX	LINC01278	63516909	63517082	40	174	1173	13947	1133	13773	0.22988505747126436	0.08226239744427503
chrX	LINC01278	63432363	63432491	0	129	1173	13947	1173	13818	0.0	0.08488927485887972
chrX	LINC01278	63314996	63315107	0	112	1173	13947	1173	13835	0.0	0.08478496566678713
chrX	LINC01278	63343205	63343289	0	85	1173	13947	1173	13862	0.0	0.08461982397922378
chrX	LINC01278	63516909	63517100	51	192	1173	13947	1122	13755	0.265625	0.08157033805888768
chrX	ARHGEF9	63712906	63713112	0	207	8262	12238	8262	12031	0.0	0.6867259579419832
chrX	ARHGEF9	63724531	63724711	0	181	8262	12238	8262	12057	0.0	0.6852450858422493
chrX	ARHGEF9	63725682	63725735	0	54	8262	12238	8262	12184	0.0	0.678102429415627
chrX	ARHGEF9	63726645	63726693	0	49	8262	12238	8262	12189	0.0	0.6778242677824268
chrX	ARHGEF9	63719673	63719856	51	184	8262	12238	8211	12054	0.27717391304347827	0.681184668989547
chrX	ARHGEF9	63736989	63737118	0	130	8262	12238	8262	12108	0.0	0.682358771060456
chrX	ARHGEF9	63724795	63724846	0	52	8262	12238	8262	12186	0.0	0.6779911373707533
chrX	ARHGEF9	63743368	63743446	0	79	8262	12238	8262	12159	0.0	0.6794966691339749
chrX	ARHGEF9	63732005	63732310	0	306	8262	12238	8262	11932	0.0	0.6924237344954743
chrX	ARHGEF9	63655493	63655737	8160	245	8262	12238	102	11993	33.30612244897959	0.00850496122738264
chrX	ARHGEF9	63665885	63666017	0	133	8262	12238	8262	12105	0.0	0.6825278810408922
chrX	ARHGEF9	63715987	63716119	0	133	8262	12238	8262	12105	0.0	0.6825278810408922
chrX	ARHGEF9	63722761	63722897	0	137	8262	12238	8262	12101	0.0	0.6827534914469878
chrX	ARHGEF9	63755833	63755910	0	78	8262	12238	8262	12160	0.0	0.6794407894736842
chrX	LAS1L	65532560	65532630	0	71	51	7818	51	7747	0.0	0.006583193494255841
chrX	LAS1L	65533609	65533735	0	127	51	7818	51	7691	0.0	0.0066311272916395785
chrX	HDAC8	72490928	72491006	0	79	139	18208	139	18129	0.0	0.007667273429312151
chrX	HDAC8	72495155	72495268	0	114	139	18208	139	18094	0.0	0.0076821045650491875
chrX	HDAC8	72330657	72330768	0	112	139	18208	139	18096	0.0	0.0076812555260831125
chrX	HDAC8	72349691	72349926	0	236	139	18208	139	17972	0.0	0.007734253282884487
chrX	HDAC8	72330690	72330876	0	187	139	18208	139	18021	0.0	0.007713223461517119
chrX	HDAC8	72330690	72330768	0	79	139	18208	139	18129	0.0	0.007667273429312151
chrX	HDAC8	72330815	72330876	0	62	139	18208	139	18146	0.0	0.007660090378044748
chrX	HDAC8	72567888	72568030	0	143	139	18208	139	18065	0.0	0.007694436756158317
chrX	HDAC8	72568753	72568884	0	132	139	18208	139	18076	0.0	0.007689754370435937
chrX	XIST	73831065	73831274	816	210	6963	13551	6147	13341	3.8857142857142857	0.4607600629637958
chrX	XIST	73833237	73833374	563	138	6963	13551	6400	13413	4.079710144927536	0.47714903451875046
chrX	XIST	73841291	73841321	0	31	6963	13551	6963	13520	0.0	0.5150147928994083
chrX	XIST	73841381	73841473	0	93	6963	13551	6963	13458	0.0	0.5173874275523852
chrX	FTX	74284742	74284944	3314	203	12300	26391	8986	26188	16.32512315270936	0.34313425996639685
chrX	FTX	74290394	74290430	0	37	12300	26391	12300	26354	0.0	0.46672231919253243
chrX	FTX	74284742	74284948	3530	207	12300	26391	8770	26184	17.053140096618357	0.3349373663305836
chrX	FTX	74247331	74247422	0	92	12300	26391	12300	26299	0.0	0.4676983915738241
chrX	FTX	74274341	74274410	0	70	12300	26391	12300	26321	0.0	0.46730747312032217
chrX	FTX	74215396	74215536	0	141	12300	26391	12300	26250	0.0	0.4685714285714286
chrX	FTX	74274341	74274457	0	117	12300	26391	12300	26274	0.0	0.4681434117378397
chrX	FTX	74285914	74286170	0	257	12300	26391	12300	26134	0.0	0.4706512588964567
chrX	MIR325HG	76658501	76658668	0	168	0	4180	0	4012	0.0	0.0
chrX	MIR325HG	76692966	76693087	0	122	0	4180	0	4058	0.0	0.0
chrX	MIR325HG	76837809	76837892	0	84	0	4180	0	4096	0.0	0.0
chrX	MIR325HG	77007275	77007380	0	106	0	4180	0	4074	0.0	0.0
chrX	MIR325HG	76781182	76781292	0	111	0	4180	0	4069	0.0	0.0
chrX	HDX	84475250	84475397	0	148	10590	7271	10590	7123	0.0	1.4867331180682297
chrX	HDX	84488023	84488132	0	110	10590	7271	10590	7161	0.0	1.478843736908253
chrX	SATL1	85118337	85118455	1952	119	20773	6989	18821	6870	16.403361344537814	2.7395924308588064
chrX	SATL1	85142609	85142762	6	154	20773	6989	20767	6835	0.03896103896103896	3.0383321141185076
chrX	AC235565.2	102438552	102438674	109	123	291	4954	182	4831	0.8861788617886179	0.0376733595528876
chrX	AC235565.2	102456806	102456914	0	109	291	4954	291	4845	0.0	0.060061919504643964
chrX	AC234782.2	103813121	103813233	0	113	163	7805	163	7692	0.0	0.021190847633905358
chrX	AC234782.2	103827004	103827078	0	75	163	7805	163	7730	0.0	0.021086675291073737
chrX	AC234782.2	103788409	103788505	0	97	163	7805	163	7708	0.0	0.02114686040477426
chrX	AC234782.2	103791253	103791400	0	148	163	7805	163	7657	0.0	0.021287710591615515
chrX	RBM41	107088435	107088839	0	405	51	4714	51	4309	0.0	0.011835692736133673
chrX	RBM41	107113396	107113468	0	73	51	4714	51	4641	0.0	0.01098901098901099
chrX	PSMD10	108087952	108088099	0	148	0	2395	0	2247	0.0	0.0
chrX	PSMD10	108088751	108088850	0	100	0	2395	0	2295	0.0	0.0
chrX	AIFM1	130155155	130155286	0	132	102	10093	102	9961	0.0	0.010239935749422748
chrX	AIFM1	130156460	130156603	0	144	102	10093	102	9949	0.0	0.010252286661976077
chrX	ATP11C	139731650	139731755	0	106	68	7441	68	7335	0.0	0.0092706203135651
chrX	ATP11C	139737730	139737796	0	67	68	7441	68	7374	0.0	0.009221589368049905
chrX	TREX2	153445598	153445644	0	47	70	2729	70	2682	0.0	0.02609992542878449
chrX	TREX2	153446008	153446111	0	104	70	2729	70	2625	0.0	0.02666666666666667
chrX	CCNQ	153592505	153592733	860915	229	2515831	1673	1654916	1444	3759.4541484716156	1146.0637119113574
chrX	CCNQ	153594546	153594679	213819	134	2515831	1673	2302012	1539	1595.6641791044776	1495.7842755035738
chrX	ARHGAP4	153918831	153919053	0	223	444	5199	444	4976	0.0	0.08922829581993569
chrX	ARHGAP4	153921096	153921159	0	64	444	5199	444	5135	0.0	0.08646543330087633
chrX	IRAK1	154014041	154014278	0	238	88402	3637	88402	3399	0.0	26.008237716975582
chrX	IRAK1	154016031	154016097	0	67	88402	3637	88402	3570	0.0	24.7624649859944
chrX	IRAK1	154013042	154013433	21824	392	88402	3637	66578	3245	55.673469387755105	20.517103235747303
chrX	IRAK1	154013042	154013343	2055	302	88402	3637	86347	3335	6.804635761589404	25.891154422788606
chrX	IRAK1	154012528	154012678	1443	151	88402	3637	86959	3486	9.556291390728477	24.94520940906483
chrX	SLC10A3	154489941	154490027	3016	87	46608	2016	43592	1929	34.666666666666664	22.598237428719543
chrX	SLC10A3	154490306	154490358	1772	53	46608	2016	44836	1963	33.43396226415094	22.84055017829852
chrX	MPP1	154799744	154799893	0	150	332	5410	332	5260	0.0	0.06311787072243347
chrX	MPP1	154804696	154804827	0	132	332	5410	332	5278	0.0	0.06290261462675256
chrY	CSF2RA	1300490	1300626	33	137	421	3562	388	3425	0.24087591240875914	0.11328467153284671
chrY	CSF2RA	1303922	1304019	78	98	421	3562	343	3464	0.7959183673469388	0.09901847575057737
chrY	LINC00278	3058656	3058784	0	129	0	4194	0	4065	0.0	0.0
chrY	LINC00278	3079283	3079341	0	59	0	4194	0	4135	0.0	0.0
chrY	PCDH11Y	5002687	5002758	0	72	0	10882	0	10810	0.0	0.0
chrY	PCDH11Y	5031905	5032011	0	107	0	10882	0	10775	0.0	0.0
chrY	PCDH11Y	5030898	5031067	0	170	0	10882	0	10712	0.0	0.0
chrY	TBL1Y	6978212	6978243	0	32	51	2646	51	2614	0.0	0.019510328997704666
chrY	TBL1Y	6995803	6995898	0	96	51	2646	51	2550	0.0	0.02
chrY	DAZ2	23248762	23248834	0	73	0	4192	0	4119	0.0	0.0
chrY	DAZ2	23251144	23251216	0	73	0	4192	0	4119	0.0	0.0
chrY	DAZ4	24888533	24888605	0	73	0	4377	0	4304	0.0	0.0
chrY	DAZ4	24890917	24890989	0	73	0	4377	0	4304	0.0	0.0
chrY	DAZ4	24886148	24886220	0	73	0	4377	0	4304	0.0	0.0
chrY	DAZ4	24893302	24893374	0	73	0	4377	0	4304	0.0	0.0
chrY	CRLF2	1198561	1198724	0	164	0	1993	0	1829	0.0	0.0
chrY	CRLF2	1198800	1199145	0	346	0	1993	0	1647	0.0	0.0
chrY	UTY	13358463	13358619	31	157	3446	9223	3415	9066	0.19745222929936307	0.3766821089786014
chrY	UTY	13359087	13359222	1120	136	3446	9223	2326	9087	8.235294117647058	0.2559700671288654
chrY	TTTY14	18932742	18932841	0	100	408	17451	408	17351	0.0	0.023514494841795863
chrY	TTTY14	19068723	19068798	0	76	408	17451	408	17375	0.0	0.02348201438848921
chrY	TTTY14	18834050	18834207	0	158	408	17451	408	17293	0.0	0.02359336147574163
chrY	TTTY14	18836319	18836409	0	91	408	17451	408	17360	0.0	0.023502304147465437
chrY	TTTY14	19073498	19073561	0	64	408	17451	408	17387	0.0	0.02346580778742739
chrY	KDM5D	19741317	19741488	0	172	0	9273	0	9101	0.0	0.0
chrY	KDM5D	19741734	19741857	0	124	0	9273	0	9149	0.0	0.0
chrY	KDM5D	19739527	19739662	0	136	0	9273	0	9137	0.0	0.0
chrY	TTTY10	20518887	20519000	0	114	0	8026	0	7912	0.0	0.0
chrY	TTTY10	20519035	20519233	0	199	0	8026	0	7827	0.0	0.0
