chrom	geneName	splicedExonStart	splicedExonEnd	splicedExonReadCount(rc)	splicedExonLength(sl)	othersExonsReadCount(RC)	othersExonsLength(L)	RC - rc	L - sl	splicedExonAverageReadCoverage(n)	otherExonsAverageReadCoverage(N)
chr1	LINC01128	851926	852766	2460	841	50545	13620	48085	12779	2.925089179548157	3.762813991705141
chr1	PLEKHN1	974441	975865	816	1425	2663	3466	1847	2041	0.5726315789473684	0.9049485546300833
chr1	PLEKHN1	970685	971006	1603	322	2663	3466	1060	3144	4.978260869565218	0.3371501272264631
chr1	SCNN1D	1287507	1287836	2007	330	22405	3430	20398	3100	6.081818181818182	6.58
chr1	MRPL20-AS1	1399519	1400303	0	785	0	2407	0	1622	0.0	0.0
chr1	MIB2	1629384	1629566	0	183	73128	7887	73128	7704	0.0	9.49221183800623
chr1	MIB2	1626836	1627207	563	372	73128	7887	72565	7515	1.5134408602150538	9.656021290751829
chr1	MMP23B	1632980	1633355	663	376	103840	2013	103177	1637	1.7632978723404256	63.02810018326206
chr1	MMP23B	1633747	1634099	18983	353	103840	2013	84857	1660	53.77620396600567	51.11867469879518
chr1	DFFB	3883506	3885429	0	1924	0	3880	0	1956	0.0	0.0
chr1	LINC01646	4593051	4594009	0	959	0	3336	0	2377	0.0	0.0
chr1	KCNAB2	6095529	6096756	0	1228	24733	13510	24733	12282	0.0	2.0137599739456116
chr1	KCNAB2	6097268	6097555	0	288	24733	13510	24733	13222	0.0	1.8705944637725003
chr1	KCNAB2	6085203	6086363	0	1161	24733	13510	24733	12349	0.0	2.002834237590088
chr1	ESPN	6448640	6449091	102	452	5713	6800	5611	6348	0.22566371681415928	0.8839004410838059
chr1	PER3	7829836	7830161	305	326	17971	7397	17666	7071	0.9355828220858896	2.498373638806392
chr1	TARDBP	11023192	11024183	0	992	102	4648	102	3656	0.0	0.027899343544857767
chr1	MFN2	11981809	11982114	5343	306	424359	10140	419016	9834	17.46078431372549	42.608907870652835
chr1	PLEKHM2	15727013	15727832	0	820	1471	4154	1471	3334	0.0	0.4412117576484703
chr1	NECAP2	16458841	16460077	455607	1237	1660932	4594	1205325	3357	368.31608730800326	359.0482573726542
chr1	SLC66A1	19312325	19312889	0	565	0	2695	0	2130	0.0	0.0
chr1	EPHB2	22913461	22921500	0	8040	378	11673	378	3633	0.0	0.10404624277456648
chr1	LYPLA2	23794223	23794600	0	378	134	1850	134	1472	0.0	0.09103260869565218
chr1	SRRM1	24652433	24652628	0	196	2729	5651	2729	5455	0.0	0.5002749770852429
chr1	SRRM1	24670119	24670315	510	197	2729	5651	2219	5454	2.5888324873096447	0.40685735240190685
chr1	ZNF593	26170417	26170873	459	457	604	734	145	277	1.0043763676148796	0.5234657039711191
chr1	ARID1A	26774328	26774901	6113	574	112352	12546	106239	11972	10.649825783972126	8.873955897093218
chr1	PIGV	26794112	26795234	5203	1123	806961	5866	801758	4743	4.633125556544969	169.04026987138943
chr1	PPP1R8	27850092	27851676	561	1585	561	2822	0	1237	0.35394321766561515	0.0
chr1	THEMIS2	27881970	27883043	662	1074	21416	2665	20754	1591	0.6163873370577281	13.044626021370208
chr1	PHACTR4	28496533	28500364	1479	3832	2745	7336	1266	3504	0.3859603340292276	0.3613013698630137
chr1	CCDC28B	32204597	32205387	23338	791	55471	2043	32133	1252	29.504424778761063	25.665335463258785
chr1	EIF3I	32221720	32222032	9556	313	21504	5731	11948	5418	30.53035143769968	2.2052417866371354
chr1	EIF3I	32228726	32229208	0	483	21504	5731	21504	5248	0.0	4.097560975609756
chr1	EIF3I	32230926	32231602	0	677	21504	5731	21504	5054	0.0	4.254847645429363
chr1	EIF3I	32228726	32231019	1104	2294	21504	5731	20400	3437	0.4812554489973845	5.935408786732616
chr1	LCK	32274736	32275083	0	348	51	3193	51	2845	0.0	0.017926186291739893
chr1	TEKT2	36087727	36088275	102	549	1528	1969	1426	1420	0.18579234972677597	1.004225352112676
chr1	MAP7D1	36176198	36176581	0	384	118084	4365	118084	3981	0.0	29.661893996483297
chr1	THRAP3	36303795	36305357	11010	1563	29510	4735	18500	3172	7.044145873320537	5.832282471626734
chr1	SH3D21	36321055	36321778	20581	724	83509	6435	62928	5711	28.426795580110497	11.018735773069515
chr1	LINC01685	38476192	38476484	0	293	1621	3681	1621	3388	0.0	0.4784533648170012
chr1	LINC01685	38474881	38475824	51	944	1621	3681	1570	2737	0.05402542372881356	0.5736207526488857
chr1	SZT2	43427529	43428118	0	590	31845	24016	31845	23426	0.0	1.3593870058908906
chr1	ARTN	43936068	43936346	0	279	0	2662	0	2383	0.0	0.0
chr1	ATP6V0B	43977025	43978295	0	1271	0	2433	0	1162	0.0	0.0
chr1	CCDC24	43993889	43995162	204	1274	88	2226	-116	952	0.16012558869701726	-0.12184873949579832
chr1	CCDC24	43995600	43995856	0	257	88	2226	88	1969	0.0	0.0446927374301676
chr1	AL139220.2	44050949	44051494	6207	546	64101	9671	57894	9125	11.368131868131869	6.34454794520548
chr1	KLF17	44129352	44130196	4693	845	123995	3164	119302	2319	5.553846153846154	51.445450625269515
chr1	DMAP1	44213470	44213858	102	389	3735	2653	3633	2264	0.2622107969151671	1.6046819787985867
chr1	ARMH1	44724319	44724668	714	350	21052	3290	20338	2940	2.04	6.917687074829932
chr1	MAST2	46032177	46032404	80177	228	316033	7806	235856	7578	351.6535087719298	31.12377936130905
chr1	MAST2	46032595	46032718	33669	124	316033	7806	282364	7682	271.5241935483871	36.75657380890393
chr1	DIO1	53904665	53904809	0	145	122	2265	122	2120	0.0	0.057547169811320756
chr1	DIO1	53894438	53894547	20	110	122	2265	102	2155	0.18181818181818182	0.047331786542923436
chr1	DIO1	53894188	53894547	122	360	122	2265	0	1905	0.3388888888888889	0.0
chr1	DIO1	53894210	53894547	122	338	122	2265	0	1927	0.3609467455621302	0.0
chr1	MROH7-TTC4	54731485	54731700	510	216	206565	7125	206055	6909	2.361111111111111	29.824142422926617
chr1	MIER1	66984571	66988619	102	4049	153	6542	51	2493	0.025191405285255618	0.02045728038507822
chr1	FPGT-TNNI3K	74370287	74375848	0	5562	0	9928	0	4366	0.0	0.0
chr1	NEXN	77942460	77943895	0	1436	17	4215	17	2779	0.0	0.0061173083843109035
chr1	LINC01140	87133613	87136669	0	3057	612	6060	612	3003	0.0	0.2037962037962038
chr1	BRDT	91949397	91949682	0	286	34576	4344	34576	4058	0.0	8.520453425332676
chr1	MTF2	93110229	93110428	0	200	755	5924	755	5724	0.0	0.1319007686932215
chr1	FNBP1L	93550946	93554659	5521	3714	2872	4512	-2649	798	1.4865374259558428	-3.319548872180451
chr1	LINC02790	95991976	95992509	0	534	0	2786	0	2252	0.0	0.0
chr1	LINC02790	95992009	95992509	0	501	0	2786	0	2285	0.0	0.0
chr1	LINC02790	95992025	95992509	0	485	0	2786	0	2301	0.0	0.0
chr1	AC118553.2	100078450	100080659	0	2210	0	5784	0	3574	0.0	0.0
chr1	TRMT13	100140407	100141019	0	613	4182	4144	4182	3531	0.0	1.1843670348343245
chr1	AC093157.1	101080388	101083574	204	3187	0	7130	-204	3943	0.06401004079071226	-0.05173725589652549
chr1	AC093157.1	101080886	101083574	204	2689	0	7130	-204	4441	0.0758646336928226	-0.045935600090069806
chr1	RNPC3	103525698	103526262	0	565	102	5469	102	4904	0.0	0.020799347471451877
chr1	LINC02785	108071483	108072697	0	1215	0	4139	0	2924	0.0	0.0
chr1	GPR61	109542421	109544639	663	2219	2587	3508	1924	1289	0.298783235691753	1.4926299456943366
chr1	CSF1	109923165	109924190	0	1026	102	5251	102	4225	0.0	0.024142011834319528
chr1	CEPT1	111182186	111182318	0	133	0	4458	0	4325	0.0	0.0
chr1	CHIAP2	111281550	111282475	0	926	0	2199	0	1273	0.0	0.0
chr1	NBPF26	120805555	120805765	0	211	41854	6817	41854	6606	0.0	6.335755373902513
chr1	NBPF26	120805417	120805765	0	349	41854	6817	41854	6468	0.0	6.470933828076685
chr1	LINC00623	120952438	120953460	0	1023	0	2606	0	1583	0.0	0.0
chr1	POLR3C	145826453	145826709	844	257	13602	4583	12758	4326	3.2840466926070038	2.9491447064262597
chr1	GNRHR2	145919343	145919900	298	558	2085	2338	1787	1780	0.5340501792114696	1.003932584269663
chr1	POLR3GL	145974824	145974991	0	168	0	1316	0	1148	0.0	0.0
chr1	LINC01719	146057693	146058461	3178	769	19342	2631	16164	1862	4.1326397919375815	8.680988184747584
chr1	NBPF12	146987953	146988126	0	174	0	7308	0	7134	0.0	0.0
chr1	CHD1L	147252622	147252735	0	114	51	4200	51	4086	0.0	0.012481644640234948
chr1	CHD1L	147254869	147254976	0	108	51	4200	51	4092	0.0	0.012463343108504398
chr1	CHD1L	147255812	147255927	0	116	51	4200	51	4084	0.0	0.01248775710088149
chr1	CHD1L	147264421	147264584	0	164	51	4200	51	4036	0.0	0.01263627353815659
chr1	CHD1L	147272170	147272630	0	461	51	4200	51	3739	0.0	0.013640010698047607
chr1	LINC02805	148162755	148163815	0	1061	32	5857	32	4796	0.0	0.006672226855713094
chr1	PDE4DIP	148991884	148993882	0	1999	2142	23819	2142	21820	0.0	0.09816681943171403
chr1	SNX27	151693423	151694484	0	1062	200518	16235	200518	15173	0.0	13.215448494035458
chr1	OAZ3	151767162	151767299	0	138	32072	4640	32072	4502	0.0	7.123944913371835
chr1	INTS3	153773192	153774808	561	1617	14048	9073	13487	7456	0.3469387755102041	1.808878755364807
chr1	INTS3	153772339	153772711	0	373	14048	9073	14048	8700	0.0	1.614712643678161
chr1	CREB3L4	153972743	153973078	0	336	336129	2539	336129	2203	0.0	152.57784838856105
chr1	AQP10	154323588	154325325	39657	1738	97881	2297	58224	559	22.817606444188723	104.15742397137745
chr1	TDRD10	154547408	154548147	2346	740	14018	2719	11672	1979	3.17027027027027	5.897928246589187
chr1	FLAD1	154992712	154993111	0	400	174719	3992	174719	3592	0.0	48.641146993318486
chr1	FLAD1	154990158	154990528	21945	371	174719	3992	152774	3621	59.15094339622642	42.19110742888705
chr1	SLC50A1	155138179	155138853	0	675	0	1885	0	1210	0.0	0.0
chr1	DAP3	155738156	155739010	1734	855	54517	4354	52783	3499	2.0280701754385966	15.085167190625894
chr1	LMNA	156114712	156115274	687	563	328592	7357	327905	6794	1.2202486678507993	48.26390933176332
chr1	LMNA	156137653	156138757	0	1105	328592	7357	328592	6252	0.0	52.557901471529114
chr1	LMNA	156135860	156136436	0	577	328592	7357	328592	6780	0.0	48.46489675516224
chr1	LMNA	156114710	156115274	699	565	328592	7357	327893	6792	1.2371681415929203	48.27635453474676
chr1	SEMA4A	156154549	156154717	0	169	24830	6084	24830	5915	0.0	4.197802197802198
chr1	TMEM79	156285183	156285983	19472	801	29172	3037	9700	2236	24.309612983770286	4.338103756708408
chr1	RHBG	156377989	156378399	0	411	0	3394	0	2983	0.0	0.0
chr1	RRNAD1	156731990	156732473	94	484	1224	2891	1130	2407	0.19421487603305784	0.4694640631491483
chr1	FCRL6	159808960	159809245	48	286	1731	2371	1683	2085	0.16783216783216784	0.8071942446043165
chr1	KLHDC9	161098360	161099062	3009	703	4498	1599	1489	896	4.2802275960170695	1.6618303571428572
chr1	PPOX	161170906	161171218	156	313	31353	4416	31197	4103	0.4984025559105431	7.603460882281258
chr1	PPOX	161170906	161171181	156	276	31353	4416	31197	4140	0.5652173913043478	7.535507246376811
chr1	NDUFS2	161213863	161214381	102	519	37441	7304	37339	6785	0.19653179190751446	5.503168754605748
chr1	NDUFS2	161212591	161213182	51	592	37441	7304	37390	6712	0.08614864864864864	5.57061978545888
chr1	NDUFS2	161213863	161214299	102	437	37441	7304	37339	6867	0.2334096109839817	5.437454492500364
chr1	NDUFS2	161213863	161214395	102	533	37441	7304	37339	6771	0.19136960600375236	5.514547334219466
chr1	FCGR2C	161589561	161589819	0	259	255	3594	255	3335	0.0	0.07646176911544228
chr1	LINC00626	168786753	168787228	0	476	0	1537	0	1061	0.0	0.0
chr1	FMO1	171281977	171283216	102	1240	3654	2776	3552	1536	0.08225806451612903	2.3125
chr1	FMO4	171341412	171342084	0	673	78	2552	78	1879	0.0	0.041511442256519426
chr1	CEP350	180110996	180113380	0	2385	4851	14304	4851	11919	0.0	0.4069972313113516
chr1	DHX9	182883138	182883368	0	231	38578	5929	38578	5698	0.0	6.770445770445771
chr1	IGFN1	201206082	201213621	233036	7540	315748	12141	82712	4601	30.906631299734748	17.97696153010215
chr1	ZC3H11A	203801574	203803016	10255	1443	25925	8033	15670	6590	7.106722106722107	2.377845220030349
chr1	ZC3H11A	203796450	203803016	69221	6567	25925	8033	-43296	1466	10.540733972894778	-29.53342428376535
chr1	ERLNC1	204141407	204142260	0	854	0	1534	0	680	0.0	0.0
chr1	CNTN2	205058180	205058663	4284	484	198164	14396	193880	13912	8.851239669421487	13.936170212765957
chr1	CNTN2	205073655	205074944	18476	1290	198164	14396	179688	13106	14.322480620155039	13.71036166641233
chr1	CDK18	205523146	205523625	0	480	102	5600	102	5120	0.0	0.019921875
chr1	MIR205HG	209428819	209429408	0	590	0	2601	0	2011	0.0	0.0
chr1	MIR205HG	209428822	209429408	0	587	0	2601	0	2014	0.0	0.0
chr1	ATF3	212615017	212615261	102	245	205563	3955	205461	3710	0.4163265306122449	55.38032345013477
chr1	ATF3	212615021	212615261	102	241	205563	3955	205461	3714	0.42323651452282157	55.32067851373183
chr1	ATF3	212619045	212619555	221653	511	205563	3955	-16090	3444	433.76320939334636	-4.671893147502904
chr1	VASH2	212951338	212951818	51	481	59048	8706	58997	8225	0.10602910602910603	7.172887537993921
chr1	PSEN2	226897719	226899555	0	1837	2692	12917	2692	11080	0.0	0.24296028880866427
chr1	AL118511.1	230874541	230875565	0	1025	0	1948	0	923	0.0	0.0
chr1	TBCE	235435744	235436608	459	865	14167	8049	13708	7184	0.530635838150289	1.908129175946548
chr1	TBCE	235436385	235436608	0	224	14167	8049	14167	7825	0.0	1.8104792332268371
chr1	FMN2	240334108	240334229	0	122	7	9266	7	9144	0.0	0.0007655293088363954
chr1	LINC01341	246790445	246792385	969	1941	5952	4672	4983	2731	0.4992272024729521	1.8246063712925669
chr1	AL732372.2	498398	498976	0	579	0	6130	0	5551	0.0	0.0
chr1	AL669831.3	764722	765247	0	526	1873	5509	1873	4983	0.0	0.3758779851495083
chr1	C1ORF159	1083914	1084383	0	470	510	4115	510	3645	0.0	0.13991769547325103
chr1	C1ORF159	1090352	1091374	1020	1023	510	4115	-510	3092	0.9970674486803519	-0.1649417852522639
chr1	CCNL2	1390229	1390371	0	143	97762	6208	97762	6065	0.0	16.11904369332234
chr1	CCNL2	1390765	1391575	42895	811	97762	6208	54867	5397	52.89149198520345	10.166203446359088
chr1	CDK11A	1722587	1722831	896	245	173055	4549	172159	4304	3.657142857142857	39.999767657992564
chr1	TMEM52	1918892	1919088	0	197	0	1347	0	1150	0.0	0.0
chr1	TMEM52	1919044	1919269	0	226	0	1347	0	1121	0.0	0.0
chr1	PRDM16-DT	3059616	3060283	0	668	0	4427	0	3759	0.0	0.0
chr1	PRDM16-DT	3060500	3061331	0	832	0	4427	0	3595	0.0	0.0
chr1	LINC01345	3947956	3949024	0	1069	0	1907	0	838	0.0	0.0
chr1	TNFRSF25	6462862	6463127	102	266	373	3596	271	3330	0.38345864661654133	0.08138138138138139
chr1	TNFRSF25	6462862	6463147	102	286	373	3596	271	3310	0.35664335664335667	0.08187311178247735
chr1	PLEKHG5	6467824	6468586	0	763	0	6625	0	5862	0.0	0.0
chr1	KLHL21	6590723	6595557	270050	4835	290044	6486	19994	1651	55.85315408479835	12.11023622047244
chr1	MAD2L2	11680352	11680613	0	262	0	2907	0	2645	0.0	0.0
chr1	MTHFR	11802880	11804532	4005	1653	73387	6734	69382	5081	2.422867513611615	13.65518598701043
chr1	MTHFR	11802880	11803526	2781	647	73387	6734	70606	6087	4.298299845440495	11.599474289469361
chr1	CROCCP3	16476929	16478437	38037	1509	63774	5234	25737	3725	25.206759443339962	6.909261744966443
chr1	CROCCP3	16491009	16491316	1765	308	63774	5234	62009	4926	5.73051948051948	12.588103938286642
chr1	MST1L	16758802	16759168	0	367	12020	5187	12020	4820	0.0	2.4937759336099585
chr1	ALDH4A1	18871429	18872957	0	1529	0	3649	0	2120	0.0	0.0
chr1	AKR7L	19270747	19270935	0	189	612	2775	612	2586	0.0	0.23665893271461716
chr1	RAP1GAP	21599493	21599617	0	125	2637	5400	2637	5275	0.0	0.4999052132701422
chr1	LACTBL1	22958684	22958920	0	237	0	1647	0	1410	0.0	0.0
chr1	RSRP1	25242248	25242705	0	458	0	5486	0	5028	0.0	0.0
chr1	RSRP1	25243549	25245301	0	1753	0	5486	0	3733	0.0	0.0
chr1	RSRP1	25242254	25242705	0	452	0	5486	0	5034	0.0	0.0
chr1	AL391650.1	26171616	26171821	804	206	1926	1644	1122	1438	3.9029126213592233	0.780250347705146
chr1	KDF1	26951341	26952412	51	1072	51	1859	0	787	0.04757462686567164	0.0
chr1	CD164L2	27379175	27380195	306	1021	816	1994	510	973	0.2997061704211557	0.5241521068859198
chr1	SNHG12	28579532	28580646	153	1115	255	3699	102	2584	0.13721973094170403	0.039473684210526314
chr1	SNHG12	28579532	28579981	153	450	255	3699	102	3249	0.34	0.03139427516158818
chr1	SNHG12	28580559	28581871	0	1313	255	3699	255	2386	0.0	0.10687342833193629
chr1	SNHG12	28580559	28581229	0	671	255	3699	255	3028	0.0	0.08421400264200793
chr1	MECR	29195940	29196258	0	319	202	4032	202	3713	0.0	0.05440344734715863
chr1	SDC3	30876551	30878740	0	2190	51	7073	51	4883	0.0	0.010444398935080893
chr1	TMEM234	32215135	32215795	0	661	9241	3451	9241	2790	0.0	3.3121863799283155
chr1	TMEM234	32216199	32216947	0	749	9241	3451	9241	2702	0.0	3.420059215396003
chr1	YARS1	32786361	32787075	927	715	130844	8638	129917	7923	1.2965034965034965	16.397450460684084
chr1	AK2	33007985	33013402	3111	5418	4217	7812	1106	2394	0.5741971207087486	0.4619883040935672
chr1	AK2	33012073	33013402	256	1330	4217	7812	3961	6482	0.1924812030075188	0.6110768281394632
chr1	STK40	36339623	36343448	0	3826	56769	5632	56769	1806	0.0	31.43355481727575
chr1	CSF3R	36466042	36466827	898	786	7031	8399	6133	7613	1.1424936386768447	0.8055956915801917
chr1	PPIEL	39547578	39548951	0	1374	5231	3504	5231	2130	0.0	2.455868544600939
chr1	PABPC4	39575758	39576790	2754	1033	6584	8427	3830	7394	2.6660212971926427	0.517987557479037
chr1	CLDN19	42733092	42736030	1146	2939	1561	3606	415	667	0.3899285471248724	0.6221889055472264
chr1	P3H1	42746374	42747412	0	1039	204	4271	204	3232	0.0	0.06311881188118812
chr1	MED8	43383916	43385106	0	1191	720	2710	720	1519	0.0	0.4739960500329164
chr1	SLC6A9	44000766	44001055	0	290	59419	5268	59419	4978	0.0	11.936319807151467
chr1	TCTEX1D4	44806783	44807351	204	569	1264	1357	1060	788	0.3585237258347979	1.3451776649746192
chr1	MUTYH	45331660	45332086	306	427	57316	5148	57010	4721	0.7166276346604216	12.07583139165431
chr1	POMGNT1	46188682	46189357	204	676	5676	5476	5472	4800	0.30177514792899407	1.14
chr1	LRRC41	46278400	46279084	102	685	3843	7322	3741	6637	0.14890510948905109	0.5636582793430767
chr1	LRRC41	46279181	46279614	0	434	3843	7322	3843	6888	0.0	0.5579268292682927
chr1	STIL	47299904	47300152	0	249	0	6600	0	6351	0.0	0.0
chr1	CALR4P	51567173	51567843	0	671	408	2713	408	2042	0.0	0.19980411361410383
chr1	TXNDC12	52020130	52021012	0	883	0	2873	0	1990	0.0	0.0
chr1	LRP8	53245544	53247056	5788	1513	79251	13559	73463	12046	3.8255122273628555	6.098538934086004
chr1	LRP8	53245546	53247056	5756	1511	79251	13559	73495	12048	3.8093977498345466	6.100182602921647
chr1	MYSM1	58661405	58663522	0	2118	51	13140	51	11022	0.0	0.004627109417528579
chr1	HSD52	59132472	59133330	14053	859	16526	6497	2473	5638	16.359720605355065	0.43863072011351545
chr1	LINC01748	60595537	60596373	0	837	0	15481	0	14644	0.0	0.0
chr1	NFIA-AS2	60952510	60954370	0	1861	0	5402	0	3541	0.0	0.0
chr1	LINC00466	63261741	63262700	342	960	2776	6950	2434	5990	0.35625	0.4063439065108514
chr1	LINC01359	64979576	64979868	0	293	0	5118	0	4825	0.0	0.0
chr1	DEPDC1	68489451	68489608	0	158	0	5916	0	5758	0.0	0.0
chr1	ADGRL4	78889763	78891216	0	1454	6644	5737	6644	4283	0.0	1.5512491244454822
chr1	ZNHIT6	85707628	85708433	0	806	255	6213	255	5407	0.0	0.04716108747919364
chr1	COL24A1	86156340	86156772	0	433	163098	9632	163098	9199	0.0	17.729970648983585
chr1	SELENOF	86880661	86880725	0	65	0	2208	0	2143	0.0	0.0
chr1	GBP2	89106131	89108291	0	2161	730	7237	730	5076	0.0	0.1438140267927502
chr1	LINC02609	90835825	90836174	0	350	51	14100	51	13750	0.0	0.0037090909090909093
chr1	CCDC18-AS1	93337376	93339274	0	1899	32571	4958	32571	3059	0.0	10.647597254004577
chr1	SLC44A3-AS1	94622718	94624609	0	1892	9674	10264	9674	8372	0.0	1.1555183946488294
chr1	COL11A1	103001259	103001969	0	711	245	8948	245	8237	0.0	0.02974383877625349
chr1	LINC01677	105952503	105953712	0	1210	0	3134	0	1924	0.0	0.0
chr1	CLCC1	108962308	108963453	256	1146	2556	6514	2300	5368	0.22338568935427575	0.4284649776453055
chr1	PSRC1	109280776	109281251	153	476	153	2373	0	1897	0.32142857142857145	0.0
chr1	PSRC1	109282679	109283122	0	444	153	2373	153	1929	0.0	0.07931570762052877
chr1	KCNA2	110593579	110602170	358777	8592	422749	18742	63972	10150	41.75709962756052	6.302660098522168
chr1	KCNA2	110593579	110604106	388947	10528	422749	18742	33802	8214	36.94405395136778	4.115169223277332
chr1	PPM1J	112712743	112713031	0	289	0	2461	0	2172	0.0	0.0
chr1	TRIM45	117111059	117112453	0	1395	10558	4375	10558	2980	0.0	3.5429530201342283
chr1	PIAS3	145856588	145857006	0	419	0	4092	0	3673	0.0	0.0
chr1	FMO5	147224894	147225339	0	446	0	5996	0	5550	0.0	0.0
chr1	AC239809.3	148226493	148226798	0	306	81262	14907	81262	14601	0.0	5.565509211697829
chr1	NBPF14	148595542	148595752	18378	211	175958	12061	157580	11850	87.0995260663507	13.29789029535865
chr1	NBPF14	148595542	148595890	45102	349	175958	12061	130856	11712	129.23209169054442	11.172814207650273
chr1	NBPF9	149081964	149082311	0	348	298	8033	298	7685	0.0	0.03877683799609629
chr1	TDRKH	151774412	151774504	0	93	1029	4678	1029	4585	0.0	0.22442748091603054
chr1	TDRKH	151773493	151774504	0	1012	1029	4678	1029	3666	0.0	0.2806873977086743
chr1	AL162258.1	153632033	153632240	8336	208	68719	1002	60383	794	40.07692307692308	76.04911838790932
chr1	JTB	153976692	153977013	51	322	102	1486	51	1164	0.15838509316770186	0.04381443298969072
chr1	SHE	154479480	154486062	204	6583	204	7140	0	557	0.030988910830928147	0.0
chr1	ADAR	154601040	154602626	204	1587	16562	9646	16358	8059	0.1285444234404537	2.029780369772925
chr1	GBAP1	155215562	155215787	264	226	270301	3205	270037	2979	1.168141592920354	90.64686136287345
chr1	GBAP1	155216383	155217029	20074	647	270301	3205	250227	2558	31.026275115919628	97.82134480062548
chr1	GBAP1	155217239	155218049	240598	811	270301	3205	29703	2394	296.66831072749693	12.407268170426065
chr1	GON4L	155764999	155766709	0	1711	82462	11036	82462	9325	0.0	8.843109919571045
chr1	KHDC4	155913044	155915964	7095	2921	295377	5660	288282	2739	2.4289626840123244	105.25082146768894
chr1	ARHGEF2	155950828	155951272	6860	445	746488	8670	739628	8225	15.415730337078651	89.92437689969604
chr1	PAQR6	156245781	156246250	36	470	18459	2498	18423	2028	0.07659574468085106	9.084319526627219
chr1	IQGAP3	156525404	156526599	32096	1196	585588	6779	553492	5583	26.836120401337794	99.13881425756762
chr1	HDGF	156742109	156743455	612	1347	29850	3683	29238	2336	0.45434298440979953	12.51626712328767
chr1	FCRL3	157676480	157678856	0	2377	13585	5345	13585	2968	0.0	4.577156334231806
chr1	LINC01704	158132039	158132656	0	618	12291	2018	12291	1400	0.0	8.779285714285715
chr1	LINC01704	158132045	158133193	0	1149	12291	2018	12291	869	0.0	14.143843498273878
chr1	AIM2	159065909	159066329	0	421	0	1885	0	1464	0.0	0.0
chr1	SNHG28	159837916	159840866	0	2951	1229	3025	1229	74	0.0	16.60810810810811
chr1	SNHG28	159838364	159840866	0	2503	1229	3025	1229	522	0.0	2.3544061302681993
chr1	SNHG28	159834501	159840866	6926	6366	1229	3025	-5697	-3341	1.0879673264216148	1.7051780903920981
chr1	SNHG28	159834522	159836155	857	1634	1229	3025	372	1391	0.5244798041615667	0.2674335010783609
chr1	SNHG28	159834526	159836155	853	1630	1229	3025	376	1395	0.5233128834355828	0.26953405017921145
chr1	SNHG28	159837916	159841235	0	3320	1229	3025	1229	-295	0.0	-4.1661016949152545
chr1	SNHG28	159837916	159840881	0	2966	1229	3025	1229	59	0.0	20.83050847457627
chr1	TSTD1	161037630	161038075	0	446	0	1199	0	753	0.0	0.0
chr1	DEDD	161124137	161124526	0	390	98266	2740	98266	2350	0.0	41.81531914893617
chr1	NR1I3	161230812	161231245	0	434	0	2001	0	1567	0.0	0.0
chr1	MPZ	161304734	161305977	1938	1244	1938	2155	0	911	1.5578778135048232	0.0
chr1	CD247	167430639	167431746	0	1108	51	2720	51	1612	0.0	0.03163771712158809
chr1	GAS5	173864483	173864704	1359	222	12941	4337	11582	4115	6.121621621621622	2.814580801944107
chr1	GAS5	173863900	173864304	504	405	12941	4337	12437	3932	1.2444444444444445	3.163021363173957
chr1	GAS5	173864256	173864704	1879	449	12941	4337	11062	3888	4.184855233853007	2.845164609053498
chr1	GAS5	173864256	173865282	3532	1027	12941	4337	9409	3310	3.439143135345667	2.8425981873111783
chr1	GAS5	173866527	173866796	219	270	12941	4337	12722	4067	0.8111111111111111	3.128104253749693
chr1	GAS5	173865228	173865547	306	320	12941	4337	12635	4017	0.95625	3.1453821259646504
chr1	GAS5	173864256	173864506	664	251	12941	4337	12277	4086	2.645418326693227	3.004650024473813
chr1	GAS5	173865856	173866206	1173	351	12941	4337	11768	3986	3.341880341880342	2.9523331660812846
chr1	CRYZL2P-SEC16B	177958839	177960939	102	2101	756	6507	654	4406	0.04854831032841504	0.1484339536995007
chr1	ABL2	179107717	179109441	1275	1725	14292	11979	13017	10254	0.7391304347826086	1.2694558221181977
chr1	LINC01344	182127296	182127927	0	632	3	6690	3	6058	0.0	0.0004952129415648729
chr1	MIR181A1HG	198897809	198900569	0	2761	0	5396	0	2635	0.0	0.0
chr1	TNNT2	201372026	201372155	0	130	0	5980	0	5850	0.0	0.0
chr1	LMOD1	201899236	201900751	255	1516	306	3970	51	2454	0.16820580474934038	0.02078239608801956
chr1	LINC00303	204036968	204037588	0	621	102	1992	102	1371	0.0	0.07439824945295405
chr1	PIK3C2B	204445955	204446144	63	190	22287	9450	22224	9260	0.33157894736842103	2.4
chr1	KLHDC8A	205343228	205343793	0	566	0	3675	0	3109	0.0	0.0
chr1	SLC26A9	205913053	205915404	0	2352	0	5649	0	3297	0.0	0.0
chr1	RAB7B	205976740	205978928	0	2189	0	3692	0	1503	0.0	0.0
chr1	PROX1-AS1	213915934	213916099	0	166	23	9778	23	9612	0.0	0.00239284228048273
chr1	LINC02817	221332155	221333985	0	1831	0	2451	0	620	0.0	0.0
chr1	PYCR2	225922203	225922383	0	181	3479	3483	3479	3302	0.0	1.053603876438522
chr1	LEFTY2	225939755	225940002	0	248	51	2290	51	2042	0.0	0.02497551420176298
chr1	MRPL55	228108436	228109021	1530	586	6030	1672	4500	1086	2.6109215017064846	4.143646408839779
chr1	MRPL55	228108436	228109016	1530	581	6030	1672	4500	1091	2.6333907056798624	4.124656278643446
chr1	MRPL55	228108436	228109031	1530	596	6030	1672	4500	1076	2.5671140939597317	4.182156133828996
chr1	C1ORF131	231223762	231225523	0	1762	28	3253	28	1491	0.0	0.018779342723004695
chr1	PCNX2	232984135	232986540	0	2406	3144	12393	3144	9987	0.0	0.31480925202763593
chr1	LINC01354	234531015	234531792	1326	778	62223	3246	60897	2468	1.7043701799485862	24.674635332252837
chr1	LINC01139	238485784	238486044	0	261	0	1865	0	1604	0.0	0.0
chr1	LINC01347	243087709	243088232	0	524	0	3859	0	3335	0.0	0.0
chr1	CEP170	243185778	243186422	0	645	725	8930	725	8285	0.0	0.08750754375377187
chr1	OR2B11	247449117	247455064	2856	5948	2825	6226	-31	278	0.4801613987895091	-0.11151079136690648
chr1	ZNF692	248855557	248855946	0	390	51	3751	51	3361	0.0	0.01517405534067242
chr2	MYT1L	1789146	1792464	0	3319	51	31707	51	28388	0.0	0.0017965337466535156
chr2	MYT1L	1789168	1792007	0	2840	51	31707	51	28867	0.0	0.0017667232479994458
chr2	MYT1L	1789313	1792464	0	3152	51	31707	51	28555	0.0	0.0017860269655051654
chr2	LINC01304	3959563	3960556	0	994	51	6379	51	5385	0.0	0.00947075208913649
chr2	MIR7515HG	6617201	6618315	0	1115	11358	7267	11358	6152	0.0	1.846228868660598
chr2	GRASLND	6915822	6917224	0	1403	255	4549	255	3146	0.0	0.0810553083280356
chr2	ID2-AS1	8675743	8676029	0	287	51	6592	51	6305	0.0	0.00808881839809675
chr2	ITGB1BP1	9406660	9407598	0	939	918	6364	918	5425	0.0	0.16921658986175114
chr2	AC064875.1	13002423	13003951	0	1529	9203	4174	9203	2645	0.0	3.4793950850661624
chr2	AC104623.2	16541689	16545695	0	4007	0	4007	0	0	0.0	0.0
chr2	NT5C1B	18584513	18584978	0	466	0	3862	0	3396	0.0	0.0
chr2	LDAH	20685546	20687094	0	1549	3129	3421	3129	1872	0.0	1.671474358974359
chr2	ADCY3	24918312	24919839	408	1528	295	5388	-113	3860	0.2670157068062827	-0.02927461139896373
chr2	HADHA	26190654	26191628	0	975	6309	4348	6309	3373	0.0	1.8704417432552625
chr2	OTOF	26477648	26478042	1577	395	208348	8072	206771	7677	3.992405063291139	26.933828318353523
chr2	OST4	27071325	27071649	0	325	0	602	0	277	0.0	0.0
chr2	EIF2B4	27367745	27367822	0	78	102	2597	102	2519	0.0	0.040492258832870186
chr2	EIF2B4	27369875	27369919	0	45	102	2597	102	2552	0.0	0.039968652037617555
chr2	IFT172	27457840	27458223	43807	384	648389	12448	604582	12064	114.08072916666667	50.11455570291777
chr2	IFT172	27449293	27449562	38647	270	648389	12448	609742	12178	143.13703703703703	50.06914107406799
chr2	IFT172	27453981	27454418	31709	438	648389	12448	616680	12010	72.39497716894977	51.347210657785176
chr2	IFT172	27458778	27459522	79838	745	648389	12448	568551	11703	107.16510067114093	48.581645731863624
chr2	IFT172	27453629	27454418	32219	790	648389	12448	616170	11658	40.78354430379747	52.853834276891405
chr2	SUPT7L	27660983	27662281	6470	1299	239208	5317	232738	4018	4.9807544264819095	57.923842707814835
chr2	HNRNPLL	38602437	38603036	613	600	5555	5109	4942	4509	1.0216666666666667	1.0960301618984254
chr2	SRSF7	38748578	38749705	0	1128	0	3873	0	2745	0.0	0.0
chr2	CDKL4	39178546	39179321	0	776	16109	2083	16109	1307	0.0	12.325172149961745
chr2	LINC01819	43028913	43029897	102	985	318	3848	216	2863	0.10355329949238579	0.07544533705902899
chr2	LINC01819	43032733	43033526	51	794	318	3848	267	3054	0.06423173803526448	0.08742632612966601
chr2	CCDC88A	55295596	55296056	0	461	3693	27139	3693	26678	0.0	0.13842866781617813
chr2	CCDC88A	55290654	55291775	0	1122	3693	27139	3693	26017	0.0	0.14194565092055195
chr2	PNPT1	55680711	55680918	0	208	2266	4809	2266	4601	0.0	0.4925016300804173
chr2	EFEMP1	55922359	55922691	0	333	2254	3973	2254	3640	0.0	0.6192307692307693
chr2	EFEMP1	55922359	55922747	0	389	2254	3973	2254	3584	0.0	0.62890625
chr2	BCL11A	60460681	60462424	0	1744	0	10714	0	8970	0.0	0.0
chr2	XPO1	61498672	61498913	0	242	13238	18326	13238	18084	0.0	0.7320283123202831
chr2	XPO1	61537561	61538356	0	796	13238	18326	13238	17530	0.0	0.7551625784369652
chr2	XPO1	61537561	61538231	0	671	13238	18326	13238	17655	0.0	0.7498159161710564
chr2	PCBP1-AS1	69996685	69996888	0	204	234223	25966	234223	25762	0.0	9.091801878736122
chr2	PCBP1-AS1	70085815	70086273	27	459	234223	25966	234196	25507	0.058823529411764705	9.181636413533539
chr2	PCBP1-AS1	70048706	70051305	4083	2600	234223	25966	230140	23366	1.5703846153846155	9.84935376187623
chr2	PCBP1-AS1	70049195	70051305	3987	2111	234223	25966	230236	23855	1.8886783514921839	9.651477677635716
chr2	PCBP1-AS1	70049201	70051305	3981	2105	234223	25966	230242	23861	1.8912114014251782	9.649302208624952
chr2	DCTN1	74366243	74366620	0	378	331815	9854	331815	9476	0.0	35.01635711270578
chr2	MOGS	74463189	74463386	280	198	714	3170	434	2972	1.4141414141414141	0.14602960969044415
chr2	MOGS	74464895	74465400	0	506	714	3170	714	2664	0.0	0.268018018018018
chr2	REG3A	79159329	79159753	0	425	0	1083	0	658	0.0	0.0
chr2	TGOLN2	85326507	85327685	102	1179	255	6949	153	5770	0.08651399491094147	0.026516464471403812
chr2	CAPG	85401528	85401683	0	156	584	2163	584	2007	0.0	0.2909815645241654
chr2	ST3GAL5	85847860	85848204	75	345	273942	15937	273867	15592	0.21739130434782608	17.56458440225757
chr2	RNF103	86622660	86623865	0	1206	0	6400	0	5194	0.0	0.0
chr2	LINC00342	95813315	95813957	28535	643	131006	7663	102471	7020	44.37791601866252	14.597008547008548
chr2	AC092683.1	97422438	97422659	0	222	62322	5579	62322	5357	0.0	11.633750233339557
chr2	LINC02611	98771618	98772142	0	525	0	3496	0	2971	0.0	0.0
chr2	MITD1	99169262	99169610	9517	349	18280	2343	8763	1994	27.269340974212035	4.394684052156469
chr2	REV1	99402243	99402800	0	558	6694	7767	6694	7209	0.0	0.9285615203218199
chr2	PANTR1	104807584	104812618	0	5035	0	9147	0	4112	0.0	0.0
chr2	AC010978.1	105856669	105857177	0	509	108	1458	108	949	0.0	0.11380400421496312
chr2	EDAR	108910775	108911072	0	298	0	4438	0	4140	0.0	0.0
chr2	NPHP1	110163047	110164730	0	1684	0	12937	0	11253	0.0	0.0
chr2	AC112229.1	110423660	110424142	0	483	15	2891	15	2408	0.0	0.006229235880398671
chr2	MIR4435-2HG	111365560	111367575	0	2016	40775	26838	40775	24822	0.0	1.6426959954878737
chr2	ZC3H8	112230902	112230950	0	49	7407	6384	7407	6335	0.0	1.1692186266771902
chr2	AC079922.2	112642082	112643293	1574	1212	5291	2394	3717	1182	1.2986798679867986	3.1446700507614214
chr2	CKAP2L	112755976	112757214	0	1239	1216	4835	1216	3596	0.0	0.3381535038932147
chr2	POTEI	130465651	130465772	0	122	0	6863	0	6741	0.0	0.0
chr2	CACNB4	151869176	151870611	0	1436	102	14196	102	12760	0.0	0.00799373040752351
chr2	NR4A2	156326149	156326328	51	180	153	3973	102	3793	0.2833333333333333	0.026891642499340892
chr2	BAZ2B	159404848	159404910	42	63	26477	18526	26435	18463	0.6666666666666666	1.4317824838866924
chr2	PLA2R1	159932005	159941992	510	9988	13027	15392	12517	5404	0.05106127352823388	2.3162472242783125
chr2	ITGB6	160200002	160200304	0	303	1279	3902	1279	3599	0.0	0.35537649347040845
chr2	SCN1A	165989159	165994416	255	5258	459	18837	204	13579	0.04849752757702548	0.015023197584505486
chr2	METTL5	169824488	169824905	0	418	0	2425	0	2007	0.0	0.0
chr2	MYO3B-AS1	170344798	170345132	51	335	24581	5707	24530	5372	0.15223880597014924	4.566269545793001
chr2	MYO3B-AS1	170344798	170345215	51	418	24581	5707	24530	5289	0.12200956937799043	4.637927774626584
chr2	AC073636.1	176844837	176846377	51	1541	1225	3276	1174	1735	0.03309539260220636	0.676657060518732
chr2	AC073636.1	176844840	176846377	51	1538	1225	3276	1174	1738	0.03315994798439532	0.6754890678941312
chr2	ZNF385B	179441981	179443468	418	1488	1337	5441	919	3953	0.28091397849462363	0.2324816594991146
chr2	OSGEPL1	189761419	189761660	0	242	0	3437	0	3195	0.0	0.0
chr2	ORMDL1	189782421	189783123	0	703	0	4012	0	3309	0.0	0.0
chr2	SF3B1	197418895	197420542	0	1648	306	10241	306	8593	0.0	0.035610380542301874
chr2	SF3B1	197418795	197420542	0	1748	306	10241	306	8493	0.0	0.03602967149417167
chr2	CFLAR-AS1	201148733	201149200	0	468	51	4158	51	3690	0.0	0.013821138211382113
chr2	FN1	215371908	215372375	0	468	51	13933	51	13465	0.0	0.003787597474935017
chr2	FN1	215371908	215372300	0	393	51	13933	51	13540	0.0	0.0037666174298375183
chr2	CFAP65	219029402	219030208	0	807	315	10236	315	9429	0.0	0.0334075723830735
chr2	CNPPD1	219174777	219175108	51	332	204	2728	153	2396	0.1536144578313253	0.06385642737896494
chr2	CUL3	224503651	224503822	0	172	10453	10494	10453	10322	0.0	1.0126913388878125
chr2	MFF-DT	227264668	227268769	1020	4102	102	11480	-918	7378	0.24865919063871283	-0.12442396313364056
chr2	MFF-DT	227265874	227268769	1020	2896	102	11480	-918	8584	0.35220994475138123	-0.10694315004659832
chr2	SLC19A3	227702168	227702691	6837	524	32721	5687	25884	5163	13.047709923664122	5.013364323067984
chr2	NDUFA10	240011616	240014860	9820	3245	53071	18589	43251	15344	3.026194144838213	2.8187565172054225
chr2	ANKMY1	240523884	240524381	0	498	0	7366	0	6868	0.0	0.0
chr2	HDLBP	241268953	241269295	0	343	6	11245	6	10902	0.0	0.000550357732526142
chr2	STK25	241508005	241508362	9960	358	35268	5262	25308	4904	27.821229050279328	5.16068515497553
chr2	RPS7	3575324	3575684	0	361	11115	1880	11115	1519	0.0	7.3173140223831465
chr2	RPS7	3575357	3575684	0	328	11115	1880	11115	1552	0.0	7.161726804123711
chr2	AC013460.1	7428542	7429872	0	1331	0	5222	0	3891	0.0	0.0
chr2	MIR3681HG	12131305	12131585	0	281	102	8436	102	8155	0.0	0.012507664009809932
chr2	DDX1	15628444	15628839	0	396	1760	8850	1760	8454	0.0	0.2081854743316773
chr2	DDX1	15627053	15628710	0	1658	1760	8850	1760	7192	0.0	0.2447163515016685
chr2	DDX1	15628444	15628710	0	267	1760	8850	1760	8583	0.0	0.20505650704881742
chr2	DDX1	15628637	15628839	0	203	1760	8850	1760	8647	0.0	0.20353879958367063
chr2	DDX1	15627053	15628839	0	1787	1760	8850	1760	7063	0.0	0.2491858983434801
chr2	LINC00954	19881566	19882260	0	695	0	6418	0	5723	0.0	0.0
chr2	LINC01884	22537004	22538291	0	1288	0	1354	0	66	0.0	0.0
chr2	TMEM214	27040710	27041694	0	985	0	4115	0	3130	0.0	0.0
chr2	CAD	27242619	27242973	357	355	723	8190	366	7835	1.0056338028169014	0.04671346522016592
chr2	LINC01936	30349936	30352431	0	2496	0	4654	0	2158	0.0	0.0
chr2	LINC00486	32928031	32928405	0	375	1871	7058	1871	6683	0.0	0.2799640879844381
chr2	LINC01913	41876762	41877778	0	1017	51	5091	51	4074	0.0	0.012518409425625921
chr2	AHSA2P	61185501	61186497	0	997	1275	8068	1275	7071	0.0	0.18031395842172254
chr2	UGP2	63885588	63885886	0	299	0	6812	0	6513	0.0	0.0
chr2	AC012368.1	64251118	64251834	0	717	10426	7851	10426	7134	0.0	1.461452200728904
chr2	AC007389.1	65732892	65733389	0	498	2316	12371	2316	11873	0.0	0.19506443190432074
chr2	TTC31	74490655	74491184	0	530	289	4040	289	3510	0.0	0.08233618233618234
chr2	TTC31	74492138	74492445	0	308	289	4040	289	3732	0.0	0.07743837084673097
chr2	ELMOD3	85355075	85357252	0	2178	153	6400	153	4222	0.0	0.03623874940786357
chr2	ELMOD3	85390137	85391748	0	1612	153	6400	153	4788	0.0	0.03195488721804511
chr2	ELMOD3	85371085	85371562	0	478	153	6400	153	5922	0.0	0.025835866261398176
chr2	SH2D6	85436465	85437029	0	565	51	2703	51	2138	0.0	0.023854069223573433
chr2	USP39	85648760	85649280	192	521	28552	3963	28360	3442	0.3685220729366603	8.239395700174317
chr2	KDM3A	86477876	86478265	0	390	10373	8754	10373	8364	0.0	1.2401960784313726
chr2	KDM3A	86478607	86480362	449	1756	10373	8754	9924	6998	0.25569476082004555	1.4181194627036295
chr2	KDM3A	86482457	86484158	0	1702	10373	8754	10373	7052	0.0	1.4709302325581395
chr2	KDM3A	86489519	86491057	0	1539	10373	8754	10373	7215	0.0	1.4376992376992377
chr2	ANKRD36BP2	88804379	88804880	0	502	68	4231	68	3729	0.0	0.018235451863770447
chr2	GPAT2P1	95796488	95797160	673	673	1650	2259	977	1586	1.0	0.6160151324085751
chr2	AC159540.2	97285302	97285523	9818	222	21131	1980	11313	1758	44.22522522522522	6.435153583617748
chr2	AC159540.2	97284877	97285523	29089	647	21131	1980	-7958	1333	44.95981452859351	-5.969992498124531
chr2	RPL31	101002292	101002808	696	517	9351	3899	8655	3382	1.3462282398452612	2.559136605558841
chr2	LINC01102	104505865	104507406	0	1542	0	7010	0	5468	0.0	0.0
chr2	LINC01102	104518058	104518401	0	344	0	7010	0	6666	0.0	0.0
chr2	LINC01102	104506590	104507406	0	817	0	7010	0	6193	0.0	0.0
chr2	C2ORF49	105342847	105343223	0	377	0	4599	0	4222	0.0	0.0
chr2	AC013268.1	109947363	109947845	0	483	260	3474	260	2991	0.0	0.08692744901370779
chr2	BCL2L11	111123732	111124139	0	408	24	6670	24	6262	0.0	0.0038326413286489938
chr2	BCL2L11	111123745	111124139	0	395	24	6670	24	6275	0.0	0.0038247011952191236
chr2	MERTK	111997322	111997476	1303	155	10793	4566	9490	4411	8.406451612903226	2.151439582861029
chr2	CHCHD5	112585973	112586365	153	393	4951	1263	4798	870	0.3893129770992366	5.514942528735633
chr2	PAX8-AS1	113255389	113259584	45180	4196	54157	13369	8977	9173	10.767397521448999	0.9786329445110651
chr2	FAM138B	113577981	113578852	0	872	0	1234	0	362	0.0	0.0
chr2	WASH2P	113595692	113596203	0	512	0	2827	0	2315	0.0	0.0
chr2	GLI2	120988207	120991380	51	3174	36197	7685	36146	4511	0.01606805293005671	8.012857459543339
chr2	PROC	127423033	127423408	29	376	2547	2498	2518	2122	0.07712765957446809	1.1866163996229973
chr2	POTEE	131261725	131261846	0	122	102	4207	102	4085	0.0	0.024969400244798042
chr2	UBXN4	135753538	135754277	0	740	51	4422	51	3682	0.0	0.013851167843563281
chr2	LINC02631	138601617	138602441	0	825	0	2371	0	1546	0.0	0.0
chr2	LINC02612	150634635	150635356	0	722	0	3285	0	2563	0.0	0.0
chr2	LINC02612	150634635	150635344	0	710	0	3285	0	2575	0.0	0.0
chr2	SCN2A	165326851	165328538	0	1688	0	23956	0	22268	0.0	0.0
chr2	SCN1A-AS1	166248194	166249384	0	1191	0	18935	0	17744	0.0	0.0
chr2	AC007405.3	170776502	170777425	0	924	4593	2602	4593	1678	0.0	2.7371871275327773
chr2	HNRNPA3	177219246	177221976	0	2731	132	6245	132	3514	0.0	0.037564029595902104
chr2	CHROMR	178426365	178430889	51	4525	11271	7002	11220	2477	0.011270718232044199	4.529672991522002
chr2	TTN-AS1	178537360	178537691	0	332	51	21966	51	21634	0.0	0.002357400388277711
chr2	TTN-AS1	178774226	178778755	0	4530	51	21966	51	17436	0.0	0.0029249827942188574
chr2	TTN-AS1	178777857	178778755	0	899	51	21966	51	21067	0.0	0.0024208477713960224
chr2	FAM171B	186747091	186747250	0	160	0	5739	0	5579	0.0	0.0
chr2	NABP1	191685598	191696662	102	11065	924	17438	822	6373	0.009218255761409852	0.12898164129923112
chr2	SLC39A10	195680031	195681050	0	1020	0	6933	0	5913	0.0	0.0
chr2	CCDC150	196729192	196729861	0	670	51	9384	51	8714	0.0	0.0058526509065871014
chr2	HSPE1	197503038	197503381	1053	344	284	1592	-769	1248	3.061046511627907	-0.6161858974358975
chr2	LINC01877	199629063	199631895	0	2833	722	9864	722	7031	0.0	0.10268809557673161
chr2	LINC01877	199629924	199631895	0	1972	722	9864	722	7892	0.0	0.09148504815002534
chr2	LINC01877	199630245	199631895	0	1651	722	9864	722	8213	0.0	0.0879094119079508
chr2	NIF3L1	200891735	200892379	0	645	112	2001	112	1356	0.0	0.08259587020648967
chr2	NRP2	205682500	205683363	0	864	51	13919	51	13055	0.0	0.0039065492148602065
chr2	TMEM169	216081918	216082232	0	315	0	3631	0	3316	0.0	0.0
chr2	RPL37A	216499085	216499398	0	314	0	5245	0	4931	0.0	0.0
chr2	PLCD4	218636470	218637173	0	704	0	5717	0	5013	0.0	0.0
chr2	ZFAND2B	219208255	219208486	3130	232	12355	2754	9225	2522	13.491379310344827	3.6578112609040443
chr2	GMPPA	219505457	219505761	1761	305	47477	3037	45716	2732	5.773770491803279	16.733528550512446
chr2	GMPPA	219506253	219506422	72	170	47477	3037	47405	2867	0.4235294117647059	16.534705266829437
chr2	AC009950.1	230172098	230172515	0	418	102	5424	102	5006	0.0	0.02037554934079105
chr2	PPP1R7	241182646	241183652	0	1007	0	3700	0	2693	0.0	0.0
chr2	FARP2	241494007	241494840	4615	834	24600	13898	19985	13064	5.53357314148681	1.5297764849969382
chr3	SETMAR	4312897	4313761	0	865	255	3571	255	2706	0.0	0.0942350332594235
chr3	BRPF1	9745572	9745930	0	359	180397	6082	180397	5723	0.0	31.521404857592174
chr3	OGG1	9756766	9757191	0	426	35008	7070	35008	6644	0.0	5.269114990969296
chr3	TTLL3	9826996	9827240	94404	245	362171	7028	267767	6783	385.32244897959185	39.476190476190474
chr3	TTLL3	9834680	9835404	29640	725	362171	7028	332531	6303	40.88275862068966	52.75757575757576
chr3	CRELD1	9933833	9934612	8995	780	156318	3805	147323	3025	11.532051282051283	48.70181818181818
chr3	TSEN2	12503261	12503784	0	524	54797	4706	54797	4182	0.0	13.103060736489718
chr3	KCNH8	19450105	19451404	0	1300	0	6105	0	4805	0.0	0.0
chr3	SGO1-AS1	20345659	20346066	0	408	2971	6600	2971	6192	0.0	0.479812661498708
chr3	OXSM	25790989	25791997	4180	1009	8825	2429	4645	1420	4.142715559960357	3.2711267605633805
chr3	LINC01980	27797556	27797911	0	356	0	4756	0	4400	0.0	0.0
chr3	LINC01980	27802113	27802850	0	738	0	4756	0	4018	0.0	0.0
chr3	LINC01980	27797568	27797911	0	344	0	4756	0	4412	0.0	0.0
chr3	LINC01980	27797574	27797911	0	338	0	4756	0	4418	0.0	0.0
chr3	C3ORF35	37417018	37418101	2703	1084	9485	7262	6782	6178	2.493542435424354	1.0977662674004531
chr3	CTNNB1	41224953	41225207	0	255	556	9254	556	8999	0.0	0.061784642738082006
chr3	CTNNB1	41239133	41239900	46	768	556	9254	510	8486	0.059895833333333336	0.06009898656610888
chr3	CTNNB1	41239133	41239971	46	839	556	9254	510	8415	0.054827175208581644	0.06060606060606061
chr3	CTNNB1	41239133	41239947	46	815	556	9254	510	8439	0.05644171779141104	0.06043370067543548
chr3	CTNNB1	41239133	41239955	46	823	556	9254	510	8431	0.05589307411907655	0.060491044953149095
chr3	CTNNB1	41239133	41239904	46	772	556	9254	510	8482	0.05958549222797927	0.0601273284602688
chr3	CTNNB1	41239133	41240443	46	1311	556	9254	510	7943	0.03508771929824561	0.0642074782827647
chr3	TCAIM	44400354	44401334	88778	981	100200	8758	11422	7777	90.49745158002038	1.4686897261154688
chr3	ATRIP	48460109	48460799	8728	691	67106	5446	58378	4755	12.630969609261939	12.277181913774974
chr3	ATRIP	48465486	48467645	19039	2160	67106	5446	48067	3286	8.814351851851852	14.627814972611077
chr3	ATRIP	48466629	48467645	7624	1017	67106	5446	59482	4429	7.496558505408063	13.43011966583879
chr3	PRKAR2A-AS1	48848104	48851976	8058	3873	9195	3920	1137	47	2.080557707203718	24.19148936170213
chr3	WDR6	49011634	49014293	81141	2660	160033	4997	78892	2337	30.504135338345865	33.75780915703894
chr3	RBM6	50061461	50062108	6365	648	34941	7225	28576	6577	9.822530864197532	4.344838072069333
chr3	HEMK1	50579843	50580229	0	387	10790	17946	10790	17559	0.0	0.6144996867703172
chr3	GRM2	51715061	51716137	4791	1077	104926	4215	100135	3138	4.4484679665738165	31.910452517527087
chr3	ABHD14A-ACY1	51985851	51987453	3946	1603	7419	4173	3473	2570	2.461634435433562	1.3513618677042802
chr3	ABHD14A-ACY1	51987555	51988603	3445	1049	7419	4173	3974	3124	3.2840800762631077	1.2720870678617158
chr3	ABHD14A-ACY1	51986604	51987061	0	458	7419	4173	7419	3715	0.0	1.9970390309555854
chr3	ABHD14A-ACY1	51986414	51987061	1377	648	7419	4173	6042	3525	2.125	1.7140425531914893
chr3	ABHD14A-ACY1	51986414	51987453	2161	1040	7419	4173	5258	3133	2.0778846153846153	1.6782636450686244
chr3	ABHD14A-ACY1	51986604	51987453	784	850	7419	4173	6635	3323	0.9223529411764706	1.996689738188384
chr3	ABHD14A-ACY1	51986414	51987624	2295	1211	7419	4173	5124	2962	1.8951279933938894	1.7299122214719784
chr3	ABHD14A-ACY1	51986604	51988603	4363	2000	7419	4173	3056	2173	2.1815	1.4063506672802577
chr3	ABHD14A-ACY1	51986987	51987196	51	210	7419	4173	7368	3963	0.24285714285714285	1.8591975775927327
chr3	ABHD14A-ACY1	51985851	51986331	1281	481	7419	4173	6138	3692	2.6632016632016633	1.662513542795233
chr3	ABHD14A-ACY1	51986987	51987453	784	467	7419	4173	6635	3706	1.6788008565310493	1.7903399892066918
chr3	PPM1M	52249173	52250595	102	1423	230645	3294	230543	1871	0.07167955024595925	123.21913415285944
chr3	GLYCTK	52292259	52293475	115377	1217	1199245	4647	1083868	3430	94.80443714050945	315.99650145772597
chr3	PHF7	52414495	52414587	0	93	4031	2348	4031	2255	0.0	1.7875831485587583
chr3	PHF7	52419832	52419934	0	103	4031	2348	4031	2245	0.0	1.79554565701559
chr3	PHF7	52421647	52421754	61	108	4031	2348	3970	2240	0.5648148148148148	1.7723214285714286
chr3	C3ORF49	63831679	63832106	1158	428	46784	1653	45626	1225	2.705607476635514	37.245714285714286
chr3	AC109587.1	69013983	69014201	0	219	11575	3711	11575	3492	0.0	3.3147193585337917
chr3	AC129807.1	81840539	81840909	0	371	0	2464	0	2093	0.0	0.0
chr3	LINC00879	94989328	94990070	0	743	102	6020	102	5277	0.0	0.019329164297896533
chr3	NXPE3	101816794	101817001	0	208	51	9079	51	8871	0.0	0.0057490700033818055
chr3	NFKBIZ	101853090	101853863	0	774	0	5643	0	4869	0.0	0.0
chr3	DUBR	107246007	107248831	306	2825	3354	13361	3048	10536	0.10831858407079646	0.28929384965831434
chr3	DUBR	107246007	107247088	102	1082	3354	13361	3252	12279	0.09426987060998152	0.2648424138773516
chr3	HHLA2	108376492	108378285	204	1794	2414	2940	2210	1146	0.11371237458193979	1.9284467713787086
chr3	DZIP3	108647942	108648962	0	1021	51	6978	51	5957	0.0	0.008561356387443344
chr3	SLC35A5	112580545	112581326	0	782	0	4736	0	3954	0.0	0.0
chr3	ZDHHC23	113948685	113948963	0	279	153	4793	153	4514	0.0	0.03389455028799291
chr3	ZBTB20-AS1	114366966	114367221	0	256	918	5834	918	5578	0.0	0.16457511652922194
chr3	AC079848.2	126247030	126247713	0	684	0	3126	0	2442	0.0	0.0
chr3	COL6A5	130431464	130431949	0	486	21107	9473	21107	8987	0.0	2.3486146656281295
chr3	NUDT16	131383161	131388830	0	5670	76	6187	76	517	0.0	0.1470019342359768
chr3	NCK1	136945582	136946295	0	714	0	5120	0	4406	0.0	0.0
chr3	LINC01213	150238699	150238998	0	300	0	1723	0	1423	0.0	0.0
chr3	EIF2A	150567901	150568046	0	146	51	5921	51	5775	0.0	0.008831168831168832
chr3	LINC02029	157087858	157088536	0	679	0	2326	0	1647	0.0	0.0
chr3	SKIL	170359698	170361429	51	1732	1326	7601	1275	5869	0.029445727482678985	0.21724314193218605
chr3	KCNMB2	178825587	178825758	0	172	102	3552	102	3380	0.0	0.03017751479289941
chr3	TTC14	180608700	180610003	51	1304	99	5485	48	4181	0.039110429447852764	0.011480507055728294
chr3	LINC01206	182001117	182001760	0	644	0	11383	0	10739	0.0	0.0
chr3	LINC01206	182002773	182004063	0	1291	0	11383	0	10092	0.0	0.0
chr3	LINC01206	182001117	182003122	0	2006	0	11383	0	9377	0.0	0.0
chr3	LINC01206	181971563	181971906	0	344	0	11383	0	11039	0.0	0.0
chr3	EIF2B5	184143051	184143565	0	515	255	6302	255	5787	0.0	0.04406428201140487
chr3	LINC02020	186440981	186442081	51	1101	51	3478	0	2377	0.04632152588555858	0.0
chr3	KNG1	186741521	186744410	1052	2890	593	2509	-459	-381	0.36401384083044985	1.204724409448819
chr3	LINC00884	194487139	194488726	0	1588	4050	9432	4050	7844	0.0	0.5163182049974503
chr3	LINC00884	194487145	194488726	0	1582	4050	9432	4050	7850	0.0	0.5159235668789809
chr3	MUC20-OT1	195701379	195701669	9816	291	133092	13794	123276	13503	33.7319587628866	9.129526771828482
chr3	MUC20-OT1	195708133	195708807	9184	675	133092	13794	123908	13119	13.605925925925925	9.444927204817441
chr3	MUC20-OT1	195708137	195708841	9226	705	133092	13794	123866	13089	13.086524822695035	9.463366185346475
chr3	MUC20-OT1	195708153	195708435	5141	283	133092	13794	127951	13511	18.166077738515902	9.470135445192806
chr3	MUC20-OT1	195708153	195708513	5761	361	133092	13794	127331	13433	15.958448753462603	9.478969701481427
chr3	MUC20-OT1	195708153	195708841	9151	689	133092	13794	123941	13105	13.281567489114659	9.45753529187333
chr3	MUC20-OT1	195708177	195708435	4801	259	133092	13794	128291	13535	18.536679536679536	9.478463243442926
chr3	MUC20-OT1	195708428	195708841	4186	414	133092	13794	128906	13380	10.11111111111111	9.63423019431988
chr3	MUC20-OT1	195708177	195708841	8811	665	133092	13794	124281	13129	13.249624060150376	9.466143651458603
chr3	MUC20-OT1	195724679	195726572	408	1894	133092	13794	132684	11900	0.21541710665258712	11.149915966386555
chr3	THUMPD3-AS1	9390289	9391826	6277	1538	7555	6225	1278	4687	4.081274382314694	0.2726690847023682
chr3	CAMK1	9757346	9757846	0	501	468	2727	468	2226	0.0	0.21024258760107817
chr3	PRRT3	9945541	9948001	1275	2461	2449	3957	1174	1496	0.5180820804550995	0.7847593582887701
chr3	SEC13	10319138	10319316	4328	179	377315	4364	372987	4185	24.178770949720672	89.1247311827957
chr3	ACAA1	38126161	38126700	0	540	661	6653	661	6113	0.0	0.10813021429739898
chr3	ALS2CL	46674565	46675976	0	1412	0	7062	0	5650	0.0	0.0
chr3	ALS2CL	46674565	46676402	0	1838	0	7062	0	5224	0.0	0.0
chr3	PRSS43P	46756041	46756629	0	589	0	1677	0	1088	0.0	0.0
chr3	MYL3	46857871	46858272	0	402	0	2814	0	2412	0.0	0.0
chr3	PLXNB1	48419576	48420257	0	682	93	9551	93	8869	0.0	0.0104859623407374
chr3	SHISA5	48469360	48469573	1518	214	40429	4383	38911	4169	7.093457943925234	9.333413288558408
chr3	DALRD3	49015818	49016086	681	269	364607	2755	363926	2486	2.5315985130111525	146.39018503620272
chr3	AMT	49416777	49417718	1377	942	2780	4678	1403	3736	1.4617834394904459	0.3755353319057816
chr3	AMT	49419709	49420342	255	634	2780	4678	2525	4044	0.4022082018927445	0.624381800197824
chr3	AMT	49416793	49417718	1377	926	2780	4678	1403	3752	1.4870410367170626	0.3739339019189765
chr3	AMT	49418970	49419405	357	436	2780	4678	2423	4242	0.8188073394495413	0.5711928335690712
chr3	AMT	49416821	49417718	999	898	2780	4678	1781	3780	1.1124721603563474	0.4711640211640212
chr3	AC104452.1	49422103	49424874	6322	2772	7803	4975	1481	2203	2.280663780663781	0.6722650930549251
chr3	GMPPB	49723597	49723951	2381	355	964203	6681	961822	6326	6.707042253521127	152.04268099905153
chr3	CAMKV	49857988	49859881	4	1894	157	3414	153	1520	0.0021119324181626186	0.1006578947368421
chr3	CAMKV	49859260	49859881	0	622	157	3414	157	2792	0.0	0.05623209169054441
chr3	IFRD2	50289446	50289762	14164	317	611703	3353	597539	3036	44.6813880126183	196.81785243741766
chr3	NPRL2	50349385	50349828	2632	444	13677	2878	11045	2434	5.927927927927928	4.537797863599014
chr3	NPRL2	50347758	50348241	1442	484	13677	2878	12235	2394	2.979338842975207	5.110693400167085
chr3	ABHD14B	51971459	51971892	46628	434	305653	2831	259025	2397	107.43778801843318	108.06216103462661
chr3	TKT	53234982	53235174	0	193	5756	8000	5756	7807	0.0	0.7372870500832586
chr3	SELENOK	53885825	53885912	0	88	2256	2138	2256	2050	0.0	1.1004878048780489
chr3	PDHB	58430656	58430942	0	287	51	4248	51	3961	0.0	0.012875536480686695
chr3	FAM107A	58565460	58567364	0	1905	0	5329	0	3424	0.0	0.0
chr3	LMOD3	69122092	69122595	0	504	64973	5087	64973	4583	0.0	14.176958324241763
chr3	LINC00877	72035752	72036520	0	769	0	8637	0	7868	0.0	0.0
chr3	LINC00877	72060509	72061094	0	586	0	8637	0	8051	0.0	0.0
chr3	LINC00877	72035754	72036520	0	767	0	8637	0	7870	0.0	0.0
chr3	LINC00877	72035761	72036520	0	760	0	8637	0	7877	0.0	0.0
chr3	LINC00877	72059686	72061094	0	1409	0	8637	0	7228	0.0	0.0
chr3	CBLB	105680991	105681818	204	828	510	10339	306	9511	0.2463768115942029	0.032173273052255286
chr3	LINC00635	107841895	107842212	0	318	738	7071	738	6753	0.0	0.10928476232785429
chr3	LINC00635	107841661	107842212	0	552	738	7071	738	6519	0.0	0.11320754716981132
chr3	LINC00635	107841663	107842212	0	550	738	7071	738	6521	0.0	0.11317282625364208
chr3	LINC00635	107841667	107842212	0	546	738	7071	738	6525	0.0	0.11310344827586206
chr3	LINC00635	107841668	107842212	0	545	738	7071	738	6526	0.0	0.11308611707018082
chr3	LINC00635	107841671	107842212	0	542	738	7071	738	6529	0.0	0.11303415530709143
chr3	LINC00635	107853872	107855229	0	1358	738	7071	738	5713	0.0	0.12917906528969017
chr3	ATG3	112532509	112534337	0	1829	0	4249	0	2420	0.0	0.0
chr3	DRD3	114131117	114131400	0	284	0	3182	0	2898	0.0	0.0
chr3	CCDC14	123955842	123956115	0	274	0	7677	0	7403	0.0	0.0
chr3	CCDC14	123956354	123956795	0	442	0	7677	0	7235	0.0	0.0
chr3	LINC02614	125886835	125887226	0	392	51	6139	51	5747	0.0	0.00887419523229511
chr3	SLC41A3	126006356	126007225	0	870	414	5485	414	4615	0.0	0.08970747562296857
chr3	SLC41A3	126006362	126007225	0	864	414	5485	414	4621	0.0	0.08959099761956286
chr3	RAB43	129121285	129121804	204	520	816	4999	612	4479	0.3923076923076923	0.13663764233087744
chr3	ASTE1	131024004	131025331	0	1328	51	3157	51	1829	0.0	0.027884089666484417
chr3	CPNE4	132034566	132035442	0	877	0	5868	0	4991	0.0	0.0
chr3	TOPBP1	133598174	133598630	0	457	7546	7110	7546	6653	0.0	1.1342251615812415
chr3	PLSCR1	146521543	146522053	0	511	0	3554	0	3043	0.0	0.0
chr3	TM4SF1	149375442	149375769	12221	328	21594	3498	9373	3170	37.25914634146341	2.956782334384858
chr3	SLC33A1	155829687	155829903	0	217	0	4422	0	4205	0.0	0.0
chr3	SLC33A1	155833467	155834041	0	575	0	4422	0	3847	0.0	0.0
chr3	VEPH1	157459621	157460355	0	735	2564	6465	2564	5730	0.0	0.4474694589877836
chr3	B3GALNT1	161103426	161104406	0	981	102	6044	102	5063	0.0	0.020146158404108237
chr3	MECOM	169144996	169146288	0	1293	0	9118	0	7825	0.0	0.0
chr3	MCCC1	183071209	183071357	0	149	5639	4334	5639	4185	0.0	1.347431302270012
chr3	KLHL6	183487550	183492228	56143	4679	99282	10287	43139	5608	11.99893139559735	7.692403708987161
chr3	ABCC5	183983752	183987917	51	4166	322291	10992	322240	6826	0.012241958713394143	47.207735130383824
chr3	CLCN2	184355693	184357094	0	1402	0	7330	0	5928	0.0	0.0
chr3	CLCN2	184354903	184355529	0	627	0	7330	0	6703	0.0	0.0
chr3	LINC02052	186456916	186457630	0	715	102	3834	102	3119	0.0	0.03270278935556268
chr3	LINC02052	186455435	186455773	0	339	102	3834	102	3495	0.0	0.029184549356223177
chr3	LINC02052	186456163	186456604	51	442	102	3834	51	3392	0.11538461538461539	0.015035377358490566
chr3	ATP13A5	193276749	193276830	0	82	20597	5709	20597	5627	0.0	3.660387417807002
chr3	LINC02028	194057636	194058147	0	512	1802	10141	1802	9629	0.0	0.18714300550420604
chr3	LINC00887	194301198	194303465	714	2268	4970	4875	4256	2607	0.3148148148148148	1.6325278097429996
chr4	CPLX1	792432	792608	0	177	1224	2354	1224	2177	0.0	0.5622416169039963
chr4	HAUS3	2241519	2242121	45449	603	152924	9687	107475	9084	75.37147595356551	11.831241743725231
chr4	LCORL	17873387	17878213	10353	4827	197422	16931	187069	12104	2.144810441267868	15.45513879709187
chr4	ARAP2	36073688	36073823	0	136	16	12390	16	12254	0.0	0.0013056960992329036
chr4	RPL9	39458193	39458440	6541	248	512155	4943	505614	4695	26.375	107.69201277955271
chr4	AC114757.1	43992592	43993112	0	521	51	9122	51	8601	0.0	0.005929543076386466
chr4	LINC02619	58987181	58987955	0	775	0	1391	0	616	0.0	0.0
chr4	LINC02619	58987184	58987889	0	706	0	1391	0	685	0.0	0.0
chr4	LINC02619	58987186	58987974	0	789	0	1391	0	602	0.0	0.0
chr4	THAP9-AS1	82900076	82900566	0	491	0	4254	0	3763	0.0	0.0
chr4	MAPK10	86359657	86360060	0	404	153	36649	153	36245	0.0	0.0042212718995723545
chr4	MAPK10	86359657	86360083	0	427	153	36649	153	36222	0.0	0.004223952294185854
chr4	CENPE	103136140	103136359	0	220	34267	9977	34267	9757	0.0	3.5120426360561647
chr4	CYP2U1-AS1	107893066	107893637	0	572	153	6869	153	6297	0.0	0.02429728442115293
chr4	COL25A1	108810720	108813929	0	3210	14410	6485	14410	3275	0.0	4.4
chr4	COL25A1	109301722	109302367	0	646	14410	6485	14410	5839	0.0	2.4678883370440143
chr4	ARSJ	113978436	113979647	0	1212	0	4875	0	3663	0.0	0.0
chr4	LINC02262	117315151	117316148	0	998	0	2351	0	1353	0.0	0.0
chr4	METTL14-DT	118678043	118680583	153	2541	204	7533	51	4992	0.0602125147579693	0.010216346153846154
chr4	MFSD8	127917824	127920836	0	3013	0	7255	0	4242	0.0	0.0
chr4	MFSD8	127917888	127920836	0	2949	0	7255	0	4306	0.0	0.0
chr4	MFSD8	127920556	127921771	0	1216	0	7255	0	6039	0.0	0.0
chr4	MFSD8	127921523	127921963	0	441	0	7255	0	6814	0.0	0.0
chr4	LINC02466	129724172	129725789	0	1618	3986	3930	3986	2312	0.0	1.7240484429065743
chr4	PCDH18	137529601	137532494	0	2894	51	6690	51	3796	0.0	0.013435194942044258
chr4	LINC01095	146113641	146114465	0	825	1957	3553	1957	2728	0.0	0.717375366568915
chr4	PDGFC	156767772	156767990	0	219	0	6013	0	5794	0.0	0.0
chr4	PDGFC	156810836	156811017	0	182	0	6013	0	5831	0.0	0.0
chr4	NPY1R	163325855	163326705	0	851	0	3904	0	3053	0.0	0.0
chr4	NEK1	169612019	169612583	693	565	15902	8391	15209	7826	1.2265486725663717	1.9433938154868386
chr4	FBXO8	174262763	174263100	1684	338	4190	2099	2506	1761	4.982248520710059	1.4230550823395798
chr4	LINC01093	184897334	184898769	0	1436	0	3158	0	1722	0.0	0.0
chr4	LINC01093	184897347	184897746	0	400	0	3158	0	2758	0.0	0.0
chr4	UVSSA	1383765	1388049	40310	4285	80182	15270	39872	10985	9.407234539089849	3.629676832043696
chr4	ADD1	2904763	2905015	3413	253	337989	11643	334576	11390	13.4901185770751	29.374539069359088
chr4	NOP14-AS1	2934939	2937844	133021	2906	505610	7475	372589	4569	45.77460426703372	81.54716568176843
chr4	NSG1	4385856	4387173	0	1318	1530	4365	1530	3047	0.0	0.5021332458155563
chr4	NSG1	4417234	4419058	1530	1825	1530	4365	0	2540	0.8383561643835616	0.0
chr4	STX18-AS1	4648976	4649542	0	567	12842	21284	12842	20717	0.0	0.6198773953757784
chr4	WFS1	6277450	6277687	0	238	205285	4521	205285	4283	0.0	47.93018911977586
chr4	LINC02517	8321956	8322243	0	288	102	1963	102	1675	0.0	0.0608955223880597
chr4	LINC02517	8320116	8320522	0	407	102	1963	102	1556	0.0	0.06555269922879177
chr4	LINC02517	8320138	8320522	0	385	102	1963	102	1578	0.0	0.06463878326996197
chr4	AC005699.1	11770308	11770688	0	381	510	4472	510	4091	0.0	0.12466389635785871
chr4	FAM200B	15686235	15687148	9414	914	145204	3683	135790	2769	10.299781181619256	49.039364391477065
chr4	FAM200B	15686235	15690447	429046	4213	145204	3683	-283842	-530	101.83859482554	535.5509433962264
chr4	LIAS	39467517	39468427	1739	911	91228	9122	89489	8211	1.9088913282107574	10.898672512483254
chr4	TMEM33	41935128	41935529	0	402	344307	7774	344307	7372	0.0	46.70469343461747
chr4	SLAIN2	48382567	48382927	0	361	397149	6316	397149	5955	0.0	66.69168765743073
chr4	DCUN1D4	51886567	51887244	0	678	0	6539	0	5861	0.0	0.0
chr4	DANCR	52719867	52721683	1887	1817	7182	7739	5295	5922	1.0385250412768299	0.8941236068895644
chr4	REST	56910629	56911536	0	908	918	7466	918	6558	0.0	0.13998170173833485
chr4	IGFBP7-AS1	57201132	57201820	86	689	6326	3695	6240	3006	0.12481857764876633	2.0758483033932134
chr4	STAP1	67606295	67607337	0	1043	51	1960	51	917	0.0	0.05561613958560523
chr4	LINC01094	78680760	78682725	357	1966	5248	5306	4891	3340	0.18158697863682605	1.4643712574850298
chr4	LINC01094	78680760	78682683	357	1924	5248	5306	4891	3382	0.18555093555093555	1.4461856889414548
chr4	GPAT3	83536107	83536763	0	657	3119	3536	3119	2879	0.0	1.0833622785689476
chr4	SPP1	87981474	87981798	0	325	867	2329	867	2004	0.0	0.43263473053892215
chr4	AIMP1	106320865	106321451	1989	587	132800	8611	130811	8024	3.3884156729131174	16.302467597208373
chr4	LINC02263	117372363	117372735	0	373	0	12565	0	12192	0.0	0.0
chr4	LINC02263	117372363	117372850	0	488	0	12565	0	12077	0.0	0.0
chr4	SNHG8	118278754	118279137	0	384	0	6609	0	6225	0.0	0.0
chr4	SNHG8	118279388	118279820	0	433	0	6609	0	6176	0.0	0.0
chr4	EXOSC9	121813865	121816447	0	2583	956	3262	956	679	0.0	1.4079528718703977
chr4	INTU	127685441	127687867	0	2427	0	16061	0	13634	0.0	0.0
chr4	LARP1B	128107138	128108901	0	1764	191	8844	191	7080	0.0	0.026977401129943502
chr4	SNHG27	131773565	131774369	0	805	0	4138	0	3333	0.0	0.0
chr4	LINC02462	134455293	134455524	0	232	0	1601	0	1369	0.0	0.0
chr4	AC107223.1	143912330	143912638	0	309	2211	15940	2211	15631	0.0	0.1414496833216045
chr4	MMAA	145655146	145655568	0	423	12963	8168	12963	7745	0.0	1.6737249838605552
chr4	TRIM2	153322647	153324148	0	1502	1268	14876	1268	13374	0.0	0.09481082697771796
chr4	GUCY1A1	155696755	155697122	0	368	102	10473	102	10105	0.0	0.010094012864918357
chr4	LINC02433	157572535	157572725	0	191	0	1495	0	1304	0.0	0.0
chr4	CLCN3	169697188	169697734	0	547	929	8113	929	7566	0.0	0.12278614855934443
chr4	LINC02431	171040607	171040834	162	228	162	1769	0	1541	0.7105263157894737	0.0
chr4	HAND2-AS1	173530799	173531078	0	280	0	14033	0	13753	0.0	0.0
chr4	HAND2-AS1	173536847	173541931	0	5085	0	14033	0	8948	0.0	0.0
chr4	TRAPPC11	183708406	183708574	0	169	163	5682	163	5513	0.0	0.02956647923090876
chr4	LINC02436	185055997	185056679	0	683	0	7067	0	6384	0.0	0.0
chr4	LINC02436	185071567	185072073	0	507	0	7067	0	6560	0.0	0.0
chr4	FAM149A	186163423	186163633	0	211	724	5237	724	5026	0.0	0.14405093513728612
chr4	LINC02434	188160215	188161153	0	939	0	1294	0	355	0.0	0.0
chr4	LINC02434	188160215	188161139	0	925	0	1294	0	369	0.0	0.0
chr4	LINC01060	188485778	188486620	0	843	0	5920	0	5077	0.0	0.0
chr4	DUX4	190173773	190175284	0	1512	0	2042	0	530	0.0	0.0
chr5	PDCD6	271620	271821	8945	202	1015817	9301	1006872	9099	44.28217821782178	110.65743488295418
chr5	EXOC3	464289	465272	58334	984	695878	8157	637544	7173	59.28252032520325	88.88108183465775
chr5	SLC9A3-AS1	479781	480216	23590	436	96645	3334	73055	2898	54.10550458715596	25.208764665286406
chr5	SLC6A19	1216557	1216945	0	389	306	5281	306	4892	0.0	0.06255110384300899
chr5	AC124852.1	1958581	1959189	0	609	714	14286	714	13677	0.0	0.05220443079622724
chr5	AC124852.1	2097238	2097792	0	555	714	14286	714	13731	0.0	0.05199912606510815
chr5	LINC01018	6585773	6586604	0	832	139452	7086	139452	6254	0.0	22.29804924848097
chr5	LINC01018	6586227	6587666	0	1440	139452	7086	139452	5646	0.0	24.69925611052072
chr5	LINC01018	6586227	6587670	0	1444	139452	7086	139452	5642	0.0	24.716767103863877
chr5	AC091951.3	7326065	7326603	0	539	90	1653	90	1114	0.0	0.0807899461400359
chr5	LINC02217	17440113	17441082	0	970	0	8721	0	7751	0.0	0.0
chr5	LINC02241	20936150	20936712	0	563	518	9146	518	8583	0.0	0.06035185832459513
chr5	LINC02241	20936150	20937373	0	1224	518	9146	518	7922	0.0	0.06538752840191871
chr5	LINC02241	20936810	20937257	0	448	518	9146	518	8698	0.0	0.0595539204414808
chr5	LINC02241	20936818	20937257	0	440	518	9146	518	8706	0.0	0.05949919595681139
chr5	LINC02241	20936818	20937693	0	876	518	9146	518	8270	0.0	0.0626360338573156
chr5	PURPL	27493569	27494335	0	767	102	4915	102	4148	0.0	0.02459016393442623
chr5	ZNF131	43161248	43161931	57855	684	325812	8233	267957	7549	84.58333333333333	35.49569479401245
chr5	NNT	43647923	43649308	10193	1386	578620	10606	568427	9220	7.354256854256854	61.651518438177874
chr5	LINC01033	54401642	54403788	0	2147	41	3578	41	1431	0.0	0.0286512928022362
chr5	C5ORF64	61750336	61751770	0	1435	51271	22226	51271	20791	0.0	2.466018950507431
chr5	AC092353.1	66322832	66323341	0	510	612	4196	612	3686	0.0	0.16603364080303853
chr5	AC112206.2	67797349	67797756	0	408	140	5824	140	5416	0.0	0.0258493353028065
chr5	SLC30A5	69121746	69121895	0	150	84	5249	84	5099	0.0	0.016473818395763874
chr5	RAD17	69372033	69372217	4794	185	22970	4169	18176	3984	25.913513513513514	4.562248995983936
chr5	MARVELD2	69419370	69420531	1806	1162	4055	4722	2249	3560	1.5542168674698795	0.6317415730337078
chr5	BHMT2	79077479	79077612	0	134	714	3744	714	3610	0.0	0.19778393351800555
chr5	COX7C	86619352	86619878	612	527	3926	1972	3314	1445	1.1612903225806452	2.2934256055363322
chr5	TMEM161B-AS1	88269467	88270585	0	1119	613	27299	613	26180	0.0	0.023414820473644002
chr5	TMEM161B-AS1	88269467	88282106	357	12640	613	27299	256	14659	0.02824367088607595	0.01746367419332833
chr5	HSD17B4	119492099	119493946	0	1848	0	10487	0	8639	0.0	0.0
chr5	HSPA4	133101758	133101878	0	121	0	4955	0	4834	0.0	0.0
chr5	AC112178.1	136520174	136521145	0	972	0	2762	0	1790	0.0	0.0
chr5	MYOT	137870440	137871007	596	568	5169	2836	4573	2268	1.0492957746478873	2.0163139329805997
chr5	WNT8A	138090527	138091541	8568	1015	9384	1631	816	616	8.441379310344828	1.3246753246753247
chr5	KIF20A	138181421	138181511	46	91	710	3854	664	3763	0.5054945054945055	0.17645495615200638
chr5	KDM3B	138386021	138386621	0	601	1292	7897	1292	7296	0.0	0.17708333333333334
chr5	REEP2	138445227	138445375	47	149	3219	3145	3172	2996	0.31543624161073824	1.0587449933244326
chr5	IK	140661619	140661708	0	90	75	2764	75	2674	0.0	0.02804786836200449
chr5	WDR55	140668233	140668502	0	270	1428	4392	1428	4122	0.0	0.34643377001455605
chr5	WDR55	140668890	140669248	0	359	1428	4392	1428	4033	0.0	0.35407884949169355
chr5	HARS2	140693490	140693665	0	176	448186	3423	448186	3247	0.0	138.0307976593779
chr5	HARS2	140691452	140691756	0	305	448186	3423	448186	3118	0.0	143.74150096215521
chr5	RELL2	141636949	141638409	408	1461	408	2590	0	1129	0.2792607802874743	0.0
chr5	ARHGAP26	143207197	143207473	0	277	2330	17199	2330	16922	0.0	0.13769058030965606
chr5	CARMN	149423185	149423639	51	455	691350	14357	691299	13902	0.11208791208791209	49.72658610271903
chr5	HMGXB3	150024261	150024680	663	420	48158	6284	47495	5864	1.5785714285714285	8.099420190995907
chr5	GPX3	151025339	151025493	0	155	0	2903	0	2748	0.0	0.0
chr5	G3BP1	151803884	151812785	0	8902	0	10115	0	1213	0.0	0.0
chr5	G3BP1	151803884	151805319	0	1436	0	10115	0	8679	0.0	0.0
chr5	PTTG1	160422301	160422893	0	593	0	1930	0	1337	0.0	0.0
chr5	GABRA1	161850596	161850884	0	289	0	6688	0	6399	0.0	0.0
chr5	GABRG2	162067464	162068106	0	643	490	19638	490	18995	0.0	0.025796262174256384
chr5	GABRG2	162149107	162155485	51	6379	490	19638	439	13259	0.007994983539739771	0.03310958594162456
chr5	GABRG2	162149107	162151753	0	2647	490	19638	490	16991	0.0	0.02883879701018186
chr5	CCNG1	163437570	163437804	0	235	0	2779	0	2544	0.0	0.0
chr5	NPM1	171406396	171407774	1836	1379	7984	6517	6148	5138	1.3313995649021029	1.196574542623589
chr5	SIMC1	176295029	176295262	0	234	765	5551	765	5317	0.0	0.14387812676321235
chr5	SIMC1	176345182	176345989	204	808	765	5551	561	4743	0.2524752475247525	0.11827956989247312
chr5	NSD1	177135086	177136030	102	945	432	15548	330	14603	0.10793650793650794	0.022598096281585975
chr5	FAM153CP	178046871	178047133	7057	263	87124	18718	80067	18455	26.832699619771862	4.338499051747494
chr5	FAM153CP	178048664	178052687	28336	4024	87124	18718	58788	14694	7.041749502982108	4.000816659861168
chr5	FAM153CP	178038837	178039411	1151	575	87124	18718	85973	18143	2.0017391304347827	4.738631979275754
chr5	RUFY1	179559691	179560198	0	508	0	5465	0	4957	0.0	0.0
chr5	LINC00847	180834311	180835705	40	1395	213	5657	173	4262	0.02867383512544803	0.04059127170342562
chr5	LINC00847	180834311	180835726	51	1416	213	5657	162	4241	0.036016949152542374	0.03819853808064136
chr5	BTNL9	181053468	181054259	0	792	0	5577	0	4785	0.0	0.0
chr5	BRD9	868606	869119	7478	514	772955	9010	765477	8496	14.54863813229572	90.09851694915254
chr5	AC026412.1	1632643	1632906	1082	264	44766	3371	43684	3107	4.098484848484849	14.059864821371098
chr5	AC026412.1	1598919	1599827	11822	909	44766	3371	32944	2462	13.005500550055006	13.380991064175467
chr5	FASTKD3	7866645	7868170	71059	1526	106287	2765	35228	1239	46.56553079947575	28.432606941081517
chr5	CTNND2	11082695	11082846	0	152	114	7298	114	7146	0.0	0.01595298068849706
chr5	LINC02103	28285963	28286886	0	924	0	1092	0	168	0.0	0.0
chr5	PRLR	35065088	35066102	7952	1015	9171	3630	1219	2615	7.834482758620689	0.4661567877629063
chr5	LINC02106	50969216	50969577	0	362	0	608	0	246	0.0	0.0
chr5	SMIM15	61162216	61162468	0	253	0	2891	0	2638	0.0	0.0
chr5	CCDC125	69320236	69320580	0	345	17679	7594	17679	7249	0.0	2.4388191474686165
chr5	CCDC125	69320236	69320583	0	348	17679	7594	17679	7246	0.0	2.439828871101297
chr5	TBCA	77691240	77693352	0	2113	1203	3121	1203	1008	0.0	1.193452380952381
chr5	RPS23	82275208	82276255	51	1048	102	3817	51	2769	0.04866412213740458	0.018418201516793065
chr5	LUCAT1	91314079	91314402	0	324	0	15454	0	15130	0.0	0.0
chr5	LUCAT1	91314164	91314402	0	239	0	15454	0	15215	0.0	0.0
chr5	LUCAT1	91314079	91314386	0	308	0	15454	0	15146	0.0	0.0
chr5	LUCAT1	91314079	91314499	0	421	0	15454	0	15033	0.0	0.0
chr5	LUCAT1	91314079	91314377	0	299	0	15454	0	15155	0.0	0.0
chr5	LUCAT1	91310626	91312413	0	1788	0	15454	0	13666	0.0	0.0
chr5	LUCAT1	91310626	91312495	0	1870	0	15454	0	13584	0.0	0.0
chr5	LUCAT1	91310626	91313229	0	2604	0	15454	0	12850	0.0	0.0
chr5	LUCAT1	91312294	91313229	0	936	0	15454	0	14518	0.0	0.0
chr5	LUCAT1	91311645	91312413	0	769	0	15454	0	14685	0.0	0.0
chr5	NR2F1-AS1	93580466	93581199	0	734	3564	22614	3564	21880	0.0	0.16288848263254113
chr5	LINC00491	102636142	102636434	0	293	21405	2811	21405	2518	0.0	8.500794281175535
chr5	AC099520.1	104739255	104739635	0	381	0	4954	0	4573	0.0	0.0
chr5	AC099520.1	104739257	104739635	0	379	0	4954	0	4575	0.0	0.0
chr5	AC011416.3	127227616	127228918	562	1303	566	1800	4	497	0.4313123561013047	0.008048289738430584
chr5	HINT1	131159295	131162477	0	3183	147	6082	147	2899	0.0	0.05070714039323905
chr5	HINT1	131159295	131162676	0	3382	147	6082	147	2700	0.0	0.05444444444444444
chr5	FNIP1	131671504	131672924	7266	1421	29869	6738	22603	5317	5.113300492610837	4.251081436900508
chr5	ACSL6	131974892	131976240	51	1349	64616	15803	64565	14454	0.03780578206078577	4.466929569669296
chr5	ACSL6	131990852	131991813	102	962	64616	15803	64514	14841	0.10602910602910603	4.347011656896435
chr5	HSPA9	138553755	138556592	0	2838	649	5786	649	2948	0.0	0.22014925373134328
chr5	APBB3	140561586	140562227	0	642	418	3183	418	2541	0.0	0.1645021645021645
chr5	APBB3	140561586	140561849	0	264	418	3183	418	2919	0.0	0.14319972593353889
chr5	NR3C1	143300484	143300763	320	280	422	9176	102	8896	1.1428571428571428	0.011465827338129496
chr5	NR3C1	143399655	143400852	51	1198	422	9176	371	7978	0.04257095158597663	0.046502882928052144
chr5	PPP2R2B	146878001	146878785	0	785	0	13227	0	12442	0.0	0.0
chr5	SH3TC2	149026859	149028554	0	1696	2844	12652	2844	10956	0.0	0.25958378970427165
chr5	SH3TC2	149006880	149009001	255	2122	2844	12652	2589	10530	0.12016965127238455	0.24586894586894587
chr5	SH3TC2	149026859	149028718	0	1860	2844	12652	2844	10792	0.0	0.2635285396590067
chr5	ZNF300	150894398	150898184	1163	3787	1382	4410	219	623	0.3071032479535252	0.35152487961476725
chr5	CCNJL	160254128	160255708	102	1581	204	9249	102	7668	0.06451612903225806	0.013302034428794992
chr5	SLU7	160418595	160419081	0	487	0	4786	0	4299	0.0	0.0
chr5	LINC01938	165240461	165240757	0	297	0	3198	0	2901	0.0	0.0
chr5	AC008429.1	172957153	172958257	0	1105	0	2174	0	1069	0.0	0.0
chr5	AC139491.6	176147538	176147870	0	333	0	2756	0	2423	0.0	0.0
chr5	CLK4	178603843	178603934	125	92	27108	7054	26983	6962	1.358695652173913	3.8757540936512496
chr5	HNRNPH1	179623036	179624669	0	1634	276	5593	276	3959	0.0	0.06971457438747158
chr5	C5ORF60	179642325	179643210	0	886	22	2531	22	1645	0.0	0.013373860182370821
chr5	MRNIP	179837275	179840959	51	3685	306	7454	255	3769	0.01383989145183175	0.06765720350225524
chr5	MRNIP	179853196	179853437	0	242	306	7454	306	7212	0.0	0.042429284525790346
chr5	ZFP62	180847610	180851493	0	3884	0	3131	0	-753	0.0	-0.0
chr5	RACK1	181236928	181237719	0	792	0	5102	0	4310	0.0	0.0
chr6	AL133351.4	3026752	3027426	1323	675	26086	1378	24763	703	1.96	35.22475106685633
chr6	RIPK1	3083084	3085408	60266	2325	459507	10181	399241	7856	25.920860215053764	50.819882892057024
chr6	PRPF4B	4060412	4061147	47576	736	422403	7279	374827	6543	64.6413043478261	57.28671863059758
chr6	PRPF4B	4061654	4062299	73828	646	422403	7279	348575	6633	114.28482972136223	52.55163576059098
chr6	HULC	8788821	8790434	2295	1614	13320	47611	11025	45997	1.4219330855018588	0.23968954497032416
chr6	U91328.1	25997902	26001775	66896	3874	67482	3639	586	-235	17.267940113577698	-2.4936170212765956
chr6	BTN3A2	26368564	26368912	4420	349	120376	5358	115956	5009	12.664756446991404	23.149530844479937
chr6	BTN2A3P	26422932	26423759	11812	828	79889	4185	68077	3357	14.265700483091788	20.279118260351503
chr6	LINC00240	27023208	27023923	0	716	102	3236	102	2520	0.0	0.04047619047619048
chr6	LINC00240	27023253	27023925	0	673	102	3236	102	2563	0.0	0.03979711275848615
chr6	LINC00240	27023253	27023931	0	679	102	3236	102	2557	0.0	0.03989049667579194
chr6	MOG	29670700	29672372	0	1673	0	2643	0	970	0.0	0.0
chr6	ATAT1	30642767	30644679	614095	1913	689283	3818	75188	1905	321.0115002613696	39.46876640419948
chr6	C6ORF136	30652647	30653109	167665	463	225863	2035	58198	1572	362.1274298056156	37.021628498727736
chr6	MUCL3	30948546	30952499	51	3954	153	5687	102	1733	0.012898330804248861	0.058857472590882864
chr6	CSNK2B	31665233	31665493	943	261	52186	2558	51243	2297	3.6130268199233715	22.308663474096647
chr6	MPIG6B	31724745	31725074	14523	330	131259	2943	116736	2613	44.00909090909091	44.67508610792193
chr6	MSH5-SAPCD1	31762419	31763168	31194	750	289079	3610	257885	2860	41.592	90.16958041958041
chr6	MSH5-SAPCD1	31764265	31764851	102	587	289079	3610	288977	3023	0.1737649063032368	95.59278862057559
chr6	CFB	31951554	31952084	624	531	102769	4475	102145	3944	1.1751412429378532	25.898833671399593
chr6	SKIV2L	31969279	31969751	919	473	4370	4787	3451	4314	1.9429175475687104	0.7999536393138619
chr6	PPT2-EGFL8	32166137	32166620	0	484	174403	5532	174403	5048	0.0	34.54893026941363
chr6	AL662789.1	32718028	32718440	0	413	0	1019	0	606	0.0	0.0
chr6	HCG25	33249533	33249889	727	357	183240	4313	182513	3956	2.0364145658263304	46.135743174924166
chr6	AL138889.1	33914087	33915115	0	1029	51	14456	51	13427	0.0	0.0037983168243092276
chr6	AL138889.1	33914087	33914792	0	706	51	14456	51	13750	0.0	0.0037090909090909093
chr6	HMGA1	34236872	34237317	203	446	2286	2333	2083	1887	0.4551569506726457	1.1038685744568097
chr6	ZNF76	35290640	35291403	408	764	43099	6025	42691	5261	0.5340314136125655	8.114616992967116
chr6	CNPY3	42935573	42935670	156	98	10146	1725	9990	1627	1.5918367346938775	6.140135218192993
chr6	TJAP1	43504760	43506553	160616	1794	236395	6659	75779	4865	89.52954292084726	15.576361767728674
chr6	TJAP1	43500743	43501687	44207	945	236395	6659	192188	5714	46.77989417989418	33.634581729086456
chr6	TJAP1	43503622	43506553	162077	2932	236395	6659	74318	3727	55.27864938608458	19.940434665951166
chr6	EFHC1	52438303	52438591	0	289	15377	16238	15377	15949	0.0	0.9641356824879302
chr6	TRAM2-AS1	52578049	52578594	0	546	864	8437	864	7891	0.0	0.10949182613103536
chr6	TRAM2-AS1	52577306	52578393	0	1088	864	8437	864	7349	0.0	0.11756701592053341
chr6	ADGRB3	69233033	69233416	0	384	51	6603	51	6219	0.0	0.008200675349734683
chr6	FAM135A	70524930	70526698	0	1769	43667	9960	43667	8191	0.0	5.331095104382859
chr6	AL391840.1	79420262	79420637	0	376	0	11835	0	11459	0.0	0.0
chr6	SLC35A1	87508419	87508596	0	178	0	2003	0	1825	0.0	0.0
chr6	LINC00222	108766995	108768456	403	1462	563	2909	160	1447	0.2756497948016416	0.11057360055286801
chr6	FIG4	109786301	109789677	132007	3377	394464	19865	262457	16488	39.09002072845721	15.918061620572537
chr6	FIG4	109786301	109788956	128825	2656	394464	19865	265639	17209	48.50338855421687	15.436050903596955
chr6	LINC01013	132131912	132132189	0	278	177	6796	177	6518	0.0	0.02715556919300399
chr6	LINC00326	133088817	133090069	0	1253	1416	6021	1416	4768	0.0	0.29697986577181207
chr6	MYB	135196725	135197323	0	599	1466	5517	1466	4918	0.0	0.2980886539243595
chr6	TNFAIP3	137875687	137875835	0	149	51	4800	51	4651	0.0	0.010965383788432596
chr6	TNFAIP3	137878431	137879351	51	921	51	4800	0	3879	0.05537459283387622	0.0
chr6	AL590617.2	138696596	138697288	102	693	42	2404	-60	1711	0.1471861471861472	-0.03506721215663355
chr6	AL592429.2	139286844	139287307	0	464	117	4873	117	4409	0.0	0.026536629621229303
chr6	VDAC1P8	143503393	143504142	561	750	1868	4338	1307	3588	0.748	0.3642697881828317
chr6	VDAC1P8	143505339	143506100	1326	762	1868	4338	542	3576	1.7401574803149606	0.15156599552572708
chr6	ADGB	146724185	146726197	0	2013	0	7809	0	5796	0.0	0.0
chr6	SYTL3	158662749	158663378	17764	630	21348	2914	3584	2284	28.196825396825396	1.5691768826619965
chr6	QKI	163563419	163570145	51	6727	97	12507	46	5780	0.0075813884346662705	0.00795847750865052
chr6	TBP	170561790	170562233	0	444	153	2328	153	1884	0.0	0.08121019108280254
chr6	SLC22A23	3271773	3273412	62777	1640	77444	6133	14667	4493	38.27865853658537	3.2644113064767417
chr6	AL033523.1	3653220	3654795	306	1576	4735	14663	4429	13087	0.19416243654822335	0.3384274470848934
chr6	TFAP2A	10409900	10410335	77574	436	1054151	7421	976577	6985	177.92201834862385	139.81059413027916
chr6	PRL	22294408	22294584	0	177	0	1437	0	1260	0.0	0.0
chr6	ZSCAN31	28353861	28354204	0	344	12071	3678	12071	3334	0.0	3.6205758848230354
chr6	GPX6	28510750	28510904	0	155	0	2026	0	1871	0.0	0.0
chr6	TRIM27	28903001	28904665	861	1665	1345	5195	484	3530	0.5171171171171172	0.13711048158640227
chr6	RNF39	30070265	30071691	0	1427	0	2210	0	783	0.0	0.0
chr6	TRIM31	30102896	30103789	0	894	0	3099	0	2205	0.0	0.0
chr6	HCG18	30291536	30294964	32028	3429	134925	15541	102897	12112	9.340332458442695	8.495459048877146
chr6	CCHCR1	31156730	31157089	0	360	13501	4266	13501	3906	0.0	3.4564772145417306
chr6	POU5F1	31165926	31166838	1323	913	7382	2841	6059	1928	1.4490690032858708	3.142634854771784
chr6	NCR3	31589781	31590126	523	346	68640	1155	68117	809	1.5115606936416186	84.19901112484548
chr6	LY6G6E	31712340	31712789	2330	450	23500	1107	21170	657	5.177777777777778	32.22222222222222
chr6	TSBP1	32330588	32330609	0	22	34062	2235	34062	2213	0.0	15.391775869859918
chr6	TSBP1	32366272	32366302	0	31	34062	2235	34062	2204	0.0	15.454627949183303
chr6	HLA-DQB2	32756097	32757304	0	1208	0	2031	0	823	0.0	0.0
chr6	DAXX	33318996	33319219	0	224	102	2984	102	2760	0.0	0.03695652173913044
chr6	CUTA	33416549	33416776	28976	228	88350	1281	59374	1053	127.08771929824562	56.38556505223172
chr6	BAK1	33575792	33575928	0	137	51	2219	51	2082	0.0	0.024495677233429394
chr6	LEMD2	33771221	33772778	0	1558	663	6568	663	5010	0.0	0.13233532934131736
chr6	RPS10	34417453	34418424	0	972	0	2123	0	1151	0.0	0.0
chr6	TFEB	41705646	41705940	0	295	512	5743	512	5448	0.0	0.09397944199706314
chr6	TRERF1	42268153	42269848	15195	1696	56006	7750	40811	6054	8.95931603773585	6.741162867525603
chr6	YIPF3	43513068	43513451	1259	384	97145	2603	95886	2219	3.2786458333333335	43.21135646687697
chr6	GTPBP2	43620489	43622167	408	1679	1697	4733	1289	3054	0.24300178677784395	0.4220694171578258
chr6	GTPBP2	43620489	43621790	408	1302	1697	4733	1289	3431	0.31336405529953915	0.37569221801224134
chr6	MRPS18A	43675201	43675617	0	417	0	1390	0	973	0.0	0.0
chr6	MLIP-AS1	54047291	54047594	0	304	0	4048	0	3744	0.0	0.0
chr6	LGSN	63275950	63281220	0	5271	0	2402	0	-2869	0.0	-0.0
chr6	EYS	65494662	65495607	0	946	102	17124	102	16178	0.0	0.00630485844974657
chr6	AL589935.1	71310295	71310642	0	348	7201	5018	7201	4670	0.0	1.5419700214132763
chr6	KHDC1	73262773	73263184	0	412	0	2448	0	2036	0.0	0.0
chr6	KHDC1	73241316	73241728	0	413	0	2448	0	2035	0.0	0.0
chr6	EEF1A1	73517514	73518264	0	751	4478	6341	4478	5590	0.0	0.8010733452593918
chr6	SNHG5	85678135	85678748	0	614	0	7815	0	7201	0.0	0.0
chr6	SNHG5	85678135	85678736	0	602	0	7815	0	7213	0.0	0.0
chr6	SNHG5	85678135	85678733	0	599	0	7815	0	7216	0.0	0.0
chr6	SNHG5	85677423	85678032	0	610	0	7815	0	7205	0.0	0.0
chr6	SNHG5	85677423	85678748	0	1326	0	7815	0	6489	0.0	0.0
chr6	SNHG5	85677423	85678188	0	766	0	7815	0	7049	0.0	0.0
chr6	SNHG5	85677794	85678032	0	239	0	7815	0	7576	0.0	0.0
chr6	SNHG5	85677794	85678188	0	395	0	7815	0	7420	0.0	0.0
chr6	SNHG5	85677794	85678748	0	955	0	7815	0	6860	0.0	0.0
chr6	SNHG5	85677006	85677492	0	487	0	7815	0	7328	0.0	0.0
chr6	SNHG5	85677953	85678748	0	796	0	7815	0	7019	0.0	0.0
chr6	SNHG5	85677423	85677875	0	453	0	7815	0	7362	0.0	0.0
chr6	SNHG5	85677078	85677492	0	415	0	7815	0	7400	0.0	0.0
chr6	SNHG5	85677953	85678736	0	784	0	7815	0	7031	0.0	0.0
chr6	SNHG5	85677078	85677875	0	798	0	7815	0	7017	0.0	0.0
chr6	SNHG5	85677953	85678188	0	236	0	7815	0	7579	0.0	0.0
chr6	SNHG5	85677790	85678032	0	243	0	7815	0	7572	0.0	0.0
chr6	MAP3K7	90550467	90552179	5457	1713	8564	7270	3107	5557	3.1856392294220663	0.559114630196149
chr6	PNISR	99403828	99404702	0	875	0	5565	0	4690	0.0	0.0
chr6	LINC02532	106774776	106775000	0	225	14827	11311	14827	11086	0.0	1.3374526429731193
chr6	CD164	109366513	109369017	667	2505	667	6868	0	4363	0.26626746506986027	0.0
chr6	SLC22A16	110424686	110425382	16574	697	16922	2809	348	2112	23.779053084648492	0.16477272727272727
chr6	SLC22A16	110456537	110457017	195	481	16922	2809	16727	2328	0.40540540540540543	7.185137457044673
chr6	LAMA4	112253955	112254538	0	584	476	11935	476	11351	0.0	0.04193463131001674
chr6	EPB41L2	130869851	130870126	0	276	0	10058	0	9782	0.0	0.0
chr6	VNN3	132734252	132734692	0	441	1467	5404	1467	4963	0.0	0.29558734636308687
chr6	VNN3	132722925	132723907	0	983	1467	5404	1467	4421	0.0	0.331825378873558
chr6	VNN2	132752460	132752749	0	290	0	2606	0	2316	0.0	0.0
chr6	TARID	133888603	133889212	0	610	300	8097	300	7487	0.0	0.040069453719780955
chr6	SGK1	134174510	134174861	0	352	0	6257	0	5905	0.0	0.0
chr6	AL138828.1	136095993	136096288	0	296	612	7340	612	7044	0.0	0.0868824531516184
chr6	BCLAF1	136275842	136276508	6	667	3804	7393	3798	6726	0.008995502248875561	0.5646743978590544
chr6	REPS1	138926400	138930098	0	3699	1767	6039	1767	2340	0.0	0.7551282051282051
chr6	PLAGL1	143964786	143966230	0	1445	0	8363	0	6918	0.0	0.0
chr6	PLAGL1	143940301	143942663	0	2363	0	8363	0	6000	0.0	0.0
chr6	PLAGL1	143964786	143966198	0	1413	0	8363	0	6950	0.0	0.0
chr6	EPM2A	145686121	145686296	0	176	0	17587	0	17411	0.0	0.0
chr6	SHPRH	145941622	145941874	0	253	1607	17722	1607	17469	0.0	0.09199152784933311
chr6	SHPRH	145954689	145955354	0	666	1607	17722	1607	17056	0.0	0.09421904315196998
chr6	STXBP5-AS1	146844318	146844712	0	395	1218	11664	1218	11269	0.0	0.10808412458958204
chr6	STXBP5-AS1	146850824	146851331	0	508	1218	11664	1218	11156	0.0	0.10917891717461456
chr6	RAET1K	150000852	150001668	33714	817	47245	1900	13531	1083	41.265605875153	12.493998153277932
chr6	SYNE1	152329729	152331890	0	2162	780	42788	780	40626	0.0	0.01919952739624871
chr6	SYNE1	152455885	152456044	0	160	780	42788	780	42628	0.0	0.018297832410622127
chr6	SERAC1	158116184	158117821	0	1638	0	9775	0	8137	0.0	0.0
chr6	SOD2	159679063	159682638	0	3576	8459	6793	8459	3217	0.0	2.6294684488654028
chr6	PACRG-AS3	163187672	163190982	0	3311	51	8368	51	5057	0.0	0.01008503065058335
chr6	PACRG-AS1	163320400	163324069	0	3670	0	2756	0	-914	0.0	-0.0
chr6	TCP10L3	167375965	167378092	6592	2128	26551	8397	19959	6269	3.0977443609022557	3.183761365449035
chr6	TCP10L3	167372967	167374451	4433	1485	26551	8397	22118	6912	2.9851851851851854	3.1999421296296298
chr6	TCP10L3	167376545	167378092	3167	1548	26551	8397	23384	6849	2.045865633074935	3.414221054168492
chr6	FRMD1	168066754	168067129	0	376	0	7718	0	7342	0.0	0.0
chr7	CYP2W1	988276	989640	51	1365	515	2697	464	1332	0.03736263736263736	0.3483483483483483
chr7	ZFAND2A-DT	1162961	1163495	0	535	1551	2348	1551	1813	0.0	0.8554881412024269
chr7	IQCE	2571525	2571654	714	130	112604	9142	111890	9012	5.492307692307692	12.41566799822459
chr7	SDK1	4265123	4269000	0	3878	51	12307	51	8429	0.0	0.0060505398030608615
chr7	USP42	6139091	6140195	0	1105	17432	7092	17432	5987	0.0	2.9116418907633204
chr7	ZDHHC4	6577433	6577720	0	288	102	3565	102	3277	0.0	0.03112602990540128
chr7	C7ORF26	6599828	6600356	0	529	36	2732	36	2203	0.0	0.016341352700862462
chr7	RSPH10B2	6757356	6757931	204	576	34372	4899	34168	4323	0.3541666666666667	7.903770529724728
chr7	RSPH10B2	6754116	6754509	0	394	34372	4899	34372	4505	0.0	7.6297447280799116
chr7	AC005532.1	7277584	7278071	65001	488	65535	3258	534	2770	133.1987704918033	0.1927797833935018
chr7	AC004540.1	26493794	26495199	0	1406	46	6357	46	4951	0.0	0.009291052312664107
chr7	AC004947.1	26556473	26557207	0	735	66	2731	66	1996	0.0	0.033066132264529056
chr7	AC004947.1	26554808	26555227	0	420	66	2731	66	2311	0.0	0.028559065339679793
chr7	HOXA-AS2	27123459	27124610	0	1152	102	4914	102	3762	0.0	0.02711323763955343
chr7	AC005162.2	29000968	29001055	0	88	0	4933	0	4845	0.0	0.0
chr7	GARS1	30631447	30632437	2598	991	76999	11228	74401	10237	2.6215943491422804	7.267851909739181
chr7	GARS1	30594877	30595143	1771	267	76999	11228	75228	10961	6.632958801498128	6.863242404890065
chr7	GHRHR	30969532	30969964	0	433	1395	3152	1395	2719	0.0	0.5130562706877528
chr7	EEPD1	36154132	36155202	0	1071	2683	4594	2683	3523	0.0	0.7615668464376951
chr7	CDK13	40078719	40078851	0	133	64285	22505	64285	22372	0.0	2.873457893795816
chr7	AEBP1	44110724	44111057	4229	334	104425	4990	100196	4656	12.661676646706587	21.519759450171822
chr7	AEBP1	44111506	44112050	19618	545	104425	4990	84807	4445	35.996330275229354	19.079190101237344
chr7	AC237221.1	57418627	57419532	0	906	0	4007	0	3101	0.0	0.0
chr7	AC237221.1	57418627	57419535	0	909	0	4007	0	3098	0.0	0.0
chr7	ASL	66075833	66076093	102	261	8623	5629	8521	5368	0.39080459770114945	1.5873695976154993
chr7	KCTD7	66638855	66639228	0	374	6560	3297	6560	2923	0.0	2.244269586041738
chr7	TYW1	67067284	67067403	0	120	204	3755	204	3635	0.0	0.056121045392022006
chr7	SPDYE21	67286043	67286437	0	395	0	1301	0	906	0.0	0.0
chr7	STAG3L4	67308576	67309139	0	564	0	3202	0	2638	0.0	0.0
chr7	NCF1	74782938	74783632	5106	695	53877	3153	48771	2458	7.3467625899280575	19.84174125305126
chr7	NSUN5P1	75412788	75415023	102	2236	0	2136	-102	-100	0.04561717352415027	1.02
chr7	NSUN5P1	75415591	75416191	0	601	0	2136	0	1535	0.0	0.0
chr7	NSUN5P1	75415980	75416191	0	212	0	2136	0	1924	0.0	0.0
chr7	SPDYE5	75501361	75501755	0	395	102	3333	102	2938	0.0	0.03471749489448604
chr7	POR	75986158	75986855	9438	698	43524	5746	34086	5048	13.521489971346705	6.752377179080824
chr7	AC007003.1	76902479	76903112	0	634	540	1239	540	605	0.0	0.8925619834710744
chr7	MAGI2-AS3	79458846	79459640	0	795	153	16832	153	16037	0.0	0.009540437737731496
chr7	STEAP2	90232336	90237631	0	5296	23	8556	23	3260	0.0	0.00705521472392638
chr7	PEG10	94663333	94665698	102	2366	561	3432	459	1066	0.04311073541842773	0.43058161350844276
chr7	PEG10	94663333	94669692	867	6360	561	3432	-306	-2928	0.13632075471698113	0.10450819672131148
chr7	ZKSCAN1	100023418	100023932	0	515	127291	10327	127291	9812	0.0	12.972992254382389
chr7	ZSCAN21	100056910	100057405	1071	496	93608	2045	92537	1549	2.159274193548387	59.739832149774045
chr7	STAG3	100220113	100220673	46	561	40472	8611	40426	8050	0.08199643493761141	5.021863354037267
chr7	PILRB	100353372	100354012	0	641	0	3977	0	3336	0.0	0.0
chr7	PILRB	100352563	100352914	0	352	0	3977	0	3625	0.0	0.0
chr7	PILRB	100352563	100353123	0	561	0	3977	0	3416	0.0	0.0
chr7	LRWD1	102465531	102466051	0	521	2318	2902	2318	2381	0.0	0.9735405291894162
chr7	ARMC10	103083681	103084062	0	382	0	4585	0	4203	0.0	0.0
chr7	KMT2E	105090008	105090273	0	266	17175	9981	17175	9715	0.0	1.7678847143592382
chr7	DUS4L-BCAP29	107563970	107564676	100908	707	272938	7282	172030	6575	142.72701555869872	26.16425855513308
chr7	PTPRZ1	122010333	122013889	0	3557	0	8512	0	4955	0.0	0.0
chr7	ASB15	123624568	123624814	0	247	153	4927	153	4680	0.0	0.032692307692307694
chr7	IRF5	128947277	128947535	0	259	1446	4365	1446	4106	0.0	0.3521675596687774
chr7	PRSS1	142751773	142752027	0	255	0	1218	0	963	0.0	0.0
chr7	PRSS2	142773265	142773519	0	255	0	1266	0	1011	0.0	0.0
chr7	EPHB6	142863965	142864749	51	785	102	4742	51	3957	0.06496815286624204	0.01288855193328279
chr7	GSTK1	143264991	143265296	0	306	1667	3842	1667	3536	0.0	0.4714366515837104
chr7	OR2F1	143959947	143964360	944	4414	944	5093	0	679	0.21386497507929317	0.0
chr7	ARHGEF35-AS1	144239039	144239388	0	350	0	7882	0	7532	0.0	0.0
chr7	CUL1	148753975	148754150	216	176	14536	4022	14320	3846	1.2272727272727273	3.723348933957358
chr7	SSPOP	149795538	149796515	0	978	46	19328	46	18350	0.0	0.0025068119891008176
chr7	SSPOP	149826449	149827985	0	1537	46	19328	46	17791	0.0	0.0025855769771232647
chr7	SSPOP	149826912	149827985	0	1074	46	19328	46	18254	0.0	0.0025199956173989264
chr7	ABCB8	151034272	151034599	0	328	177864	9139	177864	8811	0.0	20.186584950629893
chr7	ASIC3	151052165	151052474	1122	310	37959	2756	36837	2446	3.6193548387096772	15.060098119378578
chr7	AGAP3	151086741	151087072	0	332	306	10457	306	10125	0.0	0.030222222222222223
chr7	RBM33	155738059	155740026	153	1968	306	13047	153	11079	0.07774390243902439	0.01380991064175467
chr7	AC006372.1	157502806	157503908	0	1103	0	1692	0	589	0.0	0.0
chr7	AC073316.1	3158137	3158571	0	435	0	1732	0	1297	0.0	0.0
chr7	RSPH10B	5966862	5967437	408	576	29702	5015	29294	4439	0.7083333333333334	6.599234061725614
chr7	ZNF12	6688432	6692703	86129	4272	89693	5328	3564	1056	20.161282771535582	3.375
chr7	ETV1	13989267	13989666	0	400	888	9310	888	8910	0.0	0.09966329966329966
chr7	AC005165.1	25655205	25656231	0	1027	0	5486	0	4459	0.0	0.0
chr7	HNRNPA2B1	26190992	26192338	709	1347	2234	8930	1525	7583	0.526354862657758	0.20110774099960438
chr7	HNRNPA2B1	26190992	26192577	1390	1586	2234	8930	844	7344	0.8764186633039092	0.11492374727668846
chr7	HNRNPA2B1	26189926	26192338	714	2413	2234	8930	1520	6517	0.29589722337339414	0.23323615160349853
chr7	HNRNPA2B1	26190992	26191650	97	659	2234	8930	2137	8271	0.1471927162367223	0.2583726272518438
chr7	HNRNPA2B1	26191055	26192577	1344	1523	2234	8930	890	7407	0.8824688115561392	0.12015660861347374
chr7	HNRNPA2B1	26191055	26192338	663	1284	2234	8930	1571	7646	0.5163551401869159	0.20546691080303425
chr7	HNRNPA2B1	26191055	26191650	51	596	2234	8930	2183	8334	0.08557046979865772	0.2619390448764099
chr7	GARS1-DT	30576563	30578091	4788	1529	32726	12139	27938	10610	3.131458469587966	2.633176248821866
chr7	HERPUD2	35694183	35695135	0	953	13278	3420	13278	2467	0.0	5.382245642480746
chr7	MRPS24	43869307	43869517	0	211	306	2611	306	2400	0.0	0.1275
chr7	POLM	44074130	44074530	0	401	5301	4453	5301	4052	0.0	1.3082428430404738
chr7	POLM	44073782	44074530	623	749	5301	4453	4678	3704	0.8317757009345794	1.2629589632829374
chr7	MYL7	44140960	44141332	0	373	0	1463	0	1090	0.0	0.0
chr7	CAMK2B	44220615	44220901	0	287	14180	7658	14180	7371	0.0	1.9237552570885905
chr7	SNHG15	44983022	44984046	0	1025	102	3016	102	1991	0.0	0.051230537418382724
chr7	SNHG15	44983821	44984426	0	606	102	3016	102	2410	0.0	0.04232365145228216
chr7	SNHG15	44983821	44986097	0	2277	102	3016	102	739	0.0	0.13802435723951287
chr7	SNHG15	44984356	44986097	0	1742	102	3016	102	1274	0.0	0.08006279434850863
chr7	TBRG4	45108826	45109287	2027	462	72036	5038	70009	4576	4.387445887445887	15.29916958041958
chr7	TNS3	47275153	47280190	9596	5038	19328	11804	9732	6766	1.9047240968638348	1.43836831214898
chr7	LINC01446	53811507	53811931	0	425	0	7300	0	6875	0.0	0.0
chr7	LINC01446	53811507	53811942	0	436	0	7300	0	6864	0.0	0.0
chr7	LINC01446	53770079	53771607	0	1529	0	7300	0	5771	0.0	0.0
chr7	LINC00174	66491030	66491471	1720	442	211762	11077	210042	10635	3.8914027149321266	19.750070521861776
chr7	NSUN5P2	72948891	72949102	459	212	17481	1874	17022	1662	2.1650943396226414	10.24187725631769
chr7	MLXIPL	73593201	73594403	2652	1203	73577	4671	70925	3468	2.2044887780548628	20.451268742791235
chr7	TMEM120A	75988082	75988341	177407	260	151235	1694	-26172	1434	682.3346153846154	-18.251046025104603
chr7	SPDYE16	76533875	76534119	0	245	0	3612	0	3367	0.0	0.0
chr7	POMZP3	76618182	76618615	51	434	6843	1868	6792	1434	0.1175115207373272	4.7364016736401675
chr7	MAGI2	78255942	78256581	0	640	204	25254	204	24614	0.0	0.008287966198098642
chr7	HGF	81755120	81757303	0	2184	228	8746	228	6562	0.0	0.034745504419384336
chr7	ABCB1	87600754	87601078	0	325	48135	6455	48135	6130	0.0	7.85236541598695
chr7	CYP51A1	92117043	92117212	124	170	10131	3540	10007	3370	0.7294117647058823	2.9694362017804155
chr7	SAMD9L	93145384	93146040	0	657	0	2461	0	1804	0.0	0.0
chr7	SGCE	94587777	94588732	0	956	162	11980	162	11024	0.0	0.01469521044992743
chr7	SGCE	94597748	94598004	78	257	162	11980	84	11723	0.3035019455252918	0.0071654013477778725
chr7	CYP3A5	99662815	99664095	22396	1281	375655	8312	353259	7031	17.483216237314597	50.243066420139385
chr7	CYP3A5	99676114	99676576	4548	463	375655	8312	371107	7849	9.822894168466522	47.28080010192381
chr7	MCM7	100099022	100099403	0	382	306	4099	306	3717	0.0	0.08232445520581114
chr7	GIGYF1	100688591	100689555	51	965	51	6865	0	5900	0.05284974093264249	0.0
chr7	ACHE	100893164	100894233	8050	1070	15872	3736	7822	2666	7.5233644859813085	2.9339834958739686
chr7	POLR2J3	102566996	102568184	0	1189	0	3918	0	2729	0.0	0.0
chr7	NAPEPLD	103099775	103103554	51	3780	103	6140	52	2360	0.013492063492063493	0.022033898305084745
chr7	TMEM168	112783697	112784953	0	1257	153	7838	153	6581	0.0	0.02324874639112597
chr7	HRAT17	112953281	112954768	0	1488	0	3836	0	2348	0.0	0.0
chr7	HRAT17	112953283	112954768	0	1486	0	3836	0	2350	0.0	0.0
chr7	HRAT17	112953383	112954768	0	1386	0	3836	0	2450	0.0	0.0
chr7	TFEC	115939948	115942040	0	2093	1701	3858	1701	1765	0.0	0.9637393767705382
chr7	NDUFA5	123557403	123557781	0	379	663	7705	663	7326	0.0	0.0904995904995905
chr7	POT1	124822385	124824074	0	1690	0	8237	0	6547	0.0	0.0
chr7	PAX4	127610810	127610985	0	176	204	2303	204	2127	0.0	0.09590973201692525
chr7	MKLN1-AS	131326805	131327746	0	942	0	7684	0	6742	0.0	0.0
chr7	PODXL	131508950	131509585	0	636	51	6903	51	6267	0.0	0.008137865007180469
chr7	AC009275.1	134417971	134418974	102	1004	102	5023	0	4019	0.10159362549800798	0.0
chr7	AC009275.1	134417291	134418219	0	929	102	5023	102	4094	0.0	0.024914509037616023
chr7	AC009275.1	134417291	134418974	102	1684	102	5023	0	3339	0.060570071258907364	0.0
chr7	CREB3L2	137915836	137916012	0	177	0	4960	0	4783	0.0	0.0
chr7	WEE2-AS1	141727203	141727642	0	440	0	5092	0	4652	0.0	0.0
chr7	PRSS37	141841015	141841485	0	471	0	2228	0	1757	0.0	0.0
chr7	SMARCD3	151240424	151241653	0	1230	14119	4505	14119	3275	0.0	4.311145038167939
chr7	PRKAG2	151565345	151565885	0	541	21836	14143	21836	13602	0.0	1.605352154094986
chr7	AC006019.1	154055582	154055925	0	344	0	2877	0	2533	0.0	0.0
chr7	AC009403.2	155481879	155484013	1275	2135	3085	7213	1810	5078	0.5971896955503513	0.35643954312721543
chr7	CNPY1	155502013	155503105	918	1093	6834	2741	5916	1648	0.8398902104300091	3.5898058252427183
chr8	FAM87A	377563	380309	204	2747	1020	4628	816	1881	0.07426283218056061	0.43381180223285487
chr8	FAM87A	375947	379458	204	3512	1020	4628	816	1116	0.05808656036446469	0.7311827956989247
chr8	TDRP	489802	492744	0	2943	0	3607	0	664	0.0	0.0
chr8	ERICH1	625674	627238	153	1565	32530	9726	32377	8161	0.09776357827476038	3.967283421149369
chr8	MCPH1-AS1	6620134	6621635	0	1502	43200	9929	43200	8427	0.0	5.1263794944820225
chr8	MIR124-1HG	9900554	9903398	0	2845	0	4885	0	2040	0.0	0.0
chr8	MIR124-1HG	9900544	9903398	0	2855	0	4885	0	2030	0.0	0.0
chr8	PRSS51	10497711	10497971	0	261	0	3044	0	2783	0.0	0.0
chr8	FAM86B1	12186351	12186833	0	483	0	4142	0	3659	0.0	0.0
chr8	ASAH1	18056834	18057623	0	790	2982	9281	2982	8491	0.0	0.3511953833470734
chr8	TNFRSF10B	23028330	23028602	51	273	5916	4954	5865	4681	0.18681318681318682	1.2529374065370646
chr8	CLU	27604923	27605335	1122	413	28475	5788	27353	5375	2.7167070217917675	5.088930232558139
chr8	ANK1	41672353	41672912	0	560	52607	10404	52607	9844	0.0	5.344067452255181
chr8	AC083973.1	42265614	42266396	2296	783	136232	2277	133936	1494	2.9323116219667944	89.64926372155288
chr8	RPS20	56074059	56074506	0	448	0	6105	0	5657	0.0	0.0
chr8	AC092819.1	58258525	58260024	0	1500	0	2277	0	777	0.0	0.0
chr8	LINC01592	68881958	68882380	0	423	51	3717	51	3294	0.0	0.015482695810564663
chr8	AC111149.1	73368378	73369355	0	978	0	1738	0	760	0.0	0.0
chr8	ZFAND1	81714803	81715114	0	312	0	2569	0	2257	0.0	0.0
chr8	SNX16	81839611	81840082	0	472	0	4619	0	4147	0.0	0.0
chr8	AC103760.1	86335702	86338387	51	2686	204	3962	153	1276	0.0189873417721519	0.11990595611285267
chr8	RNF19A	100287906	100288267	0	362	1055	5281	1055	4919	0.0	0.21447448668428543
chr8	PABPC1	100721390	100722087	0	698	1532	8827	1532	8129	0.0	0.18846106532168777
chr8	PABPC1	100721390	100721886	0	497	1532	8827	1532	8330	0.0	0.18391356542617046
chr8	AP003471.1	104419511	104421500	91957	1990	91957	1990	0	0	46.209547738693466	0.0
chr8	EIF3E	108201742	108203117	0	1376	102	27596	102	26220	0.0	0.0038901601830663617
chr8	LINC01608	111027305	111027599	0	295	0	12963	0	12668	0.0	0.0
chr8	LINC01608	111027305	111027593	0	289	0	12963	0	12674	0.0	0.0
chr8	TRPS1	115603872	115605002	0	1131	51	11061	51	9930	0.0	0.00513595166163142
chr8	FAM83A-AS1	123201171	123201982	0	812	0	2531	0	1719	0.0	0.0
chr8	FER1L6-AS2	124058787	124060792	102	2006	867	4623	765	2617	0.05084745762711865	0.292319449751624
chr8	CASC19	127168358	127169117	0	760	180	18096	180	17336	0.0	0.010383017997231195
chr8	CASC19	127168421	127169117	0	697	180	18096	180	17399	0.0	0.010345422150698317
chr8	CYRIB	129849242	129849369	0	128	102	7461	102	7333	0.0	0.013909723169234965
chr8	CYRIB	129854265	129854343	0	79	102	7461	102	7382	0.0	0.013817393660254673
chr8	CYRIB	129855610	129855747	0	138	102	7461	102	7323	0.0	0.013928717738631708
chr8	ST3GAL1	133475718	133476600	0	883	510	8868	510	7985	0.0	0.06386975579211021
chr8	MROH5	141447906	141448088	0	183	1061	4795	1061	4612	0.0	0.2300520381613183
chr8	JRK	142657459	142666520	0	9062	0	6936	0	-2126	0.0	-0.0
chr8	NAPRT	143574784	143575093	0	310	0	2597	0	2287	0.0	0.0
chr8	NAPRT	143574784	143575345	0	562	0	2597	0	2035	0.0	0.0
chr8	NAPRT	143574786	143575093	0	308	0	2597	0	2289	0.0	0.0
chr8	GFUS	143612617	143613295	0	679	0	3184	0	2505	0.0	0.0
chr8	SCRIB	143792484	143792867	0	384	119039	6452	119039	6068	0.0	19.617501647989453
chr8	PARP10	143986054	143986460	0	407	0	5815	0	5408	0.0	0.0
chr8	VPS28	144423616	144424132	0	517	0	3187	0	2670	0.0	0.0
chr8	VPS28	144424214	144424819	0	606	0	3187	0	2581	0.0	0.0
chr8	VPS28	144424945	144425772	0	828	0	3187	0	2359	0.0	0.0
chr8	TONSL	144438652	144438735	0	84	306	5753	306	5669	0.0	0.05397777385782325
chr8	TONSL	144440350	144440476	0	127	306	5753	306	5626	0.0	0.05439033060789193
chr8	TONSL	144440965	144441111	0	147	306	5753	306	5606	0.0	0.054584373885123084
chr8	RPL8	144791276	144791495	0	220	408	1672	408	1452	0.0	0.2809917355371901
chr8	AC114550.1	8569186	8569816	0	631	1411	2470	1411	1839	0.0	0.7672648178357803
chr8	ERI1	9029791	9033338	0	3548	2647	6398	2647	2850	0.0	0.9287719298245614
chr8	AC022784.1	9189045	9189586	0	542	9095	16960	9095	16418	0.0	0.5539651601900353
chr8	AC022784.1	9325901	9326303	70	403	9095	16960	9025	16557	0.17369727047146402	0.5450866702905116
chr8	NEIL2	11769709	11770335	0	627	0	3371	0	2744	0.0	0.0
chr8	FAM66D	12145422	12145700	0	279	24	7125	24	6846	0.0	0.0035056967572304996
chr8	VPS37A	17280238	17280443	0	206	102	5710	102	5504	0.0	0.018531976744186048
chr8	NPM2	22024723	22025306	0	584	14242	1896	14242	1312	0.0	10.855182926829269
chr8	PDLIM2	22585016	22585162	0	147	102	7319	102	7172	0.0	0.01422197434467373
chr8	C8ORF58	22601971	22602312	0	342	0	3102	0	2760	0.0	0.0
chr8	CCAR2	22618826	22619015	0	190	102	6444	102	6254	0.0	0.016309561880396548
chr8	CCAR2	22619149	22620468	0	1320	102	6444	102	5124	0.0	0.01990632318501171
chr8	R3HCC1	23289865	23290469	53694	605	215658	2235	161964	1630	88.7504132231405	99.3644171779141
chr8	CDCA2	25460239	25460554	0	316	53	3713	53	3397	0.0	0.015602001766264351
chr8	ERLIN2	37744570	37746550	663	1981	6958	8103	6295	6122	0.3346794548207976	1.0282587389741915
chr8	PLPBP	37765525	37765746	0	222	153	2899	153	2677	0.0	0.05715353007097497
chr8	ADAM9	39090046	39091346	0	1301	19580	17281	19580	15980	0.0	1.225281602002503
chr8	GINS4	41541808	41545030	15735	3223	32079	5344	16344	2121	4.882097424759541	7.705799151343705
chr8	GPAT4	41598291	41599304	0	1014	22337	7612	22337	6598	0.0	3.385419824189148
chr8	FNTA	43085159	43085780	0	622	139504	8702	139504	8080	0.0	17.265346534653464
chr8	POMK	43122106	43125767	31920	3662	31920	8233	0	4571	8.716548334243583	0.0
chr8	LINC00293	46848783	46849530	0	748	0	8452	0	7704	0.0	0.0
chr8	LINC00293	46854469	46854791	0	323	0	8452	0	8129	0.0	0.0
chr8	LINC00293	46854763	46855410	0	648	0	8452	0	7804	0.0	0.0
chr8	RP1	54558759	54559320	0	562	346416	15745	346416	15183	0.0	22.816044260027663
chr8	RP1	54679419	54679627	0	209	346416	15745	346416	15536	0.0	22.29763130792997
chr8	AC011124.2	63467141	63469946	0	2806	0	5553	0	2747	0.0	0.0
chr8	LINC01289	63778448	63780922	153	2475	44022	4462	43869	1987	0.06181818181818182	22.078007045797683
chr8	ADHFE1	66453709	66454157	0	449	3	3221	3	2772	0.0	0.0010822510822510823
chr8	MCMDC2	66874325	66874586	0	262	51	6364	51	6102	0.0	0.008357915437561455
chr8	GDAP1	74351273	74351466	0	194	31532	20769	31532	20575	0.0	1.532539489671932
chr8	GDAP1	74361883	74366582	357	4700	31532	20769	31175	16069	0.07595744680851065	1.9400709440537682
chr8	GDAP1	74361883	74363053	357	1171	31532	20769	31175	19598	0.304867634500427	1.5907235432186957
chr8	ZBTB10	80518402	80518579	0	178	0	10129	0	9951	0.0	0.0
chr8	AC100801.1	85885934	85889653	0	3720	0	4745	0	1025	0.0	0.0
chr8	INTS8	94867139	94867337	0	199	7002	7694	7002	7495	0.0	0.9342228152101401
chr8	GRHL2	101492438	101492789	0	352	1020	6069	1020	5717	0.0	0.1784152527549414
chr8	FZD6	103299955	103300284	765	330	5953	4072	5188	3742	2.3181818181818183	1.3864243719935863
chr8	AC103993.1	113615503	113616958	0	1456	0	1586	0	130	0.0	0.0
chr8	COL14A1	120270034	120270174	0	141	101	10245	101	10104	0.0	0.009996041171813142
chr8	LINC00964	124849274	124849953	0	680	1897	10517	1897	9837	0.0	0.19284334654874455
chr8	LINC00964	124943269	124945051	0	1783	1897	10517	1897	8734	0.0	0.21719716052209756
chr8	LINC00964	124943269	124945746	0	2478	1897	10517	1897	8039	0.0	0.2359746237094166
chr8	PVT1	127795195	127796071	0	877	55393	23370	55393	22493	0.0	2.4626772773751835
chr8	PVT1	127854395	127855319	0	925	55393	23370	55393	22445	0.0	2.467943862775674
chr8	PVT1	128049408	128049748	0	341	55393	23370	55393	23029	0.0	2.405358461070824
chr8	PTP4A3	141421387	141422345	0	959	2040	2881	2040	1922	0.0	1.0613943808532778
chr8	THEM6	142735325	142736927	0	1603	0	2125	0	522	0.0	0.0
chr8	GRINA	143991877	143992373	0	497	0	2462	0	1965	0.0	0.0
chr8	MAF1	144106342	144106674	0	333	1376	2299	1376	1966	0.0	0.6998982706002035
chr8	WDR97	144111100	144111486	0	387	553	7698	553	7311	0.0	0.07563944740801531
chr8	MROH1	144261113	144261349	0	237	204	10950	204	10713	0.0	0.019042285074208905
chr8	SLC52A2	144359622	144360493	0	872	61401	3711	61401	2839	0.0	21.627685804860867
chr8	SLC52A2	144358594	144359423	40419	830	61401	3711	20982	2881	48.69759036144578	7.282887886150642
chr8	ADCK5	144391579	144391866	36587	288	95853	2760	59266	2472	127.03819444444444	23.97491909385113
chr8	KIFC2	144472794	144474202	514	1409	2958	4038	2444	2629	0.3647977288857346	0.9296310384176493
chr9	DMRT2	1051613	1052138	0	526	0	3147	0	2621	0.0	0.0
chr9	LINC01231	3198185	3198924	0	740	0	5272	0	4532	0.0	0.0
chr9	CD274	5462833	5463121	12323	289	49657	4115	37334	3826	42.6401384083045	9.75797177208573
chr9	PTENP1-AS	33678089	33681073	0	2985	0	4826	0	1841	0.0	0.0
chr9	CNTFR-AS1	34569511	34571022	0	1512	0	2607	0	1095	0.0	0.0
chr9	ATP8B5P	35438728	35440453	1122	1726	33642	6309	32520	4583	0.6500579374275782	7.0957887846388825
chr9	TMEM8B	35829227	35829955	15885	729	70552	16232	54667	15503	21.790123456790123	3.5262207314713283
chr9	AL353608.3	68326262	68328690	0	2429	0	5290	0	2861	0.0	0.0
chr9	TJP2	69252814	69255187	2708	2374	21732	10925	19024	8551	1.1406908171861836	2.2247690328616536
chr9	FAM189A2	69377369	69377744	0	376	0	5150	0	4774	0.0	0.0
chr9	PCA3	76783704	76785677	51	1974	408	12897	357	10923	0.025835866261398176	0.03268332875583631
chr9	AL354733.2	83858863	83859335	0	473	47	3124	47	2651	0.0	0.017729158807996984
chr9	CTSL	87729572	87731327	0	1756	0	5954	0	4198	0.0	0.0
chr9	CTSL	87730380	87731348	0	969	0	5954	0	4985	0.0	0.0
chr9	CTSL	87730380	87731320	0	941	0	5954	0	5013	0.0	0.0
chr9	CTSL	87729572	87731348	0	1777	0	5954	0	4177	0.0	0.0
chr9	CTSL	87726212	87727729	0	1518	0	5954	0	4436	0.0	0.0
chr9	CTSL	87729572	87730498	0	927	0	5954	0	5027	0.0	0.0
chr9	AL355607.2	91000769	91001901	2680	1133	2680	1533	0	400	2.3654015887025595	0.0
chr9	FGD3	93032768	93034681	0	1914	0	4169	0	2255	0.0	0.0
chr9	CARD19	93110567	93112289	0	1723	0	1748	0	25	0.0	0.0
chr9	AL589843.1	96687076	96687324	0	249	0	2839	0	2590	0.0	0.0
chr9	STRA6LP	97362195	97362441	0	247	430	7167	430	6920	0.0	0.06213872832369942
chr9	STRA6LP	97307735	97308132	306	398	430	7167	124	6769	0.7688442211055276	0.01831880632294283
chr9	INVS	100292325	100293043	102	719	284	7153	182	6434	0.14186369958275383	0.028287224121852656
chr9	SLC44A1	105389032	105397346	0	8315	0	5806	0	-2509	0.0	-0.0
chr9	RGS3	113583449	113584427	0	979	88	11098	88	10119	0.0	0.008696511512995355
chr9	RABEPK	125200541	125200906	0	366	0	3438	0	3072	0.0	0.0
chr9	GAPVD1	125331925	125332060	0	136	153	13657	153	13521	0.0	0.011315731084978922
chr9	LRSAM1	127460876	127461257	970	382	12203	8123	11233	7741	2.5392670157068062	1.4511045084614391
chr9	LRSAM1	127451514	127452084	510	571	12203	8123	11693	7552	0.8931698774080561	1.54833156779661
chr9	LRSAM1	127487494	127487763	1039	270	12203	8123	11164	7853	3.848148148148148	1.4216223099452439
chr9	STXBP1	127694993	127696027	0	1035	131172	8749	131172	7714	0.0	17.004407570650766
chr9	CERCAM	128428929	128429036	56	108	17935	5550	17879	5442	0.5185185185185185	3.2853730246233
chr9	PHYHD1	128941444	128942038	0	595	0	2479	0	1884	0.0	0.0
chr9	USP20	129880112	129881828	0	1717	46	5449	46	3732	0.0	0.01232583065380493
chr9	NUP214	131233453	131233704	92600	252	271524	12057	178924	11805	367.46031746031747	15.156628547225752
chr9	POMT1	131522931	131523799	0	869	45660	6345	45660	5476	0.0	8.338203067932797
chr9	POMT1	131509742	131510415	3413	674	45660	6345	42247	5671	5.063798219584569	7.4496561453006525
chr9	POMT1	131509902	131510415	1426	514	45660	6345	44234	5831	2.77431906614786	7.58600583090379
chr9	POMT1	131511336	131512136	918	801	45660	6345	44742	5544	1.146067415730337	8.07034632034632
chr9	POMT1	131504188	131504649	1086	462	45660	6345	44574	5883	2.3506493506493507	7.576746557878633
chr9	PMPCA	136421831	136423760	0	1930	0	6212	0	4282	0.0	0.0
chr9	CCDC183	136806503	136806867	0	365	641	2690	641	2325	0.0	0.2756989247311828
chr9	MAMDC4	136857978	136858546	0	569	34949	5342	34949	4773	0.0	7.322229205950136
chr9	MAMDC4	136858718	136859132	182	415	34949	5342	34767	4927	0.43855421686746987	7.0564237872944995
chr9	MAMDC4	136859208	136860064	714	857	34949	5342	34235	4485	0.8331388564760793	7.633221850613155
chr9	ARRDC1	137612895	137613510	1004	616	2629	2585	1625	1969	1.62987012987013	0.8252920264093448
chr9	EHMT1	137817438	137818138	0	701	73955	18118	73955	17417	0.0	4.246138829878854
chr9	CBWD1	121088	122090	20154	1003	152803	10402	132649	9399	20.093718843469592	14.113097137993403
chr9	APTX	32973375	32974561	135111	1187	678291	14598	543180	13411	113.82561078348779	40.502572515099544
chr9	FAM219A	34398183	34401122	472379	2940	589887	3788	117508	848	160.6731292517007	138.57075471698113
chr9	VCP	35062002	35062350	662938	349	8048840	8455	7385902	8106	1899.5358166189112	911.1648161855416
chr9	FANCG	35079440	35079942	25405	503	747748	2822	722343	2319	50.50695825049702	311.4890038809832
chr9	PIGO	35091239	35092767	190251	1529	588556	4627	398305	3098	124.4283845650752	128.56843124596514
chr9	STOML2	35100597	35101011	517999	415	2575629	1815	2057630	1400	1248.190361445783	1469.7357142857143
chr9	FAM214B	35107380	35108349	14441	970	359004	3855	344563	2885	14.887628865979382	119.43258232235702
chr9	FAM166B	35562379	35562528	1119	150	5328	1154	4209	1004	7.46	4.192231075697211
chr9	CD72	35615942	35616689	1684	748	13157	2901	11473	2153	2.251336898395722	5.328843474222015
chr9	ARHGEF39	35660093	35662002	346246	1910	507879	5665	161633	3755	181.2806282722513	43.04474034620506
chr9	GBA2	35736866	35737939	200018	1074	724306	4739	524288	3665	186.2364990689013	143.05266030013644
chr9	SPAG8	35809403	35810309	28301	907	36576	2480	8275	1573	31.202866593164277	5.260648442466624
chr9	SPAG8	35810438	35810682	1290	245	36576	2480	35286	2235	5.26530612244898	15.787919463087249
chr9	EXOSC3	37780274	37780880	432046	607	1087417	6782	655371	6175	711.7726523887974	106.13295546558705
chr9	FAM95C	38540568	38541562	4173	995	47876	3767	43703	2772	4.193969849246231	15.765873015873016
chr9	FAM95C	38542311	38543055	15297	745	47876	3767	32579	3022	20.532885906040267	10.78060886829914
chr9	BX255923.2	41102730	41105159	204	2430	204	4157	0	1727	0.08395061728395062	0.0
chr9	AL845472.1	41269915	41273997	0	4083	0	4083	0	0	0.0	0.0
chr9	MAMDC2-AS1	70153133	70154241	0	1109	6553	9867	6553	8758	0.0	0.7482301895409911
chr9	NMRK1	75068995	75070042	0	1048	0	3129	0	2081	0.0	0.0
chr9	AL353743.2	85785993	85786551	0	559	561	7271	561	6712	0.0	0.08358164481525626
chr9	AL353743.2	85786002	85786551	0	550	561	7271	561	6721	0.0	0.08346972176759411
chr9	AL353743.2	85786004	85786551	0	548	561	7271	561	6723	0.0	0.08344489067380634
chr9	LINC02843	88646920	88647660	1107	741	3966	1616	2859	875	1.4939271255060729	3.2674285714285713
chr9	BICD2	92711362	92715463	0	4102	51	6455	51	2353	0.0	0.021674458138546536
chr9	NUTM2F	94320207	94320593	0	387	0	2568	0	2181	0.0	0.0
chr9	PTCH1	95449840	95453620	1663	3781	134377	17222	132714	13441	0.43983073261042055	9.873818912283312
chr9	PTCH1	95443411	95447451	204	4041	134377	17222	134173	13181	0.050482553823311065	10.179273196267355
chr9	HSD17B3	96249909	96250485	0	577	522	2354	522	1777	0.0	0.29375351716375914
chr9	PTCSC2	97805361	97806024	432	664	494	2293	62	1629	0.6506024096385542	0.03806015960712093
chr9	TRMO	97909959	97910616	1055	658	16533	4155	15478	3497	1.6033434650455927	4.426079496711467
chr9	ALDOB	101424842	101425042	0	201	0	2838	0	2637	0.0	0.0
chr9	ELP1	108917546	108919349	0	1804	612	16260	612	14456	0.0	0.04233536247924737
chr9	RNF183	113301671	113302313	0	643	1224	2891	1224	2248	0.0	0.5444839857651246
chr9	KIF12	114093228	114093497	0	270	0	2858	0	2588	0.0	0.0
chr9	ASTN2	116425227	116426088	0	862	41143	8314	41143	7452	0.0	5.521068169618895
chr9	RC3H2	122865348	122865657	0	310	102	11585	102	11275	0.0	0.009046563192904656
chr9	AL157935.2	127885185	127886788	0	1604	989	3832	989	2228	0.0	0.44389587073608616
chr9	PTGES2	128125243	128125441	13435	199	124196	4049	110761	3850	67.51256281407035	28.76909090909091
chr9	CIZ1	128178708	128179415	0	708	70028	7924	70028	7216	0.0	9.704545454545455
chr9	TSC1	132897183	132897610	122505	428	614065	16580	491560	16152	286.2266355140187	30.433382862803366
chr9	GBGT1	133152952	133155312	0	2361	0	4024	0	1663	0.0	0.0
chr9	ABO	133257408	133257542	0	135	0	1706	0	1571	0.0	0.0
chr9	SARDH	133666734	133666870	0	137	43253	5142	43253	5005	0.0	8.641958041958041
chr9	SOHLH1	135693406	135694457	0	1052	72	3499	72	2447	0.0	0.029423784225582346
chr9	TMEM250	136114588	136117024	102	2437	204	3403	102	966	0.04185473943373	0.10559006211180125
chr9	SNHG7	136724657	136725110	255	454	19334	3819	19079	3365	0.5616740088105727	5.669836552748886
chr9	SNHG7	136726310	136727086	18977	777	19334	3819	357	3042	24.423423423423422	0.11735700197238659
chr9	ABCA2	137010192	137010737	759	546	835073	10294	834314	9748	1.39010989010989	85.58822322527698
chr9	ABCA2	137011406	137011749	186	344	835073	10294	834887	9950	0.5406976744186046	83.90824120603016
chr9	FAM166A	137245306	137245853	0	548	153	1454	153	906	0.0	0.16887417218543047
chr9	NSMF	137448224	137449491	0	1268	55	3951	55	2683	0.0	0.020499440924338426
chr10	TUBB8	48614	48912	0	299	0	2879	0	2580	0.0	0.0
chr10	PITRM1	3143388	3143731	152477	344	1244093	11641	1091616	11297	443.2470930232558	96.62883951491547
chr10	LINC02669	3502330	3502851	0	522	462	6362	462	5840	0.0	0.07910958904109588
chr10	LINC02669	3502330	3502866	0	537	462	6362	462	5825	0.0	0.07931330472103004
chr10	KLF6	3775995	3779590	0	3596	9	4846	9	1250	0.0	0.0072
chr10	ASB13	5638866	5640830	1911	1965	1911	3010	0	1045	0.9725190839694656	0.0
chr10	LINC00710	10946785	10947556	0	772	0	6504	0	5732	0.0	0.0
chr10	LINC00710	10946785	10947319	0	535	0	6504	0	5969	0.0	0.0
chr10	LINC00710	10934523	10935413	0	891	0	6504	0	5613	0.0	0.0
chr10	LINC00710	10946785	10948403	0	1619	0	6504	0	4885	0.0	0.0
chr10	LINC00710	10946064	10946600	0	537	0	6504	0	5967	0.0	0.0
chr10	NUDT5	12170716	12170908	612	193	26597	4491	25985	4298	3.1709844559585494	6.045835272219637
chr10	ACBD5	27240318	27240797	0	480	724	11777	724	11297	0.0	0.06408781092325395
chr10	MTPAP	30365148	30365565	51	418	294	8335	243	7917	0.12200956937799043	0.030693444486547934
chr10	MTPAP	30365344	30365565	0	222	294	8335	294	8113	0.0	0.0362381363244176
chr10	ZNF438	30848530	30850367	0	1838	51	4283	51	2445	0.0	0.020858895705521473
chr10	ITGB1	32932514	32933583	0	1070	150	12473	150	11403	0.0	0.013154433043935806
chr10	ZNF248	37828764	37833116	561	4353	459	6037	-102	1684	0.12887663680220537	-0.060570071258907364
chr10	ZWINT	56357437	56358459	0	1023	0	2184	0	1161	0.0	0.0
chr10	ZWINT	56360017	56360383	0	367	0	2184	0	1817	0.0	0.0
chr10	ANK3	60059339	60060006	605	668	87829	22486	87224	21818	0.905688622754491	3.997799981666514
chr10	ANK3	60138516	60139087	306	572	87829	22486	87523	21914	0.534965034965035	3.9939308204800583
chr10	EGR2	62815860	62816366	51	507	51	3602	0	3095	0.10059171597633136	0.0
chr10	DNAJB12	72332829	72335931	3163	3103	5426	5577	2263	2474	1.0193361263293588	0.9147130153597413
chr10	FAM245A	87396563	87398200	0	1638	0	2032	0	394	0.0	0.0
chr10	IDE	92479276	92480916	0	1641	1764	14554	1764	12913	0.0	0.1366065205606753
chr10	PLCE1-AS2	94105574	94106159	424	586	56408	4224	55984	3638	0.7235494880546075	15.388675096206708
chr10	ERLIN1	100185513	100186029	15088	517	17155	3502	2067	2985	29.18375241779497	0.6924623115577889
chr10	SEC31B	100505360	100506201	0	842	102	7409	102	6567	0.0	0.015532206486980357
chr10	PDZD7	101021797	101022385	0	589	7	6620	7	6031	0.0	0.001160669872326314
chr10	PDZD7	101023435	101024068	0	634	7	6620	7	5986	0.0	0.0011693952555963916
chr10	POLL	101584601	101584919	51	319	5033	5429	4982	5110	0.15987460815047022	0.9749510763209394
chr10	NT5C2	103097290	103098984	0	1695	2680	8572	2680	6877	0.0	0.38970481314526684
chr10	C10ORF120	122697708	122698488	54	781	54	1091	0	310	0.06914212548015365	0.0
chr10	IDI2-AS1	1035813	1036893	1732	1081	70418	3053	68686	1972	1.6022201665124884	34.83062880324544
chr10	PRKCQ-AS1	6583804	6584195	0	392	0	5311	0	4919	0.0	0.0
chr10	CELF2	11328925	11334358	0	5434	0	9833	0	4399	0.0	0.0
chr10	AL157392.3	13654352	13655482	0	1131	13373	9029	13373	7898	0.0	1.6932134717650038
chr10	LINC02654	16278070	16278749	0	680	0	2554	0	1874	0.0	0.0
chr10	VIM	17235845	17236379	0	535	72	4730	72	4195	0.0	0.017163289630512515
chr10	VIM	17235168	17236379	0	1212	72	4730	72	3518	0.0	0.02046617396247868
chr10	KIAA1217	24544980	24547843	1785	2864	1785	10748	0	7884	0.6232541899441341	0.0
chr10	GAD2	26300787	26304558	0	3772	0	2871	0	-901	0.0	-0.0
chr10	AL133216.2	38416681	38417204	204	524	19905	7231	19701	6707	0.3893129770992366	2.9373788579096467
chr10	LINC00840	43859526	43860360	0	835	34681	7297	34681	6462	0.0	5.3669142680284745
chr10	ANTXRL	46286997	46287510	0	514	1923	2961	1923	2447	0.0	0.7858602370249285
chr10	C10ORF53	49708360	49710261	102	1902	204	5807	102	3905	0.05362776025236593	0.02612035851472471
chr10	LINC01515	65585484	65585802	0	319	510	17753	510	17434	0.0	0.02925318343466789
chr10	DDX50	68906710	68907007	0	298	0	2690	0	2392	0.0	0.0
chr10	DDX50	68946351	68946847	0	497	0	2690	0	2193	0.0	0.0
chr10	SEC24C	73770279	73770798	88472	520	471877	5320	383405	4800	170.13846153846154	79.87604166666667
chr10	ZSWIM8	73791858	73792852	0	995	51	7868	51	6873	0.0	0.007420340462680052
chr10	SAMD8	75176065	75182123	291848	6059	292516	7145	668	1086	48.16768443637564	0.6151012891344383
chr10	ZNF503-AS1	75358509	75359049	0	541	16636	5296	16636	4755	0.0	3.49863301787592
chr10	CDHR1	84219078	84219621	0	544	51	7747	51	7203	0.0	0.007080383173677634
chr10	LCOR	96949007	96952196	0	3190	3745	26377	3745	23187	0.0	0.1615129167205762
chr10	LCOR	96954952	96958877	204	3926	3745	26377	3541	22451	0.05196128374936322	0.15772125963208766
chr10	LCOR	96954952	96958926	204	3975	3745	26377	3541	22402	0.05132075471698113	0.15806624408534953
chr10	OLMALINC	100381215	100383372	0	2158	51	12654	51	10496	0.0	0.004858993902439024
chr10	TWNK	100989643	100989884	0	242	0	3960	0	3718	0.0	0.0
chr10	GBF1	102375358	102375584	0	227	16712	19267	16712	19040	0.0	0.8777310924369748
chr10	GBF1	102382055	102382899	0	845	16712	19267	16712	18422	0.0	0.9071762023667355
chr10	RPARP-AS1	102451398	102452187	0	790	357	4289	357	3499	0.0	0.10202915118605316
chr10	AS3MT	102890543	102890678	0	136	0	1787	0	1651	0.0	0.0
chr10	PNLIPRP2	116638368	116638480	0	113	5895	1588	5895	1475	0.0	3.9966101694915253
chr10	LINC00867	118357526	118357848	0	323	153	4160	153	3837	0.0	0.0398749022673964
chr10	WDR11	120905875	120906855	102	981	9454	7675	9352	6694	0.10397553516819572	1.3970720047804004
chr10	LINC02641	123361318	123362147	765	830	2193	5335	1428	4505	0.9216867469879518	0.3169811320754717
chr10	AL158835.1	125706581	125707004	0	424	41	4566	41	4142	0.0	0.009898599710284886
chr10	EDRF1	125763300	125764143	0	844	51	7630	51	6786	0.0	0.007515473032714412
chr10	LINC02667	128914758	128915165	0	408	125	1874	125	1466	0.0	0.08526603001364257
chr10	PPP2R2D	131943967	131944145	0	179	369867	7403	369867	7224	0.0	51.19975083056478
chr10	SCART1	133459486	133460170	0	685	0	7075	0	6390	0.0	0.0
chr11	PSMD13	244040	244216	91361	177	1526979	2848	1435618	2671	516.1638418079096	537.4833395731936
chr11	PGGHG	290677	291113	4093	437	30264	5133	26171	4696	9.366132723112129	5.573040885860307
chr11	PKP3	394242	394524	552	283	37195	3762	36643	3479	1.9505300353356891	10.532624317332568
chr11	PTDSS2	490419	491399	130670	981	455275	5471	324605	4490	133.20081549439348	72.29510022271715
chr11	RASSF7	563188	563478	11261	291	88742	2441	77481	2150	38.697594501718214	36.03767441860465
chr11	EPS8L2	709552	710486	561	935	16540	4588	15979	3653	0.6	4.374212975636463
chr11	CRACR2B	828229	828772	153	544	22384	3193	22231	2649	0.28125	8.392223480558702
chr11	CD151	838132	838831	512609	700	1581008	3539	1068399	2839	732.2985714285714	376.3293413173653
chr11	FAM99A	1666701	1667856	51	1156	51	1435	0	279	0.04411764705882353	0.0
chr11	MRPL23	1956255	1956609	0	355	34	2986	34	2631	0.0	0.012922843025465602
chr11	TSSC2	3406498	3407697	102	1200	9692	3680	9590	2480	0.085	3.8669354838709675
chr11	OR51E1	4652487	4655488	0	3002	0	3614	0	612	0.0	0.0
chr11	OR51L1	5002570	5005536	0	2967	0	3556	0	589	0.0	0.0
chr11	TRIM6	5603245	5603735	0	491	153	3973	153	3482	0.0	0.043940264215967834
chr11	TRIM22	5698314	5698545	60	232	2008	4986	1948	4754	0.25862068965517243	0.40976020193521245
chr11	CCKBR	6270645	6272127	0	1483	0	2398	0	915	0.0	0.0
chr11	DNHD1	6497584	6498961	139771	1378	283334	18420	143563	17042	101.43033381712627	8.424069944842154
chr11	DNHD1	6547862	6548402	0	541	283334	18420	283334	17879	0.0	15.847306896358857
chr11	ILK	6608693	6608967	0	275	5780	3225	5780	2950	0.0	1.959322033898305
chr11	OR2AG1	6785017	6791558	51	6542	51	6995	0	453	0.0077957811066952	0.0
chr11	PPFIBP2	7653023	7653756	0	734	0	8897	0	8163	0.0	0.0
chr11	AKIP1	8911188	8911671	0	484	168	2242	168	1758	0.0	0.09556313993174062
chr11	SBF2-AS1	9807847	9811335	10873	3489	12056	4738	1183	1249	3.116365720836916	0.9471577261809447
chr11	ADM	10305679	10306098	0	420	0	2167	0	1747	0.0	0.0
chr11	LINC02752	11182326	11183251	0	926	0	2017	0	1091	0.0	0.0
chr11	LDHAL6A	18476383	18476501	49	119	49	2594	0	2475	0.4117647058823529	0.0
chr11	BDNF-AS	27675296	27676140	918	845	122520	12372	121602	11527	1.0863905325443788	10.549318990196928
chr11	EIF3M	32593865	32595013	0	1149	129386	7442	129386	6293	0.0	20.56030510090577
chr11	QSER1	32931742	32935435	3468	3694	76870	10924	73402	7230	0.9388197076340011	10.152420470262793
chr11	NAT10	34143444	34143528	0	85	140203	5257	140203	5172	0.0	27.108081979891725
chr11	AC044839.1	45723319	45723572	0	254	0	6744	0	6490	0.0	0.0
chr11	SLC35C1	45805148	45806336	51	1189	51	3372	0	2183	0.04289318755256518	0.0
chr11	LARGE2	45922820	45923167	102	348	88759	2871	88657	2523	0.29310344827586204	35.13951644867222
chr11	DGKZ	46374603	46374839	650	237	20198	8820	19548	8583	2.742616033755274	2.2775253407899334
chr11	MDK	46381710	46382133	827	424	4089	2201	3262	1777	1.9504716981132075	1.835678109172763
chr11	ATG13	46668498	46668910	0	413	8037	5435	8037	5022	0.0	1.6003584229390682
chr11	C11ORF49	47161126	47162247	3214	1122	5354	5413	2140	4291	2.864527629233512	0.49871824749475646
chr11	NR1H3	47261546	47262018	99413	473	281701	4063	182288	3590	210.17547568710359	50.776601671309194
chr11	NDUFS3	47580524	47580984	0	461	2995	4322	2995	3861	0.0	0.7757057757057757
chr11	TMX2	57738663	57739039	0	377	0	2143	0	1766	0.0	0.0
chr11	SELENOH	57741808	57741954	0	147	0	1851	0	1704	0.0	0.0
chr11	FAM111A	59143496	59145856	153	2361	107	6384	-46	4023	0.06480304955527319	-0.0114342530449913
chr11	MS4A1	60462184	60462533	0	350	0	4614	0	4264	0.0	0.0
chr11	TMEM132A	60935863	60937159	153	1297	3761	5092	3608	3795	0.117964533538936	0.9507246376811594
chr11	TMEM138	61364251	61364518	0	268	51	4888	51	4620	0.0	0.01103896103896104
chr11	POLR2G	62761794	62762866	0	1073	0	1552	0	479	0.0	0.0
chr11	NUDT22	64226289	64227132	0	844	0	3038	0	2194	0.0	0.0
chr11	DNAJC4	64233893	64234281	0	389	51	2070	51	1681	0.0	0.030339083878643664
chr11	ARL2	65021720	65022184	0	465	51	1837	51	1372	0.0	0.03717201166180758
chr11	VPS51	65107580	65108022	73841	443	200815	4595	126974	4152	166.68397291196388	30.58140655105973
chr11	MRPL49	65125725	65127363	51	1639	4174	2385	4123	746	0.03111653447223917	5.52680965147453
chr11	SCYL1	65538269	65538704	459	436	4238	3914	3779	3478	1.0527522935779816	1.08654399079931
chr11	SIPA1	65646455	65647065	714	611	40736	4641	40022	4030	1.1685761047463175	9.931017369727048
chr11	RELA-DT	65663426	65665543	363862	2118	403843	3732	39981	1614	171.79508970727102	24.771375464684017
chr11	MUS81	65865810	65866439	459	630	1573	4721	1114	4091	0.7285714285714285	0.27230505988755804
chr11	CTSW	65883214	65883741	204	528	5019	1700	4815	1172	0.38636363636363635	4.1083617747440275
chr11	KLC2	66266432	66267859	4305	1428	48687	3969	44382	2541	3.014705882352941	17.466351829988195
chr11	BBS1	66531655	66532219	0	565	13407	5850	13407	5285	0.0	2.536802270577105
chr11	BBS1	66515692	66515933	2923	242	13407	5850	10484	5608	12.078512396694215	1.869472182596291
chr11	SSH3	67306837	67307113	0	277	49	3237	49	2960	0.0	0.016554054054054055
chr11	TBC1D10C	67409406	67410089	0	684	964	4302	964	3618	0.0	0.2664455500276396
chr11	CARNS1	67420608	67420840	0	233	714	5370	714	5137	0.0	0.13899162935565504
chr11	TCIRG1	68042945	68043497	882	553	2776	4293	1894	3740	1.5949367088607596	0.5064171122994653
chr11	IGHMBP2	68936236	68937091	0	856	3517	8643	3517	7787	0.0	0.4516501862077822
chr11	MYEOV	69295232	69297287	0	2056	255	3619	255	1563	0.0	0.16314779270633398
chr11	ANO1	70187737	70189252	611	1516	14658	6051	14047	4535	0.4030343007915567	3.0974641675854464
chr11	IL18BP	71999227	71999662	8008	436	235124	3492	227116	3056	18.36697247706422	74.31806282722513
chr11	FOLR3	72138960	72139149	627	190	930	1275	303	1085	3.3	0.27926267281105993
chr11	INPPL1	72228347	72228498	0	152	51	6501	51	6349	0.0	0.008032761064734604
chr11	INPPL1	72228726	72228847	0	122	51	6501	51	6379	0.0	0.007994983539739771
chr11	INPPL1	72237123	72237796	0	674	51	6501	51	5827	0.0	0.008752359704822379
chr11	RELT	73394235	73394734	459	500	16983	4843	16524	4343	0.918	3.804743265024177
chr11	MOGAT2	75727969	75728989	2713	1021	12496	3996	9783	2975	2.6571988246816844	3.288403361344538
chr11	RAB30-DT	83072622	83073604	0	983	0	6987	0	6004	0.0	0.0
chr11	TMEM126B	85635666	85636536	0	871	11	2156	11	1285	0.0	0.008560311284046693
chr11	MED17	93807500	93809876	0	2377	0	8731	0	6354	0.0	0.0
chr11	LINC02700	94647334	94647578	2382	245	2382	3099	0	2854	9.722448979591837	0.0
chr11	AP000787.1	95231124	95232176	0	1053	0	6723	0	5670	0.0	0.0
chr11	BIRC3	102321836	102325362	122393	3527	124532	7530	2139	4003	34.7017295151687	0.5343492380714464
chr11	BIRC2	102348597	102350749	0	2153	153	3556	153	1403	0.0	0.1090520313613685
chr11	DYNC2H1	103154450	103154809	102	360	4092	15101	3990	14741	0.2833333333333333	0.27067363136829253
chr11	TTC12	113315950	113316315	0	366	0	4931	0	4565	0.0	0.0
chr11	HTR3A	113986517	113987046	0	530	0	2686	0	2156	0.0	0.0
chr11	RNF214	117281893	117282270	9761	378	68990	4317	59229	3939	25.822751322751323	15.036557501904037
chr11	PHLDB1	118644071	118644691	0	621	251388	19655	251388	19034	0.0	13.207313228958705
chr11	VPS11	119081458	119081964	153	507	1173	4315	1020	3808	0.30177514792899407	0.26785714285714285
chr11	HMBS	119092124	119092523	0	400	597	3568	597	3168	0.0	0.1884469696969697
chr11	PDZD3	119186091	119186690	1887	600	62557	3455	60670	2855	3.145	21.25043782837128
chr11	PDZD3	119185474	119185952	59690	479	62557	3455	2867	2976	124.61377870563675	0.9633736559139785
chr11	VWA5A	124115449	124116680	102	1232	102	6379	0	5147	0.08279220779220779	0.0
chr11	AP001993.1	127053337	127054334	0	998	0	9479	0	8481	0.0	0.0
chr11	HRAS	532241	532755	137590	515	356838	1889	219248	1374	267.1650485436893	159.56914119359533
chr11	IRF7	613784	614037	2562	254	64800	2356	62238	2102	10.086614173228346	29.60894386298763
chr11	IRF7	615096	615647	19335	552	64800	2356	45465	1804	35.02717391304348	25.202328159645234
chr11	PIDD1	802681	803647	28805	967	106080	4982	77275	4015	29.788004136504654	19.246575342465754
chr11	CHID1	869213	869956	41518	744	707943	4078	666425	3334	55.803763440860216	199.8875224955009
chr11	H19	1995175	1995998	0	824	0	2821	0	1997	0.0	0.0
chr11	H19	1995875	1996191	0	317	0	2821	0	2504	0.0	0.0
chr11	TRIM21	4384896	4385853	0	958	0	1942	0	984	0.0	0.0
chr11	TRIM3	6457695	6457847	612	153	4384	6639	3772	6486	4.0	0.5815602836879432
chr11	RRP8	6600925	6601602	816	678	969	6926	153	6248	1.2035398230088497	0.024487836107554416
chr11	TPP1	6619195	6619413	2995	219	38502	5275	35507	5056	13.67579908675799	7.022745253164557
chr11	TPP1	6618775	6619267	2322	493	38502	5275	36180	4782	4.709939148073023	7.5658720200752825
chr11	DENND2B	8870953	8871367	0	415	208720	10617	208720	10202	0.0	20.458733581650655
chr11	TMEM41B	9280653	9283593	765	2941	12544	4285	11779	1344	0.26011560693641617	8.764136904761905
chr11	EIF4G2	10808704	10808940	0	237	31748	7294	31748	7057	0.0	4.498795522176562
chr11	ABCC8	17396915	17397313	18644	399	51038	9821	32394	9422	46.72681704260652	3.438123540649544
chr11	ABCC8	17428288	17428670	0	383	51038	9821	51038	9438	0.0	5.40771349862259
chr11	ABCC8	17395851	17397313	36556	1463	51038	9821	14482	8358	24.98701298701299	1.7327111749222301
chr11	ABCC8	17397192	17397797	17546	606	51038	9821	33492	9215	28.953795379537954	3.634508952794357
chr11	ABCC8	17396915	17397797	31202	883	51038	9821	19836	8938	35.33635334088335	2.219288431416424
chr11	ABCC8	17395851	17397797	49114	1947	51038	9821	1924	7874	25.22547508988187	0.2443484886969774
chr11	ABCC8	17460487	17461825	0	1339	51038	9821	51038	8482	0.0	6.017212921480783
chr11	BDNF	27654892	27659658	153	4767	77118	7518	76965	2751	0.032095657646318436	27.977099236641223
chr11	PAX6	31801229	31801776	0	548	62146	17695	62146	17147	0.0	3.6243074590307343
chr11	PAX6	31803397	31803673	1389	277	62146	17695	60757	17418	5.014440433212997	3.4881731542082903
chr11	LMO2	33869345	33869987	0	643	0	2903	0	2260	0.0	0.0
chr11	SLC1A2	35418949	35419558	0	610	7793529	13109	7793529	12499	0.0	623.5322025762061
chr11	PAMR1	35441480	35441693	0	214	0	3879	0	3665	0.0	0.0
chr11	AC103855.2	45532648	45533125	0	478	51	4073	51	3595	0.0	0.014186369958275382
chr11	AMBRA1	46541944	46543398	2346	1455	140410	7626	138064	6171	1.6123711340206186	22.373035164479013
chr11	NUP160	47812063	47812429	971	367	33797	8120	32826	7753	2.645776566757493	4.233973945569457
chr11	OR5A2	59416968	59426412	330897	9445	330897	9445	0	0	35.03409211222869	0.0
chr11	VWCE	61291263	61291576	0	314	510	4782	510	4468	0.0	0.11414503133393017
chr11	CPSF7	61416104	61416519	0	416	1321	4905	1321	4489	0.0	0.2942748941857875
chr11	FTH1	61967311	61967631	0	321	0	1914	0	1593	0.0	0.0
chr11	AP002990.1	62572583	62574908	192219	2326	352327	4072	160108	1746	82.63929492691315	91.69988545246277
chr11	NXF1	62798538	62800486	1156	1949	1207	5978	51	4029	0.5931246793227296	0.012658227848101266
chr11	SNHG1	62852810	62853590	0	781	0	3736	0	2955	0.0	0.0
chr11	SNHG1	62853800	62855216	0	1417	0	3736	0	2319	0.0	0.0
chr11	SNHG1	62851987	62852681	0	695	0	3736	0	3041	0.0	0.0
chr11	SNHG1	62853074	62853590	0	517	0	3736	0	3219	0.0	0.0
chr11	SNHG1	62853800	62854064	0	265	0	3736	0	3471	0.0	0.0
chr11	SNHG1	62853800	62854551	0	752	0	3736	0	2984	0.0	0.0
chr11	SNHG1	62854887	62855885	0	999	0	3736	0	2737	0.0	0.0
chr11	SNHG1	62855423	62855885	0	463	0	3736	0	3273	0.0	0.0
chr11	SNHG1	62852810	62853115	0	306	0	3736	0	3430	0.0	0.0
chr11	SNHG1	62852810	62855216	0	2407	0	3736	0	1329	0.0	0.0
chr11	SNHG1	62854518	62854938	0	421	0	3736	0	3315	0.0	0.0
chr11	SNHG1	62854017	62855216	0	1200	0	3736	0	2536	0.0	0.0
chr11	SNHG1	62854518	62855216	0	699	0	3736	0	3037	0.0	0.0
chr11	SNHG1	62855132	62855885	0	754	0	3736	0	2982	0.0	0.0
chr11	SNHG1	62853551	62855216	0	1666	0	3736	0	2070	0.0	0.0
chr11	SNHG1	62852810	62854551	0	1742	0	3736	0	1994	0.0	0.0
chr11	SNHG1	62854887	62855216	0	330	0	3736	0	3406	0.0	0.0
chr11	SNHG1	62853551	62853833	0	283	0	3736	0	3453	0.0	0.0
chr11	SNHG1	62854017	62854551	0	535	0	3736	0	3201	0.0	0.0
chr11	SNHG1	62853551	62854551	0	1001	0	3736	0	2735	0.0	0.0
chr11	SLC22A8	62993236	62993627	0	392	0	3652	0	3260	0.0	0.0
chr11	SLC22A25	63166043	63168060	0	2018	48	3763	48	1745	0.0	0.027507163323782235
chr11	C11ORF95	63764867	63765254	295838	388	694788	5954	398950	5566	762.4690721649484	71.67624865253323
chr11	SF1	64764605	64766155	0	1551	135	5987	135	4436	0.0	0.03043282236248873
chr11	MEN1	64810813	64811294	2210	482	168530	4392	166320	3910	4.5850622406639	42.53708439897698
chr11	NAALADL1	65053217	65053576	4175	360	135480	3759	131305	3399	11.597222222222221	38.63047955280965
chr11	NAALADL1	65048151	65048457	2384	307	135480	3759	133096	3452	7.765472312703583	38.55619930475087
chr11	SLC25A45	65375191	65376675	159652	1485	320273	4923	160621	3438	107.50976430976431	46.71931355439209
chr11	KCNK7	65592854	65593383	51	530	707	1463	656	933	0.09622641509433963	0.7031082529474812
chr11	KCNK7	65592854	65593874	707	1021	707	1463	0	442	0.692458374142997	0.0
chr11	RELA	65653600	65655762	241026	2163	1911399	4483	1670373	2320	111.43134535367545	719.9883620689656
chr11	RELA	65653601	65655000	106356	1400	1911399	4483	1805043	3083	75.96857142857142	585.4826467726241
chr11	RNASEH2C	65717708	65719809	51	2102	867	4492	816	2390	0.024262607040913417	0.3414225941422594
chr11	EFEMP2	65866440	65867079	102	640	4023	4066	3921	3426	0.159375	1.1444833625218913
chr11	YIF1A	66284579	66284966	51	388	13169	2353	13118	1965	0.13144329896907217	6.675826972010178
chr11	CTSF	66564087	66564648	0	562	24341	3628	24341	3066	0.0	7.939008480104371
chr11	CTSF	66567443	66567662	1017	220	24341	3628	23324	3408	4.622727272727273	6.843896713615023
chr11	NUDT8	67627937	67628400	0	464	204	1484	204	1020	0.0	0.2
chr11	SHANK2	71118828	71119032	0	205	2103	19063	2103	18858	0.0	0.11151765828825963
chr11	NUMA1	72007188	72008845	816	1658	248740	15188	247924	13530	0.49215922798552475	18.324020694752402
chr11	STARD10	72754728	72755142	459	415	51	2748	-408	2333	1.106024096385542	-0.17488212601800257
chr11	OR2AT4	75081752	75090364	714	8613	612	1838	-102	-6775	0.08289794496691048	0.015055350553505535
chr11	GDPD4	77216557	77217314	0	758	777	2911	777	2153	0.0	0.36089177891314445
chr11	CCDC90B	83273792	83273992	0	201	51	5909	51	5708	0.0	0.008934828311142257
chr11	CCDC90B	83273950	83274740	51	791	51	5909	0	5118	0.06447534766118837	0.0
chr11	CREBZF	85663523	85665102	969	1580	1457	4015	488	2435	0.6132911392405064	0.20041067761806983
chr11	CREBZF	85660334	85661749	408	1416	1457	4015	1049	2599	0.288135593220339	0.403616775682955
chr11	TAF1D	93730676	93731216	0	541	188	5700	188	5159	0.0	0.03644117076952898
chr11	MTMR2	95862271	95865676	204	3406	3022	10675	2818	7269	0.05989430416911333	0.38767368276241576
chr11	CCDC82	96383961	96386293	0	2333	0	14215	0	11882	0.0	0.0
chr11	CASP12	104892330	104892503	0	174	17	1795	17	1621	0.0	0.010487353485502776
chr11	CASP1	105025507	105026356	0	850	0	3706	0	2856	0.0	0.0
chr11	ALG9	111782194	111786520	204	4327	4268	7995	4064	3668	0.04714582851860411	1.1079607415485277
chr11	SLC37A4	119027627	119027872	263	246	2425	4259	2162	4013	1.0691056910569106	0.5387490655370047
chr11	LINC02744	119987951	119988901	0	951	0	1183	0	232	0.0	0.0
chr11	MIR100HG	122064179	122066434	51	2256	1420	24445	1369	22189	0.022606382978723406	0.06169723736986795
chr11	TMEM218	125102131	125102809	0	679	0	4681	0	4002	0.0	0.0
chr11	ACRV1	125677796	125678297	0	502	663	1967	663	1465	0.0	0.45255972696245733
chr11	ARHGAP32	128972452	128975002	0	2551	88	11572	88	9021	0.0	0.009755016073606031
chr11	B3GAT1	134387547	134387940	0	394	0	11757	0	11363	0.0	0.0
chr12	AC005906.2	5021687	5022694	0	1008	0	7869	0	6861	0.0	0.0
chr12	CD9	6235475	6236275	0	801	0	4900	0	4099	0.0	0.0
chr12	TAPBPL	6457405	6457744	0	340	51	3198	51	2858	0.0	0.017844646606018196
chr12	PTPN6	6954804	6954994	31268	191	435502	4799	404234	4608	163.7068062827225	87.72439236111111
chr12	PHC1	8922632	8922788	0	157	72809	5613	72809	5456	0.0	13.34475806451613
chr12	PHC1	8932562	8933350	55222	789	72809	5613	17587	4824	69.98986058301648	3.6457296849087895
chr12	AC092821.3	9567489	9569202	1461	1714	35540	5997	34079	4283	0.8523920653442241	7.956805977118842
chr12	CLEC2D	9692827	9693948	102	1122	102	6863	0	5741	0.09090909090909091	0.0
chr12	GABARAPL1	10213835	10214187	0	353	0	3148	0	2795	0.0	0.0
chr12	GABARAPL1	10212882	10213219	0	338	0	3148	0	2810	0.0	0.0
chr12	GABARAPL1	10213428	10214187	0	760	0	3148	0	2388	0.0	0.0
chr12	FAM234B	13080624	13083449	969	2826	119837	6636	118868	3810	0.34288747346072185	31.198950131233595
chr12	PTPRO	15594936	15597399	0	2464	51	18862	51	16398	0.0	0.0031101353823637027
chr12	DDX11	31103576	31104791	0	1216	102	7413	102	6197	0.0	0.016459577214781345
chr12	IRAK4	43772911	43773072	0	162	51	5626	51	5464	0.0	0.009333821376281113
chr12	LINC02156	47414659	47415232	0	574	153	2804	153	2230	0.0	0.06860986547085202
chr12	SLC48A1	47780144	47782751	306	2608	306	4924	0	2316	0.11733128834355828	0.0
chr12	PFKM	48134942	48135383	0	442	1671	6825	1671	6383	0.0	0.26178912736957544
chr12	PFKM	48122646	48122859	51	214	1671	6825	1620	6611	0.2383177570093458	0.24504613522916352
chr12	TROAP	49330144	49331407	954122	1264	1269930	3637	315808	2373	754.8433544303797	133.08386009270964
chr12	TROAP	49330144	49330943	731352	800	1269930	3637	538578	2837	914.19	189.8406767712372
chr12	LINC02395	49923781	49924513	204	733	85306	6673	85102	5940	0.2783083219645293	14.326936026936027
chr12	LINC02395	49921925	49923681	2019	1757	85306	6673	83287	4916	1.1491178144564598	16.942026037428803
chr12	AQP6	49975464	49977139	7654	1676	17948	4743	10294	3067	4.566825775656325	3.3563743071405283
chr12	LARP4	50441589	50441643	0	55	97448	8113	97448	8058	0.0	12.09332340531149
chr12	TMPRSS12	50885245	50887884	0	2640	474	3340	474	700	0.0	0.6771428571428572
chr12	DAZAP2	51240870	51241116	84	247	84	3807	0	3560	0.340080971659919	0.0
chr12	TNS2	53059046	53060258	0	1213	0	7370	0	6157	0.0	0.0
chr12	TNS2	53060674	53061264	0	591	0	7370	0	6779	0.0	0.0
chr12	HNRNPA1	54283811	54283967	0	157	0	4239	0	4082	0.0	0.0
chr12	HNRNPA1	54283078	54283234	0	157	0	4239	0	4082	0.0	0.0
chr12	MUCL1	54856769	54856892	0	124	51	3979	51	3855	0.0	0.013229571984435798
chr12	OR9K2	55129825	55132750	0	2926	0	3123	0	197	0.0	0.0
chr12	TMEM198B	55832958	55833541	0	584	0	4040	0	3456	0.0	0.0
chr12	TMEM198B	55834850	55836246	0	1397	0	4040	0	2643	0.0	0.0
chr12	TMEM198B	55830840	55831349	0	510	0	4040	0	3530	0.0	0.0
chr12	CDK2	55966830	55967934	0	1105	102	3698	102	2593	0.0	0.039336675665252605
chr12	ERBB3	56098499	56098905	0	407	4079	8025	4079	7618	0.0	0.5354423733263324
chr12	MYL6	56158357	56158711	930	355	2762	3310	1832	2955	2.619718309859155	0.6199661590524534
chr12	MYL6	56158361	56158711	930	351	2762	3310	1832	2959	2.6495726495726495	0.6191280838120987
chr12	SLC39A5	56231203	56231561	306	359	306	2914	0	2555	0.8523676880222841	0.0
chr12	SHMT2	57234002	57234726	0	725	0	3713	0	2988	0.0	0.0
chr12	MARS1	57515919	57516337	0	419	247514	6060	247514	5641	0.0	43.87768126218756
chr12	MARS1	57516244	57516655	0	412	247514	6060	247514	5648	0.0	43.823300283286116
chr12	MARS1	57515919	57516158	0	240	247514	6060	247514	5820	0.0	42.52817869415808
chr12	MBD6	57524028	57524416	0	389	102	4948	102	4559	0.0	0.02237332748409739
chr12	KIF5A	57582601	57583215	0	615	105466	8616	105466	8001	0.0	13.181602299712535
chr12	PIP4K2C	57601525	57603418	53412	1894	92982	3262	39570	1368	28.200633579725448	28.92543859649123
chr12	DTX3	57605988	57606252	7592	265	46673	3005	39081	2740	28.649056603773584	14.263138686131386
chr12	OS9	57715759	57716193	946	435	7815	4766	6869	4331	2.174712643678161	1.5860078503809745
chr12	TSFM	57783614	57784170	1419	557	1745	3221	326	2664	2.547576301615799	0.12237237237237238
chr12	RASSF3	64610512	64610743	0	232	1692	4232	1692	4000	0.0	0.423
chr12	RAB3IP	69812777	69813033	0	257	24835	10469	24835	10212	0.0	2.431942812377595
chr12	PPFIA2-AS1	81292342	81292524	0	183	0	2017	0	1834	0.0	0.0
chr12	SOCS2	93572684	93576206	0	3523	204	4478	204	955	0.0	0.2136125654450262
chr12	NEDD1	96907603	96907856	0	254	153	4482	153	4228	0.0	0.03618732261116367
chr12	RMST	97492460	97494002	0	1543	65	10114	65	8571	0.0	0.007583712518959281
chr12	SLC25A3	98593624	98594135	0	512	306	7682	306	7170	0.0	0.042677824267782424
chr12	SLC25A3	98593685	98594135	0	451	306	7682	306	7231	0.0	0.042317798368137184
chr12	APAF1	98727172	98727316	10	145	112	7025	102	6880	0.06896551724137931	0.014825581395348838
chr12	RAD9B	110530524	110532086	0	1563	0	3723	0	2160	0.0	0.0
chr12	OAS2	113009086	113011723	0	2638	306	5140	306	2502	0.0	0.1223021582733813
chr12	RFC5	118017689	118018053	0	365	0	3264	0	2899	0.0	0.0
chr12	DYNLL1	120496112	120496553	0	442	0	2491	0	2049	0.0	0.0
chr12	RNF10	120534355	120534968	169086	614	481108	5535	312022	4921	275.3843648208469	63.40621824832351
chr12	HNF1A	120999267	120999627	1480	361	191671	4197	190191	3836	4.099722991689751	49.580552659019816
chr12	P2RX7	121177146	121177446	1373	301	80309	5559	78936	5258	4.561461794019934	15.01255230125523
chr12	OGFOD2	122978324	122978569	1298	246	44735	3734	43437	3488	5.276422764227642	12.453268348623853
chr12	ARL6IP4	122982468	122982909	1020	442	2579	2195	1559	1753	2.3076923076923075	0.8893325727324587
chr12	ARL6IP4	122982468	122982908	1020	441	2579	2195	1559	1754	2.312925170068027	0.8888255416191562
chr12	LINC02359	126096007	126096366	0	360	51	9009	51	8649	0.0	0.005896635449184877
chr12	LINC00943	126745005	126746256	0	1252	0	8509	0	7257	0.0	0.0
chr12	LINC00943	126744769	126745332	0	564	0	8509	0	7945	0.0	0.0
chr12	LINC00943	126744769	126746256	0	1488	0	8509	0	7021	0.0	0.0
chr12	LINC00943	126744769	126745336	0	568	0	8509	0	7941	0.0	0.0
chr12	LINC02368	128120538	128121952	0	1415	0	2377	0	962	0.0	0.0
chr12	EP400P1	132103996	132105304	0	1309	0	11921	0	10612	0.0	0.0
chr12	FBRSL1	132574318	132574564	2553	247	69289	9402	66736	9155	10.336032388663968	7.289568541780448
chr12	P2RX2	132621474	132621972	9239	499	35491	1867	26252	1368	18.51503006012024	19.190058479532162
chr12	P2RX2	132621618	132621972	8352	355	35491	1867	27139	1512	23.526760563380282	17.949074074074073
chr12	ZNF10	133130610	133131014	4204	405	40038	5508	35834	5103	10.380246913580248	7.0221438369586515
chr12	AC026369.1	143238	144569	0	1332	0	5449	0	4117	0.0	0.0
chr12	CD27-AS1	6446960	6448150	1196	1191	421931	3028	420735	1837	1.0041981528127624	229.03375068045727
chr12	VAMP1	6462236	6464941	765	2706	765	3275	0	569	0.2827050997782705	0.0
chr12	CHD4	6583026	6583378	0	353	844242	11254	844242	10901	0.0	77.44628933125401
chr12	PHB2	6967675	6968021	32327	347	427344	2236	395017	1889	93.16138328530259	209.11434621492853
chr12	LPCAT3	6977366	6978507	882255	1142	4462196	4160	3579941	3018	772.5525394045534	1186.1964877402254
chr12	CD163	7487358	7488087	102	730	204	5760	102	5030	0.13972602739726028	0.020278330019880716
chr12	LINC00937	8390269	8390969	204	701	8293	5660	8089	4959	0.29101283880171186	1.6311756402500504
chr12	PZP	9202318	9202684	0	367	1020	6291	1020	5924	0.0	0.17218095881161377
chr12	CLEC7A	10116776	10118590	0	1815	0	3288	0	1473	0.0	0.0
chr12	CLEC7A	10129979	10130257	0	279	0	3288	0	3009	0.0	0.0
chr12	PRB3	11267175	11268148	0	974	51	1390	51	416	0.0	0.12259615384615384
chr12	PRB4	11308220	11308882	408	663	408	927	0	264	0.6153846153846154	0.0
chr12	PRB1	11353073	11354002	0	930	0	1317	0	387	0.0	0.0
chr12	MANSC1	12343091	12343414	0	324	204	5721	204	5397	0.0	0.03779877709838799
chr12	EPS8	15682892	15684302	0	1411	3754	8578	3754	7167	0.0	0.5237895911818055
chr12	PLCZ1	18701500	18701776	0	277	0	2968	0	2691	0.0	0.0
chr12	RASSF8-AS1	25952757	25955241	12	2485	26179	9597	26167	7112	0.00482897384305835	3.6792744656917886
chr12	CAPRIN2	30714958	30716676	204	1719	204	8052	0	6333	0.11867364746945899	0.0
chr12	CAPRIN2	30719078	30720915	0	1838	204	8052	204	6214	0.0	0.03282909559060187
chr12	NELL2	44875814	44876315	0	502	22	6365	22	5863	0.0	0.00375234521575985
chr12	PCED1B-AS1	47216164	47216434	0	271	0	1838	0	1567	0.0	0.0
chr12	DDX23	48836568	48837037	0	470	51	4903	51	4433	0.0	0.011504624407850215
chr12	RND1	48857144	48858241	0	1098	0	3952	0	2854	0.0	0.0
chr12	WNT10B	48967945	48968319	0	375	51	2607	51	2232	0.0	0.0228494623655914
chr12	PRKAG1	49002273	49003006	0	734	51	3614	51	2880	0.0	0.017708333333333333
chr12	TUBA1A	49186309	49186833	0	525	255	3106	255	2581	0.0	0.09879891514916699
chr12	KRT72	52585588	52586172	9968	585	9968	2164	0	1579	17.03931623931624	0.0
chr12	KRT4	52813596	52814116	0	521	0	2886	0	2365	0.0	0.0
chr12	AC068888.1	53045599	53046061	0	463	0	5374	0	4911	0.0	0.0
chr12	AAAS	53320564	53321257	2499	694	2530	4055	31	3361	3.6008645533141213	0.009223445403153823
chr12	AAAS	53307844	53308133	0	290	2530	4055	2530	3765	0.0	0.6719787516600265
chr12	MAP3K12	53486946	53487428	0	483	408	7186	408	6703	0.0	0.06086826793972848
chr12	PMEL	55956948	55957671	51	724	180	3339	129	2615	0.07044198895027624	0.04933078393881453
chr12	SMARCC2	56164302	56164731	2142	430	18364	7617	16222	7187	4.981395348837209	2.2571309308473633
chr12	ANKRD52	56237806	56243392	153	5587	297	8841	144	3254	0.02738500089493467	0.044253226797787336
chr12	STAT2	56342617	56343531	221	915	8810	4706	8589	3791	0.24153005464480876	2.2656291216037983
chr12	GLS2	56475623	56475977	0	355	1146	3878	1146	3523	0.0	0.32529094521714447
chr12	BAZ2A	56615013	56615607	3590	595	302825	10465	299235	9870	6.033613445378151	30.317629179331306
chr12	DDIT3	57517268	57517753	0	486	0	1311	0	825	0.0	0.0
chr12	B4GALNT1	57631199	57631364	306	166	1115704	7003	1115398	6837	1.8433734939759037	163.14143630247185
chr12	AC083805.1	57871995	57872870	0	876	165128	5555	165128	4679	0.0	35.29130156016243
chr12	GIHCG	57935838	57936175	3500	338	47654	3815	44154	3477	10.355029585798816	12.698878343399482
chr12	TMBIM4	66138723	66138769	0	47	153	2161	153	2114	0.0	0.07237464522232734
chr12	ZFC3H1	71611057	71611887	0	831	31	9466	31	8635	0.0	0.003590040532715692
chr12	ZFC3H1	71656342	71657301	0	960	31	9466	31	8506	0.0	0.0036444862450035267
chr12	TRHDE-AS1	72261197	72264621	612	3425	591	8148	-21	4723	0.17868613138686132	-0.004446326487402075
chr12	TRHDE-AS1	72253550	72254614	0	1065	591	8148	591	7083	0.0	0.08343922066920796
chr12	TRHDE-AS1	72253550	72255677	102	2128	591	8148	489	6020	0.047932330827067667	0.08122923588039867
chr12	PAWR	79584878	79592693	0	7816	3999	6904	3999	-912	0.0	-4.384868421052632
chr12	CEP83	94312913	94313017	0	105	0	6852	0	6747	0.0	0.0
chr12	CEP83	94412317	94412591	0	275	0	6852	0	6577	0.0	0.0
chr12	GOLGA2P5	100157164	100157445	0	282	177	6935	177	6653	0.0	0.026604539305576432
chr12	GOLGA2P5	100157164	100157739	0	576	177	6935	177	6359	0.0	0.027834565183204905
chr12	C12ORF42	103267852	103268962	0	1111	0	4757	0	3646	0.0	0.0
chr12	ALKBH2	109092506	109093472	0	967	138	1630	138	663	0.0	0.2081447963800905
chr12	MMAB	109561039	109561329	0	291	0	6029	0	5738	0.0	0.0
chr12	TRPV4	109814410	109814796	0	387	0	3893	0	3506	0.0	0.0
chr12	MAPKAPK5-AS1	111841326	111841710	0	385	1380	2732	1380	2347	0.0	0.587984661269706
chr12	PXN	120216272	120217116	1326	845	16239	7481	14913	6636	1.5692307692307692	2.2472875226039783
chr12	KDM2B	121429508	121430469	0	962	81393	13372	81393	12410	0.0	6.558662369057212
chr12	ZCCHC8	122483278	122483563	0	286	33165	7908	33165	7622	0.0	4.351220152191026
chr12	UBC	124911645	124913774	2550	2130	37362	2504	34812	374	1.1971830985915493	93.08021390374331
chr12	LINC00939	125966199	125967342	16	1144	255	6810	239	5666	0.013986013986013986	0.04218143310977762
chr12	LINC00939	125961741	125963083	0	1343	255	6810	255	5467	0.0	0.0466434973477227
chr13	SACS	23328829	23341690	51	12862	255	15925	204	3063	0.003965168714041362	0.06660137120470128
chr13	C1QTNF9B	23891098	23892061	0	964	64	1589	64	625	0.0	0.1024
chr13	LINC00412	27236281	27236587	0	307	2397	654	2397	347	0.0	6.9077809798270895
chr13	HSPH1	31136624	31137524	816	901	2499	6340	1683	5439	0.9056603773584906	0.3094318808604523
chr13	N4BP2L2	32538617	32538825	0	209	102	10496	102	10287	0.0	0.009915427238261883
chr13	N4BP2L2	32538617	32538792	0	176	102	10496	102	10320	0.0	0.009883720930232558
chr13	TRPC4	37636842	37637625	0	784	364	3351	364	2567	0.0	0.14179976626412155
chr13	TRPC4	37639039	37639299	0	261	364	3351	364	3090	0.0	0.11779935275080906
chr13	TPT1	45340711	45341158	0	448	102	6154	102	5706	0.0	0.017875920084121977
chr13	DHRS12	51767994	51769293	0	1300	0	3227	0	1927	0.0	0.0
chr13	ATP7B	51973934	51975168	51	1235	102820	13652	102769	12417	0.04129554655870445	8.2764757993074
chr13	OR7E104P	63839748	63841623	0	1876	0	4378	0	2502	0.0	0.0
chr13	LINC00393	73545900	73546841	0	942	2329	5042	2329	4100	0.0	0.5680487804878048
chr13	DOCK9	98855897	98860522	204	4626	4962	10506	4758	5880	0.04409857328145266	0.8091836734693878
chr13	AL390755.1	110045432	110046075	0	644	0	4212	0	3568	0.0	0.0
chr13	COL4A1	110209888	110210212	0	325	51	12365	51	12040	0.0	0.004235880398671096
chr13	FO681491.1	18413722	18416214	0	2493	0	3454	0	961	0.0	0.0
chr13	ZMYM2	19993062	19993919	0	858	70	12671	70	11813	0.0	0.005925675103699314
chr13	IFT88	20601704	20601933	0	230	61635	6077	61635	5847	0.0	10.541303232426886
chr13	IFT88	20567669	20567997	21918	329	61635	6077	39717	5748	66.62006079027356	6.909707724425887
chr13	MIPEPP3	21301418	21301618	1117	201	1117	622	0	421	5.557213930348259	0.0
chr13	TPT1-AS1	45379194	45380001	0	808	51	8229	51	7421	0.0	0.006872389165880609
chr13	TPT1-AS1	45378529	45380001	0	1473	51	8229	51	6756	0.0	0.007548845470692718
chr13	TPT1-AS1	45378529	45379335	0	807	51	8229	51	7422	0.0	0.0068714632174616
chr13	DLEU1	50527865	50528534	0	670	131553	22973	131553	22303	0.0	5.898444155494777
chr13	RNASEH2B	50953904	50956503	0	2600	1275	19088	1275	16488	0.0	0.07732896652110625
chr13	EDNRB-AS1	77833364	77834990	0	1627	1245	3697	1245	2070	0.0	0.6014492753623188
chr13	LINC01068	79570562	79571445	0	884	0	1015	0	131	0.0	0.0
chr13	MBNL2	97346803	97347067	0	265	102	4919	102	4654	0.0	0.02191663085517834
chr13	ITGBL1	101453882	101454100	0	219	0	6189	0	5970	0.0	0.0
chr13	ITGBL1	101567698	101567845	0	148	0	6189	0	6041	0.0	0.0
chr13	TPP2	102644908	102646390	51	1483	51	8266	0	6783	0.03438975050573163	0.0
chr13	LINC00343	105718474	105719202	0	729	0	12772	0	12043	0.0	0.0
chr13	LINC00343	105718474	105718852	0	379	0	12772	0	12393	0.0	0.0
chr13	LINC00343	105706848	105707629	0	782	0	12772	0	11990	0.0	0.0
chr13	LINC00343	105706861	105707629	0	769	0	12772	0	12003	0.0	0.0
chr13	LINC00343	105706873	105707629	0	757	0	12772	0	12015	0.0	0.0
chr13	LINC00343	105730314	105731715	0	1402	0	12772	0	11370	0.0	0.0
chr13	LINC00343	105706875	105707629	0	755	0	12772	0	12017	0.0	0.0
chr13	LINC00343	105706889	105707629	0	741	0	12772	0	12031	0.0	0.0
chr13	LINC00343	105706896	105707629	0	734	0	12772	0	12038	0.0	0.0
chr13	LINC00343	105706898	105707629	0	732	0	12772	0	12040	0.0	0.0
chr13	LINC00343	105706899	105707629	0	731	0	12772	0	12041	0.0	0.0
chr13	LINC01070	112198230	112201000	0	2771	0	2831	0	60	0.0	0.0
chr14	OR4K2	19878941	19883932	12267	4992	13695	7052	1428	2060	2.457331730769231	0.6932038834951456
chr14	OR4K2	19876244	19883932	13287	7689	13695	7052	408	-637	1.7280530628170112	-0.640502354788069
chr14	METTL17	20990229	20990598	0	370	1020	3390	1020	3020	0.0	0.33774834437086093
chr14	METTL17	20993117	20994063	0	947	1020	3390	1020	2443	0.0	0.4175194433074089
chr14	METTL17	20994793	20995233	0	441	1020	3390	1020	2949	0.0	0.34587995930824006
chr14	METTL17	20995900	20996292	0	393	1020	3390	1020	2997	0.0	0.34034034034034033
chr14	ABHD4	22603389	22603762	0	374	0	3045	0	2671	0.0	0.0
chr14	MRPL52	22829886	22830110	0	225	0	2769	0	2544	0.0	0.0
chr14	DHRS4L2	24001383	24001517	0	135	7618	2428	7618	2293	0.0	3.3222852158744005
chr14	CPNE6	24074050	24074365	0	316	0	3677	0	3361	0.0	0.0
chr14	PCK2	24094310	24094845	0	536	0	3751	0	3215	0.0	0.0
chr14	DCAF11	24115381	24115749	0	369	1397	5675	1397	5306	0.0	0.26328684508104033
chr14	DCAF11	24115381	24115726	0	346	1397	5675	1397	5329	0.0	0.2621504972790392
chr14	DCAF11	24115325	24115749	0	425	1397	5675	1397	5250	0.0	0.2660952380952381
chr14	REC8	24179799	24180254	0	456	23	3607	23	3151	0.0	0.0072992700729927005
chr14	GMPR2	24238588	24239242	0	655	51	2910	51	2255	0.0	0.02261640798226164
chr14	GMPR2	24238245	24239239	0	995	51	2910	51	1915	0.0	0.026631853785900782
chr14	GMPR2	24238245	24239242	0	998	51	2910	51	1912	0.0	0.026673640167364017
chr14	NFATC4	24369152	24370594	0	1443	518	7075	518	5632	0.0	0.09197443181818182
chr14	NFATC4	24376293	24378001	153	1709	518	7075	365	5366	0.08952603861907549	0.06802087215803206
chr14	SCFD1	30674983	30676855	0	1873	0	20324	0	18451	0.0	0.0
chr14	SCFD1	30705822	30708065	0	2244	0	20324	0	18080	0.0	0.0
chr14	COCH	30874558	30874972	0	415	0	3999	0	3584	0.0	0.0
chr14	SRP54	34982681	34983215	51	535	11261	8450	11210	7915	0.09532710280373832	1.416298168035376
chr14	PRPF39	45096423	45096758	0	336	0	4642	0	4306	0.0	0.0
chr14	KLHDC2	49779594	49779806	0	213	116	6332	116	6119	0.0	0.018957345971563982
chr14	AL139317.5	52791784	52792326	0	543	32562	6856	32562	6313	0.0	5.157928084904166
chr14	AL365295.1	53169033	53169777	0	745	95704	14298	95704	13553	0.0	7.061462406847192
chr14	FAM71D	67208201	67208449	0	249	1684	4520	1684	4271	0.0	0.3942870522125966
chr14	SLC39A9	69458362	69462381	0	4020	306	7148	306	3128	0.0	0.09782608695652174
chr14	SRSF5	69771193	69772005	765	813	3958	3622	3193	2809	0.940959409594096	1.1367034531861873
chr14	LINC01146	88044614	88045481	0	868	0	9300	0	8432	0.0	0.0
chr14	SPATA7	88437837	88438455	0	619	2237	6106	2237	5487	0.0	0.4076909057772918
chr14	ZC3H14	88567857	88568153	0	297	0	20176	0	19879	0.0	0.0
chr14	LINC00642	90456441	90457158	306	718	23015	5124	22709	4406	0.42618384401114207	5.154108034498411
chr14	RIN3	92651581	92653075	140	1495	7198	5916	7058	4421	0.09364548494983277	1.5964713865641258
chr14	RIN3	92684986	92688049	0	3064	7198	5916	7198	2852	0.0	2.5238429172510517
chr14	SERPINA5	94581425	94581710	102	286	2600	3760	2498	3474	0.35664335664335667	0.719055843408175
chr14	TCL6	95668125	95669617	102	1493	2040	10388	1938	8895	0.06831882116543872	0.2178752107925801
chr14	AL133467.3	95691267	95692628	0	1362	102	3681	102	2319	0.0	0.04398447606727038
chr14	AL137786.1	96594663	96595763	0	1101	102	2863	102	1762	0.0	0.05788876276958002
chr14	AL137786.1	96592749	96593249	0	501	102	2863	102	2362	0.0	0.04318374259102455
chr14	AL137786.1	96592755	96593249	0	495	102	2863	102	2368	0.0	0.04307432432432432
chr14	AL137786.1	96592761	96593249	0	489	102	2863	102	2374	0.0	0.04296545914069082
chr14	AL137786.1	96592767	96593249	0	483	102	2863	102	2380	0.0	0.04285714285714286
chr14	LINC00618	96945048	96945394	0	347	0	703	0	356	0.0	0.0
chr14	MEG3	100829033	100829749	2736	717	138632	9744	135896	9027	3.8158995815899583	15.054392378420294
chr14	MEG3	100829033	100831534	4896	2502	138632	9744	133736	7242	1.9568345323741008	18.46672190002762
chr14	MEG3	100834631	100835549	47862	919	138632	9744	90770	8825	52.08052230685528	10.28555240793201
chr14	MEG8	100959801	100961132	102	1332	16860	24817	16758	23485	0.07657657657657657	0.7135618479880775
chr14	MEG8	100935771	100937488	0	1718	16860	24817	16860	23099	0.0	0.7299017273475042
chr14	MEG8	100986618	100987630	1428	1013	16860	24817	15432	23804	1.4096742349457059	0.648294404301798
chr14	DYNC1H1	102050070	102050773	0	704	44258	31680	44258	30976	0.0	1.4287835743801653
chr14	EIF5	103334236	103334597	0	362	58325	6699	58325	6337	0.0	9.203881963074009
chr14	TDRD9	104032016	104032087	0	72	122224	5526	122224	5454	0.0	22.40997433076641
chr14	INF2	104714202	104714856	0	655	51	13399	51	12744	0.0	0.004001883239171375
chr14	LINC02298	105095002	105095768	0	767	0	3493	0	2726	0.0	0.0
chr14	TEP1	20365666	20368559	153	2894	222	11420	69	8526	0.05286800276434001	0.00809289232934553
chr14	TEP1	20377279	20377492	0	214	222	11420	222	11206	0.0	0.01981081563448153
chr14	PIP4P1	20457857	20458702	0	846	0	3028	0	2182	0.0	0.0
chr14	RNASE9	20556092	20558650	0	2559	0	2714	0	155	0.0	0.0
chr14	HNRNPC	21210555	21211306	0	752	102	5164	102	4412	0.0	0.023118766999093383
chr14	HNRNPC	21263310	21263829	0	520	102	5164	102	4644	0.0	0.021963824289405683
chr14	CHD8	21430800	21431858	0	1059	0	13518	0	12459	0.0	0.0
chr14	METTL3	21503172	21503577	0	406	0	4373	0	3967	0.0	0.0
chr14	METTL3	21499024	21499600	0	577	0	4373	0	3796	0.0	0.0
chr14	PRMT5	22920528	22921056	0	529	0	3100	0	2571	0.0	0.0
chr14	C14ORF93	22998426	22999402	0	977	0	3210	0	2233	0.0	0.0
chr14	C14ORF93	22998426	22999156	0	731	0	3210	0	2479	0.0	0.0
chr14	SLC7A8	23137920	23138024	0	105	0	4274	0	4169	0.0	0.0
chr14	SLC22A17	23351947	23352451	0	505	296834	4288	296834	3783	0.0	78.46523922812582
chr14	EFS	23359316	23360039	0	724	6203	3242	6203	2518	0.0	2.4634630659253376
chr14	TINF2	24239642	24240155	0	514	0	2610	0	2096	0.0	0.0
chr14	DHRS1	24292183	24292784	0	602	0	4668	0	4066	0.0	0.0
chr14	ADCY4	24334493	24335071	0	579	0	7362	0	6783	0.0	0.0
chr14	ADCY4	24322065	24322708	0	644	0	7362	0	6718	0.0	0.0
chr14	RALGAPA1	35688458	35690003	510	1546	8964	14305	8454	12759	0.3298835705045278	0.6625911121561251
chr14	SEC23A	39103031	39103233	0	203	51	7049	51	6846	0.0	0.007449605609114811
chr14	AL627171.2	49861175	49862316	51	1142	51	1815	0	673	0.0446584938704028	0.0
chr14	AL627171.2	49861175	49861896	0	722	51	1815	51	1093	0.0	0.04666056724611162
chr14	LINC00520	55793045	55793456	0	412	408	2977	408	2565	0.0	0.15906432748538013
chr14	OTX2	56800738	56802355	0	1618	0	2555	0	937	0.0	0.0
chr14	OTX2	56810158	56810448	0	291	0	2555	0	2264	0.0	0.0
chr14	PIGH	67593742	67593952	0	211	0	2424	0	2213	0.0	0.0
chr14	MED6	70583220	70584943	0	1724	0	3828	0	2104	0.0	0.0
chr14	ZFYVE1	72969450	72971114	0	1665	0	5233	0	3568	0.0	0.0
chr14	RPS6KL1	74905642	74907124	102	1483	178	4369	76	2886	0.06877950101146325	0.026334026334026334
chr14	NEK9	75105949	75106702	0	754	4964	13134	4964	12380	0.0	0.4009693053311793
chr14	DIO2	80206230	80206338	0	109	0	2204	0	2095	0.0	0.0
chr14	CEP128	80830164	80831294	408	1131	1018	9385	610	8254	0.36074270557029176	0.07390356190937727
chr14	LINC01467	81607131	81607698	0	568	0	1224	0	656	0.0	0.0
chr14	LINC02316	86062549	86062960	0	412	12	3279	12	2867	0.0	0.004185559818625741
chr14	DDX24	94079024	94079747	0	724	51	4993	51	4269	0.0	0.011946591707659873
chr14	SERPINA9	94469212	94469857	0	646	51	2569	51	1923	0.0	0.0265210608424337
chr14	TCL1A	95712219	95712774	0	556	0	1869	0	1313	0.0	0.0
chr14	LINC00524	101407742	101408258	0	517	0	759	0	242	0.0	0.0
chr14	DIO3OS	101557303	101557819	0	517	0	4042	0	3525	0.0	0.0
chr14	DIO3OS	101557303	101558834	0	1532	0	4042	0	2510	0.0	0.0
chr14	DIO3OS	101557307	101557819	0	513	0	4042	0	3529	0.0	0.0
chr14	MOK	102232534	102233789	32117	1256	41382	7725	9265	6469	25.570859872611464	1.4322151800896583
chr14	IGHG1	105741892	105742222	0	331	2244	2768	2244	2437	0.0	0.9208042675420599
chr15	LINC01193	20979046	20979357	0	312	983	6672	983	6360	0.0	0.15455974842767295
chr15	GOLGA8DP	23161094	23161454	0	361	1275	5274	1275	4913	0.0	0.25951557093425603
chr15	PWRN1	24299629	24300430	0	802	51	22178	51	21376	0.0	0.002385853293413174
chr15	PWRN1	24346425	24347317	0	893	51	22178	51	21285	0.0	0.0023960535588442564
chr15	SNHG14	25087466	25089866	102	2401	1162	110104	1060	107703	0.0424822990420658	0.00984187998477294
chr15	SNHG14	25041973	25042515	0	543	1162	110104	1162	109561	0.0	0.010605963800987578
chr15	SNHG14	25053827	25055230	0	1404	1162	110104	1162	108700	0.0	0.010689972401103956
chr15	SNHG14	25107909	25109403	0	1495	1162	110104	1162	108609	0.0	0.010698929186347355
chr15	SNHG14	25115298	25117515	102	2218	1162	110104	1060	107886	0.045987376014427414	0.00982518584431715
chr15	SNHG14	25108997	25109403	0	407	1162	110104	1162	109697	0.0	0.01059281475336609
chr15	SNHG14	25111764	25117515	153	5752	1162	110104	1009	104352	0.02659944367176634	0.009669196565470715
chr15	SNHG14	25103858	25106294	0	2437	1162	110104	1162	107667	0.0	0.010792536246017814
chr15	SNHG14	25101822	25103970	0	2149	1162	110104	1162	107955	0.0	0.010763744152656199
chr15	SNHG14	25093833	25095828	51	1996	1162	110104	1111	108108	0.02555110220440882	0.010276760276760277
chr15	SNHG14	25089613	25091719	0	2107	1162	110104	1162	107997	0.0	0.010759558135874144
chr15	SNHG14	25089545	25091719	0	2175	1162	110104	1162	107929	0.0	0.010766337129038534
chr15	SNHG14	25111764	25115656	51	3893	1162	110104	1111	106211	0.013100436681222707	0.010460310137368069
chr15	SNHG14	25203551	25204300	0	750	1162	110104	1162	109354	0.0	0.010626040199718346
chr15	SNHG14	25245137	25245421	0	285	1162	110104	1162	109819	0.0	0.010581046995510796
chr15	LINC00929	26125208	26126371	0	1164	0	3665	0	2501	0.0	0.0
chr15	GOLGA8F	28382389	28382749	80	361	36347	5682	36267	5321	0.22160664819944598	6.815824093215561
chr15	HERC2P9	28636486	28637107	51	622	213	8168	162	7546	0.0819935691318328	0.02146832759077657
chr15	HERC2P9	28640921	28641312	0	392	213	8168	213	7776	0.0	0.027391975308641976
chr15	HERC2P9	28655272	28655691	0	420	213	8168	213	7748	0.0	0.0274909654104285
chr15	FAN1	30904511	30905897	0	1387	128408	15722	128408	14335	0.0	8.95765608650157
chr15	FAN1	30925788	30928656	64018	2869	128408	15722	64390	12853	22.313698152666433	5.009725355948028
chr15	CDIN1	36808323	36810244	0	1922	102	9162	102	7240	0.0	0.01408839779005525
chr15	PAK6	40275926	40277487	357	1562	7840	6404	7483	4842	0.22855313700384122	1.5454357703428336
chr15	CAPN3	42411746	42412315	0	570	102	10244	102	9674	0.0	0.01054372544965888
chr15	CCNDBP1	43194080	43194461	0	382	1764	5916	1764	5534	0.0	0.318756776292013
chr15	HYPK	43801517	43804427	1530	2911	2509	7451	979	4540	0.5255925798694606	0.21563876651982378
chr15	B2M	44715422	44715701	0	280	0	3042	0	2762	0.0	0.0
chr15	B2M	44717606	44718145	0	540	0	3042	0	2502	0.0	0.0
chr15	GCOM1	57705933	57706955	0	1023	102	8788	102	7765	0.0	0.01313586606567933
chr15	AQP9	58183960	58185911	0	1952	0	3242	0	1290	0.0	0.0
chr15	SMAD3	67166530	67166853	0	324	7360	7224	7360	6900	0.0	1.0666666666666667
chr15	LRRC49	70936534	70936822	0	289	4840	9178	4840	8889	0.0	0.5444931938350771
chr15	CD276	73712933	73714514	0	1582	66	5220	66	3638	0.0	0.018141836173721827
chr15	PML	74034477	74036394	102	1918	28830	10347	28728	8429	0.053180396246089674	3.408233479653577
chr15	CCDC33	74334974	74336141	24736	1168	34918	6959	10182	5791	21.17808219178082	1.7582455534450008
chr15	UBL7-AS1	74461264	74462031	1122	768	11586	2142	10464	1374	1.4609375	7.615720524017467
chr15	AC015871.5	79989904	79990606	0	703	0	703	0	0	0.0	0.0
chr15	ARNT2	80593599	80597928	969	4330	1122	7678	153	3348	0.22378752886836029	0.0456989247311828
chr15	SNHG21	82756903	82757206	0	304	1026	1055	1026	751	0.0	1.3661784287616512
chr15	ZSCAN2	84620601	84622714	0	2114	0	4531	0	2417	0.0	0.0
chr15	MIR9-3HG	89387430	89387881	0	452	0	8103	0	7651	0.0	0.0
chr15	MIR9-3HG	89387816	89389482	0	1667	0	8103	0	6436	0.0	0.0
chr15	MIR9-3HG	89388500	89389522	0	1023	0	8103	0	7080	0.0	0.0
chr15	MIR9-3HG	89388503	89389482	0	980	0	8103	0	7123	0.0	0.0
chr15	MIR9-3HG	89388500	89389482	0	983	0	8103	0	7120	0.0	0.0
chr15	FURIN	90879866	90879984	0	119	0	4749	0	4630	0.0	0.0
chr15	FES	90885036	90885585	102	550	3613	4121	3511	3571	0.18545454545454546	0.983197983758051
chr15	CHASERR	92883584	92883778	0	195	50	5803	50	5608	0.0	0.00891583452211127
chr15	CHD2	93014695	93014909	255	215	53276	16852	53021	16637	1.186046511627907	3.1869327402776944
chr15	CHD2	92946037	92946340	2063	304	53276	16852	51213	16548	6.786184210526316	3.0948150833937635
chr15	LINC01580	93899234	93899603	0	370	0	2674	0	2304	0.0	0.0
chr15	SPATA8	96783434	96784259	918	826	1122	1471	204	645	1.1113801452784504	0.31627906976744186
chr15	SYNM	99129366	99135593	51	6228	0	6844	-51	616	0.008188824662813102	-0.08279220779220779
chr15	AC027020.1	100559312	100559798	0	487	0	634	0	147	0.0	0.0
chr15	AC015712.6	100861842	100862342	0	501	102	8171	102	7670	0.0	0.013298565840938721
chr15	HERC2P3	20438926	20439655	0	730	3097	9444	3097	8714	0.0	0.3554050952490246
chr15	GOLGA6L2	23439497	23441682	238	2186	238	3047	0	861	0.10887465690759378	0.0
chr15	UBE3A	25333727	25340228	0	6502	0	16169	0	9667	0.0	0.0
chr15	SLC12A6	34336409	34338057	51	1649	1581	9653	1530	8004	0.030927835051546393	0.1911544227886057
chr15	LPCAT4	34364193	34364306	0	114	51	3593	51	3479	0.0	0.01465938488071285
chr15	AQR	34873827	34874864	0	1038	2809	13465	2809	12427	0.0	0.2260400740323489
chr15	PLCB2	40287908	40288918	4659	1011	19600	6493	14941	5482	4.6083086053412465	2.725465158701204
chr15	RMDN3	40754596	40754790	459	195	58227	4467	57768	4272	2.353846153846154	13.52247191011236
chr15	RPAP1	41517797	41518182	0	386	3842	6765	3842	6379	0.0	0.6022887599937294
chr15	UBR1	43025373	43026663	17325	1291	47020	9976	29695	8685	13.41982958946553	3.4191134139320667
chr15	ZSCAN29	43369595	43370062	661	468	3522	6474	2861	6006	1.4123931623931625	0.4763569763569764
chr15	STRC	43615432	43616690	0	1259	51	6367	51	5108	0.0	0.009984338292873924
chr15	CATSPER2	43648628	43648844	0	217	643	5336	643	5119	0.0	0.12561047079507717
chr15	FRMD5	43873274	43874462	19285	1189	25088	6396	5803	5207	16.21951219512195	1.1144613020933358
chr15	AC084759.2	53976767	53977545	0	779	51	3596	51	2817	0.0	0.01810436634717785
chr15	CCPG1	55359538	55360944	51	1407	51	5580	0	4173	0.03624733475479744	0.0
chr15	OAZ2	64691433	64691591	0	159	13618	2806	13618	2647	0.0	5.144692104268984
chr15	CT62	71110243	71112294	102	2052	408	2536	306	484	0.049707602339181284	0.6322314049586777
chr15	MYO9A	72117679	72118081	4519	403	15277	14410	10758	14007	11.213399503722083	0.7680445491539944
chr15	STRA6	74202154	74202450	48	297	8425	6568	8377	6271	0.16161616161616163	1.3358316058044968
chr15	CYP1A1	74722272	74723123	102	852	102	3368	0	2516	0.11971830985915492	0.0
chr15	CYP1A1	74720719	74721053	0	335	102	3368	102	3033	0.0	0.033630069238377844
chr15	ULK3	74840233	74840641	0	409	7655	3361	7655	2952	0.0	2.5931571815718155
chr15	FAM219B	74899991	74902063	306	2073	969	3076	663	1003	0.1476121562952243	0.6610169491525424
chr15	FAM219B	74899991	74902786	663	2796	969	3076	306	280	0.2371244635193133	1.0928571428571427
chr15	MAN2C1	75355793	75356032	0	240	3097	7504	3097	7264	0.0	0.42634911894273125
chr15	CTSH	78931450	78932458	0	1009	136	11133	136	10124	0.0	0.013433425523508494
chr15	CTSH	78931450	78935082	0	3633	136	11133	136	7500	0.0	0.018133333333333335
chr15	CTSH	78925333	78927781	0	2449	136	11133	136	8684	0.0	0.01566098572086596
chr15	CTSH	78932371	78935082	0	2712	136	11133	136	8421	0.0	0.016150100938130862
chr15	CTSH	78921771	78923118	102	1348	136	11133	34	9785	0.07566765578635015	0.0034747061829330608
chr15	CTSH	78921774	78923118	102	1345	136	11133	34	9788	0.0758364312267658	0.003473641193297916
chr15	CTSH	78931450	78932041	0	592	136	11133	136	10541	0.0	0.012902001707617874
chr15	CTSH	78931450	78932038	0	589	136	11133	136	10544	0.0	0.012898330804248861
chr15	GOLGA6L10	82344587	82345426	102	840	102	4691	0	3851	0.12142857142857143	0.0
chr15	AP3B2	82662167	82662922	306	756	1015751	8150	1015445	7394	0.40476190476190477	137.3336489045172
chr15	AP3B2	82663126	82663620	0	495	1015751	8150	1015751	7655	0.0	132.6911822338341
chr15	GOLGA2P7	84199310	84203020	0	3711	0	3261	0	-450	0.0	-0.0
chr15	DET1	88530622	88531715	0	1094	40	4789	40	3695	0.0	0.010825439783491205
chr15	POLG	89320765	89321260	0	496	29	6927	29	6431	0.0	0.004509407557145078
chr15	LINC01579	93900035	93900599	0	565	0	9355	0	8790	0.0	0.0
chr15	LINC01197	95288301	95289554	0	1254	0	13078	0	11824	0.0	0.0
chr15	LINC02254	97427650	97427952	0	303	0	5214	0	4911	0.0	0.0
chr16	DECR2	406684	406952	0	269	459	2636	459	2367	0.0	0.19391634980988592
chr16	PIGQ	574065	574763	802	699	22332	6456	21530	5757	1.1473533619456366	3.7397950321347926
chr16	RHOT2	670891	671203	1176	313	11678	4192	10502	3879	3.757188498402556	2.7073988141273526
chr16	HAGHL	728315	728604	0	290	218775	4949	218775	4659	0.0	46.957501609787506
chr16	HAGHL	727105	727614	911	510	218775	4949	217864	4439	1.7862745098039217	49.079522414958326
chr16	HAGHL	729008	729715	0	708	218775	4949	218775	4241	0.0	51.585710917236504
chr16	MSLN	768378	768865	7169	488	15451	2494	8282	2006	14.690573770491802	4.128614157527418
chr16	CHTF18	788930	789360	51	431	11477	4621	11426	4190	0.11832946635730858	2.7269689737470166
chr16	CRAMP1	1655876	1656992	1071	1117	26493	8617	25422	7500	0.9588182632050134	3.3896
chr16	NUBP2	1787940	1788207	321	268	14368	3124	14047	2856	1.1977611940298507	4.918417366946779
chr16	NDUFB10	1961496	1961975	0	480	0	679	0	199	0.0	0.0
chr16	TBL3	1977053	1977284	0	232	486	6954	486	6722	0.0	0.07229991074085093
chr16	TBL3	1977513	1977670	0	158	486	6954	486	6796	0.0	0.07151265450264861
chr16	TSC2	2088047	2088325	9545	279	112940	14665	103395	14386	34.21146953405018	7.1871958848880855
chr16	DNASE1L2	2237375	2237649	922	275	1849	1518	927	1243	3.3527272727272726	0.7457763475462591
chr16	AMDHD2	2528451	2528718	210	268	8096	3044	7886	2776	0.7835820895522388	2.840778097982709
chr16	SRRM2	2770857	2771410	577	554	122789	11355	122212	10801	1.0415162454873645	11.314878252013703
chr16	IL32	3067376	3067613	0	238	459	2993	459	2755	0.0	0.16660617059891106
chr16	IL32	3068989	3069551	51	563	459	2993	408	2430	0.0905861456483126	0.16790123456790124
chr16	IL32	3065368	3065826	0	459	459	2993	459	2534	0.0	0.18113654301499604
chr16	IL32	3065639	3065826	0	188	459	2993	459	2805	0.0	0.16363636363636364
chr16	IL32	3065661	3065826	0	166	459	2993	459	2827	0.0	0.16236292889989387
chr16	DNASE1	3656998	3657341	495	344	86877	8622	86382	8278	1.438953488372093	10.435129258274946
chr16	METTL22	8628729	8629110	0	382	108	7747	108	7365	0.0	0.014663951120162933
chr16	AC012178.1	9517182	9518324	0	1143	0	4432	0	3289	0.0	0.0
chr16	AC012178.1	9517455	9518323	0	869	0	4432	0	3563	0.0	0.0
chr16	AC012178.1	9517182	9518323	0	1142	0	4432	0	3290	0.0	0.0
chr16	AC012178.1	9517182	9518325	0	1144	0	4432	0	3288	0.0	0.0
chr16	NOMO1	14895513	14896156	0	644	9750	5532	9750	4888	0.0	1.9946808510638299
chr16	NPIPA1	14935159	14935397	26531	239	36362	7367	9831	7128	111.00836820083683	1.379208754208754
chr16	NDE1	15724190	15727000	8356	2811	11014	8104	2658	5293	2.9726076129491283	0.502172680899301
chr16	AC138969.1	16333646	16333884	28832	239	32110	7438	3278	7199	120.63598326359832	0.4553410195860536
chr16	IQCK	19763847	19764112	0	266	174633	5005	174633	4739	0.0	36.85017936273476
chr16	TMEM159	21160977	21161278	0	302	600	2567	600	2265	0.0	0.26490066225165565
chr16	SMG1P1	22483030	22483560	9158	531	34678	6698	25520	6167	17.246704331450093	4.138154694340846
chr16	KDM8	27210092	27210621	0	530	10101	3982	10101	3452	0.0	2.9261297798377752
chr16	APOBR	28495098	28497996	79129	2899	96498	3802	17369	903	27.295274232493963	19.234772978959025
chr16	ATXN2L	28835932	28837237	88580	1306	110970	6097	22390	4791	67.82542113323125	4.673345856814861
chr16	ATXN2L	28835932	28836485	4331	554	110970	6097	106639	5543	7.817689530685921	19.238499007757532
chr16	LAT	28986381	28986446	8800	66	227206	4040	218406	3974	133.33333333333334	54.95873175641671
chr16	LAT	28986539	28986714	41971	176	227206	4040	185235	3864	238.4715909090909	47.93866459627329
chr16	SPN	29663694	29670876	153	7183	153	7385	0	202	0.02130029235695392	0.0
chr16	MAZ	29807774	29807828	0	55	558616	3213	558616	3158	0.0	176.88917036098798
chr16	PRRT2	29812989	29813933	35066	945	238274	2305	203208	1360	37.10687830687831	149.41764705882352
chr16	SLX1A-SULT1A3	30202689	30203685	2637	997	46425	4064	43788	3067	2.6449348044132397	14.277143788718618
chr16	ITGAL	30473964	30474298	0	335	102	9594	102	9259	0.0	0.011016308456636786
chr16	ITGAL	30496096	30496566	0	471	102	9594	102	9123	0.0	0.011180532719500164
chr16	BCKDK	31111868	31112567	51	700	13011	3416	12960	2716	0.07285714285714286	4.771723122238586
chr16	KAT8	31130745	31131359	9567	615	177261	5737	167694	5122	15.55609756097561	32.73994533385396
chr16	KAT8	31130455	31130900	7813	446	177261	5737	169448	5291	17.517937219730943	32.02570402570402
chr16	ARMC5	31462130	31462917	10778	788	36438	4981	25660	4193	13.67766497461929	6.119723348437873
chr16	AC142381.3	31981869	31982189	0	321	51	2178	51	1857	0.0	0.027463651050080775
chr16	AC007614.1	49287719	49289655	0	1937	51	24089	51	22152	0.0	0.002302275189599133
chr16	AC007614.1	49287366	49289655	0	2290	51	24089	51	21799	0.0	0.0023395568604064406
chr16	AC007614.1	49287829	49289655	0	1827	51	24089	51	22262	0.0	0.002290899290270416
chr16	CASC22	52272618	52273219	0	602	0	2437	0	1835	0.0	0.0
chr16	CHD9	53209481	53209813	279	333	7725	15474	7446	15141	0.8378378378378378	0.4917772934416485
chr16	MT1E	56626465	56627112	0	648	0	1054	0	406	0.0	0.0
chr16	MT1H	56670505	56671129	23667	625	23667	725	0	100	37.8672	0.0
chr16	KATNB1	57736977	57737283	0	307	157	3360	157	3053	0.0	0.05142482803799541
chr16	USB1	58002478	58002645	0	168	1308	4598	1308	4430	0.0	0.29525959367945825
chr16	CCDC113	58259853	58259934	0	82	102	5938	102	5856	0.0	0.017418032786885244
chr16	SETD6	58515790	58516097	0	308	177	7506	177	7198	0.0	0.02459016393442623
chr16	FBXL8	67162847	67164174	0	1328	2418	2967	2418	1639	0.0	1.4752898108602805
chr16	HSF4	67169278	67169945	1122	668	27639	2898	26517	2230	1.6796407185628743	11.891031390134529
chr16	TMEM208	67228796	67229278	56435	483	270757	1641	214322	1158	116.84265010351967	185.07944732297065
chr16	PLEKHG4	67277509	67280806	918	3298	18388	5721	17470	2423	0.27835051546391754	7.210070160957491
chr16	CARMIL2	67648051	67648314	4	264	99983	5782	99979	5518	0.015151515151515152	18.118702428416093
chr16	TSNAXIP1	67825666	67826076	0	411	255	3696	255	3285	0.0	0.0776255707762557
chr16	TSNAXIP1	67825666	67826282	0	617	255	3696	255	3079	0.0	0.08281909710945112
chr16	EDC4	67882957	67883177	1950	221	484613	6082	482663	5861	8.823529411764707	82.35164647671046
chr16	SLC7A6	68274690	68275249	102	560	60272	6338	60170	5778	0.18214285714285713	10.413637937002424
chr16	SLC7A6	68297233	68301819	29228	4587	60272	6338	31044	1751	6.37192064530194	17.729297544260422
chr16	CDH1	68813312	68813562	0	251	64	5466	64	5215	0.0	0.012272291466922339
chr16	HPR	72076302	72077246	1479	945	1530	1930	51	985	1.565079365079365	0.05177664974619289
chr16	LINC01568	73420656	73421396	0	741	0	6893	0	6152	0.0	0.0
chr16	PLCG2	81956694	81956879	0	186	28325	13417	28325	13231	0.0	2.1408056836217972
chr16	HSD17B2	82090901	82098534	51	7634	4	2501	-47	-5133	0.006680639245480744	0.009156438729787648
chr16	DNAAF1	84169858	84170356	0	499	6396	3756	6396	3257	0.0	1.9637703408044211
chr16	SNAI3-AS1	88671276	88671693	0	418	72147	5297	72147	4879	0.0	14.787251485960239
chr16	TRAPPC2L	88859344	88859750	969	407	2271	3018	1302	2611	2.380835380835381	0.49865951742627346
chr16	SPG7	89556886	89557747	3568	862	25176	18796	21608	17934	4.139211136890951	1.2048622727779636
chr16	SPG7	89540943	89541384	769	442	25176	18796	24407	18354	1.739819004524887	1.3297918709818024
chr16	SPG7	89545871	89546181	0	311	25176	18796	25176	18485	0.0	1.3619691641871787
chr16	SPG7	89545871	89546760	51	890	25176	18796	25125	17906	0.05730337078651685	1.403160951636323
chr16	SPG7	89540943	89542279	769	1337	25176	18796	24407	17459	0.575168287210172	1.397960937052523
chr16	SPG7	89540943	89541346	769	404	25176	18796	24407	18392	1.9034653465346534	1.3270443671161374
chr16	RPL13	89561577	89561751	888	175	8832	3088	7944	2913	5.074285714285714	2.7270854788877448
chr16	RPL13	89560710	89561063	470	354	8832	3088	8362	2734	1.3276836158192091	3.0585223116313096
chr16	CDK10	89693273	89693467	0	195	189	5398	189	5203	0.0	0.03632519700172977
chr16	LINC02193	90222243	90222673	3314	431	5807	4443	2493	4012	7.689095127610209	0.6213858424725822
chr16	LUC7L	188968	190135	5111	1168	5993	6101	882	4933	4.375856164383562	0.17879586458544497
chr16	CEROX1	975760	976400	102	641	1435	2975	1333	2334	0.15912636505460218	0.5711225364181662
chr16	CEROX1	975760	977029	714	1270	1435	2975	721	1705	0.5622047244094488	0.4228739002932551
chr16	MSRB1	1940777	1940892	0	116	51	2025	51	1909	0.0	0.02671555788370875
chr16	MSRB1	1940777	1941405	0	629	51	2025	51	1396	0.0	0.036532951289398284
chr16	RPS2	1962060	1962656	0	597	51	1934	51	1337	0.0	0.0381451009723261
chr16	PKD1	2103265	2103895	11881	631	208723	16200	196842	15569	18.828843106180667	12.64320123321986
chr16	ERVK13-1	2669410	2672570	12467	3161	42024	6668	29557	3507	3.9440050616893387	8.42800114057599
chr16	ERVK13-1	2660361	2663407	27688	3047	42024	6668	14336	3621	9.08697079094191	3.9591273128969897
chr16	ERVK13-1	2671023	2672570	6596	1548	42024	6668	35428	5120	4.260981912144703	6.91953125
chr16	ERVK13-1	2669410	2672562	12446	3153	42024	6668	29578	3515	3.947351728512528	8.41479374110953
chr16	ELOB	2771413	2772102	102	690	102	1115	0	425	0.14782608695652175	0.0
chr16	PRSS33	2783952	2785171	0	1220	0	2118	0	898	0.0	0.0
chr16	ZNF213-AS1	3129247	3129653	0	407	6634	9872	6634	9465	0.0	0.7008980454305336
chr16	NMRAL1	4474092	4474792	102	701	5841	3199	5739	2498	0.14550641940085593	2.297437950360288
chr16	GLYR1	4803202	4805310	8160	2109	14989	5290	6829	3181	3.869132290184922	2.146809179503301
chr16	PARN	14591912	14593378	266	1467	31291	8816	31025	7349	0.18132242672119972	4.221662811266839
chr16	NPIPA8	18334710	18334967	0	258	0	1617	0	1359	0.0	0.0
chr16	NPIPA9	18374831	18375069	0	239	0	2981	0	2742	0.0	0.0
chr16	NOMO2	18499924	18500567	0	644	261804	6838	261804	6194	0.0	42.267355505327735
chr16	RPS15A	18782967	18784823	51	1857	870	4037	819	2180	0.027463651050080775	0.3756880733944954
chr16	THUMPD1	20733663	20737286	816	3624	816	6379	0	2755	0.2251655629139073	0.0
chr16	SMG1P3	21455342	21455872	345	531	109741	7138	109396	6607	0.6497175141242938	16.55759043438777
chr16	SMG1P4	21887583	21888113	177	531	67557	5968	67380	5437	0.3333333333333333	12.392863711605665
chr16	ERN2	23700538	23701114	563514	577	1506656	4763	943142	4186	976.627383015598	225.30864787386525
chr16	NSMCE1	27241352	27241889	51	538	15363	2869	15312	2331	0.09479553903345725	6.568854568854569
chr16	CLN3	28482476	28482672	1985	197	183736	5985	181751	5788	10.076142131979696	31.401347615756737
chr16	AC138894.1	28458385	28458591	0	207	35427	4138	35427	3931	0.0	9.012210633426609
chr16	AC138894.1	28477011	28477635	68	625	35427	4138	35359	3513	0.1088	10.065186450327355
chr16	CLN3	28491713	28492074	336	362	183736	5985	183400	5623	0.9281767955801105	32.616041259114354
chr16	AC138894.1	28477278	28477635	68	358	35427	4138	35359	3780	0.18994413407821228	9.354232804232804
chr16	CLN3	28482326	28482672	2726	347	183736	5985	181010	5638	7.855907780979827	32.105356509400494
chr16	CLN3	28482104	28482382	481	279	183736	5985	183255	5706	1.7240143369175627	32.11619348054679
chr16	CLN3	28482104	28482672	3176	569	183736	5985	180560	5416	5.581722319859402	33.33825701624816
chr16	CLN3	28482104	28482545	1763	442	183736	5985	181973	5543	3.98868778280543	32.82933429550785
chr16	CLN3	28491481	28491835	1632	355	183736	5985	182104	5630	4.597183098591549	32.345293072824155
chr16	CLN3	28482326	28482545	1313	220	183736	5985	182423	5765	5.968181818181818	31.64319167389419
chr16	CLN3	28491481	28492042	1632	562	183736	5985	182104	5423	2.903914590747331	33.57993730407524
chr16	CLN3	28491713	28492042	336	330	183736	5985	183400	5655	1.018181818181818	32.43147656940761
chr16	SULT1A2	28595366	28595675	51	310	51544	2055	51493	1745	0.16451612903225807	29.508882521489973
chr16	DOC2A	30009960	30010340	102	381	455469	6385	455367	6004	0.2677165354330709	75.84393737508327
chr16	CCDC189	30760283	30760668	106	386	8621	2142	8515	1756	0.27461139896373055	4.849088838268793
chr16	CCDC189	30759341	30759724	896	384	8621	2142	7725	1758	2.3333333333333335	4.3941979522184305
chr16	RUSF1	31508073	31508384	15199	312	19122	3175	3923	2863	48.71474358974359	1.3702410059378274
chr16	SLC6A10P	32882530	32883703	5177	1174	5206	4120	29	2946	4.409710391822828	0.009843856076035303
chr16	ABCC12	48086740	48088085	0	1346	153	8731	153	7385	0.0	0.02071767095463778
chr16	CDH8	61647241	61654101	0	6861	255	13549	255	6688	0.0	0.03812799043062201
chr16	TK2	66509442	66512066	963	2625	23401	8924	22438	6299	0.3668571428571429	3.5621527226543894
chr16	TK2	66548977	66549860	51	884	23401	8924	23350	8040	0.057692307692307696	2.904228855721393
chr16	CMTM4	66614749	66622222	2754	7474	2163	6340	-591	-1134	0.3684773882793685	0.5211640211640212
chr16	CDH16	66910259	66911315	0	1057	7071	3606	7071	2549	0.0	2.774029030992546
chr16	CIAO2B	66932064	66932300	0	237	0	1010	0	773	0.0	0.0
chr16	EXOC3L1	67184685	67185057	961	373	36657	3057	35696	2684	2.576407506702413	13.299552906110284
chr16	ATP6V0D1	67438018	67438689	3092	672	13854	6487	10762	5815	4.601190476190476	1.85073086844368
chr16	TERF2	69368375	69368595	94286	221	422022	3724	327736	3503	426.6334841628959	93.55866400228376
chr16	AARS1	70258032	70259186	7394	1155	146049	9918	138655	8763	6.401731601731602	15.822777587584161
chr16	AARS1	70253267	70253800	3278	534	146049	9918	142771	9384	6.138576779026217	15.214300937766412
chr16	AARS1	70253918	70254734	2821	817	146049	9918	143228	9101	3.4528763769889843	15.737611251510822
chr16	AP1G1	71807800	71808150	51	351	93793	10941	93742	10590	0.1452991452991453	8.851935788479699
chr16	AP1G1	71808504	71808813	81	310	93793	10941	93712	10631	0.26129032258064516	8.81497507290001
chr16	PMFBP1	72119096	72120089	89703	994	224526	5619	134823	4625	90.24446680080483	29.15091891891892
chr16	LINC01572	72521007	72522623	0	1617	2036	12582	2036	10965	0.0	0.18568171454628363
chr16	AC009053.1	74352039	74352378	2180	340	82994	3342	80814	3002	6.411764705882353	26.920053297801466
chr16	CLEC18B	74412153	74412246	0	94	3247	2892	3247	2798	0.0	1.160471765546819
chr16	LINC01227	80567554	80568113	0	560	0	3106	0	2546	0.0	0.0
chr16	ARLNC1	80829789	80830757	0	969	0	5783	0	4814	0.0	0.0
chr16	ARLNC1	80829790	80830757	0	968	0	5783	0	4815	0.0	0.0
chr16	ARLNC1	80829791	80830757	0	967	0	5783	0	4816	0.0	0.0
chr16	ARLNC1	80829792	80830757	0	966	0	5783	0	4817	0.0	0.0
chr16	HSDL1	84129985	84130431	0	447	89000	3850	89000	3403	0.0	26.15339406406112
chr16	TAF1C	84181745	84182058	0	314	2163	4997	2163	4683	0.0	0.4618834080717489
chr16	AC009123.1	84194388	84195156	51	769	51	1255	0	486	0.06631989596879063	0.0
chr16	LINC00917	86337360	86338661	0	1302	0	5647	0	4345	0.0	0.0
chr16	AC010531.4	87291683	87292438	0	756	0	2102	0	1346	0.0	0.0
chr16	PIEZO1	88715932	88716119	3312	188	220564	10919	217252	10731	17.617021276595743	20.245270711024137
chr16	CHMP1A	89647034	89647331	24138	298	197850	5318	173712	5020	81.0	34.60398406374502
chr16	CHMP1A	89656632	89657708	31338	1077	197850	5318	166512	4241	29.0974930362117	39.2624381042207
chr16	SPATA2L	89696356	89698305	0	1950	0	2471	0	521	0.0	0.0
chr17	SLC43A2	1616561	1616769	20874	209	1006389	10395	985515	10186	99.8755980861244	96.75191439230316
chr17	MYBBP1A	4538901	4539967	0	1067	722	5295	722	4228	0.0	0.1707663197729423
chr17	PELP1	4671690	4673145	0	1456	1173	6512	1173	5056	0.0	0.232001582278481
chr17	SPAG7	4959225	4959916	51	692	102	2744	51	2052	0.07369942196531792	0.024853801169590642
chr17	ZNF232	5108925	5109868	0	944	1045	2800	1045	1856	0.0	0.5630387931034483
chr17	DERL2	5481100	5481389	51	290	1154	5129	1103	4839	0.17586206896551723	0.2279396569539161
chr17	SLC16A11	7041995	7042763	0	769	21	1985	21	1216	0.0	0.017269736842105265
chr17	SLC16A11	7043311	7044092	0	782	21	1985	21	1203	0.0	0.017456359102244388
chr17	SLC16A11	7041620	7042763	21	1144	21	1985	0	841	0.018356643356643356	0.0
chr17	CLEC10A	7074794	7075885	102	1092	2548	2340	2446	1248	0.09340659340659341	1.9599358974358974
chr17	PHF23	7235929	7236767	510	839	437	2660	-73	1821	0.6078665077473182	-0.040087863811092805
chr17	CTDNEP1	7243590	7244245	0	656	804	2647	804	1991	0.0	0.4038171772978403
chr17	GPS2	7312660	7313124	4663	465	43701	2507	39038	2042	10.027956989247311	19.117531831537708
chr17	TP53	7676381	7676622	0	242	204	5536	204	5294	0.0	0.03853418964865886
chr17	PER1	8144055	8144993	51	939	43786	6344	43735	5405	0.054313099041533544	8.091581868640148
chr17	CTC1	8230293	8230468	0	176	570	8044	570	7868	0.0	0.07244534824605998
chr17	KRBA2	8371308	8372081	63030	774	330757	13409	267727	12635	81.43410852713178	21.189315393747528
chr17	MYH2	10549374	10549623	0	250	1695	6406	1695	6156	0.0	0.2753411306042885
chr17	COX10-AS1	14033551	14034416	0	866	0	11234	0	10368	0.0	0.0
chr17	TEKT3	15331006	15331614	63	609	6939	2613	6876	2004	0.10344827586206896	3.431137724550898
chr17	CDRT1	15613614	15614033	10739	420	160586	8798	149847	8378	25.56904761904762	17.885772260682742
chr17	TRIM16	15683035	15684299	0	1265	5359	4831	5359	3566	0.0	1.502804262478968
chr17	TRIM16	15627965	15629198	3454	1234	5359	4831	1905	3597	2.79902755267423	0.5296080066722268
chr17	ZSWIM7	15976559	15978163	4122	1605	6388	2082	2266	477	2.5682242990654207	4.750524109014675
chr17	ZSWIM7	15977578	15977913	0	336	6388	2082	6388	1746	0.0	3.65864833906071
chr17	ZSWIM7	15977726	15978163	0	438	6388	2082	6388	1644	0.0	3.8856447688564475
chr17	ZSWIM7	15977732	15978163	0	432	6388	2082	6388	1650	0.0	3.8715151515151516
chr17	CENPV	16348615	16349333	3790	719	1160209	1849	1156419	1130	5.271210013908206	1023.3796460176991
chr17	KRT16P6	16818800	16819162	0	363	0	1817	0	1454	0.0	0.0
chr17	TBC1D27P	16929520	16930408	51	889	51	4955	0	4066	0.05736782902137233	0.0
chr17	SREBF1	17817547	17817916	679	370	14378	6629	13699	6259	1.835135135135135	2.1886882888640358
chr17	FLII	18244835	18245419	2626	585	143447	5686	140821	5101	4.488888888888889	27.60654773573809
chr17	FLII	18245229	18245419	1708	191	143447	5686	141739	5495	8.942408376963352	25.79417652411283
chr17	FLII	18256908	18257276	68295	369	143447	5686	75152	5317	185.08130081300814	14.134286251645666
chr17	TBC1D28	18641631	18641998	0	368	157945	4165	157945	3797	0.0	41.59731366868581
chr17	B9D1	19343056	19343857	0	802	785	6772	785	5970	0.0	0.13149078726968175
chr17	ULK2	19770829	19776407	367	5579	24975	9898	24608	4319	0.06578239827926152	5.697615188701088
chr17	KRT16P3	20501512	20501970	0	459	76	2359	76	1900	0.0	0.04
chr17	KRT16P3	20502064	20502713	25	650	76	2359	51	1709	0.038461538461538464	0.02984201287302516
chr17	NOS2	27780766	27780906	0	141	687	4427	687	4286	0.0	0.1602893140457303
chr17	LYRM9	27878357	27880366	42855	2010	58107	3560	15252	1550	21.32089552238806	9.84
chr17	UNC119	28546707	28547849	0	1143	51	5095	51	3952	0.0	0.012904858299595142
chr17	PIGS	28570851	28571188	39	338	306	4809	267	4471	0.11538461538461539	0.05971818385148736
chr17	SEZ6	28956718	28956757	310	40	69647	4750	69337	4710	7.75	14.721231422505308
chr17	MYO18A	29118030	29118189	6329	160	136437	15087	130108	14927	39.55625	8.716285924834192
chr17	TEFM	30898985	30900562	0	1578	51	1841	51	263	0.0	0.19391634980988592
chr17	SLFN13	35444614	35445693	1020	1080	63464	9056	62444	7976	0.9444444444444444	7.828986960882648
chr17	GAS2L2	35750076	35750318	204	243	5601	3381	5397	3138	0.8395061728395061	1.719885277246654
chr17	DDX52	37609738	37614353	2295	4616	5309	8334	3014	3718	0.4971837088388215	0.8106508875739645
chr17	CWC25	38810275	38810595	0	321	340	3726	340	3405	0.0	0.09985315712187959
chr17	PLXDC1	39079103	39079528	0	426	51	9280	51	8854	0.0	0.0057601084255703636
chr17	MED1	39404284	39410721	0	6438	0	8626	0	2188	0.0	0.0
chr17	KRT13	41505055	41505597	0	543	51	2923	51	2380	0.0	0.02142857142857143
chr17	KRT13	41505055	41505612	0	558	51	2923	51	2365	0.0	0.02156448202959831
chr17	KRT42P	41626789	41627762	102	974	1439	4308	1337	3334	0.10472279260780287	0.40101979604079185
chr17	DNAJC7	41987818	41988896	0	1079	408	9268	408	8189	0.0	0.0498229332030773
chr17	STAT3	42329409	42329647	0	239	684	9674	684	9435	0.0	0.0724960254372019
chr17	RAMP2-AS1	42760425	42760711	255	287	321620	4005	321365	3718	0.8885017421602788	86.43491124260355
chr17	VAT1	43014606	43016144	40841	1539	85476	3313	44635	1774	26.537361923326834	25.16065388951522
chr17	AC060780.1	43166979	43167849	40	871	58621	6052	58581	5181	0.045924225028702644	11.306890561667633
chr17	MEOX1	43661065	43661922	2769	858	6826	2677	4057	1819	3.227272727272727	2.2303463441451346
chr17	ASB16-AS1	44181622	44183093	816	1472	1836	2476	1020	1004	0.5543478260869565	1.0159362549800797
chr17	GFAP	44915025	44915500	0	476	51	7492	51	7016	0.0	0.007269099201824401
chr17	GFAP	44910091	44910658	0	568	51	7492	51	6924	0.0	0.007365684575389948
chr17	GFAP	44904441	44905149	0	709	51	7492	51	6783	0.0	0.007518796992481203
chr17	OSBPL7	47807372	47808399	0	1028	35	5247	35	4219	0.0	0.008295804693055226
chr17	OSBPL7	47816106	47816482	0	377	35	5247	35	4870	0.0	0.007186858316221766
chr17	SCRN2	47837691	47838450	255	760	861	3004	606	2244	0.3355263157894737	0.2700534759358289
chr17	MKS1	58206464	58207218	2244	755	30663	8985	28419	8230	2.972185430463576	3.4530984204131228
chr17	SEPTIN4	58520742	58521160	7415	419	59483	6797	52068	6378	17.69689737470167	8.163687676387582
chr17	SEPTIN4	58521735	58522101	10691	367	59483	6797	48792	6430	29.130790190735695	7.5881804043545875
chr17	AC025048.2	60134755	60135693	0	939	204	3106	204	2167	0.0	0.09413936317489617
chr17	AC025048.2	60134755	60135713	0	959	204	3106	204	2147	0.0	0.09501630181648812
chr17	STRADA	63741453	63741796	0	344	1296	9568	1296	9224	0.0	0.14050303555941024
chr17	CCDC47	63756239	63756350	0	112	1375	4370	1375	4258	0.0	0.32292155941756695
chr17	CSH2	63872011	63872741	0	731	0	1177	0	446	0.0	0.0
chr17	ICAM2	64005106	64005373	0	268	51	1706	51	1438	0.0	0.03546592489568846
chr17	DDX5	64502161	64502549	0	389	9763	7977	9763	7588	0.0	1.286636794939378
chr17	DDX5	64506754	64507562	204	809	9763	7977	9559	7168	0.2521631644004944	1.3335658482142858
chr17	PLEKHM1P1	64821766	64822393	51	628	238141	8489	238090	7861	0.08121019108280254	30.287495229614553
chr17	AMZ2P1	64972753	64973517	632	765	3775	3863	3143	3098	0.8261437908496732	1.0145255003227889
chr17	ABCA8	68921381	68921492	0	112	71	10965	71	10853	0.0	0.006541969962222427
chr17	ABCA8	68929048	68929234	0	187	71	10965	71	10778	0.0	0.00658749304138059
chr17	ABCA10	69153304	69154009	0	706	477	8379	477	7673	0.0	0.06216603675224814
chr17	NAT9	74771959	74772277	0	319	16833	2692	16833	2373	0.0	7.0935524652338815
chr17	FDXR	74863895	74864347	0	453	37	3392	37	2939	0.0	0.012589316093909493
chr17	GGA3	75240341	75241057	0	717	5	4272	5	3555	0.0	0.0014064697609001407
chr17	SLC25A19	75288387	75288591	0	205	204	2966	204	2761	0.0	0.07388627308946034
chr17	UNC13D	75827224	75828086	0	863	0	6820	0	5957	0.0	0.0
chr17	FBF1	75913912	75914298	0	387	153	6205	153	5818	0.0	0.026297696803025093
chr17	RHBDF2	76487711	76488132	0	422	255	6598	255	6176	0.0	0.041288860103626944
chr17	SRSF2	76734114	76736464	714	2351	816	2637	102	286	0.30370055295618886	0.35664335664335667
chr17	TMC6	78120176	78121164	164465	989	1002723	11377	838258	10388	166.29423660262893	80.69484020023104
chr17	SCAT1	78630031	78630430	0	400	20317	4114	20317	3714	0.0	5.470382337102854
chr17	CANT1	78996991	78997963	51	973	8954	4029	8903	3056	0.052415210688591986	2.913285340314136
chr17	AATK	81120200	81120984	0	785	51	5255	51	4470	0.0	0.011409395973154362
chr17	CEP131	81189596	81189975	51	380	855	3992	804	3612	0.13421052631578947	0.22259136212624583
chr17	AC110285.1	81385128	81385407	0	280	0	2396	0	2116	0.0	0.0
chr17	AC110285.1	81385128	81385464	0	337	0	2396	0	2059	0.0	0.0
chr17	ACTG1	81512231	81512781	0	551	0	2143	0	1592	0.0	0.0
chr17	MCRIP1	81822360	81823311	0	952	0	3547	0	2595	0.0	0.0
chr17	PCYT2	81908875	81909321	0	447	0	6666	0	6219	0.0	0.0
chr17	PYCR1	81936747	81937257	0	511	0	2584	0	2073	0.0	0.0
chr17	PYCR1	81932383	81933376	0	994	0	2584	0	1590	0.0	0.0
chr17	PYCR1	81936747	81937300	0	554	0	2584	0	2030	0.0	0.0
chr17	DUS1L	82058340	82058818	0	479	0	3907	0	3428	0.0	0.0
chr17	DPH1	2041767	2043898	918	2132	9361	4551	8443	2419	0.43058161350844276	3.490285241835469
chr17	SGSM2	2362837	2363134	306	298	19905	7230	19599	6932	1.0268456375838926	2.82732256203116
chr17	PLD2	4818001	4818385	0	385	384	4796	384	4411	0.0	0.08705508954885513
chr17	MINK1	4890221	4890735	7629	515	214859	6924	207230	6409	14.81359223300971	32.3342175066313
chr17	RNF167	4940486	4940993	0	508	102	2282	102	1774	0.0	0.05749718151071026
chr17	XAF1	6759255	6759718	0	464	102	6341	102	5877	0.0	0.017355793772332824
chr17	ELP5	7258587	7259940	0	1354	10281	2734	10281	1380	0.0	7.45
chr17	EIF5A	7311349	7311651	761	303	139926	2599	139165	2296	2.5115511551155114	60.61193379790941
chr17	TNFSF13	7560723	7561601	0	879	831	2282	831	1403	0.0	0.5923022095509622
chr17	SENP3	7571372	7571969	423846	598	430228	3150	6382	2552	708.7725752508361	2.500783699059561
chr17	EIF4A1	7577568	7578244	271336	677	1389251	4446	1117915	3769	400.7917282127031	296.6078535420536
chr17	EIF4A1	7577826	7578244	126827	419	1389251	4446	1262424	4027	302.6897374701671	313.48994288552274
chr17	SHBG	7630151	7630507	0	357	79573	1850	79573	1493	0.0	53.29738780977897
chr17	WRAP53	7688476	7689079	0	604	0	3629	0	3025	0.0	0.0
chr17	DNAH2	7770556	7770933	204	378	556145	16910	555941	16532	0.5396825396825397	33.62817565932737
chr17	DNAH2	7786123	7786687	8060	565	556145	16910	548085	16345	14.265486725663717	33.53227286631998
chr17	CNTROB	7948486	7949137	0	652	342	5814	342	5162	0.0	0.06625339015885316
chr17	PFAS	8256266	8256648	0	383	21714	6403	21714	6020	0.0	3.6069767441860465
chr17	RANGRF	8289257	8290092	102	836	102	1335	0	499	0.12200956937799043	0.0
chr17	NDEL1	8443926	8444357	128	432	32489	5059	32361	4627	0.2962962962962963	6.993948562783661
chr17	ARHGAP44	12955866	12955980	0	115	7690	7135	7690	7020	0.0	1.0954415954415955
chr17	ZNF286A	15700047	15700366	51	320	215	3177	164	2857	0.159375	0.05740287014350717
chr17	TBC1D26	15734703	15735070	0	368	357	5061	357	4693	0.0	0.07607074366077136
chr17	SNHG29	16441073	16442018	153	946	42991	5724	42838	4778	0.16173361522198731	8.965676015069066
chr17	SNHG29	16439326	16440253	0	928	42991	5724	42991	4796	0.0	8.9639282735613
chr17	SNHG29	16439036	16439414	172	379	42991	5724	42819	5345	0.45382585751978893	8.011038353601498
chr17	SNHG29	16439326	16439703	0	378	42991	5724	42991	5346	0.0	8.04171343060232
chr17	SNHG29	16439580	16440253	0	674	42991	5724	42991	5050	0.0	8.513069306930692
chr17	SNHG29	16439037	16440253	170	1217	42991	5724	42821	4507	0.13968775677896467	9.50099844686044
chr17	SNHG29	16441073	16441502	153	430	42991	5724	42838	5294	0.3558139534883721	8.091802040045334
chr17	DRC3	17973664	17973962	102	299	26994	4609	26892	4310	0.3411371237458194	6.239443155452436
chr17	DRG2	18099632	18100435	2805	804	321194	6021	318389	5217	3.4888059701492535	61.02913551849722
chr17	KRT17P5	18420332	18421016	5656	685	11470	3166	5814	2481	8.256934306569343	2.343409915356711
chr17	KRT17P5	18422180	18423064	1173	885	11470	3166	10297	2281	1.3254237288135593	4.514248136782113
chr17	KRT16P1	18441694	18442343	4751	650	14555	2219	9804	1569	7.309230769230769	6.248565965583174
chr17	FBXW10	18749721	18750137	0	417	1130	3798	1130	3381	0.0	0.33422064477965097
chr17	EPN2	19281954	19283714	109231	1761	107116	7670	-2115	5909	62.027825099375356	-0.3579285835166695
chr17	ALDH3A2	19648750	19649124	0	375	9762	10618	9762	10243	0.0	0.9530411012398712
chr17	ALDH3A2	19648780	19649124	0	345	9762	10618	9762	10273	0.0	0.950257957753334
chr17	CDRT15L2	20580148	20580911	0	764	0	1050	0	286	0.0	0.0
chr17	NLK	28194581	28196381	1020	1801	2443	4703	1423	2902	0.5663520266518601	0.49035148173673326
chr17	PPY2P	28247443	28247950	0	508	0	659	0	151	0.0	0.0
chr17	SLC13A2	28490306	28490590	1071	285	4761	3238	3690	2953	3.7578947368421054	1.2495767016593295
chr17	SLC13A2	28493570	28494105	969	536	4761	3238	3792	2702	1.8078358208955223	1.4034048852701702
chr17	NEK8	28737305	28737736	0	432	151	4426	151	3994	0.0	0.03780671006509765
chr17	ANKRD13B	29613353	29614761	305	1409	921	3581	616	2172	0.21646557842441447	0.283609576427256
chr17	SUZ12P1	30768833	30769064	0	232	1678	3792	1678	3560	0.0	0.4713483146067416
chr17	TMEM98	32931326	32931659	0	334	0	4903	0	4569	0.0	0.0
chr17	TMEM132E	34626126	34627057	0	932	729	6124	729	5192	0.0	0.14040832049306626
chr17	TAF15	35844476	35845038	204	563	15459	5459	15255	4896	0.3623445825932504	3.1158088235294117
chr17	CCL4L2	36211775	36212878	0	1104	0	988	0	-116	0.0	-0.0
chr17	ARHGAP23	38477578	38477896	0	319	115817	8109	115817	7790	0.0	14.867394094993582
chr17	CASC3	40163480	40164166	1476	687	171249	5412	169773	4725	2.148471615720524	35.93079365079365
chr17	NKIRAS2	42022398	42022640	0	243	41	4020	41	3777	0.0	0.010855176065660577
chr17	COASY	42562147	42563322	0	1176	1069	3038	1069	1862	0.0	0.5741138560687433
chr17	COASY	42562150	42562487	0	338	1069	3038	1069	2700	0.0	0.3959259259259259
chr17	NBR2	43138656	43140283	28115	1628	32866	3057	4751	1429	17.26965601965602	3.324702589223233
chr17	TMEM106A	43213020	43213252	592	233	25325	3586	24733	3353	2.540772532188841	7.376379361765583
chr17	TMUB2	44188934	44189299	0	366	204	3574	204	3208	0.0	0.06359102244389027
chr17	TMUB2	44189021	44189299	0	279	204	3574	204	3295	0.0	0.061911987860394535
chr17	TMUB2	44188934	44189588	0	655	204	3574	204	2919	0.0	0.0698869475847893
chr17	GRN	44345264	44345605	0	342	821	3085	821	2743	0.0	0.2993073277433467
chr17	GRN	44345301	44345605	0	305	821	3085	821	2780	0.0	0.2953237410071942
chr17	DBF4B	44750594	44752264	12038	1671	12038	5975	0	4304	7.204069419509276	0.0
chr17	ACBD4	45135686	45136232	158	547	14226	3521	14068	2974	0.28884826325411334	4.730329522528581
chr17	FMNL1	45241846	45242146	0	301	66880	6173	66880	5872	0.0	11.389645776566757
chr17	FMNL1	45246209	45246604	306	396	66880	6173	66574	5777	0.7727272727272727	11.523974381166695
chr17	MAP3K14-AS1	45267112	45267490	0	379	11521	4874	11521	4495	0.0	2.563070077864294
chr17	GOSR2	46923171	46923632	1173	462	187163	11566	185990	11104	2.538961038961039	16.749819884726225
chr17	NPEPPS	47619008	47619784	51	777	4931	9467	4880	8690	0.06563706563706563	0.5615650172612198
chr17	NPEPPS	47586364	47587344	0	981	4931	9467	4931	8486	0.0	0.5810747112891822
chr17	NPEPPS	47585499	47586398	102	900	4931	9467	4829	8567	0.11333333333333333	0.5636745651920159
chr17	NPEPPS	47619277	47619784	0	508	4931	9467	4931	8959	0.0	0.5503962495814265
chr17	LRRC46	47834424	47835399	0	976	255	2544	255	1568	0.0	0.16262755102040816
chr17	PNPO	47944615	47945612	0	998	0	4987	0	3989	0.0	0.0
chr17	CDK5RAP3	47981436	47981772	0	337	0	4158	0	3821	0.0	0.0
chr17	CDK5RAP3	47971121	47971407	0	287	0	4158	0	3871	0.0	0.0
chr17	CDK5RAP3	47981436	47981768	0	333	0	4158	0	3825	0.0	0.0
chr17	NFE2L1	48050606	48051628	1288	1023	1339	5475	51	4452	1.2590420332355816	0.011455525606469003
chr17	THRA1/BTR	48294346	48294515	0	170	0	1575	0	1405	0.0	0.0
chr17	FLJ40194	49252853	49253133	0	281	61955	4893	61955	4612	0.0	13.433434518647008
chr17	FLJ40194	49252245	49252918	459	674	61955	4893	61496	4219	0.6810089020771514	14.575965868689263
chr17	ITGA3	50075458	50075735	0	278	0	8655	0	8377	0.0	0.0
chr17	AC015909.1	50214100	50214775	0	676	0	2615	0	1939	0.0	0.0
chr17	EME1	50375184	50375983	0	800	0	3178	0	2378	0.0	0.0
chr17	EPN3	50536420	50537118	102	699	102	4499	0	3800	0.1459227467811159	0.0
chr17	SPATA20	50549984	50550312	0	329	1700	4742	1700	4413	0.0	0.38522547020167686
chr17	CACNA1G	50626016	50626766	51	751	356	10101	305	9350	0.06790945406125166	0.032620320855614976
chr17	ABCC3	50677743	50678219	0	477	459	8868	459	8391	0.0	0.05470146585627458
chr17	AKAP1	57120249	57121342	2001	1094	34241	5359	32240	4265	1.8290676416819014	7.559202813599062
chr17	RPS6KB1	59936214	59936541	0	328	26686	5329	26686	5001	0.0	5.336132773445311
chr17	KCNH6	63535668	63536068	1428	401	12821	4226	11393	3825	3.561097256857855	2.978562091503268
chr17	BPTF	67893369	67893725	51	357	51	14493	0	14136	0.14285714285714285	0.0
chr17	AMZ2	68248042	68248705	0	664	0	3654	0	2990	0.0	0.0
chr17	RPL38	74203703	74203958	0	256	0	3653	0	3397	0.0	0.0
chr17	RAB37	74745007	74747334	1615	2328	26395	4785	24780	2457	0.6937285223367697	10.085470085470085
chr17	RAB37	74745305	74747335	561	2031	26395	4785	25834	2754	0.276218611521418	9.380537400145244
chr17	RAB37	74745007	74747335	1615	2329	26395	4785	24780	2456	0.6934306569343066	10.089576547231271
chr17	RAB37	74745305	74747334	561	2030	26395	4785	25834	2755	0.27635467980295564	9.377132486388385
chr17	NUP85	75234636	75235201	0	566	35616	4297	35616	3731	0.0	9.545966228893057
chr17	MYO15B	75590906	75591246	0	341	29	12656	29	12315	0.0	0.002354851806739748
chr17	MYO15B	75620466	75621176	0	711	29	12656	29	11945	0.0	0.0024277940560904145
chr17	SAP30BP	75705610	75706092	0	483	51	7603	51	7120	0.0	0.007162921348314606
chr17	ITGB4	75757199	75757818	0	620	0	6607	0	5987	0.0	0.0
chr17	PRCD	76543802	76544370	51	569	51	5045	0	4476	0.08963093145869948	0.0
chr17	SNHG16	76557969	76558600	0	632	0	5256	0	4624	0.0	0.0
chr17	SNHG16	76558373	76559043	0	671	0	5256	0	4585	0.0	0.0
chr17	SNHG16	76557777	76559043	0	1267	0	5256	0	3989	0.0	0.0
chr17	SNHG20	77088748	77089271	0	524	10	4357	10	3833	0.0	0.0026089225150013043
chr17	SEC14L1	77213917	77216802	0	2886	102	8098	102	5212	0.0	0.019570222563315427
chr17	SEC14L1	77213917	77217101	0	3185	102	8098	102	4913	0.0	0.020761245674740483
chr17	ENDOV	80429772	80430343	0	572	105383	6269	105383	5697	0.0	18.497981393715992
chr17	ENDOV	80415452	80415821	7412	370	105383	6269	97971	5899	20.032432432432433	16.608069164265128
chr17	ENDOV	80415468	80415821	7136	354	105383	6269	98247	5915	20.15819209039548	16.609805579036347
chr17	HGS	81696606	81696747	0	142	0	8542	0	8400	0.0	0.0
chr17	HGS	81700466	81700600	0	135	0	8542	0	8407	0.0	0.0
chr17	HGS	81701243	81701929	0	687	0	8542	0	7855	0.0	0.0
chr17	GCGR	81811403	81811810	0	408	0	3158	0	2750	0.0	0.0
chr17	GCGR	81812806	81813057	0	252	0	3158	0	2906	0.0	0.0
chr17	SLC16A3	82235982	82236231	0	250	0	5874	0	5624	0.0	0.0
chr17	HEXD	82440996	82441266	0	271	0	4126	0	3855	0.0	0.0
chr17	HEXD	82439630	82440334	0	705	0	4126	0	3421	0.0	0.0
chr18	LINC00667	5238080	5241889	114279	3810	190677	9559	76398	5749	29.994488188976376	13.288919812141241
chr18	LINC00667	5240647	5241889	11608	1243	190677	9559	179069	8316	9.33869670152856	21.53306878306878
chr18	CEP192	13057584	13059312	11382	1729	258342	8599	246960	6870	6.582995951417004	35.94759825327511
chr18	IMPACT	24450778	24453531	0	2754	0	4343	0	1589	0.0	0.0
chr18	LINC01915	24694255	24694999	0	745	0	10136	0	9391	0.0	0.0
chr18	AQP4-AS1	26933615	26935904	0	2290	0	9052	0	6762	0.0	0.0
chr18	LINC01902	39870829	39876450	0	5622	0	12838	0	7216	0.0	0.0
chr18	LINC01902	39870829	39875941	0	5113	0	12838	0	7725	0.0	0.0
chr18	LINC01630	51561180	51564479	0	3300	153	17204	153	13904	0.0	0.011004027617951669
chr18	LINC01919	53577418	53578121	0	704	0	3770	0	3066	0.0	0.0
chr18	ZNF532	58864876	58865385	0	510	0	9593	0	9083	0.0	0.0
chr18	LINC01924	64158862	64159294	0	433	0	3465	0	3032	0.0	0.0
chr18	SALL3	78992073	78994905	0	2833	0	7010	0	4177	0.0	0.0
chr18	SALL3	78992073	78995462	0	3390	0	7010	0	3620	0.0	0.0
chr18	MYOM1	3134649	3134824	0	176	2142	6472	2142	6296	0.0	0.34021601016518427
chr18	MYOM1	3149144	3149201	0	58	2142	6472	2142	6414	0.0	0.33395696913002804
chr18	EPB41L3	5398020	5401043	0	3024	204	9610	204	6586	0.0	0.03097479501973884
chr18	RPRD1A	35989823	35993300	0	3478	0	5239	0	1761	0.0	0.0
chr18	RPRD1A	36025598	36027075	0	1478	0	5239	0	3761	0.0	0.0
chr18	MIR924HG	39206916	39208789	0	1874	416	11691	416	9817	0.0	0.042375471121523886
chr18	SYT4	43273579	43274394	0	816	0	2529	0	1713	0.0	0.0
chr18	AC090376.1	45149916	45150266	0	351	349	3400	349	3049	0.0	0.11446375860938013
chr18	RPL17	49491531	49491833	0	303	0	2096	0	1793	0.0	0.0
chr18	TCF4	55227848	55228361	137	514	106663	22459	106526	21945	0.26653696498054474	4.8542264752791064
chr18	LINC00305	64148774	64149074	0	301	0	2884	0	2583	0.0	0.0
chr18	LINC00305	64148774	64149088	0	315	0	2884	0	2569	0.0	0.0
chr18	MBP	77016831	77017065	0	235	0	6992	0	6757	0.0	0.0
chr19	WASH5P	65821	66499	25503	679	97583	2546	72080	1867	37.55964653902798	38.607391537225496
chr19	PLPPR3	814433	814749	22430	317	119096	2397	96666	2080	70.7570977917981	46.47403846153846
chr19	PLPPR3	821484	821955	7768	472	119096	2397	111328	1925	16.45762711864407	57.832727272727276
chr19	MED16	867962	868499	28608	538	271794	3907	243186	3369	53.174721189591075	72.18343722172752
chr19	TMEM259	1011366	1011612	129981	247	949744	3940	819763	3693	526.2388663967612	221.97752504738696
chr19	CBARP	1228286	1231275	15972	2990	29341	2939	13369	-51	5.3418060200668895	-262.1372549019608
chr19	TCF3	1609289	1611849	798223	2561	1381814	5864	583591	3303	311.6841077704022	176.68513472600665
chr19	TCF3	1609291	1611849	798221	2559	1381814	5864	583593	3305	311.92692457991404	176.57881996974282
chr19	TCF3	1619110	1619474	128717	365	1381814	5864	1253097	5499	352.64931506849314	227.8772504091653
chr19	TCF3	1615284	1615821	157123	538	1381814	5864	1224691	5326	292.0501858736059	229.9457378895982
chr19	KLF16	1852398	1854760	162304	2363	200408	2969	38104	606	68.68556919170545	62.87788778877888
chr19	MKNK2	2037464	2039856	206996	2393	415667	5232	208671	2839	86.50062682824905	73.5015850651638
chr19	PLEKHJ1	2233153	2234061	198895	909	317968	3179	119073	2270	218.8063806380638	52.45506607929516
chr19	PLEKHJ1	2235761	2235990	30018	230	317968	3179	287950	2949	130.51304347826087	97.64326890471347
chr19	LSM7	2328386	2328586	41037	201	268543	1691	227506	1490	204.16417910447763	152.68859060402684
chr19	MFSD12	3544198	3544732	40592	535	623954	4683	583362	4148	75.87289719626168	140.63693346190936
chr19	CACTIN	3610644	3612413	107356	1770	244619	5168	137263	3398	60.653107344632765	40.39523248969982
chr19	LONP1	5719703	5720146	93245	444	2189766	5053	2096521	4609	210.01126126126127	454.87546105445864
chr19	SLC25A41	6426036	6426561	134	526	2934	1657	2800	1131	0.25475285171102663	2.475685234305924
chr19	SH2D3A	6754051	6754425	1224	375	7255	5600	6031	5225	3.264	1.1542583732057417
chr19	ADGRE4P	6981079	6981770	0	692	0	3337	0	2645	0.0	0.0
chr19	CD209	7747305	7747511	132676	207	153407	4420	20731	4213	640.9468599033817	4.920721576074056
chr19	ADAMTS10	8585131	8585660	51	530	3150	5729	3099	5199	0.09622641509433963	0.5960761684939412
chr19	ZNF266	9418761	9419299	0	539	6936	4513	6936	3974	0.0	1.7453447408152996
chr19	ZGLP1	10308184	10308550	0	367	76889	1531	76889	1164	0.0	66.05584192439862
chr19	RAVER1	10320654	10320951	0	298	8210	4719	8210	4421	0.0	1.8570459172133003
chr19	ICAM3	10335065	10335976	12174	912	9537	2076	-2637	1164	13.348684210526315	-2.265463917525773
chr19	ICAM3	10338681	10339245	0	565	9537	2076	9537	1511	0.0	6.311714096624752
chr19	CDC37	10395227	10395543	163943	317	844676	3052	680733	2735	517.1703470031546	248.89689213893968
chr19	CDC37	10395227	10395696	322484	470	844676	3052	522192	2582	686.1361702127659	202.24322230828815
chr19	AP1M2	10583605	10584070	226	466	73812	2145	73586	1679	0.48497854077253216	43.827278141751044
chr19	TMEM205	11345519	11346268	0	750	12586	1389	12586	639	0.0	19.69640062597809
chr19	ECSIT	11507701	11508048	0	348	0	2365	0	2017	0.0	0.0
chr19	ACP5	11577592	11578194	0	603	0	2095	0	1492	0.0	0.0
chr19	RTBDN	12834784	12835415	665	632	454011	2684	453346	2052	1.0522151898734178	220.92884990253413
chr19	STX10	13144061	13144671	222	611	324	1305	102	694	0.36333878887070375	0.14697406340057637
chr19	DNAJB1	14514781	14517046	16758	2266	66706	7011	49948	4745	7.39541041482789	10.526448893572182
chr19	SLC1A6	14976760	14977777	0	1018	0	7643	0	6625	0.0	0.0
chr19	AKAP8L	15403474	15403715	200	242	7065	4512	6865	4270	0.8264462809917356	1.6077283372365339
chr19	RASAL3	15451623	15452815	196	1193	15134	4353	14938	3160	0.16429170159262363	4.727215189873418
chr19	RASAL3	15452044	15452815	196	772	15134	4353	14938	3581	0.2538860103626943	4.171460485897794
chr19	PGLYRP2	15468644	15469929	59310	1286	68674	3114	9364	1828	46.11975116640747	5.12253829321663
chr19	SMIM7	16646147	16647261	70710	1115	247567	4512	176857	3397	63.417040358744394	52.06270238445688
chr19	USHBP1	17258211	17258701	0	491	21163	5041	21163	4550	0.0	4.651208791208791
chr19	USHBP1	17262551	17264150	19326	1600	21163	5041	1837	3441	12.07875	0.5338564370822435
chr19	IQCN	18264923	18267526	77903	2604	87257	7022	9354	4418	29.916666666666668	2.117247623358986
chr19	ISYNA1	18437598	18437988	0	391	0	3012	0	2621	0.0	0.0
chr19	ISYNA1	18437859	18438162	0	304	0	3012	0	2708	0.0	0.0
chr19	COMP	18790849	18791305	0	457	74	3110	74	2653	0.0	0.02789295137580098
chr19	SUGP2	18994365	18995280	23438	916	231411	6566	207973	5650	25.587336244541486	36.80938053097345
chr19	SUGP2	19024618	19026226	3067	1609	231411	6566	228344	4957	1.906152889993785	46.06495864434134
chr19	SUGP2	19004167	19004646	19307	480	231411	6566	212104	6086	40.22291666666667	34.85113374958922
chr19	ZNF506	19791561	19792484	48787	924	123524	6969	74737	6045	52.79978354978355	12.363440860215054
chr19	ZNF208	21986727	21987311	51	585	7692	6782	7641	6197	0.08717948717948718	1.2330159754720025
chr19	LINC01859	23023345	23024353	0	1009	51	3966	51	2957	0.0	0.017247210010145418
chr19	LINC01859	23023345	23024278	0	934	51	3966	51	3032	0.0	0.016820580474934038
chr19	LINC00662	27792999	27793899	0	901	204	28747	204	27846	0.0	0.007326007326007326
chr19	LINC00662	27792999	27794003	0	1005	204	28747	204	27742	0.0	0.0073534712709970446
chr19	LINC01837	31886625	31886978	0	354	400	7200	400	6846	0.0	0.05842827928717499
chr19	LINC01837	31910173	31910613	0	441	400	7200	400	6759	0.0	0.05918035212309513
chr19	LINC01837	31966703	31967633	0	931	400	7200	400	6269	0.0	0.0638060296698038
chr19	SLC7A9	32859840	32860650	1411	811	4301	2601	2890	1790	1.7398273736128236	1.6145251396648044
chr19	AC008555.4	34860173	34860715	999	543	2040	1105	1041	562	1.839779005524862	1.8523131672597866
chr19	LINC00904	34902201	34903083	1071	883	325148	3576	324077	2693	1.2129105322763307	120.34051243965837
chr19	LGI4	35126269	35127017	0	749	482	4379	482	3630	0.0	0.1327823691460055
chr19	DMKN	35510183	35510427	34661	245	109511	4934	74850	4689	141.4734693877551	15.962891874600128
chr19	DMKN	35499957	35500580	55431	624	109511	4934	54080	4310	88.83173076923077	12.547563805104408
chr19	DMKN	35500377	35500580	1803	204	109511	4934	107708	4730	8.838235294117647	22.77124735729387
chr19	DMKN	35510183	35510510	39834	328	109511	4934	69677	4606	121.4451219512195	15.127442466348242
chr19	U2AF1L4	35743154	35743345	0	192	153	2606	153	2414	0.0	0.06338028169014084
chr19	LINC01529	35789406	35789928	0	523	0	4162	0	3639	0.0	0.0
chr19	LINC01529	35791016	35791852	0	837	0	4162	0	3325	0.0	0.0
chr19	LINC00665	36324923	36327225	0	2303	58340	10527	58340	8224	0.0	7.093871595330739
chr19	AC016590.1	37266813	37267611	11943	799	16697	2744	4754	1945	14.947434292866083	2.444215938303342
chr19	RASGRP4	38409057	38410096	714	1040	2630	4074	1916	3034	0.6865384615384615	0.6315095583388266
chr19	RASGRP4	38411114	38411381	279	268	2630	4074	2351	3806	1.041044776119403	0.617708880714661
chr19	MAP4K1	38607863	38608033	0	171	21158	3852	21158	3681	0.0	5.747894593860364
chr19	LGALS4	38812430	38812945	459	516	6179	1410	5720	894	0.8895348837209303	6.39821029082774
chr19	HNRNPL	38840095	38840559	0	465	306	5612	306	5147	0.0	0.059452108024091704
chr19	CCER2	38908979	38909325	0	347	0	1062	0	715	0.0	0.0
chr19	GMFG	39328358	39329073	158551	716	731932	1395	573381	679	221.43994413407822	844.4491899852725
chr19	RPS16	39433521	39433761	2657	241	75492	1461	72835	1220	11.024896265560166	59.700819672131146
chr19	RPS16	39433222	39433569	23249	348	75492	1461	52243	1113	66.80747126436782	46.93890386343217
chr19	DYRK1B	39826671	39826987	0	317	2739	3204	2739	2887	0.0	0.9487357118115691
chr19	FBL	39834457	39834813	7571	357	24370	2147	16799	1790	21.207282913165265	9.384916201117319
chr19	FBL	39840616	39840787	3776	172	24370	2147	20594	1975	21.953488372093023	10.427341772151898
chr19	CCNP	40222207	40223303	357	1097	357	2051	0	954	0.325432999088423	0.0
chr19	C19ORF47	40321062	40322376	32448	1315	290305	2632	257857	1317	24.67528517110266	195.791192103265
chr19	PRX	40393767	40398816	204	5050	204	6803	0	1753	0.0403960396039604	0.0
chr19	BLVRB	40458173	40458545	0	373	103	1617	103	1244	0.0	0.08279742765273312
chr19	COQ8B	40705095	40705447	1536	353	19490	11023	17954	10670	4.351274787535411	1.6826616682286786
chr19	COQ8B	40716586	40716882	128	297	19490	11023	19362	10726	0.43097643097643096	1.805146373298527
chr19	PCAT19	41456360	41457149	0	790	0	5541	0	4751	0.0	0.0
chr19	PCAT19	41454168	41456487	0	2320	0	5541	0	3221	0.0	0.0
chr19	ATP1A3	41966581	41967340	0	760	1	5613	1	4853	0.0	0.000206058108386565
chr19	GSK3A	42230189	42230867	0	679	0	5487	0	4808	0.0	0.0
chr19	GSK3A	42242182	42242602	0	421	0	5487	0	5066	0.0	0.0
chr19	KCNN4	43766532	43767707	612	1176	1473	3224	861	2048	0.5204081632653061	0.42041015625
chr19	KCNN4	43774191	43774619	0	429	1473	3224	1473	2795	0.0	0.5270125223613595
chr19	EML2	45638504	45638873	153	370	36470	6562	36317	6192	0.4135135135135135	5.865148578811369
chr19	IGFL2-AS1	46189028	46190414	306	1387	92395	3342	92089	1955	0.220620043258832	47.10434782608696
chr19	PRKD2	46716130	46717114	9581	985	22041	5270	12460	4285	9.726903553299492	2.90781796966161
chr19	KPTN	47483934	47484219	823	286	3100	2116	2277	1830	2.8776223776223775	1.2442622950819673
chr19	CCDC114	48296461	48297668	51	1208	161	5076	110	3868	0.042218543046357616	0.02843846949327818
chr19	RPL18	48615330	48615946	0	617	58997	1757	58997	1140	0.0	51.751754385964915
chr19	FUT1	48752489	48753122	24310	634	42671	4347	18361	3713	38.34384858044164	4.945057904659305
chr19	FUT1	48752611	48753122	24039	512	42671	4347	18632	3835	46.951171875	4.858409387222946
chr19	CGB7	49057120	49058057	0	938	240	2976	240	2038	0.0	0.11776251226692837
chr19	IRF3	49664673	49665857	1136	1185	28716	3464	27580	2279	0.9586497890295359	12.101799034664326
chr19	NUP62	49927693	49929504	0	1812	0	2772	0	960	0.0	0.0
chr19	KCNC3	50311936	50316091	154451	4156	166224	6800	11773	2644	37.16337824831569	4.452723146747353
chr19	KLK12	51029093	51029457	0	365	0	1762	0	1397	0.0	0.0
chr19	KLK12	51029129	51029457	0	329	0	1762	0	1433	0.0	0.0
chr19	NKG7	51371939	51372202	0	264	0	924	0	660	0.0	0.0
chr19	ZNF577	51886820	51887951	0	1132	1110	5101	1110	3969	0.0	0.2796674225245654
chr19	ZNF577	51886820	51887936	0	1117	1110	5101	1110	3984	0.0	0.2786144578313253
chr19	ZNF649	51899797	51900294	2907	498	3570	3541	663	3043	5.837349397590361	0.21787709497206703
chr19	ZNF528-AS1	52396609	52397267	96	659	37060	4684	36964	4025	0.1456752655538695	9.18360248447205
chr19	ZNF160	53091412	53091720	114	309	58211	7275	58097	6966	0.36893203883495146	8.340080390467987
chr19	OSCAR	54094669	54096153	51	1485	87	2089	36	604	0.03434343434343434	0.059602649006622516
chr19	HSPBP1	55279398	55279856	0	459	0	1861	0	1402	0.0	0.0
chr19	FAM71E2	55360692	55360905	0	214	0	3231	0	3017	0.0	0.0
chr19	ZSCAN5B	56192668	56193179	1326	512	245928	2064	244602	1552	2.58984375	157.60438144329896
chr19	ZNF154	57697366	57701145	2679	3780	10708	5717	8029	1937	0.7087301587301588	4.145069695405266
chr19	CHMP2A	58551565	58551967	0	403	250	1713	250	1310	0.0	0.19083969465648856
chr19	FSTL3	681332	681771	48827	440	254495	3031	205668	2591	110.97045454545454	79.3778463913547
chr19	PTBP1	804291	804702	608275	412	5035324	6449	4427049	6037	1476.3956310679612	733.319363922478
chr19	ABCA7	1056906	1057429	4784	524	141657	8487	136873	7963	9.129770992366412	17.188622378500565
chr19	ARHGAP45	1080254	1080547	16181	294	404784	6133	388603	5839	55.03741496598639	66.55300565165268
chr19	GPX4	1105365	1105510	644709	146	2322068	1885	1677359	1739	4415.815068493151	964.5537665324899
chr19	ATP5F1D	1244314	1244825	181640	512	414720	2003	233080	1491	354.765625	156.32461435278336
chr19	CIRBP	1271980	1273172	635340	1193	816286	5567	180946	4374	532.5565800502934	41.36854138088706
chr19	CIRBP	1271139	1271467	58364	329	816286	5567	757922	5238	177.3981762917933	144.69683085147003
chr19	CIRBP	1271139	1271632	62070	494	816286	5567	754216	5073	125.64777327935222	148.67258032722256
chr19	CIRBP	1271980	1274810	709831	2831	816286	5567	106455	2736	250.73507594489578	38.90899122807018
chr19	CIRBP	1271139	1271365	46606	227	816286	5567	769680	5340	205.31277533039648	144.13483146067415
chr19	CIRBP	1271980	1274440	698803	2461	816286	5567	117483	3106	283.9508329947176	37.82453316162267
chr19	CIRBP	1274306	1274810	17734	505	816286	5567	798552	5062	35.116831683168314	157.75424733306994
chr19	NDUFS7	1393241	1395584	95952	2344	318392	4310	222440	1966	40.93515358361775	113.14343845371312
chr19	RPS15	1440018	1440494	1709971	477	2040851	1135	330880	658	3584.844863731656	502.85714285714283
chr19	CSNK1G2	1978304	1978511	35959	208	467344	3302	431385	3094	172.87980769230768	139.42630898513252
chr19	IZUMO4	2097251	2097495	1095	245	4993	2228	3898	1983	4.469387755102041	1.9657085224407465
chr19	OAZ1	2271384	2271530	523998	147	3699685	2110	3175687	1963	3564.612244897959	1617.7722873153336
chr19	GADD45B	2476355	2476630	43660	276	233968	1599	190308	1323	158.18840579710144	143.84580498866214
chr19	NCLN	3207628	3209575	404232	1948	940794	2813	536562	865	207.51129363449692	620.3028901734104
chr19	HMG20B	3572978	3573347	4425	370	816140	3473	811715	3103	11.95945945945946	261.5903963905898
chr19	NMRK2	3938602	3938759	0	158	0	1149	0	991	0.0	0.0
chr19	MIR7-3HG	4769132	4769351	0	220	0	2134	0	1914	0.0	0.0
chr19	MIR7-3HG	4769629	4770449	102	821	0	2134	-102	1313	0.12423873325213154	-0.07768469154607768
chr19	CRB3	6466465	6467221	255	757	255	1605	0	848	0.3368560105680317	0.0
chr19	ARHGEF18	7470125	7472477	1491	2353	3875	6116	2384	3763	0.6336591585210369	0.6335370714855169
chr19	ANGPTL4	8373704	8374370	3080	667	8298	2482	5218	1815	4.617691154422789	2.874931129476584
chr19	HNRNPM	8465323	8465515	76	193	19490	4301	19414	4108	0.39378238341968913	4.725900681596884
chr19	ZNF561-AS1	9626783	9627806	0	1024	46434	6441	46434	5417	0.0	8.571903267491232
chr19	PIN1	9849089	9849682	0	594	204	2938	204	2344	0.0	0.08703071672354949
chr19	SHFL	10089110	10089378	0	269	0	3788	0	3519	0.0	0.0
chr19	SHFL	10089306	10089695	0	390	0	3788	0	3398	0.0	0.0
chr19	PDE4A	10461525	10461999	112079	475	262576	6586	150497	6111	235.9557894736842	24.627229585992474
chr19	ATG4D	10544782	10545130	153	349	3489	2174	3336	1825	0.4383954154727794	1.827945205479452
chr19	ATG4D	10551896	10552121	51	226	3489	2174	3438	1948	0.22566371681415928	1.764887063655031
chr19	ILF3	10683916	10685765	9250	1850	87032	9698	77782	7848	5.0	9.911060142711518
chr19	QTRT1	10712160	10712628	51	469	22598	2287	22547	1818	0.10874200426439233	12.402090209020901
chr19	PRKCSH	11436040	11436505	19789	466	102037	4436	82248	3970	42.4656652360515	20.717380352644835
chr19	GCDH	12891159	12891395	0	237	1377	4015	1377	3778	0.0	0.3644785600847009
chr19	CCDC130	13758867	13759272	0	406	0	3082	0	2676	0.0	0.0
chr19	CYP4F12	15696160	15696512	0	353	102	4073	102	3720	0.0	0.027419354838709678
chr19	CYP4F12	15683492	15684882	0	1391	102	4073	102	2682	0.0	0.03803131991051454
chr19	UCA1	15834501	15836327	0	1827	0	2973	0	1146	0.0	0.0
chr19	UCA1	15828950	15829338	0	389	0	2973	0	2584	0.0	0.0
chr19	UCA1	15828957	15829338	0	382	0	2973	0	2591	0.0	0.0
chr19	UCA1	15834501	15835417	0	917	0	2973	0	2056	0.0	0.0
chr19	UCA1	15835217	15836240	0	1024	0	2973	0	1949	0.0	0.0
chr19	UCA1	15834501	15835416	0	916	0	2973	0	2057	0.0	0.0
chr19	UCA1	15834501	15835419	0	919	0	2973	0	2054	0.0	0.0
chr19	UCA1	15834501	15835280	0	780	0	2973	0	2193	0.0	0.0
chr19	LINC00905	16034479	16035012	0	534	0	3588	0	3054	0.0	0.0
chr19	TPM4	16095263	16095893	0	631	102	9477	102	8846	0.0	0.01153063531539679
chr19	HSH2D	16152551	16153208	0	658	0	3407	0	2749	0.0	0.0
chr19	MYO9B	17211650	17213284	235155	1635	247569	9359	12414	7724	143.8256880733945	1.6071983428275505
chr19	OCEL1	17228802	17229215	225	414	1983	1754	1758	1340	0.5434782608695652	1.3119402985074626
chr19	BABAM1	17268793	17269091	520	299	18401	1792	17881	1493	1.7391304347826086	11.976557267247154
chr19	GTPBP3	17338953	17339266	12395	314	60901	3908	48506	3594	39.47452229299363	13.49638286032276
chr19	BISPR	17413096	17413305	1583	210	20468	3025	18885	2815	7.538095238095238	6.708703374777975
chr19	BISPR	17405740	17406296	5454	557	20468	3025	15014	2468	9.791741472172351	6.083468395461913
chr19	MVB12A	17424930	17425332	38079	403	82217	3168	44138	2765	94.48883374689827	15.963110307414105
chr19	SLC27A1	17486562	17487335	51	774	152	6378	101	5604	0.06589147286821706	0.018022840827980013
chr19	RPL18A	17861292	17861472	0	181	102	2968	102	2787	0.0	0.03659849300322928
chr19	ARRDC2	18008169	18008584	0	416	234	3861	234	3445	0.0	0.06792452830188679
chr19	UBA52	18574869	18575241	25	373	21617	2211	21592	1838	0.06702412868632708	11.747551686615887
chr19	ZNF714	21116806	21125094	43292	8289	43856	9849	564	1560	5.222825431294487	0.36153846153846153
chr19	GOLGA2P9	22601359	22602038	476	680	578	2661	102	1981	0.7	0.05148914689550732
chr19	AC092279.1	24065462	24066750	0	1289	3569	11997	3569	10708	0.0	0.3333022039596563
chr19	AC006504.5	27805604	27806185	0	582	102	13629	102	13047	0.0	0.00781788916992412
chr19	AC006504.5	27805927	27806782	0	856	102	13629	102	12773	0.0	0.007985594613638142
chr19	AC006504.5	27805604	27806782	0	1179	102	13629	102	12450	0.0	0.00819277108433735
chr19	AC079466.1	28610981	28612154	0	1174	0	4063	0	2889	0.0	0.0
chr19	LINC00906	28967804	28969042	0	1239	144	6203	144	4964	0.0	0.029008863819500404
chr19	LINC00906	28970200	28970670	0	471	144	6203	144	5732	0.0	0.02512212142358688
chr19	LINC01532	29012510	29013108	0	599	0	4140	0	3541	0.0	0.0
chr19	LINC01791	31167512	31167833	0	322	0	3441	0	3119	0.0	0.0
chr19	LINC01533	32039492	32040570	0	1079	0	3749	0	2670	0.0	0.0
chr19	TDRD12	32826097	32826357	0	261	0	7059	0	6798	0.0	0.0
chr19	GARRE1	34299678	34300968	1479	1291	2019	7440	540	6149	1.1456235476374903	0.08781915758659944
chr19	SCN1B	35039634	35040449	0	816	1359	4311	1359	3495	0.0	0.3888412017167382
chr19	HPN	35041721	35042522	0	802	67	3344	67	2542	0.0	0.026357199055861525
chr19	FXYD3	35122764	35122954	510	191	593	3345	83	3154	2.670157068062827	0.02631578947368421
chr19	FXYD1	35142719	35143035	0	317	1785	1919	1785	1602	0.0	1.1142322097378277
chr19	FXYD1	35142719	35143050	0	332	1785	1919	1785	1587	0.0	1.1247637051039698
chr19	FXYD7	35151253	35151482	51	230	133	1691	82	1461	0.2217391304347826	0.05612594113620808
chr19	USF2	35269445	35269699	0	255	0	2816	0	2561	0.0	0.0
chr19	USF2	35278697	35279074	0	378	0	2816	0	2438	0.0	0.0
chr19	LINC01531	35406584	35409151	1275	2568	1312	3495	37	927	0.49649532710280375	0.039913700107874865
chr19	LINC01766	35600640	35601499	0	860	0	971	0	111	0.0	0.0
chr19	LINC01766	35600640	35601501	0	862	0	971	0	109	0.0	0.0
chr19	HAUS5	35619612	35620123	0	512	7802	5031	7802	4519	0.0	1.726488161097588
chr19	ETV2	35642433	35642698	7841	266	35824	2008	27983	1742	29.477443609022558	16.063719862227323
chr19	LIN37	35753086	35754157	561	1072	1006	2440	445	1368	0.523320895522388	0.3252923976608187
chr19	PROSER3	35766767	35768065	13201	1299	147436	4865	134235	3566	10.162432640492687	37.64301738642737
chr19	ARHGAP33	35787167	35788822	0	1656	0	4441	0	2785	0.0	0.0
chr19	ZNF568	36949511	36952741	5347	3231	15675	9232	10328	6001	1.6549056019808108	1.7210464922512914
chr19	LINC01535	37262541	37265532	4998	2992	2495	2437	-2503	-555	1.6704545454545454	4.50990990990991
chr19	CATSPERG	38362375	38362832	0	458	241	6878	241	6420	0.0	0.03753894080996885
chr19	FAM98C	38403337	38403694	51	358	1304	2931	1253	2573	0.1424581005586592	0.4869801787796347
chr19	ACP7	39100579	39100853	0	275	302035	3057	302035	2782	0.0	108.56757728253055
chr19	SAMD4B	39380586	39380785	20517	200	174468	5835	153951	5635	102.585	27.32049689440994
chr19	SELENOV	39518607	39518632	0	26	55866	1738	55866	1712	0.0	32.632009345794394
chr19	PLD3	40365552	40365930	0	379	102	4360	102	3981	0.0	0.02562170308967596
chr19	SPTBN4	40549188	40549413	1314	226	52526	11711	51212	11485	5.814159292035399	4.459033521985198
chr19	EGLN2	40807808	40808432	16	625	22647	5469	22631	4844	0.0256	4.671965317919075
chr19	HNRNPUL1	41264371	41264798	800	428	388413	6669	387613	6241	1.8691588785046729	62.10751482134273
chr19	TMEM91	41382771	41384083	0	1313	0	1776	0	463	0.0	0.0
chr19	DMRTC2	41850311	41850700	41704	390	93978	2448	52274	2058	106.93333333333334	25.40038872691934
chr19	CD79A	41878989	41879653	4717	665	6808	1348	2091	683	7.093233082706767	3.061493411420205
chr19	PRR19	42309578	42310813	43	1236	51	2578	8	1342	0.03478964401294499	0.005961251862891207
chr19	TMEM145	42323582	42325064	0	1483	0	2662	0	1179	0.0	0.0
chr19	ZNF226	44165587	44165807	600	221	107816	5116	107216	4895	2.7149321266968327	21.903166496424923
chr19	BCAM	44819581	44820822	51	1242	1675	4838	1624	3596	0.04106280193236715	0.45161290322580644
chr19	APOC1P1	44926803	44927033	351	231	10971	925	10620	694	1.5194805194805194	15.302593659942364
chr19	FKRP	46748514	46748884	0	371	102	5171	102	4800	0.0	0.02125
chr19	SELENOW	47780724	47780749	241	26	79073	2027	78832	2001	9.26923076923077	39.39630184907546
chr19	ZSWIM9	48194652	48197620	9240	2969	13425	3768	4185	799	3.1121589760862243	5.2377972465581975
chr19	BAX	48955686	48955833	51	148	182482	1767	182431	1619	0.34459459459459457	112.68128474366893
chr19	BAX	48960809	48961798	105349	990	182482	1767	77133	777	106.41313131313132	99.27027027027027
chr19	TRPM4	49211163	49211834	1447	672	3570	6483	2123	5811	2.1532738095238093	0.365341593529513
chr19	CPT1C	49713419	49713731	20411	313	34491	5093	14080	4780	65.21086261980831	2.9456066945606696
chr19	AP2A1	49799967	49800150	0	184	3704	6084	3704	5900	0.0	0.6277966101694915
chr19	MYH14	50210362	50210770	229	409	580074	7572	579845	7163	0.5599022004889975	80.95002094094653
chr19	MYH14	50286481	50286694	594	214	580074	7572	579480	7358	2.7757009345794392	78.7550964936124
chr19	NR1H2	50376472	50376826	7154	355	256105	5355	248951	5000	20.152112676056337	49.7902
chr19	KLK3	50858028	50858315	0	288	0	2916	0	2628	0.0	0.0
chr19	PRPF31	54129056	54129370	0	315	71	2686	71	2371	0.0	0.029945170814002532
chr19	CNOT3	54153714	54155680	51	1967	191	5828	140	3861	0.02592780884595831	0.03626003626003626
chr19	CNOT3	54153714	54155681	51	1968	191	5828	140	3860	0.025914634146341462	0.03626943005181347
chr19	TSEN34	54193174	54194536	50	1363	50	2983	0	1620	0.036683785766691124	0.0
chr19	RPS9	54206552	54207647	0	1096	0	3672	0	2576	0.0	0.0
chr19	RPS9	54206275	54206724	0	450	0	3672	0	3222	0.0	0.0
chr19	KIR3DX1	54532691	54533078	0	388	30114	4481	30114	4093	0.0	7.357439530906426
chr19	FCAR	54888006	54889067	0	1062	0	3333	0	2271	0.0	0.0
chr19	NLRP2	54969998	54970295	112840	298	117189	6333	4349	6035	378.6577181208054	0.7206296603148301
chr19	EPS8L1	55083377	55083644	0	268	0	4935	0	4667	0.0	0.0
chr19	ZNF582-AS1	56398276	56399168	0	893	26	1662	26	769	0.0	0.033810143042912875
chr19	ZNF667-AS1	56494162	56495439	0	1278	108	6804	108	5526	0.0	0.019543973941368076
chr19	ZNF667-AS1	56494162	56495437	0	1276	108	6804	108	5528	0.0	0.019536903039073805
chr19	AC006115.2	56789927	56791307	1122	1381	50818	16166	49696	14785	0.8124547429398986	3.361244504565438
chr19	ZNF264	57191500	57191946	0	447	51	12290	51	11843	0.0	0.004306341298657435
chr19	AURKC	57233459	57233608	0	150	51	1747	51	1597	0.0	0.031934877896055106
chr19	ZNF135	58066740	58069405	9904	2666	36365	6389	26461	3723	3.7149287321830458	7.10744023636852
chr19	A1BG-AS1	58353713	58355183	57109	1471	109092	3102	51983	1631	38.82324949014276	31.871857755977928
chr19	ZNF446	58480175	58481224	3468	1050	3927	4698	459	3648	3.302857142857143	0.12582236842105263
chr20	TMC2	2613193	2614020	0	828	670623	5196	670623	4368	0.0	153.5309065934066
chr20	SMOX	4182088	4182848	0	761	1497	2958	1497	2197	0.0	0.6813837050523441
chr20	PLCB1	8962195	8963010	0	816	1579	16902	1579	16086	0.0	0.09815989058808902
chr20	BTBD3	11917777	11918601	0	825	2165	5915	2165	5090	0.0	0.42534381139489197
chr20	KIZ	21244244	21246622	0	2379	2481	3152	2481	773	0.0	3.2095730918499354
chr20	LINC01727	21615382	21615888	0	507	0	7415	0	6908	0.0	0.0
chr20	AL118508.1	23180410	23180793	0	384	0	3797	0	3413	0.0	0.0
chr20	AL118508.1	23186399	23187640	0	1242	0	3797	0	2555	0.0	0.0
chr20	AL118508.1	23180153	23180528	0	376	0	3797	0	3421	0.0	0.0
chr20	AL118508.1	23180167	23180528	0	362	0	3797	0	3435	0.0	0.0
chr20	BPIFB4	33082937	33083874	1938	938	32181	2831	30243	1893	2.066098081023454	15.97622820919176
chr20	MAP1LC3A	34559735	34560345	0	611	0	1158	0	547	0.0	0.0
chr20	MYH7B	35001244	35001526	0	283	0	8201	0	7918	0.0	0.0
chr20	MYH7B	35001947	35002437	0	491	0	8201	0	7710	0.0	0.0
chr20	ROMO1	35699450	35699763	0	314	51	681	51	367	0.0	0.13896457765667575
chr20	SNHG11	38450261	38450921	0	661	0	4261	0	3600	0.0	0.0
chr20	SNHG11	38450335	38450921	0	587	0	4261	0	3674	0.0	0.0
chr20	SNHG11	38447465	38448730	0	1266	0	4261	0	2995	0.0	0.0
chr20	SNHG11	38450335	38450920	0	586	0	4261	0	3675	0.0	0.0
chr20	SNHG11	38448661	38450447	0	1787	0	4261	0	2474	0.0	0.0
chr20	SNHG11	38447465	38450447	0	2983	0	4261	0	1278	0.0	0.0
chr20	LINC01370	40007902	40008459	0	558	0	4191	0	3633	0.0	0.0
chr20	L3MBTL1	43530283	43530889	703034	607	2544979	12176	1841945	11569	1158.2108731466228	159.21384735067855
chr20	L3MBTL1	43536096	43536458	640117	363	2544979	12176	1904862	11813	1763.4077134986226	161.25133327689832
chr20	L3MBTL1	43540752	43541189	1479	438	2544979	12176	2543500	11738	3.3767123287671232	216.68938490373148
chr20	L3MBTL1	43536100	43536458	631525	359	2544979	12176	1913454	11817	1759.1225626740948	161.92383853769994
chr20	PIGT	45418771	45419395	0	625	51	11655	51	11030	0.0	0.004623753399818676
chr20	WFDC2	45479438	45480094	0	657	0	1137	0	480	0.0	0.0
chr20	SNX21	45840638	45842881	53762	2244	68032	3701	14270	1457	23.958110516934045	9.794097460535347
chr20	CTSA	45897716	45898109	0	394	25021	7771	25021	7377	0.0	3.3917581672766706
chr20	CTSA	45896964	45898109	51	1146	25021	7771	24970	6625	0.04450261780104712	3.769056603773585
chr20	LINC00494	48365872	48367162	0	1291	0	5148	0	3857	0.0	0.0
chr20	LINC00494	48366473	48367059	0	587	0	5148	0	4561	0.0	0.0
chr20	LINC01273	50172922	50173592	0	671	51	1682	51	1011	0.0	0.050445103857566766
chr20	LINC01270	50311804	50312430	0	627	2462	5084	2462	4457	0.0	0.5523894996634507
chr20	STX16	58651271	58652087	0	817	0	5049	0	4232	0.0	0.0
chr20	STX16	58651282	58652138	0	857	0	5049	0	4192	0.0	0.0
chr20	NELFCD	58994641	58995133	0	493	51	5233	51	4740	0.0	0.010759493670886076
chr20	OSBPL2	62281057	62281879	816	823	126363	10826	125547	10003	0.991494532199271	12.550934719584125
chr20	ARFGAP1	63287563	63289788	0	2226	0	6173	0	3947	0.0	0.0
chr20	LIME1	63737820	63738060	0	241	0	2442	0	2201	0.0	0.0
chr20	TCEA2	64069764	64070635	0	872	0	3909	0	3037	0.0	0.0
chr20	TCEA2	64069764	64070414	0	651	0	3909	0	3258	0.0	0.0
chr20	SLC52A3	760079	761824	663	1746	796	5203	133	3457	0.3797250859106529	0.03847266415967602
chr20	SIRPB2	1479699	1480065	0	367	0	4491	0	4124	0.0	0.0
chr20	IDH3B	2658394	2658837	0	444	510	2575	510	2131	0.0	0.2393242609103707
chr20	LZTS3	3165496	3166360	26500	865	103851	4844	77351	3979	30.63583815028902	19.439808997235485
chr20	GFRA4	3660754	3661289	0	536	0	1566	0	1030	0.0	0.0
chr20	LINC00658	5433788	5434405	0	618	102	2892	102	2274	0.0	0.044854881266490766
chr20	LINC00658	5433788	5434401	0	614	102	2892	102	2278	0.0	0.04477611940298507
chr20	LINC00658	5431961	5432638	0	678	102	2892	102	2214	0.0	0.04607046070460705
chr20	LINC00658	5431988	5432638	0	651	102	2892	102	2241	0.0	0.04551539491298527
chr20	LINC00658	5433962	5434405	0	444	102	2892	102	2448	0.0	0.041666666666666664
chr20	LINC00658	5432010	5432638	0	629	102	2892	102	2263	0.0	0.04507291206363235
chr20	MKKS	10412529	10413931	402	1403	184231	7048	183829	5645	0.28652886671418387	32.56492471213463
chr20	AL050403.1	10889948	10890280	0	333	0	2937	0	2604	0.0	0.0
chr20	AL049646.1	18323643	18325234	357	1592	3162	3242	2805	1650	0.2242462311557789	1.7
chr20	RALGAPA2	20412026	20412148	0	123	11618	11690	11618	11567	0.0	1.0044090948387654
chr20	LINC01427	22282353	22282672	0	320	255	6326	255	6006	0.0	0.042457542457542456
chr20	LINC01747	22684744	22685296	0	553	0	4355	0	3802	0.0	0.0
chr20	FAM182B	25774017	25775312	204	1296	10542	6640	10338	5344	0.1574074074074074	1.9345059880239521
chr20	NECAB3	33657086	33657857	60447	772	61974	4125	1527	3353	78.29922279792746	0.4554130629287205
chr20	NECAB3	33659496	33659732	0	237	61974	4125	61974	3888	0.0	15.939814814814815
chr20	NECAB3	33659884	33660395	306	512	61974	4125	61668	3613	0.59765625	17.068364240243564
chr20	EIF6	35284175	35284492	3587	318	105796	1643	102209	1325	11.279874213836479	77.1388679245283
chr20	FER1L4	35563853	35564918	1019	1066	22581	9174	21562	8108	0.9559099437148217	2.6593487913172176
chr20	FER1L4	35559340	35560638	3824	1299	22581	9174	18757	7875	2.9438029253271747	2.38184126984127
chr20	FER1L4	35560122	35560638	1684	517	22581	9174	20897	8657	3.2572533849129592	2.413884717569597
chr20	FER1L4	35559155	35559627	18042	473	22581	9174	4539	8701	38.143763213530654	0.5216641765314332
chr20	DSN1	36770872	36771193	612	322	122812	2481	122200	2159	1.9006211180124224	56.600277906438166
chr20	SAMHD1	36911217	36912552	0	1336	138	8463	138	7127	0.0	0.019362985828539358
chr20	SNHG17	38421005	38422984	0	1980	199	11084	199	9104	0.0	0.021858523725834796
chr20	SNHG17	38421005	38422241	0	1237	199	11084	199	9847	0.0	0.020209200771808673
chr20	SNHG17	38426418	38427444	0	1027	199	11084	199	10057	0.0	0.019787212886546685
chr20	SNHG17	38421005	38422368	0	1364	199	11084	199	9720	0.0	0.020473251028806583
chr20	SNHG17	38420591	38421098	0	508	199	11084	199	10576	0.0	0.018816187594553706
chr20	SNHG17	38425934	38426503	0	570	199	11084	199	10514	0.0	0.01892714475936846
chr20	PLCG1-AS1	41100657	41101289	0	633	0	7746	0	7113	0.0	0.0
chr20	CHD6	41496808	41498226	0	1419	56	14072	56	12653	0.0	0.0044258278669090335
chr20	SLC35C2	46358386	46358763	0	378	153	7719	153	7341	0.0	0.020841847159787496
chr20	ELMO2	46368890	46370525	0	1636	155	4584	155	2948	0.0	0.05257801899592944
chr20	PREX1	48632276	48632639	0	364	26526	7548	26526	7184	0.0	3.6923719376391984
chr20	UBE2V1	50115484	50115954	0	471	675	4832	675	4361	0.0	0.1547810135290071
chr20	CTCFL	57525027	57525652	0	626	2916	8679	2916	8053	0.0	0.3621010803427294
chr20	PPP4R1L	58245782	58247506	0	1725	51	9090	51	7365	0.0	0.006924643584521385
chr20	HAR1B	63095492	63096183	0	692	0	3139	0	2447	0.0	0.0
chr20	EEF1A2	63488013	63488425	0	413	0	3301	0	2888	0.0	0.0
chr20	ARFRP1	63698642	63700702	0	2061	0	2709	0	648	0.0	0.0
chr20	UCKL1	63940949	63941208	0	260	0	3201	0	2941	0.0	0.0
chr21	ANKRD30BP2	13042778	13045270	0	2493	0	4155	0	1662	0.0	0.0
chr21	ABCC13	14316200	14317635	0	1436	0	8015	0	6579	0.0	0.0
chr21	ABCC13	14288403	14291747	0	3345	0	8015	0	4670	0.0	0.0
chr21	LINC01684	24488112	24488912	0	801	34	9534	34	8733	0.0	0.0038932783694034124
chr21	GET1	39390697	39391476	0	780	0	8656	0	7876	0.0	0.0
chr21	GET1	39405913	39406731	0	819	0	8656	0	7837	0.0	0.0
chr21	DSCAM-AS1	40383082	40383584	0	503	744	1772	744	1269	0.0	0.5862884160756501
chr21	MX1	41421837	41422095	0	259	0	6893	0	6634	0.0	0.0
chr21	UMODL1	42110879	42111710	0	832	0	7308	0	6476	0.0	0.0
chr21	GATD3A	44144820	44145723	0	904	255	7961	255	7057	0.0	0.03613433470313164
chr21	AIRE	44292992	44293175	141	184	7997	3922	7856	3738	0.7663043478260869	2.1016586409844837
chr21	TRPM2	44391271	44391625	0	355	10791	6626	10791	6271	0.0	1.7207781852974007
chr21	ADARB1	45222017	45226560	257808	4544	490711	8105	232903	3561	56.735915492957744	65.40381915192361
chr21	LINC00334	45258450	45259285	51	836	153	2102	102	1266	0.061004784688995214	0.08056872037914692
chr21	PRMT2	46648457	46648619	0	163	10776	5492	10776	5329	0.0	2.022142991180334
chr21	PRMT2	46658744	46659430	0	687	10776	5492	10776	4805	0.0	2.2426638917793964
chr21	CBSL	6444868	6445661	0	794	0	3896	0	3102	0.0	0.0
chr21	CYP4F29P	13846758	13847123	0	366	0	1724	0	1358	0.0	0.0
chr21	AF127936.1	14753323	14753852	51	530	35	4958	-16	4428	0.09622641509433963	-0.0036133694670280035
chr21	LINC00320	20742586	20743833	0	1248	378	16661	378	15413	0.0	0.02452475183286836
chr21	LINC00320	20742594	20743833	0	1240	378	16661	378	15421	0.0	0.02451202905129369
chr21	LINC00320	20742598	20743833	0	1236	378	16661	378	15425	0.0	0.024505672609400325
chr21	LINC01687	22062008	22062648	0	641	0	3693	0	3052	0.0	0.0
chr21	N6AMT1	28872190	28876491	51	4302	51	4871	0	569	0.011854951185495118	0.0
chr21	CFAP298-TCP10L	32573283	32574676	0	1394	25849	19230	25849	17836	0.0	1.4492599237497197
chr21	CFAP298-TCP10L	32573283	32574124	0	842	25849	19230	25849	18388	0.0	1.405753752447248
chr21	CFAP298-TCP10L	32574575	32576923	10041	2349	25849	19230	15808	16881	4.274584929757344	0.9364374148450921
chr21	SETD4	36034540	36036251	0	1712	0	6423	0	4711	0.0	0.0
chr21	AP001042.1	38904229	38905423	0	1195	69893	10133	69893	8938	0.0	7.819758335198031
chr21	AP001042.1	38923425	38923693	0	269	69893	10133	69893	9864	0.0	7.0856650446066505
chr21	PRDM15	41800183	41801722	129	1540	231	11221	102	9681	0.08376623376623377	0.010536101642392316
chr21	ZBTB21	41986830	41994108	153	7279	153	8068	0	789	0.021019370792691304	0.0
chr21	TFF3	42313484	42313631	0	148	0	1171	0	1023	0.0	0.0
chr21	CBS	43053190	43053983	0	794	204	6280	204	5486	0.0	0.03718556325191396
chr21	ICOSLG	44226833	44230089	0	3257	1670	9348	1670	6091	0.0	0.27417501231324903
chr21	LINC01547	44933314	44935096	4702	1783	3774	3203	-928	1420	2.6371284352215367	-0.6535211267605634
chr21	LSS	46188445	46191235	1697680	2791	1830016	7259	132336	4468	608.2694374776066	29.618621307072516
chr21	C21ORF58	46301129	46302154	0	1026	51	4107	51	3081	0.0	0.016553067185978577
chr22	ADA2	17189941	17191810	0	1870	0	8720	0	6850	0.0	0.0
chr22	PI4KAP1	18536649	18537412	0	764	20945	3930	20945	3166	0.0	6.615603284902084
chr22	PI4KAP1	18548010	18548469	0	460	20945	3930	20945	3470	0.0	6.036023054755043
chr22	PRODH	18936014	18936553	0	540	1123	7184	1123	6644	0.0	0.16902468392534617
chr22	GNB1L	19854442	19854816	2985	375	1627	1660	-1358	1285	7.96	-1.0568093385214008
chr22	TXNRD2	19875521	19877234	261	1714	13934	6767	13673	5053	0.15227537922987164	2.7059172768652284
chr22	PI4KAP2	21475210	21476764	8058	1555	5401	6796	-2657	5241	5.181993569131833	-0.5069643197863003
chr22	PI4KAP2	21477996	21478694	0	699	5401	6796	5401	6097	0.0	0.8858454977857962
chr22	PPM1F	21924875	21925662	867	788	8771	9572	7904	8784	1.100253807106599	0.8998178506375227
chr22	TOP3B	21957026	21958693	355	1668	425353	6344	424998	4676	0.21282973621103118	90.88922155688623
chr22	TOP3B	21962428	21962893	1224	466	425353	6344	424129	5878	2.6266094420600856	72.15532494045594
chr22	TOP3B	21957030	21958693	355	1664	425353	6344	424998	4680	0.21334134615384615	90.81153846153846
chr22	TOP3B	21959131	21959736	2518	606	425353	6344	422835	5738	4.1551155115511555	73.69031021261763
chr22	PRAME	22556811	22557580	0	770	2	3814	2	3044	0.0	0.000657030223390276
chr22	DERL3	23834502	23837154	0	2653	0	2422	0	-231	0.0	-0.0
chr22	DERL3	23836733	23837154	0	422	0	2422	0	2000	0.0	0.0
chr22	AL022329.1	25563100	25563481	0	382	0	1300	0	918	0.0	0.0
chr22	HPS4	26465454	26466262	0	809	0	7752	0	6943	0.0	0.0
chr22	XBP1	28796046	28796192	0	147	102	3034	102	2887	0.0	0.03533079321094562
chr22	RASL10A	29312932	29313987	1632	1056	1746	2185	114	1129	1.5454545454545454	0.10097431355181577
chr22	THOC5	29544459	29544603	0	145	2188	7903	2188	7758	0.0	0.2820314514050013
chr22	RNF215	30379481	30379780	0	300	32997	5055	32997	4755	0.0	6.939432176656151
chr22	DUSP18	30661444	30664080	0	2637	510	2739	510	102	0.0	5.0
chr22	SELENOM	31105929	31105965	0	37	102	1444	102	1407	0.0	0.07249466950959488
chr22	LARGE1	33162225	33166832	0	4608	635	14082	635	9474	0.0	0.06702554359299134
chr22	APOL3	36145472	36145599	608	128	120451	5914	119843	5786	4.75	20.712582094711372
chr22	APOL3	36149045	36149371	1798	327	120451	5914	118653	5587	5.4984709480122325	21.237336674422767
chr22	APOL4	36201699	36202055	0	357	1440	4268	1440	3911	0.0	0.3681922781897213
chr22	IFT27	36775673	36776125	714	453	4455	3881	3741	3428	1.576158940397351	1.0913068844807468
chr22	ANKRD54	37832957	37833206	0	250	0	4400	0	4150	0.0	0.0
chr22	BAIAP2L2	38086241	38086449	153	209	28407	2163	28254	1954	0.7320574162679426	14.45957011258956
chr22	CYP2D7	42141151	42141396	0	246	68	3408	68	3162	0.0	0.021505376344086023
chr22	CYP2D7	42144283	42144577	0	295	68	3408	68	3113	0.0	0.02184388050112432
chr22	LINC00899	46042573	46043699	0	1127	0	3069	0	1942	0.0	0.0
chr22	CELSR1	46361173	46364251	0	3079	3299	15740	3299	12661	0.0	0.26056393649790693
chr22	Z84468.1	48546512	48547012	0	501	0	2253	0	1752	0.0	0.0
chr22	HDAC10	50245674	50246092	4	419	5467	4150	5463	3731	0.00954653937947494	1.464218708121147
chr22	PLXNB2	50277852	50278013	17814	162	309508	7083	291694	6921	109.96296296296296	42.14622164427106
chr22	PLXNB2	50278116	50278271	13981	156	309508	7083	295527	6927	89.62179487179488	42.66305760069294
chr22	PLXNB2	50278434	50278519	4217	86	309508	7083	305291	6997	49.03488372093023	43.63169929969987
chr22	PLXNB2	50278595	50278696	7204	102	309508	7083	302304	6981	70.62745098039215	43.30382466695316
chr22	PLXNB2	50278854	50279011	16997	158	309508	7083	292511	6925	107.57594936708861	42.23985559566787
chr22	ARSA	50627555	50628170	2243	616	9992	3989	7749	3373	3.6412337662337664	2.2973613993477615
chr22	DUXAP8	15787171	15788699	0	1529	0	9700	0	8171	0.0	0.0
chr22	TPTEP1	16614076	16615111	0	1036	0	5184	0	4148	0.0	0.0
chr22	DGCR5	18987756	18988195	0	440	1599	8044	1599	7604	0.0	0.21028406102051553
chr22	SEPTIN5	19722236	19723319	0	1084	0	4211	0	3127	0.0	0.0
chr22	COMT	19961696	19962815	4757	1120	40758	6477	36001	5357	4.2473214285714285	6.720365876423371
chr22	RANBP1	20126302	20127181	67274	880	79693	4188	12419	3308	76.44772727272728	3.7542321644498187
chr22	MED15	20554935	20555148	0	214	51	8263	51	8049	0.0	0.00633619083115915
chr22	TMEM191A	20703632	20704040	0	409	0	2582	0	2173	0.0	0.0
chr22	CRKL	20949710	20953747	153	4038	6319	5345	6166	1307	0.03789004457652303	4.717674062739097
chr22	P2RX6	21026419	21028008	0	1590	0	4616	0	3026	0.0	0.0
chr22	GGTLC2	22646982	22647290	73	309	2815	1402	2742	1093	0.23624595469255663	2.5086916742909424
chr22	RGL4	23698554	23698978	0	425	0	4727	0	4302	0.0	0.0
chr22	SPECC1L	24321287	24322918	9501	1632	15373	7480	5872	5848	5.821691176470588	1.0041039671682626
chr22	GGT1	24610249	24610531	0	283	580	4343	580	4060	0.0	0.14285714285714285
chr22	GGT1	24628080	24628388	0	309	580	4343	580	4034	0.0	0.14377788795240456
chr22	LINC02554	27316803	27317456	192	654	192	6165	0	5511	0.29357798165137616	0.0
chr22	TTC28-AS1	27997410	27998838	0	1429	153	11188	153	9759	0.0	0.01567783584383646
chr22	TTC28-AS1	27999429	28001658	0	2230	153	11188	153	8958	0.0	0.01707970529135968
chr22	TTC28-AS1	27997410	27998152	0	743	153	11188	153	10445	0.0	0.014648157012924844
chr22	TTC28-AS1	27997985	27998838	0	854	153	11188	153	10334	0.0	0.014805496419585833
chr22	GAS2L1	29307057	29308738	1020	1682	1836	4005	816	2323	0.6064209274673008	0.3512699095996556
chr22	NF2	29683019	29683915	113427	897	251405	5395	137978	4498	126.45150501672241	30.675411293908404
chr22	SMTN	31080449	31080754	23	306	2377	7949	2354	7643	0.07516339869281045	0.30799424309825985
chr22	INPP5J	31124844	31126010	0	1167	0	4440	0	3273	0.0	0.0
chr22	RNF185	31204488	31207013	714	2526	714	3456	0	930	0.2826603325415677	0.0
chr22	TOM1	35323495	35323630	0	136	0	5019	0	4883	0.0	0.0
chr22	NCF4	36875652	36876094	51	443	67941	2252	67890	1809	0.11512415349887133	37.52902155887231
chr22	ATF4	39521353	39521671	51	319	51	2289	0	1970	0.15987460815047022	0.0
chr22	MCHR1	40680948	40682083	3550	1136	3720	2441	170	1305	3.125	0.13026819923371646
chr22	C22ORF46	41693462	41698136	40029	4675	40378	5306	349	631	8.56235294117647	0.5530903328050714
chr22	SEPTIN3	41994620	41998221	368763	3602	131334	4980	-237429	1378	102.37729039422543	-172.29970972423803
chr22	NDUFA6-DT	42124046	42124562	0	517	14794	5096	14794	4579	0.0	3.2308364271675036
chr22	NDUFA6-DT	42136198	42136714	0	517	14794	5096	14794	4579	0.0	3.2308364271675036
chr22	SERHL	42510630	42511927	102	1298	409	2853	307	1555	0.07858243451463791	0.19742765273311896
chr22	SERHL	42502350	42502768	0	419	409	2853	409	2434	0.0	0.16803615447822515
chr22	PRR5	44702217	44702608	606	392	689	5239	83	4847	1.5459183673469388	0.017123994223230864
chr22	NCAPH2	50523016	50523472	0	457	51	4166	51	3709	0.0	0.013750337018064168
chrX	PLCXD1	299096	303353	52383	4258	56871	6077	4488	1819	12.302254579614843	2.467289719626168
chrX	CLCN4	10208044	10208590	0	547	153	7579	153	7032	0.0	0.021757679180887373
chrX	MSL3	11759633	11759875	0	243	0	7299	0	7056	0.0	0.0
chrX	TMSB4X	12975109	12976361	0	1253	0	1418	0	165	0.0	0.0
chrX	LINC01203	13335029	13335545	0	517	0	6494	0	5977	0.0	0.0
chrX	DDX3X	41333347	41334297	0	951	1939	11657	1939	10706	0.0	0.18111339435830376
chrX	DDX3X	41347311	41349886	255	2576	1939	11657	1684	9081	0.09899068322981366	0.18544213192379694
chrX	DDX3X	41337690	41339083	102	1394	1939	11657	1837	10263	0.07317073170731707	0.1789924973204716
chrX	CDK16	47223551	47223759	0	209	29	5750	29	5541	0.0	0.005233712326294893
chrX	ARAF	47571322	47571908	0	587	0	3551	0	2964	0.0	0.0
chrX	WDR13	48597491	48598037	0	547	1581	7435	1581	6888	0.0	0.22952961672473868
chrX	HDAC6	48822911	48823588	28136	678	133522	7947	105386	7269	41.498525073746315	14.498005227679185
chrX	HDAC6	48805630	48806464	0	835	133522	7947	133522	7112	0.0	18.774184476940384
chrX	HDAC6	48814674	48814893	1121	220	133522	7947	132401	7727	5.095454545454546	17.13485181829947
chrX	MAGIX	49164706	49165090	0	385	0	4936	0	4551	0.0	0.0
chrX	MAGED4	52191430	52191861	0	432	204	4286	204	3854	0.0	0.052932018681888945
chrX	MAGED4	52191430	52191873	0	444	204	4286	204	3842	0.0	0.05309734513274336
chrX	XAGE5	52812203	52812638	0	436	0	1120	0	684	0.0	0.0
chrX	MAGED2	54809721	54810213	0	493	0	2914	0	2421	0.0	0.0
chrX	MAGED2	54810820	54811129	0	310	0	2914	0	2604	0.0	0.0
chrX	MAGED2	54815247	54816007	0	761	0	2914	0	2153	0.0	0.0
chrX	TRO	54928602	54931031	0	2430	0	4939	0	2509	0.0	0.0
chrX	TRO	54928602	54928710	0	109	0	4939	0	4830	0.0	0.0
chrX	AR	67723685	67730619	3366	6935	3601	12830	235	5895	0.4853640951694304	0.03986429177268872
chrX	MED12	71137725	71137943	0	219	102	7470	102	7251	0.0	0.01406702523789822
chrX	NLGN3	71167010	71167800	0	791	0	4014	0	3223	0.0	0.0
chrX	NONO	71297376	71298508	0	1133	0	9256	0	8123	0.0	0.0
chrX	NONO	71297835	71298508	0	674	0	9256	0	8582	0.0	0.0
chrX	NONO	71297376	71297938	0	563	0	9256	0	8693	0.0	0.0
chrX	DMRTC1B	72846884	72847277	0	394	0	1921	0	1527	0.0	0.0
chrX	JPX	73998953	74000496	0	1544	306	19827	306	18283	0.0	0.01673685937756386
chrX	JPX	73998767	74000496	0	1730	306	19827	306	18097	0.0	0.01690887992484942
chrX	JPX	73944338	73944662	0	325	306	19827	306	19502	0.0	0.015690698389908726
chrX	JPX	73998953	73999669	0	717	306	19827	306	19110	0.0	0.016012558869701727
chrX	JPX	73944340	73944662	0	323	306	19827	306	19504	0.0	0.015689089417555372
chrX	JPX	73998953	73999950	0	998	306	19827	306	18829	0.0	0.01625152689999469
chrX	JPX	73998953	74000201	0	1249	306	19827	306	18578	0.0	0.016471094843363118
chrX	JPX	73944341	73944662	0	322	306	19827	306	19505	0.0	0.015688285055114073
chrX	ZNF711	85246929	85247651	204	723	1730	5056	1526	4333	0.2821576763485477	0.35218093699515346
chrX	DACH2	86827765	86832602	0	4838	105	2770	105	-2068	0.0	-0.05077369439071567
chrX	ARMCX4	101531643	101533459	0	1817	224	13064	224	11247	0.0	0.01991642215701965
chrX	NXF4	102563206	102563522	0	317	0	2849	0	2532	0.0	0.0
chrX	TCEAL4	103585858	103586291	0	434	0	2405	0	1971	0.0	0.0
chrX	H2BW2	104041087	104042454	0	1368	0	1885	0	517	0.0	0.0
chrX	ZCCHC18	104113433	104115842	0	2410	0	2981	0	571	0.0	0.0
chrX	PRPS1	107649939	107651026	0	1088	828	3405	828	2317	0.0	0.35735865343116097
chrX	RBMX2	130411347	130411525	0	179	0	2642	0	2463	0.0	0.0
chrX	FAM122C	134807190	134807708	0	519	0	7535	0	7016	0.0	0.0
chrX	INTS6L	135581527	135582510	173050	984	141354	5582	-31696	4598	175.8638211382114	-6.89343192692475
chrX	SLC9A6	135985434	135985827	0	394	38335	9929	38335	9535	0.0	4.0204509701101205
chrX	LINC00892	136640773	136642426	0	1654	0	1924	0	270	0.0	0.0
chrX	LINC00632	140711620	140716289	0	4670	2038	14900	2038	10230	0.0	0.1992179863147605
chrX	LINC00632	140772077	140775905	0	3829	2038	14900	2038	11071	0.0	0.1840845452082016
chrX	MAGEC3	141896881	141897832	0	952	0	2774	0	1822	0.0	0.0
chrX	LINC00894	149945347	149948175	53324	2829	13439	6782	-39885	3953	18.849063273241427	-10.089805211231976
chrX	ZNF275	153346818	153352926	20486	6109	24604	7519	4118	1410	3.3534129972172204	2.9205673758865247
chrX	SRPK3	153783973	153784213	97	241	77505	4765	77408	4524	0.4024896265560166	17.1105216622458
chrX	SRPK3	153781115	153781346	357	232	77505	4765	77148	4533	1.5387931034482758	17.01919258769027
chrX	RPL10	154398376	154398542	0	167	51	4328	51	4161	0.0	0.012256669069935111
chrX	TAZ	154419704	154420094	0	391	161	3645	161	3254	0.0	0.049477566072526125
chrX	TAZ	154419542	154420094	0	553	161	3645	161	3092	0.0	0.05206985769728331
chrX	TAZ	154420902	154421706	0	805	161	3645	161	2840	0.0	0.05669014084507042
chrX	TAZ	154420031	154420264	0	234	161	3645	161	3411	0.0	0.04720023453532688
chrX	TAZ	154419542	154419746	0	205	161	3645	161	3440	0.0	0.04680232558139535
chrX	ATP6AP1	154429047	154431657	270	2611	273	5136	3	2525	0.10340865568747606	0.001188118811881188
chrX	DKC1	154774601	154775273	46896	673	40999	3861	-5897	3188	69.68202080237741	-1.8497490589711418
chrX	PIGA	15331215	15331992	0	778	0	5184	0	4406	0.0	0.0
chrX	RAI2	17800048	17802034	204	1987	204	2626	0	639	0.10266733769501761	0.0
chrX	TAB3	30842965	30846644	25938	3680	21868	9842	-4070	6162	7.048369565217391	-0.6604998377150276
chrX	RPGR	38287093	38288041	0	949	45	8385	45	7436	0.0	0.006051640667025283
chrX	CXORF38	40626920	40630773	102	3854	102	5893	0	2039	0.026466009340944473	0.0
chrX	SLC38A5	48458538	48459034	198860	497	213423	3938	14563	3441	400.1207243460765	4.2321999418773615
chrX	TIMM17B	48893899	48894225	1751	327	315920	2570	314169	2243	5.3547400611620795	140.06642888987963
chrX	WDR45	49100581	49101144	561	564	663	3931	102	3367	0.9946808510638298	0.030294030294030293
chrX	FOXP3	49256750	49257012	0	263	0	3100	0	2837	0.0	0.0
chrX	FOXP3	49251333	49251765	0	433	0	3100	0	2667	0.0	0.0
chrX	MAGED4B	52062221	52062664	51	444	102	4000	51	3556	0.11486486486486487	0.014341957255343082
chrX	ALAS2	55020319	55020504	0	186	2815	2059	2815	1873	0.0	1.5029364655632675
chrX	SPIN3	56978291	56978660	408	370	2630	13521	2222	13151	1.1027027027027028	0.16896053532050795
chrX	SPIN3	56993786	56994949	918	1164	2630	13521	1712	12357	0.788659793814433	0.13854495427692806
chrX	SPIN2B	57119681	57120631	192	951	1212	1178	1020	227	0.20189274447949526	4.493392070484582
chrX	LINC01278	63238992	63239830	0	839	1173	13947	1173	13108	0.0	0.08948733597802869
chrX	ARHGEF9	63635002	63638209	0	3208	8262	12238	8262	9030	0.0	0.9149501661129568
chrX	ZC4H2	64919041	64919204	78	164	3308	3190	3230	3026	0.47560975609756095	1.0674157303370786
chrX	LAS1L	65520701	65523707	0	3007	51	7818	51	4811	0.0	0.01060070671378092
chrX	LAS1L	65520701	65522285	0	1585	51	7818	51	6233	0.0	0.008182255735600835
chrX	LAS1L	65522430	65523707	0	1278	51	7818	51	6540	0.0	0.007798165137614679
chrX	AL590764.2	71105999	71106426	0	428	0	2383	0	1955	0.0	0.0
chrX	HDAC8	72329567	72330876	255	1310	139	18208	-116	16898	0.1946564885496183	-0.0068647177180731446
chrX	HDAC8	72567581	72568030	0	450	139	18208	139	17758	0.0	0.007827458047077374
chrX	DMRTC1	72873549	72873942	0	394	51	1860	51	1466	0.0	0.034788540245566164
chrX	NEXMIF	74732855	74739498	51	6644	6296	12341	6245	5697	0.0076760987357013845	1.0961909777075654
chrX	NEXMIF	74732855	74744477	6296	11623	6296	12341	0	718	0.5416845908973587	0.0
chrX	ATRX	77681519	77684593	0	3075	221	17249	221	14174	0.0	0.015591928883871878
chrX	TRMT2B	101051250	101051733	0	484	0	4036	0	3552	0.0	0.0
chrX	TIMM8A	101345660	101348401	0	2742	0	3083	0	341	0.0	0.0
chrX	BTK	101353869	101353988	0	120	0	4323	0	4203	0.0	0.0
chrX	GLA	101398369	101398946	0	578	0	2857	0	2279	0.0	0.0
chrX	AC235565.2	102369585	102370152	0	568	291	4954	291	4386	0.0	0.06634746922024624
chrX	TMSB15B-AS1	103918408	103919080	51	673	51	2837	0	2164	0.07578008915304606	0.0
chrX	RBM41	107088435	107088839	0	405	51	4714	51	4309	0.0	0.011835692736133673
chrX	PSMD10	108087952	108088099	0	148	0	2395	0	2247	0.0	0.0
chrX	COL4A6	108164876	108165038	0	163	5	9330	5	9167	0.0	0.0005454347114650376
chrX	UPF3B	119837756	119837932	0	177	0	3097	0	2920	0.0	0.0
chrX	ELF4	130069299	130069677	0	379	0	4268	0	3889	0.0	0.0
chrX	ELF4	130081255	130081539	0	285	0	4268	0	3983	0.0	0.0
chrX	ENOX2	130665642	130665749	0	108	100	4295	100	4187	0.0	0.02388344877000239
chrX	CT55	135156539	135157503	51	965	51	1733	0	768	0.05284974093264249	0.0
chrX	RBMX	136872267	136875168	0	2902	22	4833	22	1931	0.0	0.011393060590367685
chrX	FMR1-AS1	147909430	147911817	0	2388	0	2104	0	-284	0.0	-0.0
chrX	AC244197.3	149532881	149534374	0	1494	224	9717	224	8223	0.0	0.02724066642344643
chrX	TMEM185A	149596556	149598255	0	1700	918	4993	918	3293	0.0	0.27877315517764956
chrX	MAGEA10	152135760	152136080	451	321	4101	2903	3650	2582	1.4049844236760125	1.4136328427575522
chrX	CSAG1	152727483	152728224	42099	742	42149	1096	50	354	56.73719676549865	0.14124293785310735
chrX	PNMA5	152991901	152992217	6	317	131602	3432	131596	3115	0.01892744479495268	42.24590690208668
chrX	PNCK	153671879	153672200	0	322	2463660	4218	2463660	3896	0.0	632.3562628336756
chrX	IRAK1	154019430	154019812	682	383	88402	3637	87720	3254	1.7806788511749347	26.95759065765212
chrX	FLNA	154365744	154366224	0	481	116779	9862	116779	9381	0.0	12.448459652489074
chrX	SLC10A3	154487305	154489082	41820	1778	46608	2016	4788	238	23.520809898762653	20.11764705882353
chrX	FAM3A	154515759	154516242	0	484	561	4886	561	4402	0.0	0.12744207178555203
chrX	CTAG1B	154617608	154618273	0	666	0	1000	0	334	0.0	0.0
chrY	PLCXD1	299096	303353	205	4258	741	6077	536	1819	0.04814466885861907	0.29466739967014843
chrY	TSPY2	6246222	6246754	0	533	0	1378	0	845	0.0	0.0
chrY	TSPY4	9337509	9338013	0	505	0	1370	0	865	0.0	0.0
chrY	TSPY8	9357842	9358328	0	487	0	1232	0	745	0.0	0.0
chrY	TSPY3	9398466	9398952	0	487	0	1332	0	845	0.0	0.0
chrY	TXLNGY	19588369	19589612	0	1244	0	8366	0	7122	0.0	0.0
chrY	TTTY14	18819354	18819786	0	433	408	17451	408	17018	0.0	0.023974615113409332
chrY	TTTY14	19041369	19043346	51	1978	408	17451	357	15473	0.02578361981799798	0.023072448781748852
chrY	TTTY14	19043162	19044695	0	1534	408	17451	408	15917	0.0	0.025632971037255765
