chrom	geneName	splicedExonStart	splicedExonEnd	splicedExonReadCount(rc)	splicedExonLength(sl)	othersExonsReadCount(RC)	othersExonsLength(L)	RC - rc	L - sl	splicedExonAverageReadCoverage(n)	otherExonsAverageReadCoverage(N)
chr1	LINC01409	804775	804840	0	66	30465	6771	30465	6705	0.0	4.543624161073826
chr1	LINC01409	807216	807323	0	108	30465	6771	30465	6663	0.0	4.572264745610085
chr1	LINC01409	803566	803667	330	102	30465	6771	30135	6669	3.235294117647059	4.518668466036887
chr1	LINC01409	783110	783363	4669	254	30465	6771	25796	6517	18.381889763779526	3.9582630044499
chr1	LINC01409	792881	793041	315	161	30465	6771	30150	6610	1.9565217391304348	4.561270801815431
chr1	LINC01128	852670	852766	573	97	50545	13620	49972	13523	5.907216494845361	3.695333875619315
chr1	LINC01128	829002	829104	0	103	50545	13620	50545	13517	0.0	3.739365243767108
chr1	LINC01128	841199	844498	8854	3300	50545	13620	41691	10320	2.683030303030303	4.039825581395349
chr1	LINC01128	849483	849602	210	120	50545	13620	50335	13500	1.75	3.7285185185185186
chr1	LINC01128	847653	847806	184	154	50545	13620	50361	13466	1.1948051948051948	3.739863359572256
chr1	LINC01128	850180	850351	26	172	50545	13620	50519	13448	0.1511627906976744	3.7566180844735277
chr1	LINC01128	841199	841373	388	175	50545	13620	50157	13445	2.217142857142857	3.730531796206768
chr1	LINC01128	850177	850351	26	175	50545	13620	50519	13445	0.14857142857142858	3.7574563034585347
chr1	SAMD11	931038	931089	0	52	10829	4083	10829	4031	0.0	2.686430166211858
chr1	SAMD11	939274	939460	663	187	10829	4083	10166	3896	3.5454545454545454	2.609342915811088
chr1	SAMD11	941143	941306	51	164	10829	4083	10778	3919	0.31097560975609756	2.750191375350855
chr1	SAMD11	939274	939412	608	139	10829	4083	10221	3944	4.374100719424461	2.5915314401622718
chr1	SAMD11	941143	941230	29	88	10829	4083	10800	3995	0.32954545454545453	2.7033792240300376
chr1	SAMD11	939271	939460	663	190	10829	4083	10166	3893	3.4894736842105263	2.611353711790393
chr1	PLEKHN1	973185	973326	0	142	2663	3466	2663	3324	0.0	0.8011432009626955
chr1	AGRN	1051031	1051043	0	13	110573	9349	110573	9336	0.0	11.843723221936589
chr1	AL390719.1	1061019	1061117	0	99	51	2217	51	2118	0.0	0.024079320113314446
chr1	TTLL10	1196385	1196488	833	104	13160	4015	12327	3911	8.009615384615385	3.15187931475326
chr1	SCNN1D	1285570	1285664	0	95	22405	3430	22405	3335	0.0	6.718140929535233
chr1	PUSL1	1308914	1308972	0	59	358628	1468	358628	1409	0.0	254.5266146202981
chr1	CPTP	1326835	1327032	75242	198	467261	2559	392019	2361	380.010101010101	166.03939008894537
chr1	ATAD3C	1454344	1454500	6704	157	181545	3768	174841	3611	42.70063694267516	48.41899750761562
chr1	ATAD3B	1487862	1487914	586	53	374583	6839	373997	6786	11.056603773584905	55.11302681992337
chr1	ATAD3A	1520547	1520617	0	71	78615	3362	78615	3291	0.0	23.887876025524157
chr1	ATAD3A	1519491	1519571	36	81	78615	3362	78579	3281	0.4444444444444444	23.94971045412984
chr1	ATAD3A	1527160	1527238	0	79	78615	3362	78615	3283	0.0	23.946085897045386
chr1	MIB2	1624990	1625185	1712	196	73128	7887	71416	7691	8.73469387755102	9.285658561955533
chr1	MIB2	1625557	1625653	1075	97	73128	7887	72053	7790	11.082474226804123	9.249422336328626
chr1	MIB2	1626649	1626754	45	106	73128	7887	73083	7781	0.42452830188679247	9.392494537977123
chr1	MIB2	1629384	1629566	0	183	73128	7887	73128	7704	0.0	9.49221183800623
chr1	MIB2	1625545	1625653	1341	109	73128	7887	71787	7778	12.302752293577981	9.229493443044484
chr1	MIB2	1626366	1626754	45	389	73128	7887	73083	7498	0.11568123393316196	9.74699919978661
chr1	MMP23B	1632980	1633120	528	141	103840	2013	103312	1872	3.74468085106383	55.18803418803419
chr1	CALML6	1915684	1915735	0	52	0	1239	0	1187	0.0	0.0
chr1	CALML6	1916440	1916615	0	176	0	1239	0	1063	0.0	0.0
chr1	GABRD	2029110	2029266	0	157	102	4393	102	4236	0.0	0.024079320113314446
chr1	GABRD	2023796	2023890	0	95	102	4393	102	4298	0.0	0.023731968357375524
chr1	GABRD	2029110	2029408	0	299	102	4393	102	4094	0.0	0.024914509037616023
chr1	PRKCZ	2056483	2056573	0	91	15823	7604	15823	7513	0.0	2.1060827898309595
chr1	PRKCZ	2146026	2146108	0	83	15823	7604	15823	7521	0.0	2.1038425741257814
chr1	PRKCZ	2098346	2098555	0	210	15823	7604	15823	7394	0.0	2.139978360833108
chr1	PRKCZ	2145337	2145511	0	175	15823	7604	15823	7429	0.0	2.129896352133531
chr1	PRKCZ	2145388	2145511	0	124	15823	7604	15823	7480	0.0	2.115374331550802
chr1	PRKCZ	2181831	2181914	219	84	15823	7604	15604	7520	2.607142857142857	2.075
chr1	AL590822.3	2317610	2317729	705	120	32244	5798	31539	5678	5.875	5.554596688974991
chr1	RER1	2399414	2399514	0	101	0	3838	0	3737	0.0	0.0
chr1	RER1	2395607	2395648	0	42	0	3838	0	3796	0.0	0.0
chr1	PLCH2	2497501	2497609	0	109	2749	6815	2749	6706	0.0	0.409931404712198
chr1	PLCH2	2503616	2503643	0	28	2749	6815	2749	6787	0.0	0.4050390452335347
chr1	PRXL2B	2588549	2588625	0	77	0	3060	0	2983	0.0	0.0
chr1	PRXL2B	2588529	2588625	0	97	0	3060	0	2963	0.0	0.0
chr1	PRDM16	3431965	3432140	32780	176	255347	9787	222567	9611	186.25	23.157527832691706
chr1	TPRG1L	3625712	3625889	0	178	0	2406	0	2228	0.0	0.0
chr1	TP73	3729999	3730148	250	150	125180	6783	124930	6633	1.6666666666666667	18.83461480476406
chr1	TP73	3731462	3731556	4384	95	125180	6783	120796	6688	46.14736842105263	18.0616028708134
chr1	TP73	3730926	3731065	4038	140	125180	6783	121142	6643	28.84285714285714	18.236037934668072
chr1	DFFB	3873013	3873137	0	125	0	3880	0	3755	0.0	0.0
chr1	DFFB	3866283	3866398	0	116	0	3880	0	3764	0.0	0.0
chr1	DFFB	3860419	3860506	0	88	0	3880	0	3792	0.0	0.0
chr1	LINC01777	4423053	4423187	0	135	102	2582	102	2447	0.0	0.04168369431957499
chr1	LINC01777	4423347	4423448	0	102	102	2582	102	2480	0.0	0.04112903225806452
chr1	LINC01777	4422759	4423187	0	429	102	2582	102	2153	0.0	0.04737575476079889
chr1	LINC01777	4422875	4423187	0	313	102	2582	102	2269	0.0	0.04495372410753636
chr1	LINC01646	4572469	4572592	0	124	0	3336	0	3212	0.0	0.0
chr1	LINC01646	4575321	4575450	0	130	0	3336	0	3206	0.0	0.0
chr1	LINC01646	4582276	4582574	0	299	0	3336	0	3037	0.0	0.0
chr1	KCNAB2	6041830	6041872	0	43	24733	13510	24733	13467	0.0	1.8365634513997178
chr1	KCNAB2	6040516	6040645	0	130	24733	13510	24733	13380	0.0	1.8485052316890882
chr1	KCNAB2	6018634	6018835	0	202	24733	13510	24733	13308	0.0	1.8585061617072438
chr1	KCNAB2	6051510	6051754	1275	245	24733	13510	23458	13265	5.204081632653061	1.7684131172257822
chr1	KCNAB2	5995862	5996084	78	223	24733	13510	24655	13287	0.34977578475336324	1.855573116580116
chr1	KCNAB2	6085739	6085793	0	55	24733	13510	24733	13455	0.0	1.8382014121144556
chr1	KCNAB2	6097516	6097555	0	40	24733	13510	24733	13470	0.0	1.8361544172234596
chr1	KCNAB2	6091262	6091307	0	46	24733	13510	24733	13464	0.0	1.836972667855021
chr1	KCNAB2	6073353	6073384	164	32	24733	13510	24569	13478	5.125	1.8228965721917199
chr1	KCNAB2	6027355	6027459	6687	105	24733	13510	18046	13405	63.68571428571428	1.3462140992167102
chr1	KCNAB2	6095938	6096204	0	267	24733	13510	24733	13243	0.0	1.8676281809257722
chr1	ESPN	6448892	6449091	0	200	5713	6800	5713	6600	0.0	0.8656060606060606
chr1	ESPN	6450443	6450470	0	28	5713	6800	5713	6772	0.0	0.8436207914943886
chr1	TAS1R1	6574630	6575392	0	763	1060	2770	1060	2007	0.0	0.5281514698555058
chr1	ZBTB48	6580540	6581299	0	760	236380	3499	236380	2739	0.0	86.30156991602774
chr1	THAP3	6628498	6628691	0	194	51	4079	51	3885	0.0	0.013127413127413128
chr1	THAP3	6629642	6629724	0	83	51	4079	51	3996	0.0	0.012762762762762763
chr1	LINC01672	6727432	6727612	0	181	5244	2191	5244	2010	0.0	2.608955223880597
chr1	CAMTA1	6820180	6820250	0	71	1414	9933	1414	9862	0.0	0.14337862502534982
chr1	CAMTA1	7755637	7755668	0	32	1414	9933	1414	9901	0.0	0.1428138571861428
chr1	CAMTA1	6871756	6871840	0	85	1414	9933	1414	9848	0.0	0.14358245329000813
chr1	CAMTA1	6806982	6807088	0	107	1414	9933	1414	9826	0.0	0.14390392835334825
chr1	CAMTA1	6886239	6886346	0	108	1414	9933	1414	9825	0.0	0.14391857506361322
chr1	CAMTA1	7749770	7749791	0	22	1414	9933	1414	9911	0.0	0.14266976087175864
chr1	PER3	7808892	7808998	0	107	17971	7397	17971	7290	0.0	2.4651577503429354
chr1	PARK7	7969344	7969404	0	61	997	2378	997	2317	0.0	0.4302977988778593
chr1	LINC01714	8214624	8214678	0	55	0	1007	0	952	0.0	0.0
chr1	CA6	8949262	8949442	0	181	1240	2672	1240	2491	0.0	0.49779205138498595
chr1	CA6	8957136	8957285	64	150	1240	2672	1176	2522	0.4266666666666667	0.4662965900079302
chr1	LNCTAM34A	9191039	9191124	0	86	612	2148	612	2062	0.0	0.2967992240543162
chr1	LNCTAM34A	9187535	9187789	612	255	612	2148	0	1893	2.4	0.0
chr1	TMEM201	9609839	9609911	0	73	15455	6994	15455	6921	0.0	2.233058806530848
chr1	TMEM201	9611014	9611073	0	60	15455	6994	15455	6934	0.0	2.228872223824632
chr1	RBP7	10004092	10004307	1219	216	3761	867	2542	651	5.643518518518518	3.9047619047619047
chr1	UBE4B	10130499	10130616	0	118	25127	9087	25127	8969	0.0	2.8015386330694616
chr1	UBE4B	10137066	10137205	51	140	25127	9087	25076	8947	0.36428571428571427	2.8027271711188106
chr1	UBE4B	10107221	10107374	0	154	25127	9087	25127	8933	0.0	2.812828836896899
chr1	UBE4B	10106196	10106583	204	388	25127	9087	24923	8699	0.5257731958762887	2.8650419588458442
chr1	UBE4B	10166243	10166342	1886	100	25127	9087	23241	8987	18.86	2.5860687659953268
chr1	KIF1B	10273013	10273031	0	19	68213	17608	68213	17589	0.0	3.8781624879185856
chr1	KIF1B	10279096	10279138	0	43	68213	17608	68213	17565	0.0	3.8834614289780816
chr1	KIF1B	10355369	10355396	0	28	68213	17608	68213	17580	0.0	3.8801478953356088
chr1	PGD	10403070	10403136	0	67	8459	3347	8459	3280	0.0	2.5789634146341465
chr1	CENPS-CORT	10440346	10440413	744	68	6986	2251	6242	2183	10.941176470588236	2.8593678424186897
chr1	CENPS-CORT	10442264	10442441	0	178	6986	2251	6986	2073	0.0	3.3699951760733238
chr1	CENPS-CORT	10433841	10433965	32	125	6986	2251	6954	2126	0.256	3.270931326434619
chr1	CENPS-CORT	10434656	10434690	555	35	6986	2251	6431	2216	15.857142857142858	2.902075812274368
chr1	TARDBP	11016843	11017007	0	165	102	4648	102	4483	0.0	0.0227526210127147
chr1	TARDBP	11020428	11020599	0	172	102	4648	102	4476	0.0	0.022788203753351208
chr1	TARDBP	11015523	11015646	0	124	102	4648	102	4524	0.0	0.022546419098143235
chr1	TARDBP	11016122	11016254	0	133	102	4648	102	4515	0.0	0.022591362126245847
chr1	TARDBP	11024063	11024335	0	273	102	4648	102	4375	0.0	0.023314285714285714
chr1	TARDBP	11024301	11024335	0	35	102	4648	102	4613	0.0	0.02211142423585519
chr1	AL109811.3	11029686	11029781	0	96	76	2216	76	2120	0.0	0.035849056603773584
chr1	UBIAD1	11285643	11285732	0	90	56558	5095	56558	5005	0.0	11.3002997002997
chr1	FBXO44	11655327	11655699	0	373	0	3061	0	2688	0.0	0.0
chr1	FBXO44	11658532	11658628	0	97	0	3061	0	2964	0.0	0.0
chr1	FBXO44	11655669	11655699	0	31	0	3061	0	3030	0.0	0.0
chr1	FBXO6	11671927	11672023	0	97	408	1742	408	1645	0.0	0.2480243161094225
chr1	AGTRAP	11745987	11746223	0	237	212944	2351	212944	2114	0.0	100.73036896877956
chr1	AGTRAP	11746126	11746223	0	98	212944	2351	212944	2253	0.0	94.51575676875278
chr1	AGTRAP	11745802	11745837	0	36	212944	2351	212944	2315	0.0	91.98444924406047
chr1	AGTRAP	11747439	11747545	0	107	212944	2351	212944	2244	0.0	94.89483065953654
chr1	AGTRAP	11744532	11744568	0	37	212944	2351	212944	2314	0.0	92.02420051858255
chr1	CLCN6	11828457	11828624	0	168	15742	7557	15742	7389	0.0	2.1304642035458112
chr1	CLCN6	11815845	11815911	0	67	15742	7557	15742	7490	0.0	2.10173564753004
chr1	AL021155.4	11911506	11911589	0	84	2542	3074	2542	2990	0.0	0.8501672240802676
chr1	PLOD1	11944521	11944662	0	142	774	5069	774	4927	0.0	0.1570935660645423
chr1	MFN2	11982066	11982114	1156	49	424359	10140	423203	10091	23.591836734693878	41.93865821028639
chr1	MFN2	11981969	11982114	1299	146	424359	10140	423060	9994	8.897260273972602	42.33139883930358
chr1	MFN2	12003757	12003889	53	133	424359	10140	424306	10007	0.39849624060150374	42.40091935645049
chr1	MFN2	11982522	11982590	3567	69	424359	10140	420792	10071	51.69565217391305	41.782543938039915
chr1	MFN2	11981973	11982114	1277	142	424359	10140	423082	9998	8.992957746478874	42.316663332666536
chr1	MFN2	11988426	11988516	0	91	424359	10140	424359	10049	0.0	42.22897800776197
chr1	MFN2	11988721	11988843	0	123	424359	10140	424359	10017	0.0	42.36388140161725
chr1	MFN2	11981809	11981853	569	45	424359	10140	423790	10095	12.644444444444444	41.98018821198613
chr1	MFN2	11992278	11992463	153	186	424359	10140	424206	9954	0.8225806451612904	42.616636528028934
chr1	MFN2	11988781	11988843	0	63	424359	10140	424359	10077	0.0	42.111640369157485
chr1	MFN2	11981809	11982114	5343	306	424359	10140	419016	9834	17.46078431372549	42.608907870652835
chr1	MIIP	12021644	12021840	51	197	2227	2492	2176	2295	0.25888324873096447	0.9481481481481482
chr1	TNFRSF8	12084463	12084551	392	89	929	3827	537	3738	4.404494382022472	0.14365971107544143
chr1	TNFRSF8	12138228	12138436	0	209	929	3827	929	3618	0.0	0.25677169707020453
chr1	TNFRSF8	12138231	12138436	0	206	929	3827	929	3621	0.0	0.25655896161281416
chr1	TNFRSF1B	12188795	12188895	0	101	51	3788	51	3687	0.0	0.013832384052074858
chr1	VPS13D	12338230	12338305	0	76	27344	20657	27344	20581	0.0	1.3286040522812304
chr1	VPS13D	12358458	12358601	0	144	27344	20657	27344	20513	0.0	1.3330083361770584
chr1	VPS13D	12453838	12453899	0	62	27344	20657	27344	20595	0.0	1.3277008982762806
chr1	VPS13D	12402567	12402702	0	136	27344	20657	27344	20521	0.0	1.3324886701427805
chr1	AADACL3	12719474	12719691	0	218	51	4059	51	3841	0.0	0.01327779224160375
chr1	C1ORF158	12755699	12755813	0	115	153	4138	153	4023	0.0	0.03803131991051454
chr1	PDPN	13610386	13610516	0	131	0	3705	0	3574	0.0	0.0
chr1	PDPN	13595826	13595984	0	159	0	3705	0	3546	0.0	0.0
chr1	PRDM2	13732778	13732855	0	78	701	10938	701	10860	0.0	0.064548802946593
chr1	PRDM2	13732778	13732882	0	105	701	10938	701	10833	0.0	0.06470968337487307
chr1	PRDM2	13778417	13782831	51	4415	701	10938	650	6523	0.011551528878822197	0.0996474015023762
chr1	PRDM2	13769117	13769173	0	57	701	10938	701	10881	0.0	0.0644242257145483
chr1	PRDM2	13769038	13769173	0	136	701	10938	701	10802	0.0	0.06489538974264025
chr1	PRDM2	13773077	13773188	0	112	701	10938	701	10826	0.0	0.06475152410862738
chr1	TMEM51	15210489	15210562	0	74	51	2243	51	2169	0.0	0.02351313969571231
chr1	FHAD1	15272322	15272529	0	208	4423	11501	4423	11293	0.0	0.3916585495439653
chr1	FHAD1	15324451	15324559	0	109	4423	11501	4423	11392	0.0	0.3882549157303371
chr1	FHAD1	15349041	15349149	0	109	4423	11501	4423	11392	0.0	0.3882549157303371
chr1	FHAD1	15317823	15317928	0	106	4423	11501	4423	11395	0.0	0.38815269855199647
chr1	FHAD1	15383155	15383402	0	248	4423	11501	4423	11253	0.0	0.3930507420243491
chr1	FHAD1	15391209	15391263	15	55	4423	11501	4408	11446	0.2727272727272727	0.3851127031277302
chr1	FHAD1	15383806	15383930	0	125	4423	11501	4423	11376	0.0	0.3888009845288326
chr1	FHAD1	15388345	15388422	0	78	4423	11501	4423	11423	0.0	0.38720126061454957
chr1	FHAD1	15383158	15383280	0	123	4423	11501	4423	11378	0.0	0.3887326419405871
chr1	EFHD2	15427897	15428009	0	113	0	2539	0	2426	0.0	0.0
chr1	CTRC	15444605	15444751	0	147	204	3491	204	3344	0.0	0.061004784688995214
chr1	CELA2B	15481644	15481749	0	106	22	1460	22	1354	0.0	0.01624815361890694
chr1	DNAJC16	15529087	15529272	0	186	1531	7125	1531	6939	0.0	0.2206369793918432
chr1	DDI2	15638306	15638434	0	129	102	11761	102	11632	0.0	0.008768913342503439
chr1	DDI2	15633797	15633879	0	83	102	11761	102	11678	0.0	0.008734372324028086
chr1	PLEKHM2	15716706	15716816	0	111	1471	4154	1471	4043	0.0	0.3638387336136532
chr1	PLEKHM2	15721328	15721388	0	61	1471	4154	1471	4093	0.0	0.35939408746640605
chr1	TMEM82	15742834	15742907	358	74	876	1449	518	1375	4.837837837837838	0.37672727272727274
chr1	CLCNKA	16024858	16024891	0	34	1651	3502	1651	3468	0.0	0.47606689734717417
chr1	CLCNKA	16024762	16024891	0	130	1651	3502	1651	3372	0.0	0.48962040332147094
chr1	SZRD1	16391374	16391424	0	51	1141	4752	1141	4701	0.0	0.24271431610295682
chr1	SZRD1	16387501	16387794	0	294	1141	4752	1141	4458	0.0	0.2559443696724989
chr1	NECAP2	16455817	16455893	1541	77	1660932	4594	1659391	4517	20.01298701298701	367.36572946646004
chr1	NECAP2	16448059	16448141	0	83	1660932	4594	1660932	4511	0.0	368.19596541786746
chr1	NECAP2	16443631	16443732	0	102	1660932	4594	1660932	4492	0.0	369.753339269813
chr1	NECAP2	16447869	16447974	297	106	1660932	4594	1660635	4488	2.80188679245283	370.0167112299465
chr1	NECAP2	16450124	16450241	23	118	1660932	4594	1660909	4476	0.19491525423728814	371.06992850759605
chr1	CROCC	16938399	16938483	0	85	102291	8914	102291	8829	0.0	11.585796805980292
chr1	CROCC	16924324	16924479	103	156	102291	8914	102188	8758	0.6602564102564102	11.667960721625942
chr1	CROCC	16931290	16931397	286	108	102291	8914	102005	8806	2.6481481481481484	11.583579377697024
chr1	CROCC	16936636	16936873	0	238	102291	8914	102291	8676	0.0	11.790110650069156
chr1	CROCC	16939893	16940093	9862	201	102291	8914	92429	8713	49.06467661691542	10.60817169746356
chr1	ARHGEF10L	17613057	17613174	0	118	3377	7987	3377	7869	0.0	0.42915237005972806
chr1	ARHGEF10L	17634547	17634562	0	16	3377	7987	3377	7971	0.0	0.42366077029230964
chr1	ARHGEF10L	17691119	17691192	0	74	3377	7987	3377	7913	0.0	0.4267660811323139
chr1	SLC66A1	19317599	19317841	0	243	0	2695	0	2452	0.0	0.0
chr1	MICOS10	19622099	19622147	1410	49	93273	5490	91863	5441	28.775510204081634	16.88347730196655
chr1	PLA2G5	20066023	20066129	0	107	8324	3257	8324	3150	0.0	2.6425396825396827
chr1	PLA2G5	20063483	20063602	0	120	8324	3257	8324	3137	0.0	2.653490596110934
chr1	PLA2G5	20070293	20070465	2583	173	8324	3257	5741	3084	14.93063583815029	1.861543450064851
chr1	LINC01757	20243387	20243544	0	158	0	649	0	491	0.0	0.0
chr1	VWA5B1	20350155	20350230	0	76	135	6402	135	6326	0.0	0.021340499525766676
chr1	VWA5B1	20349097	20349298	0	202	135	6402	135	6200	0.0	0.021774193548387097
chr1	CDA	20613841	20613899	0	59	0	824	0	765	0.0	0.0
chr1	AL592309.2	21416971	21417121	180	151	960	765	780	614	1.1920529801324504	1.270358306188925
chr1	NBPF3	21468687	21468897	0	211	3157	6838	3157	6627	0.0	0.47638448770182584
chr1	ALPL	21561096	21561212	264	117	104736	2994	104472	2877	2.2564102564102564	36.31282586027112
chr1	ALPL	21553977	21554142	941	166	104736	2994	103795	2828	5.668674698795181	36.702616690240454
chr1	ALPL	21573664	21573799	57798	136	104736	2994	46938	2858	424.9852941176471	16.42337298810357
chr1	AL590556.3	22006877	22007014	867	138	7410	1620	6543	1482	6.282608695652174	4.41497975708502
chr1	AL590556.3	22010137	22010185	0	49	7410	1620	7410	1571	0.0	4.7167409293443665
chr1	LINC00339	22027413	22027534	0	122	23942	3569	23942	3447	0.0	6.945749927473165
chr1	LINC00339	22027681	22027780	0	100	23942	3569	23942	3469	0.0	6.901700778322283
chr1	LINC00339	22028527	22028660	0	134	23942	3569	23942	3435	0.0	6.9700145560407565
chr1	CDC42	22074093	22074219	19	127	15009	13175	14990	13048	0.14960629921259844	1.1488350705088903
chr1	CDC42	22078705	22078881	0	177	15009	13175	15009	12998	0.0	1.1547161101707955
chr1	CDC42	22069220	22069318	0	99	15009	13175	15009	13076	0.0	1.1478280819822575
chr1	CDC42	22078746	22078881	0	136	15009	13175	15009	13039	0.0	1.1510852059206995
chr1	ZBTB40	22452658	22452946	0	289	2148	9189	2148	8900	0.0	0.24134831460674158
chr1	C1QB	22654007	22654160	0	154	0	1497	0	1343	0.0	0.0
chr1	KDM1A	23044426	23044486	0	61	0	3430	0	3369	0.0	0.0
chr1	KDM1A	23066059	23066071	0	13	0	3430	0	3417	0.0	0.0
chr1	MDS2	23627780	23627998	171	219	1121	2151	950	1932	0.7808219178082192	0.4917184265010352
chr1	MDS2	23639108	23639251	0	144	1121	2151	1121	2007	0.0	0.5585450921773791
chr1	LYPLA2	23793007	23793039	0	33	134	1850	134	1817	0.0	0.07374793615850303
chr1	LYPLA2	23793859	23793930	0	72	134	1850	134	1778	0.0	0.07536557930258718
chr1	LYPLA2	23794062	23794136	0	75	134	1850	134	1775	0.0	0.07549295774647888
chr1	GRHL3	24334644	24334706	0	63	663	3924	663	3861	0.0	0.1717171717171717
chr1	GRHL3	24339667	24339762	0	96	663	3924	663	3828	0.0	0.1731974921630094
chr1	GRHL3	24331425	24331612	0	188	663	3924	663	3736	0.0	0.1774625267665953
chr1	NIPAL3	24433103	24433213	0	111	1076	7530	1076	7419	0.0	0.14503302331850654
chr1	NIPAL3	24457733	24457833	0	101	1076	7530	1076	7429	0.0	0.14483779781935657
chr1	RCAN3	24514313	24514567	0	255	153	6672	153	6417	0.0	0.023842917251051893
chr1	RCAN3	24531217	24531391	0	175	153	6672	153	6497	0.0	0.023549330460212407
chr1	RCAN3	24533082	24533254	0	173	153	6672	153	6499	0.0	0.023542083397445762
chr1	RCAN3	24533112	24533254	0	143	153	6672	153	6529	0.0	0.023433910246592127
chr1	SRRM1	24648023	24648166	0	144	2729	5651	2729	5507	0.0	0.49555111676048663
chr1	SRRM1	24663182	24663224	34	43	2729	5651	2695	5608	0.7906976744186046	0.48056348074179744
chr1	SRRM1	24647078	24647208	408	131	2729	5651	2321	5520	3.114503816793893	0.42047101449275365
chr1	RHD	25316999	25317079	0	81	0	3324	0	3243	0.0	0.0
chr1	RHD	25321888	25321962	0	75	0	3324	0	3249	0.0	0.0
chr1	RHD	25307646	25307816	0	171	0	3324	0	3153	0.0	0.0
chr1	RHD	25306595	25306729	0	135	0	3324	0	3189	0.0	0.0
chr1	TMEM50A	25340473	25340579	0	107	0	3018	0	2911	0.0	0.0
chr1	TMEM50A	25352881	25352974	0	94	0	3018	0	2924	0.0	0.0
chr1	TMEM50A	25342960	25343073	0	114	0	3018	0	2904	0.0	0.0
chr1	MACO1	25456652	25456831	0	180	0	3990	0	3810	0.0	0.0
chr1	MAN1C1	25780939	25781112	308	174	88802	8819	88494	8645	1.7701149425287357	10.236437246963563
chr1	MAN1C1	25654241	25654366	51	126	88802	8819	88751	8693	0.40476190476190477	10.209478891061774
chr1	SELENON	25802015	25802117	365	103	88869	4378	88504	4275	3.5436893203883497	20.702690058479533
chr1	MTFR1L	25826614	25826826	4543	213	11895	4825	7352	4612	21.328638497652584	1.5941023417172593
chr1	MTFR1L	25823239	25823439	459	201	11895	4825	11436	4624	2.283582089552239	2.4731833910034604
chr1	MTFR1L	25822995	25823128	0	134	11895	4825	11895	4691	0.0	2.535706672351311
chr1	MTFR1L	25823018	25823128	0	111	11895	4825	11895	4714	0.0	2.523334747560458
chr1	MTFR1L	25823345	25823439	136	95	11895	4825	11759	4730	1.431578947368421	2.486046511627907
chr1	MTFR1L	25823237	25823323	155	87	11895	4825	11740	4738	1.7816091954022988	2.4778387505276487
chr1	MTFR1L	25826301	25826411	5479	111	11895	4825	6416	4714	49.36036036036036	1.3610521849809079
chr1	EXTL1	26029599	26029707	0	109	153	4359	153	4250	0.0	0.036
chr1	EXTL1	26033228	26033315	0	88	153	4359	153	4271	0.0	0.03582299227347226
chr1	PDIK1L	26112459	26112650	0	192	0	4565	0	4373	0.0	0.0
chr1	CNKSR1	26184070	26184141	0	72	92523	3847	92523	3775	0.0	24.509403973509933
chr1	ZPLD2P	26223376	26223753	663	378	967913	3201	967250	2823	1.753968253968254	342.6319518243004
chr1	CEP85	26244165	26244318	0	154	0	5161	0	5007	0.0	0.0
chr1	DHDDS	26446315	26446432	0	118	2827	5593	2827	5475	0.0	0.5163470319634703
chr1	DHDDS	26447558	26447660	0	103	2827	5593	2827	5490	0.0	0.514936247723133
chr1	DHDDS	26460036	26460144	0	109	2827	5593	2827	5484	0.0	0.5154996353026987
chr1	RPS6KA1	26530744	26530902	0	159	15499	5692	15499	5533	0.0	2.801192842942346
chr1	RPS6KA1	26546866	26546983	0	118	15499	5692	15499	5574	0.0	2.780588446358091
chr1	RPS6KA1	26560725	26560851	12534	127	15499	5692	2965	5565	98.69291338582677	0.5327942497753818
chr1	RPS6KA1	26547188	26547270	0	83	15499	5692	15499	5609	0.0	2.7632376537707257
chr1	RPS6KA1	26544074	26544178	38	105	15499	5692	15461	5587	0.3619047619047619	2.7673169858600324
chr1	RPS6KA1	26552817	26552896	0	80	15499	5692	15499	5612	0.0	2.76176051318603
chr1	ARID1A	26774328	26775220	11401	893	112352	12546	100951	11653	12.767077267637179	8.663091049515147
chr1	ARID1A	26774979	26775220	4528	242	112352	12546	107824	12304	18.710743801652892	8.76332899869961
chr1	ARID1A	26775816	26775956	51	141	112352	12546	112301	12405	0.3617021276595745	9.052881902458687
chr1	TMEM222	27330984	27331137	180	154	4598	2716	4418	2562	1.1688311688311688	1.7244340359094457
chr1	TMEM222	27334666	27334754	0	89	4598	2716	4598	2627	0.0	1.75028549676437
chr1	TMEM222	27333360	27333435	250	76	4598	2716	4348	2640	3.289473684210526	1.646969696969697
chr1	SYTL1	27350793	27350952	0	160	204	5082	204	4922	0.0	0.04144656643640796
chr1	AL445490.1	27669906	27670026	0	121	28988	1636	28988	1515	0.0	19.133993399339936
chr1	AL445490.1	27670311	27670429	0	119	28988	1636	28988	1517	0.0	19.108767303889255
chr1	FAM76A	27734030	27734183	75165	154	98996	4057	23831	3903	488.0844155844156	6.105816038944401
chr1	FAM76A	27749067	27749154	46	88	98996	4057	98950	3969	0.5227272727272727	24.93071302595112
chr1	FAM76A	27730231	27730333	96	103	98996	4057	98900	3954	0.9320388349514563	25.012645422357107
chr1	STX12	27811991	27812060	377	70	1040	3811	663	3741	5.385714285714286	0.17722534081796312
chr1	PPP1R8	27841013	27841234	0	222	561	2822	561	2600	0.0	0.21576923076923077
chr1	THEMIS2	27876587	27876728	5673	142	21416	2665	15743	2523	39.95070422535211	6.239793896155371
chr1	THEMIS2	27879643	27880054	5644	412	21416	2665	15772	2253	13.699029126213592	7.000443852640923
chr1	THEMIS2	27881970	27882125	50	156	21416	2665	21366	2509	0.32051282051282054	8.51574332403348
chr1	THEMIS2	27881970	27883043	662	1074	21416	2665	20754	1591	0.6163873370577281	13.044626021370208
chr1	THEMIS2	27881970	27882077	50	108	21416	2665	21366	2557	0.46296296296296297	8.355885803676182
chr1	SMPDL3B	27953214	27953358	0	145	51	2674	51	2529	0.0	0.020166073546856466
chr1	SMPDL3B	27942274	27942364	0	91	51	2674	51	2583	0.0	0.019744483159117306
chr1	XKR8	27965350	27965458	0	109	0	3028	0	2919	0.0	0.0
chr1	XKR8	27964184	27964235	0	52	0	3028	0	2976	0.0	0.0
chr1	XKR8	27964878	27965158	0	281	0	3028	0	2747	0.0	0.0
chr1	XKR8	27965718	27965928	0	211	0	3028	0	2817	0.0	0.0
chr1	PHACTR4	28432930	28433046	0	117	2745	7336	2745	7219	0.0	0.38024657154730573
chr1	PHACTR4	28457831	28457859	3	29	2745	7336	2742	7307	0.10344827586206896	0.37525660325715066
chr1	PHACTR4	28457831	28457855	0	25	2745	7336	2745	7311	0.0	0.37546163315551906
chr1	PHACTR4	28489773	28489894	0	122	2745	7336	2745	7214	0.0	0.3805101192126421
chr1	PHACTR4	28494229	28494322	0	94	2745	7336	2745	7242	0.0	0.37903893951946976
chr1	RCC1	28516724	28516867	71	144	117680	3738	117609	3594	0.4930555555555556	32.723706176961606
chr1	RCC1	28530522	28530615	597	94	117680	3738	117083	3644	6.351063829787234	32.130351262349066
chr1	RCC1	28516724	28516853	57	130	117680	3738	117623	3608	0.43846153846153846	32.60060975609756
chr1	RCC1	28532673	28532757	0	85	117680	3738	117680	3653	0.0	32.21461812209143
chr1	RCC1	28530522	28530573	561	52	117680	3738	117119	3686	10.788461538461538	31.774009766684753
chr1	YTHDF2	28737657	28737682	0	26	7271	3737	7271	3711	0.0	1.959310158986796
chr1	EPB41	28993329	28993542	51	214	325029	17917	324978	17703	0.2383177570093458	18.357227588544315
chr1	EPB41	28997214	28997319	1073	106	325029	17917	323956	17811	10.122641509433961	18.18853517489192
chr1	EPB41	29064981	29065158	345	178	325029	17917	324684	17739	1.9382022471910112	18.30339928970066
chr1	EPB41	29109335	29109437	50	103	325029	17917	324979	17814	0.4854368932038835	18.242898843606152
chr1	EPB41	29058810	29058852	0	43	325029	17917	325029	17874	0.0	18.18445787176905
chr1	EPB41	29060421	29060484	0	64	325029	17917	325029	17853	0.0	18.20584775667955
chr1	EPB41	29058588	29058645	0	58	325029	17917	325029	17859	0.0	18.19973122795229
chr1	EPB41	29068732	29068783	77	52	325029	17917	324952	17865	1.4807692307692308	18.189308704170166
chr1	EPB41	29065683	29065825	911	143	325029	17917	324118	17774	6.370629370629371	18.235512546416114
chr1	EPB41	28989355	28989435	0	81	325029	17917	325029	17836	0.0	18.223200269118635
chr1	EPB41	29035005	29035283	0	279	325029	17917	325029	17638	0.0	18.427769588388706
chr1	EPB41	29068732	29068768	32	37	325029	17917	324997	17880	0.8648648648648649	18.176565995525728
chr1	EPB41	29031787	29031913	0	127	325029	17917	325029	17790	0.0	18.270320404721755
chr1	EPB41	29096154	29096604	48263	451	325029	17917	276766	17466	107.01330376940133	15.845986488033894
chr1	PTPRU	29289682	29289712	0	31	485	6715	485	6684	0.0	0.07256134051466188
chr1	PTPRU	29307128	29307146	0	19	485	6715	485	6696	0.0	0.07243130227001195
chr1	MATN1-AS1	30720976	30721174	0	199	0	3750	0	3551	0.0	0.0
chr1	LINC01778	30826533	30826652	0	120	0	2117	0	1997	0.0	0.0
chr1	LINC01778	30826604	30826652	0	49	0	2117	0	2068	0.0	0.0
chr1	LINC01778	30826554	30826652	0	99	0	2117	0	2018	0.0	0.0
chr1	LINC01778	30826130	30826194	0	65	0	2117	0	2052	0.0	0.0
chr1	LINC01778	30829747	30829882	0	136	0	2117	0	1981	0.0	0.0
chr1	LINC01778	30826055	30826194	0	140	0	2117	0	1977	0.0	0.0
chr1	LINC01778	30826133	30826194	0	62	0	2117	0	2055	0.0	0.0
chr1	ZCCHC17	31318166	31318236	0	71	1173	1930	1173	1859	0.0	0.6309844002151694
chr1	ZCCHC17	31337174	31337275	0	102	1173	1930	1173	1828	0.0	0.6416849015317286
chr1	ZCCHC17	31348828	31348974	357	147	1173	1930	816	1783	2.4285714285714284	0.45765563656758274
chr1	ZCCHC17	31346639	31346740	0	102	1173	1930	1173	1828	0.0	0.6416849015317286
chr1	ZCCHC17	31310043	31310164	0	122	1173	1930	1173	1808	0.0	0.6487831858407079
chr1	LDC1P	31507295	31507350	0	56	2565	2358	2565	2302	0.0	1.1142484795829712
chr1	TINAGL1	31577133	31577458	0	326	11	5290	11	4964	0.0	0.0022159548751007254
chr1	TINAGL1	31583148	31583241	0	94	11	5290	11	5196	0.0	0.002117013086989992
chr1	HCRTR1	31619050	31619391	16	342	511	2570	495	2228	0.04678362573099415	0.22217235188509873
chr1	HCRTR1	31619531	31619710	0	180	511	2570	511	2390	0.0	0.21380753138075315
chr1	PEF1-AS1	31655951	31656044	0	94	351	2148	351	2054	0.0	0.17088607594936708
chr1	PEF1-AS1	31652110	31652244	31	135	351	2148	320	2013	0.22962962962962963	0.15896671634376552
chr1	PEF1-AS1	31655910	31656044	0	135	351	2148	351	2013	0.0	0.17436661698956782
chr1	PEF1-AS1	31655951	31656185	0	235	351	2148	351	1913	0.0	0.18348144276006273
chr1	PEF1-AS1	31656896	31657061	0	166	351	2148	351	1982	0.0	0.17709384460141273
chr1	PEF1-AS1	31653439	31653574	205	136	351	2148	146	2012	1.5073529411764706	0.07256461232604373
chr1	KHDRBS1	32031523	32031640	0	118	51	3555	51	3437	0.0	0.014838521966831539
chr1	TMEM39B	32076762	32076846	0	85	47302	2802	47302	2717	0.0	17.409642988590356
chr1	TMEM39B	32077163	32077318	0	156	47302	2802	47302	2646	0.0	17.87679516250945
chr1	KPNA6	32159399	32159531	0	133	909	7472	909	7339	0.0	0.12385883635372666
chr1	CCDC28B	32204185	32204379	2115	195	55471	2043	53356	1848	10.846153846153847	28.872294372294373
chr1	CCDC28B	32204232	32204379	102	148	55471	2043	55369	1895	0.6891891891891891	29.218469656992085
chr1	EIF3I	32222357	32222444	997	88	21504	5731	20507	5643	11.329545454545455	3.6340598972177918
chr1	EIF3I	32222537	32222630	1275	94	21504	5731	20229	5637	13.563829787234043	3.5886109632783394
chr1	EIF3I	32226170	32226320	0	151	21504	5731	21504	5580	0.0	3.8537634408602153
chr1	EIF3I	32226402	32226530	0	129	21504	5731	21504	5602	0.0	3.838629061049625
chr1	EIF3I	32229134	32229208	0	75	21504	5731	21504	5656	0.0	3.801980198019802
chr1	EIF3I	32230265	32230376	0	112	21504	5731	21504	5619	0.0	3.827015483182061
chr1	EIF3I	32222540	32222630	1275	91	21504	5731	20229	5640	14.010989010989011	3.5867021276595743
chr1	EIF3I	32227963	32228110	0	148	21504	5731	21504	5583	0.0	3.85169263836647
chr1	EIF3I	32226148	32226320	0	173	21504	5731	21504	5558	0.0	3.8690176322418135
chr1	EIF3I	32226170	32226283	0	114	21504	5731	21504	5617	0.0	3.8283781377959767
chr1	EIF3I	32230926	32231019	0	94	21504	5731	21504	5637	0.0	3.8147951037786054
chr1	EIF3I	32226104	32226320	0	217	21504	5731	21504	5514	0.0	3.8998911860718173
chr1	LCK	32276336	32276489	0	154	51	3193	51	3039	0.0	0.01678183613030602
chr1	HDAC1	32302620	32302733	0	114	297	3233	297	3119	0.0	0.0952228278294325
chr1	HDAC1	32324478	32324553	0	76	297	3233	297	3157	0.0	0.09407665505226481
chr1	RBBP4	32657426	32657572	2286	147	285335	9163	283049	9016	15.551020408163266	31.39407719609583
chr1	RBBP4	32668224	32668398	1632	175	285335	9163	283703	8988	9.325714285714286	31.564641744548286
chr1	RBBP4	32668319	32668398	369	80	285335	9163	284966	9083	4.6125	31.373554992843776
chr1	RBBP4	32662245	32662337	95861	93	285335	9163	189474	9070	1030.763440860215	20.890187431091512
chr1	RBBP4	32673458	32673580	7074	123	285335	9163	278261	9040	57.51219512195122	30.78108407079646
chr1	RBBP4	32679639	32679817	0	179	285335	9163	285335	8984	0.0	31.760351736420304
chr1	RBBP4	32679634	32679698	0	65	285335	9163	285335	9098	0.0	31.362387337876456
chr1	S100PBP	32820546	32820599	1506	54	53288	9206	51782	9152	27.88888888888889	5.657998251748252
chr1	S100PBP	32825312	32825429	3058	118	53288	9206	50230	9088	25.915254237288135	5.527068661971831
chr1	S100PBP	32825312	32825485	4004	174	53288	9206	49284	9032	23.011494252873565	5.45659875996457
chr1	HPCA	32888877	32889276	0	400	0	1970	0	1570	0.0	0.0
chr1	AZIN2	33082177	33082354	0	178	359545	7260	359545	7082	0.0	50.768850607173114
chr1	AZIN2	33083953	33084127	41	175	359545	7260	359504	7085	0.2342857142857143	50.741566690190545
chr1	AZIN2	33081600	33081812	0	213	359545	7260	359545	7047	0.0	51.02100184475663
chr1	AZIN2	33092049	33092222	1528	174	359545	7260	358017	7086	8.781609195402298	50.52455546147333
chr1	AZIN2	33083017	33083142	0	126	359545	7260	359545	7134	0.0	50.39879450518643
chr1	AZIN2	33083062	33083142	0	81	359545	7260	359545	7179	0.0	50.082880624042346
chr1	AZIN2	33101832	33101902	84	71	359545	7260	359461	7189	1.1830985915492958	50.001530115454166
chr1	ZNF362	33270486	33270612	92	127	94913	3394	94821	3267	0.7244094488188977	29.023875114784207
chr1	AL513327.1	33314689	33314823	335	135	13138	3838	12803	3703	2.4814814814814814	3.4574669187145557
chr1	AL513327.1	33314509	33314823	1414	315	13138	3838	11724	3523	4.488888888888889	3.327845586148169
chr1	CSMD2-AS1	33882585	33882668	0	84	507	2628	507	2544	0.0	0.19929245283018868
chr1	CSMD2-AS1	33884569	33884814	0	246	507	2628	507	2382	0.0	0.2128463476070529
chr1	CSMD2-AS1	33875463	33875592	0	130	507	2628	507	2498	0.0	0.20296236989591673
chr1	CSMD2-AS1	33882162	33882234	0	73	507	2628	507	2555	0.0	0.19843444227005871
chr1	CSMD2-AS1	33875441	33875592	0	152	507	2628	507	2476	0.0	0.20476575121163165
chr1	ZMYM1	35093319	35093441	0	123	51	5220	51	5097	0.0	0.010005885815185403
chr1	ZMYM1	35093913	35094009	0	97	51	5220	51	5123	0.0	0.009955104430997463
chr1	ZMYM1	35093913	35094083	0	171	51	5220	51	5049	0.0	0.010101010101010102
chr1	ZMYM1	35093393	35093441	0	49	51	5220	51	5171	0.0	0.009862695803519629
chr1	ZMYM4	35295926	35295988	0	63	1163	7937	1163	7874	0.0	0.1477012954025908
chr1	NCDN	35558155	35558223	0	69	78052	4926	78052	4857	0.0	16.070002058884086
chr1	AGO3	35966954	35967075	992	122	1623679	21176	1622687	21054	8.131147540983607	77.07262277951934
chr1	AGO3	36005718	36005858	0	141	1623679	21176	1623679	21035	0.0	77.18939862134538
chr1	AGO3	35973374	35973511	0	138	1623679	21176	1623679	21038	0.0	77.17839148208004
chr1	MAP7D1	36174897	36175008	0	112	118084	4365	118084	4253	0.0	27.76487185516106
chr1	THRAP3	36224970	36225102	0	133	29510	4735	29510	4602	0.0	6.4124293785310735
chr1	THRAP3	36225411	36225463	86	53	29510	4735	29424	4682	1.6226415094339623	6.284493806065784
chr1	SH3D21	36307516	36307607	0	92	83509	6435	83509	6343	0.0	13.16553681223396
chr1	SH3D21	36319441	36319536	3561	96	83509	6435	79948	6339	37.09375	12.612083924909292
chr1	SH3D21	36319259	36319312	1827	54	83509	6435	81682	6381	33.833333333333336	12.800814919291646
chr1	DNALI1	37559326	37559496	0	171	0	3254	0	3083	0.0	0.0
chr1	MANEAL	37796743	37796820	0	78	0	3022	0	2944	0.0	0.0
chr1	LINC01685	38493570	38493621	0	52	1621	3681	1621	3629	0.0	0.4466795260402315
chr1	LINC01685	38476728	38476803	0	76	1621	3681	1621	3605	0.0	0.44965325936199724
chr1	AL139260.1	38875940	38876018	0	79	0	2010	0	1931	0.0	0.0
chr1	AKIRIN1	38998170	38998311	0	142	0	2693	0	2551	0.0	0.0
chr1	AKIRIN1	39000971	39001106	0	136	0	2693	0	2557	0.0	0.0
chr1	AKIRIN1	39003346	39003418	0	73	0	2693	0	2620	0.0	0.0
chr1	MACF1	39083362	39083417	0	56	286688	41060	286688	41004	0.0	6.991708126036484
chr1	MACF1	39302923	39303078	184	156	286688	41060	286504	40904	1.1794871794871795	7.004302757676511
chr1	MACF1	39378460	39378523	0	64	286688	41060	286688	40996	0.0	6.993072494877549
chr1	MACF1	39427960	39428287	0	328	286688	41060	286688	40732	0.0	7.038397328881469
chr1	MACF1	39436481	39436490	0	10	286688	41060	286688	41050	0.0	6.983873325213155
chr1	MACF1	39437776	39438008	0	233	286688	41060	286688	40827	0.0	7.02201974183751
chr1	MACF1	39251845	39251941	0	97	286688	41060	286688	40963	0.0	6.9987061494519445
chr1	MACF1	39465094	39465112	109	19	286688	41060	286579	41041	5.7368421052631575	6.982748958358714
chr1	MACF1	39469546	39469615	1071	70	286688	41060	285617	40990	15.3	6.967967797023665
chr1	MACF1	39480919	39481030	51	112	286688	41060	286637	40948	0.45535714285714285	7.000024421217153
chr1	MACF1	39299251	39299257	0	7	286688	41060	286688	41053	0.0	6.983362969819502
chr1	MACF1	39328600	39328706	1153	107	286688	41060	285535	40953	10.77570093457944	6.972260884428491
chr1	MACF1	39391867	39391955	62	89	286688	41060	286626	40971	0.6966292134831461	6.995826316174855
chr1	MACF1	39459817	39459832	460	16	286688	41060	286228	41044	28.75	6.973686775168113
chr1	PABPC4-AS1	39566582	39566674	0	93	423	1413	423	1320	0.0	0.32045454545454544
chr1	PPIE	39745374	39745498	0	125	7240	11133	7240	11008	0.0	0.657703488372093
chr1	PPIE	39745374	39748767	3765	3394	7240	11133	3475	7739	1.1093105480259282	0.4490244217599173
chr1	PPIE	39762516	39762651	17	136	7240	11133	7223	10997	0.125	0.6568154951350368
chr1	PPIE	39745413	39745498	0	86	7240	11133	7240	11047	0.0	0.6553815515524577
chr1	CAP1	40041428	40041493	51993	66	53087	3616	1094	3550	787.7727272727273	0.30816901408450703
chr1	CAP1	40057445	40057495	0	51	53087	3616	53087	3565	0.0	14.89116409537167
chr1	ZMPSTE24	40280119	40280312	0	194	51	4036	51	3842	0.0	0.01327433628318584
chr1	ZMPSTE24	40262833	40262983	0	151	51	4036	51	3885	0.0	0.013127413127413128
chr1	ZMPSTE24	40267390	40267507	0	118	51	4036	51	3918	0.0	0.013016845329249618
chr1	ZFP69B	40454202	40454288	0	87	51	2571	51	2484	0.0	0.020531400966183576
chr1	EXO5	40509450	40509625	0	176	3874	2819	3874	2643	0.0	1.4657586076428302
chr1	EXO5	40509732	40509790	0	59	3874	2819	3874	2760	0.0	1.403623188405797
chr1	ZNF684	40532732	40532808	255	77	4818	3108	4563	3031	3.311688311688312	1.5054437479379743
chr1	ZNF684	40533142	40533181	0	40	4818	3108	4818	3068	0.0	1.5704041720990873
chr1	NFYC	40747533	40747605	198	73	196095	5237	195897	5164	2.712328767123288	37.935127807900855
chr1	NFYC	40749572	40749686	0	115	196095	5237	196095	5122	0.0	38.284849668098396
chr1	NFYC	40753150	40753246	0	97	196095	5237	196095	5140	0.0	38.150778210116734
chr1	NFYC	40766917	40766974	0	58	196095	5237	196095	5179	0.0	37.86348715968334
chr1	NFYC	40723688	40723792	0	105	196095	5237	196095	5132	0.0	38.21024941543258
chr1	NFYC	40712686	40712821	0	136	196095	5237	196095	5101	0.0	38.44246226230151
chr1	NFYC	40763362	40763489	0	128	196095	5237	196095	5109	0.0	38.38226658837346
chr1	KCNQ4	40824096	40824258	0	163	41391	4424	41391	4261	0.0	9.713916920910584
chr1	KCNQ4	40826637	40826694	0	58	41391	4424	41391	4366	0.0	9.480302336234539
chr1	CTPS1	41007448	41007545	342	98	112459	6125	112117	6027	3.489795918367347	18.6024556163929
chr1	CTPS1	40980885	40981043	23746	159	112459	6125	88713	5966	149.34591194968553	14.869761984579283
chr1	CTPS1	41000434	41000566	915	133	112459	6125	111544	5992	6.879699248120301	18.615487316421895
chr1	AC093151.2	41263840	41264108	0	269	0	2258	0	1989	0.0	0.0
chr1	RIMKLA	42396439	42396500	0	62	714	10644	714	10582	0.0	0.06747306747306747
chr1	CCDC30	42480460	42480566	91	107	197370	22898	197279	22791	0.8504672897196262	8.656004563204775
chr1	CCDC30	42577019	42577229	0	211	197370	22898	197370	22687	0.0	8.699695861065809
chr1	CCDC30	42630403	42630525	0	123	197370	22898	197370	22775	0.0	8.666081229418221
chr1	CCDC30	42646134	42646317	1778	184	197370	22898	195592	22714	9.66304347826087	8.611076868891432
chr1	CCDC30	42521162	42521256	0	95	197370	22898	197370	22803	0.0	8.655440073674516
chr1	CCDC30	42637236	42637378	0	143	197370	22898	197370	22755	0.0	8.673698088332234
chr1	CCDC30	42506946	42507069	0	124	197370	22898	197370	22774	0.0	8.666461754632476
chr1	CCDC30	42473121	42473303	357	183	197370	22898	197013	22715	1.9508196721311475	8.67325555800132
chr1	CCDC30	42539172	42539310	0	139	197370	22898	197370	22759	0.0	8.672173645590755
chr1	CCDC30	42556155	42556405	0	251	197370	22898	197370	22647	0.0	8.715061597562592
chr1	CCDC30	42477107	42477136	0	30	197370	22898	197370	22868	0.0	8.63083785202029
chr1	CCDC30	42534888	42534989	0	102	197370	22898	197370	22796	0.0	8.658097911914371
chr1	CCDC30	42545409	42545579	0	171	197370	22898	197370	22727	0.0	8.684384212610551
chr1	CCDC30	42536475	42536601	0	127	197370	22898	197370	22771	0.0	8.667603530806728
chr1	CCDC30	42558138	42558276	0	139	197370	22898	197370	22759	0.0	8.672173645590755
chr1	CCDC30	42537191	42537290	0	100	197370	22898	197370	22798	0.0	8.657338363014299
chr1	CCDC30	42529601	42529721	0	121	197370	22898	197370	22777	0.0	8.665320279229046
chr1	CCDC30	42580831	42580981	0	151	197370	22898	197370	22747	0.0	8.676748582230625
chr1	PPIH	42668046	42668151	0	106	9233	4021	9233	3915	0.0	2.3583652618135376
chr1	PPIH	42675366	42675448	130	83	9233	4021	9103	3938	1.5662650602409638	2.3115794819705435
chr1	PPIH	42663417	42663543	0	127	9233	4021	9233	3894	0.0	2.3710837185413456
chr1	PPIH	42675287	42675327	26	41	9233	4021	9207	3980	0.6341463414634146	2.313316582914573
chr1	YBX1	42696198	42696288	5	91	1535	3403	1530	3312	0.054945054945054944	0.46195652173913043
chr1	ERMAP	42817533	42817815	0	283	0	5141	0	4858	0.0	0.0
chr1	ZNF691	42849564	42849742	0	179	612	2041	612	1862	0.0	0.32867883995703545
chr1	ZNF691	42849290	42849413	0	124	612	2041	612	1917	0.0	0.3192488262910798
chr1	ZNF691	42850658	42850743	0	86	612	2041	612	1955	0.0	0.3130434782608696
chr1	SLC2A1-AS1	42973973	42974188	0	216	1258	4280	1258	4064	0.0	0.3095472440944882
chr1	FAM183A	43152827	43152931	0	105	2602	811	2602	706	0.0	3.685552407932011
chr1	FAM183A	43152827	43152979	3	153	2602	811	2599	658	0.0196078431372549	3.9498480243161094
chr1	CFAP57	43232065	43232164	74	100	25573	5416	25499	5316	0.74	4.796651617757712
chr1	CFAP57	43177120	43177211	80	92	25573	5416	25493	5324	0.8695652173913043	4.78831705484598
chr1	TIE1	43307795	43307924	255	130	66898	6231	66643	6101	1.9615384615384615	10.923291263727258
chr1	MPL	43349836	43349962	95	127	662	3950	567	3823	0.7480314960629921	0.14831284331676695
chr1	SZT2	43426367	43426538	0	172	31845	24016	31845	23844	0.0	1.3355561147458481
chr1	SZT2	43426437	43426538	0	102	31845	24016	31845	23914	0.0	1.3316467341306348
chr1	PTPRF	43597747	43598053	0	307	4099	10480	4099	10173	0.0	0.402929322716996
chr1	PTPRF	43602070	43602097	0	28	4099	10480	4099	10452	0.0	0.39217374665135857
chr1	PTPRF	43603610	43604189	779	580	4099	10480	3320	9900	1.3431034482758621	0.33535353535353535
chr1	PTPRF	43612767	43612800	0	34	4099	10480	4099	10446	0.0	0.3923990044035995
chr1	ST3GAL3	43792101	43792149	0	49	242611	18223	242611	18174	0.0	13.349345218443931
chr1	ST3GAL3	43838218	43838311	76	94	242611	18223	242535	18129	0.8085106382978723	13.378288929339732
chr1	ST3GAL3	43894382	43894477	36	96	242611	18223	242575	18127	0.375	13.381971644508193
chr1	ST3GAL3	43899540	43899727	1352	188	242611	18223	241259	18035	7.191489361702128	13.377266426393124
chr1	ST3GAL3	43920781	43920928	35	148	242611	18223	242576	18075	0.23648648648648649	13.420525587828493
chr1	KDM4A	43653662	43653799	0	138	51	5208	51	5070	0.0	0.010059171597633136
chr1	ST3GAL3	43801281	43801541	0	261	242611	18223	242611	17962	0.0	13.50690346286605
chr1	ST3GAL3	43801281	43801545	0	265	242611	18223	242611	17958	0.0	13.50991201692839
chr1	ST3GAL3	43858134	43858308	51	175	242611	18223	242560	18048	0.2914285714285714	13.439716312056738
chr1	ST3GAL3	43814890	43815004	561	115	242611	18223	242050	18108	4.878260869565217	13.367020101612546
chr1	ST3GAL3	43814890	43814933	0	44	242611	18223	242611	18179	0.0	13.345673579404808
chr1	ST3GAL3	43824730	43824892	40384	163	242611	18223	202227	18060	247.75460122699386	11.19750830564784
chr1	ST3GAL3	43921442	43921638	102	197	242611	18223	242509	18026	0.5177664974619289	13.453289692666148
chr1	ST3GAL3	43709413	43709526	0	114	242611	18223	242611	18109	0.0	13.39726103042686
chr1	ST3GAL3	43879334	43879507	55	174	242611	18223	242556	18049	0.3160919540229885	13.438750069255914
chr1	ST3GAL3	43899508	43899727	1644	220	242611	18223	240967	18003	7.472727272727273	13.384824751430317
chr1	ST3GAL3	43879026	43879231	3417	206	242611	18223	239194	18017	16.5873786407767	13.276017094965866
chr1	ST3GAL3	43920801	43920928	0	128	242611	18223	242611	18095	0.0	13.407626416137054
chr1	ST3GAL3	43921511	43921638	51	128	242611	18223	242560	18095	0.3984375	13.404807957999447
chr1	ST3GAL3	43831654	43831794	32	141	242611	18223	242579	18082	0.22695035460992907	13.415496073443203
chr1	ST3GAL3	43896729	43896822	3924	94	242611	18223	238687	18129	41.744680851063826	13.166032323900932
chr1	ST3GAL3	43920403	43920550	93	148	242611	18223	242518	18075	0.6283783783783784	13.41731673582296
chr1	ST3GAL3	43819113	43819236	51	124	242611	18223	242560	18099	0.4112903225806452	13.401845405823526
chr1	ST3GAL3	43920781	43920940	35	160	242611	18223	242576	18063	0.21875	13.429441399546032
chr1	ST3GAL3	43900748	43900833	576	86	242611	18223	242035	18137	6.6976744186046515	13.34481998125379
chr1	ST3GAL3	43911166	43911243	168	78	242611	18223	242443	18145	2.1538461538461537	13.361421879305594
chr1	ARTN	43934111	43934260	0	150	0	2662	0	2512	0.0	0.0
chr1	DPH2	43970965	43971189	0	225	0	2729	0	2504	0.0	0.0
chr1	DPH2	43971386	43972070	0	685	0	2729	0	2044	0.0	0.0
chr1	DPH2	43970905	43971189	0	285	0	2729	0	2444	0.0	0.0
chr1	DPH2	43971659	43972070	0	412	0	2729	0	2317	0.0	0.0
chr1	ATP6V0B	43976589	43976659	0	71	0	2433	0	2362	0.0	0.0
chr1	ATP6V0B	43975799	43975848	0	50	0	2433	0	2383	0.0	0.0
chr1	ATP6V0B	43975664	43975848	0	185	0	2433	0	2248	0.0	0.0
chr1	B4GALT2	43982816	43982930	0	115	153	5400	153	5285	0.0	0.028949858088930937
chr1	AL139220.2	44048357	44048486	732	130	64101	9671	63369	9541	5.630769230769231	6.641756629284142
chr1	AL139220.2	44061131	44061227	781	97	64101	9671	63320	9574	8.051546391752577	6.613745560894088
chr1	AL139220.2	44048362	44048486	672	125	64101	9671	63429	9546	5.376	6.644563167818982
chr1	AL139220.2	44050949	44051158	2473	210	64101	9671	61628	9461	11.776190476190477	6.51389916499313
chr1	AL139220.2	44074837	44074963	0	127	64101	9671	64101	9544	0.0	6.716366303436714
chr1	AL139220.2	44050949	44051107	2341	159	64101	9671	61760	9512	14.723270440251572	6.492851135407906
chr1	AL139220.2	44052111	44052186	2304	76	64101	9671	61797	9595	30.31578947368421	6.4405419489317355
chr1	AL139220.2	44069880	44069934	0	55	64101	9671	64101	9616	0.0	6.666077371048253
chr1	AL139220.2	44110393	44110597	852	205	64101	9671	63249	9466	4.15609756097561	6.681702936826537
chr1	DMAP1	44214538	44214616	0	79	3735	2653	3735	2574	0.0	1.451048951048951
chr1	ARMH1	44684392	44684656	13020	265	21052	3290	8032	3025	49.132075471698116	2.655206611570248
chr1	ARMH1	44688195	44688319	431	125	21052	3290	20621	3165	3.448	6.515323854660347
chr1	ARMH1	44698062	44698229	612	168	21052	3290	20440	3122	3.642857142857143	6.547085201793722
chr1	ARMH1	44704088	44704173	34	86	21052	3290	21018	3204	0.3953488372093023	6.559925093632959
chr1	ARMH1	44685333	44685457	2566	125	21052	3290	18486	3165	20.528	5.840758293838863
chr1	ARMH1	44723802	44723906	0	105	21052	3290	21052	3185	0.0	6.609733124018838
chr1	ARMH1	44689108	44689224	822	117	21052	3290	20230	3173	7.0256410256410255	6.375669713205169
chr1	ARMH1	44689741	44689874	479	134	21052	3290	20573	3156	3.574626865671642	6.518694550063372
chr1	KIF2C	44753131	44753254	0	124	41451	3547	41451	3423	0.0	12.109553023663453
chr1	PLK3	44804649	44804779	44296	131	144597	3191	100301	3060	338.1374045801527	32.7781045751634
chr1	BTBD19	44810212	44810426	1556	215	9155	3529	7599	3314	7.2372093023255815	2.2929993964996984
chr1	BTBD19	44812457	44812522	1	66	9155	3529	9154	3463	0.015151515151515152	2.6433727981518915
chr1	UROD	45013135	45013215	0	81	192	3179	192	3098	0.0	0.06197546804389929
chr1	UROD	45013291	45013354	0	64	192	3179	192	3115	0.0	0.06163723916532905
chr1	UROD	45014939	45015006	39	68	192	3179	153	3111	0.5735294117647058	0.04918032786885246
chr1	UROD	45013908	45014070	0	163	192	3179	192	3016	0.0	0.0636604774535809
chr1	UROD	45014438	45014576	0	139	192	3179	192	3040	0.0	0.06315789473684211
chr1	UROD	45013354	45013426	0	73	192	3179	192	3106	0.0	0.061815840309079204
chr1	TOE1	45341472	45341569	51	98	52081	2244	52030	2146	0.5204081632653061	24.24510717614166
chr1	AKR1A1	45552435	45552563	0	129	0	2518	0	2389	0.0	0.0
chr1	AKR1A1	45568484	45568684	0	201	0	2518	0	2317	0.0	0.0
chr1	AKR1A1	45561788	45561878	0	91	0	2518	0	2427	0.0	0.0
chr1	NASP	45591222	45591270	0	49	51	8254	51	8205	0.0	0.006215722120658135
chr1	NASP	45602254	45602365	0	112	51	8254	51	8142	0.0	0.006263817243920413
chr1	NASP	45604935	45605016	0	82	51	8254	51	8172	0.0	0.006240822320117474
chr1	NASP	45607320	45608337	0	1018	51	8254	51	7236	0.0	0.007048092868988391
chr1	NASP	45617462	45617591	0	130	51	8254	51	8124	0.0	0.006277695716395864
chr1	NASP	45600384	45600457	0	74	51	8254	51	8180	0.0	0.0062347188264058676
chr1	NASP	45594693	45594773	0	81	51	8254	51	8173	0.0	0.006240058729964517
chr1	NASP	45588650	45588948	0	299	51	8254	51	7955	0.0	0.006411062225015713
chr1	NASP	45604916	45605016	0	101	51	8254	51	8153	0.0	0.0062553661228995465
chr1	NASP	45606481	45606591	0	111	51	8254	51	8143	0.0	0.006263048016701462
chr1	TMEM69	45690973	45691110	0	138	51	1468	51	1330	0.0	0.038345864661654135
chr1	MAST2	46010729	46010939	0	211	316033	7806	316033	7595	0.0	41.61066491112574
chr1	MAST2	46000958	46000979	0	22	316033	7806	316033	7784	0.0	40.60033401849949
chr1	TSPAN1	46180525	46180658	0	134	5040	2305	5040	2171	0.0	2.3215108245048364
chr1	TSPAN1	46184593	46184668	357	76	5040	2305	4683	2229	4.697368421052632	2.100942126514132
chr1	RAD54L	46248343	46248408	0	66	42953	4044	42953	3978	0.0	10.797637003519357
chr1	RAD54L	46259963	46260099	0	137	42953	4044	42953	3907	0.0	10.993857179421552
chr1	RAD54L	46270658	46270785	0	128	42953	4044	42953	3916	0.0	10.968590398365679
chr1	RAD54L	46273354	46273465	52	112	42953	4044	42901	3932	0.4642857142857143	10.910732451678536
chr1	RAD54L	46273623	46273747	0	125	42953	4044	42953	3919	0.0	10.9601939270222
chr1	RAD54L	46248317	46248408	0	92	42953	4044	42953	3952	0.0	10.868674089068826
chr1	RAD54L	46257741	46257817	0	77	42953	4044	42953	3967	0.0	10.82757751449458
chr1	RAD54L	46271367	46271442	0	76	42953	4044	42953	3968	0.0	10.82484879032258
chr1	UQCRH	46309896	46310044	252	149	1347	1345	1095	1196	1.691275167785235	0.9155518394648829
chr1	NSUN4	46346920	46347075	0	156	2697	8320	2697	8164	0.0	0.3303527682508574
chr1	NSUN4	46341322	46341497	96	176	2697	8320	2601	8144	0.5454545454545454	0.3193762278978389
chr1	FAAH	46411611	46411651	0	41	2798	2707	2798	2666	0.0	1.0495123780945237
chr1	FAAHP1	46439522	46439577	0	56	253	2350	253	2294	0.0	0.11028770706190061
chr1	FAAHP1	46477347	46477504	0	158	253	2350	253	2192	0.0	0.11541970802919709
chr1	MKNK1-AS1	46540929	46541009	105	81	162	1569	57	1488	1.2962962962962963	0.038306451612903226
chr1	MKNK1-AS1	46559669	46559811	0	143	162	1569	162	1426	0.0	0.11360448807854137
chr1	EFCAB14-AS1	46682180	46682264	175	85	2685	588	2510	503	2.0588235294117645	4.990059642147117
chr1	CYP4B1	46811139	46811184	124	46	25637	3487	25513	3441	2.6956521739130435	7.414414414414415
chr1	CYP4B1	46812176	46812348	92	173	25637	3487	25545	3314	0.5317919075144508	7.708207604103802
chr1	CYP4B1	46810807	46810949	2134	143	25637	3487	23503	3344	14.923076923076923	7.028409090909091
chr1	CYP4A22	47143761	47143916	18212	156	112125	3865	93913	3709	116.74358974358974	25.320301968185493
chr1	CMPK1	47368468	47368615	0	148	0	3851	0	3703	0.0	0.0
chr1	CMPK1	47374908	47374985	0	78	0	3851	0	3773	0.0	0.0
chr1	SLC5A9	48229102	48229165	0	64	0	4404	0	4340	0.0	0.0
chr1	SLC5A9	48231945	48232151	0	207	0	4404	0	4197	0.0	0.0
chr1	SLC5A9	48229102	48229177	0	76	0	4404	0	4328	0.0	0.0
chr1	SLC5A9	48241943	48242216	0	274	0	4404	0	4130	0.0	0.0
chr1	ELAVL4	50178173	50178402	0	230	102	8008	102	7778	0.0	0.013113911031113397
chr1	ELAVL4	50197428	50197467	0	40	102	8008	102	7968	0.0	0.012801204819277108
chr1	ELAVL4	50141771	50141858	0	88	102	8008	102	7920	0.0	0.012878787878787878
chr1	ELAVL4	50120844	50121054	0	211	102	8008	102	7797	0.0	0.013081954597922277
chr1	C1ORF185	51145723	51145760	0	38	867	1125	867	1087	0.0	0.797608095676173
chr1	RNF11	51269955	51270125	0	171	1224	3115	1224	2944	0.0	0.4157608695652174
chr1	OSBPL9	51651990	51652041	0	52	1293	7377	1293	7325	0.0	0.17651877133105803
chr1	OSBPL9	51669433	51669512	0	80	1293	7377	1293	7297	0.0	0.17719610798958477
chr1	OSBPL9	51772069	51772182	0	114	1293	7377	1293	7263	0.0	0.17802560925237504
chr1	OSBPL9	51776832	51776918	0	87	1293	7377	1293	7290	0.0	0.17736625514403292
chr1	OSBPL9	51669433	51669814	0	382	1293	7377	1293	6995	0.0	0.18484631879914223
chr1	OSBPL9	51740142	51740211	0	70	1293	7377	1293	7307	0.0	0.17695360613110717
chr1	OSBPL9	51756319	51756358	0	40	1293	7377	1293	7337	0.0	0.17623006678478942
chr1	OSBPL9	51752502	51752725	1122	224	1293	7377	171	7153	5.008928571428571	0.023906053404166083
chr1	OSBPL9	51745535	51745631	0	97	1293	7377	1293	7280	0.0	0.17760989010989012
chr1	OSBPL9	51749501	51749588	32	88	1293	7377	1261	7289	0.36363636363636365	0.1730004115790918
chr1	BTF3L4	52060427	52060659	0	233	2400	5956	2400	5723	0.0	0.4193604752752053
chr1	BTF3L4	52083339	52083541	28	203	2400	5956	2372	5753	0.13793103448275862	0.41230662263167045
chr1	BTF3L4	52059834	52059901	26	68	2400	5956	2374	5888	0.38235294117647056	0.4031929347826087
chr1	ZFYVE9	52266654	52266831	1123	178	107048	7995	105925	7817	6.308988764044944	13.55059485736216
chr1	ZFYVE9	52199250	52199431	0	182	107048	7995	107048	7813	0.0	13.70126711890439
chr1	SHISAL2A	52659400	52659580	0	181	104	2691	104	2510	0.0	0.04143426294820717
chr1	ZYG11B	52805470	52805524	811	55	341902	8221	341091	8166	14.745454545454546	41.76965466568699
chr1	ZYG11A	52856997	52857749	191	753	9367	4456	9176	3703	0.2536520584329349	2.4779908182554684
chr1	SCP2	52941795	52941853	0	59	4957	6178	4957	6119	0.0	0.810099689491747
chr1	SCP2	52948008	52948080	18	73	4957	6178	4939	6105	0.2465753424657534	0.809009009009009
chr1	SCP2	52950754	52950886	408	133	4957	6178	4549	6045	3.0676691729323307	0.7525227460711331
chr1	SCP2	52974768	52974832	0	65	4957	6178	4957	6113	0.0	0.8108948143301161
chr1	SCP2	52976682	52976769	459	88	4957	6178	4498	6090	5.215909090909091	0.7385878489326765
chr1	SCP2	53027968	53028071	0	104	4957	6178	4957	6074	0.0	0.8161014158709252
chr1	SCP2	53038916	53039046	0	131	4957	6178	4957	6047	0.0	0.8197453282619481
chr1	SCP2	52993257	52996000	1938	2744	4957	6178	3019	3434	0.706268221574344	0.8791496796738497
chr1	SCP2	53027977	53028071	0	95	4957	6178	4957	6083	0.0	0.814893966792701
chr1	PODN	53063468	53063559	0	92	5428	4913	5428	4821	0.0	1.125907488073014
chr1	PODN	53063369	53063559	0	191	5428	4913	5428	4722	0.0	1.1495129182549768
chr1	PODN	53066811	53066867	0	57	5428	4913	5428	4856	0.0	1.1177924217462933
chr1	CPT2	53202322	53202429	0	108	306	5091	306	4983	0.0	0.061408789885611076
chr1	CPT2	53210014	53211250	0	1237	306	5091	306	3854	0.0	0.07939802802283343
chr1	CPT2	53200718	53200799	0	82	306	5091	306	5009	0.0	0.0610900379317229
chr1	CPT2	53210014	53211369	0	1356	306	5091	306	3735	0.0	0.0819277108433735
chr1	CPT2	53212780	53212816	0	37	306	5091	306	5054	0.0	0.060546102097348634
chr1	CPT2	53197302	53197507	0	206	306	5091	306	4885	0.0	0.06264073694984647
chr1	CPT2	53210014	53211319	0	1306	306	5091	306	3785	0.0	0.08084544253632761
chr1	AL606760.1	53241846	53241945	0	100	510	1945	510	1845	0.0	0.2764227642276423
chr1	DIO1	53904665	53904809	0	145	122	2265	122	2120	0.0	0.057547169811320756
chr1	DIO1	53906094	53906294	0	201	122	2265	122	2064	0.0	0.05910852713178295
chr1	DIO1	53894438	53894547	20	110	122	2265	102	2155	0.18181818181818182	0.047331786542923436
chr1	DIO1	53904733	53904809	0	77	122	2265	122	2188	0.0	0.055758683729433274
chr1	LRRC42	53947861	53947981	0	121	102	2093	102	1972	0.0	0.05172413793103448
chr1	LRRC42	53947787	53947821	0	35	102	2093	102	2058	0.0	0.04956268221574344
chr1	TCEANC2	54068755	54068897	0	143	2567	4725	2567	4582	0.0	0.560235704932344
chr1	ACOT11	54585834	54585904	0	71	123999	9790	123999	9719	0.0	12.758411359193333
chr1	MROH7	54670496	54670576	0	81	209164	6269	209164	6188	0.0	33.80155138978668
chr1	MROH7	54679890	54680045	175	156	209164	6269	208989	6113	1.1217948717948718	34.18763291346311
chr1	MROH7	54682655	54682794	1295	140	209164	6269	207869	6129	9.25	33.9156469244575
chr1	MROH7	54686257	54686448	2029	192	209164	6269	207135	6077	10.567708333333334	34.08507487246997
chr1	MROH7	54709013	54709076	0	64	209164	6269	209164	6205	0.0	33.70894439967768
chr1	MROH7	54695695	54695855	0	161	209164	6269	209164	6108	0.0	34.244269810085136
chr1	LEXM	54841615	54841702	0	88	918	1788	918	1700	0.0	0.54
chr1	DHCR24-DT	54887860	54887968	0	109	0	691	0	582	0.0	0.0
chr1	PCSK9	55051342	55051453	0	112	153	5316	153	5204	0.0	0.029400461183704842
chr1	PCSK9	55059485	55059663	0	179	153	5316	153	5137	0.0	0.029783920576211795
chr1	AL603840.1	55978493	55978578	0	86	668	8505	668	8419	0.0	0.07934434018291958
chr1	AL603840.1	56019130	56019206	0	77	668	8505	668	8428	0.0	0.07925961082107262
chr1	DAB1-AS1	57864421	57864594	0	174	0	4284	0	4110	0.0	0.0
chr1	DAB1-AS1	57864706	57864824	0	119	0	4284	0	4165	0.0	0.0
chr1	DAB1-AS1	57876730	57876842	0	113	0	4284	0	4171	0.0	0.0
chr1	DAB1-AS1	57880118	57880269	0	152	0	4284	0	4132	0.0	0.0
chr1	LINC01135	58893544	58893717	0	174	0	5023	0	4849	0.0	0.0
chr1	LINC01135	58896256	58896385	0	130	0	5023	0	4893	0.0	0.0
chr1	LINC01358	59021126	59021286	0	161	9058	8361	9058	8200	0.0	1.1046341463414635
chr1	LINC01358	59056839	59056861	0	23	9058	8361	9058	8338	0.0	1.0863516430798752
chr1	LINC01358	59062114	59062184	0	71	9058	8361	9058	8290	0.0	1.0926417370325694
chr1	LINC01358	59088014	59088152	0	139	9058	8361	9058	8222	0.0	1.1016784237411823
chr1	LINC01358	59083427	59083520	0	94	9058	8361	9058	8267	0.0	1.0956816257408974
chr1	LINC01358	59056937	59057032	0	96	9058	8361	9058	8265	0.0	1.095946763460375
chr1	LINC01358	59082567	59082708	0	142	9058	8361	9058	8219	0.0	1.1020805450784767
chr1	LINC01358	59082636	59082708	0	73	9058	8361	9058	8288	0.0	1.0929054054054055
chr1	LINC01358	59086402	59086596	0	195	9058	8361	9058	8166	0.0	1.109233406808719
chr1	LINC01358	59082220	59082437	0	218	9058	8361	9058	8143	0.0	1.1123664497114085
chr1	FGGY	59318592	59318708	0	117	759	12210	759	12093	0.0	0.06276358223765816
chr1	FGGY	59321535	59321750	0	216	759	12210	759	11994	0.0	0.0632816408204102
chr1	FGGY	59339957	59340069	0	113	759	12210	759	12097	0.0	0.06274282880052906
chr1	FGGY	59346246	59346398	102	153	759	12210	657	12057	0.6666666666666666	0.05449116695695447
chr1	FGGY	59554123	59554227	0	105	759	12210	759	12105	0.0	0.06270136307311029
chr1	FGGY	59674038	59674133	0	96	759	12210	759	12114	0.0	0.06265477959385835
chr1	FGGY	59641279	59641351	0	73	759	12210	759	12137	0.0	0.06253604679904425
chr1	FGGY	59315719	59315736	0	18	759	12210	759	12192	0.0	0.062253937007874016
chr1	FGGY	59638227	59638375	0	149	759	12210	759	12061	0.0	0.06293010529806815
chr1	FGGY	59378748	59378837	0	90	759	12210	759	12120	0.0	0.06262376237623762
chr1	FGGY	59474101	59474202	0	102	759	12210	759	12108	0.0	0.06268582755203171
chr1	FGGY	59667282	59667403	0	122	759	12210	759	12088	0.0	0.06278954334877565
chr1	NFIA	61277519	61277585	0	67	10	32389	10	32322	0.0	0.00030938679537157354
chr1	NFIA	61383236	61383365	0	130	10	32389	10	32259	0.0	0.00030999101026070246
chr1	NFIA	61426464	61426556	0	93	10	32389	10	32296	0.0	0.00030963586821897447
chr1	NFIA	60973745	60973951	0	207	10	32389	10	32182	0.0	0.0003107327077248151
chr1	NFIA	61443522	61443577	0	56	10	32389	10	32333	0.0	0.000309281538984938
chr1	NFIA	61372696	61372744	0	49	10	32389	10	32340	0.0	0.00030921459492888067
chr1	NFIA	61385870	61385924	0	55	10	32389	10	32334	0.0	0.00030927197377373663
chr1	NFIA	61399375	61399520	0	146	10	32389	10	32243	0.0	0.0003101448376391775
chr1	NFIA	61439450	61439518	0	69	10	32389	10	32320	0.0	0.0003094059405940594
chr1	PATJ	62100318	62100408	0	91	20780	10505	20780	10414	0.0	1.9953908200499328
chr1	PATJ	62108436	62108520	0	85	20780	10505	20780	10420	0.0	1.9942418426103647
chr1	PATJ	62153357	62153481	639	125	20780	10505	20141	10380	5.112	1.9403660886319847
chr1	PATJ	61833357	61833377	0	21	20780	10505	20780	10484	0.0	1.9820679130103014
chr1	ALG6	63396512	63396597	0	86	408	5100	408	5014	0.0	0.08137215795771839
chr1	ALG6	63411681	63411806	0	126	408	5100	408	4974	0.0	0.08202653799758745
chr1	PGM1	63654989	63655111	0	123	0	4092	0	3969	0.0	0.0
chr1	UBE2U	64232560	64232649	0	90	0	1838	0	1748	0.0	0.0
chr1	CACHD1	64632598	64632743	0	146	480	7052	480	6906	0.0	0.06950477845351868
chr1	RAVER2	64807205	64807474	0	270	2142	6082	2142	5812	0.0	0.36854783207157604
chr1	DNAJC6	65345610	65345723	51	114	145979	6981	145928	6867	0.4473684210526316	21.25061890199505
chr1	LEPROT	65429861	65430048	287	188	18353	5243	18066	5055	1.5265957446808511	3.573887240356083
chr1	LEPROT	65429930	65430048	191	119	18353	5243	18162	5124	1.6050420168067228	3.5444964871194378
chr1	LEPROT	65421327	65421459	459	133	18353	5243	17894	5110	3.4511278195488724	3.501761252446184
chr1	SGIP1	66634079	66634163	0	85	1252	13353	1252	13268	0.0	0.09436237564063914
chr1	SGIP1	66684106	66684187	0	82	1252	13353	1252	13271	0.0	0.09434104438248814
chr1	SGIP1	66635943	66636015	0	73	1252	13353	1252	13280	0.0	0.09427710843373494
chr1	SGIP1	66681868	66682369	0	502	1252	13353	1252	12851	0.0	0.0974243249552564
chr1	MIER1	66928889	66928963	0	75	153	6542	153	6467	0.0	0.0236585743002938
chr1	MIER1	66946149	66946295	102	147	153	6542	51	6395	0.6938775510204082	0.007974980453479281
chr1	MIER1	66928886	66928963	0	78	153	6542	153	6464	0.0	0.023669554455445545
chr1	IL12RB2	67390028	67390128	118	101	5064	6084	4946	5983	1.1683168316831682	0.8266755808123015
chr1	IL12RB2	67313912	67314000	0	89	5064	6084	5064	5995	0.0	0.8447039199332778
chr1	IL12RB2	67386578	67386669	0	92	5064	6084	5064	5992	0.0	0.8451268357810414
chr1	LINC01702	67527377	67527437	0	61	0	953	0	892	0.0	0.0
chr1	LINC01702	67529652	67529749	0	98	0	953	0	855	0.0	0.0
chr1	LINC01702	67530314	67530378	0	65	0	953	0	888	0.0	0.0
chr1	LINC01702	67529618	67529749	0	132	0	953	0	821	0.0	0.0
chr1	LINC01702	67530228	67530378	0	151	0	953	0	802	0.0	0.0
chr1	GADD45A	67686349	67686587	0	239	0	1706	0	1467	0.0	0.0
chr1	GADD45A	67686024	67686126	0	103	0	1706	0	1603	0.0	0.0
chr1	GADD45A	67686403	67686587	0	185	0	1706	0	1521	0.0	0.0
chr1	GNG12-AS1	68138296	68138450	0	155	0	3481	0	3326	0.0	0.0
chr1	LINC01707	69214383	69214559	0	177	51	6166	51	5989	0.0	0.008515611955251294
chr1	LINC01707	69085179	69085298	0	120	51	6166	51	6046	0.0	0.008435329143235196
chr1	LRRC7	70043953	70044094	22	142	22	14308	0	14166	0.15492957746478872	0.0
chr1	LRRC7	69716141	69716218	0	78	22	14308	22	14230	0.0	0.001546029515108925
chr1	LRRC7	70130127	70130256	0	130	22	14308	22	14178	0.0	0.0015516998166172943
chr1	LRRC7	70132202	70132288	0	87	22	14308	22	14221	0.0	0.001547007945995359
chr1	LRRC7	70140542	70140614	0	73	22	14308	22	14235	0.0	0.0015454864769933263
chr1	LRRC7	70140348	70140614	0	267	22	14308	22	14041	0.0	0.0015668399686632006
chr1	LRRC7	70147026	70147077	0	52	22	14308	22	14256	0.0	0.0015432098765432098
chr1	SRSF11	70231858	70231975	0	118	51	6054	51	5936	0.0	0.008591644204851753
chr1	SRSF11	70231094	70231203	0	110	51	6054	51	5944	0.0	0.008580080753701211
chr1	HHLA3	70366932	70366984	0	53	10710	1228	10710	1175	0.0	9.114893617021277
chr1	HHLA3	70366145	70366328	0	184	10710	1228	10710	1044	0.0	10.258620689655173
chr1	CTH	70424284	70424416	0	133	0	2426	0	2293	0.0	0.0
chr1	CTH	70417936	70418032	0	97	0	2426	0	2329	0.0	0.0
chr1	LINC01788	70777529	70777695	294	167	126931	2464	126637	2297	1.7604790419161678	55.13147583804963
chr1	ZRANB2-AS2	71223056	71223114	0	59	51	14846	51	14787	0.0	0.003448975451410022
chr1	ZRANB2-AS2	71365037	71365199	0	163	51	14846	51	14683	0.0	0.003473404617584962
chr1	ZRANB2-AS2	71193674	71193728	0	55	51	14846	51	14791	0.0	0.0034480427286863635
chr1	ZRANB2-AS2	71304358	71304415	0	58	51	14846	51	14788	0.0	0.003448742223424398
chr1	ZRANB2-AS2	71402495	71402571	0	77	51	14846	51	14769	0.0	0.0034531789559211863
chr1	ZRANB2-AS2	71093132	71093251	0	120	51	14846	51	14726	0.0	0.0034632622572321066
chr1	ZRANB2-AS2	71368054	71368088	0	35	51	14846	51	14811	0.0	0.0034433866720680576
chr1	ZRANB2-AS2	71184346	71184571	0	226	51	14846	51	14620	0.0	0.0034883720930232558
chr1	ZRANB2-AS2	71198866	71198991	0	126	51	14846	51	14720	0.0	0.003464673913043478
chr1	ZRANB2-AS2	71202347	71202422	0	76	51	14846	51	14770	0.0	0.0034529451591062965
chr1	ZRANB2-AS2	71208180	71208296	0	117	51	14846	51	14729	0.0	0.003462556860615113
chr1	ZRANB2-AS2	71268434	71268478	0	45	51	14846	51	14801	0.0	0.003445713127491386
chr1	ZRANB2-AS2	71202034	71202056	0	23	51	14846	51	14823	0.0	0.0034405990690143697
chr1	ZRANB2-AS2	71237129	71237195	0	67	51	14846	51	14779	0.0	0.0034508424115298735
chr1	ZRANB2-AS2	71402098	71402571	0	474	51	14846	51	14372	0.0	0.003548566657389368
chr1	ZRANB2-AS2	71280525	71280615	51	91	51	14846	0	14755	0.5604395604395604	0.0
chr1	ZRANB2-AS2	71461560	71461817	0	258	51	14846	51	14588	0.0	0.0034960241294214422
chr1	ZRANB2-AS2	71477376	71477453	0	78	51	14846	51	14768	0.0	0.0034534127843987
chr1	AL513166.1	72462192	72462304	0	113	51	6431	51	6318	0.0	0.008072174738841406
chr1	AL513166.1	72583014	72583192	0	179	51	6431	51	6252	0.0	0.008157389635316698
chr1	LINC01360	73307167	73307363	0	197	0	5538	0	5341	0.0	0.0
chr1	LINC01360	73310852	73310990	0	139	0	5538	0	5399	0.0	0.0
chr1	FPGT	74200691	74200818	0	128	0	3573	0	3445	0.0	0.0
chr1	FPGT-TNNI3K	74240807	74240835	0	29	0	9928	0	9899	0.0	0.0
chr1	FPGT	74204390	74204456	0	67	0	3573	0	3506	0.0	0.0
chr1	FPGT-TNNI3K	74260693	74260754	0	62	0	9928	0	9866	0.0	0.0
chr1	TYW3	74738689	74738788	0	100	51	4625	51	4525	0.0	0.011270718232044199
chr1	TYW3	74734117	74734182	0	66	51	4625	51	4559	0.0	0.011186663742048695
chr1	ACADM	75733527	75733628	0	102	26	4672	26	4570	0.0	0.0056892778993435445
chr1	ACADM	75728400	75728488	14	89	26	4672	12	4583	0.15730337078651685	0.0026183722452542005
chr1	ACADM	75732643	75732741	0	99	26	4672	26	4573	0.0	0.005685545593702165
chr1	ACADM	75733050	75733149	0	100	26	4672	26	4572	0.0	0.005686789151356081
chr1	ACADM	75734790	75734871	0	82	26	4672	26	4590	0.0	0.005664488017429194
chr1	ACADM	75754932	75755089	0	158	26	4672	26	4514	0.0	0.0057598582188746125
chr1	ACADM	75728388	75728488	26	101	26	4672	0	4571	0.25742574257425743	0.0
chr1	RABGGTB	75789158	75789356	0	199	0	4958	0	4759	0.0	0.0
chr1	RABGGTB	75789951	75790057	0	107	0	4958	0	4851	0.0	0.0
chr1	AC092813.1	75935924	75936154	0	231	0	2089	0	1858	0.0	0.0
chr1	AC092813.1	75972219	75972265	0	47	0	2089	0	2042	0.0	0.0
chr1	AC092813.1	76013259	76013330	0	72	0	2089	0	2017	0.0	0.0
chr1	AC092813.1	76010739	76010853	0	115	0	2089	0	1974	0.0	0.0
chr1	AC092813.1	75935950	75936154	0	205	0	2089	0	1884	0.0	0.0
chr1	AC092813.1	75983444	75983560	0	117	0	2089	0	1972	0.0	0.0
chr1	AC092813.1	75997414	75997566	0	153	0	2089	0	1936	0.0	0.0
chr1	AC092813.1	76010763	76010853	0	91	0	2089	0	1998	0.0	0.0
chr1	AC092813.1	75982696	75982775	0	80	0	2089	0	2009	0.0	0.0
chr1	NEXN	77925187	77925229	0	43	17	4215	17	4172	0.0	0.004074784276126558
chr1	NEXN	77917565	77917757	0	193	17	4215	17	4022	0.0	0.004226752859273993
chr1	DNAJB4	78013050	78013619	306	570	357	3709	51	3139	0.5368421052631579	0.01624721248805352
chr1	PTGFR	78532212	78532353	0	142	852	5771	852	5629	0.0	0.15135903357612365
chr1	PTGFR	78497873	78497944	0	72	852	5771	852	5699	0.0	0.1494999122653097
chr1	IFI44L	78627905	78628393	0	489	51	7676	51	7187	0.0	0.0070961458188395716
chr1	IFI44	78660553	78660654	0	102	102	1958	102	1856	0.0	0.05495689655172414
chr1	IFI44	78650185	78650652	0	468	102	1958	102	1490	0.0	0.06845637583892618
chr1	IFI44	78650540	78650652	0	113	102	1958	102	1845	0.0	0.055284552845528454
chr1	IFI44	78662703	78662878	0	176	102	1958	102	1782	0.0	0.05723905723905724
chr1	LINC01781	80540588	80540636	0	49	0	968	0	919	0.0	0.0
chr1	ADGRL2	81580875	81580980	0	106	10445	19025	10445	18919	0.0	0.5520904910407527
chr1	ADGRL2	81942033	81942045	0	13	10445	19025	10445	19012	0.0	0.549389859036398
chr1	ADGRL2	81986900	81987029	0	130	10445	19025	10445	18895	0.0	0.5527917438475787
chr1	ADGRL2	81980794	81980839	0	46	10445	19025	10445	18979	0.0	0.5503451182886349
chr1	ADGRL2	81952986	81953025	0	40	10445	19025	10445	18985	0.0	0.5501711877798262
chr1	ADGRL2	81985258	81985355	0	98	10445	19025	10445	18927	0.0	0.5518571353093464
chr1	ADGRL2	81981123	81981150	0	28	10445	19025	10445	18997	0.0	0.5498236563667948
chr1	ADGRL2	81987259	81987341	0	83	10445	19025	10445	18942	0.0	0.5514201245908563
chr1	ADGRL2	81989656	81989695	0	40	10445	19025	10445	18985	0.0	0.5501711877798262
chr1	ADGRL2	81989656	81989709	0	54	10445	19025	10445	18971	0.0	0.5505771967740235
chr1	ADGRL2	81941192	81942045	0	854	10445	19025	10445	18171	0.0	0.5748170161245941
chr1	ADGRL2	81811842	81811923	0	82	10445	19025	10445	18943	0.0	0.5513910151507153
chr1	ADGRL2	81987288	81987341	0	54	10445	19025	10445	18971	0.0	0.5505771967740235
chr1	ADGRL2	81987868	81987886	0	19	10445	19025	10445	19006	0.0	0.5495632958013259
chr1	LINC01362	82991859	82991980	0	122	2	2150	2	2028	0.0	0.0009861932938856016
chr1	LINC01362	82952671	82952728	0	58	2	2150	2	2092	0.0	0.0009560229445506692
chr1	LINC01362	82952671	82952837	0	167	2	2150	2	1983	0.0	0.0010085728693898135
chr1	PRKACB	84184036	84184135	0	100	0	6412	0	6312	0.0	0.0
chr1	PRKACB	84173328	84173352	0	25	0	6412	0	6387	0.0	0.0
chr1	PRKACB	84175798	84175807	0	10	0	6412	0	6402	0.0	0.0
chr1	PRKACB	84175032	84175056	0	25	0	6412	0	6387	0.0	0.0
chr1	SPATA1	84545633	84545759	365	127	1142	4298	777	4171	2.874015748031496	0.18628626228722128
chr1	SPATA1	84550431	84550530	0	100	1142	4298	1142	4198	0.0	0.2720343020485946
chr1	DNAI3	85073053	85073092	0	40	11552	3947	11552	3907	0.0	2.956744305093422
chr1	DNAI3	85090115	85090232	0	118	11552	3947	11552	3829	0.0	3.0169757116740663
chr1	CLCA3P	86647162	86647222	0	61	103	3453	103	3392	0.0	0.03036556603773585
chr1	SH3GLB1	86715723	86715865	0	143	306	6893	306	6750	0.0	0.04533333333333334
chr1	SH3GLB1	86728402	86728489	0	88	306	6893	306	6805	0.0	0.0449669360764144
chr1	LINC01140	87165388	87165981	561	594	612	6060	51	5466	0.9444444444444444	0.009330406147091108
chr1	LINC01140	87132663	87132863	0	201	612	6060	612	5859	0.0	0.10445468509984639
chr1	LINC01140	87132611	87132912	0	302	612	6060	612	5758	0.0	0.10628690517540813
chr1	LINC02801	87216932	87217000	0	69	16039	4934	16039	4865	0.0	3.296813977389517
chr1	PKN2	88784638	88784824	0	187	0	6701	0	6514	0.0	0.0
chr1	PKN2	88804390	88804534	0	145	0	6701	0	6556	0.0	0.0
chr1	LRRC8B	89588312	89588368	0	57	4158	8278	4158	8221	0.0	0.5057778859019584
chr1	LRRC8B	89526961	89526986	0	26	4158	8278	4158	8252	0.0	0.5038778477944741
chr1	LRRC8B	89572473	89572612	210	140	4158	8278	3948	8138	1.5	0.4851314819365938
chr1	LRRC8D	89929807	89929878	0	72	153	4860	153	4788	0.0	0.03195488721804511
chr1	CDC7	91513947	91514043	0	97	0	3612	0	3515	0.0	0.0
chr1	BRDT	91949889	91949958	0	70	34576	4344	34576	4274	0.0	8.089845577912962
chr1	BRDT	91964626	91964764	0	139	34576	4344	34576	4205	0.0	8.222592152199763
chr1	BRDT	91949637	91949682	0	46	34576	4344	34576	4298	0.0	8.044671940437413
chr1	BRDT	91950715	91950811	0	97	34576	4344	34576	4247	0.0	8.141276194961149
chr1	BRDT	91949899	91950474	0	576	34576	4344	34576	3768	0.0	9.176220806794054
chr1	BRDT	91962717	91962946	0	230	34576	4344	34576	4114	0.0	8.40447253281478
chr1	BRDT	91950107	91950474	0	368	34576	4344	34576	3976	0.0	8.696177062374245
chr1	BRDT	91957528	91957600	0	73	34576	4344	34576	4271	0.0	8.095527979395927
chr1	BRDT	91950304	91950474	0	171	34576	4344	34576	4173	0.0	8.285645818356098
chr1	BTBD8	92141114	92141211	0	98	17361	8361	17361	8263	0.0	2.1010528863608857
chr1	BTBD8	92175062	92175249	0	188	17361	8361	17361	8173	0.0	2.1241894041355684
chr1	C1ORF146	92240705	92240936	0	232	593	1093	593	861	0.0	0.6887340301974448
chr1	RPAP2	92301475	92301590	0	116	157	17061	157	16945	0.0	0.009265269991147832
chr1	RPL5	92833388	92833458	215	71	2276	2191	2061	2120	3.028169014084507	0.9721698113207548
chr1	RPL5	92833795	92833949	309	155	2276	2191	1967	2036	1.9935483870967743	0.9661100196463654
chr1	MTF2	93120548	93120672	384	125	755	5924	371	5799	3.072	0.0639765476806346
chr1	MTF2	93129277	93129448	0	172	755	5924	755	5752	0.0	0.1312586926286509
chr1	MTF2	93127231	93127299	0	69	755	5924	755	5855	0.0	0.12894961571306576
chr1	CCDC18	93183977	93184146	0	170	653	5355	653	5185	0.0	0.12594021215043394
chr1	CCDC18	93210801	93210926	0	126	653	5355	653	5229	0.0	0.12488047427806465
chr1	CCDC18	93217737	93217869	0	133	653	5355	653	5222	0.0	0.1250478743776331
chr1	CCDC18	93236247	93236390	22	144	653	5355	631	5211	0.1527777777777778	0.12109000191901746
chr1	CCDC18	93270346	93270814	0	469	653	5355	653	4886	0.0	0.1336471551371265
chr1	ARHGAP29-AS1	94250378	94250544	0	167	46667	3779	46667	3612	0.0	12.91998892580288
chr1	ARHGAP29-AS1	94257960	94258029	23	70	46667	3779	46644	3709	0.32857142857142857	12.575896468050688
chr1	SLC44A3	94892280	94892517	0	238	186	2888	186	2650	0.0	0.07018867924528302
chr1	SLC44A3	94820948	94821056	0	109	186	2888	186	2779	0.0	0.06693055055775458
chr1	SLC44A3	94825832	94825942	0	111	186	2888	186	2777	0.0	0.06697875405113432
chr1	AC105942.1	94961316	94961433	0	118	0	2318	0	2200	0.0	0.0
chr1	AC105942.1	94939828	94939925	0	98	0	2318	0	2220	0.0	0.0
chr1	AC105942.1	94930801	94930845	0	45	0	2318	0	2273	0.0	0.0
chr1	RWDD3	95244210	95244715	0	506	0	1781	0	1275	0.0	0.0
chr1	LINC02607	95512519	95512622	0	104	1028	6933	1028	6829	0.0	0.15053448528335042
chr1	LINC02790	95996120	95996194	0	75	0	2786	0	2711	0.0	0.0
chr1	LINC02790	96006192	96006421	0	230	0	2786	0	2556	0.0	0.0
chr1	LINC02790	96002100	96002212	0	113	0	2786	0	2673	0.0	0.0
chr1	LINC02790	96006169	96006421	0	253	0	2786	0	2533	0.0	0.0
chr1	LINC02790	96003362	96003444	0	83	0	2786	0	2703	0.0	0.0
chr1	LINC02790	96005756	96005867	0	112	0	2786	0	2674	0.0	0.0
chr1	LINC02790	96006196	96006421	0	226	0	2786	0	2560	0.0	0.0
chr1	LINC02790	96006362	96006421	0	60	0	2786	0	2726	0.0	0.0
chr1	LINC02790	96021297	96021396	0	100	0	2786	0	2686	0.0	0.0
chr1	PTBP2	96806418	96806452	0	35	0	14696	0	14661	0.0	0.0
chr1	PTBP2	96813028	96813106	0	79	0	14696	0	14617	0.0	0.0
chr1	PTBP2	96751424	96751500	0	77	0	14696	0	14619	0.0	0.0
chr1	SNX7	98738236	98738389	0	154	159	2079	159	1925	0.0	0.0825974025974026
chr1	SNX7	98691534	98691699	0	166	159	2079	159	1913	0.0	0.08311552535284893
chr1	SNX7	98662696	98662816	0	121	159	2079	159	1958	0.0	0.08120531154239019
chr1	AL445433.2	99144035	99144130	0	96	1024	5989	1024	5893	0.0	0.1737654844731037
chr1	AL445433.2	99008625	99008735	106	111	1024	5989	918	5878	0.954954954954955	0.15617556992174209
chr1	PLPPR4	99301723	99301897	0	175	0	5547	0	5372	0.0	0.0
chr1	AGL	99852560	99852703	0	144	0	8193	0	8049	0.0	0.0
chr1	SLC35A3	99999260	99999415	0	156	867	15955	867	15799	0.0	0.054876890942464715
chr1	SLC35A3	100007033	100007156	0	124	867	15955	867	15831	0.0	0.05476596551070684
chr1	SLC35A3	99974970	99975069	0	100	867	15955	867	15855	0.0	0.054683065279091767
chr1	SLC35A3	100017681	100017815	0	135	867	15955	867	15820	0.0	0.05480404551201011
chr1	SLC35A3	100015301	100015420	0	120	867	15955	867	15835	0.0	0.05475213135459425
chr1	AC118553.2	100043072	100043229	0	158	0	5784	0	5626	0.0	0.0
chr1	AC118553.2	100069613	100069685	0	73	0	5784	0	5711	0.0	0.0
chr1	SLC35A3	100009287	100009323	0	37	867	15955	867	15918	0.0	0.054466641537881645
chr1	TRMT13	100140181	100140251	0	71	4182	4144	4182	4073	0.0	1.0267616007856617
chr1	RTCA	100267499	100267538	0	40	0	3041	0	3001	0.0	0.0
chr1	CDC14A	100353761	100353852	0	92	16036	6533	16036	6441	0.0	2.489675516224189
chr1	CDC14A	100455404	100455492	0	89	16036	6533	16036	6444	0.0	2.4885164494103043
chr1	CDC14A	100485825	100485901	257	77	16036	6533	15779	6456	3.3376623376623376	2.44408302354399
chr1	CDC14A	100383465	100383640	0	176	16036	6533	16036	6357	0.0	2.522573540978449
chr1	CDC14A	100480949	100481082	5258	134	16036	6533	10778	6399	39.23880597014925	1.6843256758868572
chr1	CDC14A	100504813	100504937	1190	125	16036	6533	14846	6408	9.52	2.3167915106117354
chr1	VCAM1	100729106	100729382	495	277	63554	3110	63059	2833	1.7870036101083033	22.258736321920225
chr1	VCAM1	100731197	100731518	5416	322	63554	3110	58138	2788	16.819875776397517	20.852941176470587
chr1	AC093157.1	101075394	101075716	0	323	0	7130	0	6807	0.0	0.0
chr1	AC093157.1	101072659	101072830	0	172	0	7130	0	6958	0.0	0.0
chr1	AC093157.1	101080886	101080998	0	113	0	7130	0	7017	0.0	0.0
chr1	AC093157.1	101080388	101080613	0	226	0	7130	0	6904	0.0	0.0
chr1	AC093157.1	101083460	101083574	0	115	0	7130	0	7015	0.0	0.0
chr1	AC093157.1	101077362	101077508	0	147	0	7130	0	6983	0.0	0.0
chr1	AC093157.1	101085051	101085157	0	107	0	7130	0	7023	0.0	0.0
chr1	LINC01709	101646253	101646352	0	100	0	2787	0	2687	0.0	0.0
chr1	LINC01709	101733329	101733556	0	228	0	2787	0	2559	0.0	0.0
chr1	LINC01709	101786604	101786716	0	113	0	2787	0	2674	0.0	0.0
chr1	LINC01709	101737223	101737357	0	135	0	2787	0	2652	0.0	0.0
chr1	LINC01709	101729270	101729567	0	298	0	2787	0	2489	0.0	0.0
chr1	LINC01709	101785592	101785729	0	138	0	2787	0	2649	0.0	0.0
chr1	LINC01709	101641782	101641849	0	68	0	2787	0	2719	0.0	0.0
chr1	LINC01709	101784281	101784803	0	523	0	2787	0	2264	0.0	0.0
chr1	LINC01709	101730940	101731053	0	114	0	2787	0	2673	0.0	0.0
chr1	RNPC3	103526066	103526262	0	197	102	5469	102	5272	0.0	0.019347496206373292
chr1	AMY2B	103565434	103565594	0	161	0	4634	0	4473	0.0	0.0
chr1	AMY2B	103577489	103577608	0	120	0	4634	0	4514	0.0	0.0
chr1	AMY2A	103619553	103619784	0	232	0	1909	0	1677	0.0	0.0
chr1	AC092506.1	104092007	104092204	180	198	2169	3126	1989	2928	0.9090909090909091	0.6793032786885246
chr1	AL355306.2	106047625	106047774	0	150	0	8939	0	8789	0.0	0.0
chr1	AL355306.2	106041831	106041911	0	81	0	8939	0	8858	0.0	0.0
chr1	AL355306.2	105961469	105961523	0	55	0	8939	0	8884	0.0	0.0
chr1	AL355306.2	106041831	106042040	0	210	0	8939	0	8729	0.0	0.0
chr1	AL355306.2	106082964	106083086	0	123	0	8939	0	8816	0.0	0.0
chr1	NTNG1	107436664	107436799	0	136	0	9155	0	9019	0.0	0.0
chr1	NTNG1	107418579	107418645	0	67	0	9155	0	9088	0.0	0.0
chr1	NTNG1	107430749	107430917	0	169	0	9155	0	8986	0.0	0.0
chr1	NTNG1	107421083	107421143	0	61	0	9155	0	9094	0.0	0.0
chr1	LINC02785	108052310	108052461	0	152	0	4139	0	3987	0.0	0.0
chr1	NBPF6	108457247	108457334	0	88	51	2602	51	2514	0.0	0.02028639618138425
chr1	PRPF38B	108693589	108693642	0	54	167484	6962	167484	6908	0.0	24.244933410538508
chr1	FNDC7	108737494	108737524	0	31	77061	3103	77061	3072	0.0	25.0849609375
chr1	GPSM2	108885274	108885578	0	305	5867	18055	5867	17750	0.0	0.33053521126760566
chr1	GPSM2	108901789	108901945	110	157	5867	18055	5757	17898	0.7006369426751592	0.321656050955414
chr1	GPSM2	108914337	108914408	510	72	5867	18055	5357	17983	7.083333333333333	0.2978924539843185
chr1	GPSM2	108918612	108918789	705	178	5867	18055	5162	17877	3.960674157303371	0.288750908989204
chr1	GPSM2	108922416	108922576	0	161	5867	18055	5867	17894	0.0	0.3278752654521069
chr1	GPSM2	108923999	108924214	0	216	5867	18055	5867	17839	0.0	0.32888614832669993
chr1	GPSM2	108882475	108882625	0	151	5867	18055	5867	17904	0.0	0.32769213583556744
chr1	GPSM2	108885506	108885578	0	73	5867	18055	5867	17982	0.0	0.32627071515960404
chr1	GPSM2	108882579	108882625	0	47	5867	18055	5867	18008	0.0	0.3257996446023989
chr1	GPSM2	108918612	108919150	2203	539	5867	18055	3664	17516	4.087198515769944	0.2091801781228591
chr1	GPSM2	108886078	108886172	0	95	5867	18055	5867	17960	0.0	0.32667037861915366
chr1	GPSM2	108877530	108877774	0	245	5867	18055	5867	17810	0.0	0.32942167321729365
chr1	ELAPOR1	109161893	109162014	918	122	178014	9175	177096	9053	7.524590163934426	19.56213409919364
chr1	ELAPOR1	109173687	109173837	0	151	178014	9175	178014	9024	0.0	19.726728723404257
chr1	ELAPOR1	109185044	109185133	0	90	178014	9175	178014	9085	0.0	19.594276279581727
chr1	ELAPOR1	109201318	109201417	0	100	178014	9175	178014	9075	0.0	19.61586776859504
chr1	SARS1	109236804	109236870	629	67	26785	3445	26156	3378	9.388059701492537	7.743043220840734
chr1	ATXN7L2	109485331	109485509	2215	179	145856	4493	143641	4314	12.374301675977653	33.2964765878535
chr1	CYB561D1	109495142	109495180	0	39	76138	5618	76138	5579	0.0	13.647248610862162
chr1	CYB561D1	109494519	109494623	0	105	76138	5618	76138	5513	0.0	13.810629421367677
chr1	AMPD2	109625302	109625433	0	132	70772	8217	70772	8085	0.0	8.753494124922696
chr1	AMPD2	109628642	109628806	0	165	70772	8217	70772	8052	0.0	8.78936910084451
chr1	AMPD2	109629799	109629916	153	118	70772	8217	70619	8099	1.2966101694915255	8.71947153969626
chr1	AMPD2	109620913	109621266	51	354	70772	8217	70721	7863	0.1440677966101695	8.994149815592014
chr1	AMPD2	109629795	109629916	153	122	70772	8217	70619	8095	1.2540983606557377	8.72378011117974
chr1	AMPD2	109630682	109630793	414	112	70772	8217	70358	8105	3.6964285714285716	8.680814312152991
chr1	AMPD2	109623978	109624089	0	112	70772	8217	70772	8105	0.0	8.731893892658853
chr1	AMPD2	109622184	109622353	0	170	70772	8217	70772	8047	0.0	8.794830371567043
chr1	GSTM4	109657589	109657671	75	83	2041	3643	1966	3560	0.9036144578313253	0.552247191011236
chr1	GSTM4	109657532	109657671	178	140	2041	3643	1863	3503	1.2714285714285714	0.5318298601198972
chr1	GSTM2	109671472	109671583	765	112	1713	5816	948	5704	6.830357142857143	0.1661991584852735
chr1	GSTM4	109659789	109659959	664	171	2041	3643	1377	3472	3.8830409356725144	0.39660138248847926
chr1	GSTM1	109689047	109689129	0	83	510	2094	510	2011	0.0	0.2536051715564396
chr1	GSTM1	109688169	109688245	51	77	510	2094	459	2017	0.6623376623376623	0.22756569162121965
chr1	GSTM1	109690453	109690564	0	112	510	2094	510	1982	0.0	0.25731584258324924
chr1	GSTM1	109688990	109689129	0	140	510	2094	510	1954	0.0	0.2610030706243603
chr1	GSTM1	109690270	109690366	0	97	510	2094	510	1997	0.0	0.2553830746119179
chr1	GSTM1	109688116	109688245	51	130	510	2094	459	1964	0.3923076923076923	0.23370672097759673
chr1	GSTM5	109716001	109716090	0	90	1537	3359	1537	3269	0.0	0.4701743652493117
chr1	CSF1	109910812	109911062	51	251	102	5251	51	5000	0.20318725099601595	0.0102
chr1	CSF1	109914258	109914381	0	124	102	5251	102	5127	0.0	0.01989467524868344
chr1	CSF1	109923165	109923711	0	547	102	5251	102	4704	0.0	0.021683673469387755
chr1	STRIP1	110039823	110039937	5835	115	119310	6781	113475	6666	50.73913043478261	17.022952295229523
chr1	KCNC4	110232220	110232597	510	378	174575	22579	174065	22201	1.3492063492063493	7.840412594027296
chr1	RBM15	110345538	110345649	0	112	873	3757	873	3645	0.0	0.23950617283950618
chr1	LAMTOR5-AS1	110414151	110414231	46	81	1596	11148	1550	11067	0.5679012345679012	0.1400560224089636
chr1	LAMTOR5-AS1	110417488	110417640	0	153	1596	11148	1596	10995	0.0	0.1451568894952251
chr1	LAMTOR5-AS1	110413320	110413410	0	91	1596	11148	1596	11057	0.0	0.14434295016731483
chr1	LAMTOR5-AS1	110430108	110431361	0	1254	1596	11148	1596	9894	0.0	0.16130988477865374
chr1	LAMTOR5-AS1	110409084	110409158	0	75	1596	11148	1596	11073	0.0	0.14413438092657815
chr1	LAMTOR5-AS1	110408921	110409158	0	238	1596	11148	1596	10910	0.0	0.1462878093492209
chr1	LAMTOR5-AS1	110411444	110411521	0	78	1596	11148	1596	11070	0.0	0.14417344173441735
chr1	LAMTOR5-AS1	110413038	110413094	0	57	1596	11148	1596	11091	0.0	0.14390045983229646
chr1	LAMTOR5-AS1	110416008	110416188	51	181	1596	11148	1545	10967	0.281767955801105	0.14087717698550195
chr1	LAMTOR5-AS1	110417818	110417916	0	99	1596	11148	1596	11049	0.0	0.14444746130871572
chr1	LAMTOR5-AS1	110417793	110417916	0	124	1596	11148	1596	11024	0.0	0.14477503628447025
chr1	LAMTOR5-AS1	110421634	110421716	0	83	1596	11148	1596	11065	0.0	0.14423859014911886
chr1	LAMTOR5-AS1	110431276	110431361	0	86	1596	11148	1596	11062	0.0	0.14427770746700416
chr1	AL358215.3	110484475	110484621	0	147	0	1194	0	1047	0.0	0.0
chr1	CYMP	110489426	110489571	0	146	0	1272	0	1126	0.0	0.0
chr1	CHI3L2	111229851	111229881	0	31	0	3296	0	3265	0.0	0.0
chr1	CHI3L2	111231237	111231294	0	58	0	3296	0	3238	0.0	0.0
chr1	CHI3L2	111238749	111238932	0	184	0	3296	0	3112	0.0	0.0
chr1	CHI3L2	111242226	111242366	0	141	0	3296	0	3155	0.0	0.0
chr1	CHIAP2	111280523	111280553	0	31	0	2199	0	2168	0.0	0.0
chr1	CHIAP2	111284064	111284249	0	186	0	2199	0	2013	0.0	0.0
chr1	CHIA	111312189	111312391	0	203	0	3684	0	3481	0.0	0.0
chr1	CHIA	111315269	111315435	0	167	0	3684	0	3517	0.0	0.0
chr1	CHIA	111315733	111315872	0	140	0	3684	0	3544	0.0	0.0
chr1	PIFO	111347673	111347772	0	100	51	3954	51	3854	0.0	0.013233004670472236
chr1	ATP5PB	111454210	111454356	0	147	204	3146	204	2999	0.0	0.06802267422474158
chr1	ATP5PB	111449836	111449873	0	38	204	3146	204	3108	0.0	0.06563706563706563
chr1	RAP1A	111627469	111627563	0	95	45483	5543	45483	5448	0.0	8.348568281938325
chr1	INKA2-AS1	111744374	111744529	0	156	408	2417	408	2261	0.0	0.18045112781954886
chr1	DDX20	111759399	111759568	0	170	0	4387	0	4217	0.0	0.0
chr1	WNT2B	112491010	112491081	0	72	102	12381	102	12309	0.0	0.008286619546673165
chr1	LINC01357	112876939	112876984	0	46	0	797	0	751	0.0	0.0
chr1	SLC16A1-AS1	113033674	113033838	341	165	73700	12689	73359	12524	2.066666666666667	5.857473650590865
chr1	MAGI3	113618531	113618606	0	76	10843	8438	10843	8362	0.0	1.2966993542214782
chr1	MAGI3	113682211	113682302	0	92	10843	8438	10843	8346	0.0	1.2991852384375748
chr1	DCLRE1B	113906995	113907161	0	167	68	3872	68	3705	0.0	0.01835357624831309
chr1	DCLRE1B	113908008	113908191	0	184	68	3872	68	3688	0.0	0.01843817787418655
chr1	HIPK1	113963386	113963521	102	136	1453	9171	1351	9035	0.75	0.14952960708356391
chr1	OLFML3	113979974	113980126	0	153	153	2495	153	2342	0.0	0.06532877882152006
chr1	SYCP1	114913974	114914045	0	72	266	4313	266	4241	0.0	0.06272105635463335
chr1	SYCP1	114947245	114947320	0	76	266	4313	266	4237	0.0	0.06278026905829596
chr1	SYCP1	114984724	114984868	0	145	266	4313	266	4168	0.0	0.06381957773512476
chr1	TTF2	117097350	117097433	0	84	18964	9739	18964	9655	0.0	1.964163645779389
chr1	WARS2-AS1	119146952	119147069	0	118	255	8221	255	8103	0.0	0.031469825990373936
chr1	WARS2-AS1	119141746	119141813	0	68	255	8221	255	8153	0.0	0.03127683061449773
chr1	HAO2	119380503	119380723	0	221	0	1886	0	1665	0.0	0.0
chr1	PHGDH	119723375	119723441	875	67	19639	6218	18764	6151	13.059701492537313	3.0505608844090393
chr1	PHGDH	119741766	119741897	0	132	19639	6218	19639	6086	0.0	3.2269142293789024
chr1	PHGDH	119741766	119741876	0	111	19639	6218	19639	6107	0.0	3.2158179138693304
chr1	PHGDH	119724318	119724469	4073	152	19639	6218	15566	6066	26.79605263157895	2.5661061655126938
chr1	PHGDH	119740385	119740518	0	134	19639	6218	19639	6084	0.0	3.227975016436555
chr1	PHGDH	119742806	119743044	0	239	19639	6218	19639	5979	0.0	3.2846629871215924
chr1	PHGDH	119729508	119729633	714	126	19639	6218	18925	6092	5.666666666666667	3.1065331582403153
chr1	PHGDH	119724784	119724875	2517	92	19639	6218	17122	6126	27.358695652173914	2.794972249428665
chr1	PHGDH	119724784	119724957	4587	174	19639	6218	15052	6044	26.362068965517242	2.4904037061548645
chr1	PHGDH	119724784	119724967	4736	184	19639	6218	14903	6034	25.73913043478261	2.4698375870069604
chr1	NBPF26	120805555	120805765	0	211	41854	6817	41854	6606	0.0	6.335755373902513
chr1	NBPF26	120807606	120807709	102	104	41854	6817	41752	6713	0.9807692307692307	6.21957396097125
chr1	NBPF26	120822103	120822267	0	165	41854	6817	41854	6652	0.0	6.291942273000601
chr1	NBPF26	120822103	120822156	0	54	41854	6817	41854	6763	0.0	6.188673665533048
chr1	LINC00623	121008410	121008499	0	90	0	2606	0	2516	0.0	0.0
chr1	FCGR1B	121094673	121094958	0	286	1167	4239	1167	3953	0.0	0.2952188211484948
chr1	LINC02798	121427981	121428064	0	84	0	4744	0	4660	0.0	0.0
chr1	LINC02798	121397620	121397787	0	168	0	4744	0	4576	0.0	0.0
chr1	EMBP1	121538322	121538420	0	99	0	5755	0	5656	0.0	0.0
chr1	GPR89A	145616233	145616293	0	61	87735	4656	87735	4595	0.0	19.093579978237216
chr1	GPR89A	145630686	145630807	0	122	87735	4656	87735	4534	0.0	19.350463167181296
chr1	GPR89A	145608347	145608675	62718	329	87735	4656	25017	4327	190.6322188449848	5.781603882597643
chr1	GPR89A	145612201	145612247	0	47	87735	4656	87735	4609	0.0	19.035582555868952
chr1	CD160	145730743	145731070	0	328	181	1793	181	1465	0.0	0.12354948805460751
chr1	NUDT17	145846012	145846196	0	185	0	1664	0	1479	0.0	0.0
chr1	LIX1L-AS1	145932083	145932159	0	77	2255	3264	2255	3187	0.0	0.7075619705051773
chr1	LIX1L-AS1	145936390	145936588	51	199	2255	3264	2204	3065	0.2562814070351759	0.7190864600326264
chr1	LIX1L-AS1	145934252	145934390	182	139	2255	3264	2073	3125	1.3093525179856116	0.66336
chr1	LIX1L-AS1	145947096	145947361	0	266	2255	3264	2255	2998	0.0	0.7521681120747165
chr1	LIX1L-AS1	145947096	145947145	0	50	2255	3264	2255	3214	0.0	0.7016179215930305
chr1	LIX1L-AS1	145958360	145958438	0	79	2255	3264	2255	3185	0.0	0.7080062794348508
chr1	POLR3GL	145977083	145977152	0	70	0	1316	0	1246	0.0	0.0
chr1	POLR3GL	145975306	145975436	0	131	0	1316	0	1185	0.0	0.0
chr1	LINC01719	146058557	146059662	10459	1106	19342	2631	8883	1525	9.456600361663654	5.8249180327868855
chr1	LINC01719	146057693	146057988	1763	296	19342	2631	17579	2335	5.956081081081081	7.528479657387581
chr1	LINC01719	146058312	146058461	652	150	19342	2631	18690	2481	4.346666666666667	7.5332527206771465
chr1	NBPF12	146951813	146952037	0	225	0	7308	0	7083	0.0	0.0
chr1	NBPF12	146982927	146983091	0	165	0	7308	0	7143	0.0	0.0
chr1	CHD1L	147264428	147264584	0	157	51	4200	51	4043	0.0	0.0126143952510512
chr1	CHD1L	147268781	147268878	0	98	51	4200	51	4102	0.0	0.012432959531935642
chr1	CHD1L	147272170	147272281	0	112	51	4200	51	4088	0.0	0.012475538160469667
chr1	CHD1L	147280025	147280191	0	167	51	4200	51	4033	0.0	0.012645673196131912
chr1	CHD1L	147254869	147254976	0	108	51	4200	51	4092	0.0	0.012463343108504398
chr1	CHD1L	147256530	147256562	0	33	51	4200	51	4167	0.0	0.012239020878329733
chr1	CHD1L	147259836	147259918	0	83	51	4200	51	4117	0.0	0.01238766091814428
chr1	CHD1L	147264421	147264584	0	164	51	4200	51	4036	0.0	0.01263627353815659
chr1	CHD1L	147270931	147271005	0	75	51	4200	51	4125	0.0	0.012363636363636363
chr1	CHD1L	147252622	147252735	0	114	51	4200	51	4086	0.0	0.012481644640234948
chr1	CHD1L	147256530	147256570	0	41	51	4200	51	4159	0.0	0.012262563116133687
chr1	CHD1L	147270931	147271113	0	183	51	4200	51	4017	0.0	0.012696041822255415
chr1	CHD1L	147270931	147271195	0	265	51	4200	51	3935	0.0	0.012960609911054638
chr1	CHD1L	147254897	147254976	0	80	51	4200	51	4120	0.0	0.01237864077669903
chr1	CHD1L	147272446	147272630	0	185	51	4200	51	4015	0.0	0.012702366127023662
chr1	CHD1L	147272170	147272630	0	461	51	4200	51	3739	0.0	0.013640010698047607
chr1	CHD1L	147284350	147284499	0	150	51	4200	51	4050	0.0	0.012592592592592593
chr1	GPR89B	147936626	147936686	0	61	918	5227	918	5166	0.0	0.17770034843205576
chr1	GPR89B	147968331	147968428	0	98	918	5227	918	5129	0.0	0.17898225775004875
chr1	LINC02805	148163791	148163866	0	76	32	5857	32	5781	0.0	0.005535374502681197
chr1	LINC02805	148163756	148163815	0	60	32	5857	32	5797	0.0	0.005520096601690529
chr1	LINC02805	148163756	148163866	0	111	32	5857	32	5746	0.0	0.005569091541942221
chr1	LINC02805	148163791	148163815	0	25	32	5857	32	5832	0.0	0.0054869684499314125
chr1	LINC02805	148174249	148174515	0	267	32	5857	32	5590	0.0	0.005724508050089445
chr1	AC245100.4	148424062	148424189	0	128	0	3322	0	3194	0.0	0.0
chr1	AC245100.4	148424626	148424638	0	13	0	3322	0	3309	0.0	0.0
chr1	AC245100.4	148417662	148417765	0	104	0	3322	0	3218	0.0	0.0
chr1	AC245100.4	148424626	148424678	0	53	0	3322	0	3269	0.0	0.0
chr1	AC245100.4	148420819	148420937	0	119	0	3322	0	3203	0.0	0.0
chr1	PDE4DIP	148929196	148929273	0	78	2142	23819	2142	23741	0.0	0.09022366370414052
chr1	PDE4DIP	149024444	149024684	0	241	2142	23819	2142	23578	0.0	0.09084740011875476
chr1	PDE4DIP	149030231	149030278	0	48	2142	23819	2142	23771	0.0	0.09010979765260191
chr1	PDE4DIP	149010442	149010595	0	154	2142	23819	2142	23665	0.0	0.09051341643777731
chr1	PDE4DIP	149012590	149012776	0	187	2142	23819	2142	23632	0.0	0.09063981042654029
chr1	PDE4DIP	148889783	148889894	0	112	2142	23819	2142	23707	0.0	0.09035306027755516
chr1	PDE4DIP	149047638	149047788	0	151	2142	23819	2142	23668	0.0	0.09050194355247591
chr1	AC245297.3	149177157	149177212	0	56	0	4300	0	4244	0.0	0.0
chr1	AC245297.3	149190635	149190795	0	161	0	4300	0	4139	0.0	0.0
chr1	NBPF19	149486129	149486293	0	165	0	13847	0	13682	0.0	0.0
chr1	LINC00869	149661301	149661419	0	119	21464	10886	21464	10767	0.0	1.9934986532924677
chr1	LINC00869	149664520	149664646	0	127	21464	10886	21464	10759	0.0	1.9949809461845895
chr1	LINC00869	149665804	149666124	258	321	21464	10886	21206	10565	0.8037383177570093	2.007193563653573
chr1	LINC00869	149658151	149658254	0	104	21464	10886	21464	10782	0.0	1.9907252828788722
chr1	LINC00869	149665956	149666124	75	169	21464	10886	21389	10717	0.4437869822485207	1.9958010637305217
chr1	VPS45	150142837	150142931	0	95	17797	5991	17797	5896	0.0	3.0184871099050206
chr1	VPS45	150098849	150099080	610	232	17797	5991	17187	5759	2.6293103448275863	2.984372286855357
chr1	PLEKHO1	150157384	150157486	0	103	4665	6559	4665	6456	0.0	0.7225836431226765
chr1	CA14	150263793	150263878	0	86	4807	3005	4807	2919	0.0	1.6467968482356972
chr1	CA14	150260282	150260387	49	106	4807	3005	4758	2899	0.46226415094339623	1.641255605381166
chr1	C1ORF54	150279642	150279741	78	100	9655	1278	9577	1178	0.78	8.12988115449915
chr1	CIART	150283804	150283880	48	77	901	2702	853	2625	0.6233766233766234	0.32495238095238094
chr1	RPRD2	150441880	150441958	0	79	141940	8751	141940	8672	0.0	16.36761992619926
chr1	TARS2	150504631	150504733	0	103	2065	4095	2065	3992	0.0	0.5172845691382766
chr1	TARS2	150490600	150490725	765	126	2065	4095	1300	3969	6.071428571428571	0.327538422776518
chr1	TARS2	150491597	150491662	0	66	2065	4095	2065	4029	0.0	0.5125341275750807
chr1	TARS2	150497529	150497747	51	219	2065	4095	2014	3876	0.2328767123287671	0.5196078431372549
chr1	TARS2	150492410	150492489	0	80	2065	4095	2065	4015	0.0	0.5143212951432129
chr1	ECM1	150511456	150511831	0	376	153	2947	153	2571	0.0	0.059509918319719954
chr1	ADAMTSL4	150554565	150554634	0	70	954956	6453	954956	6383	0.0	149.6092746357512
chr1	SETDB1	150939939	150939974	26434	36	85120	7114	58686	7078	734.2777777777778	8.2913252331167
chr1	SETDB1	150942851	150943053	128	203	85120	7114	84992	6911	0.6305418719211823	12.298075531760961
chr1	ANXA9	150983089	150983180	0	92	1254	1608	1254	1516	0.0	0.8271767810026385
chr1	PRUNE1	151018556	151018669	98	114	149725	3165	149627	3051	0.8596491228070176	49.04195345788266
chr1	PRUNE1	151018466	151018669	455	204	149725	3165	149270	2961	2.230392156862745	50.412022965214454
chr1	PRUNE1	151028785	151028944	1342	160	149725	3165	148383	3005	8.3875	49.37870216306156
chr1	PRUNE1	151031371	151031464	602	94	149725	3165	149123	3071	6.404255319148936	48.55845001628134
chr1	PRUNE1	151024610	151024795	76044	186	149725	3165	73681	2979	408.83870967741933	24.73346760657939
chr1	PRUNE1	151017811	151017904	0	94	149725	3165	149725	3071	0.0	48.7544773689352
chr1	PRUNE1	151025514	151025673	63861	160	149725	3165	85864	3005	399.13125	28.57371048252912
chr1	BNIPL	151044879	151045033	0	155	7618	3554	7618	3399	0.0	2.241247425713445
chr1	GABPB2	151103561	151103675	0	115	28268	9200	28268	9085	0.0	3.1115024766097963
chr1	GABPB2	151117391	151117516	255	126	28268	9200	28013	9074	2.0238095238095237	3.087172140180736
chr1	GABPB2	151090405	151090573	8917	169	28268	9200	19351	9031	52.76331360946745	2.142730594618536
chr1	PIP5K1A	151238181	151238265	813	85	124237	5373	123424	5288	9.564705882352941	23.340393343419063
chr1	PIP5K1A	151242122	151242269	0	148	124237	5373	124237	5225	0.0	23.777416267942584
chr1	PIP5K1A	151224370	151224406	370	37	124237	5373	123867	5336	10.0	23.213455772113942
chr1	PSMD4	151265393	151265609	42824	217	256556	2624	213732	2407	197.34562211981566	88.79601163273784
chr1	PSMD4	151266939	151266978	9377	40	256556	2624	247179	2584	234.425	95.65750773993808
chr1	ZNF687	151285205	151286074	1741	870	192982	6334	191241	5464	2.0011494252873563	35.00018301610542
chr1	CGN	151515494	151515616	892	123	127789	6639	126897	6516	7.252032520325203	19.474677716390424
chr1	TUFT1	151564524	151564614	357	91	2162	3434	1805	3343	3.923076923076923	0.539934190846545
chr1	TUFT1	151562090	151562165	0	76	2162	3434	2162	3358	0.0	0.6438356164383562
chr1	SNX27	151638887	151639119	0	233	200518	16235	200518	16002	0.0	12.530808648918885
chr1	RIIAD1	151727574	151727621	0	48	24	2288	24	2240	0.0	0.010714285714285714
chr1	OAZ3	151768057	151768233	0	177	32072	4640	32072	4463	0.0	7.186197624915976
chr1	OAZ3	151770171	151770257	374	87	32072	4640	31698	4553	4.2988505747126435	6.962003074895673
chr1	OAZ3	151768144	151768233	0	90	32072	4640	32072	4550	0.0	7.048791208791209
chr1	FLG-AS1	152251652	152251758	0	107	3230	12348	3230	12241	0.0	0.2638673311004003
chr1	SPRR3	153002602	153002686	0	85	0	1445	0	1360	0.0	0.0
chr1	S100A1	153628781	153628867	0	87	92327	1071	92327	984	0.0	93.82825203252033
chr1	CHTOP	153643226	153643364	0	139	990345	4833	990345	4694	0.0	210.98103962505326
chr1	CHTOP	153642245	153642429	84804	185	990345	4833	905541	4648	458.4	194.8237951807229
chr1	SNAPIN	153659137	153659184	0	48	0	1519	0	1471	0.0	0.0
chr1	INTS3	153761019	153761109	0	91	14048	9073	14048	8982	0.0	1.5640169227343577
chr1	SLC27A3	153777760	153777885	2819	126	169851	3384	167032	3258	22.373015873015873	51.268262737876
chr1	RPS27	153990913	153991034	0	122	672	689	672	567	0.0	1.1851851851851851
chr1	UBAP2L	154269361	154269412	0	52	175259	6628	175259	6576	0.0	26.65130778588808
chr1	HAX1	154273479	154273598	0	120	51	1613	51	1493	0.0	0.03415941058271936
chr1	HAX1	154273335	154273534	0	200	51	1613	51	1413	0.0	0.036093418259023353
chr1	HAX1	154273335	154273598	0	264	51	1613	51	1349	0.0	0.03780578206078577
chr1	AQP10	154321932	154322059	26763	128	97881	2297	71118	2169	209.0859375	32.788381742738586
chr1	IL6R	154435968	154436110	323	143	323	6465	0	6322	2.2587412587412588	0.0
chr1	IL6R	154454487	154454581	0	95	323	6465	323	6370	0.0	0.05070643642072214
chr1	IL6R	154445046	154445094	0	49	323	6465	323	6416	0.0	0.0503428927680798
chr1	TDRD10	154542730	154542821	35	92	14018	2719	13983	2627	0.3804347826086957	5.322801674914351
chr1	TDRD10	154544371	154544517	69	147	14018	2719	13949	2572	0.46938775510204084	5.423405909797823
chr1	CHRNB2	154577005	154577253	0	249	93980	4878	93980	4629	0.0	20.30244113199395
chr1	FLAD1	154989559	154989707	216	149	174719	3992	174503	3843	1.4496644295302012	45.408014571948996
chr1	FLAD1	154990338	154990528	13026	191	174719	3992	161693	3801	68.19895287958116	42.53959484346225
chr1	FLAD1	154983841	154984066	1993	226	174719	3992	172726	3766	8.81858407079646	45.864577801380776
chr1	DCST1	155034652	155034727	4892	76	85724	3211	80832	3135	64.36842105263158	25.78373205741627
chr1	DCST1	155047786	155047929	0	144	85724	3211	85724	3067	0.0	27.950440169546788
chr1	ADAM15	155053416	155053493	0	78	3893	4801	3893	4723	0.0	0.8242642388312513
chr1	ADAM15	155055789	155055852	126	64	3893	4801	3767	4737	1.96875	0.7952290479206249
chr1	ADAM15	155060762	155060832	0	71	3893	4801	3893	4730	0.0	0.8230443974630021
chr1	ADAM15	155061417	155061489	0	73	3893	4801	3893	4728	0.0	0.8233925549915397
chr1	ADAM15	155061903	155061975	0	73	3893	4801	3893	4728	0.0	0.8233925549915397
chr1	ADAM15	155061414	155061489	0	76	3893	4801	3893	4725	0.0	0.8239153439153439
chr1	ADAM15	155061903	155062117	0	215	3893	4801	3893	4586	0.0	0.8488879197557785
chr1	ADAM15	155052530	155052559	0	30	3893	4801	3893	4771	0.0	0.8159714944456089
chr1	EFNA3	155086127	155086205	0	79	0	1950	0	1871	0.0	0.0
chr1	EFNA1	155133502	155133568	0	67	51	2170	51	2103	0.0	0.024251069900142655
chr1	SLC50A1	155137560	155137722	0	163	0	1885	0	1722	0.0	0.0
chr1	SLC50A1	155137578	155137722	0	145	0	1885	0	1740	0.0	0.0
chr1	SLC50A1	155136827	155136951	0	125	0	1885	0	1760	0.0	0.0
chr1	TRIM46	155174600	155174641	1498	42	455013	4548	453515	4506	35.666666666666664	100.64691522414559
chr1	TRIM46	155175385	155175647	4826	263	455013	4548	450187	4285	18.34980988593156	105.06114352392065
chr1	TRIM46	155178808	155178846	277	39	455013	4548	454736	4509	7.102564102564102	100.85074295852739
chr1	THBS3-AS1	155203122	155203271	18826	150	128720	2476	109894	2326	125.50666666666666	47.24591573516767
chr1	MTX1	155212126	155212219	48	94	25217	2569	25169	2475	0.5106382978723404	10.16929292929293
chr1	HCN3	155283973	155284135	856	163	681385	3866	680529	3703	5.251533742331288	183.7777477720767
chr1	HCN3	155285723	155285964	2500	242	681385	3866	678885	3624	10.330578512396695	187.33029801324503
chr1	FDPS	155310063	155310205	51	143	6119	3010	6068	2867	0.35664335664335667	2.1164980816184165
chr1	FDPS	155310042	155310205	51	164	6119	3010	6068	2846	0.31097560975609756	2.1321152494729443
chr1	FDPS	155310335	155310453	0	119	6119	3010	6119	2891	0.0	2.1165686613628503
chr1	FDPS	155309788	155309965	110	178	6119	3010	6009	2832	0.6179775280898876	2.121822033898305
chr1	FDPS	155309752	155309965	182	214	6119	3010	5937	2796	0.8504672897196262	2.1233905579399144
chr1	MSTO1	155611215	155611291	312	77	7524	4041	7212	3964	4.0519480519480515	1.8193743693239153
chr1	DAP3	155729041	155729122	0	82	54517	4354	54517	4272	0.0	12.761470037453183
chr1	DAP3	155731943	155732033	1380	91	54517	4354	53137	4263	15.164835164835164	12.464696223316913
chr1	DAP3	155736945	155737063	357	119	54517	4354	54160	4235	3.0	12.788665879574971
chr1	DAP3	155709032	155709125	51	94	54517	4354	54466	4260	0.5425531914893617	12.785446009389672
chr1	DAP3	155717005	155717128	13498	124	54517	4354	41019	4230	108.85483870967742	9.697163120567376
chr1	DAP3	155721516	155721618	3072	103	54517	4354	51445	4251	29.825242718446603	12.101858386262055
chr1	DAP3	155725381	155725411	277	31	54517	4354	54240	4323	8.935483870967742	12.546842470506594
chr1	DAP3	155736607	155736694	0	88	54517	4354	54517	4266	0.0	12.779418659165495
chr1	DAP3	155737005	155737063	273	59	54517	4354	54244	4295	4.627118644067797	12.629569266589057
chr1	AL355388.2	156030732	156030861	0	130	31401	2372	31401	2242	0.0	14.005798394290812
chr1	LAMTOR2	156057977	156058067	2030	91	10396	1339	8366	1248	22.307692307692307	6.703525641025641
chr1	RAB25	156065910	156066106	4244	197	21276	1694	17032	1497	21.543147208121827	11.37742150968604
chr1	LMNA	156130616	156130773	190	158	328592	7357	328402	7199	1.2025316455696202	45.61772468398389
chr1	LMNA	156137653	156137743	0	91	328592	7357	328592	7266	0.0	45.22323148912744
chr1	LMNA	156126735	156126915	51	181	328592	7357	328541	7176	0.281767955801105	45.78330546265329
chr1	LMNA	156126735	156126949	51	215	328592	7357	328541	7142	0.2372093023255814	46.00126015121815
chr1	LMNA	156129826	156129908	0	83	328592	7357	328592	7274	0.0	45.17349463843827
chr1	SEMA4A	156158387	156158486	0	100	24830	6084	24830	5984	0.0	4.149398395721925
chr1	SEMA4A	156153330	156153476	52	147	24830	6084	24778	5937	0.35374149659863946	4.173488293751053
chr1	SEMA4A	156154549	156154717	0	169	24830	6084	24830	5915	0.0	4.197802197802198
chr1	SLC25A44	156207861	156208013	1984	153	6812	3772	4828	3619	12.967320261437909	1.3340701851340149
chr1	SLC25A44	156207885	156208013	1834	129	6812	3772	4978	3643	14.217054263565892	1.366456217403239
chr1	PMF1	156232319	156232425	0	107	148704	2529	148704	2422	0.0	61.39719240297275
chr1	PMF1	156236287	156236483	86670	197	148704	2529	62034	2332	439.9492385786802	26.601200686106345
chr1	PMF1	156225556	156225668	125	113	148704	2529	148579	2416	1.1061946902654867	61.49793046357616
chr1	PMF1	156233627	156233728	0	102	148704	2529	148704	2427	0.0	61.27070457354759
chr1	PMF1	156236348	156236483	80106	136	148704	2529	68598	2393	589.0147058823529	28.666109486000835
chr1	TMEM79	156285524	156285983	11940	460	29172	3037	17232	2577	25.956521739130434	6.686845168800931
chr1	RHBG	156381805	156381943	0	139	0	3394	0	3255	0.0	0.0
chr1	RHBG	156374606	156374729	0	124	0	3394	0	3270	0.0	0.0
chr1	RHBG	156371181	156371254	0	74	0	3394	0	3320	0.0	0.0
chr1	TTC24	156583041	156583170	0	130	0	2644	0	2514	0.0	0.0
chr1	TTC24	156583799	156583895	0	97	0	2644	0	2547	0.0	0.0
chr1	BCAN	156647507	156647682	0	176	0	4571	0	4395	0.0	0.0
chr1	BCAN	156647345	156647394	0	50	0	4571	0	4521	0.0	0.0
chr1	RRNAD1	156731990	156732115	94	126	1224	2891	1130	2765	0.746031746031746	0.40867992766726946
chr1	RRNAD1	156732984	156733047	0	64	1224	2891	1224	2827	0.0	0.432967810399717
chr1	RRNAD1	156734008	156734493	51	486	1224	2891	1173	2405	0.10493827160493827	0.48773388773388776
chr1	RRNAD1	156734008	156734052	0	45	1224	2891	1224	2846	0.0	0.43007730147575546
chr1	PRCC	156791696	156791792	0	97	2856	4062	2856	3965	0.0	0.7203026481715006
chr1	PRCC	156791066	156791162	0	97	2856	4062	2856	3965	0.0	0.7203026481715006
chr1	NTRK1	156871622	156871755	0	134	2905	4584	2905	4450	0.0	0.6528089887640449
chr1	NTRK1	156837725	156837865	0	141	2905	4584	2905	4443	0.0	0.6538374971865857
chr1	NTRK1	156874382	156874400	0	19	2905	4584	2905	4565	0.0	0.6363636363636364
chr1	NTRK1	156880448	156880539	390	92	2905	4584	2515	4492	4.239130434782608	0.5598842386464826
chr1	PEAR1	156904943	156904998	2739	56	137099	5554	134360	5498	48.910714285714285	24.437977446344124
chr1	PEAR1	156902187	156902285	0	99	137099	5554	137099	5455	0.0	25.132722273143905
chr1	LINC02772	157280718	157280853	0	136	0	1651	0	1515	0.0	0.0
chr1	CD1D	158182877	158183156	0	280	459	4291	459	4011	0.0	0.11443530291697832
chr1	CD1C	158293211	158293302	0	92	0	2448	0	2356	0.0	0.0
chr1	CD1E	158355299	158355569	0	271	23	2210	23	1939	0.0	0.01186178442496132
chr1	CD1E	158354376	158354673	0	298	23	2210	23	1912	0.0	0.01202928870292887
chr1	PYHIN1	158973646	158973771	0	126	0	3495	0	3369	0.0	0.0
chr1	IFI16	159016532	159016700	0	169	306	5088	306	4919	0.0	0.06220776580605814
chr1	IFI16	159045296	159045464	0	169	306	5088	306	4919	0.0	0.06220776580605814
chr1	IFI16	159049431	159049599	0	169	306	5088	306	4919	0.0	0.06220776580605814
chr1	IFI16	159016617	159016700	0	84	306	5088	306	5004	0.0	0.06115107913669065
chr1	CADM3	159189770	159189872	0	103	51	3857	51	3754	0.0	0.013585508790623336
chr1	FCRL6	159802419	159802455	0	37	1731	2371	1731	2334	0.0	0.7416452442159382
chr1	FCRL6	159808960	159809245	48	286	1731	2371	1683	2085	0.16783216783216784	0.8071942446043165
chr1	FCRL6	159815427	159815459	0	33	1731	2371	1731	2338	0.0	0.7403763900769889
chr1	SLAMF8	159829865	159830192	51	328	2416	1906	2365	1578	0.15548780487804878	1.4987325728770595
chr1	SLAMF8	159836669	159836795	1625	127	2416	1906	791	1779	12.795275590551181	0.44463181562675663
chr1	LINC01133	159965498	159965645	0	148	0	3683	0	3535	0.0	0.0
chr1	NCSTN	160344475	160344614	0	140	97	4150	97	4010	0.0	0.024189526184538655
chr1	NCSTN	160351221	160351372	0	152	97	4150	97	3998	0.0	0.024262131065532766
chr1	NCSTN	160352886	160352991	0	106	97	4150	97	4044	0.0	0.023986152324431256
chr1	NCSTN	160343703	160343802	0	100	97	4150	97	4050	0.0	0.023950617283950617
chr1	NCSTN	160343703	160343888	0	186	97	4150	97	3964	0.0	0.02447023208879919
chr1	NCSTN	160353322	160353501	0	180	97	4150	97	3970	0.0	0.024433249370277077
chr1	NCSTN	160351287	160351372	0	86	97	4150	97	4064	0.0	0.02386811023622047
chr1	VANGL2	160420410	160420547	0	138	0	5362	0	5224	0.0	0.0
chr1	AL121985.1	160676359	160676504	0	146	0	4131	0	3985	0.0	0.0
chr1	AL121985.1	160684954	160685101	0	148	0	4131	0	3983	0.0	0.0
chr1	AL121985.1	160686608	160686693	0	86	0	4131	0	4045	0.0	0.0
chr1	SLAMF7	160751344	160751448	0	105	0	3183	0	3078	0.0	0.0
chr1	SLAMF7	160748193	160748514	0	322	0	3183	0	2861	0.0	0.0
chr1	SLAMF7	160750303	160750423	0	121	0	3183	0	3062	0.0	0.0
chr1	SLAMF7	160749820	160750093	0	274	0	3183	0	2909	0.0	0.0
chr1	LY9	160816593	160816863	0	271	0	5244	0	4973	0.0	0.0
chr1	LY9	160824180	160824249	0	70	0	5244	0	5174	0.0	0.0
chr1	LY9	160797109	160797275	0	167	0	5244	0	5077	0.0	0.0
chr1	LY9	160798825	160799008	0	184	0	5244	0	5060	0.0	0.0
chr1	KLHDC9	161099345	161099505	153	161	4498	1599	4345	1438	0.9503105590062112	3.021557719054242
chr1	NIT1	161118803	161118881	0	79	3264	3450	3264	3371	0.0	0.9682586769504598
chr1	NIT1	161118785	161118881	0	97	3264	3450	3264	3353	0.0	0.9734566060244557
chr1	UFC1	161158120	161158211	0	92	1712	1386	1712	1294	0.0	1.3230293663060277
chr1	USP21	161160365	161160506	6012	142	67773	3470	61761	3328	42.33802816901409	18.55799278846154
chr1	USP21	161160328	161160506	6282	179	67773	3470	61491	3291	35.09497206703911	18.684594348222426
chr1	PPOX	161167370	161167486	0	117	31353	4416	31353	4299	0.0	7.2930914166085135
chr1	PPOX	161168431	161168576	5246	146	31353	4416	26107	4270	35.93150684931507	6.114051522248244
chr1	PPOX	161169905	161170024	0	120	31353	4416	31353	4296	0.0	7.298184357541899
chr1	PPOX	161170408	161170519	8	112	31353	4416	31345	4304	0.07142857142857142	7.282760223048327
chr1	PPOX	161167099	161167234	0	136	31353	4416	31353	4280	0.0	7.325467289719626
chr1	PPOX	161167354	161167486	0	133	31353	4416	31353	4283	0.0	7.320336212934858
chr1	PPOX	161168444	161168576	5092	133	31353	4416	26261	4283	38.285714285714285	6.131449918281579
chr1	PPOX	161167994	161168127	4417	134	31353	4416	26936	4282	32.96268656716418	6.290518449322747
chr1	PPOX	161168412	161168576	5415	165	31353	4416	25938	4251	32.81818181818182	6.101623147494707
chr1	NDUFS2	161203436	161203543	0	108	37441	7304	37441	7196	0.0	5.203029460811562
chr1	NDUFS2	161209192	161209313	145	122	37441	7304	37296	7182	1.1885245901639345	5.192982456140351
chr1	NDUFS2	161209856	161209931	0	76	37441	7304	37441	7228	0.0	5.179994465965689
chr1	NDUFS2	161210110	161210188	0	79	37441	7304	37441	7225	0.0	5.182145328719723
chr1	NDUFS2	161212350	161212480	0	131	37441	7304	37441	7173	0.0	5.21971281193364
chr1	NDUFS2	161212591	161212654	41	64	37441	7304	37400	7240	0.640625	5.165745856353591
chr1	NDUFS2	161213156	161213182	0	27	37441	7304	37441	7277	0.0	5.145114745087262
chr1	NDUFS2	161212587	161213182	51	596	37441	7304	37390	6708	0.08557046979865772	5.573941562313656
chr1	NDUFS2	161212591	161213182	51	592	37441	7304	37390	6712	0.08614864864864864	5.57061978545888
chr1	NDUFS2	161213086	161213182	0	97	37441	7304	37441	7207	0.0	5.1950881087831275
chr1	NDUFS2	161213089	161213182	0	94	37441	7304	37441	7210	0.0	5.1929264909847435
chr1	NDUFS2	161210303	161210389	0	87	37441	7304	37441	7217	0.0	5.187889704863517
chr1	NDUFS2	161209842	161209931	0	90	37441	7304	37441	7214	0.0	5.190047130579429
chr1	NDUFS2	161206406	161206597	0	192	37441	7304	37441	7112	0.0	5.264482564679415
chr1	NDUFS2	161203786	161203837	0	52	37441	7304	37441	7252	0.0	5.162851627137341
chr1	NDUFS2	161208004	161208127	0	124	37441	7304	37441	7180	0.0	5.214623955431755
chr1	FCER1G	161217985	161218077	0	93	0	970	0	877	0.0	0.0
chr1	TOMM40L	161227257	161227350	0	94	70	3090	70	2996	0.0	0.02336448598130841
chr1	TOMM40L	161227635	161227737	0	103	70	3090	70	2987	0.0	0.023434884499497825
chr1	TOMM40L	161226887	161226955	0	69	70	3090	70	3021	0.0	0.023171135385633895
chr1	SDHC	161328395	161328497	0	103	1772	1910	1772	1807	0.0	0.9806308799114555
chr1	SDHC	161356676	161356840	0	165	1772	1910	1772	1745	0.0	1.0154727793696274
chr1	SDHC	161323613	161323670	0	58	1772	1910	1772	1852	0.0	0.9568034557235421
chr1	SDHC	161339561	161339588	728	28	1772	1910	1044	1882	26.0	0.5547290116896918
chr1	SDHC	161326650	161326768	0	119	1772	1910	1772	1791	0.0	0.989391401451703
chr1	FCGR2A	161510833	161510956	0	124	1781	4043	1781	3919	0.0	0.45445266649655525
chr1	FCGR2A	161513894	161513932	0	39	1781	4043	1781	4004	0.0	0.4448051948051948
chr1	FCGR2C	161595552	161595590	0	39	255	3594	255	3555	0.0	0.07172995780590717
chr1	FCGR2B	161670251	161670272	0	22	47	5256	47	5234	0.0	0.008979747802827665
chr1	FCGR2B	161675256	161675313	0	58	47	5256	47	5198	0.0	0.009041939207387457
chr1	FCRLA	161710759	161710912	0	154	0	2862	0	2708	0.0	0.0
chr1	FCRLA	161710474	161710492	0	19	0	2862	0	2843	0.0	0.0
chr1	FCRLA	161711207	161711474	0	268	0	2862	0	2594	0.0	0.0
chr1	FCRLA	161711933	161712218	0	286	0	2862	0	2576	0.0	0.0
chr1	FCRLB	161722988	161723009	8165	22	183926	2599	175761	2577	371.1363636363636	68.20372526193248
chr1	DUSP12	161751865	161751984	0	120	15901	1722	15901	1602	0.0	9.925717852684144
chr1	NOS1AP	162360811	162360924	0	114	367	7866	367	7752	0.0	0.04734262125902993
chr1	UHMK1	162518101	162518190	0	90	165141	9256	165141	9166	0.0	18.016692123063496
chr1	UAP1	162592731	162592782	0	52	23016	3449	23016	3397	0.0	6.775390050044156
chr1	UAP1	162592734	162592782	0	49	23016	3449	23016	3400	0.0	6.7694117647058825
chr1	DDR2	162705051	162705131	0	81	94768	11121	94768	11040	0.0	8.584057971014493
chr1	HSD17B7	162795620	162795663	20	44	20	3983	0	3939	0.45454545454545453	0.0
chr1	RGS4	163073455	163073622	0	168	663	3740	663	3572	0.0	0.18561030235162373
chr1	NUF2	163322866	163323095	2	230	3843	3228	3841	2998	0.008695652173913044	1.281187458305537
chr1	NUF2	163345677	163345818	0	142	3843	3228	3843	3086	0.0	1.245301360985094
chr1	PBX1	164820071	164820184	6094	114	550534	20254	544440	20140	53.45614035087719	27.032770605759683
chr1	PBX1	164811989	164812149	0	161	550534	20254	550534	20093	0.0	27.39929328621908
chr1	PBX1	164657112	164657372	0	261	550534	20254	550534	19993	0.0	27.53633771820137
chr1	AL356441.1	165605595	165605688	0	94	139262	2014	139262	1920	0.0	72.53229166666667
chr1	MGST3	165632230	165632274	26520	45	157324	6822	130804	6777	589.3333333333334	19.30116570754021
chr1	UCK2	165885141	165885379	1183	239	5321	6996	4138	6757	4.949790794979079	0.612401953529673
chr1	MAEL	166989736	166989829	0	94	0	3163	0	3069	0.0	0.0
chr1	POU2F1	167303473	167303574	0	102	12796	15677	12796	15575	0.0	0.8215730337078652
chr1	POU2F1	167374107	167374296	0	190	12796	15677	12796	15487	0.0	0.826241363724414
chr1	POU2F1	167389587	167389761	2181	175	12796	15677	10615	15502	12.462857142857143	0.6847503547929299
chr1	POU2F1	167319013	167319056	0	44	12796	15677	12796	15633	0.0	0.8185249152433954
chr1	POU2F1	167387180	167387247	1802	68	12796	15677	10994	15609	26.5	0.7043372413351272
chr1	RCSD1	167685420	167685510	0	91	4131	8178	4131	8087	0.0	0.5108198343019661
chr1	RCSD1	167690048	167690120	0	73	4131	8178	4131	8105	0.0	0.5096853793954349
chr1	MPZL1	167772274	167772488	25	215	20272	7079	20247	6864	0.11627906976744186	2.949737762237762
chr1	MPZL1	167776063	167776166	0	104	20272	7079	20272	6975	0.0	2.9063799283154124
chr1	DCAF6	167966628	167966721	0	94	65409	6334	65409	6240	0.0	10.482211538461538
chr1	DCAF6	168015780	168015951	0	172	65409	6334	65409	6162	0.0	10.61489776046738
chr1	DCAF6	168050891	168050933	2085	43	65409	6334	63324	6291	48.48837209302326	10.065808297567955
chr1	DCAF6	168022987	168023047	0	61	65409	6334	65409	6273	0.0	10.427068388330943
chr1	DCAF6	168019544	168019667	180	124	65409	6334	65229	6210	1.4516129032258065	10.503864734299517
chr1	SFT2D2	168235100	168235182	99	83	18438	11226	18339	11143	1.1927710843373494	1.6457865924795836
chr1	TBX19	168305007	168305196	0	190	1734	3818	1734	3628	0.0	0.47794928335170894
chr1	C1ORF112	169800882	169800971	0	90	14462	6002	14462	5912	0.0	2.446211096075778
chr1	C1ORF112	169807790	169807929	153	140	14462	6002	14309	5862	1.0928571428571427	2.4409757761856024
chr1	LINC01681	170226363	170226512	0	150	48	2807	48	2657	0.0	0.018065487391795258
chr1	LINC01681	170239898	170240141	0	244	48	2807	48	2563	0.0	0.01872805306281701
chr1	LINC01681	170241064	170241285	0	222	48	2807	48	2585	0.0	0.018568665377176014
chr1	LINC01681	170240229	170240322	0	94	48	2807	48	2713	0.0	0.017692591227423518
chr1	LINC01681	170226918	170227058	0	141	48	2807	48	2666	0.0	0.01800450112528132
chr1	LINC01681	170239969	170240141	0	173	48	2807	48	2634	0.0	0.018223234624145785
chr1	PRRX1	170730276	170730348	0	73	51	8256	51	8183	0.0	0.006232433092997678
chr1	FMO3	171101079	171101206	0	128	0	3450	0	3322	0.0	0.0
chr1	FMO2	171185707	171185845	0	139	0	6211	0	6072	0.0	0.0
chr1	FMO2	171196648	171196811	0	164	0	6211	0	6047	0.0	0.0
chr1	FMO2	171199345	171199488	0	144	0	6211	0	6067	0.0	0.0
chr1	FMO1	171283143	171283216	0	74	3654	2776	3654	2702	0.0	1.3523316062176165
chr1	FMO1	171267542	171267731	0	190	3654	2776	3654	2586	0.0	1.4129930394431554
chr1	FMO1	171270576	171270745	0	170	3654	2776	3654	2606	0.0	1.402148887183423
chr1	FMO4	171319817	171319957	0	141	78	2552	78	2411	0.0	0.03235172127747823
chr1	PRRC2C	171589368	171589605	0	238	70197	11736	70197	11498	0.0	6.105148721516786
chr1	PRRC2C	171591151	171591204	0	54	70197	11736	70197	11682	0.0	6.008988186954289
chr1	PRRC2C	171591151	171591200	0	50	70197	11736	70197	11686	0.0	6.006931370871128
chr1	EEF1AKNMT	171790451	171790616	0	166	0	3836	0	3670	0.0	0.0
chr1	EEF1AKNMT	171781987	171782120	0	134	0	3836	0	3702	0.0	0.0
chr1	DNM3	172323328	172323340	0	13	366281	11354	366281	11341	0.0	32.297063750991974
chr1	DNM3	172093695	172093725	0	31	366281	11354	366281	11323	0.0	32.3484058994966
chr1	SUCO	172553259	172553370	0	112	6701	7919	6701	7807	0.0	0.8583322659152043
chr1	SUCO	172577538	172577559	8	22	6701	7919	6693	7897	0.36363636363636365	0.8475370393820438
chr1	FASLG	172660094	172660140	0	47	0	1809	0	1762	0.0	0.0
chr1	DARS2	173828332	173828399	33	68	311587	7142	311554	7074	0.4852941176470588	44.04212609556121
chr1	DARS2	173845228	173845291	434	64	311587	7142	311153	7078	6.78125	43.96058208533484
chr1	DARS2	173853794	173853905	0	112	311587	7142	311587	7030	0.0	44.32247510668563
chr1	DARS2	173850326	173850479	0	154	311587	7142	311587	6988	0.0	44.58886662850601
chr1	ZBTB37	173873466	173873566	0	101	111447	19470	111447	19369	0.0	5.753885074087459
chr1	RABGAP1L	174877391	174877605	0	215	78645	13119	78645	12904	0.0	6.094621822690638
chr1	RABGAP1L	174957890	174958173	334	284	78645	13119	78311	12835	1.176056338028169	6.101363459291001
chr1	CACYBP	175000088	175000195	0	108	59	4456	59	4348	0.0	0.013569457221711132
chr1	AL591043.2	176228184	176228249	0	66	226	3358	226	3292	0.0	0.06865127582017011
chr1	LINC01741	177708956	177709125	0	170	0	1909	0	1739	0.0	0.0
chr1	RASAL2	178470692	178470723	0	32	24928	16105	24928	16073	0.0	1.5509239096621663
chr1	C1ORF220	178544874	178545028	0	155	0	2779	0	2624	0.0	0.0
chr1	RALGPS2	178784417	178784522	0	106	10800	9117	10800	9011	0.0	1.198535123737654
chr1	RALGPS2	178892229	178892307	0	79	10800	9117	10800	9038	0.0	1.1949546359814118
chr1	TOR3A	179085627	179085893	250	267	56332	2835	56082	2568	0.9363295880149812	21.838785046728972
chr1	SOAT1	179302676	179302802	0	127	16482	7022	16482	6895	0.0	2.3904278462654096
chr1	SOAT1	179323436	179323495	13773	60	16482	7022	2709	6962	229.55	0.3891123240448147
chr1	AXDND1	179368799	179368972	0	174	132	6113	132	5939	0.0	0.02222596396699781
chr1	AXDND1	179366403	179366606	0	204	132	6113	132	5909	0.0	0.02233880521238788
chr1	AXDND1	179444969	179445204	0	236	132	6113	132	5877	0.0	0.022460438999489536
chr1	AXDND1	179506832	179506926	0	95	132	6113	132	6018	0.0	0.02193419740777667
chr1	TDRD5	179654200	179654362	0	163	0	4109	0	3946	0.0	0.0
chr1	TOR1AIP1	179900125	179900167	0	43	16494	4707	16494	4664	0.0	3.536449399656947
chr1	TOR1AIP1	179913997	179914054	0	58	16494	4707	16494	4649	0.0	3.5478597547859754
chr1	TOR1AIP1	179913585	179913630	0	46	16494	4707	16494	4661	0.0	3.5387255953658014
chr1	CEP350	179990506	179990621	0	116	4851	14304	4851	14188	0.0	0.3419086552015788
chr1	CEP350	180043055	180043192	0	138	4851	14304	4851	14166	0.0	0.34243964421855144
chr1	CEP350	180052223	180052316	0	94	4851	14304	4851	14210	0.0	0.3413793103448276
chr1	QSOX1	180175930	180176033	0	104	36863	8766	36863	8662	0.0	4.255714615562225
chr1	XPR1	180836521	180836716	51	196	5076	7345	5025	7149	0.2602040816326531	0.702895509861519
chr1	KIAA1614	180935114	180936670	2346	1557	135635	6226	133289	4669	1.5067437379576107	28.547654744056544
chr1	MR1	181052234	181052510	102	277	140982	9356	140880	9079	0.36823104693140796	15.517127436942394
chr1	MR1	181053572	181053677	0	106	140982	9356	140982	9250	0.0	15.241297297297297
chr1	CACNA1E	181731174	181731231	0	58	0	18323	0	18265	0.0	0.0
chr1	CACNA1E	181793664	181793793	0	130	0	18323	0	18193	0.0	0.0
chr1	RGSL1	182472395	182472557	0	163	10133	8963	10133	8800	0.0	1.1514772727272726
chr1	RGSL1	182449277	182449299	0	23	10133	8963	10133	8940	0.0	1.1334451901565996
chr1	RGSL1	182471281	182471386	0	106	10133	8963	10133	8857	0.0	1.1440668397877385
chr1	RGSL1	182460623	182460756	0	134	10133	8963	10133	8829	0.0	1.1476950957073282
chr1	RGSL1	182473574	182474542	0	969	10133	8963	10133	7994	0.0	1.267575681761321
chr1	RGSL1	182488460	182488543	0	84	10133	8963	10133	8879	0.0	1.141232120734317
chr1	RGSL1	182488979	182489202	0	224	10133	8963	10133	8739	0.0	1.1595148186291337
chr1	RGSL1	182530789	182530910	0	122	10133	8963	10133	8841	0.0	1.1461373147833955
chr1	RGSL1	182556023	182556222	288	200	10133	8963	9845	8763	1.44	1.1234736962227547
chr1	RGSL1	182548699	182548824	0	126	10133	8963	10133	8837	0.0	1.1466561050130135
chr1	RGSL1	182460623	182460734	0	112	10133	8963	10133	8851	0.0	1.1448423906903176
chr1	NPL	182794355	182794439	0	85	3452	4113	3452	4028	0.0	0.8570009930486594
chr1	NPL	182822114	182822199	0	86	3452	4113	3452	4027	0.0	0.8572138068040726
chr1	NPL	182825780	182825820	0	41	3452	4113	3452	4072	0.0	0.8477406679764243
chr1	NPL	182818812	182818859	0	48	3452	4113	3452	4065	0.0	0.8492004920049201
chr1	SMG7	183512836	183512868	0	33	27613	8348	27613	8315	0.0	3.3208659049909803
chr1	SMG7	183527625	183527731	0	107	27613	8348	27613	8241	0.0	3.3506855964082027
chr1	SMG7	183502252	183502391	21302	140	27613	8348	6311	8208	152.15714285714284	0.7688840155945419
chr1	SMG7	183547102	183547252	0	151	27613	8348	27613	8197	0.0	3.368671465170184
chr1	SMG7	183501130	183501267	238	138	27613	8348	27375	8210	1.7246376811594204	3.3343483556638245
chr1	TSEN15	184054353	184054435	345	83	651	8390	306	8307	4.156626506024097	0.03683640303358613
chr1	TSEN15	184054727	184054863	0	137	651	8390	651	8253	0.0	0.07888040712468193
chr1	TSEN15	184072156	184072310	0	155	651	8390	651	8235	0.0	0.0790528233151184
chr1	TSEN15	184058160	184058240	0	81	651	8390	651	8309	0.0	0.07834877843302443
chr1	TSEN15	184072156	184072194	0	39	651	8390	651	8351	0.0	0.07795473595976529
chr1	TSEN15	184095030	184095092	0	63	651	8390	651	8327	0.0	0.07817941635643089
chr1	TSEN15	184112864	184112960	0	97	651	8390	651	8293	0.0	0.07849993970818762
chr1	TSEN15	184054360	184054435	289	76	651	8390	362	8314	3.8026315789473686	0.04354101515515997
chr1	TSEN15	184072156	184072298	0	143	651	8390	651	8247	0.0	0.07893779556202256
chr1	TSEN15	184120964	184121250	0	287	651	8390	651	8103	0.0	0.08034061458718993
chr1	TSEN15	184070615	184070732	0	118	651	8390	651	8272	0.0	0.07869922630560929
chr1	TSEN15	184093624	184093724	0	101	651	8390	651	8289	0.0	0.07853782120883097
chr1	TSEN15	184072050	184072194	0	145	651	8390	651	8245	0.0	0.07895694360218314
chr1	C1ORF21	184592224	184592290	86	67	617	11609	531	11542	1.2835820895522387	0.04600589152659851
chr1	C1ORF21	184509309	184509452	0	144	617	11609	617	11465	0.0	0.05381596162232883
chr1	RNF2	185093060	185093276	0	217	8442	3914	8442	3697	0.0	2.283473086286178
chr1	HMCN1	186178415	186178766	0	352	15	18847	15	18495	0.0	0.0008110300081103001
chr1	PRG4	186304793	186304922	0	130	15859	5062	15859	4932	0.0	3.215531224655312
chr1	PRG4	186304107	186304257	2956	151	15859	5062	12903	4911	19.576158940397352	2.6273671350030545
chr1	PRG4	186300090	186300213	0	124	15859	5062	15859	4938	0.0	3.211624139327663
chr1	ODR4	186393946	186394015	200	70	9670	4088	9470	4018	2.857142857142857	2.356893977103036
chr1	ODR4	186385987	186386083	0	97	9670	4088	9670	3991	0.0	2.4229516411926837
chr1	PDC-AS1	186431205	186431349	0	145	1479	6863	1479	6718	0.0	0.22015480797856504
chr1	PDC-AS1	186456711	186456852	0	142	1479	6863	1479	6721	0.0	0.22005653920547538
chr1	PLA2G4A	186932762	186932899	0	138	383	2897	383	2759	0.0	0.1388184124682856
chr1	LINC01036	187326920	187327023	0	104	153	12115	153	12011	0.0	0.012738323203729914
chr1	LINC01036	187417910	187418003	0	94	153	12115	153	12021	0.0	0.01272772647866234
chr1	LINC01036	187092824	187092946	0	123	153	12115	153	11992	0.0	0.012758505670446965
chr1	LINC01036	187303465	187303539	0	75	153	12115	153	12040	0.0	0.01270764119601329
chr1	LINC01036	187675351	187675442	0	92	153	12115	153	12023	0.0	0.012725609248939533
chr1	LINC01035	189036038	189036345	0	308	0	1396	0	1088	0.0	0.0
chr1	RGS1	192576284	192576365	0	82	0	4077	0	3995	0.0	0.0
chr1	RGS13	192638163	192638203	0	41	0	5934	0	5893	0.0	0.0
chr1	RO60	193075819	193076040	975	222	51598	8943	50623	8721	4.391891891891892	5.804724228872836
chr1	RO60	193069033	193069634	408	602	51598	8943	51190	8341	0.6777408637873754	6.137153818486992
chr1	RO60	193069033	193069181	408	149	51598	8943	51190	8794	2.738255033557047	5.821014327950875
chr1	RO60	193059873	193060222	15511	350	51598	8943	36087	8593	44.317142857142855	4.199581054346561
chr1	RO60	193084988	193085040	0	53	51598	8943	51598	8890	0.0	5.804049493813273
chr1	RO60	193070553	193070619	507	67	51598	8943	51091	8876	7.567164179104478	5.756083821541234
chr1	CDC73	193161122	193161190	0	69	7390	10538	7390	10469	0.0	0.7058935906008215
chr1	CDC73	193236255	193236356	739	102	7390	10538	6651	10436	7.245098039215686	0.6373131467995401
chr1	CDC73	193237707	193237854	0	148	7390	10538	7390	10390	0.0	0.7112608277189605
chr1	CDC73	193141072	193141142	0	71	7390	10538	7390	10467	0.0	0.706028470430878
chr1	CDC73	193127847	193128138	0	292	7390	10538	7390	10246	0.0	0.721257075932071
chr1	LINC01031	193349132	193349275	0	144	0	2025	0	1881	0.0	0.0
chr1	LINC01031	193363220	193363298	0	79	0	2025	0	1946	0.0	0.0
chr1	CFH	196677475	196677667	0	193	0	7513	0	7320	0.0	0.0
chr1	CFHR3	196788744	196788944	0	201	51	3366	51	3165	0.0	0.016113744075829384
chr1	CFHR3	196788215	196788398	0	184	51	3366	51	3182	0.0	0.016027655562539284
chr1	CFHR1	196828069	196828246	0	178	0	2230	0	2052	0.0	0.0
chr1	CFHR2	196949454	196949649	0	196	102	2757	102	2561	0.0	0.03982819211245607
chr1	CFHR2	196950851	196951028	0	178	102	2757	102	2579	0.0	0.039550213260953856
chr1	CFHR2	196948298	196948553	0	256	102	2757	102	2501	0.0	0.04078368652538984
chr1	CFHR2	196949616	196949649	0	34	102	2757	102	2723	0.0	0.0374586852735953
chr1	CFHR2	196950899	196951028	0	130	102	2757	102	2627	0.0	0.038827559954320516
chr1	CRB1	197428973	197429108	0	136	10558	9131	10558	8995	0.0	1.173763201778766
chr1	LHX9	197913014	197913120	0	107	0	6492	0	6385	0.0	0.0
chr1	NEK7	198220998	198221110	0	113	2895	5465	2895	5352	0.0	0.5409192825112108
chr1	PTPRC	198699563	198699704	0	142	0	9077	0	8935	0.0	0.0
chr1	PTPRC	198696711	198696909	0	199	0	9077	0	8878	0.0	0.0
chr1	PTPRC	198702386	198702530	0	145	0	9077	0	8932	0.0	0.0
chr1	PTPRC	198694017	198694140	0	124	0	9077	0	8953	0.0	0.0
chr1	AC096631.1	198975080	198975351	0	272	0	1889	0	1617	0.0	0.0
chr1	NR5A2	200029032	200029728	0	697	0	7555	0	6858	0.0	0.0
chr1	NR5A2	200039657	200039795	0	139	0	7555	0	7416	0.0	0.0
chr1	NR5A2	200038700	200038772	0	73	0	7555	0	7482	0.0	0.0
chr1	AC104461.1	200472040	200472119	0	80	0	4073	0	3993	0.0	0.0
chr1	AC104461.1	200444617	200444945	0	329	0	4073	0	3744	0.0	0.0
chr1	AC104461.1	200444613	200444945	0	333	0	4073	0	3740	0.0	0.0
chr1	CAMSAP2	200828572	200828605	3409	34	4197	7795	788	7761	100.26470588235294	0.10153330756345831
chr1	MROH3P	200957706	200957826	0	121	195	3084	195	2963	0.0	0.06581167735403308
chr1	IGFN1	201224678	201224874	0	197	315748	12141	315748	11944	0.0	26.435699933020764
chr1	PKP1	201319815	201319878	0	64	0	5800	0	5736	0.0	0.0
chr1	NAV1	201790553	201790577	3075	25	704606	19125	701531	19100	123.0	36.72937172774869
chr1	NAV1	201788467	201788638	153	172	704606	19125	704453	18953	0.8895348837209303	37.16841660950773
chr1	NAV1	201804488	201804497	0	10	704606	19125	704606	19115	0.0	36.86141773476327
chr1	NAV1	201794171	201794246	4030	76	704606	19125	700576	19049	53.026315789473685	36.77757362591212
chr1	NAV1	201787652	201787768	321	117	704606	19125	704285	19008	2.7435897435897436	37.05203072390572
chr1	RNPEP	201989382	201989531	0	150	0	3183	0	3033	0.0	0.0
chr1	RNPEP	201996146	201996263	0	118	0	3183	0	3065	0.0	0.0
chr1	RNPEP	201997318	201997554	0	237	0	3183	0	2946	0.0	0.0
chr1	RNPEP	201999901	202000015	0	115	0	3183	0	3068	0.0	0.0
chr1	ELF3	202011128	202011299	0	172	0	4243	0	4071	0.0	0.0
chr1	ELF3	202011128	202011293	0	166	0	4243	0	4077	0.0	0.0
chr1	PTPRVP	202168844	202169116	0	273	0	6628	0	6355	0.0	0.0
chr1	PTPRVP	202187630	202187707	0	78	0	6628	0	6550	0.0	0.0
chr1	PTPRVP	202184681	202184779	0	99	0	6628	0	6529	0.0	0.0
chr1	PTPRVP	202187852	202187981	0	130	0	6628	0	6498	0.0	0.0
chr1	LGR6	202280780	202280852	0	73	40287	4502	40287	4429	0.0	9.096184240234816
chr1	LGR6	202276305	202276521	0	217	40287	4502	40287	4285	0.0	9.401866977829638
chr1	PPP1R12B	202422619	202422738	0	120	459	21018	459	20898	0.0	0.021963824289405683
chr1	PPP1R12B	202434655	202434768	0	114	459	21018	459	20904	0.0	0.02195752009184845
chr1	PPP1R12B	202445045	202445228	0	184	459	21018	459	20834	0.0	0.022031294998560047
chr1	PPP1R12B	202425565	202425725	204	161	459	21018	255	20857	1.2670807453416149	0.01222611113774752
chr1	PPP1R12B	202443086	202443127	0	42	459	21018	459	20976	0.0	0.021882151029748283
chr1	PPP1R12B	202575001	202575182	0	182	459	21018	459	20836	0.0	0.02202918026492609
chr1	PPP1R12B	202501858	202502005	0	148	459	21018	459	20870	0.0	0.0219932918064207
chr1	PPFIA4	203061651	203061678	0	28	13525	8892	13525	8864	0.0	1.5258348375451263
chr1	PPFIA4	203048917	203048980	0	64	13525	8892	13525	8828	0.0	1.532057091073856
chr1	ADORA1	203128277	203128432	0	156	131	4200	131	4044	0.0	0.032393669634025714
chr1	ADORA1	203128784	203129182	0	399	131	4200	131	3801	0.0	0.03446461457511181
chr1	ATP2B4	203733222	203733400	0	179	251386	9518	251386	9339	0.0	26.917871292429595
chr1	ZC3H11A	203796292	203796496	918	205	25925	8033	25007	7828	4.478048780487805	3.194557996934083
chr1	ZC3H11A	203796450	203796607	99	158	25925	8033	25826	7875	0.6265822784810127	3.2794920634920635
chr1	ZC3H11A	203833936	203834102	51	167	25925	8033	25874	7866	0.30538922155688625	3.289346554792779
chr1	ZC3H11A	203796292	203796601	1004	310	25925	8033	24921	7723	3.238709677419355	3.226854849151884
chr1	SOX13	204112914	204113134	0	221	28578	6980	28578	6759	0.0	4.228140257434532
chr1	MDM4	204544534	204544684	0	151	7363	10513	7363	10362	0.0	0.7105771086662807
chr1	MDM4	204537429	204537497	0	69	7363	10513	7363	10444	0.0	0.7049980850248947
chr1	MDM4	204542783	204542944	0	162	7363	10513	7363	10351	0.0	0.7113322384310694
chr1	MDM4	204537458	204537497	0	40	7363	10513	7363	10473	0.0	0.7030459276234126
chr1	MDM4	204538208	204538308	0	101	7363	10513	7363	10412	0.0	0.707164809834806
chr1	NFASC	204977680	204977725	0	46	8857	21307	8857	21261	0.0	0.41658435633319224
chr1	NFASC	204985909	204986114	1647	206	8857	21307	7210	21101	7.995145631067961	0.34168996730012796
chr1	NFASC	204950556	204950574	0	19	8857	21307	8857	21288	0.0	0.41605599398722287
chr1	NFASC	204997169	204997406	25	238	8857	21307	8832	21069	0.10504201680672269	0.4191940766054393
chr1	NFASC	204962107	204962158	204	52	8857	21307	8653	21255	3.923076923076923	0.40710421077393555
chr1	NFASC	204984026	204984142	0	117	8857	21307	8857	21190	0.0	0.4179801793298726
chr1	NFASC	204991291	204991306	0	16	8857	21307	8857	21291	0.0	0.4159973697806585
chr1	NFASC	205002595	205002748	0	154	8857	21307	8857	21153	0.0	0.4187112939063017
chr1	CNTN2	205073655	205073841	204	187	198164	14396	197960	14209	1.0909090909090908	13.93201492012105
chr1	CNTN2	205073655	205073912	368	258	198164	14396	197796	14138	1.426356589147287	13.990380534729098
chr1	CNTN2	205066069	205066220	0	152	198164	14396	198164	14244	0.0	13.912103341757932
chr1	TMCC2	205256329	205256416	313	88	165438	5657	165125	5569	3.5568181818181817	29.650745196624168
chr1	TMCC2	205268949	205269884	204	936	165438	5657	165234	4721	0.21794871794871795	34.99978818047024
chr1	CDK18	205530258	205530349	0	92	102	5600	102	5508	0.0	0.018518518518518517
chr1	CDK18	205523146	205523297	0	152	102	5600	102	5448	0.0	0.018722466960352423
chr1	MFSD4A	205597779	205597850	1014	72	44852	5662	43838	5590	14.083333333333334	7.842218246869409
chr1	MFSD4A	205579750	205579949	8919	200	44852	5662	35933	5462	44.595	6.578725741486635
chr1	MFSD4A	205580660	205580921	9818	262	44852	5662	35034	5400	37.47328244274809	6.487777777777778
chr1	AC119673.2	205853787	205853874	0	88	15286	5942	15286	5854	0.0	2.611206012982576
chr1	AC119673.2	205864132	205864257	3732	126	15286	5942	11554	5816	29.61904761904762	1.9865887207702888
chr1	AC119673.2	205858142	205858320	663	179	15286	5942	14623	5763	3.7039106145251397	2.5373937185493665
chr1	AC119673.2	205858142	205858289	510	148	15286	5942	14776	5794	3.445945945945946	2.5502243700379705
chr1	AC119673.2	205868769	205868833	0	65	15286	5942	15286	5877	0.0	2.60098689807725
chr1	AC119673.2	205858142	205858293	510	152	15286	5942	14776	5790	3.3552631578947367	2.551986183074266
chr1	AC119673.2	205882514	205882549	0	36	15286	5942	15286	5906	0.0	2.588215374195733
chr1	AC119673.2	205836238	205836303	0	66	15286	5942	15286	5876	0.0	2.60142954390742
chr1	BX571818.1	206060726	206060833	0	108	0	1910	0	1802	0.0	0.0
chr1	RHEX	206099654	206099798	0	145	408	1728	408	1583	0.0	0.25773847125710675
chr1	SRGAP2	206458370	206458409	0	40	24	12849	24	12809	0.0	0.0018736825669451167
chr1	IKBKE	206473195	206473314	0	120	1603	3813	1603	3693	0.0	0.4340644462496615
chr1	IKBKE	206493265	206493378	0	114	1603	3813	1603	3699	0.0	0.43336036766693703
chr1	RASSF5	206585179	206585295	0	117	24944	5452	24944	5335	0.0	4.675538894095595
chr1	DYRK3	206636874	206636968	9253	95	163741	10320	154488	10225	97.4	15.108850855745722
chr1	DYRK3	206638924	206639042	0	119	163741	10320	163741	10201	0.0	16.051465542593863
chr1	IL20	206867383	206867458	0	76	1423	1573	1423	1497	0.0	0.9505678022712091
chr1	IL24	206899316	206899515	0	200	231136	1986	231136	1786	0.0	129.4154535274356
chr1	IL24	206901493	206901652	255	160	231136	1986	230881	1826	1.59375	126.44085432639649
chr1	IL24	206899319	206899515	0	197	231136	1986	231136	1789	0.0	129.19843487982112
chr1	IL24	206897730	206897876	12	147	231136	1986	231124	1839	0.08163265306122448	125.67917346383905
chr1	PFKFB2	207034945	207035080	0	136	1883	7139	1883	7003	0.0	0.2688847636727117
chr1	PFKFB2	207049463	207049617	0	155	1883	7139	1883	6984	0.0	0.26961626575028635
chr1	PFKFB2	207060845	207060930	0	86	1883	7139	1883	7053	0.0	0.2669785906706366
chr1	C4BPA	207114675	207114771	0	97	0	2483	0	2386	0.0	0.0
chr1	CD55	207324558	207324750	0	193	768	5771	768	5578	0.0	0.13768375761921836
chr1	CD55	207347446	207347561	0	116	768	5771	768	5655	0.0	0.13580901856763924
chr1	CD55	207340390	207340508	0	119	768	5771	768	5652	0.0	0.13588110403397027
chr1	CD55	207354006	207354099	0	94	768	5771	768	5677	0.0	0.1352827197463449
chr1	CD55	207322235	207322289	0	55	768	5771	768	5716	0.0	0.13435969209237228
chr1	CD55	207370708	207370834	0	127	768	5771	768	5644	0.0	0.13607370659107015
chr1	CR2	207471422	207471499	0	78	0	4907	0	4829	0.0	0.0
chr1	CR2	207476233	207476419	0	187	0	4907	0	4720	0.0	0.0
chr1	CR2	207473544	207473721	0	178	0	4907	0	4729	0.0	0.0
chr1	CD46	207757013	207757202	0	190	0	7781	0	7591	0.0	0.0
chr1	CD46	207767778	207767823	0	46	0	7781	0	7735	0.0	0.0
chr1	CD46	207770320	207770362	0	43	0	7781	0	7738	0.0	0.0
chr1	CD46	207790252	207790345	0	94	0	7781	0	7687	0.0	0.0
chr1	CD46	207767606	207767651	0	46	0	7781	0	7735	0.0	0.0
chr1	CD46	207785618	207785682	0	65	0	7781	0	7716	0.0	0.0
chr1	MIR205HG	209430424	209430500	0	77	0	2601	0	2524	0.0	0.0
chr1	MIR205HG	209431742	209431825	0	84	0	2601	0	2517	0.0	0.0
chr1	MIR205HG	209430424	209430476	0	53	0	2601	0	2548	0.0	0.0
chr1	MIR205HG	209429567	209429620	0	54	0	2601	0	2547	0.0	0.0
chr1	CAMK1G	209607857	209607933	0	77	0	3342	0	3265	0.0	0.0
chr1	CAMK1G	209598274	209598922	0	649	0	3342	0	2693	0.0	0.0
chr1	TRAF3IP3	209777351	209777487	0	137	0	5521	0	5384	0.0	0.0
chr1	TRAF3IP3	209780469	209780606	0	138	0	5521	0	5383	0.0	0.0
chr1	TRAF3IP3	209758725	209758854	0	130	0	5521	0	5391	0.0	0.0
chr1	SYT14	210159420	210159477	663	58	61132	13990	60469	13932	11.431034482758621	4.340295722078668
chr1	SYT14	209953054	209953259	2788	206	61132	13990	58344	13784	13.533980582524272	4.232733604178758
chr1	SYT14	210015683	210017099	53691	1417	61132	13990	7441	12573	37.89061397318278	0.5918237493040642
chr1	SYT14	209965892	209966013	0	122	61132	13990	61132	13868	0.0	4.408133833285261
chr1	SYT14	210159399	210159477	663	79	61132	13990	60469	13911	8.39240506329114	4.346847818273309
chr1	HHAT	210400467	210400662	0	196	946	6661	946	6465	0.0	0.14632637277648877
chr1	HHAT	210348932	210349066	0	135	946	6661	946	6526	0.0	0.14495862703034018
chr1	HHAT	210404463	210404679	0	217	946	6661	946	6444	0.0	0.1468032278088144
chr1	RCOR3	211304082	211304140	0	59	114	9078	114	9019	0.0	0.012639982259674021
chr1	RCOR3	211312719	211312961	0	243	114	9078	114	8835	0.0	0.012903225806451613
chr1	RCOR3	211267774	211267870	0	97	114	9078	114	8981	0.0	0.012693463979512303
chr1	RCOR3	211291523	211291599	0	77	114	9078	114	9001	0.0	0.012665259415620486
chr1	RCOR3	211271527	211271874	0	348	114	9078	114	8730	0.0	0.013058419243986255
chr1	RCOR3	211312719	211312835	0	117	114	9078	114	8961	0.0	0.012721794442584533
chr1	RCOR3	211312354	211312487	0	134	114	9078	114	8944	0.0	0.012745974955277281
chr1	LINC00467	211399376	211399437	0	62	18341	6958	18341	6896	0.0	2.65965777262181
chr1	LINC00467	211390563	211390670	0	108	18341	6958	18341	6850	0.0	2.6775182481751827
chr1	LINC00467	211394951	211395001	0	51	18341	6958	18341	6907	0.0	2.655422035616042
chr1	LINC00467	211422538	211422639	0	102	18341	6958	18341	6856	0.0	2.6751750291715286
chr1	LINC00467	211422538	211422700	0	163	18341	6958	18341	6795	0.0	2.6991905813097867
chr1	LINC00467	211384441	211384534	0	94	18341	6958	18341	6864	0.0	2.6720571095571097
chr1	LINC00467	211428416	211428575	0	160	18341	6958	18341	6798	0.0	2.6979994115916446
chr1	LINC00467	211422538	211422670	0	133	18341	6958	18341	6825	0.0	2.6873260073260075
chr1	LINC01693	211639971	211640189	0	219	0	2205	0	1986	0.0	0.0
chr1	LINC01693	211640218	211640360	0	143	0	2205	0	2062	0.0	0.0
chr1	LINC01693	211639971	211640360	0	390	0	2205	0	1815	0.0	0.0
chr1	LINC01693	211639996	211640189	0	194	0	2205	0	2011	0.0	0.0
chr1	LINC01693	211640246	211640360	0	115	0	2205	0	2090	0.0	0.0
chr1	LINC01693	211643292	211643431	0	140	0	2205	0	2065	0.0	0.0
chr1	LINC01693	211650737	211650815	0	79	0	2205	0	2126	0.0	0.0
chr1	DTL	212068223	212068327	0	105	47	4939	47	4834	0.0	0.009722796855606123
chr1	DTL	212042992	212043118	0	127	47	4939	47	4812	0.0	0.009767248545303408
chr1	NENF	212442564	212442625	0	62	0	1269	0	1207	0.0	0.0
chr1	ATF3	212619045	212619266	78586	222	205563	3955	126977	3733	353.990990990991	34.014733458344494
chr1	TATDN3	212797111	212797196	0	86	6110	3983	6110	3897	0.0	1.5678727226071336
chr1	TATDN3	212802700	212802763	0	64	6110	3983	6110	3919	0.0	1.559071191630518
chr1	TATDN3	212807735	212807848	0	114	6110	3983	6110	3869	0.0	1.5792194365469114
chr1	FLVCR1	212872677	212872818	51	142	3797	6434	3746	6292	0.3591549295774648	0.5953591862682772
chr1	FLVCR1	212887890	212888001	0	112	3797	6434	3797	6322	0.0	0.6006010756089845
chr1	VASH2	212951338	212951818	51	481	59048	8706	58997	8225	0.10602910602910603	7.172887537993921
chr1	RPS6KC1	213117316	213117410	0	95	14927	6207	14927	6112	0.0	2.442244764397906
chr1	RPS6KC1	213176399	213176492	1569	94	14927	6207	13358	6113	16.69148936170213	2.185179126451824
chr1	RPS6KC1	213072869	213072986	0	118	14927	6207	14927	6089	0.0	2.4514698636886187
chr1	RPS6KC1	213071005	213071041	1978	37	14927	6207	12949	6170	53.45945945945946	2.09870340356564
chr1	RPS6KC1	213077695	213077816	0	122	14927	6207	14927	6085	0.0	2.4530813475760067
chr1	RPS6KC1	213125765	213125843	315	79	14927	6207	14612	6128	3.9873417721518987	2.3844647519582245
chr1	SMYD2	214305186	214305250	0	65	51	3948	51	3883	0.0	0.013134174607262426
chr1	KCNK2	215171996	215172183	0	188	0	3448	0	3260	0.0	0.0
chr1	KCNK2	215124632	215124750	0	119	0	3448	0	3329	0.0	0.0
chr1	KCTD3	215618087	215618154	0	68	51	4395	51	4327	0.0	0.011786457129651028
chr1	USH2A-AS2	216079964	216080041	0	78	0	779	0	701	0.0	0.0
chr1	SPATA17	217665278	217665464	1341	187	1483	6386	142	6199	7.171122994652406	0.022906920471043715
chr1	TGFB2	218363333	218363417	0	85	153	6058	153	5973	0.0	0.025615268709191362
chr1	LINC02869	218523352	218523450	612	99	3825	1248	3213	1149	6.181818181818182	2.7963446475195823
chr1	LYPLAL1	219193129	219193251	0	123	0	2949	0	2826	0.0	0.0
chr1	LYPLAL1	219193081	219193251	0	171	0	2949	0	2778	0.0	0.0
chr1	MARK1	220599797	220599863	0	67	51	13355	51	13288	0.0	0.0038380493678506922
chr1	MARK1	220657789	220657834	0	46	51	13355	51	13309	0.0	0.0038319933879329775
chr1	MARK1	220604066	220604137	0	72	51	13355	51	13283	0.0	0.003839494090190469
chr1	MARK1	220576645	220576736	0	92	51	13355	51	13263	0.0	0.0038452838724270526
chr1	MARK1	220529671	220529771	0	101	51	13355	51	13254	0.0	0.003847894975101856
chr1	MTARC2	220754367	220754432	534	66	1366	2550	832	2484	8.090909090909092	0.33494363929146537
chr1	LINC02474	221968347	221968496	0	150	0	1370	0	1220	0.0	0.0
chr1	TAF1A-AS1	222590257	222590407	0	151	0	2263	0	2112	0.0	0.0
chr1	MIA3	222648828	222648850	96	23	20294	10160	20198	10137	4.173913043478261	1.992502712834172
chr1	BROX	222731356	222731516	1004	161	18658	4997	17654	4836	6.236024844720497	3.650537634408602
chr1	BROX	222722418	222722514	0	97	18658	4997	18658	4900	0.0	3.8077551020408165
chr1	DISP1	222928429	222928570	0	142	44838	10206	44838	10064	0.0	4.455286168521463
chr1	DISP1	222965426	222965477	0	52	44838	10206	44838	10154	0.0	4.415796730352571
chr1	DISP1	222899780	222899865	0	86	44838	10206	44838	10120	0.0	4.430632411067194
chr1	DISP1	222942806	222943332	0	527	44838	10206	44838	9679	0.0	4.632503357784895
chr1	DISP1	222872270	222872428	0	159	44838	10206	44838	10047	0.0	4.462824723798149
chr1	AC138393.1	224002521	224002622	0	102	1275	3147	1275	3045	0.0	0.4187192118226601
chr1	AC138393.1	224007293	224007417	0	125	1275	3147	1275	3022	0.0	0.42190602250165454
chr1	FBXO28	224134073	224134212	0	140	18549	6025	18549	5885	0.0	3.151911639762107
chr1	FBXO28	224153141	224153337	160	197	18549	6025	18389	5828	0.8121827411167513	3.1552848318462594
chr1	CNIH4	224371282	224371423	571	142	1427955	4931	1427384	4789	4.02112676056338	298.0547087074546
chr1	CNIH3	224513780	224513936	0	157	25841	6388	25841	6231	0.0	4.147167388862141
chr1	CNIH3	224546828	224546939	2061	112	25841	6388	23780	6276	18.401785714285715	3.7890376035691524
chr1	CNIH3	224583163	224583267	318	105	25841	6388	25523	6283	3.0285714285714285	4.062231418112367
chr1	CNIH3	224587165	224587420	0	256	25841	6388	25841	6132	0.0	4.214122635355512
chr1	LINC02813	224772709	224773053	153	345	306	1589	153	1244	0.4434782608695652	0.1229903536977492
chr1	LINC02813	224772639	224773053	306	415	306	1589	0	1174	0.7373493975903614	0.0
chr1	DNAH14	224960152	224960302	0	151	2459	19791	2459	19640	0.0	0.12520366598778004
chr1	DNAH14	225250655	225250703	134	49	2459	19791	2325	19742	2.7346938775510203	0.1177692229763955
chr1	DNAH14	225271905	225272073	0	169	2459	19791	2459	19622	0.0	0.12531852002853938
chr1	DNAH14	225333290	225333506	0	217	2459	19791	2459	19574	0.0	0.12562583018289566
chr1	DNAH14	225353802	225353888	0	87	2459	19791	2459	19704	0.0	0.12479699553390175
chr1	DNAH14	225140767	225141021	21	255	2459	19791	2438	19536	0.08235294117647059	0.1247952497952498
chr1	DNAH14	225331436	225331577	102	142	2459	19791	2357	19649	0.7183098591549296	0.11995521400580182
chr1	AC099066.2	225710502	225710568	0	67	100944	3554	100944	3487	0.0	28.948666475480355
chr1	SRP9	225786861	225786985	0	125	1069	2226	1069	2101	0.0	0.5088053307948596
chr1	SRP9	225789033	225789141	0	109	1069	2226	1069	2117	0.0	0.504959848842702
chr1	PSEN2	226883704	226883919	0	216	2692	12917	2692	12701	0.0	0.2119518148177309
chr1	PSEN2	226890034	226890133	0	100	2692	12917	2692	12817	0.0	0.21003354919247874
chr1	PSEN2	226910588	226910757	0	170	2692	12917	2692	12747	0.0	0.21118694594806622
chr1	AL391628.1	226933476	226933598	0	123	729	9653	729	9530	0.0	0.07649527806925499
chr1	PSEN2	226890655	226890965	763	311	2692	12917	1929	12606	2.4533762057877815	0.1530223702998572
chr1	PSEN2	226871261	226871404	0	144	2692	12917	2692	12773	0.0	0.2107570656854302
chr1	PSEN2	226889757	226889926	0	170	2692	12917	2692	12747	0.0	0.21118694594806622
chr1	PSEN2	226894006	226894125	0	120	2692	12917	2692	12797	0.0	0.2103618035477065
chr1	PSEN2	226895423	226895587	408	165	2692	12917	2284	12752	2.4727272727272727	0.17910915934755334
chr1	PSEN2	226897719	226899555	0	1837	2692	12917	2692	11080	0.0	0.24296028880866427
chr1	PSEN2	226885460	226885679	0	220	2692	12917	2692	12697	0.0	0.2120185870678113
chr1	PSEN2	226883709	226883919	0	211	2692	12917	2692	12706	0.0	0.21186840862584605
chr1	PSEN2	226880468	226880724	0	257	2692	12917	2692	12660	0.0	0.21263823064770931
chr1	PSEN2	226881540	226881711	0	172	2692	12917	2692	12745	0.0	0.21122008630835623
chr1	ZNF678	227582513	227582606	0	94	51	8921	51	8827	0.0	0.005777727427211964
chr1	ZNF678	227650955	227651076	0	122	51	8921	51	8799	0.0	0.005796113194681214
chr1	SNAP47	227747691	227748233	0	543	314	6591	314	6048	0.0	0.05191798941798942
chr1	GUK1	228147405	228147544	0	140	0	2999	0	2859	0.0	0.0
chr1	GUK1	228148370	228148456	0	87	0	2999	0	2912	0.0	0.0
chr1	GUK1	228141625	228141829	0	205	0	2999	0	2794	0.0	0.0
chr1	GUK1	228141123	228141288	0	166	0	2999	0	2833	0.0	0.0
chr1	GUK1	228148233	228148284	0	52	0	2999	0	2947	0.0	0.0
chr1	GUK1	228148370	228148539	0	170	0	2999	0	2829	0.0	0.0
chr1	GUK1	228141632	228141829	0	198	0	2999	0	2801	0.0	0.0
chr1	GUK1	228147409	228147544	0	136	0	2999	0	2863	0.0	0.0
chr1	OBSCN	228214173	228214434	0	262	3739400	37944	3739400	37682	0.0	99.2357093572528
chr1	OBSCN	228219323	228219599	0	277	3739400	37944	3739400	37667	0.0	99.27522765285264
chr1	OBSCN	228259500	228259776	0	277	3739400	37944	3739400	37667	0.0	99.27522765285264
chr1	OBSCN	228277504	228277666	626	163	3739400	37944	3738774	37781	3.8404907975460123	98.95910642915752
chr1	OBSCN	228292522	228292786	2213	265	3739400	37944	3737187	37679	8.350943396226414	99.18487751798084
chr1	OBSCN	228336199	228336270	2364	72	3739400	37944	3737036	37872	32.833333333333336	98.67543303760034
chr1	OBSCN	228350840	228350943	36	104	3739400	37944	3739364	37840	0.34615384615384615	98.82040169133192
chr1	OBSCN	228224458	228224734	0	277	3739400	37944	3739400	37667	0.0	99.27522765285264
chr1	OBSCN	228376646	228376698	0	53	3739400	37944	3739400	37891	0.0	98.68834287825605
chr1	LINC01736	230005957	230006024	0	68	77	1189	77	1121	0.0	0.06868867082961641
chr1	LINC01736	230005957	230006098	0	142	77	1189	77	1047	0.0	0.07354345749761222
chr1	COG2	230661324	230661557	0	234	213	10610	213	10376	0.0	0.020528141865844257
chr1	CAPN9	230774553	230774631	0	79	5035	2613	5035	2534	0.0	1.9869771112865036
chr1	CAPN9	230798161	230798220	0	60	5035	2613	5035	2553	0.0	1.972189580885233
chr1	ARV1	230988319	230988439	0	121	14061	2003	14061	1882	0.0	7.471307120085016
chr1	ARV1	230990599	230990698	0	100	14061	2003	14061	1903	0.0	7.388859695218077
chr1	ARV1	230999622	230999801	0	180	14061	2003	14061	1823	0.0	7.713110257816785
chr1	GNPAT	231250960	231251143	0	184	0	2954	0	2770	0.0	0.0
chr1	GNPAT	231258221	231258309	0	89	0	2954	0	2865	0.0	0.0
chr1	SPRTN	231347796	231347925	0	130	1020	5825	1020	5695	0.0	0.1791044776119403
chr1	SPRTN	231344622	231344714	0	93	1020	5825	1020	5732	0.0	0.1779483600837404
chr1	TSNAX-DISC1	231617952	231618059	0	108	14587	4222	14587	4114	0.0	3.545697617890131
chr1	DISC1	231701954	231702024	13106	71	50684	12565	37578	12494	184.59154929577466	3.0076836881703217
chr1	DISC1	231749925	231750076	0	152	50684	12565	50684	12413	0.0	4.083138644968984
chr1	DISC1	231767139	231767269	0	131	50684	12565	50684	12434	0.0	4.076242560720605
chr1	DISC1	231800107	231800210	0	104	50684	12565	50684	12461	0.0	4.067410320199021
chr1	TSNAX-DISC1	231561127	231561255	378	129	14587	4222	14209	4093	2.9302325581395348	3.471536770095285
chr1	TSNAX-DISC1	231616643	231616906	0	264	14587	4222	14587	3958	0.0	3.68544719555331
chr1	DISC1	231795241	231795296	0	56	50684	12565	50684	12509	0.0	4.051802702054521
chr1	DISC1	231958827	231958888	0	62	50684	12565	50684	12503	0.0	4.053747100695833
chr1	DISC1	231774638	231774817	0	180	50684	12565	50684	12385	0.0	4.092369802180056
chr1	DISC1	231693825	231694805	542	981	50684	12565	50142	11584	0.5524974515800204	4.328556629834254
chr1	DISC1	231813229	231813381	0	153	50684	12565	50684	12412	0.0	4.083467611988398
chr1	DISC1	231770834	231771070	0	237	50684	12565	50684	12328	0.0	4.111291369240753
chr1	NTPCR	232956346	232956443	0	98	32	15861	32	15763	0.0	0.0020300704180676267
chr1	NTPCR	232969908	232970118	0	211	32	15861	32	15650	0.0	0.0020447284345047924
chr1	NTPCR	232955556	232955719	0	164	32	15861	32	15697	0.0	0.002038606103077021
chr1	AL357556.3	235335241	235335334	255	94	11600	5210	11345	5116	2.7127659574468086	2.217552775605942
chr1	TBCE	235380018	235380149	0	132	14167	8049	14167	7917	0.0	1.7894404446128584
chr1	TBCE	235419472	235419561	157	90	14167	8049	14010	7959	1.7444444444444445	1.760271390878251
chr1	TBCE	235430704	235430804	0	101	14167	8049	14167	7948	0.0	1.7824609964771012
chr1	TBCE	235434203	235434280	0	78	14167	8049	14167	7971	0.0	1.7773177769414126
chr1	TBCE	235419416	235419561	157	146	14167	8049	14010	7903	1.0753424657534247	1.7727445273946603
chr1	TBCE	235438768	235438922	969	155	14167	8049	13198	7894	6.251612903225807	1.6719027109196858
chr1	AL357556.3	235363013	235363128	100	116	11600	5210	11500	5094	0.8620689655172413	2.2575579112681585
chr1	TBCE	235401502	235401587	0	86	14167	8049	14167	7963	0.0	1.7791033530076605
chr1	TBCE	235414432	235414618	0	187	14167	8049	14167	7862	0.0	1.801958789112185
chr1	TBCE	235432945	235433171	0	227	14167	8049	14167	7822	0.0	1.8111736128867297
chr1	AL357556.3	235342835	235342883	0	49	11600	5210	11600	5161	0.0	2.2476264289866306
chr1	AL357556.3	235367101	235367504	0	404	11600	5210	11600	4806	0.0	2.4136496046608404
chr1	AL357556.3	235359826	235359944	0	119	11600	5210	11600	5091	0.0	2.278530740522491
chr1	TBCE	235435744	235436608	459	865	14167	8049	13708	7184	0.530635838150289	1.908129175946548
chr1	TBCE	235438768	235438988	969	221	14167	8049	13198	7828	4.384615384615385	1.6859989780275932
chr1	TBCE	235432945	235433098	0	154	14167	8049	14167	7895	0.0	1.794426852438252
chr1	TBCE	235413875	235413997	0	123	14167	8049	14167	7926	0.0	1.7874085288922534
chr1	TBCE	235427139	235427239	0	101	14167	8049	14167	7948	0.0	1.7824609964771012
chr1	TBCE	235438768	235438926	969	159	14167	8049	13198	7890	6.09433962264151	1.6727503168567808
chr1	TBCE	235419416	235419515	100	100	14167	8049	14067	7949	1.0	1.7696565605736572
chr1	GPR137B	236178413	236178636	0	224	13928	2304	13928	2080	0.0	6.696153846153846
chr1	GPR137B	236168705	236168755	0	51	13928	2304	13928	2253	0.0	6.181979582778517
chr1	LGALS8	236523969	236524061	0	93	1071	9039	1071	8946	0.0	0.11971830985915492
chr1	LGALS8	236537496	236537585	0	90	1071	9039	1071	8949	0.0	0.11967817633255112
chr1	LGALS8	236518423	236518500	0	78	1071	9039	1071	8961	0.0	0.1195179109474389
chr1	LGALS8	236540563	236540683	0	121	1071	9039	1071	8918	0.0	0.12009419152276295
chr1	LGALS8	236542914	236543040	0	127	1071	9039	1071	8912	0.0	0.12017504488330341
chr1	LGALS8	236525423	236525545	0	123	1071	9039	1071	8916	0.0	0.12012113055181696
chr1	LGALS8	236523388	236523624	0	237	1071	9039	1071	8802	0.0	0.12167689161554192
chr1	ACTN2	236727677	236727756	21	80	54026	5985	54005	5905	0.2625	9.145639288738357
chr1	ACTN2	236734432	236734518	0	87	54026	5985	54026	5898	0.0	9.160054255679892
chr1	ACTN2	236737121	236737214	0	94	54026	5985	54026	5891	0.0	9.17093872008148
chr1	ACTN2	236735634	236735720	820	87	54026	5985	53206	5898	9.425287356321839	9.021024075957952
chr1	ACTN2	236736557	236736668	0	112	54026	5985	54026	5873	0.0	9.199046483909417
chr1	ACTN2	236725932	236726020	0	89	54026	5985	54026	5896	0.0	9.163161465400272
chr1	MTR	236803427	236803642	0	216	2805	12378	2805	12162	0.0	0.23063640848544648
chr1	MTR	236808703	236808773	0	71	2805	12378	2805	12307	0.0	0.22791907044771267
chr1	MTR	236831965	236832078	51	114	2805	12378	2754	12264	0.4473684210526316	0.224559686888454
chr1	MTR	236861124	236861277	0	154	2805	12378	2805	12224	0.0	0.22946662303664922
chr1	MTR	236907044	236907206	0	163	2805	12378	2805	12215	0.0	0.22963569381907492
chr1	RYR2	237678047	237678112	0	66	674	17966	674	17900	0.0	0.0376536312849162
chr1	RYR2	237687454	237687504	0	51	674	17966	674	17915	0.0	0.03762210438180296
chr1	RYR2	237726272	237726308	0	37	674	17966	674	17929	0.0	0.03759272686708684
chr1	RYR2	237830529	237830630	0	102	674	17966	674	17864	0.0	0.0377295118674429
chr1	RYR2	237743599	237743623	0	25	674	17966	674	17941	0.0	0.03756758263196031
chr1	RYR2	237755060	237755117	0	58	674	17966	674	17908	0.0	0.03763681036408309
chr1	RYR2	237769586	237769619	0	34	674	17966	674	17932	0.0	0.037586437653357126
chr1	FMN2	240180168	240180180	0	13	7	9266	7	9253	0.0	0.0007565114017075543
chr1	AL365184.1	240770765	240770902	0	138	79	2738	79	2600	0.0	0.030384615384615385
chr1	AL365184.1	240774525	240774600	0	76	79	2738	79	2662	0.0	0.029676934635612322
chr1	AL365184.1	240765437	240765599	0	163	79	2738	79	2575	0.0	0.030679611650485435
chr1	AL359764.1	241360455	241360613	75	159	153	3176	78	3017	0.4716981132075472	0.025853496851176664
chr1	AL359764.2	241447125	241447271	0	147	51	9640	51	9493	0.0	0.005372379648161804
chr1	AL359764.2	241436324	241436522	0	199	51	9640	51	9441	0.0	0.005401970130282809
chr1	AL359764.2	241436324	241436503	0	180	51	9640	51	9460	0.0	0.005391120507399577
chr1	AL359764.2	241424625	241424714	0	90	51	9640	51	9550	0.0	0.005340314136125655
chr1	AL359764.2	241430226	241430385	0	160	51	9640	51	9480	0.0	0.005379746835443038
chr1	KMO	241590050	241590113	0	64	70	4774	70	4710	0.0	0.014861995753715499
chr1	KMO	241590011	241590113	0	103	70	4774	70	4671	0.0	0.0149860843502462
chr1	WDR64	241783271	241783381	0	111	81202	4968	81202	4857	0.0	16.718550545604284
chr1	WDR64	241790590	241790696	0	107	81202	4968	81202	4861	0.0	16.704793252417197
chr1	EXO1	241849111	241849216	0	106	16	4110	16	4004	0.0	0.003996003996003996
chr1	EXO1	241852291	241852411	0	121	16	4110	16	3989	0.0	0.004011030333416896
chr1	EXO1	241853357	241853481	0	125	16	4110	16	3985	0.0	0.004015056461731493
chr1	EXO1	241881915	241882017	0	103	16	4110	16	4007	0.0	0.00399301222859995
chr1	EXO1	241849108	241849216	0	109	16	4110	16	4001	0.0	0.003999000249937516
chr1	SDCCAG8	243293090	243293219	156	130	13075	5112	12919	4982	1.2	2.59313528703332
chr1	SDCCAG8	243293398	243293494	104	97	13075	5112	12971	5015	1.0721649484536082	2.5864406779661016
chr1	C1ORF100	244378562	244378639	20	78	20	1156	0	1078	0.2564102564102564	0.0
chr1	C1ORF100	244378466	244378639	20	174	20	1156	0	982	0.11494252873563218	0.0
chr1	CATSPERE	244463907	244463956	0	50	59291	4458	59291	4408	0.0	13.450771324863885
chr1	CATSPERE	244490446	244490471	0	26	59291	4458	59291	4432	0.0	13.377933212996389
chr1	CATSPERE	244518591	244518698	0	108	59291	4458	59291	4350	0.0	13.630114942528735
chr1	CATSPERE	244617528	244617686	0	159	59291	4458	59291	4299	0.0	13.791812049313794
chr1	CATSPERE	244499001	244499079	0	79	59291	4458	59291	4379	0.0	13.539849280657684
chr1	CATSPERE	244552321	244552814	0	494	59291	4458	59291	3964	0.0	14.957366296670031
chr1	COX20	244836484	244836520	0	37	6324	4575	6324	4538	0.0	1.3935654473336272
chr1	COX20	244841943	244842058	0	116	6324	4575	6324	4459	0.0	1.4182552141735816
chr1	EFCAB2	245017241	245017326	107792	86	108001	8154	209	8068	1253.3953488372092	0.0259048091224591
chr1	EFCAB2	245002120	245002232	106	113	108001	8154	107895	8041	0.9380530973451328	13.41810720059694
chr1	SMYD3-AS1	246109075	246109434	51	360	51	945	0	585	0.14166666666666666	0.0
chr1	CNST	246621428	246621634	0	207	6732	5943	6732	5736	0.0	1.1736401673640167
chr1	LINC01341	246781478	246781627	138	150	5952	4672	5814	4522	0.92	1.2857142857142858
chr1	NLRP3	247429584	247429755	0	172	102	4587	102	4415	0.0	0.023103057757644395
chr1	NLRP3	247435969	247436140	0	172	102	4587	102	4415	0.0	0.023103057757644395
chr1	GCSAML	247556406	247556466	0	61	3533	4690	3533	4629	0.0	0.7632317995247354
chr1	GCSAML	247549135	247549220	0	86	3533	4690	3533	4604	0.0	0.7673761946133797
chr1	GCSAML	247538675	247538791	0	117	3533	4690	3533	4573	0.0	0.7725781762519134
chr1	GCSAML	247549044	247549220	0	177	3533	4690	3533	4513	0.0	0.7828495457567028
chr1	GCSAML	247526939	247527054	0	116	3533	4690	3533	4574	0.0	0.7724092697857455
chr1	AL390860.1	247746202	247746512	0	311	0	3842	0	3531	0.0	0.0
chr1	OR2L2	248035549	248035624	0	76	153	4378	153	4302	0.0	0.03556485355648536
chr1	OR2L3	248051187	248051241	0	55	51	2933	51	2878	0.0	0.017720639332870047
chr1	OR2L13	248098650	248098775	0	126	102	2023	102	1897	0.0	0.05376910911966262
chr1	OR2M2	248177917	248177995	0	79	0	1214	0	1135	0.0	0.0
chr1	OR2T2	248449193	248449392	0	200	0	3534	0	3334	0.0	0.0
chr1	LYPD9P	248692603	248692770	0	168	51	929	51	761	0.0	0.06701708278580815
chr1	AL627309.1	120720	120932	96	213	3884	3729	3788	3516	0.4507042253521127	1.0773606370875994
chr1	AP006222.1	261549	261634	0	86	3009	5940	3009	5854	0.0	0.51400751622822
chr1	AL732372.2	498072	498305	0	234	0	6130	0	5896	0.0	0.0
chr1	AL732372.2	502186	502243	0	58	0	6130	0	6072	0.0	0.0
chr1	AL732372.2	498398	498456	0	59	0	6130	0	6071	0.0	0.0
chr1	AL732372.2	498046	498305	0	260	0	6130	0	5870	0.0	0.0
chr1	AL669831.3	711710	711922	0	213	1873	5509	1873	5296	0.0	0.3536631419939577
chr1	AL669831.3	612740	612864	0	125	1873	5509	1873	5384	0.0	0.3478826151560178
chr1	HES4	999691	999787	29	97	2340	966	2311	869	0.29896907216494845	2.659378596087457
chr1	C1ORF159	1090875	1090983	340	109	510	4115	170	4006	3.1192660550458715	0.042436345481777334
chr1	C1ORF159	1115021	1115075	0	55	510	4115	510	4060	0.0	0.12561576354679804
chr1	C1ORF159	1083914	1084086	0	173	510	4115	510	3942	0.0	0.1293759512937595
chr1	C1ORF159	1091277	1091374	0	98	510	4115	510	4017	0.0	0.12696041822255413
chr1	C1ORF159	1083914	1084011	0	98	510	4115	510	4017	0.0	0.12696041822255413
chr1	C1ORF159	1105955	1106049	0	95	510	4115	510	4020	0.0	0.12686567164179105
chr1	UBE2J2	1257207	1257310	0	104	354458	4676	354458	4572	0.0	77.52799650043744
chr1	UBE2J2	1266097	1266290	0	194	354458	4676	354458	4482	0.0	79.08478357875948
chr1	UBE2J2	1267861	1267992	0	132	354458	4676	354458	4544	0.0	78.00572183098592
chr1	UBE2J2	1267732	1267992	0	261	354458	4676	354458	4415	0.0	80.28493771234429
chr1	UBE2J2	1262268	1262390	49131	123	354458	4676	305327	4553	399.4390243902439	67.06061937184275
chr1	UBE2J2	1264782	1264830	0	49	354458	4676	354458	4627	0.0	76.60644045818024
chr1	UBE2J2	1262169	1262390	67739	222	354458	4676	286719	4454	305.1306306306306	64.37337224966322
chr1	UBE2J2	1271509	1271637	3252	129	354458	4676	351206	4547	25.209302325581394	77.23905872003519
chr1	ACAP3	1294717	1294816	144	100	203250	7540	203106	7440	1.44	27.299193548387098
chr1	ACAP3	1307336	1307383	0	48	203250	7540	203250	7492	0.0	27.128937533368926
chr1	INTS11	1312439	1312501	306	63	392827	6765	392521	6702	4.857142857142857	58.56774097284393
chr1	INTS11	1314300	1314365	0	66	392827	6765	392827	6699	0.0	58.639647708613225
chr1	INTS11	1315403	1315438	0	36	392827	6765	392827	6729	0.0	58.378213701887354
chr1	INTS11	1321907	1321984	13947	78	392827	6765	378880	6687	178.80769230769232	56.659189472110064
chr1	INTS11	1322891	1323287	189241	397	392827	6765	203586	6368	476.67758186397987	31.970163316582916
chr1	INTS11	1323180	1323287	139409	108	392827	6765	253418	6657	1290.8240740740741	38.067898452756495
chr1	INTS11	1320995	1321093	40	99	392827	6765	392787	6666	0.40404040404040403	58.923942394239425
chr1	INTS11	1319295	1319524	255	230	392827	6765	392572	6535	1.108695652173913	60.07222647283856
chr1	INTS11	1323146	1323287	159009	142	392827	6765	233818	6623	1119.781690140845	35.303940812320704
chr1	INTS11	1321907	1321980	13115	74	392827	6765	379712	6691	177.22972972972974	56.74966372739501
chr1	DVL1	1337017	1337055	414	39	203373	3895	202959	3856	10.615384615384615	52.634595435684645
chr1	MXRA8	1355449	1355752	80	304	204	3538	124	3234	0.2631578947368421	0.0383426097711812
chr1	CCNL2	1388491	1388510	0	20	97762	6208	97762	6188	0.0	15.798642533936652
chr1	CCNL2	1392678	1392803	0	126	97762	6208	97762	6082	0.0	16.07398881946728
chr1	CCNL2	1388625	1388743	0	119	97762	6208	97762	6089	0.0	16.055509935950074
chr1	CCNL2	1388815	1388830	0	16	97762	6208	97762	6192	0.0	15.78843669250646
chr1	CCNL2	1392789	1392803	0	15	97762	6208	97762	6193	0.0	15.785887292103988
chr1	CCNL2	1391296	1391575	551	280	97762	6208	97211	5928	1.9678571428571427	16.39861673414305
chr1	ANKRD65	1420051	1420592	89715	542	183396	2647	93681	2105	165.5258302583026	44.50403800475059
chr1	CDK11B	1645125	1645262	309	138	227309	3502	227000	3364	2.239130434782609	67.47919143876338
chr1	CDK11B	1657255	1657302	409	48	227309	3502	226900	3454	8.520833333333334	65.69195136074117
chr1	CDK11B	1642385	1642508	1529	124	227309	3502	225780	3378	12.330645161290322	66.83836589698046
chr1	SLC35E2B	1690975	1691393	3550	419	498602	8472	495052	8053	8.47255369928401	61.474233205016766
chr1	CDK11A	1722587	1722634	818	48	173055	4549	172237	4501	17.041666666666668	38.26638524772273
chr1	SLC35E2A	1744250	1744668	102	419	11281	3273	11179	2854	0.24343675417661098	3.916958654519972
chr1	NADK	1754050	1754208	891	159	276911	5178	276020	5019	5.60377358490566	54.99501892807332
chr1	NADK	1755373	1755476	2139	104	276911	5178	274772	5074	20.567307692307693	54.15293653921955
chr1	NADK	1756778	1756882	136253	105	276911	5178	140658	5073	1297.647619047619	27.726788882318154
chr1	NADK	1756738	1756882	137144	145	276911	5178	139767	5033	945.8206896551724	27.77011722630638
chr1	GNB1	1817836	1817875	0	40	25599	6282	25599	6242	0.0	4.101089394424863
chr1	GNB1	1839189	1839238	0	50	25599	6282	25599	6232	0.0	4.107670089858793
chr1	GNB1	1815755	1815862	31	108	25599	6282	25568	6174	0.28703703703703703	4.141237447359896
chr1	CFAP74	1922588	1922723	0	136	220	8293	220	8157	0.0	0.02697070001225941
chr1	CFAP74	1956619	1956784	0	166	220	8293	220	8127	0.0	0.027070259628399162
chr1	FAAP20	2192844	2192975	256	132	47124	8807	46868	8675	1.9393939393939394	5.402651296829971
chr1	FAAP20	2193997	2194133	561	137	47124	8807	46563	8670	4.094890510948905	5.370588235294117
chr1	FAAP20	2192646	2192975	1474	330	47124	8807	45650	8477	4.466666666666667	5.3851598442845345
chr1	MORN1	2389924	2389996	0	73	252057	5620	252057	5547	0.0	45.44023796646836
chr1	PEX10	2410629	2410868	0	240	0	3454	0	3214	0.0	0.0
chr1	PANK4	2521717	2521800	11510	84	86583	4175	75073	4091	137.02380952380952	18.35076998288927
chr1	PANK4	2515257	2515401	0	145	86583	4175	86583	4030	0.0	21.484615384615385
chr1	TNFRSF14-AS1	2550572	2550731	0	160	0	4264	0	4104	0.0	0.0
chr1	MMEL1	2591931	2592027	0	97	23	3894	23	3797	0.0	0.006057413747695549
chr1	PRDM16-DT	3060500	3060604	0	105	0	4427	0	4322	0.0	0.0
chr1	MEGF6	3490911	3490959	0	49	2751	9060	2751	9011	0.0	0.3052935301298413
chr1	MEGF6	3493770	3493899	27	130	2751	9060	2724	8930	0.2076923076923077	0.30503919372900334
chr1	MEGF6	3496987	3497119	0	133	2751	9060	2751	8927	0.0	0.3081662372577574
chr1	MEGF6	3497490	3497621	0	132	2751	9060	2751	8928	0.0	0.3081317204301075
chr1	WRAP73	3635159	3635294	0	136	2122	3935	2122	3799	0.0	0.5585680442221638
chr1	WRAP73	3635943	3636030	0	88	2122	3935	2122	3847	0.0	0.5515986482973746
chr1	TP73-AS1	3738222	3738513	47	292	120321	6550	120274	6258	0.16095890410958905	19.21923937360179
chr1	TP73-AS1	3742429	3742517	281	89	120321	6550	120040	6461	3.157303370786517	18.579167311561676
chr1	TP73-AS1	3743300	3743371	1706	72	120321	6550	118615	6478	23.694444444444443	18.310435319543068
chr1	TP73-AS1	3741219	3741373	1040	155	120321	6550	119281	6395	6.709677419354839	18.652228303362
chr1	LRRC47	3783769	3783911	1065	143	44071	4517	43006	4374	7.4475524475524475	9.832190214906264
chr1	CEP104	3823173	3823241	0	69	8636	11552	8636	11483	0.0	0.7520682748410694
chr1	CEP104	3826707	3826744	221	38	8636	11552	8415	11514	5.815789473684211	0.7308494007295466
chr1	CEP104	3836494	3836692	0	199	8636	11552	8636	11353	0.0	0.7606799964767021
chr1	CEP104	3848607	3848781	0	175	8636	11552	8636	11377	0.0	0.75907532741496
chr1	CEP104	3855873	3856001	0	129	8636	11552	8636	11423	0.0	0.7560185590475357
chr1	CEP104	3851685	3851802	0	118	8636	11552	8636	11434	0.0	0.7552912366625852
chr1	CEP104	3828884	3828971	0	88	8636	11552	8636	11464	0.0	0.7533147243545011
chr1	CEP104	3841081	3841169	0	89	8636	11552	8636	11463	0.0	0.7533804414202215
chr1	LINC01345	3945493	3945669	0	177	0	1907	0	1730	0.0	0.0
chr1	LINC01345	3947274	3947328	0	55	0	1907	0	1852	0.0	0.0
chr1	Z98259.3	5492487	5492607	0	121	0	1286	0	1165	0.0	0.0
chr1	NPHP4	5952699	5952836	0	138	3669	12312	3669	12174	0.0	0.30137999014292755
chr1	NPHP4	5879345	5879632	0	288	3669	12312	3669	12024	0.0	0.3051397205588822
chr1	NPHP4	5888459	5888610	0	152	3669	12312	3669	12160	0.0	0.30172697368421053
chr1	CHD5	6106394	6106509	585	116	14791	10138	14206	10022	5.043103448275862	1.4174815406106565
chr1	CHD5	6113310	6113416	0	107	14791	10138	14791	10031	0.0	1.4745289602233078
chr1	CHD5	6127082	6127164	0	83	14791	10138	14791	10055	0.0	1.4710094480358031
chr1	RPL22	6200488	6200750	0	263	3810	3060	3810	2797	0.0	1.3621737575974258
chr1	ICMT	6233473	6233643	0	171	204	2935	204	2764	0.0	0.07380607814761216
chr1	ICMT	6234404	6234511	0	108	204	2935	204	2827	0.0	0.07216130173328617
chr1	ACOT7	6282723	6282796	22924	74	225024	3514	202100	3440	309.7837837837838	58.75
chr1	ACOT7	6282723	6282888	60099	166	225024	3514	164925	3348	362.0421686746988	49.26075268817204
chr1	HES2	6419240	6419340	0	101	255	4128	255	4027	0.0	0.06332257263471566
chr1	TNFRSF25	6462862	6462970	0	109	373	3596	373	3487	0.0	0.10696874103814166
chr1	TNFRSF25	6463071	6463127	58	57	373	3596	315	3539	1.0175438596491229	0.0890081944051992
chr1	TNFRSF25	6465087	6465222	0	136	373	3596	373	3460	0.0	0.10780346820809249
chr1	TNFRSF25	6463064	6463147	72	84	373	3596	301	3512	0.8571428571428571	0.08570615034168565
chr1	PLEKHG5	6484289	6484480	0	192	0	6625	0	6433	0.0	0.0
chr1	PLEKHG5	6477026	6477089	0	64	0	6625	0	6561	0.0	0.0
chr1	PLEKHG5	6495515	6495589	0	75	0	6625	0	6550	0.0	0.0
chr1	PLEKHG5	6474696	6474832	0	137	0	6625	0	6488	0.0	0.0
chr1	NOL9	6550395	6550615	102	221	62997	7283	62895	7062	0.46153846153846156	8.906117247238743
chr1	DNAJC11	6639901	6640057	51	157	109231	5102	109180	4945	0.3248407643312102	22.0788675429727
chr1	DNAJC11	6678393	6678467	68	75	109231	5102	109163	5027	0.9066666666666666	21.715337179232147
chr1	TNFRSF9	7936459	7936563	0	105	20	6365	20	6260	0.0	0.003194888178913738
chr1	ERRFI1	8015307	8015384	0	78	1101	4183	1101	4105	0.0	0.2682095006090134
chr1	ERRFI1	8015307	8015400	0	94	1101	4183	1101	4089	0.0	0.2692589875275128
chr1	RERE	8614560	8614686	0	127	103011	11873	103011	11746	0.0	8.769879107781373
chr1	RERE	8792403	8792588	0	186	103011	11873	103011	11687	0.0	8.814152477111321
chr1	RERE	8508626	8508675	34	50	103011	11873	102977	11823	0.68	8.709887507400829
chr1	RERE	8519709	8519792	0	84	103011	11873	103011	11789	0.0	8.737891254559335
chr1	ENO1	8870451	8870510	0	60	2034	4608	2034	4548	0.0	0.4472295514511873
chr1	ENO1	8870824	8870883	0	60	2034	4608	2034	4548	0.0	0.4472295514511873
chr1	ENO1	8873772	8873973	0	202	2034	4608	2034	4406	0.0	0.4616432137993645
chr1	ENO1	8875788	8876031	357	244	2034	4608	1677	4364	1.4631147540983607	0.38428047662694775
chr1	GPR157	9105485	9105680	0	196	0	5201	0	5005	0.0	0.0
chr1	CLSTN1	9737497	9737554	44	58	21363	5261	21319	5203	0.7586206896551724	4.097443782433212
chr1	CLSTN1	9756480	9756510	0	31	21363	5261	21363	5230	0.0	4.084703632887189
chr1	CLSTN1	9746888	9747012	176	125	21363	5261	21187	5136	1.408	4.125194704049845
chr1	CTNNBIP1	9883704	9883738	5063	35	66778	3347	61715	3312	144.65714285714284	18.63375603864734
chr1	DFFA	10463430	10463620	51	191	495472	6631	495421	6440	0.2670157068062827	76.92872670807454
chr1	EXOSC10	11073933	11074008	56638	76	447315	4858	390677	4782	745.2368421052631	81.6974069427018
chr1	EXOSC10	11095415	11095547	51	133	447315	4858	447264	4725	0.38345864661654133	94.65904761904761
chr1	MTHFR	11796205	11796399	33153	195	73387	6734	40234	6539	170.01538461538462	6.152928582352041
chr1	MTHFR	11801160	11801399	2193	240	73387	6734	71194	6494	9.1375	10.963042808746536
chr1	MTHFR	11791636	11791745	17	110	73387	6734	73370	6624	0.15454545454545454	11.07638888888889
chr1	KAZN-AS1	14390685	14390751	0	67	0	2835	0	2768	0.0	0.0
chr1	KAZN-AS1	14409405	14409451	0	47	0	2835	0	2788	0.0	0.0
chr1	TMEM51-AS1	15120576	15120697	0	122	102	10809	102	10687	0.0	0.009544306166370356
chr1	CASP9	15495272	15495452	0	181	6658	4712	6658	4531	0.0	1.4694327962922091
chr1	CASP9	15505989	15506079	0	91	6658	4712	6658	4621	0.0	1.4408136766933564
chr1	AL450998.2	15725592	15725872	0	281	1094	1540	1094	1259	0.0	0.868943606036537
chr1	ZBTB17	15943807	15943895	0	89	1920	3882	1920	3793	0.0	0.506195623517005
chr1	ZBTB17	15948290	15948497	255	208	1920	3882	1665	3674	1.2259615384615385	0.4531845400108873
chr1	FAM131C	16063520	16063636	0	117	56861	1727	56861	1610	0.0	35.31739130434783
chr1	EPHA2	16150895	16150963	0	69	215595	4159	215595	4090	0.0	52.71271393643032
chr1	ARHGEF19	16205537	16205667	0	131	615	3803	615	3672	0.0	0.16748366013071894
chr1	CPLANE2	16232892	16233017	0	126	2592	1579	2592	1453	0.0	1.783895388850654
chr1	SPATA21	16432789	16432924	0	136	44	4528	44	4392	0.0	0.010018214936247723
chr1	CROCCP3	16484822	16484906	0	85	63774	5234	63774	5149	0.0	12.385705962322781
chr1	CROCCP3	16486425	16486661	405	237	63774	5234	63369	4997	1.7088607594936709	12.681408845307184
chr1	CROCCP3	16489684	16489791	0	108	63774	5234	63774	5126	0.0	12.441279750292626
chr1	CROCCP3	16491009	16491316	1765	308	63774	5234	62009	4926	5.73051948051948	12.588103938286642
chr1	CROCCP2	16619844	16620024	79	181	19354	5265	19275	5084	0.43646408839779005	3.7913060582218727
chr1	CROCCP2	16619844	16620038	79	195	19354	5265	19275	5070	0.40512820512820513	3.801775147928994
chr1	CROCCP2	16619844	16620245	79	402	19354	5265	19275	4863	0.19651741293532338	3.9636027143738435
chr1	CROCCP2	16630031	16630142	0	112	19354	5265	19354	5153	0.0	3.755870366776635
chr1	MST1L	16758215	16758293	0	79	12020	5187	12020	5108	0.0	2.3531714956930307
chr1	MST1L	16758674	16758711	0	38	12020	5187	12020	5149	0.0	2.334433870654496
chr1	BX284668.1	16851573	16851723	0	151	0	842	0	691	0.0	0.0
chr1	ATP13A2	16993628	16993835	88	208	75763	5196	75675	4988	0.4230769230769231	15.171411387329591
chr1	ATP13A2	16996385	16996496	0	112	75763	5196	75763	5084	0.0	14.902242328874902
chr1	ATP13A2	16986462	16986632	204	171	75763	5196	75559	5025	1.1929824561403508	15.036616915422886
chr1	ATP13A2	16989886	16990003	0	118	75763	5196	75763	5078	0.0	14.919850334777472
chr1	ATP13A2	16996385	16996478	0	94	75763	5196	75763	5102	0.0	14.849666797334379
chr1	ALDH4A1	18876314	18876467	0	154	0	3649	0	3495	0.0	0.0
chr1	ALDH4A1	18886463	18886511	0	49	0	3649	0	3600	0.0	0.0
chr1	IFFO2	18911383	18911476	0	94	250	6188	250	6094	0.0	0.04102395799146702
chr1	IFFO2	18918361	18918502	0	142	250	6188	250	6046	0.0	0.04134965266291763
chr1	UBR4	19140787	19140892	0	106	4599	22176	4599	22070	0.0	0.20838241957408246
chr1	UBR4	19146022	19146106	0	85	4599	22176	4599	22091	0.0	0.20818432845955367
chr1	UBR4	19149762	19149795	0	34	4599	22176	4599	22142	0.0	0.20770481437991148
chr1	EMC1	19243949	19244015	0	67	28869	8562	28869	8495	0.0	3.3983519717480872
chr1	EMC1	19234179	19234188	320	10	28869	8562	28549	8552	32.0	3.338283442469598
chr1	AKR7A2	19307313	19307410	0	98	20	1788	20	1690	0.0	0.011834319526627219
chr1	AKR7A2	19308157	19308262	0	106	20	1788	20	1682	0.0	0.011890606420927468
chr1	AKR7A2	19307001	19307101	0	101	20	1788	20	1687	0.0	0.011855364552459988
chr1	CAPZB	19344357	19344434	0	78	98160	19106	98160	19028	0.0	5.158713474879126
chr1	CAPZB	19385504	19385626	0	123	98160	19106	98160	18983	0.0	5.170942422167202
chr1	CAPZB	19419660	19419750	0	91	98160	19106	98160	19015	0.0	5.162240336576387
chr1	CAPZB	19448833	19449330	1794	498	98160	19106	96366	18608	3.602409638554217	5.1787403267411865
chr1	CAPZB	19342751	19342864	0	114	98160	19106	98160	18992	0.0	5.16849199663016
chr1	CAPZB	19412235	19417164	85918	4930	98160	19106	12242	14176	17.427586206896553	0.8635722347629797
chr1	TMCO4	19745531	19745651	35	121	179303	4046	179268	3925	0.2892561983471074	45.67337579617834
chr1	TMCO4	19798136	19798215	51	80	179303	4046	179252	3966	0.6375	45.19717599596571
chr1	PLA2G2D	20115506	20115613	0	108	1944	2685	1944	2577	0.0	0.7543655413271245
chr1	LINC01141	20400934	20400987	0	54	0	4291	0	4237	0.0	0.0
chr1	LINC01141	20399479	20399549	0	71	0	4291	0	4220	0.0	0.0
chr1	LINC01141	20408705	20408810	0	106	0	4291	0	4185	0.0	0.0
chr1	LINC01141	20402773	20402846	0	74	0	4291	0	4217	0.0	0.0
chr1	DDOST	20656100	20656187	0	88	51	2732	51	2644	0.0	0.019288956127080183
chr1	KIF17	20687387	20687944	0	558	765	4306	765	3748	0.0	0.20410885805763074
chr1	SH2D5	20727957	20728086	0	130	0	4501	0	4371	0.0	0.0
chr1	HP1BP3	20767583	20767664	0	82	138	5936	138	5854	0.0	0.023573624871882474
chr1	HP1BP3	20780344	20780540	0	197	138	5936	138	5739	0.0	0.024046001045478306
chr1	HP1BP3	20780349	20780540	0	192	138	5936	138	5744	0.0	0.02402506963788301
chr1	EIF4G3	21050865	21050994	1263	130	308882	9643	307619	9513	9.715384615384615	32.33669715126669
chr1	EIF4G3	20941490	20942330	0	841	308882	9643	308882	8802	0.0	35.092251760963414
chr1	EIF4G3	20982387	20982408	60	22	308882	9643	308822	9621	2.727272727272727	32.09874233447667
chr1	EIF4G3	20892618	20892729	0	112	308882	9643	308882	9531	0.0	32.40814185290106
chr1	EIF4G3	20997600	20997633	0	34	308882	9643	308882	9609	0.0	32.14507232802581
chr1	EIF4G3	21001198	21001312	0	115	308882	9643	308882	9528	0.0	32.41834592779177
chr1	ECE1	21221746	21221842	0	97	21010	7299	21010	7202	0.0	2.917245209663982
chr1	RAP1GAP	21603657	21603912	0	256	2637	5400	2637	5144	0.0	0.5126360808709176
chr1	RAP1GAP	21603834	21603912	0	79	2637	5400	2637	5321	0.0	0.49558353692914864
chr1	RAP1GAP	21665210	21665317	0	108	2637	5400	2637	5292	0.0	0.49829931972789115
chr1	USP48	21695065	21695221	0	157	37164	9527	37164	9370	0.0	3.966275346851654
chr1	USP48	21703511	21703618	0	108	37164	9527	37164	9419	0.0	3.9456417878755707
chr1	HSPG2	21836801	21837006	0	206	564	17430	564	17224	0.0	0.03274500696702276
chr1	HSPG2	21832874	21832892	0	19	564	17430	564	17411	0.0	0.03239331457124806
chr1	HSPG2	21888667	21888718	0	52	564	17430	564	17378	0.0	0.03245482794337668
chr1	LINC01635	22024805	22024955	0	151	102	1231	102	1080	0.0	0.09444444444444444
chr1	LINC01635	22024805	22024966	0	162	102	1231	102	1069	0.0	0.09541627689429373
chr1	LUZP1	23109021	23109127	0	107	357	9666	357	9559	0.0	0.03734700282456324
chr1	LUZP1	23109584	23109650	0	67	357	9666	357	9599	0.0	0.0371913741014689
chr1	HNRNPR	23323555	23323732	0	178	316	6774	316	6596	0.0	0.04790782292298363
chr1	HNRNPR	23333517	23333631	0	115	316	6774	316	6659	0.0	0.04745457275867247
chr1	HNRNPR	23340851	23341017	231	167	316	6774	85	6607	1.3832335329341316	0.01286514303011957
chr1	HNRNPR	23340851	23341020	240	170	316	6774	76	6604	1.411764705882353	0.01150817686250757
chr1	HNRNPR	23338062	23338163	0	102	316	6774	316	6672	0.0	0.047362110311750596
chr1	ASAP3	23439160	23439230	920	71	5075	5015	4155	4944	12.95774647887324	0.8404126213592233
chr1	ELOA-AS1	23772267	23772426	0	160	17606	2991	17606	2831	0.0	6.219003885552808
chr1	ELOA-AS1	23772271	23772426	0	156	17606	2991	17606	2835	0.0	6.2102292768959435
chr1	ELOA-AS1	23771701	23771883	0	183	17606	2991	17606	2808	0.0	6.26994301994302
chr1	GALE	23796508	23796586	0	79	865	3023	865	2944	0.0	0.2938179347826087
chr1	GALE	23798886	23799012	0	127	865	3023	865	2896	0.0	0.2986878453038674
chr1	SRSF10	23971572	23971626	0	55	357	8967	357	8912	0.0	0.04005834829443447
chr1	SRSF10	23971572	23971623	0	52	357	8967	357	8915	0.0	0.04004486819966349
chr1	IFNLR1	24159051	24159182	51	132	371	1986	320	1854	0.38636363636363635	0.1725997842502697
chr1	STPG1	24391560	24391679	0	120	1224	5592	1224	5472	0.0	0.2236842105263158
chr1	SYF2	25228997	25229123	385	127	1006	3780	621	3653	3.031496062992126	0.16999726252395292
chr1	RSRP1	25244453	25244498	0	46	0	5486	0	5440	0.0	0.0
chr1	RHCE	25375348	25375428	0	81	0	2447	0	2366	0.0	0.0
chr1	RHCE	25385710	25385844	0	135	0	2447	0	2312	0.0	0.0
chr1	RHCE	25408682	25408869	0	188	0	2447	0	2259	0.0	0.0
chr1	RHCE	25388975	25389113	0	139	0	2447	0	2308	0.0	0.0
chr1	PAFAH2	25990726	25990863	0	138	0	3807	0	3669	0.0	0.0
chr1	PAFAH2	25997447	25997621	0	175	0	3807	0	3632	0.0	0.0
chr1	SLC30A2	26044297	26044444	0	148	14	3491	14	3343	0.0	0.004187855219862399
chr1	UBXN11	26302812	26302918	0	107	17300	4722	17300	4615	0.0	3.7486457204767065
chr1	UBXN11	26294204	26294331	0	128	17300	4722	17300	4594	0.0	3.7657814540705266
chr1	UBXN11	26296918	26296995	0	78	17300	4722	17300	4644	0.0	3.7252368647717486
chr1	UBXN11	26300925	26301024	5028	100	17300	4722	12272	4622	50.28	2.655127650367806
chr1	UBXN11	26301693	26301722	0	30	17300	4722	17300	4692	0.0	3.687127024722933
chr1	UBXN11	26303042	26303167	54	126	17300	4722	17246	4596	0.42857142857142855	3.7523933855526543
chr1	UBXN11	26300925	26301053	9666	129	17300	4722	7634	4593	74.93023255813954	1.662094491617679
chr1	CRYBG2	26338011	26338047	0	37	792	6090	792	6053	0.0	0.13084420948290104
chr1	CRYBG2	26354045	26354785	357	741	792	6090	435	5349	0.4817813765182186	0.08132361189007291
chr1	ZNF683	26362115	26362175	99	61	123	2318	24	2257	1.6229508196721312	0.010633584404076208
chr1	ZNF683	26367592	26367797	0	206	123	2318	123	2112	0.0	0.05823863636363636
chr1	ZNF683	26367592	26367647	0	56	123	2318	123	2262	0.0	0.054376657824933686
chr1	DHDDS-AS1	26466203	26466324	0	122	0	1265	0	1143	0.0	0.0
chr1	MAP3K6	27355668	27355745	0	78	102	5375	102	5297	0.0	0.019256182744949973
chr1	MAP3K6	27364660	27364684	0	25	102	5375	102	5350	0.0	0.019065420560747663
chr1	FCN3	27373487	27373520	0	34	0	1666	0	1632	0.0	0.0
chr1	WASF2	27409691	27410206	0	516	13107	5690	13107	5174	0.0	2.533243138770777
chr1	AHDC1	27558304	27558530	0	227	2495	4518	2495	4291	0.0	0.5814495455604755
chr1	EYA3	28027788	28027926	0	139	4501	6293	4501	6154	0.0	0.7313942151446213
chr1	EYA3	28042570	28042650	0	81	4501	6293	4501	6212	0.0	0.7245653573728268
chr1	EYA3	28048382	28048426	0	45	4501	6293	4501	6248	0.0	0.7203905249679897
chr1	EYA3	28035543	28035680	0	138	4501	6293	4501	6155	0.0	0.7312753858651503
chr1	PTAFR	28176591	28176673	42002	83	406551	4211	364549	4128	506.04819277108436	88.31128875968992
chr1	SNHG12	28581110	28581229	0	120	255	3699	255	3579	0.0	0.07124895222129086
chr1	SNHG12	28581093	28581229	0	137	255	3699	255	3562	0.0	0.07158899494665918
chr1	SRSF4	29150102	29150192	0	91	0	8221	0	8130	0.0	0.0
chr1	SRSF4	29159863	29160091	0	229	0	8221	0	7992	0.0	0.0
chr1	SRSF4	29159863	29160058	0	196	0	8221	0	8025	0.0	0.0
chr1	MECR	29203130	29203233	0	104	202	4032	202	3928	0.0	0.05142566191446028
chr1	PUM1	30941997	30942123	0	127	0	6646	0	6519	0.0	0.0
chr1	PUM1	30945345	30945483	0	139	0	6646	0	6507	0.0	0.0
chr1	PUM1	30964673	30964910	0	238	0	6646	0	6408	0.0	0.0
chr1	PUM1	30980061	30980163	0	103	0	6646	0	6543	0.0	0.0
chr1	PUM1	30980061	30980166	0	106	0	6646	0	6540	0.0	0.0
chr1	PUM1	30980061	30980178	0	118	0	6646	0	6528	0.0	0.0
chr1	PUM1	30941921	30942123	0	203	0	6646	0	6443	0.0	0.0
chr1	PUM1	31006993	31007102	0	110	0	6646	0	6536	0.0	0.0
chr1	PUM1	31055312	31055380	0	69	0	6646	0	6577	0.0	0.0
chr1	NKAIN1	31185246	31185327	0	82	1512	1982	1512	1900	0.0	0.7957894736842105
chr1	FABP3	31369069	31369136	30	68	839	1405	809	1337	0.4411764705882353	0.6050860134629769
chr1	PEF1	31635221	31635522	51	302	102	1689	51	1387	0.16887417218543047	0.03677000720980533
chr1	COL16A1	31662586	31662658	0	73	2127	9320	2127	9247	0.0	0.23002054720449874
chr1	COL16A1	31670601	31670646	0	46	2127	9320	2127	9274	0.0	0.22935087340953203
chr1	COL16A1	31679803	31679851	0	49	2127	9320	2127	9271	0.0	0.22942508898716427
chr1	COL16A1	31684108	31684231	0	124	2127	9320	2127	9196	0.0	0.2312962157459765
chr1	COL16A1	31694143	31694170	0	28	2127	9320	2127	9292	0.0	0.228906586310805
chr1	COL16A1	31702120	31702227	0	108	2127	9320	2127	9212	0.0	0.23089448545375596
chr1	ADGRB2	31728024	31728081	0	58	246166	7790	246166	7732	0.0	31.837299534402483
chr1	ADGRB2	31735182	31735281	355	100	246166	7790	245811	7690	3.55	31.965019505851757
chr1	ADGRB2	31742837	31743002	255	166	246166	7790	245911	7624	1.536144578313253	32.25485309548793
chr1	ADGRB2	31744192	31744357	61441	166	246166	7790	184725	7624	370.1265060240964	24.229407135362013
chr1	SPOCD1	31792214	31792401	25	188	9798	6982	9773	6794	0.13297872340425532	1.4384751251103916
chr1	SPOCD1	31796589	31796715	0	127	9798	6982	9798	6855	0.0	1.4293216630196937
chr1	SPOCD1	31799400	31799485	0	86	9798	6982	9798	6896	0.0	1.4208236658932714
chr1	SPOCD1	31800440	31800617	25	178	9798	6982	9773	6804	0.1404494382022472	1.4363609641387418
chr1	SPOCD1	31813950	31815372	1626	1423	9798	6982	8172	5559	1.1426563598032327	1.4700485698866703
chr1	SPOCD1	31796592	31796715	0	124	9798	6982	9798	6858	0.0	1.4286964129483815
chr1	SPOCD1	31815347	31815372	0	26	9798	6982	9798	6956	0.0	1.4085681426106957
chr1	PTP4A2	31910037	31910112	0	76	0	6592	0	6516	0.0	0.0
chr1	PTP4A2	31911695	31911826	0	132	0	6592	0	6460	0.0	0.0
chr1	PTP4A2	31915894	31915987	0	94	0	6592	0	6498	0.0	0.0
chr1	PTP4A2	31930038	31930334	0	297	0	6592	0	6295	0.0	0.0
chr1	PTP4A2	31913786	31913843	0	58	0	6592	0	6534	0.0	0.0
chr1	PTP4A2	31912980	31913023	0	44	0	6592	0	6548	0.0	0.0
chr1	PTP4A2	31930932	31931142	0	211	0	6592	0	6381	0.0	0.0
chr1	TMEM234	32217436	32217577	0	142	9241	3451	9241	3309	0.0	2.7926866122695677
chr1	MTMR9LP	32234703	32234814	0	112	0	2789	0	2677	0.0	0.0
chr1	MTMR9LP	32234035	32234301	0	267	0	2789	0	2522	0.0	0.0
chr1	MTMR9LP	32239294	32239425	0	132	0	2789	0	2657	0.0	0.0
chr1	MTMR9LP	32234402	32234623	0	222	0	2789	0	2567	0.0	0.0
chr1	BSDC1	32383829	32383997	255	169	7016	6752	6761	6583	1.5088757396449703	1.0270393437642413
chr1	BSDC1	32386778	32386895	5	118	7016	6752	7011	6634	0.0423728813559322	1.0568284594513113
chr1	BSDC1	32369229	32369338	0	110	7016	6752	7016	6642	0.0	1.0563083408611864
chr1	BSDC1	32383829	32384048	601	220	7016	6752	6415	6532	2.731818181818182	0.9820881812614819
chr1	BSDC1	32381213	32381268	179	56	7016	6752	6837	6696	3.1964285714285716	1.021057347670251
chr1	BSDC1	32383829	32383939	235	111	7016	6752	6781	6641	2.1171171171171173	1.0210811624755307
chr1	BSDC1	32383829	32383906	70	78	7016	6752	6946	6674	0.8974358974358975	1.040755169313755
chr1	ZBTB8OS	32631826	32631879	3034	54	45880	3541	42846	3487	56.18518518518518	12.287353025523373
chr1	ZBTB8OS	32632207	32632345	0	139	45880	3541	45880	3402	0.0	13.486184597295708
chr1	ZBTB8OS	32633261	32633354	0	94	45880	3541	45880	3447	0.0	13.310124746156077
chr1	ZBTB8OS	32634767	32634792	52	26	45880	3541	45828	3515	2.0	13.037837837837838
chr1	SYNC	32684009	32684089	14	81	55147	3729	55133	3648	0.1728395061728395	15.113212719298245
chr1	YARS1	32806481	32806611	0	131	130844	8638	130844	8507	0.0	15.380745268602327
chr1	YARS1	32810910	32811057	0	148	130844	8638	130844	8490	0.0	15.411542991755006
chr1	YARS1	32804544	32804883	267	340	130844	8638	130577	8298	0.7852941176470588	15.735960472402988
chr1	YARS1	32810590	32810766	0	177	130844	8638	130844	8461	0.0	15.46436591419454
chr1	YARS1	32797591	32797638	1289	48	130844	8638	129555	8590	26.854166666666668	15.082072176949941
chr1	TMEM54	32895909	32895969	0	61	0	1424	0	1363	0.0	0.0
chr1	AK2	33024441	33024567	0	127	4217	7812	4217	7685	0.0	0.5487312947299935
chr1	AK2	33021366	33021461	0	96	4217	7812	4217	7716	0.0	0.5465266977708657
chr1	AK2	33011447	33011710	511	264	4217	7812	3706	7548	1.9356060606060606	0.49099099099099097
chr1	AK2	33012073	33012122	0	50	4217	7812	4217	7762	0.0	0.5432878124194795
chr1	AK2	33031543	33031661	0	119	4217	7812	4217	7693	0.0	0.5481606655401013
chr1	PHC2	33368535	33368622	0	88	95841	4902	95841	4814	0.0	19.908807644370587
chr1	CSMD2	33605862	33605988	0	127	71831	18235	71831	18108	0.0	3.9668102496134305
chr1	CSMD2	33804745	33804898	1922	154	71831	18235	69909	18081	12.480519480519481	3.8664343786295006
chr1	ZMYM6	35019352	35019602	0	251	51	9585	51	9334	0.0	0.005463895436040283
chr1	ZMYM6	35030546	35030713	0	168	51	9585	51	9417	0.0	0.00541573749601784
chr1	ZMYM6	35031266	35031337	0	72	51	9585	51	9513	0.0	0.005361084831283507
chr1	KIAA0319L	35470862	35470960	494	99	20963	9295	20469	9196	4.98989898989899	2.2258590691605047
chr1	KIAA0319L	35474804	35474906	0	103	20963	9295	20963	9192	0.0	2.280570060922541
chr1	KIAA0319L	35506611	35507135	0	525	20963	9295	20963	8770	0.0	2.390307867730901
chr1	KIAA0319L	35554349	35554519	60	171	20963	9295	20903	9124	0.3508771929824561	2.2909907935116176
chr1	CLSPN	35753744	35753936	0	193	9489	9618	9489	9425	0.0	1.006790450928382
chr1	TRAPPC3	36137795	36137978	0	184	204	3533	204	3349	0.0	0.06091370558375635
chr1	TRAPPC3	36138083	36138232	0	150	204	3533	204	3383	0.0	0.06030150753768844
chr1	STK40	36367847	36368084	4928	238	56769	5632	51841	5394	20.705882352941178	9.610863922877272
chr1	STK40	36367851	36368084	4571	234	56769	5632	52198	5398	19.534188034188034	9.669877732493516
chr1	OSCP1	36420475	36420615	663	141	7887	2655	7224	2514	4.702127659574468	2.873508353221957
chr1	OSCP1	36444003	36444033	0	31	7887	2655	7887	2624	0.0	3.0057164634146343
chr1	OSCP1	36418990	36419054	18	65	7887	2655	7869	2590	0.27692307692307694	3.0382239382239384
chr1	OSCP1	36447812	36447887	51	76	7887	2655	7836	2579	0.6710526315789473	3.038386971694455
chr1	CSF3R	36469155	36469257	0	103	7031	8399	7031	8296	0.0	0.8475168756027001
chr1	CSF3R	36479986	36480080	0	95	7031	8399	7031	8304	0.0	0.8467003853564548
chr1	MEAF6	37496706	37496736	0	31	153	2301	153	2270	0.0	0.06740088105726873
chr1	MEAF6	37496546	37496604	0	59	153	2301	153	2242	0.0	0.06824264049955397
chr1	SNIP1	37548820	37548987	0	168	0	5537	0	5369	0.0	0.0
chr1	GNL2	37581341	37581545	0	205	0	5764	0	5559	0.0	0.0
chr1	RSPO1	37613703	37613892	0	190	0	3066	0	2876	0.0	0.0
chr1	RSPO1	37631843	37632022	0	180	0	3066	0	2886	0.0	0.0
chr1	C1ORF109	37691458	37691581	0	124	0	3992	0	3868	0.0	0.0
chr1	C1ORF109	37690215	37690438	0	224	0	3992	0	3768	0.0	0.0
chr1	EPHA10	37718952	37719053	0	102	3	8168	3	8066	0.0	0.00037193156459211507
chr1	EPHA10	37722804	37722931	0	128	3	8168	3	8040	0.0	0.00037313432835820896
chr1	EPHA10	37722005	37722296	0	292	3	8168	3	7876	0.0	0.0003809040121889284
chr1	EPHA10	37734579	37734687	0	109	3	8168	3	8059	0.0	0.0003722546221615585
chr1	FHL3	37997962	37998132	0	171	1122	2010	1122	1839	0.0	0.6101141924959217
chr1	FHL3	37999256	37999432	0	177	1122	2010	1122	1833	0.0	0.6121112929623568
chr1	LINC01343	38211733	38211822	0	90	51	2578	51	2488	0.0	0.0204983922829582
chr1	LINC01343	38214264	38214515	0	252	51	2578	51	2326	0.0	0.021926053310404127
chr1	PPIEL	39524835	39525151	102	317	5231	3504	5129	3187	0.3217665615141956	1.6093504863508001
chr1	PPIEL	39524835	39525057	102	223	5231	3504	5129	3281	0.45739910313901344	1.5632429137458093
chr1	PPIEL	39547578	39547634	0	57	5231	3504	5231	3447	0.0	1.5175514940527994
chr1	PPIEL	39556133	39556201	0	69	5231	3504	5231	3435	0.0	1.5228529839883551
chr1	PPIEL	39523561	39523697	0	137	5231	3504	5231	3367	0.0	1.5536085536085535
chr1	PPIEL	39548669	39548746	0	78	5231	3504	5231	3426	0.0	1.526853473438412
chr1	PPIEL	39523806	39523896	0	91	5231	3504	5231	3413	0.0	1.5326692059771463
chr1	PPIEL	39525698	39525848	1305	151	5231	3504	3926	3353	8.642384105960264	1.1708917387414255
chr1	PPIEL	39556598	39556738	0	141	5231	3504	5231	3363	0.0	1.5554564377044307
chr1	PPIEL	39537190	39537343	0	154	5231	3504	5231	3350	0.0	1.5614925373134327
chr1	PABPC4	39563835	39563922	0	88	6584	8427	6584	8339	0.0	0.7895431106847344
chr1	PABPC4	39564685	39564773	0	89	6584	8427	6584	8338	0.0	0.789637802830415
chr1	PABPC4	39569594	39569689	0	96	6584	8427	6584	8331	0.0	0.7903012843596207
chr1	PABPC4	39564700	39564773	0	74	6584	8427	6584	8353	0.0	0.7882198012690051
chr1	PABPC4	39571606	39571705	0	100	6584	8427	6584	8327	0.0	0.790680917497298
chr1	HPCAL4	39683936	39684152	18	217	2760	4763	2742	4546	0.08294930875576037	0.6031676198856137
chr1	HPCAL4	39691064	39691170	39	107	2760	4763	2721	4656	0.3644859813084112	0.5844072164948454
chr1	TRIT1	39844530	39844640	0	111	10332	6546	10332	6435	0.0	1.6055944055944056
chr1	TRIT1	39847219	39847297	0	79	10332	6546	10332	6467	0.0	1.5976496056904284
chr1	TRIT1	39847547	39847660	174	114	10332	6546	10158	6432	1.5263157894736843	1.5792910447761195
chr1	TRIT1	39852730	39852876	36	147	10332	6546	10296	6399	0.24489795918367346	1.6090014064697609
chr1	TRIT1	39864709	39865667	816	959	10332	6546	9516	5587	0.8508863399374348	1.7032396635045641
chr1	TRIT1	39876061	39876132	2964	72	10332	6546	7368	6474	41.166666666666664	1.1380908248378128
chr1	PPT1	40076841	40076913	48	73	54	2932	6	2859	0.6575342465753424	0.002098635886673662
chr1	PPT1	40089409	40089512	0	104	54	2932	54	2828	0.0	0.019094766619519095
chr1	PPT1	40092044	40092172	0	129	54	2932	54	2803	0.0	0.019265073135925792
chr1	PPT1	40093932	40094019	0	88	54	2932	54	2844	0.0	0.0189873417721519
chr1	PPT1	40076729	40076913	48	185	54	2932	6	2747	0.2594594594594595	0.002184200946487077
chr1	PPT1	40089409	40089582	0	174	54	2932	54	2758	0.0	0.019579405366207395
chr1	PPT1	40075129	40075245	0	117	54	2932	54	2815	0.0	0.019182948490230906
chr1	COL9A2	40303130	40303185	0	56	46616	4128	46616	4072	0.0	11.447937131630649
chr1	SLFNL1	41017233	41017377	0	145	153	3549	153	3404	0.0	0.04494712103407755
chr1	SCMH1	41033982	41034048	0	67	10699	4464	10699	4397	0.0	2.433249943143052
chr1	SCMH1	41151613	41151684	640	72	10699	4464	10059	4392	8.88888888888889	2.2903005464480874
chr1	SCMH1	41159724	41159933	0	210	10699	4464	10699	4254	0.0	2.515044663845792
chr1	SCMH1	41152598	41152741	5012	144	10699	4464	5687	4320	34.80555555555556	1.3164351851851852
chr1	EDN2	41481094	41481193	342	100	17051	1657	16709	1557	3.42	10.731535003211304
chr1	HIVEP3	41524734	41524910	450	177	65188	14641	64738	14464	2.542372881355932	4.475801991150442
chr1	HIVEP3	41700915	41700995	0	81	65188	14641	65188	14560	0.0	4.477197802197802
chr1	FOXJ3	42205761	42205863	0	103	174	6539	174	6436	0.0	0.027035425730267248
chr1	ZMYND12	42448466	42448638	0	173	652	2189	652	2016	0.0	0.32341269841269843
chr1	ZMYND12	42449917	42450059	0	143	652	2189	652	2046	0.0	0.31867057673509286
chr1	CLDN19	42738228	42738313	0	86	1561	3606	1561	3520	0.0	0.4434659090909091
chr1	P3H1	42751640	42751740	0	101	204	4271	204	4170	0.0	0.04892086330935252
chr1	SLC2A1	42929872	42930035	0	164	7505	4036	7505	3872	0.0	1.9382747933884297
chr1	SLC2A1	42943225	42943321	0	97	7505	4036	7505	3939	0.0	1.9053059152069054
chr1	AC099795.1	42961249	42961471	0	223	55	1102	55	879	0.0	0.06257110352673492
chr1	ELOVL1	43364927	43365008	0	82	0	2516	0	2434	0.0	0.0
chr1	ELOVL1	43365185	43365376	0	192	0	2516	0	2324	0.0	0.0
chr1	HYI	43452902	43453004	0	103	51	1686	51	1583	0.0	0.032217308907138344
chr1	SLC6A9	44011560	44011722	0	163	59419	5268	59419	5105	0.0	11.639373163565132
chr1	ERI3	44283985	44284069	0	85	5394	2800	5394	2715	0.0	1.9867403314917127
chr1	ERI3	44352849	44352925	255	77	5394	2800	5139	2723	3.311688311688312	1.887256702166728
chr1	ERI3	44232239	44232388	662	150	5394	2800	4732	2650	4.413333333333333	1.7856603773584905
chr1	ERI3	44230316	44230470	663	155	5394	2800	4731	2645	4.27741935483871	1.7886578449905481
chr1	ERI3	44241914	44242080	0	167	5394	2800	5394	2633	0.0	2.048613748575769
chr1	ERI3	44339044	44339322	0	279	5394	2800	5394	2521	0.0	2.1396271320904403
chr1	TMEM53	44654939	44655209	0	271	357	3566	357	3295	0.0	0.10834597875569044
chr1	TMEM53	44660173	44660295	0	123	357	3566	357	3443	0.0	0.10368864362474586
chr1	TMEM53	44645359	44645464	0	106	357	3566	357	3460	0.0	0.10317919075144509
chr1	PTCH2	44821841	44821904	0	64	19616	5358	19616	5294	0.0	3.7053267850396674
chr1	EIF2B3	44857703	44857807	0	105	1477	3430	1477	3325	0.0	0.4442105263157895
chr1	EIF2B3	44969977	44970044	0	68	1477	3430	1477	3362	0.0	0.43932183224271265
chr1	MUTYH	45334390	45334511	361	122	57316	5148	56955	5026	2.959016393442623	11.332073219259849
chr1	MUTYH	45329888	45330068	459	181	57316	5148	56857	4967	2.5359116022099446	11.446949869136299
chr1	MUTYH	45331660	45331849	306	190	57316	5148	57010	4958	1.6105263157894736	11.498588140379185
chr1	MUTYH	45333096	45333170	51	75	57316	5148	57265	5073	0.68	11.288192391090085
chr1	MUTYH	45333412	45333561	306	150	57316	5148	57010	4998	2.04	11.40656262505002
chr1	MUTYH	45338506	45338656	562	151	57316	5148	56754	4997	3.7218543046357615	11.357614568741244
chr1	MUTYH	45333412	45333594	335	183	57316	5148	56981	4965	1.830601092896175	11.476535750251763
chr1	MUTYH	45333412	45333564	306	153	57316	5148	57010	4995	2.0	11.413413413413414
chr1	MUTYH	45333412	45333497	275	86	57316	5148	57041	5062	3.197674418604651	11.268470960094824
chr1	MUTYH	45333412	45333603	344	192	57316	5148	56972	4956	1.7916666666666667	11.495560936238903
chr1	TESK2	45385911	45385960	0	50	76825	3331	76825	3281	0.0	23.415117342273696
chr1	MUTYH	45332917	45332959	268	43	57316	5148	57048	5105	6.232558139534884	11.17492654260529
chr1	MUTYH	45331660	45331872	306	213	57316	5148	57010	4935	1.4366197183098592	11.552178318135764
chr1	MUTYH	45333412	45333617	357	206	57316	5148	56959	4942	1.733009708737864	11.525495750708215
chr1	MUTYH	45338185	45338656	1335	472	57316	5148	55981	4676	2.8283898305084745	11.971984602224124
chr1	TESK2	45346692	45346779	773	88	76825	3331	76052	3243	8.784090909090908	23.451125501079247
chr1	CCDC163	45497298	45497383	0	86	51	2764	51	2678	0.0	0.019044062733383122
chr1	CCDC163	45495417	45495545	0	129	51	2764	51	2635	0.0	0.01935483870967742
chr1	CCDC163	45495417	45495473	0	57	51	2764	51	2707	0.0	0.01884004432951607
chr1	CCDC163	45497303	45497383	0	81	51	2764	51	2683	0.0	0.01900857249347745
chr1	CCDC17	45623556	45623652	0	97	0	2792	0	2695	0.0	0.0
chr1	CCDC17	45623216	45623439	0	224	0	2792	0	2568	0.0	0.0
chr1	GPBP1L1	45685575	45685620	0	46	306	7449	306	7403	0.0	0.04133459408347967
chr1	PIK3R3	46055794	46055971	204	178	63799	7408	63595	7230	1.146067415730337	8.795988934993085
chr1	PIK3R3	46131846	46131956	0	111	63799	7408	63799	7297	0.0	8.743182129642319
chr1	POMGNT1	46194843	46194961	0	119	5676	5476	5676	5357	0.0	1.0595482546201231
chr1	KNCN	46549933	46550002	0	70	9845	2938	9845	2868	0.0	3.432705718270572
chr1	MKNK1	46560233	46560277	0	45	3739	6721	3739	6676	0.0	0.5600659077291792
chr1	MKNK1	46574946	46575020	0	75	3739	6721	3739	6646	0.0	0.562594041528739
chr1	MKNK1	46580529	46580627	0	99	3739	6721	3739	6622	0.0	0.5646330413772275
chr1	MKNK1	46571416	46571539	0	124	3739	6721	3739	6597	0.0	0.566772775504017
chr1	MKNK1	46561477	46561642	561	166	3739	6721	3178	6555	3.3795180722891565	0.48482074752097637
chr1	MKNK1	46582813	46582923	0	111	3739	6721	3739	6610	0.0	0.5656580937972768
chr1	MKNK1	46582813	46582905	0	93	3739	6721	3739	6628	0.0	0.5641219070609536
chr1	MKNK1	46585873	46585974	0	102	3739	6721	3739	6619	0.0	0.5648889560356549
chr1	ATPAF1	46653816	46653867	195	52	5609	4748	5414	4696	3.75	1.1528960817717206
chr1	ATPAF1	46663832	46663923	388	92	5609	4748	5221	4656	4.217391304347826	1.1213487972508591
chr1	EFCAB14	46688352	46688544	1797	193	45758	13320	43961	13127	9.310880829015543	3.34889921535766
chr1	EFCAB14	46680059	46680138	0	80	45758	13320	45758	13240	0.0	3.4560422960725075
chr1	EFCAB14	46685082	46685144	0	63	45758	13320	45758	13257	0.0	3.451610469940409
chr1	CYP4A11	46933945	46934079	0	135	51	3867	51	3732	0.0	0.013665594855305467
chr1	CYP4A11	46932982	46933047	0	66	51	3867	51	3801	0.0	0.013417521704814523
chr1	CYP4A11	46934175	46934366	0	192	51	3867	51	3675	0.0	0.013877551020408163
chr1	CYP4A11	46934999	46935154	0	156	51	3867	51	3711	0.0	0.0137429264349232
chr1	CYP4A11	46934999	46935058	0	60	51	3867	51	3807	0.0	0.013396375098502758
chr1	PDZK1IP1	47187318	47187427	0	110	43247	1435	43247	1325	0.0	32.639245283018866
chr1	TAL1	47225442	47225889	0	448	51	5709	51	5261	0.0	0.009693974529557118
chr1	STIL	47312947	47313156	0	210	0	6600	0	6390	0.0	0.0
chr1	STIL	47312947	47313021	0	75	0	6600	0	6525	0.0	0.0
chr1	TRABD2B	47794585	47794760	826	176	32191	7531	31365	7355	4.693181818181818	4.264445955132563
chr1	SPATA6	48413109	48413151	0	43	0	5955	0	5912	0.0	0.0
chr1	SPATA6	48451551	48451600	0	50	0	5955	0	5905	0.0	0.0
chr1	SPATA6	48393254	48393300	0	47	0	5955	0	5908	0.0	0.0
chr1	BEND5	48742622	48742771	0	150	1428	2148	1428	1998	0.0	0.7147147147147147
chr1	BEND5	48736238	48736452	0	215	1428	2148	1428	1933	0.0	0.7387480600103467
chr1	BEND5	48761336	48761470	724	135	1428	2148	704	2013	5.362962962962963	0.34972677595628415
chr1	LINC02808	50318281	50318406	0	126	51	3525	51	3399	0.0	0.01500441306266549
chr1	FAF1	50451792	50452193	0	402	0	7571	0	7169	0.0	0.0
chr1	TTC39A	51296078	51296170	0	93	1301	5284	1301	5191	0.0	0.25062608360624156
chr1	TTC39A	51343006	51343078	0	73	1301	5284	1301	5211	0.0	0.2496641719439647
chr1	EPS15	51468472	51468568	0	97	14146	7406	14146	7309	0.0	1.9354220823642085
chr1	CALR4P	51567173	51567332	0	160	408	2713	408	2553	0.0	0.1598119858989424
chr1	NRDC	51791577	51791661	0	85	5072	6114	5072	6029	0.0	0.8412672084922873
chr1	NRDC	51806793	51806913	0	121	5072	6114	5072	5993	0.0	0.8463207074920741
chr1	NRDC	51837486	51837620	51	135	5072	6114	5021	5979	0.37777777777777777	0.8397725372135809
chr1	NRDC	51836368	51836438	0	71	5072	6114	5072	6043	0.0	0.8393182194274367
chr1	TXNDC12	52030366	52030548	0	183	0	2873	0	2690	0.0	0.0
chr1	TUT4	52458335	52458449	0	115	91877	15476	91877	15361	0.0	5.981186120695267
chr1	TUT4	52481422	52481635	0	214	91877	15476	91877	15262	0.0	6.019984274669113
chr1	TUT4	52497005	52497183	31	179	91877	15476	91846	15297	0.17318435754189945	6.004183826894162
chr1	TUT4	52525562	52526373	2106	812	91877	15476	89771	14664	2.5935960591133007	6.121863066012002
chr1	ECHDC2	52897436	52897484	1047	49	61438	10086	60391	10037	21.367346938775512	6.01683770050812
chr1	ECHDC2	52899173	52899224	640	52	61438	10086	60798	10034	12.307692307692308	6.059198724337254
chr1	ECHDC2	52906518	52906611	305	94	61438	10086	61133	9992	3.24468085106383	6.118194555644515
chr1	ECHDC2	52905033	52905090	527	58	61438	10086	60911	10028	9.086206896551724	6.074092540885521
chr1	ECHDC2	52907867	52907954	1589	88	61438	10086	59849	9998	18.056818181818183	5.986097219443889
chr1	ECHDC2	52915130	52915292	0	163	61438	10086	61438	9923	0.0	6.19147435251436
chr1	ECHDC2	52913894	52914095	51	202	61438	10086	61387	9884	0.2524752475247525	6.210744637798462
chr1	ECHDC2	52917543	52917615	0	73	61438	10086	61438	10013	0.0	6.135823429541596
chr1	SLC1A7	53114757	53114973	0	217	867	3662	867	3445	0.0	0.25166908563134976
chr1	MAGOH	53233541	53233652	0	112	167	1368	167	1256	0.0	0.13296178343949044
chr1	LRP8	53249379	53249556	0	178	79251	13559	79251	13381	0.0	5.922651520813093
chr1	LRP8	53257239	53257464	0	226	79251	13559	79251	13333	0.0	5.943973599339984
chr1	LRP8	53262445	53262564	1461	120	79251	13559	77790	13439	12.175	5.788377111392217
chr1	LRP8	53271027	53271153	65	127	79251	13559	79186	13432	0.5118110236220472	5.8953245979749855
chr1	LRP8	53271226	53271346	0	121	79251	13559	79251	13438	0.0	5.8975293942550975
chr1	LRP8	53276691	53277078	1332	388	79251	13559	77919	13171	3.4329896907216493	5.915951712094754
chr1	LRP8	53275630	53275753	48	124	79251	13559	79203	13435	0.3870967741935484	5.895273539263119
chr1	LRP8	53248462	53248591	0	130	79251	13559	79251	13429	0.0	5.90148186759997
chr1	LRP8	53246955	53247056	0	102	79251	13559	79251	13457	0.0	5.889202645463327
chr1	LRP8	53280586	53280715	0	130	79251	13559	79251	13429	0.0	5.90148186759997
chr1	LRP8	53246923	53247056	0	134	79251	13559	79251	13425	0.0	5.903240223463687
chr1	LRP8	53271226	53271415	0	190	79251	13559	79251	13369	0.0	5.927967686438777
chr1	LRP8	53272603	53272642	0	40	79251	13559	79251	13519	0.0	5.862193949256602
chr1	LRP8	53254910	53254957	54	48	79251	13559	79197	13511	1.125	5.861668270298275
chr1	LRP8	53249379	53249440	0	62	79251	13559	79251	13497	0.0	5.871749277617249
chr1	LRP8	53258008	53258074	0	67	79251	13559	79251	13492	0.0	5.873925289060184
chr1	LINC02812	53367414	53367485	4172	72	29157	936	24985	864	57.94444444444444	28.917824074074073
chr1	SLC25A3P1	53415400	53415524	38	125	38	1834	0	1709	0.304	0.0
chr1	NDC1	53835499	53835620	0	122	4250	4738	4250	4616	0.0	0.9207105719237435
chr1	YIPF1	53855000	53855051	0	52	0	2050	0	1998	0.0	0.0
chr1	YIPF1	53883112	53883276	0	165	0	2050	0	1885	0.0	0.0
chr1	YIPF1	53888906	53888986	0	81	0	2050	0	1969	0.0	0.0
chr1	YIPF1	53889243	53889463	0	221	0	2050	0	1829	0.0	0.0
chr1	LDLRAD1	54014235	54014364	1479	130	10460	2382	8981	2252	11.376923076923077	3.988010657193606
chr1	LDLRAD1	54012142	54012280	644	139	10460	2382	9816	2243	4.633093525179856	4.376281765492644
chr1	LDLRAD1	54017375	54017427	0	53	10460	2382	10460	2329	0.0	4.491197939029626
chr1	TMEM59	54047266	54047372	1060	107	27443	9158	26383	9051	9.906542056074766	2.91492652745553
chr1	TMEM59	54048649	54048682	0	34	27443	9158	27443	9124	0.0	3.007781674704077
chr1	CYB5RL	54187651	54187739	450	89	8687	8739	8237	8650	5.056179775280899	0.9522543352601156
chr1	CYB5RL	54190747	54190896	255	150	8687	8739	8432	8589	1.7	0.9817208056816858
chr1	CYB5RL	54179983	54180233	0	251	8687	8739	8687	8488	0.0	1.023444863336475
chr1	CYB5RL	54186180	54186286	0	107	8687	8739	8687	8632	0.0	1.006371640407785
chr1	CYB5RL	54179148	54179352	45	205	8687	8739	8642	8534	0.21951219512195122	1.0126552613077104
chr1	CYB5RL	54190737	54190896	255	160	8687	8739	8432	8579	1.59375	0.9828651357967129
chr1	SSBP3	54257126	54257186	2	61	16221	3706	16219	3645	0.03278688524590164	4.44965706447188
chr1	SSBP3	54258068	54258149	442	82	16221	3706	15779	3624	5.390243902439025	4.354028697571744
chr1	DHCR24	54877901	54877998	0	98	2550	4979	2550	4881	0.0	0.5224339274738783
chr1	DHCR24	54855988	54856024	0	37	2550	4979	2550	4942	0.0	0.5159854309995953
chr1	DHCR24	54879748	54879805	0	58	2550	4979	2550	4921	0.0	0.5181873602926235
chr1	AL590440.2	54977724	54977862	0	139	0	1589	0	1450	0.0	0.0
chr1	AL590440.2	54979558	54979643	0	86	0	1589	0	1503	0.0	0.0
chr1	USP24	55151911	55151975	0	65	824	12094	824	12029	0.0	0.06850112228780447
chr1	LINC01753	55921364	55921411	58	48	58	710	0	662	1.2083333333333333	0.0
chr1	LINC01753	55921311	55921411	58	101	58	710	0	609	0.5742574257425742	0.0
chr1	AC119674.1	56172555	56172666	0	112	0	6862	0	6750	0.0	0.0
chr1	AC119674.1	56236374	56236434	0	61	0	6862	0	6801	0.0	0.0
chr1	AC119674.1	56166079	56166159	0	81	0	6862	0	6781	0.0	0.0
chr1	AC119674.1	56168238	56168342	0	105	0	6862	0	6757	0.0	0.0
chr1	AC119674.1	56253652	56253893	0	242	0	6862	0	6620	0.0	0.0
chr1	AC119674.1	56258368	56258500	0	133	0	6862	0	6729	0.0	0.0
chr1	AC119674.1	56332292	56332406	0	115	0	6862	0	6747	0.0	0.0
chr1	AC119674.2	56478885	56479111	0	227	0	2666	0	2439	0.0	0.0
chr1	AC119674.1	56341660	56341728	0	69	0	6862	0	6793	0.0	0.0
chr1	AC119674.1	56304464	56304560	0	97	0	6862	0	6765	0.0	0.0
chr1	AC119674.1	56318385	56318576	0	192	0	6862	0	6670	0.0	0.0
chr1	AC119674.2	56400093	56400267	0	175	0	2666	0	2491	0.0	0.0
chr1	FYB2	56738624	56738653	0	30	613	4670	613	4640	0.0	0.13211206896551725
chr1	FYB2	56742160	56742221	0	62	613	4670	613	4608	0.0	0.1330295138888889
chr1	C8B	56959528	56959657	998	130	3738	2746	2740	2616	7.676923076923077	1.047400611620795
chr1	C8B	56963771	56963993	0	223	3738	2746	3738	2523	0.0	1.4815695600475625
chr1	OMA1	58506059	58506209	0	151	0	3704	0	3553	0.0	0.0
chr1	OMA1	58538794	58539310	0	517	0	3704	0	3187	0.0	0.0
chr1	MYSM1	58671869	58671958	0	90	51	13140	51	13050	0.0	0.003908045977011494
chr1	MYSM1	58663449	58663522	0	74	51	13140	51	13066	0.0	0.0039032603704270627
chr1	LINC02777	58889148	58889208	0	61	29	1976	29	1915	0.0	0.015143603133159269
chr1	LINC02777	58896997	58897090	5	94	29	1976	24	1882	0.05319148936170213	0.012752391073326248
chr1	LINC02777	58884871	58885005	0	135	29	1976	29	1841	0.0	0.015752308527973928
chr1	HSD52	59198182	59198512	0	331	16526	6497	16526	6166	0.0	2.6801816412585144
chr1	HSD52	59203094	59203306	0	213	16526	6497	16526	6284	0.0	2.6298535964353915
chr1	CYP2J2	59904870	59905058	0	189	0	2983	0	2794	0.0	0.0
chr1	CYP2J2	59904365	59904516	0	152	0	2983	0	2831	0.0	0.0
chr1	LINC01748	60588036	60588162	0	127	0	15481	0	15354	0.0	0.0
chr1	LINC01748	60537680	60537788	0	109	0	15481	0	15372	0.0	0.0
chr1	LINC01748	60528918	60529249	0	332	0	15481	0	15149	0.0	0.0
chr1	LINC01748	60554472	60554568	0	97	0	15481	0	15384	0.0	0.0
chr1	LINC01748	60573337	60573413	0	77	0	15481	0	15404	0.0	0.0
chr1	LINC01748	60600126	60600250	0	125	0	15481	0	15356	0.0	0.0
chr1	LINC01748	60640010	60640126	0	117	0	15481	0	15364	0.0	0.0
chr1	LINC01748	60543476	60543521	0	46	0	15481	0	15435	0.0	0.0
chr1	LINC01748	60600126	60600270	0	145	0	15481	0	15336	0.0	0.0
chr1	AC099792.1	60733463	60733522	0	60	0	4307	0	4247	0.0	0.0
chr1	AC099792.1	60729574	60729667	0	94	0	4307	0	4213	0.0	0.0
chr1	AC099792.1	60726409	60726476	0	68	0	4307	0	4239	0.0	0.0
chr1	AC099792.1	60677195	60677412	0	218	0	4307	0	4089	0.0	0.0
chr1	AC099792.1	60732446	60732508	0	63	0	4307	0	4244	0.0	0.0
chr1	AC099792.1	60704777	60704959	0	183	0	4307	0	4124	0.0	0.0
chr1	NFIA-AS2	60969930	60970065	0	136	0	5402	0	5266	0.0	0.0
chr1	NFIA-AS2	60963565	60963804	0	240	0	5402	0	5162	0.0	0.0
chr1	NFIA-AS1	61249947	61249981	0	35	0	846	0	811	0.0	0.0
chr1	NFIA-AS1	61251284	61251369	0	86	0	846	0	760	0.0	0.0
chr1	NFIA-AS1	61251284	61251407	0	124	0	846	0	722	0.0	0.0
chr1	NFIA-AS1	61249947	61250128	0	182	0	846	0	664	0.0	0.0
chr1	TM2D1	61723712	61723772	0	61	0	5509	0	5448	0.0	0.0
chr1	TM2D1	61724287	61724425	0	139	0	5509	0	5370	0.0	0.0
chr1	TM2D1	61686791	61686895	0	105	0	5509	0	5404	0.0	0.0
chr1	KANK4	62273203	62275087	0	1885	2232	6824	2232	4939	0.0	0.4519133427819397
chr1	DOCK7	62543655	62543745	0	91	8017	19101	8017	19010	0.0	0.4217254076801683
chr1	DOCK7	62544946	62545039	0	94	8017	19101	8017	19007	0.0	0.4217919713789656
chr1	DOCK7	62583183	62583254	0	72	8017	19101	8017	19029	0.0	0.4213043249776657
chr1	DOCK7	62543285	62543321	0	37	8017	19101	8017	19064	0.0	0.42053084347461184
chr1	DOCK7	62633899	62633935	0	37	8017	19101	8017	19064	0.0	0.42053084347461184
chr1	LINC01739	63010877	63010987	51	111	1975	2075	1924	1964	0.4594594594594595	0.9796334012219959
chr1	LINC00466	63185558	63185661	0	104	2776	6950	2776	6846	0.0	0.40549225825299445
chr1	LINC00466	63197142	63197389	0	248	2776	6950	2776	6702	0.0	0.41420471501044465
chr1	LINC00466	63198715	63199001	0	287	2776	6950	2776	6663	0.0	0.4166291460303167
chr1	LINC00466	63164243	63164355	0	113	2776	6950	2776	6837	0.0	0.40602603481058946
chr1	LINC00466	63183439	63183579	0	141	2776	6950	2776	6809	0.0	0.40769569687178736
chr1	LINC00466	63160887	63161172	51	286	2776	6950	2725	6664	0.17832167832167833	0.40891356542617047
chr1	LINC00466	63203104	63203167	25	64	2776	6950	2751	6886	0.390625	0.3995062445541679
chr1	LINC00466	63170151	63170424	0	274	2776	6950	2776	6676	0.0	0.4158178550029958
chr1	LINC00466	63171117	63171175	0	59	2776	6950	2776	6891	0.0	0.4028442896531708
chr1	LINC00466	63200804	63201013	0	210	2776	6950	2776	6740	0.0	0.4118694362017804
chr1	LINC00466	63244355	63244478	0	124	2776	6950	2776	6826	0.0	0.40668033987694113
chr1	LINC00466	63198715	63199020	0	306	2776	6950	2776	6644	0.0	0.41782059000602045
chr1	LINC00466	63257984	63258050	0	67	2776	6950	2776	6883	0.0	0.4033125090803429
chr1	LINC00466	63261741	63262700	342	960	2776	6950	2434	5990	0.35625	0.4063439065108514
chr1	FOXD3-AS1	63321664	63322080	0	417	255	1214	255	797	0.0	0.3199498117942284
chr1	ITGB3BP	63446805	63446856	0	52	0	5316	0	5264	0.0	0.0
chr1	ITGB3BP	63508527	63508570	0	44	0	5316	0	5272	0.0	0.0
chr1	ITGB3BP	63510064	63510181	0	118	0	5316	0	5198	0.0	0.0
chr1	ITGB3BP	63447564	63447614	0	51	0	5316	0	5265	0.0	0.0
chr1	ROR1-AS1	64108319	64108393	0	75	58222	4585	58222	4510	0.0	12.909534368070954
chr1	ROR1-AS1	64111111	64111369	102	259	58222	4585	58120	4326	0.3938223938223938	13.435043920480814
chr1	ROR1-AS1	64113628	64113791	0	164	58222	4585	58222	4421	0.0	13.169418683555756
chr1	JAK1	64841450	64841601	0	152	51	11649	51	11497	0.0	0.004435939810385318
chr1	JAK1	64956933	64957017	0	85	51	11649	51	11564	0.0	0.004410238671739883
chr1	JAK1	64841555	64841601	0	47	51	11649	51	11602	0.0	0.004395793828650233
chr1	JAK1	64882891	64883063	0	173	51	11649	51	11476	0.0	0.004444057162774486
chr1	JAK1	65044479	65044582	0	104	51	11649	51	11545	0.0	0.0044174967518406235
chr1	LINC01359	64989585	64989668	0	84	0	5118	0	5034	0.0	0.0
chr1	LINC01359	64993476	64993581	0	106	0	5118	0	5012	0.0	0.0
chr1	LINC01359	64993471	64993581	0	111	0	5118	0	5007	0.0	0.0
chr1	LINC01359	64992748	64992889	0	142	0	5118	0	4976	0.0	0.0
chr1	LINC01359	65001897	65001965	0	69	0	5118	0	5049	0.0	0.0
chr1	LINC01359	64987262	64987673	0	412	0	5118	0	4706	0.0	0.0
chr1	DNAI4	66827811	66827910	0	100	4444	6353	4444	6253	0.0	0.7106988645450184
chr1	DNAI4	66835625	66835777	204	153	4444	6353	4240	6200	1.3333333333333333	0.6838709677419355
chr1	DNAI4	66847483	66847678	0	196	4444	6353	4444	6157	0.0	0.7217800877050512
chr1	DNAI4	66874780	66874937	0	158	4444	6353	4444	6195	0.0	0.7173527037933818
chr1	DNAI4	66919017	66919116	0	100	4444	6353	4444	6253	0.0	0.7106988645450184
chr1	C1ORF141	67095234	67095421	0	188	0	3403	0	3215	0.0	0.0
chr1	C1ORF141	67115351	67115464	0	114	0	3403	0	3289	0.0	0.0
chr1	C1ORF141	67113613	67113756	0	144	0	3403	0	3259	0.0	0.0
chr1	WLS	68193954	68194221	0	268	157360	4383	157360	4115	0.0	38.24058323207777
chr1	WLS	68193954	68194227	0	274	157360	4383	157360	4109	0.0	38.29642248722317
chr1	WLS	68228220	68228255	0	36	157360	4383	157360	4347	0.0	36.19967793880837
chr1	WLS	68186539	68186649	0	111	157360	4383	157360	4272	0.0	36.835205992509366
chr1	DEPDC1	68482045	68482897	0	853	0	5916	0	5063	0.0	0.0
chr1	DEPDC1	68494429	68494695	0	267	0	5916	0	5649	0.0	0.0
chr1	DEPDC1	68483272	68483305	0	34	0	5916	0	5882	0.0	0.0
chr1	ANKRD13C	70313744	70313790	0	47	0	2923	0	2876	0.0	0.0
chr1	ANKRD13C	70324852	70324957	0	106	0	2923	0	2817	0.0	0.0
chr1	PTGER3	70974296	70974388	0	93	86	6851	86	6758	0.0	0.012725658478839894
chr1	PTGER3	70953762	70953789	0	28	86	6851	86	6823	0.0	0.01260442620548146
chr1	ZRANB2	71065677	71065752	18	76	143	3973	125	3897	0.23684210526315788	0.03207595586348473
chr1	AL583808.1	72766644	72766687	0	44	51	2770	51	2726	0.0	0.018708730741012473
chr1	AL583808.1	72850749	72850800	0	52	51	2770	51	2718	0.0	0.018763796909492272
chr1	AL583808.1	72700939	72701063	0	125	51	2770	51	2645	0.0	0.019281663516068054
chr1	AL583808.1	72756530	72756558	0	29	51	2770	51	2741	0.0	0.018606348048157608
chr1	AL583808.1	72735556	72735635	0	80	51	2770	51	2690	0.0	0.01895910780669145
chr1	AL591463.1	73905928	73906012	0	85	0	3781	0	3696	0.0	0.0
chr1	LRRIQ3	74041212	74041933	0	722	0	6363	0	5641	0.0	0.0
chr1	LRRIQ3	74182537	74182861	0	325	0	6363	0	6038	0.0	0.0
chr1	LRRIQ3	74041690	74041933	0	244	0	6363	0	6119	0.0	0.0
chr1	ERICH3	74623047	74623285	0	239	4520	8847	4520	8608	0.0	0.525092936802974
chr1	CRYZ	74707102	74707204	0	103	0	3988	0	3885	0.0	0.0
chr1	CRYZ	74719208	74719372	0	165	0	3988	0	3823	0.0	0.0
chr1	CRYZ	74724710	74724834	0	125	0	3988	0	3863	0.0	0.0
chr1	CRYZ	74730381	74730420	0	40	0	3988	0	3948	0.0	0.0
chr1	AL137803.1	75723667	75723788	0	122	0	1996	0	1874	0.0	0.0
chr1	PIGK	77166718	77166830	0	113	0	5525	0	5412	0.0	0.0
chr1	PIGK	77210435	77210489	0	55	0	5525	0	5470	0.0	0.0
chr1	ZZZ3	77631849	77633405	43784	1557	45721	9025	1937	7468	28.120745022479127	0.25937332619175146
chr1	ZZZ3	77641383	77641446	0	64	45721	9025	45721	8961	0.0	5.102220734293048
chr1	USP33	77701368	77701471	0	104	5396	6945	5396	6841	0.0	0.788773571115334
chr1	USP33	77714613	77714783	0	171	5396	6945	5396	6774	0.0	0.7965751402421022
chr1	USP33	77745420	77745599	0	180	5396	6945	5396	6765	0.0	0.7976348854397635
chr1	USP33	77746398	77746556	0	159	5396	6945	5396	6786	0.0	0.7951665193044504
chr1	FUBP1	77945505	77945642	0	138	1434	4700	1434	4562	0.0	0.3143358176238492
chr1	FUBP1	77969021	77969084	330	64	1434	4700	1104	4636	5.15625	0.23813632441760138
chr1	ADGRL4	78921612	78921786	0	175	6644	5737	6644	5562	0.0	1.194534340165408
chr1	ADGRL4	78926885	78927091	0	207	6644	5737	6644	5530	0.0	1.2014466546112115
chr1	ADGRL4	79005069	79005219	5847	151	6644	5737	797	5586	38.72185430463576	0.1426781238811314
chr1	ADGRL4	78921612	78921805	0	194	6644	5737	6644	5543	0.0	1.1986289013169764
chr1	AL157944.1	82684437	82684573	0	137	51	7228	51	7091	0.0	0.007192215484416866
chr1	LINC01725	83849906	83850022	0	117	51	12439	51	12322	0.0	0.004138938484012335
chr1	TTLL7	83942462	83942679	0	218	0	10574	0	10356	0.0	0.0
chr1	TTLL7	83887176	83887284	0	109	0	10574	0	10465	0.0	0.0
chr1	TTLL7	83882668	83882787	0	120	0	10574	0	10454	0.0	0.0
chr1	TTLL7	83933607	83933766	0	160	0	10574	0	10414	0.0	0.0
chr1	CTBS	84569930	84570139	0	210	18185	6941	18185	6731	0.0	2.7016787995840144
chr1	SSX2IP	84671176	84671308	0	133	21044	8472	21044	8339	0.0	2.5235639764959825
chr1	SSX2IP	84649670	84649948	5414	279	21044	8472	15630	8193	19.405017921146953	1.9077261076528744
chr1	SSX2IP	84655464	84655588	147	125	21044	8472	20897	8347	1.176	2.503534203905595
chr1	SSX2IP	84680337	84680387	0	51	21044	8472	21044	8421	0.0	2.4989906186913666
chr1	MCOLN3	85041009	85041177	0	169	12191	6622	12191	6453	0.0	1.8891988222532154
chr1	MCOLN3	85047309	85047609	0	301	12191	6622	12191	6321	0.0	1.9286505299794336
chr1	MCOLN3	85036709	85036868	0	160	12191	6622	12191	6462	0.0	1.8865676261219437
chr1	MCOLN3	85047574	85047609	0	36	12191	6622	12191	6586	0.0	1.8510476768903734
chr1	AC092807.3	85494728	85494761	0	34	2140	1635	2140	1601	0.0	1.3366645846346035
chr1	COL24A1	85960757	85960880	1269	124	163098	9632	161829	9508	10.233870967741936	17.020298695835088
chr1	COL24A1	85736145	85736559	95640	415	163098	9632	67458	9217	230.4578313253012	7.318867310404687
chr1	LINC02795	86315603	86315747	0	145	0	2891	0	2746	0.0	0.0
chr1	ODF2L	86356443	86356602	0	160	61	7821	61	7661	0.0	0.007962406996475655
chr1	ODF2L	86368635	86368722	0	88	61	7821	61	7733	0.0	0.007888271046165784
chr1	ODF2L	86382241	86382358	0	118	61	7821	61	7703	0.0	0.007918992600285602
chr1	ODF2L	86385457	86385590	0	134	61	7821	61	7687	0.0	0.007935475478079875
chr1	ODF2L	86386914	86387079	0	166	61	7821	61	7655	0.0	0.007968647942521228
chr1	ODF2L	86386914	86387086	0	173	61	7821	61	7648	0.0	0.007975941422594142
chr1	ODF2L	86355344	86355383	0	40	61	7821	61	7781	0.0	0.007839609304716617
chr1	SELENOF	86868052	86868102	0	51	0	2208	0	2157	0.0	0.0
chr1	SELENOF	86866071	86866169	0	99	0	2208	0	2109	0.0	0.0
chr1	SELENOF	86887155	86887196	0	42	0	2208	0	2166	0.0	0.0
chr1	PKN2-AS1	87903898	87904077	57	180	1303	16670	1246	16490	0.31666666666666665	0.07556094602789569
chr1	GTF2B	88887260	88887367	0	108	26	2533	26	2425	0.0	0.010721649484536083
chr1	GTF2B	88887275	88887367	0	93	26	2533	26	2440	0.0	0.010655737704918032
chr1	KYAT3	88988251	88988351	0	101	0	2212	0	2111	0.0	0.0
chr1	GBP3	89020531	89020743	0	213	435	4282	435	4069	0.0	0.10690587367903662
chr1	GBP3	89020125	89020211	0	87	435	4282	435	4195	0.0	0.10369487485101311
chr1	GBP3	89020129	89020211	0	83	435	4282	435	4199	0.0	0.10359609430816862
chr1	GBP3	89020352	89020743	0	392	435	4282	435	3890	0.0	0.11182519280205655
chr1	AL627316.1	90395444	90395521	102	78	46338	3004	46236	2926	1.3076923076923077	15.801777170198223
chr1	LINC02609	90789397	90789487	0	91	51	14100	51	14009	0.0	0.0036405168106217432
chr1	LINC02609	90831929	90832196	0	268	51	14100	51	13832	0.0	0.003687102371312898
chr1	LINC02609	90837549	90837765	0	217	51	14100	51	13883	0.0	0.003673557588417489
chr1	HFM1	91319077	91319209	0	133	12687	5855	12687	5722	0.0	2.217231737154841
chr1	HFM1	91323092	91323199	0	108	12687	5855	12687	5747	0.0	2.207586566904472
chr1	HFM1	91266016	91266107	0	92	12687	5855	12687	5763	0.0	2.2014575741801146
chr1	HFM1	91396292	91396405	11	114	12687	5855	12676	5741	0.09649122807017543	2.2079777042327122
chr1	HFM1	91316390	91316476	0	87	12687	5855	12687	5768	0.0	2.1995492371705962
chr1	HFM1	91394092	91394402	612	311	12687	5855	12075	5544	1.9678456591639872	2.178030303030303
chr1	TGFBR3	91800958	91801055	0	98	886	8604	886	8506	0.0	0.1041617681636492
chr1	TGFBR3	91866755	91866842	119	88	886	8604	767	8516	1.3522727272727273	0.09006575857209957
chr1	GLMN	92264553	92264638	0	86	5119	2929	5119	2843	0.0	1.800562785789659
chr1	GLMN	92266699	92266741	0	43	5119	2929	5119	2886	0.0	1.7737352737352738
chr1	EVI5	92663419	92663452	0	34	1587	8299	1587	8265	0.0	0.19201451905626135
chr1	EVI5	92662718	92662865	0	148	1587	8299	1587	8151	0.0	0.19470003680529996
chr1	DIPK1A	92876295	92876430	0	136	5328	3098	5328	2962	0.0	1.7987846049966238
chr1	DIPK1A	92847182	92847359	0	178	5328	3098	5328	2920	0.0	1.8246575342465754
chr1	TMED5	93158814	93158885	0	72	4266	9216	4266	9144	0.0	0.46653543307086615
chr1	TMED5	93156035	93156084	0	50	4266	9216	4266	9166	0.0	0.46541566659393413
chr1	CCDC18-AS1	93269682	93269758	0	77	32571	4958	32571	4881	0.0	6.673017824216349
chr1	CCDC18-AS1	93318167	93318228	0	62	32571	4958	32571	4896	0.0	6.6525735294117645
chr1	CCDC18-AS1	93290564	93290686	0	123	32571	4958	32571	4835	0.0	6.736504653567735
chr1	CCDC18-AS1	93309539	93309634	1147	96	32571	4958	31424	4862	11.947916666666666	6.463183874948581
chr1	CCDC18-AS1	93309714	93309790	911	77	32571	4958	31660	4881	11.831168831168831	6.486375742675682
chr1	CCDC18-AS1	93311489	93311608	0	120	32571	4958	32571	4838	0.0	6.7323274080198425
chr1	CCDC18-AS1	93326601	93326662	0	62	32571	4958	32571	4896	0.0	6.6525735294117645
chr1	CCDC18-AS1	93337376	93339274	0	1899	32571	4958	32571	3059	0.0	10.647597254004577
chr1	CCDC18-AS1	93339155	93339274	0	120	32571	4958	32571	4838	0.0	6.7323274080198425
chr1	CCDC18-AS1	93345539	93345590	0	52	32571	4958	32571	4906	0.0	6.639013452914798
chr1	DNTTIP2	93875644	93875783	0	140	2040	6505	2040	6365	0.0	0.32050274941084056
chr1	GCLM	93904522	93904588	0	67	204	5434	204	5367	0.0	0.03801006148686417
chr1	ABCA4	94056600	94056822	867	223	96245	8539	95378	8316	3.8878923766816142	11.46921596921597
chr1	F3	94532320	94532480	0	161	0	2893	0	2732	0.0	0.0
chr1	SLC44A3-AS1	94732257	94732437	0	181	9674	10264	9674	10083	0.0	0.9594366755925816
chr1	SLC44A3-AS1	94770261	94770313	0	53	9674	10264	9674	10211	0.0	0.9474096562530604
chr1	SLC44A3-AS1	94742268	94742414	102	147	9674	10264	9572	10117	0.6938775510204082	0.9461302757734507
chr1	SLC44A3-AS1	94705438	94705557	0	120	9674	10264	9674	10144	0.0	0.9536671924290221
chr1	SLC44A3-AS1	94743837	94743993	0	157	9674	10264	9674	10107	0.0	0.957158405065796
chr1	CNN3	94902120	94902258	0	139	9458	2792	9458	2653	0.0	3.5650207312476443
chr1	AC092802.1	95180333	95180359	0	27	0	4080	0	4053	0.0	0.0
chr1	AC092802.2	95249354	95249448	0	95	0	1425	0	1330	0.0	0.0
chr1	AL445218.1	95372580	95372656	649	77	2026	883	1377	806	8.428571428571429	1.7084367245657568
chr1	DPYD	97720824	97720926	0	103	1217	7161	1217	7058	0.0	0.17242844998583168
chr1	PLPPR5	98897261	98897389	0	129	0	4707	0	4578	0.0	0.0
chr1	FRRS1	99712104	99712163	0	60	0	8643	0	8583	0.0	0.0
chr1	LRRC39	100149365	100149435	0	71	4310	1986	4310	1915	0.0	2.2506527415143602
chr1	EXTL2	100876793	100876864	0	72	0	4022	0	3950	0.0	0.0
chr1	EXTL2	100878423	100878447	0	25	0	4022	0	3997	0.0	0.0
chr1	EXTL2	100878393	100878447	0	55	0	4022	0	3967	0.0	0.0
chr1	DPH5	100992636	100992740	0	105	0	2126	0	2021	0.0	0.0
chr1	DPH5	101001466	101001587	0	122	0	2126	0	2004	0.0	0.0
chr1	DPH5	101013709	101013818	0	110	0	2126	0	2016	0.0	0.0
chr1	DPH5	101025308	101025466	0	159	0	2126	0	1967	0.0	0.0
chr1	OLFM3	101812409	101813146	0	738	0	4403	0	3665	0.0	0.0
chr1	COL11A1	103025799	103025952	0	154	245	8948	245	8794	0.0	0.027859904480327494
chr1	COL11A1	103026215	103026332	0	118	245	8948	245	8830	0.0	0.027746319365798414
chr1	COL11A1	102979596	102979612	0	17	245	8948	245	8931	0.0	0.02743253834956892
chr1	AC095032.1	103418744	103418815	0	72	78	2780	78	2708	0.0	0.02880354505169867
chr1	AC095032.1	103469341	103469390	0	50	78	2780	78	2730	0.0	0.02857142857142857
chr1	LINC01676	105604162	105604265	0	104	0	3046	0	2942	0.0	0.0
chr1	LINC01676	105600630	105600759	0	130	0	3046	0	2916	0.0	0.0
chr1	LINC01676	105603276	105603558	0	283	0	3046	0	2763	0.0	0.0
chr1	LINC01676	105604162	105604260	0	99	0	3046	0	2947	0.0	0.0
chr1	LINC01676	105612899	105612944	0	46	0	3046	0	3000	0.0	0.0
chr1	LINC01676	105601269	105601385	0	117	0	3046	0	2929	0.0	0.0
chr1	LINC01676	105603276	105603562	0	287	0	3046	0	2759	0.0	0.0
chr1	LINC01677	105954509	105954711	0	203	0	3134	0	2931	0.0	0.0
chr1	VAV3	107683487	107683533	0	47	0	7345	0	7298	0.0	0.0
chr1	VAV3	107576391	107576475	0	85	0	7345	0	7260	0.0	0.0
chr1	VAV3	107609423	107609539	0	117	0	7345	0	7228	0.0	0.0
chr1	SLC25A24	108181940	108182028	0	89	102	5275	102	5186	0.0	0.019668337832626302
chr1	NBPF4	108237010	108237097	0	88	0	2602	0	2514	0.0	0.0
chr1	HENMT1	108655585	108655698	0	114	390	2436	390	2322	0.0	0.16795865633074936
chr1	HENMT1	108659863	108659962	390	100	390	2436	0	2336	3.9	0.0
chr1	HENMT1	108649340	108649433	0	94	390	2436	390	2342	0.0	0.16652433817250215
chr1	AKNAD1	108820544	108820626	0	83	3848	5057	3848	4974	0.0	0.7736228387615601
chr1	AKNAD1	108834446	108834528	0	83	3848	5057	3848	4974	0.0	0.7736228387615601
chr1	AKNAD1	108834928	108835056	0	129	3848	5057	3848	4928	0.0	0.7808441558441559
chr1	CLCC1	108941404	108941498	0	95	2556	6514	2556	6419	0.0	0.39819286493223244
chr1	CLCC1	108943835	108944057	0	223	2556	6514	2556	6291	0.0	0.4062947067238913
chr1	CLCC1	108947337	108947508	0	172	2556	6514	2556	6342	0.0	0.4030274361400189
chr1	CLCC1	108950308	108950448	160	141	2556	6514	2396	6373	1.1347517730496455	0.3759610858308489
chr1	CLCC1	108962308	108962469	0	162	2556	6514	2556	6352	0.0	0.40239294710327456
chr1	CLCC1	108938165	108938308	258	144	2556	6514	2298	6370	1.7916666666666667	0.3607535321821036
chr1	CLCC1	108943835	108943907	0	73	2556	6514	2556	6441	0.0	0.39683278993945037
chr1	CLCC1	108950308	108950438	153	131	2556	6514	2403	6383	1.16793893129771	0.376468745104183
chr1	CLCC1	108950308	108950394	147	87	2556	6514	2409	6427	1.6896551724137931	0.3748249572117629
chr1	CLCC1	108938165	108938216	150	52	2556	6514	2406	6462	2.8846153846153846	0.372330547818013
chr1	CLCC1	108943474	108943615	0	142	2556	6514	2556	6372	0.0	0.4011299435028249
chr1	CLCC1	108962308	108962464	0	157	2556	6514	2556	6357	0.0	0.40207645115620577
chr1	CLCC1	108941404	108941494	0	91	2556	6514	2556	6423	0.0	0.3979448855674918
chr1	WDR47	109017517	109017601	0	85	3840	4440	3840	4355	0.0	0.8817451205510907
chr1	WDR47	109023354	109023521	0	168	3840	4440	3840	4272	0.0	0.898876404494382
chr1	WDR47	109024864	109024992	0	129	3840	4440	3840	4311	0.0	0.8907446068197634
chr1	C1ORF194	109107920	109108037	0	118	0	1232	0	1114	0.0	0.0
chr1	C1ORF194	109107006	109107122	0	117	0	1232	0	1115	0.0	0.0
chr1	SORT1	109314260	109314384	0	125	12716	9152	12716	9027	0.0	1.408662900188324
chr1	SORT1	109397206	109397340	0	135	12716	9152	12716	9017	0.0	1.4102251303094155
chr1	GSTM3	109739832	109739908	0	77	51	4562	51	4485	0.0	0.01137123745819398
chr1	SLC16A4	110378852	110379356	357	505	2809	3174	2452	2669	0.7069306930693069	0.9186961408767329
chr1	SLC16A4	110381651	110381795	229	145	2809	3174	2580	3029	1.5793103448275863	0.8517662594915814
chr1	SLC16A4	110382833	110382966	51	134	2809	3174	2758	3040	0.3805970149253731	0.9072368421052631
chr1	LAMTOR5	110407032	110407128	138	97	954	1329	816	1232	1.422680412371134	0.6623376623376623
chr1	LRIF1	110951287	110952815	408	1529	17938	3506	17530	1977	0.2668410725964683	8.866970156803237
chr1	DRAM2	111124741	111124881	0	141	0	3309	0	3168	0.0	0.0
chr1	DRAM2	111139500	111139666	0	167	0	3309	0	3142	0.0	0.0
chr1	DRAM2	111122615	111122643	0	29	0	3309	0	3280	0.0	0.0
chr1	DRAM2	111139587	111139711	0	125	0	3309	0	3184	0.0	0.0
chr1	KCND3	111778435	111778492	0	58	52472	8036	52472	7978	0.0	6.577086989220356
chr1	LINC02884	112238069	112238198	0	130	36782	6272	36782	6142	0.0	5.988603060892218
chr1	LINC02884	112271351	112271605	0	255	36782	6272	36782	6017	0.0	6.113013129466512
chr1	ST7L	112550600	112550693	0	94	0	7822	0	7728	0.0	0.0
chr1	ST7L	112555867	112556018	0	152	0	7822	0	7670	0.0	0.0
chr1	ST7L	112581991	112582106	0	116	0	7822	0	7706	0.0	0.0
chr1	ST7L	112583971	112584126	0	156	0	7822	0	7666	0.0	0.0
chr1	ST7L	112600793	112600848	0	56	0	7822	0	7766	0.0	0.0
chr1	ST7L	112616812	112616895	0	84	0	7822	0	7738	0.0	0.0
chr1	ST7L	112540778	112540872	0	95	0	7822	0	7727	0.0	0.0
chr1	ST7L	112541950	112542090	0	141	0	7822	0	7681	0.0	0.0
chr1	ST7L	112618908	112619139	0	232	0	7822	0	7590	0.0	0.0
chr1	ST7L	112616812	112616844	0	33	0	7822	0	7789	0.0	0.0
chr1	RHOC	112705099	112705168	0	70	0	2792	0	2722	0.0	0.0
chr1	RHOC	112705099	112706252	0	1154	0	2792	0	1638	0.0	0.0
chr1	RHOC	112703383	112703457	0	75	0	2792	0	2717	0.0	0.0
chr1	RHOC	112705099	112705123	0	25	0	2792	0	2767	0.0	0.0
chr1	RHOC	112705052	112705168	0	117	0	2792	0	2675	0.0	0.0
chr1	RHOC	112705099	112705201	0	103	0	2792	0	2689	0.0	0.0
chr1	AL603832.3	112711007	112711071	0	65	0	1086	0	1021	0.0	0.0
chr1	RHOC	112705604	112705733	0	130	0	2792	0	2662	0.0	0.0
chr1	PPM1J	112714633	112714727	0	95	0	2461	0	2366	0.0	0.0
chr1	LINC01356	112828476	112828511	0	36	0	3190	0	3154	0.0	0.0
chr1	LINC01356	112848953	112849050	0	98	0	3190	0	3092	0.0	0.0
chr1	LINC01356	112840487	112840580	0	94	0	3190	0	3096	0.0	0.0
chr1	PHTF1	113724758	113724893	0	136	39349	7066	39349	6930	0.0	5.6780663780663785
chr1	PHTF1	113738109	113738268	0	160	39349	7066	39349	6906	0.0	5.697799015348972
chr1	RSBN1	113796185	113796303	0	119	0	6622	0	6503	0.0	0.0
chr1	PTPN22	113856547	113856619	0	73	68	4520	68	4447	0.0	0.015291207555655498
chr1	PTPN22	113854470	113854537	0	68	68	4520	68	4452	0.0	0.015274034141958671
chr1	PTPN22	113864197	113864382	0	186	68	4520	68	4334	0.0	0.015689893862482696
chr1	BCL2L15	113881772	113881997	0	226	306	9098	306	8872	0.0	0.03449053201082056
chr1	BCL2L15	113886536	113886658	0	123	306	9098	306	8975	0.0	0.03409470752089137
chr1	AP4B1	113901235	113901383	0	149	153	5835	153	5686	0.0	0.026908195568061906
chr1	AP4B1	113902637	113902862	0	226	153	5835	153	5609	0.0	0.02727758958816188
chr1	AP4B1	113902637	113902734	0	98	153	5835	153	5737	0.0	0.026668990761722154
chr1	SYT6	114093734	114093803	0	70	1810	5075	1810	5005	0.0	0.36163836163836166
chr1	TRIM33	114397939	114397990	0	52	27050	4931	27050	4879	0.0	5.544168887067022
chr1	TRIM33	114420379	114420451	0	73	27050	4931	27050	4858	0.0	5.568135034993825
chr1	BCAS2	114576687	114576758	0	72	0	1296	0	1224	0.0	0.0
chr1	DENND2C	114621894	114622065	0	172	89	7434	89	7262	0.0	0.012255576976039658
chr1	AMPD1	114680258	114680478	0	221	0	2917	0	2696	0.0	0.0
chr1	AMPD1	114693435	114693447	0	13	0	2917	0	2904	0.0	0.0
chr1	CSDE1	114739691	114739890	0	200	0	5803	0	5603	0.0	0.0
chr1	CSDE1	114749820	114750207	0	388	0	5803	0	5415	0.0	0.0
chr1	CSDE1	114737470	114737563	0	94	0	5803	0	5709	0.0	0.0
chr1	CSDE1	114741526	114741673	0	148	0	5803	0	5655	0.0	0.0
chr1	SIKE1	114776345	114776459	0	115	0	5899	0	5784	0.0	0.0
chr1	SIKE1	114780109	114780215	0	107	0	5899	0	5792	0.0	0.0
chr1	TSPAN2	115053378	115053462	1119	85	1422	3422	303	3337	13.16470588235294	0.09080011986814504
chr1	TSPAN2	115060463	115060538	0	76	1422	3422	1422	3346	0.0	0.42498505678421994
chr1	NGF	115293626	115293750	0	125	1896	1159	1896	1034	0.0	1.8336557059961316
chr1	NGF	115300396	115300483	0	88	1896	1159	1896	1071	0.0	1.7703081232492996
chr1	ATP1A1-AS1	116405606	116406148	0	543	165	13019	165	12476	0.0	0.013225392754087848
chr1	ATP1A1-AS1	116400895	116401131	0	237	165	13019	165	12782	0.0	0.012908777969018933
chr1	ATP1A1-AS1	116406927	116407195	0	269	165	13019	165	12750	0.0	0.012941176470588235
chr1	ATP1A1-AS1	116411260	116411315	0	56	165	13019	165	12963	0.0	0.012728535061328396
chr1	ATP1A1-AS1	116411619	116411710	0	92	165	13019	165	12927	0.0	0.012763982362497098
chr1	ATP1A1-AS1	116413761	116413913	0	153	165	13019	165	12866	0.0	0.012824498678688016
chr1	LINC01762	116466189	116466479	0	291	0	1769	0	1478	0.0	0.0
chr1	CD58	116535964	116536228	0	265	0	1790	0	1525	0.0	0.0
chr1	IGSF3	116606491	116606551	0	61	102	7413	102	7352	0.0	0.013873775843307944
chr1	VTCN1	117156573	117156921	861	349	1779	3035	918	2686	2.4670487106017194	0.34177215189873417
chr1	VTCN1	117156573	117157011	861	439	1779	3035	918	2596	1.9612756264236901	0.35362095531587057
chr1	GDAP2	117877775	117877841	0	67	174	9948	174	9881	0.0	0.017609553688897883
chr1	SPAG17	118036769	118036883	0	115	12684	8422	12684	8307	0.0	1.5269050198627663
chr1	TBX15	118890866	118890965	0	100	0	4354	0	4254	0.0	0.0
chr1	WARS2	119042263	119042349	0	87	0	3838	0	3751	0.0	0.0
chr1	AL359915.1	119266616	119266695	0	80	0	2928	0	2848	0.0	0.0
chr1	HMGCS2	119759117	119759282	0	166	238	2575	238	2409	0.0	0.0987961809879618
chr1	HMGCS2	119759863	119759989	0	127	238	2575	238	2448	0.0	0.09722222222222222
chr1	REG4	119798496	119798602	0	107	459	3421	459	3314	0.0	0.13850331925165962
chr1	REG4	119809028	119809202	0	175	459	3421	459	3246	0.0	0.1414048059149723
chr1	NOTCH2	120029905	120029987	0	83	62	19972	62	19889	0.0	0.003117301020664689
chr1	NOTCH2	119976349	119976352	0	4	62	19972	62	19968	0.0	0.0031049679487179485
chr1	NOTCH2	120051483	120051779	0	297	62	19972	62	19675	0.0	0.003151207115628971
chr1	AC244669.1	120340755	120340810	0	56	2346	1113	2346	1057	0.0	2.219489120151372
chr1	AC241952.1	120522098	120522162	0	65	44941	9489	44941	9424	0.0	4.768781833616298
chr1	AC241952.1	120531877	120532089	2580	213	44941	9489	42361	9276	12.112676056338028	4.566731349719706
chr1	FAM72B	121177207	121177332	0	126	0	2555	0	2429	0.0	0.0
chr1	FAM72C	143964854	143964979	0	126	455	2301	455	2175	0.0	0.20919540229885059
chr1	AC245595.1	144290006	144290133	94	128	94	1488	0	1360	0.734375	0.0
chr1	AC245595.1	144290786	144290968	0	183	94	1488	94	1305	0.0	0.07203065134099616
chr1	NBPF15	144450771	144450802	0	32	0	5330	0	5298	0.0	0.0
chr1	LINC01145	145214676	145214731	0	56	1034	6063	1034	6007	0.0	0.17213251206925254
chr1	LINC01145	145169526	145169615	0	90	1034	6063	1034	5973	0.0	0.1731123388581952
chr1	NBPF20	145394977	145395141	0	165	120169	19134	120169	18969	0.0	6.335020296272866
chr1	PDZK1	145671426	145671489	0	64	5043	2268	5043	2204	0.0	2.2881125226860255
chr1	PIAS3	145857314	145857416	0	103	0	4092	0	3989	0.0	0.0
chr1	RBM8A	145919186	145919306	195	121	26083	3735	25888	3614	1.6115702479338843	7.163254012174876
chr1	RBM8A	145923508	145923573	4663	66	26083	3735	21420	3669	70.65151515151516	5.838103025347506
chr1	ANKRD34A	145962254	145962318	0	65	0	3458	0	3393	0.0	0.0
chr1	HJV	146019697	146019734	0	38	247	2423	247	2385	0.0	0.10356394129979035
chr1	HJV	146020134	146020320	0	187	247	2423	247	2236	0.0	0.11046511627906977
chr1	HJV	146019174	146019734	0	561	247	2423	247	1862	0.0	0.1326530612244898
chr1	HJV	146020134	146020338	0	205	247	2423	247	2218	0.0	0.11136158701532912
chr1	AC244394.3	147002428	147002577	0	150	0	888	0	738	0.0	0.0
chr1	PRKAB2	147167766	147167933	0	168	51	5469	51	5301	0.0	0.009620826259196379
chr1	FMO5	147201151	147201343	0	193	0	5996	0	5803	0.0	0.0
chr1	FMO5	147201151	147201504	0	354	0	5996	0	5642	0.0	0.0
chr1	LINC00624	147408589	147408689	0	101	0	5570	0	5469	0.0	0.0
chr1	ACP6	147659646	147659775	0	130	51	10129	51	9999	0.0	0.0051005100510051
chr1	ACP6	147659395	147659526	0	132	51	10129	51	9997	0.0	0.005101530459137742
chr1	NBPF11	148124898	148125001	0	104	0	5942	0	5838	0.0	0.0
chr1	NBPF11	148127140	148127288	0	149	0	5942	0	5793	0.0	0.0
chr1	NBPF11	148137710	148137809	0	100	0	5942	0	5842	0.0	0.0
chr1	NBPF11	148135123	148135247	0	125	0	5942	0	5817	0.0	0.0
chr1	AC239809.3	148200530	148200633	0	104	81262	14907	81262	14803	0.0	5.489562926433831
chr1	AC239809.3	148207933	148207963	0	31	81262	14907	81262	14876	0.0	5.46262436138747
chr1	AC239809.3	148226493	148226621	0	129	81262	14907	81262	14778	0.0	5.498849641358777
chr1	AC239809.3	148201407	148201478	0	72	81262	14907	81262	14835	0.0	5.477721604314122
chr1	AC239809.3	148208532	148208654	0	123	81262	14907	81262	14784	0.0	5.496617965367966
chr1	AC239809.3	148228535	148228657	0	123	81262	14907	81262	14784	0.0	5.496617965367966
chr1	AC239809.3	148226734	148226798	0	65	81262	14907	81262	14842	0.0	5.475138121546961
chr1	AC239809.3	148216038	148216305	0	268	81262	14907	81262	14639	0.0	5.55106223102671
chr1	AC239809.3	148225075	148225289	0	215	81262	14907	81262	14692	0.0	5.531037299210455
chr1	AC239809.3	148226100	148226253	0	154	81262	14907	81262	14753	0.0	5.508167830271809
chr1	LINC01138	148292913	148293048	170	136	3761	7412	3591	7276	1.25	0.4935404068169324
chr1	LINC01138	148460730	148461093	0	364	3761	7412	3761	7048	0.0	0.5336265607264472
chr1	NBPF14	148579073	148579237	285	165	175958	12061	175673	11896	1.7272727272727273	14.767400806993948
chr1	NBPF14	148593597	148593700	0	104	175958	12061	175958	11957	0.0	14.715898636781802
chr1	NBPF9	149065525	149065689	0	165	298	8033	298	7868	0.0	0.037874936451448904
chr1	NBPF9	149092754	149092785	0	32	298	8033	298	8001	0.0	0.0372453443319585
chr1	NBPF9	149065636	149065689	0	54	298	8033	298	7979	0.0	0.03734803860132849
chr1	AC243772.3	149728229	149728281	0	53	399	3275	399	3222	0.0	0.12383612662942271
chr1	MTMR11	149935583	149935705	612	123	23540	4455	22928	4332	4.975609756097561	5.292705447830102
chr1	MTMR11	149931259	149931426	0	168	23540	4455	23540	4287	0.0	5.4910193608584095
chr1	MTMR11	149935583	149935620	384	38	23540	4455	23156	4417	10.105263157894736	5.242472266244057
chr1	ANP32E	150223185	150223240	0	56	117	1638	117	1582	0.0	0.07395701643489254
chr1	ANP32E	150229071	150229237	0	167	117	1638	117	1471	0.0	0.07953772943575799
chr1	ANP32E	150230570	150230693	0	124	117	1638	117	1514	0.0	0.0772787318361955
chr1	ANP32E	150231776	150231926	0	151	117	1638	117	1487	0.0	0.07868190988567586
chr1	ANP32E	150223185	150223294	0	110	117	1638	117	1528	0.0	0.07657068062827226
chr1	APH1A	150267715	150267789	74	75	224481	3360	224407	3285	0.9866666666666667	68.31263318112633
chr1	APH1A	150267956	150268127	3590	172	224481	3360	220891	3188	20.872093023255815	69.28826850690088
chr1	APH1A	150267956	150267991	372	36	224481	3360	224109	3324	10.333333333333334	67.42148014440433
chr1	MCL1	150578243	150578491	96	249	13121	5876	13025	5627	0.3855421686746988	2.314732539541496
chr1	ENSA	150626478	150626526	0	49	3073	2646	3073	2597	0.0	1.1832884097035041
chr1	GOLPH3L	150694107	150694173	51	67	2262	3340	2211	3273	0.7611940298507462	0.6755270394133822
chr1	HORMAD1	150700111	150700183	0	73	354	2428	354	2355	0.0	0.1503184713375796
chr1	HORMAD1	150711544	150711571	0	28	354	2428	354	2400	0.0	0.1475
chr1	HORMAD1	150711832	150711853	0	22	354	2428	354	2406	0.0	0.14713216957605985
chr1	HORMAD1	150714614	150714678	0	65	354	2428	354	2363	0.0	0.14980956411341514
chr1	CTSS	150750005	150750171	52	167	92	1610	40	1443	0.31137724550898205	0.02772002772002772
chr1	CTSS	150755000	150755150	40	151	92	1610	52	1459	0.26490066225165565	0.03564084989718986
chr1	CTSS	150748164	150748285	0	122	92	1610	92	1488	0.0	0.06182795698924731
chr1	CTSK	150799167	150799273	0	107	121501	7254	121501	7147	0.0	17.000279837694137
chr1	CTSK	150804020	150804239	51	220	121501	7254	121450	7034	0.2318181818181818	17.26613591128803
chr1	CTSK	150806101	150806224	0	124	121501	7254	121501	7130	0.0	17.040813464235622
chr1	CTSK	150799167	150799285	0	119	121501	7254	121501	7135	0.0	17.028871758934827
chr1	CTSK	150807248	150807341	0	94	121501	7254	121501	7160	0.0	16.96941340782123
chr1	CTSK	150806314	150806365	0	52	121501	7254	121501	7202	0.0	16.8704526520411
chr1	ARNT	150823193	150823345	204	153	47680	6472	47476	6319	1.3333333333333333	7.51321411615762
chr1	ARNT	150842423	150842468	0	46	47680	6472	47680	6426	0.0	7.419856831621537
chr1	ARNT	150861246	150861302	0	57	47680	6472	47680	6415	0.0	7.432579890880748
chr1	ARNT	150853155	150853278	0	124	47680	6472	47680	6348	0.0	7.511027095148078
chr1	CERS2	150968917	150969131	341	215	45931	4616	45590	4401	1.586046511627907	10.359009316064531
chr1	CERS2	150968917	150969091	224	175	45931	4616	45707	4441	1.28	10.292051339788335
chr1	MINDY1	151000456	151000615	0	160	112275	3804	112275	3644	0.0	30.8109220636663
chr1	CDC42SE1	151056650	151056786	0	137	2720	4192	2720	4055	0.0	0.6707768187422934
chr1	CDC42SE1	151056655	151056786	0	132	2720	4192	2720	4060	0.0	0.6699507389162561
chr1	SEMA6C	151133959	151134055	0	97	218031	3937	218031	3840	0.0	56.77890625
chr1	SEMA6C	151137985	151138105	4807	121	218031	3937	213224	3816	39.72727272727273	55.876310272536685
chr1	SEMA6C	151138315	151138406	698	92	218031	3937	217333	3845	7.586956521739131	56.52353706111833
chr1	TMOD4	151170518	151170663	2461	146	40530	1545	38069	1399	16.856164383561644	27.21157969978556
chr1	TMOD4	151171432	151171540	26714	109	40530	1545	13816	1436	245.08256880733944	9.62116991643454
chr1	PI4KB	151315572	151316509	131360	938	143827	5088	12467	4150	140.04264392324095	3.0040963855421685
chr1	PI4KB	151310210	151310255	0	46	143827	5088	143827	5042	0.0	28.525783419278063
chr1	PI4KB	151326171	151326373	0	203	143827	5088	143827	4885	0.0	29.442579324462642
chr1	PI4KB	151324744	151324917	0	174	143827	5088	143827	4914	0.0	29.26882376882377
chr1	PI4KB	151293399	151293462	242	64	143827	5088	143585	5024	3.78125	28.579816878980893
chr1	PI4KB	151315572	151315672	31350	101	143827	5088	112477	4987	310.3960396039604	22.554040505313814
chr1	RFX5	151346754	151346766	0	13	400	3082	400	3069	0.0	0.13033561420658196
chr1	RFX5	151345285	151345443	0	159	400	3082	400	2923	0.0	0.13684570646595964
chr1	SELENBP1	151366721	151366904	0	184	65782	3236	65782	3052	0.0	21.553735255570118
chr1	SELENBP1	151369003	151369189	0	187	65782	3236	65782	3049	0.0	21.574942604132502
chr1	SELENBP1	151369441	151369554	0	114	65782	3236	65782	3122	0.0	21.070467648942984
chr1	SELENBP1	151368999	151369189	0	191	65782	3236	65782	3045	0.0	21.60328407224959
chr1	SELENBP1	151369441	151369506	0	66	65782	3236	65782	3170	0.0	20.751419558359622
chr1	SELENBP1	151367015	151367175	0	161	65782	3236	65782	3075	0.0	21.39252032520325
chr1	POGZ	151411624	151411771	297	148	50528	8685	50231	8537	2.0067567567567566	5.8839170668853225
chr1	POGZ	151424954	151425061	0	108	50528	8685	50528	8577	0.0	5.891104115658155
chr1	POGZ	151440927	151441086	0	160	50528	8685	50528	8525	0.0	5.927038123167155
chr1	POGZ	151411624	151411798	373	175	50528	8685	50155	8510	2.1314285714285712	5.893654524089307
chr1	POGZ	151450909	151451047	0	139	50528	8685	50528	8546	0.0	5.9124736718932835
chr1	CELF3	151707144	151707294	0	151	0	6085	0	5934	0.0	0.0
chr1	MRPL9	151761450	151761552	0	103	5166	1368	5166	1265	0.0	4.0837944664031625
chr1	MRPL9	151761961	151762010	0	50	5166	1368	5166	1318	0.0	3.919575113808801
chr1	MRPL9	151761961	151762025	0	65	5166	1368	5166	1303	0.0	3.964696853415196
chr1	TDRKH	151781908	151782019	0	112	1029	4678	1029	4566	0.0	0.22536136662286466
chr1	RORC	151813487	151813620	0	134	51	3825	51	3691	0.0	0.013817393660254673
chr1	RORC	151817194	151817280	0	87	51	3825	51	3738	0.0	0.013643659711075442
chr1	RORC	151813487	151813702	0	216	51	3825	51	3609	0.0	0.014131338320864505
chr1	RORC	151830927	151831132	0	206	51	3825	51	3619	0.0	0.014092290688035369
chr1	THEM5	151847737	151847862	765	126	10931	1167	10166	1041	6.071428571428571	9.765609990393852
chr1	THEM4	151889982	151890214	51	233	1275	6944	1224	6711	0.21888412017167383	0.1823871256146625
chr1	SPRR2D	153040666	153040779	0	114	0	954	0	840	0.0	0.0
chr1	S100A4	153545469	153545518	0	50	0	804	0	754	0.0	0.0
chr1	S100A2	153563414	153563536	0	123	0	1552	0	1429	0.0	0.0
chr1	S100A14	153616294	153616355	7248	62	163950	1283	156702	1221	116.90322580645162	128.33906633906633
chr1	S100A13	153627482	153627598	0	117	40508	1716	40508	1599	0.0	25.333333333333332
chr1	AL162258.1	153630449	153630656	0	208	68719	1002	68719	794	0.0	86.54785894206549
chr1	S100A13	153628120	153628237	0	118	40508	1716	40508	1598	0.0	25.34918648310388
chr1	AL162258.1	153633035	153633157	0	123	68719	1002	68719	879	0.0	78.17861205915814
chr1	GATAD2B	153914673	153914740	3566	68	41693	9263	38127	9195	52.44117647058823	4.146492659053834
chr1	GATAD2B	153886423	153886521	51	99	41693	9263	41642	9164	0.5151515151515151	4.544085552160628
chr1	DENND4B	153942186	153942356	714	171	866059	7219	865345	7048	4.175438596491228	122.77880249716232
chr1	CRTC2	153951259	153951666	599	408	360492	3463	359893	3055	1.4681372549019607	117.80458265139116
chr1	CRTC2	153948833	153948900	1915	68	360492	3463	358577	3395	28.16176470588235	105.61914580265096
chr1	SLC39A1	153962219	153962350	51	132	417813	3208	417762	3076	0.38636363636363635	135.81339401820546
chr1	TPM3	154176114	154176248	0	135	183897	14152	183897	14017	0.0	13.119569094670757
chr1	TPM3	154170648	154170711	0	64	183897	14152	183897	14088	0.0	13.053449744463373
chr1	TPM3	154158897	154159048	0	152	183897	14152	183897	14000	0.0	13.1355
chr1	TPM3	154169304	154169383	0	80	183897	14152	183897	14072	0.0	13.068291642978965
chr1	TPM3	154173538	154173636	0	99	183897	14152	183897	14053	0.0	13.085960293175834
chr1	TPM3	154171412	154171488	0	77	183897	14152	183897	14075	0.0	13.06550621669627
chr1	TPM3	154172028	154172104	0	77	183897	14152	183897	14075	0.0	13.06550621669627
chr1	C1ORF43	154212319	154212378	0	60	250594	2680	250594	2620	0.0	95.64656488549619
chr1	C1ORF43	154213892	154213946	6	55	250594	2680	250588	2625	0.10909090909090909	95.46209523809524
chr1	C1ORF43	154218715	154218785	65294	71	250594	2680	185300	2609	919.6338028169014	71.02338060559602
chr1	C1ORF43	154213181	154213303	66	123	250594	2680	250528	2557	0.5365853658536586	97.97731716855691
chr1	C1ORF43	154219835	154219937	2338	103	250594	2680	248256	2577	22.699029126213592	96.33527357392316
chr1	ADAR	154586634	154586941	102	308	16562	9646	16460	9338	0.33116883116883117	1.7626900835296637
chr1	KCNN3	154737043	154737088	0	46	0	3372	0	3326	0.0	0.0
chr1	PBXIP1	154951794	154951921	6544	128	526507	3603	519963	3475	51.125	149.62964028776977
chr1	SHC1	154968203	154968257	0	55	137265	4260	137265	4205	0.0	32.643281807372176
chr1	SHC1	154973292	154973508	0	217	137265	4260	137265	4043	0.0	33.95127380657927
chr1	DCST2	155023552	155023620	102	69	221754	3086	221652	3017	1.4782608695652173	73.46768312893603
chr1	DCST2	155024471	155024602	64	132	221754	3086	221690	2954	0.48484848484848486	75.04739336492891
chr1	DCST2	155026301	155026402	6882	102	221754	3086	214872	2984	67.47058823529412	72.00804289544236
chr1	MUC1	155187454	155187576	4618	123	172617	3963	167999	3840	37.54471544715447	43.74973958333333
chr1	MUC1	155187721	155187858	6982	138	172617	3963	165635	3825	50.594202898550726	43.30326797385621
chr1	MUC1	155188007	155188063	2406	57	172617	3963	170211	3906	42.21052631578947	43.57680491551459
chr1	MUC1	155188162	155188285	10468	124	172617	3963	162149	3839	84.41935483870968	42.23730138056786
chr1	MUC1	155187454	155187544	4322	91	172617	3963	168295	3872	47.494505494505496	43.46461776859504
chr1	MUC1	155188162	155188231	7898	70	172617	3963	164719	3893	112.82857142857142	42.31158489596712
chr1	MUC1	155186729	155186804	12844	76	172617	3963	159773	3887	169.0	41.10445073321328
chr1	MUC1	155188327	155188503	459	177	172617	3963	172158	3786	2.593220338983051	45.47226624405705
chr1	MUC1	155188162	155188212	5084	51	172617	3963	167533	3912	99.68627450980392	42.82540899795501
chr1	THBS3	155200450	155200610	0	161	266988	4646	266988	4485	0.0	59.529096989966554
chr1	THBS3	155201093	155201204	5445	112	266988	4646	261543	4534	48.61607142857143	57.68482576091751
chr1	THBS3	155203222	155203305	5487	84	266988	4646	261501	4562	65.32142857142857	57.32156948706707
chr1	THBS3	155203512	155203539	773	28	266988	4646	266215	4618	27.607142857142858	57.64724989172802
chr1	THBS3	155204854	155204957	13807	104	266988	4646	253181	4542	132.7596153846154	55.74218405988551
chr1	GBAP1	155217518	155217593	20637	76	270301	3205	249664	3129	271.5394736842105	79.79034835410674
chr1	GBAP1	155218387	155218479	0	93	270301	3205	270301	3112	0.0	86.85764781491002
chr1	GBAP1	155217704	155217846	4395	143	270301	3205	265906	3062	30.734265734265733	86.84062704114957
chr1	GBA	155239615	155239762	88	148	107813	3264	107725	3116	0.5945945945945946	34.571566110397946
chr1	FAM189B	155250275	155250821	306	547	61868	4158	61562	3611	0.5594149908592322	17.04846302963168
chr1	FAM189B	155254399	155254456	1478	58	61868	4158	60390	4100	25.482758620689655	14.729268292682926
chr1	SCAMP3	155261656	155261734	0	79	14036	2310	14036	2231	0.0	6.291349170775437
chr1	CLK2	155268707	155268792	0	86	68	3019	68	2933	0.0	0.023184452778724857
chr1	CLK2	155268707	155268795	0	89	68	3019	68	2930	0.0	0.023208191126279865
chr1	RUSC1-AS1	155319802	155319953	27	152	6183	2545	6156	2393	0.17763157894736842	2.5725031341412454
chr1	RUSC1-AS1	155322242	155322437	0	196	6183	2545	6183	2349	0.0	2.632183908045977
chr1	ASH1L	155415743	155415923	0	181	10130	13816	10130	13635	0.0	0.742940960762743
chr1	ASH1L	155462452	155462599	0	148	10130	13816	10130	13668	0.0	0.741147205150717
chr1	ASH1L	155440489	155440593	0	105	10130	13816	10130	13711	0.0	0.7388228429727955
chr1	ASH1L	155440502	155440593	0	92	10130	13816	10130	13724	0.0	0.7381229962110172
chr1	ASH1L	155562152	155562295	0	144	10130	13816	10130	13672	0.0	0.7409303686366296
chr1	ASH1L	155562152	155562291	0	140	10130	13816	10130	13676	0.0	0.7407136589646095
chr1	ASH1L	155345962	155346207	660	246	10130	13816	9470	13570	2.682926829268293	0.6978629329403095
chr1	ASH1L	155520224	155520356	0	133	10130	13816	10130	13683	0.0	0.7403347219177081
chr1	YY1AP1	155668626	155668777	765	152	9407	4688	8642	4536	5.032894736842105	1.9052028218694885
chr1	YY1AP1	155670319	155670464	0	146	9407	4688	9407	4542	0.0	2.0711140466754734
chr1	YY1AP1	155675009	155675096	0	88	9407	4688	9407	4600	0.0	2.045
chr1	YY1AP1	155680415	155680456	0	42	9407	4688	9407	4646	0.0	2.0247524752475248
chr1	YY1AP1	155668626	155668717	0	92	9407	4688	9407	4596	0.0	2.046779808529156
chr1	YY1AP1	155680381	155680456	12	76	9407	4688	9395	4612	0.15789473684210525	2.0370771899392888
chr1	YY1AP1	155688070	155688201	103	132	9407	4688	9304	4556	0.7803030303030303	2.042142230026339
chr1	YY1AP1	155679927	155680008	0	82	9407	4688	9407	4606	0.0	2.042336083369518
chr1	YY1AP1	155679157	155679313	151	157	9407	4688	9256	4531	0.9617834394904459	2.04281615537409
chr1	GON4L	155776394	155776481	0	88	82462	11036	82462	10948	0.0	7.5321519912312755
chr1	RIT1	155910655	155910804	0	150	81078	4045	81078	3895	0.0	20.81591784338896
chr1	RIT1	155904602	155904605	0	4	81078	4045	81078	4041	0.0	20.06384558277654
chr1	RIT1	155904602	155904610	0	9	81078	4045	81078	4036	0.0	20.088701684836472
chr1	ARHGEF2	155954901	155954969	0	69	746488	8670	746488	8601	0.0	86.79083827461923
chr1	ARHGEF2	155965630	155965760	0	131	746488	8670	746488	8539	0.0	87.42100948588828
chr1	SSR2	156014960	156015069	1104	110	140240	5038	139136	4928	10.036363636363637	28.233766233766232
chr1	SSR2	156018131	156018368	8847	238	140240	5038	131393	4800	37.17226890756302	27.373541666666668
chr1	SSR2	156019084	156019266	8	183	140240	5038	140232	4855	0.04371584699453552	28.884037075180228
chr1	SSR2	156018251	156018368	7950	118	140240	5038	132290	4920	67.37288135593221	26.88821138211382
chr1	SSR2	156012394	156012565	5228	172	140240	5038	135012	4866	30.3953488372093	27.745992601726265
chr1	SSR2	156012384	156012565	5517	182	140240	5038	134723	4856	30.313186813186814	27.743616144975288
chr1	SSR2	156020265	156020346	19509	82	140240	5038	120731	4956	237.91463414634146	24.360573042776434
chr1	PAQR6	156245534	156245661	17	128	18459	2498	18442	2370	0.1328125	7.7814345991561185
chr1	PAQR6	156246680	156246756	102	77	18459	2498	18357	2421	1.3246753246753247	7.582403965303594
chr1	PAQR6	156245781	156245987	0	207	18459	2498	18459	2291	0.0	8.057180270624182
chr1	PAQR6	156245141	156245238	110	98	18459	2498	18349	2400	1.1224489795918366	7.645416666666667
chr1	PAQR6	156244581	156244672	0	92	18459	2498	18459	2406	0.0	7.672069825436409
chr1	PAQR6	156247509	156247632	0	124	18459	2498	18459	2374	0.0	7.775484414490312
chr1	PAQR6	156245141	156245277	218	137	18459	2498	18241	2361	1.5912408759124088	7.7259635747564595
chr1	GLMP	156293319	156293576	0	258	1814646	2595	1814646	2337	0.0	776.4852374839538
chr1	GLMP	156294758	156295016	629682	259	1814646	2595	1184964	2336	2431.2046332046334	507.26198630136986
chr1	GLMP	156293319	156293429	0	111	1814646	2595	1814646	2484	0.0	730.5338164251208
chr1	CCT3	156334712	156334775	0	64	408	3882	408	3818	0.0	0.106862231534835
chr1	CCT3	156335826	156335888	0	63	408	3882	408	3819	0.0	0.10683424980361352
chr1	CCT3	156337078	156337240	0	163	408	3882	408	3719	0.0	0.10970691045980102
chr1	CCT3	156337676	156337789	0	114	408	3882	408	3768	0.0	0.10828025477707007
chr1	CCT3	156334867	156334918	0	52	408	3882	408	3830	0.0	0.10652741514360313
chr1	CCT3	156333215	156333284	50	70	408	3882	358	3812	0.7142857142857143	0.09391395592864638
chr1	MIR9-1HG	156407079	156407197	0	119	33808	7374	33808	7255	0.0	4.659958649207443
chr1	MIR9-1HG	156414653	156414753	0	101	33808	7374	33808	7273	0.0	4.648425684036849
chr1	MIR9-1HG	156417911	156418034	0	124	33808	7374	33808	7250	0.0	4.663172413793103
chr1	MIR9-1HG	156414055	156414298	0	244	33808	7374	33808	7130	0.0	4.741654978962131
chr1	MIR9-1HG	156416768	156416864	92	97	33808	7374	33716	7277	0.9484536082474226	4.633227978562594
chr1	MIR9-1HG	156413412	156413497	0	86	33808	7374	33808	7288	0.0	4.638858397365532
chr1	MIR9-1HG	156407841	156407975	0	135	33808	7374	33808	7239	0.0	4.670258322972786
chr1	MIR9-1HG	156414083	156414298	0	216	33808	7374	33808	7158	0.0	4.72310701313216
chr1	MIR9-1HG	156454642	156454795	0	154	33808	7374	33808	7220	0.0	4.6825484764542935
chr1	MIR9-1HG	156453130	156453252	13319	123	33808	7374	20489	7251	108.28455284552845	2.825679216659771
chr1	MEF2D	156475107	156475237	0	131	5429	3875	5429	3744	0.0	1.4500534188034189
chr1	MEF2D	156476493	156476514	0	22	5429	3875	5429	3853	0.0	1.4090319231767454
chr1	MEF2D	156479585	156479796	0	212	5429	3875	5429	3663	0.0	1.482118482118482
chr1	MEF2D	156499431	156499560	30	130	5429	3875	5399	3745	0.23076923076923078	1.4416555407209612
chr1	IQGAP3	156569375	156569463	1227	89	585588	6779	584361	6690	13.786516853932584	87.34843049327354
chr1	GPATCH4	156598034	156598121	0	88	51	3333	51	3245	0.0	0.01571648690292758
chr1	GPATCH4	156598420	156598494	0	75	51	3333	51	3258	0.0	0.01565377532228361
chr1	GPATCH4	156597799	156597885	0	87	51	3333	51	3246	0.0	0.015711645101663587
chr1	GPATCH4	156597799	156597922	0	124	51	3333	51	3209	0.0	0.015892801495793082
chr1	ARHGEF11	156971696	156971816	16	121	11105	8467	11089	8346	0.1322314049586777	1.3286604361370717
chr1	FCRL3	157697139	157697424	0	286	13585	5345	13585	5059	0.0	2.685313303024313
chr1	FCRL3	157697139	157697329	0	191	13585	5345	13585	5154	0.0	2.6358168412883196
chr1	FCRL2	157748552	157748618	0	67	103	3783	103	3716	0.0	0.027717976318622176
chr1	FCRL1	157801460	157801577	0	118	0	3961	0	3843	0.0	0.0
chr1	LINC01704	158132573	158132656	0	84	12291	2018	12291	1934	0.0	6.355222337125129
chr1	LINC01704	158133114	158133193	0	80	12291	2018	12291	1938	0.0	6.342105263157895
chr1	LINC01704	158132577	158132656	0	80	12291	2018	12291	1938	0.0	6.342105263157895
chr1	AL365440.1	158479904	158481802	0	1899	1814	2501	1814	602	0.0	3.0132890365448506
chr1	CRP	159713502	159713640	0	139	0	1062	0	923	0.0	0.0
chr1	SNHG28	159840710	159840866	0	157	1229	3025	1229	2868	0.0	0.4285216178521618
chr1	SNHG28	159838364	159838655	0	292	1229	3025	1229	2733	0.0	0.44968898646176364
chr1	SNHG28	159840710	159840881	0	172	1229	3025	1229	2853	0.0	0.4307746232036453
chr1	SNHG28	159837916	159838027	0	112	1229	3025	1229	2913	0.0	0.42190181943014077
chr1	SNHG28	159841125	159841235	0	111	1229	3025	1229	2914	0.0	0.4217570350034317
chr1	SNHG28	159838364	159838451	0	88	1229	3025	1229	2937	0.0	0.4184542049710589
chr1	SNHG28	159842226	159842314	165	89	1229	3025	1064	2936	1.853932584269663	0.36239782016348776
chr1	SNHG28	159837916	159840866	0	2951	1229	3025	1229	74	0.0	16.60810810810811
chr1	SNHG28	159838364	159840866	0	2503	1229	3025	1229	522	0.0	2.3544061302681993
chr1	AL590560.2	159858733	159858912	0	180	1596	6349	1596	6169	0.0	0.25871291943588914
chr1	SNHG28	159840710	159840779	0	70	1229	3025	1229	2955	0.0	0.41590524534686973
chr1	SNHG28	159840768	159840866	0	99	1229	3025	1229	2926	0.0	0.42002734107997264
chr1	SNHG28	159837092	159837219	176	128	1229	3025	1053	2897	1.375	0.36347946151190885
chr1	SNHG28	159837916	159840881	0	2966	1229	3025	1229	59	0.0	20.83050847457627
chr1	CFAP45	159898065	159898268	102	204	632795	2640	632693	2436	0.5	259.7261904761905
chr1	IGSF9	159931137	159931261	0	125	205	6448	205	6323	0.0	0.032421318994148345
chr1	IGSF9	159931452	159931603	0	152	205	6448	205	6296	0.0	0.03256035578144854
chr1	SLAMF9	159952261	159952534	54	274	156	1007	102	733	0.19708029197080293	0.13915416098226466
chr1	KCNJ10	160040501	160040601	0	101	23954	4234	23954	4133	0.0	5.79578998306315
chr1	KCNJ10	160044755	160044821	0	67	23954	4234	23954	4167	0.0	5.748500119990401
chr1	DCAF8	160225061	160225119	0	59	213997	6531	213997	6472	0.0	33.06504944375772
chr1	DCAF8	160243959	160244034	0	76	213997	6531	213997	6455	0.0	33.15213013168087
chr1	DCAF8	160261284	160261358	1083	75	213997	6531	212914	6456	14.44	32.979244114002476
chr1	DCAF8	160220458	160220691	1162	234	213997	6531	212835	6297	4.965811965811966	33.79942829919009
chr1	DCAF8	160261284	160261325	1083	42	213997	6531	212914	6489	25.785714285714285	32.811527199876714
chr1	DCAF8	160261284	160261350	1083	67	213997	6531	212914	6464	16.16417910447761	32.93842821782178
chr1	AL139011.2	160278130	160278191	1281	62	14777	3223	13496	3161	20.661290322580644	4.269534957291996
chr1	PEX19	160282416	160282502	378	87	155418	3122	155040	3035	4.344827586206897	51.084019769357496
chr1	PEX19	160283529	160283639	0	111	155418	3122	155418	3011	0.0	51.61673862504151
chr1	COPA	160293165	160293234	9318	70	25801	7549	16483	7479	133.11428571428573	2.2039042652761065
chr1	COPA	160298844	160298991	0	148	25801	7549	25801	7401	0.0	3.486150520199973
chr1	COPA	160299101	160299264	1989	164	25801	7549	23812	7385	12.128048780487806	3.224373730534868
chr1	COPA	160307162	160307245	257	84	25801	7549	25544	7465	3.0595238095238093	3.4218352310783655
chr1	COPA	160313989	160314125	153	137	25801	7549	25648	7412	1.1167883211678833	3.460334592552617
chr1	COPA	160333602	160333679	0	78	25801	7549	25801	7471	0.0	3.453486815687324
chr1	COPA	160339908	160339982	0	75	25801	7549	25801	7474	0.0	3.4521006154669522
chr1	COPA	160298844	160298931	0	88	25801	7549	25801	7461	0.0	3.458115534110709
chr1	COPA	160335241	160335322	0	82	25801	7549	25801	7467	0.0	3.4553368153207447
chr1	SLAMF6	160496060	160496393	153	334	153	2754	0	2420	0.45808383233532934	0.0
chr1	CD84	160550937	160551035	0	99	51	9263	51	9164	0.0	0.0055652553470100395
chr1	CD84	160565403	160565745	51	343	51	9263	0	8920	0.14868804664723032	0.0
chr1	CD84	160552704	160552737	0	34	51	9263	51	9229	0.0	0.005526059161339257
chr1	SLAMF1	160623502	160623585	0	84	0	2198	0	2114	0.0	0.0
chr1	CD244	160836194	160836254	0	61	0	2779	0	2718	0.0	0.0
chr1	CD244	160841209	160841485	0	277	0	2779	0	2502	0.0	0.0
chr1	CD244	160841209	160841500	0	292	0	2779	0	2487	0.0	0.0
chr1	F11R	161000630	161000777	0	148	20170	5046	20170	4898	0.0	4.11800734993875
chr1	AL591806.2	161022749	161022827	0	79	7431	2127	7431	2048	0.0	3.62841796875
chr1	TSTD1	161038550	161038673	0	124	0	1199	0	1075	0.0	0.0
chr1	TSTD1	161038550	161038694	0	145	0	1199	0	1054	0.0	0.0
chr1	USF1	161042115	161042217	0	103	0	2093	0	1990	0.0	0.0
chr1	ARHGAP30	161056387	161056532	0	146	3109	5073	3109	4927	0.0	0.6310127866856099
chr1	ARHGAP30	161059613	161059716	0	104	3109	5073	3109	4969	0.0	0.625679211108875
chr1	ARHGAP30	161060155	161060262	0	108	3109	5073	3109	4965	0.0	0.626183282980866
chr1	NECTIN4	161073224	161073299	0	76	571971	3467	571971	3391	0.0	168.67325272780892
chr1	DEDD	161130814	161130847	4217	34	98266	2740	94049	2706	124.02941176470588	34.755728011825575
chr1	DEDD	161130814	161130843	3815	30	98266	2740	94451	2710	127.16666666666667	34.852767527675276
chr1	DEDD	161124413	161124526	0	114	98266	2740	98266	2626	0.0	37.42041127189642
chr1	DEDD	161124339	161124526	0	188	98266	2740	98266	2552	0.0	38.505485893416925
chr1	APOA2	161222917	161223050	0	134	0	769	0	635	0.0	0.0
chr1	APOA2	161223349	161223425	0	77	0	769	0	692	0.0	0.0
chr1	APOA2	161222917	161222994	0	78	0	769	0	691	0.0	0.0
chr1	APOA2	161222917	161223266	0	350	0	769	0	419	0.0	0.0
chr1	NR1I3	161233168	161233338	0	171	0	2001	0	1830	0.0	0.0
chr1	NR1I3	161231116	161231233	0	118	0	2001	0	1883	0.0	0.0
chr1	NR1I3	161236458	161236598	0	141	0	2001	0	1860	0.0	0.0
chr1	NR1I3	161231116	161231245	0	130	0	2001	0	1871	0.0	0.0
chr1	NR1I3	161232806	161232946	0	141	0	2001	0	1860	0.0	0.0
chr1	NR1I3	161236529	161236598	0	70	0	2001	0	1931	0.0	0.0
chr1	FCGR3B	161626144	161626402	0	259	0	2793	0	2534	0.0	0.0
chr1	RGS5	163168257	163168368	0	112	25900	9121	25900	9009	0.0	2.874902874902875
chr1	RGS5	163161914	163161976	0	63	25900	9121	25900	9058	0.0	2.8593508500772797
chr1	RXRG	165424750	165424808	0	59	0	2703	0	2644	0.0	0.0
chr1	LRRC52-AS1	165522973	165523087	0	115	0	4368	0	4253	0.0	0.0
chr1	LRRC52-AS1	165575282	165575369	0	88	0	4368	0	4280	0.0	0.0
chr1	LRRC52-AS1	165508079	165508171	0	93	0	4368	0	4275	0.0	0.0
chr1	LRRC52-AS1	165499011	165499113	0	103	0	4368	0	4265	0.0	0.0
chr1	LRRC52-AS1	165528782	165528882	0	101	0	4368	0	4267	0.0	0.0
chr1	TMCO1	165759524	165759584	0	61	5457	5337	5457	5276	0.0	1.0343062926459439
chr1	TMCO1	165754853	165754990	51	138	5457	5337	5406	5199	0.3695652173913043	1.0398153491055973
chr1	LINC01675	166484286	166484452	0	167	0	2032	0	1865	0.0	0.0
chr1	ILDR2	166920706	166921379	0	674	98	4354	98	3680	0.0	0.026630434782608695
chr1	ILDR2	166935300	166935477	0	178	98	4354	98	4176	0.0	0.02346743295019157
chr1	ILDR2	166939513	166939570	0	58	98	4354	98	4296	0.0	0.02281191806331471
chr1	ILDR2	166936590	166936737	0	148	98	4354	98	4206	0.0	0.02330004755111745
chr1	GPA33	167082244	167082311	0	68	0	2956	0	2888	0.0	0.0
chr1	LINC01363	167182041	167182193	0	153	0	1348	0	1195	0.0	0.0
chr1	ADCY10	167901661	167901805	0	145	129709	6176	129709	6031	0.0	21.507046924224838
chr1	ADCY10	167818362	167818412	0	51	129709	6176	129709	6125	0.0	21.176979591836734
chr1	ADCY10	167901661	167901842	0	182	129709	6176	129709	5994	0.0	21.639806473139807
chr1	GPR161	168104476	168104894	102	419	9037	11010	8935	10591	0.24343675417661098	0.8436408271173638
chr1	AL023755.1	168413591	168413687	66	97	66	4252	0	4155	0.6804123711340206	0.0
chr1	AL023755.1	168464312	168464373	0	62	66	4252	66	4190	0.0	0.015751789976133652
chr1	AL023755.1	168494045	168494143	0	99	66	4252	66	4153	0.0	0.01589212617385023
chr1	AL023755.1	168407238	168407318	0	81	66	4252	66	4171	0.0	0.015823543514744666
chr1	AL023755.1	168494045	168494124	0	80	66	4252	66	4172	0.0	0.015819750719079578
chr1	NME7	169287302	169287408	0	107	306	5730	306	5623	0.0	0.0544193491019029
chr1	NME7	169323116	169323283	0	168	306	5730	306	5562	0.0	0.05501618122977346
chr1	NME7	169169446	169169554	0	109	306	5730	306	5621	0.0	0.05443871197295855
chr1	NME7	169190642	169190705	0	64	306	5730	306	5666	0.0	0.054006353688669254
chr1	NME7	169246987	169247060	0	74	306	5730	306	5656	0.0	0.0541018387553041
chr1	NME7	169324392	169324500	0	109	306	5730	306	5621	0.0	0.05443871197295855
chr1	SLC19A2	169477154	169477757	0	604	1300	3979	1300	3375	0.0	0.3851851851851852
chr1	SELP	169611491	169611677	0	187	115	3507	115	3320	0.0	0.03463855421686747
chr1	SELP	169612216	169612402	0	187	115	3507	115	3320	0.0	0.03463855421686747
chr1	SELP	169593604	169593724	0	121	115	3507	115	3386	0.0	0.03396337861783816
chr1	SELP	169609503	169609689	0	187	115	3507	115	3320	0.0	0.03463855421686747
chr1	SELL	169701559	169701688	0	130	0	2591	0	2461	0.0	0.0
chr1	SELE	169727738	169727927	0	190	2489	4601	2489	4411	0.0	0.5642711403309907
chr1	SELE	169728057	169728246	0	190	2489	4601	2489	4411	0.0	0.5642711403309907
chr1	SELE	169730431	169730617	51	187	2489	4601	2438	4414	0.2727272727272727	0.5523334843679203
chr1	SCYL3	169855795	169855957	0	163	492	6898	492	6735	0.0	0.07305122494432072
chr1	KIFAP3	170055304	170055436	0	133	5503	5001	5503	4868	0.0	1.130443714050945
chr1	KIFAP3	170041676	170041840	0	165	5503	5001	5503	4836	0.0	1.1379239040529363
chr1	LINC01142	170273532	170274507	0	976	0	1808	0	832	0.0	0.0
chr1	BX284613.2	171247565	171247727	0	163	1020	7890	1020	7727	0.0	0.1320046589879643
chr1	BX284613.2	171121749	171121863	816	115	1020	7890	204	7775	7.095652173913043	0.026237942122186494
chr1	BX284613.2	171247580	171247727	0	148	1020	7890	1020	7742	0.0	0.13174890209248255
chr1	BX284613.2	171203890	171203988	0	99	1020	7890	1020	7791	0.0	0.13092029264536004
chr1	DNM3OS	172142135	172142213	0	79	0	2594	0	2515	0.0	0.0
chr1	DNM3OS	172142135	172142233	0	99	0	2594	0	2495	0.0	0.0
chr1	SLC9C2	173554732	173554814	0	83	346	5154	346	5071	0.0	0.06823111812265825
chr1	SLC9C2	173600116	173600217	0	102	346	5154	346	5052	0.0	0.06848772763262075
chr1	CENPL	173806438	173806576	0	139	156089	4921	156089	4782	0.0	32.6409452112087
chr1	CENPL	173802962	173803505	328	544	156089	4921	155761	4377	0.6029411764705882	35.58624628741147
chr1	CENPL	173806458	173806576	0	119	156089	4921	156089	4802	0.0	32.50499791753436
chr1	GAS5	173864483	173864506	144	24	12941	4337	12797	4313	6.0	2.9670762810108973
chr1	GAS5	173865228	173865282	0	55	12941	4337	12941	4282	0.0	3.02218589444185
chr1	RABGAP1L-DT	174158886	174158990	0	105	486	2489	486	2384	0.0	0.20385906040268456
chr1	RABGAP1L-DT	174122083	174122192	0	110	486	2489	486	2379	0.0	0.2042875157629256
chr1	KIAA0040	175177610	175177684	0	75	0	4773	0	4698	0.0	0.0
chr1	KIAA0040	175192639	175192716	0	78	0	4773	0	4695	0.0	0.0
chr1	TNR	175403139	175403616	0	478	51	12830	51	12352	0.0	0.004128886010362694
chr1	COP1	176136487	176136547	0	61	15779	4200	15779	4139	0.0	3.81227349601353
chr1	COP1	176175909	176176007	556	99	15779	4200	15223	4101	5.616161616161616	3.7120214581809314
chr1	COP1	176201260	176201345	0	86	15779	4200	15779	4114	0.0	3.8354399611084102
chr1	COP1	176133846	176133900	0	55	15779	4200	15779	4145	0.0	3.806755126658625
chr1	COP1	176168664	176168748	0	85	15779	4200	15779	4115	0.0	3.8345078979343863
chr1	AL136114.1	177556485	177556556	0	72	0	2756	0	2684	0.0	0.0
chr1	AL136114.1	177576710	177576950	0	241	0	2756	0	2515	0.0	0.0
chr1	AL136114.1	177597570	177597707	0	138	0	2756	0	2618	0.0	0.0
chr1	AL136114.1	177489598	177489649	0	52	0	2756	0	2704	0.0	0.0
chr1	AL136114.1	177399471	177399567	0	97	0	2756	0	2659	0.0	0.0
chr1	SEC16B	177932697	177932806	0	110	858	7408	858	7298	0.0	0.11756645656344204
chr1	CRYZL2P-SEC16B	177960341	177960403	42	63	756	6507	714	6444	0.6666666666666666	0.11080074487895716
chr1	CRYZL2P	178024403	178024486	0	84	3927	5510	3927	5426	0.0	0.7237375598967932
chr1	CRYZL2P	178026154	178026255	0	102	3927	5510	3927	5408	0.0	0.726146449704142
chr1	CRYZL2P	178030607	178030682	0	76	3927	5510	3927	5434	0.0	0.7226720647773279
chr1	ANGPTL1	178869113	178869223	0	111	1281	3604	1281	3493	0.0	0.3667334669338677
chr1	ABL2	179133311	179133374	0	64	14292	11979	14292	11915	0.0	1.199496433067562
chr1	NPHS2	179557026	179557230	0	205	0	1882	0	1677	0.0	0.0
chr1	TOR1AIP2	179865435	179865854	463	420	62665	18885	62202	18465	1.1023809523809525	3.3686433793663686
chr1	TOR1AIP2	179877238	179877373	612	136	62665	18885	62053	18749	4.5	3.3096698490586163
chr1	ACBD6	180326410	180326562	0	153	1928	7516	1928	7363	0.0	0.26184978948798043
chr1	GLUL	182390496	182390852	0	357	102	10959	102	10602	0.0	0.009620826259196379
chr1	RGS8	182669623	182669752	0	130	0	6695	0	6565	0.0	0.0
chr1	NCF2	183574486	183574621	0	136	2976	2526	2976	2390	0.0	1.2451882845188285
chr1	NCF2	183573184	183573292	0	109	2976	2526	2976	2417	0.0	1.231278444352503
chr1	EDEM3	184749546	184749592	0	47	16684	6328	16684	6281	0.0	2.6562649259672027
chr1	EDEM3	184701496	184701544	0	49	16684	6328	16684	6279	0.0	2.657111004937092
chr1	NIBAN1	184823637	184823742	0	106	132116	8346	132116	8240	0.0	16.03349514563107
chr1	LINC01350	185563238	185563328	0	91	0	2415	0	2324	0.0	0.0
chr1	LINC01350	185563167	185563328	0	162	0	2415	0	2253	0.0	0.0
chr1	LINC01350	185565473	185565696	0	224	0	2415	0	2191	0.0	0.0
chr1	LINC01350	185568863	185568895	0	33	0	2415	0	2382	0.0	0.0
chr1	LINC01350	185622726	185622839	0	114	0	2415	0	2301	0.0	0.0
chr1	LINC01350	185585668	185585783	0	116	0	2415	0	2299	0.0	0.0
chr1	LINC01350	185621460	185621586	0	127	0	2415	0	2288	0.0	0.0
chr1	LINC01350	185626780	185626930	0	151	0	2415	0	2264	0.0	0.0
chr1	AL390957.1	192569246	192569304	0	59	859	10139	859	10080	0.0	0.08521825396825397
chr1	AL390957.1	192627340	192627421	0	82	859	10139	859	10057	0.0	0.08541314507308342
chr1	AL390957.1	192589025	192589151	0	127	859	10139	859	10012	0.0	0.08579704354774272
chr1	AL390957.1	192597533	192597747	0	215	859	10139	859	9924	0.0	0.08655783958081419
chr1	AL390957.1	192947623	192947758	0	136	859	10139	859	10003	0.0	0.0858742377286814
chr1	AL390957.1	192947623	192947712	0	90	859	10139	859	10049	0.0	0.08548114240222908
chr1	UCHL5	193020306	193020381	0	76	65016	6676	65016	6600	0.0	9.850909090909092
chr1	UCHL5	193027874	193027955	30	82	65016	6676	64986	6594	0.36585365853658536	9.855323020928116
chr1	AL353709.1	195754505	195754542	0	38	0	6534	0	6496	0.0	0.0
chr1	AL353709.1	195759333	195759458	0	126	0	6534	0	6408	0.0	0.0
chr1	AL353709.1	195758745	195758810	0	66	0	6534	0	6468	0.0	0.0
chr1	KCNT2	196305233	196305345	0	113	969	7225	969	7112	0.0	0.13624859392575928
chr1	KCNT2	196342078	196342228	0	151	969	7225	969	7074	0.0	0.136980491942324
chr1	KCNT2	196468993	196469068	0	76	969	7225	969	7149	0.0	0.1355434326479228
chr1	KCNT2	196319483	196319555	0	73	969	7225	969	7152	0.0	0.13548657718120805
chr1	KCNT2	196259586	196259624	0	39	969	7225	969	7186	0.0	0.134845532980796
chr1	KCNT2	196317173	196317269	0	97	969	7225	969	7128	0.0	0.13594276094276095
chr1	KCNT2	196326716	196326889	0	174	969	7225	969	7051	0.0	0.13742731527442917
chr1	KCNT2	196273467	196273488	0	22	969	7225	969	7203	0.0	0.13452728029987504
chr1	KCNT2	196529394	196529486	0	93	969	7225	969	7132	0.0	0.13586651710600112
chr1	ASPM	197100430	197105185	12681	4756	29862	10916	17181	6160	2.6663162321278384	2.7891233766233765
chr1	ZBTB41	197175930	197176014	0	85	17174	8691	17174	8606	0.0	1.9955844759470136
chr1	DENND1B	197647054	197647114	0	61	3241	11873	3241	11812	0.0	0.2743819844226211
chr1	DENND1B	197715030	197715074	0	45	3241	11873	3241	11828	0.0	0.2740108217788299
chr1	DENND1B	197735585	197735796	0	212	3241	11873	3241	11661	0.0	0.2779349969985421
chr1	ATP6V1G3	198536678	198536724	0	47	0	683	0	636	0.0	0.0
chr1	ATP6V1G3	198536678	198536696	0	19	0	683	0	664	0.0	0.0
chr1	LINC00862	200371045	200371165	153	121	63125	3543	62972	3422	1.2644628099173554	18.402104032729397
chr1	KIF21B	200983055	200983094	0	40	867	11444	867	11404	0.0	0.07602595580498071
chr1	CACNA1S	201054504	201054561	0	58	5839	6097	5839	6039	0.0	0.9668819340950489
chr1	TNNT2	201362385	201362394	0	10	0	5980	0	5970	0.0	0.0
chr1	TNNT2	201372026	201372041	0	16	0	5980	0	5964	0.0	0.0
chr1	TNNT2	201365190	201365307	0	118	0	5980	0	5862	0.0	0.0
chr1	TNNT2	201369815	201369845	0	31	0	5980	0	5949	0.0	0.0
chr1	TNNT2	201362385	201362391	0	7	0	5980	0	5973	0.0	0.0
chr1	LAD1	201391077	201391195	0	119	0	3275	0	3156	0.0	0.0
chr1	CSRP1	201496191	201496304	663	114	19101	6152	18438	6038	5.815789473684211	3.0536601523683338
chr1	CSRP1	201496191	201496261	481	71	19101	6152	18620	6081	6.774647887323944	3.0619963821739846
chr1	ARL8A	202135458	202135526	0	69	0	1981	0	1912	0.0	0.0
chr1	PTPN7	202158117	202158301	0	185	579	3851	579	3666	0.0	0.1579378068739771
chr1	PTPN7	202158117	202158248	0	132	579	3851	579	3719	0.0	0.15568701263780585
chr1	PTPN7	202159280	202159454	0	175	579	3851	579	3676	0.0	0.1575081610446137
chr1	PTPN7	202158117	202158320	0	204	579	3851	579	3647	0.0	0.15876062517137374
chr1	UBE2T	202334988	202335058	0	71	51	1657	51	1586	0.0	0.03215636822194199
chr1	KDM5B	202766925	202767060	51	136	219740	17458	219689	17322	0.375	12.682657891698419
chr1	KDM5B	202774612	202774735	0	124	219740	17458	219740	17334	0.0	12.676820122302988
chr1	KDM5B	202777016	202777094	0	79	219740	17458	219740	17379	0.0	12.643995626906037
chr1	KDM5B	202766396	202766504	0	109	219740	17458	219740	17349	0.0	12.665859703729321
chr1	KDM5B	202766925	202767051	51	127	219740	17458	219689	17331	0.4015748031496063	12.676071778893313
chr1	KDM5B	202776104	202776220	0	117	219740	17458	219740	17341	0.0	12.671702900640101
chr1	KLHL12	202893238	202893425	0	188	22593	3521	22593	3333	0.0	6.778577857785779
chr1	ADIPOR1	202954240	202954307	0	68	0	3123	0	3055	0.0	0.0
chr1	CYB5R1	202966527	202966600	0	74	51	3200	51	3126	0.0	0.016314779270633396
chr1	CHI3L1	203180469	203180652	0	184	51	3371	51	3187	0.0	0.016002510197678066
chr1	CHIT1	203225047	203225104	0	58	144	7752	144	7694	0.0	0.018715882505848713
chr1	CHIT1	203223134	203223259	0	126	144	7752	144	7626	0.0	0.01888276947285602
chr1	CHIT1	203217301	203217372	0	72	144	7752	144	7680	0.0	0.01875
chr1	CHIT1	203217934	203218091	0	158	144	7752	144	7594	0.0	0.01896233868843824
chr1	CHIT1	203230014	203230084	29	71	144	7752	115	7681	0.4084507042253521	0.01497200885301393
chr1	FMOD	203347291	203348277	0	987	51	2329	51	1342	0.0	0.038002980625931444
chr1	ETNK2	204146641	204146764	0	124	255	4420	255	4296	0.0	0.05935754189944134
chr1	PLEKHA6	204243113	204243263	0	151	10923	9689	10923	9538	0.0	1.1452086391276997
chr1	PIK3C2B	204489815	204489931	0	117	22287	9450	22287	9333	0.0	2.387978142076503
chr1	LRRN2	204682869	204682997	0	129	51	5690	51	5561	0.0	0.009171012407840316
chr1	RBBP5	205115857	205115883	247	27	16918	4418	16671	4391	9.148148148148149	3.7966294693691642
chr1	DSTYK	205148204	205148339	0	136	3438	8489	3438	8353	0.0	0.4115886507841494
chr1	KLHDC8A	205343228	205343793	0	566	0	3675	0	3109	0.0	0.0
chr1	KLHDC8A	205348375	205348590	0	216	0	3675	0	3459	0.0	0.0
chr1	KLHDC8A	205344133	205344458	0	326	0	3675	0	3349	0.0	0.0
chr1	LEMD1	205416231	205416296	258	66	258	1049	0	983	3.909090909090909	0.0
chr1	LEMD1	205384287	205384364	0	78	258	1049	258	971	0.0	0.26570545829042225
chr1	LEMD1	205419229	205419352	0	124	258	1049	258	925	0.0	0.2789189189189189
chr1	RAB29	205772495	205772567	0	73	103255	3871	103255	3798	0.0	27.18667719852554
chr1	RAB29	205774832	205775086	0	255	103255	3871	103255	3616	0.0	28.555033185840706
chr1	RAB29	205771471	205771653	0	183	103255	3871	103255	3688	0.0	27.997559652928416
chr1	PM20D1	205832597	205832766	264	170	7015	2624	6751	2454	1.5529411764705883	2.7510187449062755
chr1	PM20D1	205842153	205842215	0	63	7015	2624	7015	2561	0.0	2.7391643889105817
chr1	RAB7B	205985539	205985665	0	127	0	3692	0	3565	0.0	0.0
chr1	CTSE	206022900	206023057	0	158	0	3572	0	3414	0.0	0.0
chr1	CTSE	206012307	206012406	0	100	0	3572	0	3472	0.0	0.0
chr1	CTSE	206012507	206012649	0	143	0	3572	0	3429	0.0	0.0
chr1	CTSE	206014646	206014793	0	148	0	3572	0	3424	0.0	0.0
chr1	EIF2D	206609375	206609459	960	85	42282	5561	41322	5476	11.294117647058824	7.546018991964938
chr1	DYRK3-AS1	206635095	206635130	575	36	128743	941	128168	905	15.972222222222221	141.62209944751382
chr1	IL10	206773679	206773809	0	131	51	3447	51	3316	0.0	0.015379975874547648
chr1	FCMR	206910209	206910340	0	132	468250	3427	468250	3295	0.0	142.1092564491654
chr1	FCMR	206913758	206914094	0	337	468250	3427	468250	3090	0.0	151.53721682847896
chr1	FCMR	206913861	206914094	0	234	468250	3427	468250	3193	0.0	146.64891951143125
chr1	FCMR	206921340	206921433	1208	94	468250	3427	467042	3333	12.851063829787234	140.12661266126614
chr1	FCAMR	206960421	206961223	0	803	102	3549	102	2746	0.0	0.037144938091769844
chr1	FCAMR	206969226	206969358	0	133	102	3549	102	3416	0.0	0.029859484777517563
chr1	C1ORF116	207027493	207027679	0	187	0	5505	0	5318	0.0	0.0
chr1	AL137789.1	207600624	207600855	0	232	0	1513	0	1281	0.0	0.0
chr1	MIR29B2CHG	207818961	207819146	0	186	1582	11453	1582	11267	0.0	0.1404100470400284
chr1	AC092810.2	209153505	209153750	0	246	0	3124	0	2878	0.0	0.0
chr1	AC092810.2	209151404	209151505	0	102	0	3124	0	3022	0.0	0.0
chr1	AC092810.2	209211755	209211886	0	132	0	3124	0	2992	0.0	0.0
chr1	AC092810.2	209161714	209161841	0	128	0	3124	0	2996	0.0	0.0
chr1	AC092810.2	209159483	209159562	0	80	0	3124	0	3044	0.0	0.0
chr1	AC092810.2	209153664	209153750	0	87	0	3124	0	3037	0.0	0.0
chr1	AC092810.2	209155799	209155896	0	98	0	3124	0	3026	0.0	0.0
chr1	AC092810.2	209153571	209153750	0	180	0	3124	0	2944	0.0	0.0
chr1	AL023754.1	209531246	209531374	0	129	0	1078	0	949	0.0	0.0
chr1	IRF6	209793133	209793183	0	51	0	4981	0	4930	0.0	0.0
chr1	KCNH1	210775347	210775544	0	198	124	4644	124	4446	0.0	0.027890238416554206
chr1	KCNH1	210919639	210920069	45	431	124	4644	79	4213	0.10440835266821345	0.01875148350344173
chr1	KCNH1	211090561	211090690	0	130	124	4644	124	4514	0.0	0.027470093043863535
chr1	AC092017.3	211175088	211175253	0	166	0	2372	0	2206	0.0	0.0
chr1	RD3	211481119	211481429	36	311	11999	3514	11963	3203	0.1157556270096463	3.7349359975023417
chr1	INTS7	212020720	212020754	0	35	18399	5042	18399	5007	0.0	3.6746554823247455
chr1	INTS7	212020121	212020268	0	148	18399	5042	18399	4894	0.0	3.7595014303228442
chr1	INTS7	212030736	212030940	0	205	18399	5042	18399	4837	0.0	3.8038040107504654
chr1	LINC02608	212234801	212234919	0	119	21864	1198	21864	1079	0.0	20.26320667284523
chr1	LINC02608	212234502	212234696	0	195	21864	1198	21864	1003	0.0	21.798604187437686
chr1	LINC02608	212232367	212232407	0	41	21864	1198	21864	1157	0.0	18.8971477960242
chr1	PACC1	212413897	212414080	408	184	918	2929	510	2745	2.217391304347826	0.18579234972677597
chr1	NSL1	212739533	212739601	0	69	22150	13874	22150	13805	0.0	1.604491126403477
chr1	NSL1	212766188	212766273	0	86	22150	13874	22150	13788	0.0	1.60646939367566
chr1	ANGEL2	213013092	213013418	0	327	1947	7328	1947	7001	0.0	0.2781031281245536
chr1	PROX1-AS1	213966070	213966284	0	215	23	9778	23	9563	0.0	0.0024051030011502665
chr1	PROX1-AS1	213965303	213965481	0	179	23	9778	23	9599	0.0	0.002396082925304719
chr1	PROX1-AS1	213966070	213966258	0	189	23	9778	23	9589	0.0	0.002398581708207321
chr1	PROX1-AS1	213839737	213839797	0	61	23	9778	23	9717	0.0	0.0023669856951734074
chr1	PROX1-AS1	213840680	213840829	0	150	23	9778	23	9628	0.0	0.0023888658080598256
chr1	PROX1-AS1	213843482	213843568	0	87	23	9778	23	9691	0.0	0.002373336085027345
chr1	PROX1-AS1	213895393	213895518	0	126	23	9778	23	9652	0.0	0.002382925818483216
chr1	PROX1-AS1	213840507	213840600	0	94	23	9778	23	9684	0.0	0.0023750516315572076
chr1	PROX1-AS1	213915934	213916099	0	166	23	9778	23	9612	0.0	0.00239284228048273
chr1	PROX1-AS1	213876637	213876806	0	170	23	9778	23	9608	0.0	0.0023938384679433804
chr1	PROX1-AS1	213921472	213921580	0	109	23	9778	23	9669	0.0	0.0023787361671320714
chr1	PROX1-AS1	213842059	213842240	0	182	23	9778	23	9596	0.0	0.0023968320133388914
chr1	PROX1-AS1	213835852	213836054	0	203	23	9778	23	9575	0.0	0.002402088772845953
chr1	PROX1-AS1	213840092	213840196	0	105	23	9778	23	9673	0.0	0.0023777525069781868
chr1	PROX1-AS1	213895426	213895518	0	93	23	9778	23	9685	0.0	0.002374806401652039
chr1	PROX1-AS1	213963863	213963936	0	74	23	9778	23	9704	0.0	0.002370156636438582
chr1	PROX1-AS1	213894662	213894743	0	82	23	9778	23	9696	0.0	0.002372112211221122
chr1	PROX1-AS1	213837292	213837295	0	4	23	9778	23	9774	0.0	0.002353181911192961
chr1	PROX1-AS1	213979310	213979419	21	110	23	9778	2	9668	0.19090909090909092	0.0002068680182043856
chr1	PROX1-AS1	213963863	213963985	0	123	23	9778	23	9655	0.0	0.002382185396167789
chr1	PROX1-AS1	213895807	213895891	0	85	23	9778	23	9693	0.0	0.0023728463839884453
chr1	PROX1-AS1	213901294	213901409	0	116	23	9778	23	9662	0.0	0.0023804595321879527
chr1	PROX1-AS1	213977128	213977418	0	291	23	9778	23	9487	0.0	0.002424370190787393
chr1	PTPN14	214401684	214401772	0	89	319232	18774	319232	18685	0.0	17.084934439389883
chr1	USH2A	215630188	215630260	0	73	4722	20706	4722	20633	0.0	0.228856685891533
chr1	ESRRG	216650972	216651089	0	118	0	10959	0	10841	0.0	0.0
chr1	ESRRG	216714515	216714634	0	120	0	10959	0	10839	0.0	0.0
chr1	ESRRG	216865060	216865178	0	119	0	10959	0	10840	0.0	0.0
chr1	ESRRG	216959561	216959685	0	125	0	10959	0	10834	0.0	0.0
chr1	ESRRG	216707358	216707486	0	129	0	10959	0	10830	0.0	0.0
chr1	ESRRG	216715073	216715249	0	177	0	10959	0	10782	0.0	0.0
chr1	ESRRG	216936661	216936699	0	39	0	10959	0	10920	0.0	0.0
chr1	LYPLAL1-DT	219149938	219150031	0	94	0	5524	0	5430	0.0	0.0
chr1	LYPLAL1-DT	219156119	219156199	0	81	0	5524	0	5443	0.0	0.0
chr1	LYPLAL1-DT	219081397	219081943	0	547	0	5524	0	4977	0.0	0.0
chr1	LYPLAL1-AS1	219429044	219429175	0	132	0	2629	0	2497	0.0	0.0
chr1	LYPLAL1-AS1	219427269	219427321	0	53	0	2629	0	2576	0.0	0.0
chr1	EPRS1	220018448	220018508	0	61	700	5356	700	5295	0.0	0.13220018885741266
chr1	EPRS1	220019987	220020221	0	235	700	5356	700	5121	0.0	0.1366920523335286
chr1	EPRS1	220030385	220030480	0	96	700	5356	700	5260	0.0	0.13307984790874525
chr1	EPRS1	220018125	220018146	0	22	700	5356	700	5334	0.0	0.13123359580052493
chr1	BPNT1	220072849	220072957	0	109	0	2818	0	2709	0.0	0.0
chr1	BPNT1	220079726	220079854	0	129	0	2818	0	2689	0.0	0.0
chr1	BPNT1	220066072	220066117	0	46	0	2818	0	2772	0.0	0.0
chr1	RAB3GAP2	220210800	220210876	0	77	64946	10381	64946	10304	0.0	6.302989130434782
chr1	DUSP10	221738933	221739787	0	855	0	2833	0	1978	0.0	0.0
chr1	AL513314.2	222480302	222480426	0	125	0	1548	0	1423	0.0	0.0
chr1	TAF1A	222579758	222579872	0	115	175	2904	175	2789	0.0	0.0627465041233417
chr1	TAF1A	222584127	222584297	0	171	175	2904	175	2733	0.0	0.06403219904866447
chr1	TAF1A	222579758	222579825	0	68	175	2904	175	2836	0.0	0.06170662905500705
chr1	AIDA	222670132	222670250	38	119	11580	3582	11542	3463	0.31932773109243695	3.3329483107132543
chr1	AL929091.1	223098689	223098976	0	288	0	4473	0	4185	0.0	0.0
chr1	TLR5	223137177	223137263	0	87	2024	7742	2024	7655	0.0	0.2644023514043109
chr1	TLR5	223141647	223141763	0	117	2024	7742	2024	7625	0.0	0.26544262295081966
chr1	SUSD4	223292438	223292651	0	214	0	4430	0	4216	0.0	0.0
chr1	CAPN8	223538398	223538491	0	94	56	4820	56	4726	0.0	0.01184934405416843
chr1	CAPN8	223642682	223642833	0	152	56	4820	56	4668	0.0	0.011996572407883462
chr1	TP53BP2	223798214	223798677	0	464	0	5901	0	5437	0.0	0.0
chr1	TP53BP2	223821219	223821367	0	149	0	5901	0	5752	0.0	0.0
chr1	TP53BP2	223818205	223818337	0	133	0	5901	0	5768	0.0	0.0
chr1	GTF2IP20	223984381	223984440	0	60	236472	3980	236472	3920	0.0	60.32448979591837
chr1	NVL	224232088	224232182	0	95	1320	4451	1320	4356	0.0	0.30303030303030304
chr1	NVL	224233200	224233289	0	90	1320	4451	1320	4361	0.0	0.30268287090116947
chr1	NVL	224304735	224304812	0	78	1320	4451	1320	4373	0.0	0.30185227532586323
chr1	NVL	224311799	224311857	0	59	1320	4451	1320	4392	0.0	0.3005464480874317
chr1	NVL	224307990	224308263	51	274	1320	4451	1269	4177	0.18613138686131386	0.303806559731865
chr1	NVL	224301690	224301771	0	82	1320	4451	1320	4369	0.0	0.30212863355458913
chr1	NVL	224326390	224326464	84	75	1320	4451	1236	4376	1.12	0.28244972577696525
chr1	NVL	224313049	224313155	126	107	1320	4451	1194	4344	1.1775700934579438	0.27486187845303867
chr1	NVL	224313049	224313151	98	103	1320	4451	1222	4348	0.9514563106796117	0.281048758049678
chr1	WDR26	224393827	224394013	102	187	13486	10645	13384	10458	0.5454545454545454	1.2797858099062918
chr1	WDR26	224431681	224431781	0	101	13486	10645	13486	10544	0.0	1.2790212443095599
chr1	WDR26	224402003	224402109	0	107	13486	10645	13486	10538	0.0	1.279749478079332
chr1	WDR26	224413252	224413335	0	84	13486	10645	13486	10561	0.0	1.276962408862797
chr1	CNIH3-AS2	224615203	224615427	1318	225	4309	4139	2991	3914	5.857777777777778	0.7641798671435871
chr1	LINC02765	225462393	225462493	0	101	459	2015	459	1914	0.0	0.23981191222570533
chr1	LINC02765	225461540	225461729	408	190	459	2015	51	1825	2.1473684210526316	0.027945205479452055
chr1	LINC02765	225450478	225450678	0	201	459	2015	459	1814	0.0	0.25303197353914003
chr1	ENAH	225504990	225505053	0	64	1602	15063	1602	14999	0.0	0.10680712047469831
chr1	ENAH	225531045	225531057	72	13	1602	15063	1530	15050	5.538461538461538	0.10166112956810631
chr1	ENAH	225535506	225535563	0	58	1602	15063	1602	15005	0.0	0.10676441186271243
chr1	PYCR2	225921857	225922079	0	223	3479	3483	3479	3260	0.0	1.0671779141104294
chr1	ACBD3	226159183	226159358	0	176	176	3597	176	3421	0.0	0.05144694533762058
chr1	LIN9	226295841	226295946	0	106	1905	4458	1905	4352	0.0	0.4377297794117647
chr1	PARP1	226374225	226374354	2458	130	9256	16916	6798	16786	18.907692307692308	0.40498034076015726
chr1	CDC42BPA	227059372	227059411	0	40	40256	13908	40256	13868	0.0	2.9027978079030863
chr1	CDC42BPA	227112670	227112913	400	244	40256	13908	39856	13664	1.639344262295082	2.9168618266978923
chr1	CDC42BPA	227010877	227011063	0	187	40256	13908	40256	13721	0.0	2.9338969462867137
chr1	CDC42BPA	227051880	227051985	0	106	40256	13908	40256	13802	0.0	2.916678742211274
chr1	CDC42BPA	227068653	227068701	266	49	40256	13908	39990	13859	5.428571428571429	2.8854895735623063
chr1	MRPL55	228107976	228108137	1582	162	6030	1672	4448	1510	9.765432098765432	2.9456953642384107
chr1	MRPL55	228108436	228108508	76	73	6030	1672	5954	1599	1.0410958904109588	3.7235772357723578
chr1	MRPL55	228107976	228108084	1582	109	6030	1672	4448	1563	14.513761467889909	2.8458093410108765
chr1	MRPL55	228108436	228108474	8	39	6030	1672	6022	1633	0.20512820512820512	3.687691365584813
chr1	MRPL55	228108440	228108508	76	69	6030	1672	5954	1603	1.1014492753623188	3.7142857142857144
chr1	MRPL55	228108954	228109021	100	68	6030	1672	5930	1604	1.4705882352941178	3.697007481296758
chr1	MRPL55	228108436	228109021	1530	586	6030	1672	4500	1086	2.6109215017064846	4.143646408839779
chr1	OBSCN-AS1	228204329	228204433	0	105	0	2798	0	2693	0.0	0.0
chr1	OBSCN-AS1	228205323	228205447	0	125	0	2798	0	2673	0.0	0.0
chr1	TRIM11	228400963	228401194	1572	232	12619	8493	11047	8261	6.775862068965517	1.3372473066214745
chr1	TRIM11	228402065	228402161	738	97	12619	8493	11881	8396	7.608247422680412	1.4150786088613625
chr1	AL162595.1	229267953	229269627	0	1675	0	4970	0	3295	0.0	0.0
chr1	AL162595.1	229268242	229269627	0	1386	0	4970	0	3584	0.0	0.0
chr1	LINC01682	229885539	229885818	0	280	0	2680	0	2400	0.0	0.0
chr1	LINC01682	229875336	229875435	0	100	0	2680	0	2580	0.0	0.0
chr1	AL512328.1	230776849	230776990	0	142	12624	1349	12624	1207	0.0	10.458989229494614
chr1	TTC13	230956420	230956560	0	141	135	4237	135	4096	0.0	0.032958984375
chr1	C1ORF131	231229149	231229209	0	61	28	3253	28	3192	0.0	0.008771929824561403
chr1	C1ORF131	231229149	231229206	0	58	28	3253	28	3195	0.0	0.008763693270735524
chr1	EGLN1	231367568	231367636	0	69	13421	5387	13421	5318	0.0	2.5236931177134263
chr1	EGLN1	231370561	231370698	0	138	13421	5387	13421	5249	0.0	2.5568679748523526
chr1	AL445524.1	231527337	231527415	0	79	938	4123	938	4044	0.0	0.23194856577645895
chr1	EGLN1	231367568	231368187	12	620	13421	5387	13409	4767	0.01935483870967742	2.812880218166562
chr1	AL445524.1	231524282	231524376	0	95	938	4123	938	4028	0.0	0.23286991062562065
chr1	AL445524.1	231527765	231527792	0	28	938	4123	938	4095	0.0	0.22905982905982905
chr1	AL445524.1	231524425	231524547	71	123	938	4123	867	4000	0.5772357723577236	0.21675
chr1	AL136171.2	231822724	231822834	0	111	0	5695	0	5584	0.0	0.0
chr1	AL136171.2	231822679	231822834	0	156	0	5695	0	5539	0.0	0.0
chr1	SIPA1L2	232404124	232404178	0	55	1537	8582	1537	8527	0.0	0.1802509675149525
chr1	SIPA1L2	232471370	232471528	0	159	1537	8582	1537	8423	0.0	0.18247655229728124
chr1	SIPA1L2	232533489	232533583	0	95	1537	8582	1537	8487	0.0	0.18110050665724048
chr1	SIPA1L2	232608826	232608988	0	163	1537	8582	1537	8419	0.0	0.18256324979213684
chr1	SIPA1L2	232608911	232608988	0	78	1537	8582	1537	8504	0.0	0.1807384760112888
chr1	SIPA1L2	232574173	232574222	0	50	1537	8582	1537	8532	0.0	0.18014533520862636
chr1	SIPA1L2	232433413	232433566	0	154	1537	8582	1537	8428	0.0	0.18236829615567157
chr1	SIPA1L2	232419874	232419920	0	47	1537	8582	1537	8535	0.0	0.1800820152314001
chr1	LINC01744	232735700	232735750	0	51	0	2274	0	2223	0.0	0.0
chr1	PCNX2	233025145	233025399	0	255	3144	12393	3144	12138	0.0	0.25902125556104794
chr1	PCNX2	233160282	233160433	0	152	3144	12393	3144	12241	0.0	0.2568417612940119
chr1	PCNX2	233217898	233217931	0	34	3144	12393	3144	12359	0.0	0.2543895137147018
chr1	PCNX2	233227225	233227371	0	147	3144	12393	3144	12246	0.0	0.2567368936795688
chr1	PCNX2	233112844	233112966	755	123	3144	12393	2389	12270	6.138211382113822	0.19470252648736755
chr1	TARBP1	234393361	234393486	0	126	8637	7852	8637	7726	0.0	1.117913538700492
chr1	TARBP1	234393361	234393476	0	116	8637	7852	8637	7736	0.0	1.1164684591520166
chr1	TARBP1	234398381	234398553	0	173	8637	7852	8637	7679	0.0	1.1247558275817164
chr1	AL391832.2	234962545	234962635	0	91	0	2943	0	2852	0.0	0.0
chr1	AL391832.2	234962313	234962415	0	103	0	2943	0	2840	0.0	0.0
chr1	RBM34	235152705	235152765	0	61	132	2905	132	2844	0.0	0.046413502109704644
chr1	RBM34	235160510	235160647	0	138	132	2905	132	2767	0.0	0.047705095771593785
chr1	RBM34	235156594	235156681	132	88	132	2905	0	2817	1.5	0.0
chr1	ARID4B	235213768	235214026	0	259	83	9671	83	9412	0.0	0.008818529536761582
chr1	ARID4B	235176747	235176903	0	157	83	9671	83	9514	0.0	0.008723985705276435
chr1	B3GALNT2	235458602	235458786	0	185	9022	10294	9022	10109	0.0	0.8924720546048076
chr1	B3GALNT2	235489167	235489268	0	102	9022	10294	9022	10192	0.0	0.8852040816326531
chr1	B3GALNT2	235457165	235457251	168	87	9022	10294	8854	10207	1.9310344827586208	0.8674439110414421
chr1	B3GALNT2	235496185	235496308	153	124	9022	10294	8869	10170	1.2338709677419355	0.8720747295968535
chr1	GNG4	235595399	235595511	196	113	4398	5200	4202	5087	1.7345132743362832	0.8260271279732652
chr1	LYST	235791698	235792125	255	428	86694	19662	86439	19234	0.5957943925233645	4.494072995736716
chr1	LYST	235747169	235747331	0	163	86694	19662	86694	19499	0.0	4.44607415764911
chr1	HEATR1	236574660	236574903	0	244	804	9106	804	8862	0.0	0.0907244414353419
chr1	CHRM3-AS2	239727653	239727808	0	156	0	9402	0	9246	0.0	0.0
chr1	CHRM3-AS2	239720138	239720178	0	41	0	9402	0	9361	0.0	0.0
chr1	AL359918.2	240179316	240179475	0	160	0	500	0	340	0.0	0.0
chr1	RGS7	240800640	240800721	0	82	0	2595	0	2513	0.0	0.0
chr1	RGS7	240801454	240801508	0	55	0	2595	0	2540	0.0	0.0
chr1	OPN3	241604259	241604579	0	321	0	3735	0	3414	0.0	0.0
chr1	OPN3	241604419	241604579	0	161	0	3735	0	3574	0.0	0.0
chr1	PLD5	242288361	242288530	0	170	10150	9558	10150	9388	0.0	1.0811674478057094
chr1	SEPTIN14P21	243039280	243039492	0	213	0	1465	0	1252	0.0	0.0
chr1	LINC01347	243089320	243089379	0	60	0	3859	0	3799	0.0	0.0
chr1	CEP170	243185778	243186072	0	295	725	8930	725	8635	0.0	0.08396062536189924
chr1	CEP170	243126377	243126494	0	118	725	8930	725	8812	0.0	0.08227417158420336
chr1	CEP170	243176701	243176816	0	116	725	8930	725	8814	0.0	0.08225550260948492
chr1	AKT3	243613670	243613739	0	70	13809	11633	13809	11563	0.0	1.1942402490703106
chr1	AKT3	243843124	243843282	0	159	13809	11633	13809	11474	0.0	1.2035035732961479
chr1	AKT3	243504387	243505334	2319	948	13809	11633	11490	10685	2.4462025316455698	1.075339260645765
chr1	AKT3	243683196	243683310	0	115	13809	11633	13809	11518	0.0	1.1989060600798749
chr1	HNRNPU	244848787	244848856	0	70	50645	15411	50645	15341	0.0	3.3012841405384266
chr1	HNRNPU	244854972	244855044	306	73	50645	15411	50339	15338	4.191780821917808	3.281979397574651
chr1	HNRNPU	244856456	244856625	0	170	50645	15411	50645	15241	0.0	3.3229446886687226
chr1	HNRNPU	244862618	244862730	135	113	50645	15411	50510	15298	1.1946902654867257	3.3017387893842334
chr1	HNRNPU	244847001	244847101	198	101	50645	15411	50447	15310	1.9603960396039604	3.295035924232528
chr1	HNRNPU	244847001	244847053	48	53	50645	15411	50597	15358	0.9056603773584906	3.2945044927724965
chr1	HNRNPU	244862460	244862534	105	75	50645	15411	50540	15336	1.4	3.2955138236828376
chr1	SMYD3	245764040	245764149	0	110	960	5892	960	5782	0.0	0.16603251470079558
chr1	SMYD3	245915529	245915640	0	112	960	5892	960	5780	0.0	0.16608996539792387
chr1	KIF28P	246780948	246781057	0	110	9069	3552	9069	3442	0.0	2.634805345729227
chr1	AHCTF1	246842693	246842776	495	84	15674	9618	15179	9534	5.892857142857143	1.592091462135515
chr1	AHCTF1	246843794	246843928	0	135	15674	9618	15674	9483	0.0	1.6528524728461458
chr1	ZNF695	246988120	246988255	0	136	1719	3762	1719	3626	0.0	0.4740761169332598
chr1	ZNF695	246988124	246988255	0	132	1719	3762	1719	3630	0.0	0.4735537190082645
chr1	ZNF669	247101730	247101791	0	62	5159	1726	5159	1664	0.0	3.100360576923077
chr1	ZNF496	247322697	247322805	991	109	62312	8915	61321	8806	9.091743119266056	6.96354758119464
chr1	OR6F1	247713890	247713954	0	65	0	1765	0	1700	0.0	0.0
chr1	OR2T27	248651423	248651572	0	150	0	1195	0	1045	0.0	0.0
chr1	ZNF692	248850681	248850781	0	101	51	3751	51	3650	0.0	0.013972602739726028
chr1	ZNF692	248855557	248855635	0	79	51	3751	51	3672	0.0	0.013888888888888888
chr1	ZNF692	248856287	248856422	0	136	51	3751	51	3615	0.0	0.014107883817427386
chr1	ZNF692	248856372	248856422	0	51	51	3751	51	3700	0.0	0.013783783783783784
chr1	ZNF692	248850862	248850947	0	86	51	3751	51	3665	0.0	0.013915416098226467
chr1	ZNF692	248857827	248857859	0	33	51	3751	51	3718	0.0	0.013717052178590641
chr1	ZNF692	248857827	248858017	0	191	51	3751	51	3560	0.0	0.014325842696629213
chr2	SH3YL1	233100	233229	3865	130	70692	8808	66827	8678	29.73076923076923	7.700737497119152
chr2	SH3YL1	224863	224920	189	58	70692	8808	70503	8750	3.2586206896551726	8.057485714285715
chr2	SH3YL1	242797	242871	722	75	70692	8808	69970	8733	9.626666666666667	8.012137867857552
chr2	SH3YL1	243502	243562	268	61	70692	8808	70424	8747	4.39344262295082	8.051217560306391
chr2	SH3YL1	244626	244738	561	113	70692	8808	70131	8695	4.964601769911504	8.065669925244393
chr2	SH3YL1	256206	256690	607	485	70692	8808	70085	8323	1.2515463917525773	8.420641595578518
chr2	SH3YL1	260084	260702	11895	619	70692	8808	58797	8189	19.21647819063005	7.179997557699353
chr2	SH3YL1	262630	262750	3013	121	70692	8808	67679	8687	24.90082644628099	7.790836882698285
chr2	SH3YL1	262630	262786	3877	157	70692	8808	66815	8651	24.694267515923567	7.723384579817362
chr2	SH3YL1	263210	263368	3548	159	70692	8808	67144	8649	22.31446540880503	7.763209619609204
chr2	SH3YL1	263210	263372	3572	163	70692	8808	67120	8645	21.914110429447852	7.764025448235975
chr2	AC079779.3	312956	313157	0	202	0	3482	0	3280	0.0	0.0
chr2	AC079779.3	313873	313884	0	12	0	3482	0	3470	0.0	0.0
chr2	AC079779.3	313873	313892	0	20	0	3482	0	3462	0.0	0.0
chr2	AC079779.3	311487	311659	0	173	0	3482	0	3309	0.0	0.0
chr2	TMEM18	675757	676238	44289	482	350038	8014	305749	7532	91.88589211618257	40.593335103558154
chr2	LINC01115	853978	854215	0	238	204	6823	204	6585	0.0	0.030979498861047835
chr2	LINC01115	794472	795158	0	687	204	6823	204	6136	0.0	0.033246414602346806
chr2	LINC01115	835274	835359	0	86	204	6823	204	6737	0.0	0.030280540299836723
chr2	PXDN	1638845	1638978	0	134	2457238	11294	2457238	11160	0.0	220.1826164874552
chr2	PXDN	1648171	1649675	119618	1505	2457238	11294	2337620	9789	79.48039867109634	238.80069465726837
chr2	PXDN	1687631	1687703	130	73	2457238	11294	2457108	11221	1.7808219178082192	218.97406648248818
chr2	MYT1L	1886538	1886607	0	70	51	31707	51	31637	0.0	0.0016120365394948952
chr2	MYT1L	1922291	1923263	0	973	51	31707	51	30734	0.0	0.001659400013014902
chr2	MYT1L	1942981	1943334	0	354	51	31707	51	31353	0.0	0.0016266385991771121
chr2	MYT1L	1979164	1979227	0	64	51	31707	51	31643	0.0	0.0016117308725468508
chr2	MYT1L	1922285	1923263	0	979	51	31707	51	30728	0.0	0.0016597240302004687
chr2	MYT1L	2284403	2284503	0	101	51	31707	51	31606	0.0	0.0016136176675314814
chr2	MYT1L	1887058	1887121	0	64	51	31707	51	31643	0.0	0.0016117308725468508
chr2	MYT1L	1791872	1792007	0	136	51	31707	51	31571	0.0	0.001615406543980235
chr2	MYT1L	1922285	1923260	0	976	51	31707	51	30731	0.0	0.0016595620057921969
chr2	MYT1L	2326035	2326111	0	77	51	31707	51	31630	0.0	0.0016123932975023712
chr2	MYT1L	2002372	2002515	0	144	51	31707	51	31563	0.0	0.001615815987073472
chr2	MYT1L	1860161	1860251	0	91	51	31707	51	31616	0.0	0.0016131072874493928
chr2	MYT1L	2326035	2326309	0	275	51	31707	51	31432	0.0	0.0016225502672435734
chr2	EIPR1	3274338	3274419	0	82	2071	5742	2071	5660	0.0	0.36590106007067136
chr2	EIPR1	3257298	3257455	108	158	2071	5742	1963	5584	0.6835443037974683	0.3515401146131805
chr2	EIPR1	3338016	3338149	0	134	2071	5742	2071	5608	0.0	0.3692938659058488
chr2	EIPR1	3353205	3353323	0	119	2071	5742	2071	5623	0.0	0.3683087319935977
chr2	EIPR1	3318856	3318958	0	103	2071	5742	2071	5639	0.0	0.36726369923745344
chr2	AC108488.1	3533107	3533190	0	84	0	1197	0	1113	0.0	0.0
chr2	AC108488.1	3536197	3536313	0	117	0	1197	0	1080	0.0	0.0
chr2	RNASEH1	3557674	3557843	0	170	0	5954	0	5784	0.0	0.0
chr2	LINC01304	3959563	3959774	0	212	51	6379	51	6167	0.0	0.008269823252797147
chr2	LINC01304	3961769	3961894	0	126	51	6379	51	6253	0.0	0.008156085079162002
chr2	LINC01304	3959251	3959395	0	145	51	6379	51	6234	0.0	0.008180943214629451
chr2	LINC01304	3968178	3968288	0	111	51	6379	51	6268	0.0	0.008136566687938737
chr2	LINC01304	3959563	3959636	0	74	51	6379	51	6305	0.0	0.00808881839809675
chr2	LINC01304	3961769	3961803	0	35	51	6379	51	6344	0.0	0.008039092055485498
chr2	LINC01304	3965054	3965209	0	156	51	6379	51	6223	0.0	0.008195404145910332
chr2	LINC01249	4634893	4635059	0	167	0	3785	0	3618	0.0	0.0
chr2	MIR7515HG	6635575	6635640	0	66	11358	7267	11358	7201	0.0	1.5772809332037216
chr2	MIR7515HG	6626136	6626238	0	103	11358	7267	11358	7164	0.0	1.585427135678392
chr2	MIR7515HG	6632697	6632742	0	46	11358	7267	11358	7221	0.0	1.5729123390112172
chr2	MIR7515HG	6625028	6625145	0	118	11358	7267	11358	7149	0.0	1.5887536718422157
chr2	MIR7515HG	6634594	6634733	0	140	11358	7267	11358	7127	0.0	1.5936579205836958
chr2	MIR7515HG	6638090	6638153	0	64	11358	7267	11358	7203	0.0	1.5768429820907954
chr2	MIR7515HG	6633668	6633969	0	302	11358	7267	11358	6965	0.0	1.6307250538406317
chr2	MIR7515HG	6634799	6634872	0	74	11358	7267	11358	7193	0.0	1.5790351730849437
chr2	MIR7515HG	6649210	6649263	0	54	11358	7267	11358	7213	0.0	1.5746568695411063
chr2	MIR7515HG	6639050	6639277	0	228	11358	7267	11358	7039	0.0	1.6135814746412842
chr2	MIR7515HG	6647535	6647721	0	187	11358	7267	11358	7080	0.0	1.6042372881355933
chr2	MIR7515HG	6639050	6639273	0	224	11358	7267	11358	7043	0.0	1.6126650575039045
chr2	MIR7515HG	6618062	6618315	0	254	11358	7267	11358	7013	0.0	1.6195636674746898
chr2	MIR7515HG	6625028	6625127	0	100	11358	7267	11358	7167	0.0	1.5847634993721222
chr2	MIR7515HG	6649210	6649381	0	172	11358	7267	11358	7095	0.0	1.600845665961945
chr2	MIR7515HG	6639113	6639277	0	165	11358	7267	11358	7102	0.0	1.5992678118839763
chr2	MIR7515HG	6634442	6634548	0	107	11358	7267	11358	7160	0.0	1.586312849162011
chr2	MIR7515HG	6634799	6634911	0	113	11358	7267	11358	7154	0.0	1.5876432764886776
chr2	MIR7515HG	6635119	6635251	0	133	11358	7267	11358	7134	0.0	1.592094196804037
chr2	MIR7515HG	6634594	6634911	0	318	11358	7267	11358	6949	0.0	1.6344797812634912
chr2	MIR7515HG	6634594	6634872	0	279	11358	7267	11358	6988	0.0	1.6253577561534058
chr2	MIR7515HG	6638966	6639277	0	312	11358	7267	11358	6955	0.0	1.6330697340043134
chr2	MIR7515HG	6636807	6636848	24	42	11358	7267	11334	7225	0.5714285714285714	1.568719723183391
chr2	MIR7515HG	6649210	6649327	0	118	11358	7267	11358	7149	0.0	1.5887536718422157
chr2	MIR7515HG	6649568	6649722	0	155	11358	7267	11358	7112	0.0	1.5970191226096737
chr2	AC007463.1	7889485	7889559	0	75	0	888	0	813	0.0	0.0
chr2	AC007463.1	7887774	7887809	0	36	0	888	0	852	0.0	0.0
chr2	LINC00298	7968144	7968279	0	136	51	4416	51	4280	0.0	0.01191588785046729
chr2	LINC00298	7925638	7925752	51	115	51	4416	0	4301	0.4434782608695652	0.0
chr2	LINC00299	8312725	8312849	0	125	561	22103	561	21978	0.0	0.025525525525525526
chr2	LINC00299	8383476	8383655	0	180	561	22103	561	21923	0.0	0.025589563472152535
chr2	LINC00299	8376531	8376633	0	103	561	22103	561	22000	0.0	0.0255
chr2	LINC01814	8545147	8545236	0	90	51	13537	51	13447	0.0	0.0037926675094816687
chr2	LINC01814	8579910	8580047	0	138	51	13537	51	13399	0.0	0.0038062541980744833
chr2	LINC01814	8575889	8575961	0	73	51	13537	51	13464	0.0	0.003787878787878788
chr2	LINC01814	8582977	8583073	0	97	51	13537	51	13440	0.0	0.003794642857142857
chr2	LINC01814	8578951	8579060	0	110	51	13537	51	13427	0.0	0.0037983168243092276
chr2	ID2-AS1	8675743	8676029	0	287	51	6592	51	6305	0.0	0.00808881839809675
chr2	ID2-AS1	8675743	8675855	0	113	51	6592	51	6479	0.0	0.007871585121160672
chr2	ID2-AS1	8677418	8677560	0	143	51	6592	51	6449	0.0	0.007908202822142968
chr2	KIDINS220	8727188	8727267	0	80	220	14698	220	14618	0.0	0.01504993843207005
chr2	KIDINS220	8747144	8747201	0	58	220	14698	220	14640	0.0	0.015027322404371584
chr2	KIDINS220	8747886	8748000	0	115	220	14698	220	14583	0.0	0.015086059109922513
chr2	KIDINS220	8825742	8825913	0	172	220	14698	220	14526	0.0	0.015145256780944513
chr2	KIDINS220	8740151	8740184	0	34	220	14698	220	14664	0.0	0.015002727768685215
chr2	KIDINS220	8749370	8749421	0	52	220	14698	220	14646	0.0	0.01502116618872047
chr2	MBOAT2	8862270	8862322	0	53	8650	8666	8650	8613	0.0	1.0042958318820387
chr2	MBOAT2	8862589	8862722	17	134	8650	8666	8633	8532	0.12686567164179105	1.0118377871542428
chr2	ITGB1BP1	9407448	9407598	0	151	918	6364	918	6213	0.0	0.14775470787059392
chr2	ITGB1BP1	9414177	9414256	0	80	918	6364	918	6284	0.0	0.1460852959898154
chr2	ITGB1BP1	9418625	9418732	0	108	918	6364	918	6256	0.0	0.14673913043478262
chr2	ITGB1BP1	9419989	9420100	0	112	918	6364	918	6252	0.0	0.14683301343570057
chr2	ADAM17	9505165	9505365	0	201	38014	10467	38014	10266	0.0	3.702902785895188
chr2	ADAM17	9523248	9523338	0	91	38014	10467	38014	10376	0.0	3.6636468774094064
chr2	NOL10	10657741	10657891	0	151	1154	3858	1154	3707	0.0	0.31130294038305906
chr2	NOL10	10675793	10675871	0	79	1154	3858	1154	3779	0.0	0.30537179147922733
chr2	NOL10	10684566	10684612	0	47	1154	3858	1154	3811	0.0	0.302807662030963
chr2	PDIA6	10810242	10810420	663	179	5669	4116	5006	3937	3.7039106145251397	1.2715265430530862
chr2	PDIA6	10820770	10820918	0	149	5669	4116	5669	3967	0.0	1.4290395765061759
chr2	AC062028.1	11106695	11106787	0	93	0	4225	0	4132	0.0	0.0
chr2	AC062028.1	11123151	11123289	0	139	0	4225	0	4086	0.0	0.0
chr2	AC062028.1	11128983	11129098	0	116	0	4225	0	4109	0.0	0.0
chr2	ROCK2	11235701	11235962	0	262	18	10233	18	9971	0.0	0.001805235182027881
chr2	E2F6	11458280	11458351	0	72	153	4076	153	4004	0.0	0.03821178821178821
chr2	E2F6	11457178	11457233	0	56	153	4076	153	4020	0.0	0.03805970149253731
chr2	E2F6	11455341	11455474	0	134	153	4076	153	3942	0.0	0.03881278538812785
chr2	AC064875.1	13002423	13002608	0	186	9203	4174	9203	3988	0.0	2.3076730190571717
chr2	AC064875.1	12981036	12981118	0	83	9203	4174	9203	4091	0.0	2.249572231728184
chr2	AC064875.1	12972531	12972586	0	56	9203	4174	9203	4118	0.0	2.2348227294803302
chr2	AC064875.1	13001587	13001741	0	155	9203	4174	9203	4019	0.0	2.2898731027618813
chr2	NBAS	15178987	15179116	0	130	3934	9002	3934	8872	0.0	0.4434174932371506
chr2	NBAS	15218772	15218968	0	197	3934	9002	3934	8805	0.0	0.4467915956842703
chr2	NBAS	15483261	15483368	0	108	3934	9002	3934	8894	0.0	0.44232066561727007
chr2	CYRIA	16622938	16623137	0	200	0	5464	0	5264	0.0	0.0
chr2	SMC6	17752977	17753064	0	88	0	9859	0	9771	0.0	0.0
chr2	SMC6	17799150	17799225	0	76	0	9859	0	9783	0.0	0.0
chr2	SMC6	17740744	17740822	0	79	0	9859	0	9780	0.0	0.0
chr2	SMC6	17713384	17713580	0	197	0	9859	0	9662	0.0	0.0
chr2	SMC6	17753001	17753064	0	64	0	9859	0	9795	0.0	0.0
chr2	NT5C1B	18563844	18564119	0	276	0	3862	0	3586	0.0	0.0
chr2	NT5C1B	18586993	18587173	0	181	0	3862	0	3681	0.0	0.0
chr2	NT5C1B	18586942	18587173	0	232	0	3862	0	3630	0.0	0.0
chr2	LINC01376	19031323	19031380	0	58	50	3056	50	2998	0.0	0.01667778519012675
chr2	TTC32	19897868	19898035	0	168	0	1999	0	1831	0.0	0.0
chr2	WDR35	19914036	19914277	0	242	0	7835	0	7593	0.0	0.0
chr2	WDR35	19960553	19960614	0	62	0	7835	0	7773	0.0	0.0
chr2	WDR35	19962294	19962327	0	34	0	7835	0	7801	0.0	0.0
chr2	MATN3	20003160	20003286	0	127	0	3159	0	3032	0.0	0.0
chr2	SDC1	20223202	20223278	0	77	6785	2932	6785	2855	0.0	2.3765323992994745
chr2	PUM2	20278582	20278819	0	238	257844	6889	257844	6651	0.0	38.767704104645915
chr2	PUM2	20311493	20311663	0	171	257844	6889	257844	6718	0.0	38.38106579339089
chr2	PUM2	20318536	20318645	0	110	257844	6889	257844	6779	0.0	38.03569848060186
chr2	PUM2	20326260	20326385	0	126	257844	6889	257844	6763	0.0	38.12568386810587
chr2	HS1BP3	20640972	20641180	0	209	51	10915	51	10706	0.0	0.0047636839155613675
chr2	HS1BP3	20645339	20645505	0	167	51	10915	51	10748	0.0	0.004745068850018608
chr2	LDAH	20739970	20740205	0	236	3129	3421	3129	3185	0.0	0.9824175824175824
chr2	LDAH	20801291	20801465	315	175	3129	3421	2814	3246	1.8	0.866913123844732
chr2	LDAH	20790254	20790398	0	145	3129	3421	3129	3276	0.0	0.9551282051282052
chr2	LDAH	20801309	20801465	255	157	3129	3421	2874	3264	1.624203821656051	0.8805147058823529
chr2	APOB	21016438	21016649	0	212	102	14858	102	14646	0.0	0.006964358869315854
chr2	APOB	21037957	21038111	0	155	102	14858	102	14703	0.0	0.0069373597225056115
chr2	AC009411.1	21639172	21639298	0	127	0	1365	0	1238	0.0	0.0
chr2	LINC01822	21692835	21692994	0	160	204	2303	204	2143	0.0	0.09519365375641624
chr2	LINC01822	21692835	21692999	0	165	204	2303	204	2138	0.0	0.09541627689429373
chr2	AC096570.1	21946340	21946554	0	215	1	5616	1	5401	0.0	0.00018515089798185522
chr2	AC096570.1	21964552	21964613	0	62	1	5616	1	5554	0.0	0.00018005041411595248
chr2	AC096570.1	22530123	22530353	1	231	1	5616	0	5385	0.004329004329004329	0.0
chr2	AC018467.1	23030541	23030660	0	120	0	1777	0	1657	0.0	0.0
chr2	AC018467.1	23166734	23166963	0	230	0	1777	0	1547	0.0	0.0
chr2	AC018467.1	23077819	23077917	0	99	0	1777	0	1678	0.0	0.0
chr2	AC012506.4	23376237	23376329	0	93	0	757	0	664	0.0	0.0
chr2	AC012506.4	23380123	23380241	0	119	0	757	0	638	0.0	0.0
chr2	ATAD2B	23883593	23883635	0	43	0	10538	0	10495	0.0	0.0
chr2	WDCP	24032828	24032946	0	119	222	3875	222	3756	0.0	0.05910543130990415
chr2	TP53I3	24079443	24079640	3	198	1444	2318	1441	2120	0.015151515151515152	0.6797169811320755
chr2	PFN4	24122418	24122547	0	130	102	1611	102	1481	0.0	0.0688723835246455
chr2	PFN4	24122751	24122833	0	83	102	1611	102	1528	0.0	0.06675392670157068
chr2	ITSN2	24209099	24209221	2056	123	68602	11889	66546	11766	16.715447154471544	5.655787863335033
chr2	ITSN2	24284762	24284843	0	82	68602	11889	68602	11807	0.0	5.810282036080292
chr2	ITSN2	24206243	24206275	0	33	68602	11889	68602	11856	0.0	5.786268556005398
chr2	ITSN2	24308877	24308952	29	76	68602	11889	68573	11813	0.3815789473684211	5.80487598408533
chr2	ADCY3	24872569	24872719	0	151	295	5388	295	5237	0.0	0.05632995990070651
chr2	ADCY3	24838846	24838912	0	67	295	5388	295	5321	0.0	0.055440706634091334
chr2	ADCY3	24820383	24820451	0	69	295	5388	295	5319	0.0	0.05546155292348186
chr2	DNAJC27	24951393	24951554	0	162	51	5634	51	5472	0.0	0.00932017543859649
chr2	DNAJC27	24953549	24953635	0	87	51	5634	51	5547	0.0	0.009194159004867496
chr2	DNAJC27	24958546	24958601	0	56	51	5634	51	5578	0.0	0.00914306202940122
chr2	POMC	25165635	25165685	0	51	1224	1542	1224	1491	0.0	0.8209255533199196
chr2	DNMT3A	25236935	25237005	0	71	1134	12088	1134	12017	0.0	0.0943663143879504
chr2	DNMT3A	25240301	25240450	0	150	1134	12088	1134	11938	0.0	0.0949907857262523
chr2	DNMT3A	25241561	25241707	0	147	1134	12088	1134	11941	0.0	0.09496692069340926
chr2	DNMT3A	25249656	25249724	0	69	1134	12088	1134	12019	0.0	0.09435061153174142
chr2	DNMT3A	25239314	25239513	0	200	1134	12088	1134	11888	0.0	0.09539030955585465
chr2	DTNB	25419514	25419535	0	22	57218	7172	57218	7150	0.0	8.002517482517483
chr2	DTNB	25455404	25455494	1329	91	57218	7172	55889	7081	14.604395604395604	7.89281174975286
chr2	DTNB	25596085	25596240	255	156	57218	7172	56963	7016	1.6346153846153846	8.119013683010262
chr2	DTNB	25607235	25607321	51	87	57218	7172	57167	7085	0.5862068965517241	8.068736767819336
chr2	DTNB	25639013	25639094	392	82	57218	7172	56826	7090	4.780487804878049	8.014950634696756
chr2	DTNB	25383835	25383889	0	55	57218	7172	57218	7117	0.0	8.039623436841365
chr2	DTNB	25387288	25387378	0	91	57218	7172	57218	7081	0.0	8.080497104928682
chr2	DTNB	25628170	25628384	51	215	57218	7172	57167	6957	0.2372093023255814	8.21719131809688
chr2	KIF3C	25938234	25938348	0	115	3400	6411	3400	6296	0.0	0.5400254129606099
chr2	KIF3C	25934032	25934156	0	125	3400	6411	3400	6286	0.0	0.5408845052497614
chr2	HADHA	26232159	26232279	0	121	6309	4348	6309	4227	0.0	1.4925479063165366
chr2	HADHA	26236854	26236988	0	135	6309	4348	6309	4213	0.0	1.497507714217897
chr2	HADHA	26199242	26199366	564	125	6309	4348	5745	4223	4.512	1.3604072933933222
chr2	HADHA	26210694	26210814	0	121	6309	4348	6309	4227	0.0	1.4925479063165366
chr2	HADHA	26210544	26210814	0	271	6309	4348	6309	4077	0.0	1.5474613686534215
chr2	OTOF	26460007	26460205	0	199	208348	8072	208348	7873	0.0	26.46360980566493
chr2	MAPRE3-AS1	26986660	26986770	0	111	10629	2446	10629	2335	0.0	4.55203426124197
chr2	CGREF1	27102359	27102430	0	72	45	3355	45	3283	0.0	0.01370697532744441
chr2	CGREF1	27110672	27110968	0	297	45	3355	45	3058	0.0	0.014715500327011119
chr2	PREB	27132229	27132403	0	175	0	2369	0	2194	0.0	0.0
chr2	PREB	27131671	27131831	0	161	0	2369	0	2208	0.0	0.0
chr2	PREB	27133531	27133721	0	191	0	2369	0	2178	0.0	0.0
chr2	PREB	27133531	27133654	0	124	0	2369	0	2245	0.0	0.0
chr2	PREB	27131673	27131831	0	159	0	2369	0	2210	0.0	0.0
chr2	SLC5A6	27206482	27206534	0	53	262	5118	262	5065	0.0	0.051727541954590325
chr2	SLC5A6	27208613	27208686	0	74	262	5118	262	5044	0.0	0.05194290245836638
chr2	SLC5A6	27208393	27208448	0	56	262	5118	262	5062	0.0	0.05175819834057685
chr2	SLC5A6	27212019	27212146	0	128	262	5118	262	4990	0.0	0.05250501002004008
chr2	SLC30A3	27257904	27258058	18999	155	346952	5592	327953	5437	122.5741935483871	60.31874195328306
chr2	SLC30A3	27263345	27263459	18335	115	346952	5592	328617	5477	159.43478260869566	59.99945225488406
chr2	SLC30A3	27264009	27264082	69247	74	346952	5592	277705	5518	935.7702702702703	50.32711127220007
chr2	MPV17	27311898	27311951	0	54	55871	4256	55871	4202	0.0	13.296287482151357
chr2	MPV17	27312493	27312589	0	97	55871	4256	55871	4159	0.0	13.433758114931473
chr2	MPV17	27312213	27312246	154	34	55871	4256	55717	4222	4.529411764705882	13.196826148744671
chr2	MPV17	27312679	27312772	0	94	55871	4256	55871	4162	0.0	13.424074963959635
chr2	MPV17	27316158	27316186	0	29	55871	4256	55871	4227	0.0	13.217648450437663
chr2	MPV17	27312993	27313109	490	117	55871	4256	55381	4139	4.188034188034188	13.380285093017637
chr2	MPV17	27317077	27317234	714	158	55871	4256	55157	4098	4.518987341772152	13.45949243533431
chr2	GTF3C2	27356086	27356186	33198	101	90796	5782	57598	5681	328.6930693069307	10.138707973948248
chr2	GTF3C2	27350313	27350632	0	320	90796	5782	90796	5462	0.0	16.62321493958257
chr2	IFT172	27445744	27445843	21694	100	648389	12448	626695	12348	216.94	50.75275348234532
chr2	IFT172	27449498	27449562	6081	65	648389	12448	642308	12383	93.55384615384615	51.87014455301623
chr2	IFT172	27453629	27453739	204	111	648389	12448	648185	12337	1.837837837837838	52.5399205641566
chr2	IFT172	27476640	27476726	37	87	648389	12448	648352	12361	0.42528735632183906	52.45141978804304
chr2	IFT172	27484226	27484266	0	41	648389	12448	648389	12407	0.0	52.25993390827759
chr2	IFT172	27486158	27486242	0	85	648389	12448	648389	12363	0.0	52.44592736390844
chr2	IFT172	27445552	27445629	0	78	648389	12448	648389	12370	0.0	52.416248989490704
chr2	IFT172	27484027	27484106	0	80	648389	12448	648389	12368	0.0	52.42472509702458
chr2	FNDC4	27492665	27492790	0	126	0	1943	0	1817	0.0	0.0
chr2	SUPT7L	27660983	27661388	2243	406	239208	5317	236965	4911	5.524630541871921	48.25188352677662
chr2	SUPT7L	27660983	27661601	4186	619	239208	5317	235022	4698	6.762520193861066	50.02596849723287
chr2	RBKS	27869771	27870890	55633	1120	56814	3164	1181	2044	49.67232142857143	0.5777886497064579
chr2	RBKS	27861412	27861546	0	135	56814	3164	56814	3029	0.0	18.756685374711125
chr2	FLJ31356	28387760	28387911	0	152	0	3004	0	2852	0.0	0.0
chr2	AC092164.1	28731665	28731737	0	73	0	5024	0	4951	0.0	0.0
chr2	AC092164.1	28731910	28731983	0	74	0	5024	0	4950	0.0	0.0
chr2	TRMT61B	28851071	28851298	0	228	0	2045	0	1817	0.0	0.0
chr2	ALK	29224617	29224678	0	62	899	7416	899	7354	0.0	0.12224639651890128
chr2	CAPN13	30775929	30776045	0	117	24	4978	24	4861	0.0	0.004937255708701913
chr2	CAPN13	30806180	30806266	0	87	24	4978	24	4891	0.0	0.0049069719893682275
chr2	GALNT14	30966203	30966302	0	100	13679	4371	13679	4271	0.0	3.202762819011941
chr2	GALNT14	30992837	30993007	0	171	13679	4371	13679	4200	0.0	3.256904761904762
chr2	GALNT14	31114742	31114827	0	86	13679	4371	13679	4285	0.0	3.192298716452742
chr2	GALNT14	31125153	31125253	0	101	13679	4371	13679	4270	0.0	3.203512880562061
chr2	GALNT14	31132629	31132712	0	84	13679	4371	13679	4287	0.0	3.190809423839515
chr2	CAPN14	31201861	31201998	0	138	1103	4008	1103	3870	0.0	0.28501291989664085
chr2	MEMO1	31883385	31883462	0	78	0	5233	0	5155	0.0	0.0
chr2	MEMO1	31932066	31932135	0	70	0	5233	0	5163	0.0	0.0
chr2	MEMO1	32010186	32010264	0	79	0	5233	0	5154	0.0	0.0
chr2	DPY30	32023676	32023808	0	133	0	2602	0	2469	0.0	0.0
chr2	NLRC4	32249606	32251601	7328	1996	21939	3799	14611	1803	3.6713426853707416	8.103716028840822
chr2	FAM98A	33586561	33586678	2557	118	63397	4926	60840	4808	21.66949152542373	12.653910149750416
chr2	FAM98A	33588334	33588519	13356	186	63397	4926	50041	4740	71.80645161290323	10.55717299578059
chr2	FEZ2	36558437	36558513	0	77	1378	5090	1378	5013	0.0	0.274885298224616
chr2	FEZ2	36555976	36556060	0	85	1378	5090	1378	5005	0.0	0.2753246753246753
chr2	FEZ2	36581504	36581590	0	87	1378	5090	1378	5003	0.0	0.27543473915650607
chr2	FEZ2	36560784	36560865	0	82	1378	5090	1378	5008	0.0	0.2751597444089457
chr2	FEZ2	36554169	36554262	0	94	1378	5090	1378	4996	0.0	0.2758206565252202
chr2	STRN	36886715	36886826	0	112	0	14334	0	14222	0.0	0.0
chr2	EIF2AK2	37126288	37126411	367	124	13757	6264	13390	6140	2.9596774193548385	2.1807817589576546
chr2	SULT6B1	37191220	37191253	0	34	2	1336	2	1302	0.0	0.0015360983102918587
chr2	PRKD3	37260222	37260384	0	163	38946	9554	38946	9391	0.0	4.147162176552018
chr2	PRKD3	37316236	37317179	10761	944	38946	9554	28185	8610	11.399364406779661	3.273519163763066
chr2	PRKD3	37268300	37268372	2490	73	38946	9554	36456	9481	34.10958904109589	3.845164012234996
chr2	LINC00211	37875742	37875883	0	142	7287	3817	7287	3675	0.0	1.9828571428571429
chr2	LINC00211	37871807	37871888	1181	82	7287	3817	6106	3735	14.402439024390244	1.634805890227577
chr2	RMDN2-AS1	38029854	38029920	0	67	0	3034	0	2967	0.0	0.0
chr2	RMDN2-AS1	38030318	38030474	0	157	0	3034	0	2877	0.0	0.0
chr2	RMDN2-AS1	38030686	38030825	0	140	0	3034	0	2894	0.0	0.0
chr2	ATL2	38343267	38343512	0	246	3491650	5619	3491650	5373	0.0	649.8511073887959
chr2	ATL2	38296685	38296700	10186	16	3491650	5619	3481464	5603	636.625	621.3571301088703
chr2	ATL2	38354066	38354177	0	112	3491650	5619	3491650	5507	0.0	634.0384964590521
chr2	ATL2	38358442	38358688	0	247	3491650	5619	3491650	5372	0.0	649.9720774385704
chr2	LINC02613	38424421	38424469	0	49	51	5399	51	5350	0.0	0.009532710280373832
chr2	LINC02613	38462902	38462971	0	70	51	5399	51	5329	0.0	0.009570275849127416
chr2	LINC02613	38456318	38456390	0	73	51	5399	51	5326	0.0	0.009575666541494556
chr2	HNRNPLL	38582071	38582173	0	103	5555	5109	5555	5006	0.0	1.109668397922493
chr2	HNRNPLL	38577919	38578002	0	84	5555	5109	5555	5025	0.0	1.1054726368159205
chr2	SRSF7	38746143	38746179	0	37	0	3873	0	3836	0.0	0.0
chr2	SRSF7	38748897	38749346	0	450	0	3873	0	3423	0.0	0.0
chr2	SRSF7	38747061	38747130	0	70	0	3873	0	3803	0.0	0.0
chr2	SRSF7	38748897	38749173	0	277	0	3873	0	3596	0.0	0.0
chr2	DHX57	38806558	38806693	0	136	509	7002	509	6866	0.0	0.07413341101077775
chr2	DHX57	38868181	38868411	0	231	509	7002	509	6771	0.0	0.07517353418992763
chr2	SOS1	38989269	38989314	0	46	6085	9674	6085	9628	0.0	0.6320108018280016
chr2	CDKL4	39225838	39225960	0	123	16109	2083	16109	1960	0.0	8.218877551020409
chr2	MAP4K3	39307942	39308005	0	64	29321	6093	29321	6029	0.0	4.863327251617184
chr2	MAP4K3	39378065	39378123	0	59	29321	6093	29321	6034	0.0	4.859297315213788
chr2	MAP4K3	39303073	39303117	0	45	29321	6093	29321	6048	0.0	4.848048941798941
chr2	THUMPD2	39757247	39757368	0	122	68	3435	68	3313	0.0	0.02052520374283127
chr2	THUMPD2	39771504	39771640	0	137	68	3435	68	3298	0.0	0.020618556701030927
chr2	THUMPD2	39771514	39771640	0	127	68	3435	68	3308	0.0	0.020556227327690448
chr2	THUMPD2	39768900	39769093	0	194	68	3435	68	3241	0.0	0.020981178648565257
chr2	SLC8A1	40178386	40178493	0	108	0	21938	0	21830	0.0	0.0
chr2	SLC8A1	40174705	40174720	0	16	0	21938	0	21922	0.0	0.0
chr2	SLC8A1	40170280	40170349	0	70	0	21938	0	21868	0.0	0.0
chr2	SLC8A1	40453160	40453349	0	190	0	21938	0	21748	0.0	0.0
chr2	SLC8A1	40446414	40446648	0	235	0	21938	0	21703	0.0	0.0
chr2	LINC01914	41932419	41932528	0	110	0	1088	0	978	0.0	0.0
chr2	HAAO	42769712	42769858	0	147	174	2486	174	2339	0.0	0.07439076528430953
chr2	HAAO	42770492	42770582	0	91	174	2486	174	2395	0.0	0.07265135699373695
chr2	HAAO	42789007	42789166	0	160	174	2486	174	2326	0.0	0.07480653482373173
chr2	LINC01819	43032733	43032902	0	170	318	3848	318	3678	0.0	0.0864600326264274
chr2	LINC01819	43033229	43033526	12	298	318	3848	306	3550	0.040268456375838924	0.08619718309859155
chr2	LINC01819	43038522	43038599	0	78	318	3848	318	3770	0.0	0.0843501326259947
chr2	LINC02580	43100319	43100398	26	80	26	3098	0	3018	0.325	0.0
chr2	THADA	43428099	43428231	0	133	2289	14267	2289	14134	0.0	0.16194990802320644
chr2	THADA	43556344	43556555	0	212	2289	14267	2289	14055	0.0	0.16286019210245464
chr2	THADA	43430212	43430302	0	91	2289	14267	2289	14176	0.0	0.16147009029345372
chr2	THADA	43592843	43592890	0	48	2289	14267	2289	14219	0.0	0.1609817849356495
chr2	ABCG5	43824218	43824432	0	215	2818	3732	2818	3517	0.0	0.8012510662496446
chr2	LRPPRC	43890222	43890362	1	141	6494	10068	6493	9927	0.0070921985815602835	0.6540747456431953
chr2	PREPL	44332458	44332656	0	199	51	6296	51	6097	0.0	0.008364769558799409
chr2	PREPL	44338350	44338536	0	187	51	6296	51	6109	0.0	0.008348338516942217
chr2	PREPL	44344519	44344586	0	68	51	6296	51	6228	0.0	0.008188824662813102
chr2	PREPL	44359496	44360038	0	543	51	6296	51	5753	0.0	0.008864940031288024
chr2	PREPL	44359496	44359750	0	255	51	6296	51	6041	0.0	0.008442310875682833
chr2	PREPL	44360618	44360676	0	59	51	6296	51	6237	0.0	0.008177008177008177
chr2	LINC01121	45211600	45211660	0	61	0	4879	0	4818	0.0	0.0
chr2	LINC01121	45190882	45191084	0	203	0	4879	0	4676	0.0	0.0
chr2	SRBD1	45476992	45477075	0	84	46	5070	46	4986	0.0	0.009225832330525471
chr2	PIGF	46613693	46613785	22376	93	142714	3770	120338	3677	240.6021505376344	32.7272232798477
chr2	PIGF	46591802	46591925	0	124	142714	3770	142714	3646	0.0	39.14262205156336
chr2	PIGF	46588074	46588179	37100	106	142714	3770	105614	3664	350.0	28.824781659388645
chr2	MCFD2	46907809	46907969	0	161	51	5539	51	5378	0.0	0.009483079211602826
chr2	MCFD2	46912542	46912658	0	117	51	5539	51	5422	0.0	0.009406123201770564
chr2	MCFD2	46909022	46909177	0	156	51	5539	51	5383	0.0	0.009474270852684376
chr2	MCFD2	46910779	46910873	0	95	51	5539	51	5444	0.0	0.009368111682586333
chr2	CALM2	47162285	47162392	0	108	1162	5477	1162	5369	0.0	0.21642764015645372
chr2	CALM2	47172413	47172459	17	47	1162	5477	1145	5430	0.3617021276595745	0.21086556169429096
chr2	CALM2	47167475	47167690	0	216	1162	5477	1162	5261	0.0	0.22087055692834062
chr2	AC092650.1	48148974	48149108	0	135	6420	8084	6420	7949	0.0	0.8076487608504215
chr2	AC092650.1	48243468	48243619	0	152	6420	8084	6420	7932	0.0	0.8093797276853253
chr2	LHCGR	48694223	48694304	0	82	11870	4117	11870	4035	0.0	2.9417596034696407
chr2	LHCGR	48729152	48729227	483	76	11870	4117	11387	4041	6.355263157894737	2.817866864637466
chr2	FSHR	48968697	48968883	0	187	0	3172	0	2985	0.0	0.0
chr2	FSHR	48988976	48989054	0	79	0	3172	0	3093	0.0	0.0
chr2	FSHR	49014696	49014947	0	252	0	3172	0	2920	0.0	0.0
chr2	AC009975.2	49339510	49339574	0	65	0	2105	0	2040	0.0	0.0
chr2	NRXN1	50054954	50055044	0	91	0	25608	0	25517	0.0	0.0
chr2	NRXN1	50528624	50528651	0	28	0	25608	0	25580	0.0	0.0
chr2	NRXN1	50621225	50621249	0	25	0	25608	0	25583	0.0	0.0
chr2	NRXN1	50921868	50921880	0	13	0	25608	0	25595	0.0	0.0
chr2	NRXN1	50925937	50925955	0	19	0	25608	0	25589	0.0	0.0
chr2	NRXN1	49926287	49926390	0	104	0	25608	0	25504	0.0	0.0
chr2	NRXN1	50621204	50621249	0	46	0	25608	0	25562	0.0	0.0
chr2	NRXN1	51026370	51026469	0	100	0	25608	0	25508	0.0	0.0
chr2	NRXN1	50185541	50185650	0	110	0	25608	0	25498	0.0	0.0
chr2	NRXN1	50466460	50466487	0	28	0	25608	0	25580	0.0	0.0
chr2	NRXN1	50547469	50547523	0	55	0	25608	0	25553	0.0	0.0
chr2	NRXN1	50624807	50624967	0	161	0	25608	0	25447	0.0	0.0
chr2	NRXN1	50925937	50925952	0	16	0	25608	0	25592	0.0	0.0
chr2	AC010967.1	52723737	52723897	0	161	0	847	0	686	0.0	0.0
chr2	AC010967.1	52732741	52732777	0	37	0	847	0	810	0.0	0.0
chr2	ASB3	53765376	53765585	0	210	51	6051	51	5841	0.0	0.008731381612737545
chr2	PSME4	53869375	53869538	0	164	23649	10440	23649	10276	0.0	2.301381860646166
chr2	PSME4	53874338	53874494	0	157	23649	10440	23649	10283	0.0	2.299815229018769
chr2	PSME4	53925538	53925689	0	152	23649	10440	23649	10288	0.0	2.2986975116640744
chr2	RTN4	55025085	55027485	153	2401	360	6380	207	3979	0.06372344856309871	0.05202312138728324
chr2	RTN4	55028163	55028220	0	58	360	6380	360	6322	0.0	0.05694400506168934
chr2	CLHC1	55181569	55181744	0	176	512855	6648	512855	6472	0.0	79.24211990111249
chr2	CLHC1	55208625	55208710	1760	86	512855	6648	511095	6562	20.46511627906977	77.887077110637
chr2	CLHC1	55180509	55180712	0	204	512855	6648	512855	6444	0.0	79.58643699565488
chr2	CLHC1	55228031	55228204	0	174	512855	6648	512855	6474	0.0	79.21763978992895
chr2	CLHC1	55222234	55222493	393	260	512855	6648	512462	6388	1.5115384615384615	80.22260488415779
chr2	MTIF2	55254040	55254201	4382	162	11419	3390	7037	3228	27.049382716049383	2.17998760842627
chr2	MTIF2	55268577	55268739	0	163	11419	3390	11419	3227	0.0	3.5385807251317014
chr2	MTIF2	55266380	55266518	102	139	11419	3390	11317	3251	0.7338129496402878	3.481082743771147
chr2	CCDC88A	55299838	55299919	0	82	3693	27139	3693	27057	0.0	0.1364896329970063
chr2	CCDC88A	55303068	55303152	0	85	3693	27139	3693	27054	0.0	0.13650476824129518
chr2	CCDC88A	55308808	55309023	0	216	3693	27139	3693	26923	0.0	0.13716896333989526
chr2	CCDC88A	55317205	55317349	0	145	3693	27139	3693	26994	0.0	0.13680817959546565
chr2	CCDC88A	55322527	55322692	0	166	3693	27139	3693	26973	0.0	0.13691469247024804
chr2	CCDC88A	55339463	55339648	0	186	3693	27139	3693	26953	0.0	0.13701628761176862
chr2	CCDC88A	55349517	55349599	0	83	3693	27139	3693	27056	0.0	0.1364946777054997
chr2	CCDC88A	55355578	55355751	0	174	3693	27139	3693	26965	0.0	0.13695531244205453
chr2	CCDC88A	55362307	55362448	0	142	3693	27139	3693	26997	0.0	0.13679297699744417
chr2	CCDC88A	55301871	55302072	0	202	3693	27139	3693	26937	0.0	0.13709767234658649
chr2	CCDC88A	55317563	55317841	0	279	3693	27139	3693	26860	0.0	0.13749069247952345
chr2	CCDC88A	55299827	55299919	0	93	3693	27139	3693	27046	0.0	0.13654514530799378
chr2	CCDC88A	55300956	55300996	0	41	3693	27139	3693	27098	0.0	0.13628312052550004
chr2	CCDC88A	55300252	55300339	0	88	3693	27139	3693	27051	0.0	0.13651990684263057
chr2	CCDC88A	55363611	55363733	0	123	3693	27139	3693	27016	0.0	0.1366967722830915
chr2	CCDC88A	55363949	55364033	0	85	3693	27139	3693	27054	0.0	0.13650476824129518
chr2	PPP4R3B	55573618	55573777	0	160	6402	8236	6402	8076	0.0	0.7927191679049034
chr2	PPP4R3B	55578246	55578342	0	97	6402	8236	6402	8139	0.0	0.7865831183192038
chr2	PNPT1	55656304	55656371	0	68	2266	4809	2266	4741	0.0	0.4779582366589327
chr2	EFEMP1	55922898	55922939	0	42	2254	3973	2254	3931	0.0	0.5733909946578479
chr2	EFEMP1	55922609	55922747	0	139	2254	3973	2254	3834	0.0	0.5878977569118414
chr2	EFEMP1	55922609	55922691	0	83	2254	3973	2254	3890	0.0	0.5794344473007712
chr2	EFEMP1	55922570	55922691	0	122	2254	3973	2254	3851	0.0	0.5853025188262789
chr2	EFEMP1	55922570	55922747	0	178	2254	3973	2254	3795	0.0	0.593939393939394
chr2	AC007743.1	56179602	56180162	0	561	0	4275	0	3714	0.0	0.0
chr2	AC132153.1	57294122	57294218	0	97	0	4556	0	4459	0.0	0.0
chr2	FANCL	58163433	58163517	0	85	0	2345	0	2260	0.0	0.0
chr2	FANCL	58221941	58222042	0	102	0	2345	0	2243	0.0	0.0
chr2	FANCL	58194228	58194273	0	46	0	2345	0	2299	0.0	0.0
chr2	AC007179.2	59384623	59384793	0	171	0	5116	0	4945	0.0	0.0
chr2	AC007179.2	59249108	59249165	0	58	0	5116	0	5058	0.0	0.0
chr2	AC007179.2	59240920	59241103	0	184	0	5116	0	4932	0.0	0.0
chr2	AC007179.2	59249488	59249693	0	206	0	5116	0	4910	0.0	0.0
chr2	AC007179.2	59240992	59241103	0	112	0	5116	0	5004	0.0	0.0
chr2	AC007179.2	59240289	59240341	0	53	0	5116	0	5063	0.0	0.0
chr2	AC007179.2	59241713	59241821	0	109	0	5116	0	5007	0.0	0.0
chr2	AC007179.2	59322257	59322318	0	62	0	5116	0	5054	0.0	0.0
chr2	BCL11A	60468731	60468833	0	103	0	10714	0	10611	0.0	0.0
chr2	BCL11A	60478163	60478239	0	77	0	10714	0	10637	0.0	0.0
chr2	BCL11A	60460681	60461744	0	1064	0	10714	0	9650	0.0	0.0
chr2	BCL11A	60508605	60508824	0	220	0	10714	0	10494	0.0	0.0
chr2	PUS10	61010655	61010888	0	234	5388	7352	5388	7118	0.0	0.7569542006181512
chr2	AC016747.1	61144168	61144266	0	99	1402	3112	1402	3013	0.0	0.4653169598406903
chr2	USP34	61214059	61214694	0	636	167541	17149	167541	16513	0.0	10.146006176951493
chr2	USP34	61214059	61214278	0	220	167541	17149	167541	16929	0.0	9.896686159844055
chr2	XPO1	61481184	61481281	0	98	13238	18326	13238	18228	0.0	0.7262453368444152
chr2	XPO1	61490641	61490776	0	136	13238	18326	13238	18190	0.0	0.7277625068719077
chr2	XPO1	61501995	61502040	451	46	13238	18326	12787	18280	9.804347826086957	0.6995076586433261
chr2	XPO1	61520390	61520475	0	86	13238	18326	13238	18240	0.0	0.7257675438596491
chr2	XPO1	61499712	61499894	372	183	13238	18326	12866	18143	2.0327868852459017	0.7091440224880119
chr2	XPO1	61514061	61514200	0	140	13238	18326	13238	18186	0.0	0.7279225778071043
chr2	XPO1	61529065	61529159	0	95	13238	18326	13238	18231	0.0	0.7261258296308486
chr2	XPO1	61534557	61534678	0	122	13238	18326	13238	18204	0.0	0.7272028125686663
chr2	XPO1	61534557	61534654	0	98	13238	18326	13238	18228	0.0	0.7262453368444152
chr2	XPO1	61502248	61502310	0	63	13238	18326	13238	18263	0.0	0.724853528993046
chr2	XPO1	61537561	61537668	0	108	13238	18326	13238	18218	0.0	0.7266439784828191
chr2	XPO1	61537561	61537587	0	27	13238	18326	13238	18299	0.0	0.7234275096999836
chr2	FAM161A	61838537	61838705	0	169	51	5267	51	5098	0.0	0.010003923107100824
chr2	FAM161A	61836582	61836872	0	291	51	5267	51	4976	0.0	0.0102491961414791
chr2	FAM161A	61846758	61846996	0	239	51	5267	51	5028	0.0	0.010143198090692125
chr2	CCT4	61883458	61883548	0	91	12	2716	12	2625	0.0	0.004571428571428572
chr2	AC018462.1	62137548	62137605	0	58	68247	1846	68247	1788	0.0	38.169463087248324
chr2	AC092155.1	62661894	62661933	0	40	288	7620	288	7580	0.0	0.03799472295514512
chr2	AC092155.1	62624952	62625011	37	60	288	7620	251	7560	0.6166666666666667	0.0332010582010582
chr2	AC092155.1	62613605	62613702	0	98	288	7620	288	7522	0.0	0.03828768944429673
chr2	AC092155.1	62629352	62629476	0	125	288	7620	288	7495	0.0	0.03842561707805203
chr2	AC092155.1	62625126	62625220	0	95	288	7620	288	7525	0.0	0.038272425249169434
chr2	AC092155.1	62629352	62629460	0	109	288	7620	288	7511	0.0	0.038343762481693515
chr2	AC092155.1	62625126	62625143	0	18	288	7620	288	7602	0.0	0.037884767166535126
chr2	AC092155.1	62629352	62629444	0	93	288	7620	288	7527	0.0	0.038262255878836186
chr2	AC007098.1	63046036	63046141	0	106	255	3322	255	3216	0.0	0.07929104477611941
chr2	WDPCP	63259306	63259409	0	104	1757	12791	1757	12687	0.0	0.1384882162843856
chr2	WDPCP	63486541	63486586	0	46	1757	12791	1757	12745	0.0	0.13785798352295017
chr2	WDPCP	63571374	63571626	0	253	1757	12791	1757	12538	0.0	0.14013399266230658
chr2	WDPCP	63711496	63711591	0	96	1757	12791	1757	12695	0.0	0.138400945254037
chr2	VPS54	63947382	63947490	0	109	402	5472	402	5363	0.0	0.07495804586984897
chr2	VPS54	63913824	63913925	0	102	402	5472	402	5370	0.0	0.07486033519553073
chr2	LINC00309	64192355	64192458	51	104	1489	2798	1438	2694	0.49038461538461536	0.5337787676317743
chr2	RAB1A	65097970	65098066	0	97	1581	3321	1581	3224	0.0	0.49038461538461536
chr2	RAB1A	65090982	65091078	0	97	1581	3321	1581	3224	0.0	0.49038461538461536
chr2	SPRED2	65316733	65316883	536	151	591238	5516	590702	5365	3.5496688741721854	110.10288909599254
chr2	SPRED2	65334114	65334265	51	152	591238	5516	591187	5364	0.3355263157894737	110.21383296047726
chr2	AC012370.2	65450232	65450759	0	528	1787	2484	1787	1956	0.0	0.91359918200409
chr2	AC012370.2	65450475	65450759	0	285	1787	2484	1787	2199	0.0	0.8126421100500227
chr2	AC012370.2	65453882	65453982	629	101	1787	2484	1158	2383	6.227722772277228	0.4859420898027696
chr2	AC012370.2	65456018	65456096	0	79	1787	2484	1787	2405	0.0	0.743035343035343
chr2	LINC01797	66699910	66700108	0	199	0	1886	0	1687	0.0	0.0
chr2	LINC01797	66699910	66700394	0	485	0	1886	0	1401	0.0	0.0
chr2	C1D	68053060	68053286	0	227	0	3571	0	3344	0.0	0.0
chr2	GFPT1	69328270	69328438	0	169	8838	8872	8838	8703	0.0	1.015511892450879
chr2	GFPT1	69354258	69354312	0	55	8838	8872	8838	8817	0.0	1.002381762504253
chr2	GFPT1	69371309	69371472	357	164	8838	8872	8481	8708	2.176829268292683	0.9739320165365182
chr2	NFU1	69400363	69400538	0	176	16	1756	16	1580	0.0	0.010126582278481013
chr2	NFU1	69399238	69399382	0	145	16	1756	16	1611	0.0	0.009931719428926133
chr2	NFU1	69423581	69423717	0	137	16	1756	16	1619	0.0	0.009882643607164917
chr2	NFU1	69429903	69430021	0	119	16	1756	16	1637	0.0	0.009773976786805132
chr2	AAK1	69495984	69496080	0	97	835976	21266	835976	21169	0.0	39.49057584203316
chr2	PCBP1-AS1	69964230	69964427	0	198	234223	25966	234223	25768	0.0	9.089684880471903
chr2	PCBP1-AS1	69988741	69988838	80	98	234223	25966	234143	25868	0.8163265306122449	9.051453533323025
chr2	PCBP1-AS1	69996685	69996888	0	204	234223	25966	234223	25762	0.0	9.091801878736122
chr2	PCBP1-AS1	70032132	70032255	0	124	234223	25966	234223	25842	0.0	9.063656063772154
chr2	PCBP1-AS1	70081369	70081490	0	122	234223	25966	234223	25844	0.0	9.06295465098282
chr2	PCBP1-AS1	69988445	69988505	42	61	234223	25966	234181	25905	0.6885245901639344	9.039992279482725
chr2	PCBP1-AS1	70011654	70011718	0	65	234223	25966	234223	25901	0.0	9.043009922396818
chr2	PCBP1-AS1	70059642	70059680	0	39	234223	25966	234223	25927	0.0	9.03394145099703
chr2	PCBP1-AS1	70051202	70051305	0	104	234223	25966	234223	25862	0.0	9.056646817724847
chr2	PCBP1-AS1	69975558	69975635	842	78	234223	25966	233381	25888	10.794871794871796	9.015026266996292
chr2	PCBP1-AS1	70015447	70015517	0	71	234223	25966	234223	25895	0.0	9.0451052326704
chr2	PCBP1-AS1	69968398	69968520	0	123	234223	25966	234223	25843	0.0	9.063305343806833
chr2	PCBP1-AS1	70018014	70018131	102	118	234223	25966	234121	25848	0.864406779661017	9.057606004333024
chr2	PCBP1-AS1	70083506	70083687	0	182	234223	25966	234223	25784	0.0	9.084044368600683
chr2	PCBP1-AS1	70053730	70053792	0	63	234223	25966	234223	25903	0.0	9.042311701347334
chr2	PCBP1-AS1	70015447	70015580	0	134	234223	25966	234223	25832	0.0	9.067164756890678
chr2	PCBP1-AS1	70011654	70011834	0	181	234223	25966	234223	25785	0.0	9.083692069032383
chr2	PCBP1-AS1	70055713	70055910	0	198	234223	25966	234223	25768	0.0	9.089684880471903
chr2	PCBP1-AS1	70011654	70011752	0	99	234223	25966	234223	25867	0.0	9.054896199791239
chr2	PCBP1-AS1	69964368	69964427	0	60	234223	25966	234223	25906	0.0	9.041264571913842
chr2	PCBP1-AS1	69996857	69996888	0	32	234223	25966	234223	25934	0.0	9.031503046194185
chr2	PCBP1-AS1	70083537	70083687	0	151	234223	25966	234223	25815	0.0	9.073135773774936
chr2	PCBP1-AS1	70055655	70055910	0	256	234223	25966	234223	25710	0.0	9.110190587320108
chr2	PCBP1-AS1	70003045	70003315	0	271	234223	25966	234223	25695	0.0	9.11550885386262
chr2	PCBP1-AS1	70077300	70077381	60	82	234223	25966	234163	25884	0.7317073170731707	9.046631123473961
chr2	PCBP1-AS1	69975348	69975461	0	114	234223	25966	234223	25852	0.0	9.0601500850998
chr2	PCBP1-AS1	69997912	69998134	0	223	234223	25966	234223	25743	0.0	9.098512216913335
chr2	PCBP1-AS1	70085815	70085903	0	89	234223	25966	234223	25877	0.0	9.051396993469103
chr2	PCBP1-AS1	70053730	70053812	0	83	234223	25966	234223	25883	0.0	9.049298767530813
chr2	PCBP1-AS1	70053730	70053815	0	86	234223	25966	234223	25880	0.0	9.050347758887172
chr2	PCBP1-AS1	70052619	70052800	100145	182	234223	25966	134078	25784	550.2472527472528	5.200046540490226
chr2	PCBP1-AS1	70053730	70053994	306	265	234223	25966	233917	25701	1.1547169811320754	9.101474650791799
chr2	PCBP1-AS1	70085815	70085930	0	116	234223	25966	234223	25850	0.0	9.060851063829787
chr2	C2ORF42	70182666	70182935	0	270	2815	3521	2815	3251	0.0	0.8658874192556136
chr2	C2ORF42	70190542	70190715	0	174	2815	3521	2815	3347	0.0	0.8410516880788766
chr2	TIA1	70229058	70229091	0	34	1838	6250	1838	6216	0.0	0.2956885456885457
chr2	TIA1	70225327	70225393	20	67	1838	6250	1818	6183	0.29850746268656714	0.2940320232896652
chr2	TIA1	70228343	70228462	0	120	1838	6250	1838	6130	0.0	0.299836867862969
chr2	SNRPG	70289349	70289372	0	24	102	1396	102	1372	0.0	0.07434402332361516
chr2	SNRPG	70287264	70287371	0	108	102	1396	102	1288	0.0	0.07919254658385093
chr2	FAM136A	70301407	70301603	102	197	204	3023	102	2826	0.5177664974619289	0.036093418259023353
chr2	TGFA	70451728	70451760	13502	33	54220	2892	40718	2859	409.1515151515151	14.242042672263029
chr2	ADD2	70713065	70713184	0	120	434	12701	434	12581	0.0	0.03449646292027661
chr2	ADD2	70673240	70673326	42	87	434	12701	392	12614	0.4827586206896552	0.03107658157602664
chr2	ADD2	70741340	70741406	0	67	434	12701	434	12634	0.0	0.03435174924806079
chr2	TEX261	70991829	70991983	0	155	0	4189	0	4034	0.0	0.0
chr2	ATP6V1B1-AS1	70947533	70947671	0	139	0	1142	0	1003	0.0	0.0
chr2	MCEE	71129716	71129817	798	102	3144	1469	2346	1367	7.823529411764706	1.7161667885881493
chr2	CYP26B1	72143988	72144213	0	226	2	5022	2	4796	0.0	0.0004170141784820684
chr2	EXOC6B	72480615	72480750	0	136	1020	10224	1020	10088	0.0	0.10111022997620936
chr2	EXOC6B	72741303	72741469	0	167	1020	10224	1020	10057	0.0	0.10142189519737496
chr2	EXOC6B	72182893	72182905	0	13	1020	10224	1020	10211	0.0	0.09989227303887964
chr2	SFXN5	72961130	72961248	0	119	3820	11003	3820	10884	0.0	0.3509739066519662
chr2	SFXN5	72971569	72971685	0	117	3820	11003	3820	10886	0.0	0.3509094249494764
chr2	SFXN5	73022521	73022576	2	56	3820	11003	3818	10947	0.03571428571428571	0.3487713528820681
chr2	SFXN5	73041606	73041661	0	56	3820	11003	3820	10947	0.0	0.3489540513382662
chr2	RAB11FIP5	73079650	73081663	0	2014	0	5513	0	3499	0.0	0.0
chr2	PRADC1	73228794	73228962	156	169	810	1409	654	1240	0.9230769230769231	0.5274193548387097
chr2	TPRKB	73734527	73734591	0	65	247	2011	247	1946	0.0	0.12692702980472764
chr2	TPRKB	73734428	73734591	0	164	247	2011	247	1847	0.0	0.1337303735787764
chr2	TPRKB	73732583	73732700	0	118	247	2011	247	1893	0.0	0.13048071843634443
chr2	TPRKB	73734527	73734588	0	62	247	2011	247	1949	0.0	0.1267316572601334
chr2	DUSP11	73766417	73766594	0	178	663	3556	663	3378	0.0	0.19626998223801065
chr2	BOLA3	74142271	74142360	48	90	9653	1750	9605	1660	0.5333333333333333	5.786144578313253
chr2	SLC4A5	74222867	74222952	0	86	16945	6641	16945	6555	0.0	2.5850495804729214
chr2	SLC4A5	74224839	74225011	459	173	16945	6641	16486	6468	2.653179190751445	2.548855905998763
chr2	SLC4A5	74227516	74227564	252	49	16945	6641	16693	6592	5.142857142857143	2.5323118932038833
chr2	SLC4A5	74232468	74232647	0	180	16945	6641	16945	6461	0.0	2.6226590311097353
chr2	SLC4A5	74235100	74235214	52	115	16945	6641	16893	6526	0.45217391304347826	2.588568801716212
chr2	SLC4A5	74304488	74304680	306	193	16945	6641	16639	6448	1.5854922279792747	2.580490074441687
chr2	SLC4A5	74328119	74328186	627	68	16945	6641	16318	6573	9.220588235294118	2.4825802525483036
chr2	SLC4A5	74224839	74224995	459	157	16945	6641	16486	6484	2.9235668789808917	2.5425663170882173
chr2	SLC4A5	74314944	74315025	3125	82	16945	6641	13820	6559	38.109756097560975	2.1070285104436652
chr2	DCTN1	74363613	74363628	0	16	331815	9854	331815	9838	0.0	33.727891847936576
chr2	DCTN1	74366458	74366620	0	163	331815	9854	331815	9691	0.0	34.239500567536886
chr2	DCTN1	74376741	74376762	834	22	331815	9854	330981	9832	37.90909090909091	33.6636493083808
chr2	DCTN1	74390582	74390728	0	147	331815	9854	331815	9707	0.0	34.18306376841455
chr2	DCTN1	74378904	74378972	396	69	331815	9854	331419	9785	5.739130434782608	33.87010730710271
chr2	DCTN1	74383742	74383806	10081	65	331815	9854	321734	9789	155.09230769230768	32.86689140872408
chr2	RTKN	74439550	74439977	2102	428	297788	4493	295686	4065	4.911214953271028	72.73948339483395
chr2	MOGS	74464495	74464722	0	228	714	3170	714	2942	0.0	0.24269204622705642
chr2	MOGS	74463189	74463219	0	31	714	3170	714	3139	0.0	0.2274609748327493
chr2	MOGS	74464895	74464987	0	93	714	3170	714	3077	0.0	0.23204419889502761
chr2	MOGS	74464665	74464722	0	58	714	3170	714	3112	0.0	0.2294344473007712
chr2	MRPL53	74472357	74472470	0	114	0	687	0	573	0.0	0.0
chr2	DQX1	74525492	74525748	408	257	867	2764	459	2507	1.5875486381322956	0.18308735540486637
chr2	DQX1	74525008	74525202	0	195	867	2764	867	2569	0.0	0.3374854028804983
chr2	LOXL3	74535587	74535755	0	169	164	4535	164	4366	0.0	0.03756298671552909
chr2	LOXL3	74536708	74536928	0	221	164	4535	164	4314	0.0	0.03801576263328697
chr2	M1AP	74559697	74559709	0	13	1618	3014	1618	3001	0.0	0.5391536154615129
chr2	M1AP	74607054	74607223	0	170	1618	3014	1618	2844	0.0	0.5689170182841069
chr2	M1AP	74614963	74615149	0	187	1618	3014	1618	2827	0.0	0.572338167668907
chr2	EVA1A	75522364	75522487	0	124	0	2756	0	2632	0.0	0.0
chr2	EVA1A	75526111	75526199	0	89	0	2756	0	2667	0.0	0.0
chr2	GCFC2	75665928	75666053	816	126	966	5480	150	5354	6.476190476190476	0.028016436309301458
chr2	GCFC2	75680192	75680314	0	123	966	5480	966	5357	0.0	0.1803248086615643
chr2	GCFC2	75691976	75692100	0	125	966	5480	966	5355	0.0	0.1803921568627451
chr2	GCFC2	75696199	75696315	0	117	966	5480	966	5363	0.0	0.18012306544844303
chr2	GCFC2	75702198	75702423	0	226	966	5480	966	5254	0.0	0.18385991625428244
chr2	GCFC2	75702312	75702423	0	112	966	5480	966	5368	0.0	0.17995529061102833
chr2	LRRTM4	77521667	77521818	0	152	51	5416	51	5264	0.0	0.009688449848024316
chr2	LRRTM4	77521667	77521748	0	82	51	5416	51	5334	0.0	0.009561304836895388
chr2	CTNNA2-AS1	79499176	79499242	0	67	0	2074	0	2007	0.0	0.0
chr2	LRRTM1	80303995	80304013	0	19	0	4963	0	4944	0.0	0.0
chr2	AC008067.1	80605160	80605307	0	148	0	3369	0	3221	0.0	0.0
chr2	LINC01815	81461696	81461752	0	57	0	1379	0	1322	0.0	0.0
chr2	SUCLG1	84436051	84436127	0	77	0	4176	0	4099	0.0	0.0
chr2	SUCLG1	84448928	84448947	0	20	0	4176	0	4156	0.0	0.0
chr2	TRABD2A	84841860	84842007	0	148	576	8785	576	8637	0.0	0.06668982285515804
chr2	RETSAT	85343998	85344165	0	168	153	4060	153	3892	0.0	0.03931140801644399
chr2	RETSAT	85351679	85351862	0	184	153	4060	153	3876	0.0	0.039473684210526314
chr2	CAPG	85413142	85413244	5	103	584	2163	579	2060	0.04854368932038835	0.28106796116504856
chr2	GGCX	85560814	85560985	0	172	2063894	6215	2063894	6043	0.0	341.5346682111534
chr2	TMEM150A	85600344	85600412	456	69	7118	2915	6662	2846	6.608695652173913	2.3408292340126495
chr2	TMEM150A	85600499	85600759	405	261	7118	2915	6713	2654	1.5517241379310345	2.5293896006028636
chr2	ST3GAL5	85844395	85844554	2204	160	273942	15937	271738	15777	13.775	17.22368004056538
chr2	ST3GAL5	85847860	85848204	75	345	273942	15937	273867	15592	0.21739130434782608	17.56458440225757
chr2	ST3GAL5	85861180	85861292	21	113	273942	15937	273921	15824	0.18584070796460178	17.31047775530839
chr2	ST3GAL5	85863361	85863485	0	125	273942	15937	273942	15812	0.0	17.32494308120415
chr2	ST3GAL5	85847381	85847562	0	182	273942	15937	273942	15755	0.0	17.387622976832752
chr2	ST3GAL5	85846376	85846563	18034	188	273942	15937	255908	15749	95.92553191489361	16.24915867674138
chr2	ST3GAL5	85851263	85851703	663	441	273942	15937	273279	15496	1.5034013605442176	17.635454310789882
chr2	ST3GAL5	85852859	85853000	0	142	273942	15937	273942	15795	0.0	17.343589743589742
chr2	ST3GAL5	85847860	85848084	75	225	273942	15937	273867	15712	0.3333333333333333	17.43043533604888
chr2	ST3GAL5	85870071	85870258	51	188	273942	15937	273891	15749	0.2712765957446808	17.391008952949395
chr2	ST3GAL5	85858133	85858247	0	115	273942	15937	273942	15822	0.0	17.313993174061434
chr2	ST3GAL5	85846376	85846424	18034	49	273942	15937	255908	15888	368.0408163265306	16.106998992950654
chr2	ST3GAL5	85847860	85848381	99	522	273942	15937	273843	15415	0.1896551724137931	17.76470969834577
chr2	ST3GAL5	85867844	85868058	147	215	273942	15937	273795	15722	0.6837209302325581	17.41476911334436
chr2	ST3GAL5	85852859	85853091	0	233	273942	15937	273942	15704	0.0	17.444090677534387
chr2	ST3GAL5	85844395	85844521	2204	127	273942	15937	271738	15810	17.35433070866142	17.187729285262492
chr2	ST3GAL5	85875414	85875545	765	132	273942	15937	273177	15805	5.795454545454546	17.284213856374564
chr2	ST3GAL5	85852859	85853099	0	241	273942	15937	273942	15696	0.0	17.452981651376145
chr2	ST3GAL5	85852859	85853097	0	239	273942	15937	273942	15698	0.0	17.450758058351383
chr2	POLR1A	86088784	86088870	0	87	12070	13555	12070	13468	0.0	0.8961983961983963
chr2	IMMT	86170748	86170841	0	94	204	3687	204	3593	0.0	0.05677706651822989
chr2	IMMT	86171207	86171312	0	106	204	3687	204	3581	0.0	0.056967327562133484
chr2	IMMT	86170748	86170844	0	97	204	3687	204	3590	0.0	0.05682451253481894
chr2	IMMT	86171207	86171345	0	139	204	3687	204	3548	0.0	0.05749718151071026
chr2	REEP1	86227362	86227398	0	37	98135	5860	98135	5823	0.0	16.85299673707711
chr2	REEP1	86282169	86282242	135	74	98135	5860	98000	5786	1.8243243243243243	16.93743518838576
chr2	REEP1	86240020	86240071	0	52	98135	5860	98135	5808	0.0	16.896522038567493
chr2	REEP1	86219969	86220121	0	153	98135	5860	98135	5707	0.0	17.195549325389873
chr2	REEP1	86239921	86240071	0	151	98135	5860	98135	5709	0.0	17.189525310912593
chr2	CHMP3	86542251	86542312	0	62	204	7030	204	6968	0.0	0.029276693455797934
chr2	CD8A	86789322	86789433	740	112	33495	3058	32755	2946	6.607142857142857	11.11846571622539
chr2	CD8A	86789639	86789750	0	112	33495	3058	33495	2946	0.0	11.369653767820774
chr2	CD8B	86822320	86822374	0	55	24761	5288	24761	5233	0.0	4.731702656220142
chr2	CD8B	86846683	86846773	140	91	24761	5288	24621	5197	1.5384615384615385	4.737540888974408
chr2	CD8B	86844921	86844958	180	38	24761	5288	24581	5250	4.7368421052631575	4.682095238095238
chr2	EIF2AK3	88593912	88594108	0	197	51	5207	51	5010	0.0	0.010179640718562874
chr2	MALLP2	88814307	88814430	0	124	0	1025	0	901	0.0	0.0
chr2	LSP1P5	89580557	89580635	0	79	0	2420	0	2341	0.0	0.0
chr2	AC026273.1	94196572	94196720	0	149	0	1450	0	1301	0.0	0.0
chr2	MRPS5	95104639	95104730	0	92	0	8383	0	8291	0.0	0.0
chr2	LINC00342	95813315	95813957	28535	643	131006	7663	102471	7020	44.37791601866252	14.597008547008548
chr2	LINC00342	95814670	95814791	4906	122	131006	7663	126100	7541	40.21311475409836	16.721920169738762
chr2	ANKRD36C	95867439	95867581	0	143	6954	8656	6954	8513	0.0	0.816868319041466
chr2	ANKRD36C	95938828	95938901	0	74	6954	8656	6954	8582	0.0	0.8103006292239571
chr2	GPAT2	96026696	96026909	0	214	440	5194	440	4980	0.0	0.08835341365461848
chr2	NEURL3	96499189	96499274	0	86	3281	2501	3281	2415	0.0	1.358592132505176
chr2	NEURL3	96504530	96504709	612	180	3281	2501	2669	2321	3.4	1.1499353726841879
chr2	KANSL3	96602115	96602338	0	224	7890	9053	7890	8829	0.0	0.8936459395174992
chr2	KANSL3	96619671	96619762	640	92	7890	9053	7250	8961	6.956521739130435	0.8090614886731392
chr2	KANSL3	96615491	96615544	0	54	7890	9053	7890	8999	0.0	0.876764084898322
chr2	KANSL3	96606969	96607047	51	79	7890	9053	7839	8974	0.6455696202531646	0.8735235123690662
chr2	KANSL3	96598080	96598160	0	81	7890	9053	7890	8972	0.0	0.879402585822559
chr2	KANSL3	96619358	96619544	0	187	7890	9053	7890	8866	0.0	0.8899165350778254
chr2	KANSL3	96634148	96634178	0	31	7890	9053	7890	9022	0.0	0.8745289292839725
chr2	KANSL3	96631311	96631482	0	172	7890	9053	7890	8881	0.0	0.8884134669519198
chr2	LMAN2L	96733518	96733601	0	84	102	2719	102	2635	0.0	0.03870967741935484
chr2	LMAN2L	96737948	96738067	0	120	102	2719	102	2599	0.0	0.039245863793766836
chr2	LMAN2L	96737136	96737217	0	82	102	2719	102	2637	0.0	0.038680318543799774
chr2	LMAN2L	96713106	96713139	0	34	102	2719	102	2685	0.0	0.03798882681564246
chr2	ANKRD23	96840826	96840912	0	87	1147	3843	1147	3756	0.0	0.3053780617678381
chr2	ANKRD23	96840786	96840912	0	127	1147	3843	1147	3716	0.0	0.3086652314316469
chr2	FAHD2B	97091461	97091712	0	252	0	2630	0	2378	0.0	0.0
chr2	FAHD2B	97091862	97091988	0	127	0	2630	0	2503	0.0	0.0
chr2	AC092683.1	97422954	97423084	0	131	62322	5579	62322	5448	0.0	11.439427312775331
chr2	AC092683.1	97423801	97423918	0	118	62322	5579	62322	5461	0.0	11.412195568577184
chr2	AC092683.1	97423788	97423918	0	131	62322	5579	62322	5448	0.0	11.439427312775331
chr2	AC092683.1	97422438	97422659	0	222	62322	5579	62322	5357	0.0	11.633750233339557
chr2	AC092683.1	97424294	97424405	51	112	62322	5579	62271	5467	0.45535714285714285	11.390342052313883
chr2	ANKRD36B	97576378	97576446	0	69	24456	6818	24456	6749	0.0	3.623647947844125
chr2	TMEM131	97794929	97795115	51	187	16187	11049	16136	10862	0.2727272727272727	1.4855459399742221
chr2	TMEM131	97818612	97818721	0	110	16187	11049	16187	10939	0.0	1.479751348386507
chr2	AC092675.1	98333440	98333503	0	64	0	1169	0	1105	0.0	0.0
chr2	CRACDL	98832861	98832997	0	137	105	4720	105	4583	0.0	0.022910757145974254
chr2	CRACDL	98897376	98897481	0	106	105	4720	105	4614	0.0	0.022756827048114433
chr2	TSGA10	99020279	99020482	0	204	7889	5121	7889	4917	0.0	1.6044335977221884
chr2	TSGA10	99035229	99035439	0	211	7889	5121	7889	4910	0.0	1.6067209775967413
chr2	TSGA10	99073017	99073073	0	57	7889	5121	7889	5064	0.0	1.5578593996840442
chr2	TSGA10	99078658	99078813	0	156	7889	5121	7889	4965	0.0	1.5889224572004028
chr2	TSGA10	99118550	99118686	0	137	7889	5121	7889	4984	0.0	1.5828651685393258
chr2	TSGA10	99117543	99117759	0	217	7889	5121	7889	4904	0.0	1.6086867862969005
chr2	TSGA10	99127047	99127176	0	130	7889	5121	7889	4991	0.0	1.5806451612903225
chr2	MITD1	99171342	99171429	0	88	18280	2343	18280	2255	0.0	8.106430155210642
chr2	MITD1	99173413	99173502	400	90	18280	2343	17880	2253	4.444444444444445	7.936085219707057
chr2	LYG2	99243411	99243472	0	62	473	1214	473	1152	0.0	0.4105902777777778
chr2	TXNDC9	99327534	99327653	0	120	102	2824	102	2704	0.0	0.03772189349112426
chr2	TXNDC9	99322560	99322659	102	100	102	2824	0	2724	1.02	0.0
chr2	REV1	99451344	99451501	0	158	6694	7767	6694	7609	0.0	0.8797476672361677
chr2	AFF3	99580600	99580728	0	129	19357	15102	19357	14973	0.0	1.2927936953182395
chr2	AFF3	100011496	100011571	20	76	19357	15102	19337	15026	0.2631578947368421	1.286902701983229
chr2	AFF3	100105503	100105583	0	81	19357	15102	19357	15021	0.0	1.28866253911191
chr2	AFF3	100129223	100129306	0	84	19357	15102	19357	15018	0.0	1.288919962711413
chr2	AFF3	100112385	100112524	0	140	19357	15102	19357	14962	0.0	1.2937441518513568
chr2	CHST10	100402563	100402655	0	93	0	4387	0	4294	0.0	0.0
chr2	CHST10	100408542	100408660	0	119	0	4387	0	4268	0.0	0.0
chr2	CHST10	100416222	100416525	0	304	0	4387	0	4083	0.0	0.0
chr2	CHST10	100416722	100417070	0	349	0	4387	0	4038	0.0	0.0
chr2	NPAS2-AS1	100975532	100975668	0	137	0	2117	0	1980	0.0	0.0
chr2	TBC1D8	101191300	101191458	71	159	41191	6443	41120	6284	0.44654088050314467	6.5436028007638445
chr2	RFX8	101414853	101414912	0	60	0	3282	0	3222	0.0	0.0
chr2	RFX8	101428955	101429019	0	65	0	3282	0	3217	0.0	0.0
chr2	MFSD9	102732023	102732138	0	116	2	2075	2	1959	0.0	0.0010209290454313426
chr2	AC013727.1	103859474	103859643	0	170	0	2132	0	1962	0.0	0.0
chr2	LINC01831	104413575	104413660	0	86	0	849	0	763	0.0	0.0
chr2	MRPS9-AS1	105098601	105098668	0	68	0	1182	0	1114	0.0	0.0
chr2	MRPS9-AS1	105099247	105099300	0	54	0	1182	0	1128	0.0	0.0
chr2	FHL2	105373558	105373733	0	176	0	6508	0	6332	0.0	0.0
chr2	FHL2	105396646	105396697	0	52	0	6508	0	6456	0.0	0.0
chr2	FHL2	105390106	105390227	0	122	0	6508	0	6386	0.0	0.0
chr2	FHL2	105377995	105378117	0	123	0	6508	0	6385	0.0	0.0
chr2	FHL2	105389875	105390227	0	353	0	6508	0	6155	0.0	0.0
chr2	UXS1	106145189	106145370	0	182	204	6685	204	6503	0.0	0.03137013685991081
chr2	UXS1	106159144	106159382	102	239	204	6685	102	6446	0.42677824267782427	0.015823766677008997
chr2	LINC01885	107386742	107386864	0	123	0	2430	0	2307	0.0	0.0
chr2	RGPD4-AS1	107824560	107824743	0	184	0	2376	0	2192	0.0	0.0
chr2	EDAR	108940210	108940326	0	117	0	4438	0	4321	0.0	0.0
chr2	SEPTIN10	109553086	109553219	0	134	716	3956	716	3822	0.0	0.18733647305075876
chr2	SEPTIN10	109593050	109593119	0	70	716	3956	716	3886	0.0	0.184251158003088
chr2	SEPTIN10	109545459	109545542	0	84	716	3956	716	3872	0.0	0.18491735537190082
chr2	SEPTIN10	109585720	109585838	0	119	716	3956	716	3837	0.0	0.18660411780036487
chr2	SEPTIN10	109545384	109545542	0	159	716	3956	716	3797	0.0	0.18856992362391362
chr2	SEPTIN10	109604834	109604933	0	100	716	3956	716	3856	0.0	0.18568464730290457
chr2	SEPTIN10	109574580	109574767	0	188	716	3956	716	3768	0.0	0.19002123142250532
chr2	SEPTIN10	109585125	109585321	0	197	716	3956	716	3759	0.0	0.19047619047619047
chr2	MALL	110097498	110097604	0	107	612	2628	612	2521	0.0	0.24276080920269735
chr2	NPHP1	110201420	110201494	0	75	0	12937	0	12862	0.0	0.0
chr2	NPHP1	110156367	110156481	0	115	0	12937	0	12822	0.0	0.0
chr2	NPHP1	110125188	110125323	0	136	0	12937	0	12801	0.0	0.0
chr2	NPHP1	110125218	110125323	0	106	0	12937	0	12831	0.0	0.0
chr2	NPHP1	110202372	110202479	0	108	0	12937	0	12829	0.0	0.0
chr2	LINC01106	110377649	110377777	0	129	44643	3061	44643	2932	0.0	15.22612551159618
chr2	AC112229.1	110407937	110408028	0	92	15	2891	15	2799	0.0	0.0053590568060021436
chr2	AC112229.1	110407937	110408019	0	83	15	2891	15	2808	0.0	0.005341880341880342
chr2	AC112229.1	110433435	110433533	0	99	15	2891	15	2792	0.0	0.0053724928366762174
chr2	RGPD6	110562611	110562757	0	147	853	12910	853	12763	0.0	0.0668338165008227
chr2	RGPD6	110569656	110569724	0	69	853	12910	853	12841	0.0	0.06642784829841912
chr2	RGPD6	110569656	110569721	0	66	853	12910	853	12844	0.0	0.06641233260666458
chr2	BUB1	110674305	110674365	0	61	7675	6333	7675	6272	0.0	1.2236926020408163
chr2	BUB1	110676576	110676623	0	48	7675	6333	7675	6285	0.0	1.2211614956245027
chr2	BUB1	110676532	110676623	0	92	7675	6333	7675	6241	0.0	1.2297708700528762
chr2	MIR4435-2HG	111367486	111367575	0	90	40775	26838	40775	26748	0.0	1.5244130402273066
chr2	MIR4435-2HG	111184532	111184642	0	111	40775	26838	40775	26727	0.0	1.5256108055524376
chr2	MIR4435-2HG	111248147	111248241	0	95	40775	26838	40775	26743	0.0	1.5246980518266462
chr2	MIR4435-2HG	111239801	111239996	0	196	40775	26838	40775	26642	0.0	1.5304781923279034
chr2	MIR4435-2HG	111233627	111233739	0	113	40775	26838	40775	26725	0.0	1.5257249766136576
chr2	MIR4435-2HG	111365560	111367575	0	2016	40775	26838	40775	24822	0.0	1.6426959954878737
chr2	MIR4435-2HG	111479906	111480061	0	156	40775	26838	40775	26682	0.0	1.528183794318267
chr2	MIR4435-2HG	111274706	111274861	0	156	40775	26838	40775	26682	0.0	1.528183794318267
chr2	MIR4435-2HG	111344060	111344237	0	178	40775	26838	40775	26660	0.0	1.5294448612153038
chr2	MIR4435-2HG	111208487	111208661	0	175	40775	26838	40775	26663	0.0	1.5292727750065633
chr2	MIR4435-2HG	111207719	111208661	0	943	40775	26838	40775	25895	0.0	1.5746283066229
chr2	MIR4435-2HG	111208755	111208977	2722	223	40775	26838	38053	26615	12.20627802690583	1.4297576554574487
chr2	MIR4435-2HG	111208755	111208936	2722	182	40775	26838	38053	26656	14.956043956043956	1.4275585234093637
chr2	MIR4435-2HG	111350607	111350761	0	155	40775	26838	40775	26683	0.0	1.5281265225049656
chr2	MIR4435-2HG	111330214	111330554	375	341	40775	26838	40400	26497	1.099706744868035	1.5247009095369286
chr2	MIR4435-2HG	111447211	111447349	0	139	40775	26838	40775	26699	0.0	1.5272107569571893
chr2	MIR4435-2HG	111247429	111247558	0	130	40775	26838	40775	26708	0.0	1.5266961210124308
chr2	MIR4435-2HG	111377622	111377917	0	296	40775	26838	40775	26542	0.0	1.5362444427699495
chr2	MIR4435-2HG	111365560	111365662	0	103	40775	26838	40775	26735	0.0	1.525154292126426
chr2	MIR4435-2HG	111469786	111469987	0	202	40775	26838	40775	26636	0.0	1.5308229463883467
chr2	MIR4435-2HG	111477335	111477481	0	147	40775	26838	40775	26691	0.0	1.5276685024914765
chr2	MIR4435-2HG	111494556	111494778	0	223	40775	26838	40775	26615	0.0	1.5320308096937818
chr2	MIR4435-2HG	111471988	111472097	0	110	40775	26838	40775	26728	0.0	1.5255537264292127
chr2	MIR4435-2HG	111469602	111469987	0	386	40775	26838	40775	26452	0.0	1.5414713443217904
chr2	AC017002.3	111613151	111613235	0	85	0	1314	0	1229	0.0	0.0
chr2	AC017002.3	111613151	111613293	0	143	0	1314	0	1171	0.0	0.0
chr2	ANAPC1	111873307	111873408	0	102	914	12406	914	12304	0.0	0.07428478543563069
chr2	RGPD8	112417192	112417338	34	147	812	8209	778	8062	0.23129251700680273	0.09650210865790126
chr2	RGPD8	112424239	112424307	425	69	812	8209	387	8140	6.159420289855072	0.047542997542997546
chr2	RGPD8	112412430	112412626	0	197	812	8209	812	8012	0.0	0.10134797803295058
chr2	CKAP2L	112760712	112760764	112	53	1216	4835	1104	4782	2.1132075471698113	0.23086574654956085
chr2	PAX8	113227154	113227256	0	103	9028	6861	9028	6758	0.0	1.3358981947321693
chr2	PAX8	113235393	113235503	0	111	9028	6861	9028	6750	0.0	1.3374814814814815
chr2	PAX8	113235393	113235582	0	190	9028	6861	9028	6671	0.0	1.3533203417778443
chr2	PAX8	113236600	113236721	51	122	9028	6861	8977	6739	0.4180327868852459	1.3320967502596825
chr2	PGM5P4-AS1	113534559	113534713	0	155	139	2429	139	2274	0.0	0.06112576956904134
chr2	PGM5P4-AS1	113534559	113534716	0	158	139	2429	139	2271	0.0	0.06120651695288419
chr2	SLC35F5	113733364	113733403	0	40	0	4957	0	4917	0.0	0.0
chr2	DPP10-AS1	115135636	115136161	0	526	0	9102	0	8576	0.0	0.0
chr2	DPP10-AS1	115131826	115131924	0	99	0	9102	0	9003	0.0	0.0
chr2	CCDC93	117944732	117944797	0	66	284	8019	284	7953	0.0	0.03570979504589463
chr2	THORLNC	118184442	118184655	0	214	0	2777	0	2563	0.0	0.0
chr2	THORLNC	118185337	118185390	0	54	0	2777	0	2723	0.0	0.0
chr2	C2ORF76	119340158	119340361	0	204	0	1563	0	1359	0.0	0.0
chr2	SCTR	119465788	119465886	0	99	1445	3432	1445	3333	0.0	0.43354335433543356
chr2	SCTR	119480688	119480813	0	126	1445	3432	1445	3306	0.0	0.43708408953418026
chr2	CLASP1	121401867	121401870	0	4	153	10990	153	10986	0.0	0.013926815947569634
chr2	CLASP1	121409023	121409047	0	25	153	10990	153	10965	0.0	0.013953488372093023
chr2	CLASP1	121427403	121427430	0	28	153	10990	153	10962	0.0	0.013957307060755337
chr2	CLASP1	121382207	121382324	0	118	153	10990	153	10872	0.0	0.014072847682119206
chr2	CLASP1	121418621	121418729	0	109	153	10990	153	10881	0.0	0.014061207609594707
chr2	CLASP1	121444938	121444962	0	25	153	10990	153	10965	0.0	0.013953488372093023
chr2	CLASP1	121445448	121445496	0	49	153	10990	153	10941	0.0	0.013984096517685769
chr2	CLASP1	121402594	121402663	0	70	153	10990	153	10920	0.0	0.014010989010989012
chr2	NIFK	121728476	121728536	0	61	0	1932	0	1871	0.0	0.0
chr2	LINC01941	126112932	126113170	0	239	0	1004	0	765	0.0	0.0
chr2	BIN1	127060595	127060640	0	46	46	5365	46	5319	0.0	0.008648242150780222
chr2	BIN1	127057472	127057601	0	130	46	5365	46	5235	0.0	0.008787010506208214
chr2	BIN1	127052254	127052362	0	109	46	5365	46	5256	0.0	0.008751902587519025
chr2	BIN1	127068162	127068255	0	94	46	5365	46	5271	0.0	0.00872699677480554
chr2	BIN1	127051153	127051243	46	91	46	5365	0	5274	0.5054945054945055	0.0
chr2	CYP27C1	127205899	127206090	0	192	51	5215	51	5023	0.0	0.010153294843718894
chr2	ERCC3	127272864	127272961	0	98	0	6406	0	6308	0.0	0.0
chr2	ERCC3	127280446	127280631	0	186	0	6406	0	6220	0.0	0.0
chr2	ERCC3	127290223	127290273	0	51	0	6406	0	6355	0.0	0.0
chr2	ERCC3	127280897	127280972	0	76	0	6406	0	6330	0.0	0.0
chr2	ERCC3	127284170	127284289	0	120	0	6406	0	6286	0.0	0.0
chr2	IWS1	127485873	127486033	0	161	0	4167	0	4006	0.0	0.0
chr2	IWS1	127523675	127523791	0	117	0	4167	0	4050	0.0	0.0
chr2	LIMS2	127640069	127640145	0	77	51	7746	51	7669	0.0	0.006650149954361716
chr2	LIMS2	127642048	127642199	0	152	51	7746	51	7594	0.0	0.0067158282854885435
chr2	LIMS2	127674313	127674421	0	109	51	7746	51	7637	0.0	0.006678014927327484
chr2	LIMS2	127673677	127673743	0	67	51	7746	51	7679	0.0	0.006641489777314755
chr2	WDR33	127770777	127771004	0	228	5085	14069	5085	13841	0.0	0.3673867495123185
chr2	POLR2D	127850589	127850685	0	97	1530	5227	1530	5130	0.0	0.2982456140350877
chr2	POLR2D	127852924	127853105	0	182	1530	5227	1530	5045	0.0	0.30327056491575816
chr2	SAP130	127977984	127978089	130	106	73086	4395	72956	4289	1.2264150943396226	17.010025647003964
chr2	LINC02572	129869426	129869535	0	110	135	4097	135	3987	0.0	0.033860045146726865
chr2	LINC02572	129872605	129872751	0	147	135	4097	135	3950	0.0	0.03417721518987342
chr2	CCDC74B	130140178	130140371	0	194	0	3013	0	2819	0.0	0.0
chr2	CCDC74B	130144371	130144474	0	104	0	3013	0	2909	0.0	0.0
chr2	SMPD4	130157250	130157396	0	147	4	7065	4	6918	0.0	0.0005782017924255566
chr2	SMPD4	130161185	130161272	0	88	4	7065	4	6977	0.0	0.0005733123118818977
chr2	SMPD4	130173278	130173354	0	77	4	7065	4	6988	0.0	0.0005724098454493417
chr2	SMPD4	130173513	130173604	4	92	4	7065	0	6973	0.043478260869565216	0.0
chr2	SMPD4	130159512	130159634	0	123	4	7065	4	6942	0.0	0.0005762028233938346
chr2	SMPD4	130174913	130175000	0	88	4	7065	4	6977	0.0	0.0005733123118818977
chr2	SMPD4	130173513	130173656	4	144	4	7065	0	6921	0.027777777777777776	0.0
chr2	SMPD4	130156584	130156675	0	92	4	7065	4	6973	0.0	0.000573641187437258
chr2	CCDC115	130339559	130339762	0	204	0	2582	0	2378	0.0	0.0
chr2	FAR2P2	130425913	130426038	0	126	0	4636	0	4510	0.0	0.0
chr2	FAR2P2	130426165	130426263	0	99	0	4636	0	4537	0.0	0.0
chr2	FAR2P2	130425464	130425611	0	148	0	4636	0	4488	0.0	0.0
chr2	CFC1	130597867	130597982	0	116	0	1678	0	1562	0.0	0.0
chr2	CFC1	130597493	130597603	0	111	0	1678	0	1567	0.0	0.0
chr2	NF1P8	131193518	131193591	0	74	0	1606	0	1532	0.0	0.0
chr2	ANKRD30BL	132153531	132153694	0	164	9138	4955	9138	4791	0.0	1.9073262366938009
chr2	NCKAP5	132725626	132725759	0	134	1217	9586	1217	9452	0.0	0.1287558188743123
chr2	NCKAP5	132773815	132773894	0	80	1217	9586	1217	9506	0.0	0.1280244056385441
chr2	NCKAP5	132728815	132728952	0	138	1217	9586	1217	9448	0.0	0.12881033022861982
chr2	CCNT2-AS1	134877519	134877643	230	125	281	3241	51	3116	1.84	0.016367137355584083
chr2	MAP3K19	134985799	134988253	0	2455	56	6971	56	4516	0.0	0.012400354295837024
chr2	MAP3K19	134985799	134988274	0	2476	56	6971	56	4495	0.0	0.012458286985539488
chr2	MAP3K19	135024625	135024741	0	117	56	6971	56	6854	0.0	0.008170411438576015
chr2	MAP3K19	134983675	134983825	0	151	56	6971	56	6820	0.0	0.008211143695014663
chr2	MAP3K19	135030311	135030500	0	190	56	6971	56	6781	0.0	0.008258368972128005
chr2	MAP3K19	135021714	135021830	0	117	56	6971	56	6854	0.0	0.008170411438576015
chr2	ZRANB3	135271300	135271395	0	96	35749	9098	35749	9002	0.0	3.9712286158631414
chr2	LCT	135800606	135800809	0	204	4280	6597	4280	6393	0.0	0.6694822462067886
chr2	DARS1	135912485	135912566	45	82	16656	4752	16611	4670	0.5487804878048781	3.5569593147751606
chr2	LRP1B	140234785	140234884	0	100	0	16448	0	16348	0.0	0.0
chr2	LRP1B	140269267	140269381	0	115	0	16448	0	16333	0.0	0.0
chr2	AC079793.1	143471971	143472019	0	49	0	3377	0	3328	0.0	0.0
chr2	GTDC1	143957194	143957339	0	146	82	13660	82	13514	0.0	0.006067781559863845
chr2	GTDC1	144007181	144007535	0	355	82	13660	82	13305	0.0	0.006163096580232995
chr2	GTDC1	143970652	143970762	0	111	82	13660	82	13549	0.0	0.006052107166580559
chr2	GTDC1	144177134	144177240	0	107	82	13660	82	13553	0.0	0.006050320962148602
chr2	GTDC1	144230240	144230322	0	83	82	13660	82	13577	0.0	0.00603962583781395
chr2	ZEB2	144424795	144424867	0	73	0	21461	0	21388	0.0	0.0
chr2	ZEB2	144404835	144405024	0	190	0	21461	0	21271	0.0	0.0
chr2	ZEB2	144424795	144424953	0	159	0	21461	0	21302	0.0	0.0
chr2	ZEB2	144394392	144394480	0	89	0	21461	0	21372	0.0	0.0
chr2	ZEB2	144424795	144424864	0	70	0	21461	0	21391	0.0	0.0
chr2	ZEB2	144518292	144518446	0	155	0	21461	0	21306	0.0	0.0
chr2	ZEB2	144497707	144497764	0	58	0	21461	0	21403	0.0	0.0
chr2	ZEB2	144519938	144520208	0	271	0	21461	0	21190	0.0	0.0
chr2	ZEB2	144516457	144516553	0	97	0	21461	0	21364	0.0	0.0
chr2	ORC4	147975901	147975975	0	75	0	8740	0	8665	0.0	0.0
chr2	ORC4	147981927	147982081	0	155	0	8740	0	8585	0.0	0.0
chr2	MMADHC	149572229	149572331	0	103	0	2159	0	2056	0.0	0.0
chr2	NMI	151281947	151282043	0	97	51	3321	51	3224	0.0	0.015818858560794045
chr2	NMI	151288890	151289077	0	188	51	3321	51	3133	0.0	0.016278327481646985
chr2	NEB	151502792	151502885	0	94	153	30273	153	30179	0.0	0.0050697504887504555
chr2	NEB	151506908	151507013	0	106	153	30273	153	30167	0.0	0.0050717671627937815
chr2	NEB	151508004	151508109	0	106	153	30273	153	30167	0.0	0.0050717671627937815
chr2	NEB	151514817	151514928	0	112	153	30273	153	30161	0.0	0.0050727761015881435
chr2	NEB	151499297	151499390	0	94	153	30273	153	30179	0.0	0.0050697504887504555
chr2	NEB	151533441	151533546	0	106	153	30273	153	30167	0.0	0.0050717671627937815
chr2	NEB	151534214	151534319	0	106	153	30273	153	30167	0.0	0.0050717671627937815
chr2	NEB	151494160	151494253	0	94	153	30273	153	30179	0.0	0.0050697504887504555
chr2	NEB	151501390	151501483	0	94	153	30273	153	30179	0.0	0.0050697504887504555
chr2	NEB	151496940	151497033	0	94	153	30273	153	30179	0.0	0.0050697504887504555
chr2	CACNB4	151841667	151841739	0	73	102	14196	102	14123	0.0	0.007222261559158819
chr2	CACNB4	151869176	151869735	0	560	102	14196	102	13636	0.0	0.00748019947198592
chr2	CACNB4	151870841	151870861	0	21	102	14196	102	14175	0.0	0.0071957671957671955
chr2	CACNB4	151880799	151880922	0	124	102	14196	102	14072	0.0	0.0072484366117111995
chr2	CACNB4	151971544	151971704	0	161	102	14196	102	14035	0.0	0.007267545422158889
chr2	ARL5A	151810377	151810561	0	185	204	6732	204	6547	0.0	0.031159309607453795
chr2	CACNB4	151841902	151842088	0	187	102	14196	102	14009	0.0	0.0072810336212434865
chr2	CACNB4	151853447	151853543	0	97	102	14196	102	14099	0.0	0.00723455564224413
chr2	CACNB4	151869176	151869235	0	60	102	14196	102	14136	0.0	0.007215619694397283
chr2	CACNB4	151853447	151853564	0	118	102	14196	102	14078	0.0	0.00724534735047592
chr2	CACNB4	151860710	151860820	0	111	102	14196	102	14085	0.0	0.00724174653887114
chr2	CACNB4	151870530	151870611	0	82	102	14196	102	14114	0.0	0.007226866940626329
chr2	CACNB4	151970280	151970426	0	147	102	14196	102	14049	0.0	0.007260303224428785
chr2	CACNB4	151874919	151874970	0	52	102	14196	102	14144	0.0	0.007211538461538462
chr2	CACNB4	151962844	151962911	0	68	102	14196	102	14128	0.0	0.007219705549263873
chr2	CACNB4	151870841	151870902	0	62	102	14196	102	14134	0.0	0.007216640724494128
chr2	CACNB4	151869176	151870611	0	1436	102	14196	102	12760	0.0	0.00799373040752351
chr2	CACNB4	151971544	151971700	0	157	102	14196	102	14039	0.0	0.00726547474891374
chr2	CACNB4	151855223	151855375	0	153	102	14196	102	14043	0.0	0.007263405255287332
chr2	CACNB4	151869176	151869193	0	18	102	14196	102	14178	0.0	0.007194244604316547
chr2	CACNB4	151967536	151967610	0	75	102	14196	102	14121	0.0	0.007223284469938389
chr2	CACNB4	151872416	151872493	0	78	102	14196	102	14118	0.0	0.007224819379515512
chr2	STAM2	152150144	152150229	0	86	40210	6791	40210	6705	0.0	5.997017151379567
chr2	PRPF40A	152679055	152679109	0	55	178359	9227	178359	9172	0.0	19.446031399912776
chr2	PRPF40A	152693157	152693476	0	320	178359	9227	178359	8907	0.0	20.02458740316605
chr2	AC011901.1	153187451	153187569	0	119	0	1031	0	912	0.0	0.0
chr2	AC012501.2	153423435	153423492	0	58	561	988	561	930	0.0	0.603225806451613
chr2	LINC01876	156013672	156013783	0	112	0	2723	0	2611	0.0	0.0
chr2	LINC01876	156150484	156150602	0	119	0	2723	0	2604	0.0	0.0
chr2	LINC01876	156024484	156024607	0	124	0	2723	0	2599	0.0	0.0
chr2	LINC01876	156024465	156024607	0	143	0	2723	0	2580	0.0	0.0
chr2	LINC01876	156024469	156024607	0	139	0	2723	0	2584	0.0	0.0
chr2	NR4A2	156330667	156330791	0	125	153	3973	153	3848	0.0	0.03976091476091476
chr2	NR4A2	156326311	156326328	0	18	153	3973	153	3955	0.0	0.038685208596713025
chr2	ERMN	157325130	157325236	0	107	1173	4361	1173	4254	0.0	0.2757404795486601
chr2	ERMN	157324146	157324269	0	124	1173	4361	1173	4237	0.0	0.2768468255841397
chr2	ERMN	157324117	157324269	0	153	1173	4361	1173	4208	0.0	0.27875475285171103
chr2	CYTIP	157438882	157438963	36	82	9529	3398	9493	3316	0.43902439024390244	2.8627864897466826
chr2	CYTIP	157443846	157444006	510	161	9529	3398	9019	3237	3.1677018633540373	2.786221810318196
chr2	CYTIP	157464935	157465027	0	93	9529	3398	9529	3305	0.0	2.88320726172466
chr2	ACVR1C	157556092	157556332	0	241	51	9064	51	8823	0.0	0.005780346820809248
chr2	ACVR1C	157550161	157550392	0	232	51	9064	51	8832	0.0	0.00577445652173913
chr2	ACVR1	157860032	157860179	0	148	0	4499	0	4351	0.0	0.0
chr2	ACVR1	157819402	157819489	0	88	0	4499	0	4411	0.0	0.0
chr2	ACVR1	157826527	157826646	0	120	0	4499	0	4379	0.0	0.0
chr2	ACVR1	157860054	157860179	0	126	0	4499	0	4373	0.0	0.0
chr2	CCDC148	158340241	158340393	0	153	0	3816	0	3663	0.0	0.0
chr2	CCDC148	158345214	158345318	0	105	0	3816	0	3711	0.0	0.0
chr2	CCDC148	158358448	158358570	0	123	0	3816	0	3693	0.0	0.0
chr2	WDSUB1	159248371	159248512	0	142	0	1977	0	1835	0.0	0.0
chr2	BAZ2B	159336941	159337077	0	137	26477	18526	26477	18389	0.0	1.4398281581380172
chr2	BAZ2B	159427940	159428042	0	103	26477	18526	26477	18423	0.0	1.437170927644792
chr2	BAZ2B	159430862	159431156	0	295	26477	18526	26477	18231	0.0	1.4523065108880477
chr2	BAZ2B	159453612	159453801	0	190	26477	18526	26477	18336	0.0	1.443989965095986
chr2	BAZ2B	159397073	159397100	0	28	26477	18526	26477	18498	0.0	1.4313439290734133
chr2	BAZ2B	159448241	159448409	0	169	26477	18526	26477	18357	0.0	1.4423380726698263
chr2	CD302	159780004	159780178	0	175	51	4084	51	3909	0.0	0.013046815042210284
chr2	CD302	159783358	159783469	0	112	51	4084	51	3972	0.0	0.01283987915407855
chr2	LY75-CD302	159806972	159807140	102	169	3547	5689	3445	5520	0.6035502958579881	0.6240942028985508
chr2	ITGB6	160199178	160199258	0	81	1279	3902	1279	3821	0.0	0.33472912850039255
chr2	ITGB6	160196215	160196420	0	206	1279	3902	1279	3696	0.0	0.34604978354978355
chr2	RBMS1	160401967	160402102	0	136	370	9745	370	9609	0.0	0.03850556769695077
chr2	AC009299.2	161227048	161227133	0	86	0	2835	0	2749	0.0	0.0
chr2	AC009299.2	161254584	161254680	0	97	0	2835	0	2738	0.0	0.0
chr2	AC009299.2	161246758	161246913	0	156	0	2835	0	2679	0.0	0.0
chr2	DPP4	162039131	162039184	0	54	14003	14461	14003	14407	0.0	0.9719580759353093
chr2	DPP4	162032034	162032265	1092	232	14003	14461	12911	14229	4.706896551724138	0.9073722679035772
chr2	DPP4	162046701	162046805	0	105	14003	14461	14003	14356	0.0	0.9754109779882976
chr2	FAP	162224465	162224540	0	76	47867	6864	47867	6788	0.0	7.0517088980553915
chr2	FAP	162226522	162226621	2353	100	47867	6864	45514	6764	23.53	6.728858663512715
chr2	FAP	162221592	162221712	0	121	47867	6864	47867	6743	0.0	7.09876909387513
chr2	IFIH1	162279995	162280112	0	118	231129	5110	231129	4992	0.0	46.29987980769231
chr2	KCNH7	162512653	162512674	0	22	51	5031	51	5009	0.0	0.010181672988620483
chr2	FIGN	163734902	163735072	0	171	0	9946	0	9775	0.0	0.0
chr2	AC016766.1	163867698	163867794	0	97	0	1126	0	1029	0.0	0.0
chr2	GRB14	164494430	164494524	0	95	396	3003	396	2908	0.0	0.1361760660247593
chr2	COBLL1	164703103	164703220	0	118	58	17102	58	16984	0.0	0.0034149788035798398
chr2	COBLL1	164743686	164743875	0	190	58	17102	58	16912	0.0	0.0034295175023651846
chr2	COBLL1	164727105	164727144	0	40	58	17102	58	17062	0.0	0.003399367014418005
chr2	COBLL1	164800533	164800554	0	22	58	17102	58	17080	0.0	0.003395784543325527
chr2	COBLL1	164703627	164703671	0	45	58	17102	58	17057	0.0	0.003400363487131383
chr2	COBLL1	164837427	164837498	58	72	58	17102	0	17030	0.8055555555555556	0.0
chr2	COBLL1	164779654	164779785	0	132	58	17102	58	16970	0.0	0.003417796110783736
chr2	SLC38A11	164915111	164915273	0	163	0	5207	0	5044	0.0	0.0
chr2	SLC38A11	164944568	164944634	0	67	0	5207	0	5140	0.0	0.0
chr2	SCN3A	165179551	165179691	0	141	130	11548	130	11407	0.0	0.011396510914350837
chr2	GALNT3	165761752	165761792	0	41	90	4440	90	4399	0.0	0.020459195271652648
chr2	GALNT3	165771264	165771383	0	120	90	4440	90	4320	0.0	0.020833333333333332
chr2	TTC21B	165864983	165865077	0	95	0	8712	0	8617	0.0	0.0
chr2	SCN1A	166002471	166002753	0	283	459	18837	459	18554	0.0	0.02473860084078905
chr2	SCN1A	166077709	166077847	0	139	459	18837	459	18698	0.0	0.024548080008557065
chr2	SCN1A	166077709	166077801	0	93	459	18837	459	18744	0.0	0.024487836107554416
chr2	SCN1A	166126923	166127010	0	88	459	18837	459	18749	0.0	0.024481305669635713
chr2	SCN1A	166007229	166007293	0	65	459	18837	459	18772	0.0	0.024451310462390796
chr2	SCN1A	165999050	165999116	0	67	459	18837	459	18770	0.0	0.024453915823122004
chr2	SCN1A	166060639	166060867	0	229	459	18837	459	18608	0.0	0.024666809974204642
chr2	SCN9A	166233339	166233462	0	124	153	13972	153	13848	0.0	0.011048526863084922
chr2	SCN9A	166259205	166259287	0	83	153	13972	153	13889	0.0	0.011015911872705019
chr2	SCN7A	166486855	166486968	0	114	29	9765	29	9651	0.0	0.003004869961662004
chr2	SCN7A	166436346	166436440	0	95	29	9765	29	9670	0.0	0.0029989658738366082
chr2	B3GALT1-AS1	167869739	167869980	0	242	51	1368	51	1126	0.0	0.0452930728241563
chr2	B3GALT1-AS1	167939242	167939297	0	56	51	1368	51	1312	0.0	0.038871951219512195
chr2	B3GALT1-AS1	167862714	167862850	0	137	51	1368	51	1231	0.0	0.041429731925264016
chr2	CERS6-AS1	168775195	168775370	0	176	0	4221	0	4045	0.0	0.0
chr2	CERS6-AS1	168783954	168784047	0	94	0	4221	0	4127	0.0	0.0
chr2	CERS6-AS1	168777812	168777937	0	126	0	4221	0	4095	0.0	0.0
chr2	CERS6-AS1	168775195	168775315	0	121	0	4221	0	4100	0.0	0.0
chr2	ABCB11	168929291	168929351	0	61	11347	7746	11347	7685	0.0	1.4765126870527001
chr2	ABCB11	168932780	168932940	0	161	11347	7746	11347	7585	0.0	1.4959789057350033
chr2	LRP2	169140454	169140545	0	92	0	16189	0	16097	0.0	0.0
chr2	LRP2	169270903	169271107	0	205	0	16189	0	15984	0.0	0.0
chr2	LRP2	169277744	169277951	0	208	0	16189	0	15981	0.0	0.0
chr2	LRP2	169140454	169140508	0	55	0	16189	0	16134	0.0	0.0
chr2	FASTKD1	169537226	169537340	0	115	1194	5035	1194	4920	0.0	0.2426829268292683
chr2	FASTKD1	169538012	169538141	0	130	1194	5035	1194	4905	0.0	0.2434250764525994
chr2	FASTKD1	169569183	169569252	0	70	1194	5035	1194	4965	0.0	0.2404833836858006
chr2	CCDC173	169681006	169681233	0	228	352	2218	352	1990	0.0	0.17688442211055277
chr2	METTL5	169821091	169821273	0	183	0	2425	0	2242	0.0	0.0
chr2	METTL5	169821942	169822057	0	116	0	2425	0	2309	0.0	0.0
chr2	MYO3B-AS1	170334745	170334879	0	135	24581	5707	24581	5572	0.0	4.411521895190237
chr2	MYO3B-AS1	170343458	170343656	4466	199	24581	5707	20115	5508	22.44221105527638	3.6519607843137254
chr2	MYO3B-AS1	170343458	170343558	0	101	24581	5707	24581	5606	0.0	4.3847663217980735
chr2	MYO3B-AS1	170343458	170343637	4034	180	24581	5707	20547	5527	22.41111111111111	3.717568301067487
chr2	MYO3B-AS1	170341385	170341429	0	45	24581	5707	24581	5662	0.0	4.341398799010951
chr2	MYO3B-AS1	170343494	170343656	4466	163	24581	5707	20115	5544	27.39877300613497	3.6282467532467533
chr2	MYO3B-AS1	170344340	170344352	2314	13	24581	5707	22267	5694	178.0	3.9106076571829997
chr2	MYO3B-AS1	170344340	170344381	4476	42	24581	5707	20105	5665	106.57142857142857	3.5489849955869373
chr2	MYO3B-AS1	170344340	170344438	4476	99	24581	5707	20105	5608	45.21212121212121	3.5850570613409416
chr2	MYO3B-AS1	170344171	170344298	0	128	24581	5707	24581	5579	0.0	4.405986735974189
chr2	MYO3B-AS1	170341329	170341429	0	101	24581	5707	24581	5606	0.0	4.3847663217980735
chr2	MYO3B-AS1	170344340	170344574	11514	235	24581	5707	13067	5472	48.99574468085106	2.3879751461988303
chr2	MYO3B-AS1	170340166	170340417	102	252	24581	5707	24479	5455	0.40476190476190477	4.487442713107241
chr2	MYO3B-AS1	170340166	170340421	102	256	24581	5707	24479	5451	0.3984375	4.49073564483581
chr2	MYO3B-AS1	170341188	170341425	0	238	24581	5707	24581	5469	0.0	4.49460596087036
chr2	MYO3B-AS1	170341188	170341429	0	242	24581	5707	24581	5465	0.0	4.497895699908509
chr2	MYO3B-AS1	170344798	170344933	0	136	24581	5707	24581	5571	0.0	4.412313767725722
chr2	MYO3B-AS1	170343816	170343840	0	25	24581	5707	24581	5682	0.0	4.326117564237944
chr2	MYO3B-AS1	170350461	170350644	1428	184	24581	5707	23153	5523	7.760869565217392	4.192105739634257
chr2	MYO3B-AS1	170347951	170348125	0	175	24581	5707	24581	5532	0.0	4.443420101229212
chr2	MYO3B-AS1	170346177	170346242	0	66	24581	5707	24581	5641	0.0	4.357560716185073
chr2	MYO3B-AS1	170349511	170349634	719	124	24581	5707	23862	5583	5.798387096774194	4.274046211714132
chr2	MYO3B-AS1	170344171	170344301	0	131	24581	5707	24581	5576	0.0	4.408357245337159
chr2	MYO3B-AS1	170345062	170345132	49	71	24581	5707	24532	5636	0.6901408450704225	4.352732434350603
chr2	MYO3B-AS1	170344798	170345132	51	335	24581	5707	24530	5372	0.15223880597014924	4.566269545793001
chr2	MYO3B-AS1	170349837	170349851	0	15	24581	5707	24581	5692	0.0	4.318517217146873
chr2	MYO3B-AS1	170346177	170346405	0	229	24581	5707	24581	5478	0.0	4.4872216137276375
chr2	MYO3B-AS1	170350317	170350644	4473	328	24581	5707	20108	5379	13.637195121951219	3.738241308793456
chr2	MYO3B-AS1	170345062	170345215	49	154	24581	5707	24532	5553	0.3181818181818182	4.417792184404826
chr2	MYO3B-AS1	170350461	170350571	1428	111	24581	5707	23153	5596	12.864864864864865	4.137419585418156
chr2	MYO3B-AS1	170347951	170348099	0	149	24581	5707	24581	5558	0.0	4.422634041021951
chr2	AC007405.1	170726042	170726089	0	48	6662	6575	6662	6527	0.0	1.0206833154588633
chr2	AC007405.1	170730367	170730997	0	631	6662	6575	6662	5944	0.0	1.1207940780619112
chr2	AC007405.1	170740631	170741287	0	657	6662	6575	6662	5918	0.0	1.1257181480229808
chr2	AC007405.1	170733878	170733994	177	117	6662	6575	6485	6458	1.5128205128205128	1.004180860947662
chr2	AC007405.1	170728578	170730037	5404	1460	6662	6575	1258	5115	3.7013698630136984	0.24594330400782013
chr2	TLK1	171059923	171059986	0	64	225	9435	225	9371	0.0	0.024010244370931598
chr2	TLK1	171022871	171023129	0	259	225	9435	225	9176	0.0	0.02452048823016565
chr2	TLK1	171081639	171081708	0	70	225	9435	225	9365	0.0	0.02402562733582488
chr2	METTL8	171326041	171326148	0	108	0	9953	0	9845	0.0	0.0
chr2	METTL8	171337452	171337502	0	51	0	9953	0	9902	0.0	0.0
chr2	METTL8	171360421	171360513	0	93	0	9953	0	9860	0.0	0.0
chr2	METTL8	171392042	171392197	0	156	0	9953	0	9797	0.0	0.0
chr2	METTL8	171414602	171414726	0	125	0	9953	0	9828	0.0	0.0
chr2	METTL8	171433025	171433219	0	195	0	9953	0	9758	0.0	0.0
chr2	SLC25A12	171855833	171855949	36	117	8119	6150	8083	6033	0.3076923076923077	1.3397977788828113
chr2	SLC25A12	171848172	171848276	1061	105	8119	6150	7058	6045	10.104761904761904	1.1675765095119934
chr2	SLC25A12	171845726	171845858	0	133	8119	6150	8119	6017	0.0	1.3493435266744225
chr2	SLC25A12	171852667	171852688	22	22	8119	6150	8097	6128	1.0	1.3213120104438643
chr2	SLC25A12	171991346	171991442	0	97	8119	6150	8119	6053	0.0	1.3413183545349414
chr2	SLC25A12	171921079	171921231	0	153	8119	6150	8119	5997	0.0	1.353843588460897
chr2	SP3	173963760	173963883	0	124	35061	9158	35061	9034	0.0	3.881005091875138
chr2	SP3	173934369	173934411	0	43	35061	9158	35061	9115	0.0	3.846516730663741
chr2	OLA1	174246714	174246815	0	102	59467	6016	59467	5914	0.0	10.055292526208996
chr2	GPR155	174466543	174466627	0	85	0	7788	0	7703	0.0	0.0
chr2	GPR155	174482872	174482918	0	47	0	7788	0	7741	0.0	0.0
chr2	GPR155	174483009	174483158	0	150	0	7788	0	7638	0.0	0.0
chr2	CHRNA1	174748579	174748819	0	241	27927	4993	27927	4752	0.0	5.8768939393939394
chr2	CHRNA1	174757565	174757675	0	111	27927	4993	27927	4882	0.0	5.720401474805407
chr2	CHRNA1	174764020	174764144	0	125	27927	4993	27927	4868	0.0	5.736852917009038
chr2	CHRNA1	174757945	174758020	0	76	27927	4993	27927	4917	0.0	5.679682733374008
chr2	CHN1	174808904	174809042	0	139	410167	9117	410167	8978	0.0	45.685787480507905
chr2	CHN1	174824433	174824518	0	86	410167	9117	410167	9031	0.0	45.41767246152143
chr2	CHN1	174846879	174846957	0	79	410167	9117	410167	9038	0.0	45.38249612746183
chr2	CHN1	174877839	174878128	0	290	410167	9117	410167	8827	0.0	46.467316188965675
chr2	CHN1	174944887	174944943	0	57	410167	9117	410167	9060	0.0	45.27229580573952
chr2	CHN1	174821728	174821779	0	52	410167	9117	410167	9065	0.0	45.247324875896304
chr2	CHN1	174875787	174875865	0	79	410167	9117	410167	9038	0.0	45.38249612746183
chr2	CHN1	175004893	175005080	255	188	410167	9117	409912	8929	1.3563829787234043	45.907940418859894
chr2	CHN1	174805524	174805653	0	130	410167	9117	410167	8987	0.0	45.64003560698787
chr2	CHN1	174952163	174952202	0	40	410167	9117	410167	9077	0.0	45.187506885534866
chr2	CHN1	174940815	174940894	462	80	410167	9117	409705	9037	5.775	45.33639482129025
chr2	CHN1	174872019	174872114	0	96	410167	9117	410167	9021	0.0	45.468019066622325
chr2	CHN1	174918533	174918565	0	33	410167	9117	410167	9084	0.0	45.152686041391455
chr2	CHN1	174951742	174951837	0	96	410167	9117	410167	9021	0.0	45.468019066622325
chr2	CHN1	174917324	174917431	0	108	410167	9117	410167	9009	0.0	45.528582528582525
chr2	CHN1	174945169	174945261	509	93	410167	9117	409658	9024	5.473118279569892	45.39649822695036
chr2	ATF2	175080659	175080765	0	107	2652	5317	2652	5210	0.0	0.509021113243762
chr2	ATF2	175113993	175114108	0	116	2652	5317	2652	5201	0.0	0.5099019419342434
chr2	ATF2	175117989	175118118	0	130	2652	5317	2652	5187	0.0	0.5112781954887218
chr2	ATF2	175121443	175121540	0	98	2652	5317	2652	5219	0.0	0.50814332247557
chr2	ATF2	175132694	175132757	0	64	2652	5317	2652	5253	0.0	0.5048543689320388
chr2	ATF2	175092542	175092616	0	75	2652	5317	2652	5242	0.0	0.5059137733689432
chr2	ATF2	175136411	175136486	0	76	2652	5317	2652	5241	0.0	0.5060103033772181
chr2	ATF2	175147945	175147980	0	36	2652	5317	2652	5281	0.0	0.5021776178754024
chr2	ATF2	175074999	175075087	0	89	2652	5317	2652	5228	0.0	0.5072685539403213
chr2	ATF2	175114689	175114868	0	180	2652	5317	2652	5137	0.0	0.5162546233210045
chr2	LNPK	175938312	175938383	2117	72	49901	9098	47784	9026	29.40277777777778	5.294039441613117
chr2	LNPK	175940987	175941080	930	94	49901	9098	48971	9004	9.893617021276595	5.4388049755664145
chr2	HAGLR	176177331	176177494	0	164	51	4973	51	4809	0.0	0.010605115408608859
chr2	HAGLR	176177710	176177856	0	147	51	4973	51	4826	0.0	0.010567757977621219
chr2	HAGLR	176179028	176179098	0	71	51	4973	51	4902	0.0	0.01040391676866585
chr2	HAGLR	176177000	176177070	0	71	51	4973	51	4902	0.0	0.01040391676866585
chr2	HAGLR	176176898	176176939	0	42	51	4973	51	4931	0.0	0.010342729669438248
chr2	HAGLR	176177710	176177821	0	112	51	4973	51	4861	0.0	0.010491668380991566
chr2	HAGLR	176177710	176177826	0	117	51	4973	51	4856	0.0	0.010502471169686986
chr2	LINC01116	176633364	176633740	51	377	459	2130	408	1753	0.13527851458885942	0.2327438676554478
chr2	AC092162.2	176782815	176782919	0	105	5578	6240	5578	6135	0.0	0.9092094539527302
chr2	AC073636.1	176847989	176848342	868	354	1225	3276	357	2922	2.4519774011299433	0.12217659137577003
chr2	AC073636.1	176847865	176847941	0	77	1225	3276	1225	3199	0.0	0.38293216630196936
chr2	AC073636.1	176846527	176846629	0	103	1225	3276	1225	3173	0.0	0.3860699653324929
chr2	AC073636.1	176848574	176848657	153	84	1225	3276	1072	3192	1.8214285714285714	0.3358395989974937
chr2	AC074286.1	177143739	177143836	0	98	2703	6857	2703	6759	0.0	0.39991122947181534
chr2	AC074286.1	177097022	177097169	0	148	2703	6857	2703	6709	0.0	0.4028916380980772
chr2	AC074286.1	177131061	177131208	0	148	2703	6857	2703	6709	0.0	0.4028916380980772
chr2	AC019080.1	177331571	177331656	0	86	0	3664	0	3578	0.0	0.0
chr2	AC019080.1	177348321	177348475	0	155	0	3664	0	3509	0.0	0.0
chr2	AC019080.1	177332141	177332251	0	111	0	3664	0	3553	0.0	0.0
chr2	PDE11A	177669492	177669567	0	76	221	6758	221	6682	0.0	0.033073929961089495
chr2	PDE11A	177816828	177816921	0	94	221	6758	221	6664	0.0	0.03316326530612245
chr2	PDE11A	177899504	177899590	17	87	221	6758	204	6671	0.19540229885057472	0.030580122920101933
chr2	PDE11A	177921730	177921958	0	229	221	6758	221	6529	0.0	0.03384898146729974
chr2	PRKRA	178441609	178441704	0	96	51	10172	51	10076	0.0	0.005061532354108773
chr2	PRKRA	178444421	178444500	0	80	51	10172	51	10092	0.0	0.005053507728894174
chr2	PRKRA	178450241	178450411	0	171	51	10172	51	10001	0.0	0.005099490050994901
chr2	PRKRA	178445425	178445535	0	111	51	10172	51	10061	0.0	0.005069078620415466
chr2	PRKRA	178447504	178447586	0	83	51	10172	51	10089	0.0	0.005055010407374368
chr2	PRKRA	178450365	178450411	0	47	51	10172	51	10125	0.0	0.005037037037037037
chr2	PRKRA	178447455	178447586	0	132	51	10172	51	10040	0.0	0.005079681274900398
chr2	FKBP7	178469651	178469785	0	135	0	3086	0	2951	0.0	0.0
chr2	FKBP7	178477061	178477213	0	153	0	3086	0	2933	0.0	0.0
chr2	FKBP7	178473028	178473142	0	115	0	3086	0	2971	0.0	0.0
chr2	FKBP7	178469651	178469782	0	132	0	3086	0	2954	0.0	0.0
chr2	TTN	178637368	178637419	0	52	877	119344	877	119292	0.0	0.0073517084129698556
chr2	TTN	178790707	178790845	0	139	877	119344	877	119205	0.0	0.007357073948240426
chr2	TTN	178739140	178741921	0	2782	877	119344	877	116562	0.0	0.007523892863883598
chr2	TTN	178789977	178790115	22	139	877	119344	855	119205	0.15827338129496402	0.007172517931294828
chr2	TTN	178665707	178665791	0	85	877	119344	877	119259	0.0	0.007353742694471696
chr2	TTN	178675670	178675754	0	85	877	119344	877	119259	0.0	0.007353742694471696
chr2	TTN	178677200	178677287	0	88	877	119344	877	119256	0.0	0.00735392768498021
chr2	TTN	178756221	178756797	0	577	877	119344	877	118767	0.0	0.007384206050502244
chr2	TTN	178757541	178757916	0	376	877	119344	877	118968	0.0	0.007371730213166566
chr2	CCDC141	178918712	178918907	18	196	852	13822	834	13626	0.09183673469387756	0.06120651695288419
chr2	SESTD1	179123714	179123829	0	116	4370	11426	4370	11310	0.0	0.3863837312113174
chr2	ZNF385B	179576115	179576267	0	153	1337	5441	1337	5288	0.0	0.2528366111951589
chr2	ZNF385B	179483271	179483434	0	164	1337	5441	1337	5277	0.0	0.2533636535910555
chr2	ZNF385B	179544826	179544969	0	144	1337	5441	1337	5297	0.0	0.2524070228431187
chr2	ZNF385B	179522881	179522920	0	40	1337	5441	1337	5401	0.0	0.24754675060174042
chr2	CERKL	181547821	181547847	0	27	0	4691	0	4664	0.0	0.0
chr2	CERKL	181566057	181566121	0	65	0	4691	0	4626	0.0	0.0
chr2	CERKL	181573752	181573884	0	133	0	4691	0	4558	0.0	0.0
chr2	CERKL	181565432	181565510	0	79	0	4691	0	4612	0.0	0.0
chr2	CERKL	181558565	181558708	0	144	0	4691	0	4547	0.0	0.0
chr2	NCKAP1	183024977	183024995	0	19	51	22553	51	22534	0.0	0.002263246649507411
chr2	LINC01473	186057669	186057906	0	238	0	3606	0	3368	0.0	0.0
chr2	LINC01473	186058756	186058969	0	214	0	3606	0	3392	0.0	0.0
chr2	LINC01473	186178598	186178691	0	94	0	3606	0	3512	0.0	0.0
chr2	LINC01473	186086300	186086370	0	71	0	3606	0	3535	0.0	0.0
chr2	LINC01473	186305161	186305219	0	59	0	3606	0	3547	0.0	0.0
chr2	LINC01473	186099768	186099830	0	63	0	3606	0	3543	0.0	0.0
chr2	LINC01473	186080647	186080777	0	131	0	3606	0	3475	0.0	0.0
chr2	LINC01473	186080647	186080774	0	128	0	3606	0	3478	0.0	0.0
chr2	LINC01473	186215018	186215090	0	73	0	3606	0	3533	0.0	0.0
chr2	CALCRL	187387328	187387493	0	166	655	7327	655	7161	0.0	0.09146767211283341
chr2	CALCRL	187431296	187431364	0	69	655	7327	655	7258	0.0	0.09024524662441444
chr2	CALCRL	187387328	187387465	0	138	655	7327	655	7189	0.0	0.09111142022534427
chr2	TFPI	187488336	187488375	0	40	81185	11727	81185	11687	0.0	6.946607341490545
chr2	TFPI	187513615	187513646	0	32	81185	11727	81185	11695	0.0	6.9418554938007695
chr2	TFPI	187520541	187520613	333	73	81185	11727	80852	11654	4.561643835616438	6.937703792689206
chr2	TFPI	187529363	187529485	1022	123	81185	11727	80163	11604	8.308943089430894	6.908221302998966
chr2	TFPI	187544503	187544637	17592	135	81185	11727	63593	11592	130.3111111111111	5.485938578329883
chr2	OSGEPL1	189752652	189752724	0	73	0	3437	0	3364	0.0	0.0
chr2	ORMDL1	189783013	189783123	0	111	0	4012	0	3901	0.0	0.0
chr2	HIBCH	190208879	190208913	0	35	519	6477	519	6442	0.0	0.08056504191244955
chr2	HIBCH	190261155	190261234	38	80	519	6477	481	6397	0.475	0.07519149601375645
chr2	NEMP2	190516269	190516384	0	116	2410	6535	2410	6419	0.0	0.3754478890792958
chr2	NEMP2	190525262	190525378	0	117	2410	6535	2410	6418	0.0	0.3755063882829542
chr2	AC006460.2	190629750	190629825	44	76	43184	7821	43140	7745	0.5789473684210527	5.570045190445449
chr2	AC006460.2	190640950	190641462	678	513	43184	7821	42506	7308	1.3216374269005848	5.816365626710454
chr2	AC006460.1	190678424	190678537	120	114	4260	5423	4140	5309	1.0526315789473684	0.7798078734224901
chr2	STAT1	190979771	190979866	0	96	4	9766	4	9670	0.0	0.0004136504653567735
chr2	STAT1	190998216	190998308	0	93	4	9766	4	9673	0.0	0.00041352217512664115
chr2	STAT1	191001073	191001163	0	91	4	9766	4	9675	0.0	0.00041343669250645994
chr2	STAT1	191013524	191013678	0	155	4	9766	4	9611	0.0	0.00041618978254083863
chr2	STAT1	190975309	190975388	0	80	4	9766	4	9686	0.0	0.00041296716911005574
chr2	STAT1	190975309	190975434	0	126	4	9766	4	9640	0.0	0.0004149377593360996
chr2	STAT1	190978527	190978606	0	80	4	9766	4	9686	0.0	0.00041296716911005574
chr2	STAT1	191010366	191010449	0	84	4	9766	4	9682	0.0	0.0004131377814501136
chr2	STAT4	191068059	191068594	459	536	8388	4634	7929	4098	0.8563432835820896	1.9348462664714494
chr2	STAT4	191150946	191151014	0	69	8388	4634	8388	4565	0.0	1.8374589266155532
chr2	STAT4	191150946	191151081	0	136	8388	4634	8388	4498	0.0	1.8648288128056913
chr2	DNAH7	195754336	195754514	0	179	0	21418	0	21239	0.0	0.0
chr2	STK17B	196174248	196174407	0	160	0	6579	0	6419	0.0	0.0
chr2	HECW2	196257822	196257906	0	85	565	22512	565	22427	0.0	0.02519284790654122
chr2	HECW2	196320338	196320439	0	102	565	22512	565	22410	0.0	0.025211958946898705
chr2	HECW2	196493243	196493375	0	133	565	22512	565	22379	0.0	0.025246883238750614
chr2	GTF3C3	196773912	196774140	0	229	87	7152	87	6923	0.0	0.012566806297847753
chr2	GTF3C3	196799239	196799254	0	16	87	7152	87	7136	0.0	0.01219170403587444
chr2	PGAP1	196842720	196842825	0	106	179	7923	179	7817	0.0	0.02289881028527568
chr2	PGAP1	196864986	196865080	0	95	179	7923	179	7828	0.0	0.022866632600919774
chr2	PGAP1	196892345	196892401	0	57	179	7923	179	7866	0.0	0.02275616577676074
chr2	PGAP1	196922102	196922186	0	85	179	7923	179	7838	0.0	0.022837458535340648
chr2	ANKRD44	197086679	197086748	0	70	14705	12858	14705	12788	0.0	1.1499061620269002
chr2	ANKRD44	197147026	197147105	0	80	14705	12858	14705	12778	0.0	1.150806072937862
chr2	SF3B1	197418895	197419640	0	746	306	10241	306	9495	0.0	0.03222748815165877
chr2	SF3B1	197418895	197418951	0	57	306	10241	306	10184	0.0	0.0300471327572663
chr2	HSPD1	197490196	197490296	0	101	0	6724	0	6623	0.0	0.0
chr2	HSPD1	197494656	197494752	0	97	0	6724	0	6627	0.0	0.0
chr2	HSPD1	197490526	197490664	0	139	0	6724	0	6585	0.0	0.0
chr2	HSPD1	197499166	197499438	0	273	0	6724	0	6451	0.0	0.0
chr2	HSPD1	197499141	197499438	0	298	0	6724	0	6426	0.0	0.0
chr2	HSPD1	197499258	197499438	0	181	0	6724	0	6543	0.0	0.0
chr2	HSPD1	197490937	197491042	0	106	0	6724	0	6618	0.0	0.0
chr2	HSPD1	197487287	197487379	0	93	0	6724	0	6631	0.0	0.0
chr2	HSPD1	197489729	197489853	0	125	0	6724	0	6599	0.0	0.0
chr2	HSPD1	197494662	197494752	0	91	0	6724	0	6633	0.0	0.0
chr2	RFTN2	197587991	197588021	0	31	4574	5787	4574	5756	0.0	0.7946490618485059
chr2	BOLL	197758941	197759007	0	67	3589	3989	3589	3922	0.0	0.9150943396226415
chr2	SATB2	199433337	199433514	0	178	0	10975	0	10797	0.0	0.0
chr2	FTCDNL1	199844379	199844532	0	154	153	2766	153	2612	0.0	0.05857580398162328
chr2	AC097717.1	199882440	199882596	0	157	455	6765	455	6608	0.0	0.06885593220338983
chr2	AC097717.1	199894582	199894663	29	82	455	6765	426	6683	0.35365853658536583	0.0637438276223253
chr2	AC097717.1	199908862	199908994	0	133	455	6765	455	6632	0.0	0.06860675512665862
chr2	AC097717.1	199884326	199884390	0	65	455	6765	455	6700	0.0	0.06791044776119402
chr2	AC097717.1	199879405	199879610	0	206	455	6765	455	6559	0.0	0.06937033084311633
chr2	AC097717.1	199880967	199881060	0	94	455	6765	455	6671	0.0	0.06820566631689402
chr2	AC097717.1	199881893	199881991	0	99	455	6765	455	6666	0.0	0.06825682568256826
chr2	AC097717.1	199879405	199879797	0	393	455	6765	455	6372	0.0	0.07140615191462649
chr2	AC097717.1	199880496	199880598	0	103	455	6765	455	6662	0.0	0.06829780846592615
chr2	AC097717.1	199896504	199896605	0	102	455	6765	455	6663	0.0	0.06828755815698634
chr2	AC097717.1	199908896	199908994	0	99	455	6765	455	6666	0.0	0.06825682568256826
chr2	TYW5	199936404	199936492	0	89	357	9858	357	9769	0.0	0.03654417033473232
chr2	TYW5	199948317	199948472	0	156	357	9858	357	9702	0.0	0.0367965367965368
chr2	TYW5	199948336	199948472	0	137	357	9858	357	9721	0.0	0.03672461680897027
chr2	AC012459.1	200449375	200449468	0	94	102	8989	102	8895	0.0	0.011467116357504217
chr2	LINC01792	200716334	200716417	0	84	6056	3235	6056	3151	0.0	1.9219295461758172
chr2	LINC01792	200727060	200727344	0	285	6056	3235	6056	2950	0.0	2.0528813559322034
chr2	LINC01792	200727060	200727340	0	281	6056	3235	6056	2954	0.0	2.050101557210562
chr2	CLK1	200855003	200855086	0	84	0	4804	0	4720	0.0	0.0
chr2	CLK1	200860124	200860215	0	92	0	4804	0	4712	0.0	0.0
chr2	CLK1	200861701	200861862	0	162	0	4804	0	4642	0.0	0.0
chr2	PPIL3	200882341	200882435	0	95	0	2472	0	2377	0.0	0.0
chr2	PPIL3	200887612	200887685	0	74	0	2472	0	2398	0.0	0.0
chr2	PPIL3	200885261	200885367	0	107	0	2472	0	2365	0.0	0.0
chr2	PPIL3	200882341	200882382	0	42	0	2472	0	2430	0.0	0.0
chr2	PPIL3	200885261	200885343	0	83	0	2472	0	2389	0.0	0.0
chr2	ORC2	200958029	200958133	0	105	0	5850	0	5745	0.0	0.0
chr2	FAM126B	201045495	201045593	0	99	204	12477	204	12378	0.0	0.016480853126514785
chr2	FAM126B	200987364	200987532	0	169	204	12477	204	12308	0.0	0.016574585635359115
chr2	FAM126B	201022058	201022114	0	57	204	12477	204	12420	0.0	0.01642512077294686
chr2	FAM126B	201052172	201052269	0	98	204	12477	204	12379	0.0	0.01647952177074077
chr2	CFLAR-AS1	201148733	201148871	0	139	51	4158	51	4019	0.0	0.012689723811893506
chr2	CFLAR-AS1	201149330	201149443	0	114	51	4158	51	4044	0.0	0.012611275964391691
chr2	CFLAR-AS1	201147742	201147864	0	123	51	4158	51	4035	0.0	0.012639405204460967
chr2	CFLAR-AS1	201149124	201149200	0	77	51	4158	51	4081	0.0	0.012496937025238911
chr2	CFLAR-AS1	201144135	201144302	0	168	51	4158	51	3990	0.0	0.012781954887218045
chr2	CFLAR-AS1	201150370	201150489	0	120	51	4158	51	4038	0.0	0.01263001485884101
chr2	CFLAR-AS1	201145639	201145690	0	52	51	4158	51	4106	0.0	0.012420847540185095
chr2	CFLAR-AS1	201143346	201143469	0	124	51	4158	51	4034	0.0	0.01264253842340109
chr2	CFLAR-AS1	201144135	201144295	0	161	51	4158	51	3997	0.0	0.012759569677257944
chr2	CFLAR-AS1	201145573	201145690	0	118	51	4158	51	4040	0.0	0.012623762376237625
chr2	FLACC1	201289456	201289566	0	111	9688	2497	9688	2386	0.0	4.06035205364627
chr2	FLACC1	201330735	201330833	0	99	9688	2497	9688	2398	0.0	4.040033361134278
chr2	FLACC1	201342369	201342431	9163	63	9688	2497	525	2434	145.44444444444446	0.21569433032046015
chr2	FLACC1	201344169	201344263	430	95	9688	2497	9258	2402	4.526315789473684	3.8542880932556205
chr2	C2CD6	201491168	201494759	4342	3592	27522	6836	23180	3244	1.2087973273942094	7.145499383477189
chr2	TMEM237	201627320	201627414	0	95	0	7126	0	7031	0.0	0.0
chr2	TMEM237	201640260	201640265	0	6	0	7126	0	7120	0.0	0.0
chr2	TMEM237	201634803	201634893	0	91	0	7126	0	7035	0.0	0.0
chr2	TMEM237	201634386	201634397	0	12	0	7126	0	7114	0.0	0.0
chr2	MPP4	201685918	201686050	1432	133	22423	4177	20991	4044	10.766917293233083	5.190652818991098
chr2	MPP4	201687290	201687371	12757	82	22423	4177	9666	4095	155.5731707317073	2.3604395604395605
chr2	MPP4	201660331	201660346	0	16	22423	4177	22423	4161	0.0	5.388848834414804
chr2	MPP4	201664080	201664101	0	22	22423	4177	22423	4155	0.0	5.396630565583634
chr2	MPP4	201664210	201664336	0	127	22423	4177	22423	4050	0.0	5.536543209876543
chr2	MPP4	201666596	201666721	0	126	22423	4177	22423	4051	0.0	5.5351764996297215
chr2	MPP4	201673528	201673556	0	29	22423	4177	22423	4148	0.0	5.405737704918033
chr2	ALS2	201727704	201727775	0	72	156840	10478	156840	10406	0.0	15.072073803574861
chr2	ALS2	201719985	201720128	0	144	156840	10478	156840	10334	0.0	15.177085349332302
chr2	ALS2	201778440	201778487	1097	48	156840	10478	155743	10430	22.854166666666668	14.932214765100671
chr2	ALS2	201779978	201780083	100	106	156840	10478	156740	10372	0.9433962264150944	15.111839568067875
chr2	SUMO1	202210734	202210806	0	73	0	2157	0	2084	0.0	0.0
chr2	SUMO1	202220031	202220106	0	76	0	2157	0	2081	0.0	0.0
chr2	SUMO1	202207867	202208002	0	136	0	2157	0	2021	0.0	0.0
chr2	SUMO1	202210734	202210783	0	50	0	2157	0	2107	0.0	0.0
chr2	SUMO1	202233577	202233670	0	94	0	2157	0	2063	0.0	0.0
chr2	SUMO1	202231542	202231732	0	191	0	2157	0	1966	0.0	0.0
chr2	ICA1L	202870529	202870656	0	128	274	10225	274	10097	0.0	0.027136773298999703
chr2	ICA1L	202786675	202786775	0	101	274	10225	274	10124	0.0	0.027064401422362702
chr2	ICA1L	202869535	202869605	0	71	274	10225	274	10154	0.0	0.02698443962970258
chr2	ICA1L	202860146	202860244	0	99	274	10225	274	10126	0.0	0.027059055895714005
chr2	RAPH1	203470238	203470313	0	76	561	11179	561	11103	0.0	0.05052688462577682
chr2	RAPH1	203477075	203477156	0	82	561	11179	561	11097	0.0	0.05055420383887537
chr2	AC009498.1	204230180	204230291	0	112	450	1074	450	962	0.0	0.4677754677754678
chr2	AC007362.1	205761427	205761502	0	76	0	1629	0	1553	0.0	0.0
chr2	AC007362.1	205760797	205760911	0	115	0	1629	0	1514	0.0	0.0
chr2	AC007362.1	205761427	205761463	0	37	0	1629	0	1592	0.0	0.0
chr2	AC007362.1	205762387	205762509	0	123	0	1629	0	1506	0.0	0.0
chr2	INO80D	206063568	206063684	0	117	0	14385	0	14268	0.0	0.0
chr2	NDUFS1	206149817	206149925	0	109	51	12182	51	12073	0.0	0.004224302161848753
chr2	NDUFS1	206152418	206152510	0	93	51	12182	51	12089	0.0	0.004218711225080652
chr2	NDUFS1	206153617	206153682	0	66	51	12182	51	12116	0.0	0.00420931000330142
chr2	NDUFS1	206149779	206149925	0	147	51	12182	51	12035	0.0	0.00423764021603656
chr2	GPR1	206217362	206217613	0	252	153	2840	153	2588	0.0	0.05911901081916538
chr2	GPR1	206203893	206203948	0	56	153	2840	153	2784	0.0	0.05495689655172414
chr2	DYTN	206698755	206698971	0	217	0	2806	0	2589	0.0	0.0
chr2	MDH1B	206760900	206761013	0	114	35	2903	35	2789	0.0	0.01254930082466834
chr2	KLF7	207148981	207149200	0	220	1798	9124	1798	8904	0.0	0.20193171608265947
chr2	AC009226.1	207417600	207417744	369	145	369	1292	0	1147	2.5448275862068965	0.0
chr2	METTL21A	207621805	207621917	0	113	507	4067	507	3954	0.0	0.1282245827010622
chr2	METTL21A	207620640	207620694	0	55	507	4067	507	4012	0.0	0.12637088733798604
chr2	PLEKHM3	207929896	207929940	0	45	435	11431	435	11386	0.0	0.03820481292815739
chr2	C2ORF80	208168381	208168495	0	115	0	1402	0	1287	0.0	0.0
chr2	C2ORF80	208170944	208171063	0	120	0	1402	0	1282	0.0	0.0
chr2	C2ORF80	208184950	208185032	0	83	0	1402	0	1319	0.0	0.0
chr2	C2ORF80	208171987	208172075	0	89	0	1402	0	1313	0.0	0.0
chr2	KANSL1L	210031420	210031546	51	127	5202	6250	5151	6123	0.4015748031496063	0.8412542871141597
chr2	KANSL1L	210026379	210026402	0	24	5202	6250	5202	6226	0.0	0.8355284291680052
chr2	MYL1	210302487	210302515	0	29	235	1335	235	1306	0.0	0.17993874425727413
chr2	LANCL1	210437689	210437872	0	184	0	5060	0	4876	0.0	0.0
chr2	ERBB4	211387944	211387992	0	49	153	13047	153	12998	0.0	0.011771041698722881
chr2	ERBB4	211657949	211657994	0	46	153	13047	153	13001	0.0	0.011768325513422044
chr2	IKZF2	213013790	213013934	0	145	0	12218	0	12073	0.0	0.0
chr2	IKZF2	213021992	213022130	0	139	0	12218	0	12079	0.0	0.0
chr2	IKZF2	213056910	213057099	0	190	0	12218	0	12028	0.0	0.0
chr2	IKZF2	213097876	213097960	0	85	0	12218	0	12133	0.0	0.0
chr2	IKZF2	213081169	213081238	0	70	0	12218	0	12148	0.0	0.0
chr2	IKZF2	213056565	213056744	0	180	0	12218	0	12038	0.0	0.0
chr2	BARD1	214780559	214781509	0	951	1632	7585	1632	6634	0.0	0.24600542659029243
chr2	BARD1	214792296	214792445	0	150	1632	7585	1632	7435	0.0	0.219502353732347
chr2	BARD1	214797060	214797117	0	58	1632	7585	1632	7527	0.0	0.21681944998007174
chr2	BARD1	214730234	214730280	0	47	1632	7585	1632	7538	0.0	0.21650305120721677
chr2	BARD1	214780967	214781509	0	543	1632	7585	1632	7042	0.0	0.23175234308435103
chr2	FN1	215372108	215372300	0	193	51	13933	51	13740	0.0	0.0037117903930131003
chr2	FN1	215372108	215372375	0	268	51	13933	51	13665	0.0	0.0037321624588364435
chr2	FN1	215380810	215381080	0	271	51	13933	51	13662	0.0	0.003732981993851559
chr2	FN1	215392930	215393203	0	274	51	13933	51	13659	0.0	0.0037338018888644848
chr2	LINC00607	215622685	215622761	0	77	1963	6966	1963	6889	0.0	0.28494701698359703
chr2	LINC00607	215740876	215741021	0	146	1963	6966	1963	6820	0.0	0.2878299120234604
chr2	LINC00607	215641230	215641819	1479	590	1963	6966	484	6376	2.506779661016949	0.07590966122961104
chr2	LINC00607	215797359	215797591	0	233	1963	6966	1963	6733	0.0	0.291549086588445
chr2	LINC00607	215750242	215750417	0	176	1963	6966	1963	6790	0.0	0.2891016200294551
chr2	LINC00607	215701047	215701219	38	173	1963	6966	1925	6793	0.21965317919075145	0.2833799499484764
chr2	PECR	216058894	216058976	0	83	0	3209	0	3126	0.0	0.0
chr2	DIRC3	217599611	217600829	0	1219	2397	8277	2397	7058	0.0	0.3396146217058657
chr2	TNS1	217829843	217829882	0	40	0	16327	0	16287	0.0	0.0
chr2	TNS1	217830366	217830390	0	25	0	16327	0	16302	0.0	0.0
chr2	TNS1	217901709	217901823	0	115	0	16327	0	16212	0.0	0.0
chr2	TMBIM1	218278514	218278565	0	52	0	5110	0	5058	0.0	0.0
chr2	TMBIM1	218279288	218279353	0	66	0	5110	0	5044	0.0	0.0
chr2	TMBIM1	218281939	218282181	0	243	0	5110	0	4867	0.0	0.0
chr2	TMBIM1	218285762	218285938	0	177	0	5110	0	4933	0.0	0.0
chr2	TMBIM1	218284038	218284136	0	99	0	5110	0	5011	0.0	0.0
chr2	TMBIM1	218285762	218285934	0	173	0	5110	0	4937	0.0	0.0
chr2	TMBIM1	218284038	218284160	0	123	0	5110	0	4987	0.0	0.0
chr2	TMBIM1	218284038	218284266	0	229	0	5110	0	4881	0.0	0.0
chr2	USP37	218479649	218479715	0	67	102	9311	102	9244	0.0	0.011034184335785374
chr2	USP37	218534608	218534706	0	99	102	9311	102	9212	0.0	0.01107251411202779
chr2	USP37	218558497	218558677	0	181	102	9311	102	9130	0.0	0.01117196056955093
chr2	USP37	218558497	218558717	0	221	102	9311	102	9090	0.0	0.011221122112211221
chr2	ZNF142	218651700	218652300	0	601	0	11333	0	10732	0.0	0.0
chr2	ZNF142	218658700	218658876	0	177	0	11333	0	11156	0.0	0.0
chr2	ZNF142	218651700	218651822	0	123	0	11333	0	11210	0.0	0.0
chr2	ZNF142	218658700	218658801	0	102	0	11333	0	11231	0.0	0.0
chr2	PRKAG3	218827832	218827878	0	47	137	3347	137	3300	0.0	0.04151515151515151
chr2	CFAP65	219031488	219031658	0	171	315	10236	315	10065	0.0	0.03129657228017884
chr2	CFAP65	219038895	219039050	8	156	315	10236	307	10080	0.05128205128205128	0.030456349206349206
chr2	CFAP65	219038895	219038944	0	50	315	10236	315	10186	0.0	0.03092479874337326
chr2	CFAP65	219038895	219038942	0	48	315	10236	315	10188	0.0	0.030918727915194347
chr2	NHEJ1	219095273	219095355	0	83	24010	3122	24010	3039	0.0	7.900625205659757
chr2	SLC23A3	219169308	219169406	0	99	64	3310	64	3211	0.0	0.019931485518530054
chr2	SLC23A3	219165168	219165422	51	255	64	3310	13	3055	0.2	0.00425531914893617
chr2	SLC23A3	219168651	219168833	0	183	64	3310	64	3127	0.0	0.020466901183242726
chr2	SLC23A3	219168647	219168833	0	187	64	3310	64	3123	0.0	0.020493115593980146
chr2	ABCB6	219210933	219211108	20215	176	54392	4486	34177	4310	114.85795454545455	7.929698375870069
chr2	ABCB6	219215996	219216180	0	185	54392	4486	54392	4301	0.0	12.646361311322948
chr2	ABCB6	219216651	219216832	0	182	54392	4486	54392	4304	0.0	12.637546468401487
chr2	ABCB6	219217669	219217807	0	139	54392	4486	54392	4347	0.0	12.5125373821026
chr2	ATG9A	219222049	219222167	0	119	0	4730	0	4611	0.0	0.0
chr2	ATG9A	219227921	219228053	0	133	0	4730	0	4597	0.0	0.0
chr2	ATG9A	219228433	219228485	0	53	0	4730	0	4677	0.0	0.0
chr2	ATG9A	219229009	219229174	0	166	0	4730	0	4564	0.0	0.0
chr2	ATG9A	219228433	219228482	0	50	0	4730	0	4680	0.0	0.0
chr2	ATG9A	219227921	219228079	0	159	0	4730	0	4571	0.0	0.0
chr2	ATG9A	219228423	219228485	0	63	0	4730	0	4667	0.0	0.0
chr2	GLB1L	219239919	219240094	0	176	36	3358	36	3182	0.0	0.011313639220615965
chr2	GLB1L	219243778	219243942	0	165	36	3358	36	3193	0.0	0.011274663326025681
chr2	TUBA4A	219252007	219252230	0	224	204	3973	204	3749	0.0	0.05441451053614297
chr2	PTPRN	219290537	219290611	0	75	306	6977	306	6902	0.0	0.04433497536945813
chr2	PTPRN	219299699	219299786	0	88	306	6977	306	6889	0.0	0.044418638409057916
chr2	PTPRN	219308881	219308977	0	97	306	6977	306	6880	0.0	0.04447674418604651
chr2	RESP18	219328923	219329008	0	86	4290	1150	4290	1064	0.0	4.0319548872180455
chr2	RESP18	219329362	219329404	0	43	4290	1150	4290	1107	0.0	3.875338753387534
chr2	DNPEP	219385423	219385531	427	109	2483	5992	2056	5883	3.9174311926605503	0.34948155702872685
chr2	DNPEP	219385630	219385706	0	77	2483	5992	2483	5915	0.0	0.4197802197802198
chr2	DNPEP	219399439	219399500	0	62	2483	5992	2483	5930	0.0	0.4187183811129848
chr2	OBSL1	219557342	219557618	4914	277	208638	9151	203724	8874	17.740072202166065	22.95740365111562
chr2	OBSL1	219558183	219558459	923	277	208638	9151	207715	8874	3.332129963898917	23.407144466982196
chr2	EPHA4	221429957	221430151	0	195	0	7576	0	7381	0.0	0.0
chr2	EPHA4	221568717	221568785	0	69	0	7576	0	7507	0.0	0.0
chr2	PAX3	222201943	222202190	0	248	1748	7543	1748	7295	0.0	0.23961617546264566
chr2	SCG2	223602141	223602217	0	77	0	2579	0	2502	0.0	0.0
chr2	AP1S3	223775900	223776009	0	110	5355	5957	5355	5847	0.0	0.9158542842483325
chr2	AP1S3	223773312	223773351	0	40	5355	5957	5355	5917	0.0	0.9050194355247592
chr2	AP1S3	223776048	223776158	1173	111	5355	5957	4182	5846	10.567567567567568	0.715360930550804
chr2	AP1S3	223770196	223770325	0	130	5355	5957	5355	5827	0.0	0.9189977690063498
chr2	SERPINE2	224010342	224010386	0	45	51	6288	51	6243	0.0	0.008169149447381067
chr2	FAM124B	224400380	224400505	0	126	2799	3566	2799	3440	0.0	0.8136627906976744
chr2	CUL3	224481891	224482078	0	188	10453	10494	10453	10306	0.0	1.0142635358043859
chr2	CUL3	224557658	224557856	0	199	10453	10494	10453	10295	0.0	1.01534725594949
chr2	CUL3	224478199	224478345	0	147	10453	10494	10453	10347	0.0	1.0102445153184498
chr2	CUL3	224556294	224556420	0	127	10453	10494	10453	10367	0.0	1.0082955531976463
chr2	CUL3	224556294	224556389	0	96	10453	10494	10453	10398	0.0	1.0052894787459126
chr2	DOCK10	224768871	224768947	0	77	357226	11350	357226	11273	0.0	31.68863656524439
chr2	DOCK10	224784736	224784742	0	7	357226	11350	357226	11343	0.0	31.493079432248965
chr2	MFF-DT	227268352	227268443	0	92	102	11480	102	11388	0.0	0.008956796628029505
chr2	MFF-DT	227281703	227281789	0	87	102	11480	102	11393	0.0	0.008952865794786272
chr2	MFF-DT	227305459	227305655	0	197	102	11480	102	11283	0.0	0.00904014889657006
chr2	MFF-DT	227268627	227268769	0	143	102	11480	102	11337	0.0	0.00899708917703096
chr2	MFF-DT	227279482	227279578	0	97	102	11480	102	11383	0.0	0.008960730914521655
chr2	MFF-DT	227301792	227301974	0	183	102	11480	102	11297	0.0	0.009028945737806496
chr2	MFF-DT	227251115	227251239	0	125	102	11480	102	11355	0.0	0.008982826948480845
chr2	SLC19A3	227698735	227699564	3589	830	32721	5687	29132	4857	4.324096385542169	5.997941115915174
chr2	SLC19A3	227702168	227702320	1680	153	32721	5687	31041	5534	10.980392156862745	5.609143476689556
chr2	SLC19A3	227700912	227701108	1388	197	32721	5687	31333	5490	7.0456852791878175	5.707285974499089
chr2	SLC19A3	227702591	227702691	517	101	32721	5687	32204	5586	5.118811881188119	5.7651271034729685
chr2	SLC19A3	227698735	227698846	672	112	32721	5687	32049	5575	6.0	5.748699551569507
chr2	SLC19A3	227706552	227706743	0	192	32721	5687	32721	5495	0.0	5.954686078252958
chr2	SLC19A3	227702168	227702691	6837	524	32721	5687	25884	5163	13.047709923664122	5.013364323067984
chr2	SPHKAP	227993533	227993620	0	88	0	7058	0	6970	0.0	0.0
chr2	PID1	229155817	229155964	0	148	0	3375	0	3227	0.0	0.0
chr2	PID1	229262682	229262893	0	212	0	3375	0	3163	0.0	0.0
chr2	PID1	229227956	229228063	0	108	0	3375	0	3267	0.0	0.0
chr2	TRIP12	229771518	229771632	0	115	23	12692	23	12577	0.0	0.0018287349924465293
chr2	TRIP12	229860405	229860531	0	127	23	12692	23	12565	0.0	0.0018304814962196577
chr2	TRIP12	229908964	229909086	0	123	23	12692	23	12569	0.0	0.0018298989577532024
chr2	TRIP12	229900736	229900858	0	123	23	12692	23	12569	0.0	0.0018298989577532024
chr2	SLC16A14	230067098	230067237	0	140	147	4940	147	4800	0.0	0.030625
chr2	SP110	230171695	230171767	0	73	51	8874	51	8801	0.0	0.005794796045903875
chr2	SP110	230216780	230216928	0	149	51	8874	51	8725	0.0	0.005845272206303725
chr2	SP110	230170620	230170761	0	142	51	8874	51	8732	0.0	0.005840586349060925
chr2	SP110	230219555	230219673	0	119	51	8874	51	8755	0.0	0.005825242718446602
chr2	SP110	230216780	230216821	0	42	51	8874	51	8832	0.0	0.00577445652173913
chr2	AC010149.1	230570639	230570715	0	77	195	700	195	623	0.0	0.3130016051364366
chr2	SPATA3-AS1	230992333	230992402	0	70	10	3752	10	3682	0.0	0.0027159152634437804
chr2	SPATA3-AS1	230991768	230991975	0	208	10	3752	10	3544	0.0	0.0028216704288939053
chr2	SPATA3-AS1	230989660	230989832	0	173	10	3752	10	3579	0.0	0.002794076557697681
chr2	SPATA3-AS1	230991768	230992036	0	269	10	3752	10	3483	0.0	0.002871088142405972
chr2	SPATA3-AS1	230991768	230992039	0	272	10	3752	10	3480	0.0	0.0028735632183908046
chr2	NCL	231455827	231455904	0	78	147	6296	147	6218	0.0	0.023641042135734962
chr2	NCL	231456009	231456136	0	128	147	6296	147	6168	0.0	0.023832684824902722
chr2	NCL	231457285	231457357	0	73	147	6296	147	6223	0.0	0.023622047244094488
chr2	PDE6D	231737186	231737292	987	107	3759	2832	2772	2725	9.22429906542056	1.0172477064220184
chr2	ECEL1	232481090	232481156	0	67	138	2995	138	2928	0.0	0.0471311475409836
chr2	AC073254.1	232581983	232582141	0	159	1035	3540	1035	3381	0.0	0.30612244897959184
chr2	AC073254.1	232610731	232610872	0	142	1035	3540	1035	3398	0.0	0.3045909358446145
chr2	AC073254.1	232611474	232611654	552	181	1035	3540	483	3359	3.0497237569060776	0.1437927954748437
chr2	USP40	233488238	233488304	0	67	991	8632	991	8565	0.0	0.11570344424985406
chr2	USP40	233491031	233491071	0	41	991	8632	991	8591	0.0	0.1153532766849028
chr2	HJURP	233844204	233844283	0	80	0	3831	0	3751	0.0	0.0
chr2	HJURP	233845727	233845820	0	94	0	3831	0	3737	0.0	0.0
chr2	HJURP	233847396	233847461	0	66	0	3831	0	3765	0.0	0.0
chr2	HJURP	233849762	233849859	0	98	0	3831	0	3733	0.0	0.0
chr2	AC010148.1	234857334	234857419	0	86	51	4307	51	4221	0.0	0.012082444918265814
chr2	GBX2	236167137	236167174	0	38	0	2335	0	2297	0.0	0.0
chr2	ASB18	236241279	236241402	0	124	0	5562	0	5438	0.0	0.0
chr2	IQCA1	236419148	236419271	0	124	1665	5992	1665	5868	0.0	0.2837423312883436
chr2	IQCA1	236343701	236343763	0	63	1665	5992	1665	5929	0.0	0.28082307303086523
chr2	AC012063.1	236979929	236980067	0	139	3813	13105	3813	12966	0.0	0.2940768162887552
chr2	AC012063.1	236959770	236959840	0	71	3813	13105	3813	13034	0.0	0.2925425809421513
chr2	COL6A3	237378635	237379235	0	601	10787	19510	10787	18909	0.0	0.5704690887936962
chr2	COL6A3	237387581	237388184	0	604	10787	19510	10787	18906	0.0	0.5705596107055961
chr2	COL6A3	237394586	237395204	0	619	10787	19510	10787	18891	0.0	0.5710126515271823
chr2	RAB17	237578003	237578155	102	153	102	4078	0	3925	0.6666666666666666	0.0
chr2	RAB17	237585997	237586157	0	161	102	4078	102	3917	0.0	0.026040336992596374
chr2	RAB17	237586041	237586157	0	117	102	4078	102	3961	0.0	0.02575107296137339
chr2	RAB17	237586063	237586157	0	95	102	4078	102	3983	0.0	0.025608837559628422
chr2	ILKAP	238185180	238185287	0	108	2832	4683	2832	4575	0.0	0.6190163934426229
chr2	LINC02610	238229315	238229668	0	354	0	3731	0	3377	0.0	0.0
chr2	HES6	238239660	238239747	0	88	0	1138	0	1050	0.0	0.0
chr2	PER2	238262951	238263058	0	108	2701	6896	2701	6788	0.0	0.39790807307012377
chr2	NDUFA10	240005209	240005295	0	87	53071	18589	53071	18502	0.0	2.8683926062047345
chr2	NDUFA10	240011616	240014860	9820	3245	53071	18589	43251	15344	3.026194144838213	2.8187565172054225
chr2	NDUFA10	240022171	240022340	66	170	53071	18589	53005	18419	0.38823529411764707	2.877734947608448
chr2	NDUFA10	239990073	239990182	0	110	53071	18589	53071	18479	0.0	2.8719627685480815
chr2	NDUFA10	239961022	239961186	0	165	53071	18589	53071	18424	0.0	2.880536257056014
chr2	NDUFA10	240021770	240021860	0	91	53071	18589	53071	18498	0.0	2.8690128662558116
chr2	NDUFA10	240017814	240017905	46	92	53071	18589	53025	18497	0.5	2.866681083418933
chr2	NDUFA10	240000182	240000387	0	206	53071	18589	53071	18383	0.0	2.88696077898058
chr2	NDUFA10	239960954	239961186	0	233	53071	18589	53071	18356	0.0	2.8912072346916537
chr2	NDUFA10	239982114	239982219	0	106	53071	18589	53071	18483	0.0	2.8713412324839043
chr2	NDUFA10	240012486	240012534	0	49	53071	18589	53071	18540	0.0	2.8625134843581446
chr2	NDUFA10	239987515	239987578	0	64	53071	18589	53071	18525	0.0	2.8648313090418354
chr2	NDUFA10	239964182	239964261	0	80	53071	18589	53071	18509	0.0	2.8673077962072506
chr2	ANKMY1	240482182	240482261	0	80	0	7366	0	7286	0.0	0.0
chr2	ANKMY1	240557189	240557352	0	164	0	7366	0	7202	0.0	0.0
chr2	ANKMY1	240509347	240509455	0	109	0	7366	0	7257	0.0	0.0
chr2	ANKMY1	240511860	240512001	0	142	0	7366	0	7224	0.0	0.0
chr2	ANKMY1	240526228	240526445	0	218	0	7366	0	7148	0.0	0.0
chr2	ANKMY1	240529036	240529509	0	474	0	7366	0	6892	0.0	0.0
chr2	ANKMY1	240507559	240507691	0	133	0	7366	0	7233	0.0	0.0
chr2	ANKMY1	240558303	240558619	0	317	0	7366	0	7049	0.0	0.0
chr2	AQP12B	240677598	240679781	0	2184	0	1584	0	-600	0.0	-0.0
chr2	KIF1A	240757318	240757594	0	277	1290	16333	1290	16056	0.0	0.08034379671150972
chr2	KIF1A	240772569	240772596	0	28	1290	16333	1290	16305	0.0	0.07911683532658693
chr2	KIF1A	240728388	240728412	0	25	1290	16333	1290	16308	0.0	0.07910228108903605
chr2	KIF1A	240734718	240734745	0	28	1290	16333	1290	16305	0.0	0.07911683532658693
chr2	KIF1A	240739555	240739669	0	115	1290	16333	1290	16218	0.0	0.07954125046244913
chr2	KIF1A	240720224	240720389	0	166	1290	16333	1290	16167	0.0	0.07979216923362405
chr2	KIF1A	240744256	240744334	0	79	1290	16333	1290	16254	0.0	0.07936507936507936
chr2	KIF1A	240775041	240775167	0	127	1290	16333	1290	16206	0.0	0.07960014809329878
chr2	KIF1A	240788379	240788508	0	130	1290	16333	1290	16203	0.0	0.07961488613219773
chr2	KIF1A	240796959	240797047	0	89	1290	16333	1290	16244	0.0	0.0794139374538291
chr2	MTERF4	241094276	241094432	0	157	95811	9722	95811	9565	0.0	10.016832200731836
chr2	MTERF4	241095129	241096438	0	1310	95811	9722	95811	8412	0.0	11.389800285306706
chr2	MTERF4	241099395	241099894	0	500	95811	9722	95811	9222	0.0	10.38939492517892
chr2	MTERF4	241097242	241097427	0	186	95811	9722	95811	9536	0.0	10.047294463087248
chr2	MTERF4	241090277	241090449	0	173	95811	9722	95811	9549	0.0	10.033616085453975
chr2	MTERF4	241096392	241096438	0	47	95811	9722	95811	9675	0.0	9.90294573643411
chr2	MTERF4	241101163	241101221	0	59	95811	9722	95811	9663	0.0	9.915243713132568
chr2	PASK	241142836	241143074	0	239	51	10561	51	10322	0.0	0.004940902925789576
chr2	PASK	241145749	241145860	0	112	51	10561	51	10449	0.0	0.004880849842090152
chr2	HDLBP	241255373	241255580	0	208	6	11245	6	11037	0.0	0.0005436259853220984
chr2	HDLBP	241267577	241267708	0	132	6	11245	6	11113	0.0	0.0005399082156033474
chr2	HDLBP	241255373	241255511	0	139	6	11245	6	11106	0.0	0.0005402485143165856
chr2	HDLBP	241268953	241269105	0	153	6	11245	6	11092	0.0	0.0005409304002884963
chr2	HDLBP	241268953	241269295	0	343	6	11245	6	10902	0.0	0.000550357732526142
chr2	HDLBP	241268828	241268953	0	126	6	11245	6	11119	0.0	0.0005396168720208652
chr2	HDLBP	241269200	241269295	0	96	6	11245	6	11149	0.0	0.0005381648578347834
chr2	HDLBP	241266536	241266627	0	92	6	11245	6	11153	0.0	0.0005379718461400521
chr2	HDLBP	241267591	241267708	0	118	6	11245	6	11127	0.0	0.0005392289026691831
chr2	HDLBP	241268957	241269295	0	339	6	11245	6	10906	0.0	0.0005501558774986246
chr2	HDLBP	241268828	241269295	0	468	6	11245	6	10777	0.0	0.0005567412081284216
chr2	STK25	241498234	241498349	0	116	35268	5262	35268	5146	0.0	6.853478429848426
chr2	STK25	241501477	241501708	2220	232	35268	5262	33048	5030	9.568965517241379	6.5701789264413515
chr2	STK25	241508005	241508135	2133	131	35268	5262	33135	5131	16.282442748091604	6.457805496004678
chr2	STK25	241500739	241500796	1305	58	35268	5262	33963	5204	22.5	6.526325903151422
chr2	STK25	241501477	241501799	3112	323	35268	5262	32156	4939	9.634674922600619	6.510629682121887
chr2	STK25	241504037	241504096	0	60	35268	5262	35268	5202	0.0	6.779700115340254
chr2	DTYMK	241680228	241680319	0	92	102	2407	102	2315	0.0	0.044060475161987044
chr2	DTYMK	241684715	241684749	0	35	102	2407	102	2372	0.0	0.04300168634064081
chr2	DTYMK	241681918	241682333	0	416	102	2407	102	1991	0.0	0.051230537418382724
chr2	DTYMK	241682798	241682915	0	118	102	2407	102	2289	0.0	0.04456094364351245
chr2	PDCD1	241852197	241852353	0	157	0	2102	0	1945	0.0	0.0
chr2	LINC01880	242059119	242059193	51	75	11227	1573	11176	1498	0.68	7.460614152202937
chr2	AC079779.1	199743	199901	0	159	0	4340	0	4181	0.0	0.0
chr2	AC079779.1	202915	202988	0	74	0	4340	0	4266	0.0	0.0
chr2	ACP1	269300	269347	0	48	567456	3562	567456	3514	0.0	161.4843483210017
chr2	ACP1	275139	275201	29027	63	567456	3562	538429	3499	460.74603174603175	153.88082309231208
chr2	ACP1	272036	272065	6330	30	567456	3562	561126	3532	211.0	158.8691959229898
chr2	AC093326.1	558733	558990	0	258	0	2562	0	2304	0.0	0.0
chr2	SNTG2	1237887	1238017	0	131	0	4516	0	4385	0.0	0.0
chr2	SNTG2	1103404	1103442	0	39	0	4516	0	4477	0.0	0.0
chr2	TPO	1503947	1504079	0	133	41	6780	41	6647	0.0	0.006168196178727246
chr2	TPO	1477085	1477604	0	520	41	6780	41	6260	0.0	0.006549520766773163
chr2	TPO	1487820	1487991	0	172	41	6780	41	6608	0.0	0.006204600484261501
chr2	TPO	1540593	1540723	0	131	41	6780	41	6649	0.0	0.00616634080312829
chr2	TRAPPC12	3477694	3477795	1745	102	33941	8700	32196	8598	17.107843137254903	3.7445917655268666
chr2	TRAPPC12	3421699	3421786	0	88	33941	8700	33941	8612	0.0	3.9411286576869484
chr2	TRAPPC12	3457149	3457229	400	81	33941	8700	33541	8619	4.938271604938271	3.891518737672584
chr2	TRAPPC12	3477691	3477795	1979	105	33941	8700	31962	8595	18.847619047619048	3.718673647469459
chr2	TRAPPC12	3462857	3463071	204	215	33941	8700	33737	8485	0.9488372093023256	3.976075427224514
chr2	RNASEH1-AS1	3559447	3559729	0	283	0	4380	0	4097	0.0	0.0
chr2	RNASEH1-AS1	3559403	3559729	0	327	0	4380	0	4053	0.0	0.0
chr2	COLEC11	3613310	3613382	0	73	66829	2791	66829	2718	0.0	24.58756438557763
chr2	COLEC11	3637532	3637604	0	73	66829	2791	66829	2718	0.0	24.58756438557763
chr2	COLEC11	3626013	3626092	1343	80	66829	2791	65486	2711	16.7875	24.15566211729989
chr2	COLEC11	3641239	3641432	153	194	66829	2791	66676	2597	0.788659793814433	25.674239507123605
chr2	AC010729.1	5728086	5728152	0	67	0	2024	0	1957	0.0	0.0
chr2	SILC1	5969329	5969486	0	158	153	19776	153	19618	0.0	0.00779896013864818
chr2	SILC1	5982297	5982857	0	561	153	19776	153	19215	0.0	0.007962529274004685
chr2	SILC1	5982772	5982857	0	86	153	19776	153	19690	0.0	0.0077704418486541395
chr2	SILC1	5942600	5942768	0	169	153	19776	153	19607	0.0	0.007803335543428367
chr2	AC013460.1	7421684	7421843	0	160	0	5222	0	5062	0.0	0.0
chr2	AC013460.1	7422572	7424012	0	1441	0	5222	0	3781	0.0	0.0
chr2	AC013460.1	7426850	7427019	0	170	0	5222	0	5052	0.0	0.0
chr2	AC013460.1	7436004	7436097	0	94	0	5222	0	5128	0.0	0.0
chr2	AC013460.1	7428542	7429872	0	1331	0	5222	0	3891	0.0	0.0
chr2	AC013460.1	7430179	7430293	0	115	0	5222	0	5107	0.0	0.0
chr2	AC013460.1	7422572	7423035	0	464	0	5222	0	4758	0.0	0.0
chr2	AC013460.1	7429695	7429872	0	178	0	5222	0	5044	0.0	0.0
chr2	AC013460.1	7428542	7429273	0	732	0	5222	0	4490	0.0	0.0
chr2	AC013460.1	7428542	7428894	0	353	0	5222	0	4869	0.0	0.0
chr2	AC013460.1	7449752	7449780	0	29	0	5222	0	5193	0.0	0.0
chr2	U91324.1	8141784	8141883	0	100	0	1720	0	1620	0.0	0.0
chr2	ASAP2	9391061	9391196	0	136	2427	7286	2427	7150	0.0	0.33944055944055945
chr2	ASAP2	9336035	9336044	0	10	2427	7286	2427	7276	0.0	0.3335623969213854
chr2	IAH1	9475986	9476039	0	54	62001	5393	62001	5339	0.0	11.612848848098896
chr2	AC080162.1	9506786	9507015	51	230	575	572	524	342	0.2217391304347826	1.5321637426900585
chr2	AC082651.1	9639051	9639254	718	204	8046	2967	7328	2763	3.519607843137255	2.65218964893232
chr2	AC082651.1	9648851	9649003	1767	153	8046	2967	6279	2814	11.549019607843137	2.2313432835820897
chr2	TAF1B	9875864	9876018	0	155	0	3995	0	3840	0.0	0.0
chr2	TAF1B	9846056	9846186	0	131	0	3995	0	3864	0.0	0.0
chr2	GRHL1	9962454	9962531	0	78	582	4949	582	4871	0.0	0.11948265243276535
chr2	GRHL1	9952906	9953060	51	155	582	4949	531	4794	0.32903225806451614	0.11076345431789737
chr2	HPCAL1	10406264	10406361	0	98	443	4816	443	4718	0.0	0.09389571852479864
chr2	HPCAL1	10408561	10408734	0	174	443	4816	443	4642	0.0	0.0954330030159414
chr2	HPCAL1	10424524	10424613	0	90	443	4816	443	4726	0.0	0.09373677528565383
chr2	ODC1-DT	10455245	10455268	0	24	1020	3663	1020	3639	0.0	0.2802967848309975
chr2	ATP6V1C2	10777584	10777722	0	139	19513	3434	19513	3295	0.0	5.9220030349013655
chr2	ATP6V1C2	10757426	10757456	160	31	19513	3434	19353	3403	5.161290322580645	5.687040846312078
chr2	SLC66A3	11172750	11172824	0	75	0	2280	0	2205	0.0	0.0
chr2	SLC66A3	11171924	11172045	0	122	0	2280	0	2158	0.0	0.0
chr2	SLC66A3	11174967	11175009	0	43	0	2280	0	2237	0.0	0.0
chr2	LINC00570	11400371	11400457	0	87	497	2182	497	2095	0.0	0.23723150357995226
chr2	LINC00570	11399671	11399774	322	104	497	2182	175	2078	3.0961538461538463	0.08421559191530317
chr2	LPIN1	11776085	11776193	0	109	204	11894	204	11785	0.0	0.017310140008485363
chr2	LPIN1	11763022	11763286	0	265	204	11894	204	11629	0.0	0.017542351019004213
chr2	LPIN1	11764203	11764289	0	87	204	11894	204	11807	0.0	0.01727788599983061
chr2	LPIN1	11791707	11791785	0	79	204	11894	204	11815	0.0	0.017266187050359712
chr2	MIR3681HG	12106455	12106684	0	230	102	8436	102	8206	0.0	0.012429929320009749
chr2	MIR3681HG	12416088	12416286	0	199	102	8436	102	8237	0.0	0.012383149204807575
chr2	MIR3681HG	12340217	12340301	0	85	102	8436	102	8351	0.0	0.012214106095078434
chr2	MIR3681HG	12397521	12398370	0	850	102	8436	102	7586	0.0	0.013445821249670446
chr2	AC011897.1	14628602	14628684	0	83	0	349	0	266	0.0	0.0
chr2	LRATD1	14633585	14633828	0	244	37	7141	37	6897	0.0	0.0053646512976656515
chr2	DDX1	15613223	15613284	0	62	1760	8850	1760	8788	0.0	0.2002730996813837
chr2	DDX1	15621064	15621116	0	53	1760	8850	1760	8797	0.0	0.2000682050699102
chr2	DDX1	15628444	15628839	0	396	1760	8850	1760	8454	0.0	0.2081854743316773
chr2	LINC01804	15708345	15708446	0	102	505	2232	505	2130	0.0	0.23708920187793428
chr2	MYCN	15941947	15942854	0	908	0	2619	0	1711	0.0	0.0
chr2	GACAT3	16034145	16034305	0	161	0	3700	0	3539	0.0	0.0
chr2	GACAT3	16074166	16074373	0	208	0	3700	0	3492	0.0	0.0
chr2	GACAT3	16074021	16074373	0	353	0	3700	0	3347	0.0	0.0
chr2	AC010745.2	16278526	16278609	0	84	0	5384	0	5300	0.0	0.0
chr2	AC010880.1	16431730	16431807	0	78	0	482	0	404	0.0	0.0
chr2	AC104623.1	16524854	16525037	0	184	0	1466	0	1282	0.0	0.0
chr2	AC104623.1	16524692	16525037	0	346	0	1466	0	1120	0.0	0.0
chr2	AC008164.1	16765011	16765125	0	115	0	2725	0	2610	0.0	0.0
chr2	VSNL1	17546002	17546023	0	22	6171	3799	6171	3777	0.0	1.6338363780778395
chr2	LINC01808	19479223	19479284	0	62	0	3067	0	3005	0.0	0.0
chr2	LINC01808	19479096	19479284	0	189	0	3067	0	2878	0.0	0.0
chr2	LINC01808	19487311	19487515	0	205	0	3067	0	2862	0.0	0.0
chr2	LINC01808	19479096	19479142	0	47	0	3067	0	3020	0.0	0.0
chr2	LINC00954	19870424	19870546	0	123	0	6418	0	6295	0.0	0.0
chr2	LINC00954	19870401	19870546	0	146	0	6418	0	6272	0.0	0.0
chr2	LINC00954	19869074	19869156	0	83	0	6418	0	6335	0.0	0.0
chr2	AC018742.1	21258769	21258899	0	131	0	1026	0	895	0.0	0.0
chr2	AC011752.1	21356576	21356847	0	272	0	3336	0	3064	0.0	0.0
chr2	AC011752.1	21396254	21396364	0	111	0	3336	0	3225	0.0	0.0
chr2	LINC01884	22518300	22518391	0	92	0	1354	0	1262	0.0	0.0
chr2	LINC01884	22539739	22539803	0	65	0	1354	0	1289	0.0	0.0
chr2	LINC01884	22543431	22543555	0	125	0	1354	0	1229	0.0	0.0
chr2	UBXN2A	23939539	23939662	66	124	1368	6848	1302	6724	0.532258064516129	0.19363474122546104
chr2	MFSD2B	24017285	24017364	0	80	2583	4542	2583	4462	0.0	0.5788883908561183
chr2	MFSD2B	24020001	24020085	0	85	2583	4542	2583	4457	0.0	0.5795378056989006
chr2	FKBP1B	24054103	24054192	0	90	1785	1249	1785	1159	0.0	1.5401207937877481
chr2	FKBP1B	24054472	24054540	204	69	1785	1249	1581	1180	2.9565217391304346	1.3398305084745763
chr2	FAM228B	24095140	24095229	0	90	1390	4946	1390	4856	0.0	0.28624382207578253
chr2	FAM228B	24161505	24161613	0	109	1390	4946	1390	4837	0.0	0.28736820343187924
chr2	FAM228B	24167626	24167683	0	58	1390	4946	1390	4888	0.0	0.2843698854337152
chr2	FAM228B	24137908	24138100	0	193	1390	4946	1390	4753	0.0	0.2924468756574795
chr2	FAM228B	24165372	24165500	0	129	1390	4946	1390	4817	0.0	0.2885613452356238
chr2	FAM228A	24179110	24179297	138	188	903	2289	765	2101	0.7340425531914894	0.3641123274631128
chr2	FAM228A	24179110	24179227	138	118	903	2289	765	2171	1.1694915254237288	0.3523721787194841
chr2	AC009228.1	24220772	24220962	46	191	8854	5047	8808	4856	0.24083769633507854	1.813838550247117
chr2	NCOA1	24584475	24584560	0	86	3621	8659	3621	8573	0.0	0.4223725650297446
chr2	NCOA1	24665748	24665915	0	168	3621	8659	3621	8491	0.0	0.4264515369214462
chr2	NCOA1	24554388	24554573	153	186	3621	8659	3468	8473	0.8225806451612904	0.4093001298241473
chr2	NCOA1	24768078	24768135	0	58	3621	8659	3621	8601	0.0	0.4209975584234391
chr2	CENPO	24793851	24793965	0	115	153	5526	153	5411	0.0	0.028275734614673812
chr2	DNAJC27-AS1	25004066	25004110	0	45	185163	5744	185163	5699	0.0	32.49043691875767
chr2	DNAJC27-AS1	25001414	25001545	0	132	185163	5744	185163	5612	0.0	32.99411974340698
chr2	DNAJC27-AS1	25027310	25027517	396	208	185163	5744	184767	5536	1.9038461538461537	33.37554190751445
chr2	DNAJC27-AS1	25003984	25004110	0	127	185163	5744	185163	5617	0.0	32.964749866476765
chr2	DNAJC27-AS1	25028548	25028640	0	93	185163	5744	185163	5651	0.0	32.7664130242435
chr2	EFR3B	25139058	25139190	598	133	171722	10668	171124	10535	4.496240601503759	16.243379212149975
chr2	RAB10	26109767	26109906	0	140	113	3661	113	3521	0.0	0.03209315535359273
chr2	GAREM2	26186188	26186358	0	171	1603	5694	1603	5523	0.0	0.2902408111533587
chr2	HADHB	26269952	26269997	0	46	744	3812	744	3766	0.0	0.1975570897503983
chr2	DRC1	26424270	26424454	1020	185	62173	2931	61153	2746	5.513513513513513	22.269847050254917
chr2	DRC1	26440377	26440517	53	141	62173	2931	62120	2790	0.375886524822695	22.265232974910393
chr2	FAM166C	26572115	26572151	0	37	1512	923	1512	886	0.0	1.7065462753950338
chr2	FAM166C	26578776	26578853	0	78	1512	923	1512	845	0.0	1.7893491124260354
chr2	SLC35F6	26775043	26775215	0	173	0	3908	0	3735	0.0	0.0
chr2	SLC35F6	26776371	26776482	0	112	0	3908	0	3796	0.0	0.0
chr2	SLC35F6	26774250	26774323	0	74	0	3908	0	3834	0.0	0.0
chr2	CENPA	26792755	26792833	0	79	0	1956	0	1877	0.0	0.0
chr2	CENPA	26792501	26792833	0	333	0	1956	0	1623	0.0	0.0
chr2	MAPRE3	27021370	27021530	867	161	83981	3639	83114	3478	5.385093167701863	23.897067280046002
chr2	TMEM214	27035593	27035728	0	136	0	4115	0	3979	0.0	0.0
chr2	TMEM214	27037789	27037892	0	104	0	4115	0	4011	0.0	0.0
chr2	TMEM214	27039740	27039837	0	98	0	4115	0	4017	0.0	0.0
chr2	TMEM214	27037814	27037892	0	79	0	4115	0	4036	0.0	0.0
chr2	AGBL5	27069047	27069094	0	48	204	5304	204	5256	0.0	0.03881278538812785
chr2	AGBL5	27052332	27052543	0	212	204	5304	204	5092	0.0	0.04006284367635507
chr2	KHK	27094476	27094611	0	136	663	3023	663	2887	0.0	0.2296501558711465
chr2	KHK	27094799	27094934	0	136	663	3023	663	2887	0.0	0.2296501558711465
chr2	ABHD1	27128440	27128601	0	162	0	4565	0	4403	0.0	0.0
chr2	ABHD1	27129315	27129361	0	47	0	4565	0	4518	0.0	0.0
chr2	CAD	27226130	27226319	0	190	723	8190	723	8000	0.0	0.090375
chr2	CAD	27240566	27240617	0	52	723	8190	723	8138	0.0	0.08884246743671664
chr2	DNAJC5G	27277753	27278015	10203	263	75926	2173	65723	1910	38.79467680608365	34.40994764397906
chr2	DNAJC5G	27277801	27278015	10203	215	75926	2173	65723	1958	47.455813953488374	33.56639427987743
chr2	TRIM54	27299529	27299655	0	127	2266	2338	2266	2211	0.0	1.0248756218905473
chr2	GTF3C2-AS1	27340265	27340373	72	109	9489	3294	9417	3185	0.6605504587155964	2.9566718995290424
chr2	SNX17	27372622	27372740	0	119	0	3482	0	3363	0.0	0.0
chr2	SNX17	27374688	27374758	0	71	0	3482	0	3411	0.0	0.0
chr2	SNX17	27371268	27371343	0	76	0	3482	0	3406	0.0	0.0
chr2	SNX17	27371268	27371468	0	201	0	3482	0	3281	0.0	0.0
chr2	SNX17	27373039	27373113	0	75	0	3482	0	3407	0.0	0.0
chr2	NRBP1	27435722	27435746	462	25	471599	5119	471137	5094	18.48	92.48861405575187
chr2	KRTCAP3	27442578	27442763	23	186	19078	1409	19055	1223	0.12365591397849462	15.580539656582175
chr2	GCKR	27499141	27499208	0	68	18	2962	18	2894	0.0	0.006219765031098825
chr2	ZNF512	27583425	27583526	408	102	204807	4272	204399	4170	4.0	49.016546762589925
chr2	ZNF512	27599969	27600053	22832	85	204807	4272	181975	4187	268.61176470588236	43.46190589921185
chr2	ZNF512	27600690	27600815	14274	126	204807	4272	190533	4146	113.28571428571429	45.95586107091172
chr2	ZNF512	27583657	27583716	458	60	204807	4272	204349	4212	7.633333333333334	48.5159069325736
chr2	GPN1	27629374	27629442	221	69	8082	3765	7861	3696	3.2028985507246377	2.1268939393939394
chr2	SLC4A1AP	27668636	27668750	3948	115	121725	4778	117777	4663	34.3304347826087	25.257773965258416
chr2	MRPL33	27774423	27774530	0	108	824	1541	824	1433	0.0	0.5750174459176552
chr2	BABAM2	27894532	27894684	0	153	11781	3409	11781	3256	0.0	3.6182432432432434
chr2	BABAM2	28327273	28327447	0	175	11781	3409	11781	3234	0.0	3.642857142857143
chr2	BABAM2	27892382	27892448	110	67	11781	3409	11671	3342	1.6417910447761195	3.4922202274087373
chr2	BABAM2	28310081	28310153	0	73	11781	3409	11781	3336	0.0	3.531474820143885
chr2	PLB1	28582067	28582133	0	67	20183	8664	20183	8597	0.0	2.347679423054554
chr2	PLB1	28640926	28641001	41	76	20183	8664	20142	8588	0.5394736842105263	2.345365626455519
chr2	PPP1CB	28752037	28752176	0	140	612	5733	612	5593	0.0	0.1094224924012158
chr2	PPP1CB	28778350	28778589	0	240	612	5733	612	5493	0.0	0.11141452758055707
chr2	SPDYA	28840171	28840469	0	299	459	3497	459	3198	0.0	0.14352720450281425
chr2	SPDYA	28814612	28814686	0	75	459	3497	459	3422	0.0	0.1341320864991233
chr2	CLIP4	29121373	29121521	0	149	14627	6993	14627	6844	0.0	2.137200467562829
chr2	CLIP4	29132151	29132245	48	95	14627	6993	14579	6898	0.5052631578947369	2.1135111626558425
chr2	YPEL5	30148244	30148541	0	298	0	3132	0	2834	0.0	0.0
chr2	YPEL5	30155849	30155910	0	62	0	3132	0	3070	0.0	0.0
chr2	YPEL5	30148244	30148305	0	62	0	3132	0	3070	0.0	0.0
chr2	LBH	30256701	30256803	0	103	0	4538	0	4435	0.0	0.0
chr2	LCLAT1	30525586	30525755	0	170	153	7528	153	7358	0.0	0.020793693938570265
chr2	LCLAT1	30459551	30459722	0	172	153	7528	153	7356	0.0	0.020799347471451877
chr2	LCLAT1	30562145	30562292	0	148	153	7528	153	7380	0.0	0.020731707317073172
chr2	LCLAT1	30489159	30489240	0	82	153	7528	153	7446	0.0	0.02054794520547945
chr2	LCLAT1	30476576	30476635	0	60	153	7528	153	7468	0.0	0.020487412961971076
chr2	LCLAT1	30476401	30476635	0	235	153	7528	153	7293	0.0	0.02097902097902098
chr2	SPAST	32098795	32098891	11	97	14001	9360	13990	9263	0.1134020618556701	1.51030983482673
chr2	SPAST	32114637	32114825	85	189	14001	9360	13916	9171	0.4497354497354497	1.517391778432014
chr2	SPAST	32126947	32127022	294	76	14001	9360	13707	9284	3.8684210526315788	1.4764110297285653
chr2	SPAST	32136876	32136968	0	93	14001	9360	14001	9267	0.0	1.5108449336354808
chr2	SPAST	32144936	32145007	0	72	14001	9360	14001	9288	0.0	1.5074289405684755
chr2	SPAST	32077828	32077943	0	116	14001	9360	14001	9244	0.0	1.5146040675032453
chr2	SPAST	32098800	32098891	11	92	14001	9360	13990	9268	0.11956521739130435	1.509495036685369
chr2	SPAST	32128407	32128479	0	73	14001	9360	14001	9287	0.0	1.5075912565952407
chr2	SPAST	32136562	32136638	0	77	14001	9360	14001	9283	0.0	1.5082408704082733
chr2	SLC30A6	32175318	32175361	0	44	3738	5426	3738	5382	0.0	0.6945373467112598
chr2	SLC30A6	32197343	32197392	0	50	3738	5426	3738	5376	0.0	0.6953125
chr2	SLC30A6	32209492	32209561	0	70	3738	5426	3738	5356	0.0	0.6979088872292756
chr2	SLC30A6	32171286	32171373	0	88	3738	5426	3738	5338	0.0	0.7002622705133008
chr2	SLC30A6	32177476	32177596	168	121	3738	5426	3570	5305	1.3884297520661157	0.6729500471253534
chr2	SLC30A6	32197317	32197392	0	76	3738	5426	3738	5350	0.0	0.6986915887850468
chr2	SLC30A6	32187151	32187303	0	153	3738	5426	3738	5273	0.0	0.7088943675327138
chr2	YIPF4	32292176	32292348	0	173	9413	11009	9413	10836	0.0	0.8686784791435954
chr2	BIRC6	32435495	32435585	0	91	100508	17804	100508	17713	0.0	5.674250550443177
chr2	BIRC6	32441328	32441462	0	135	100508	17804	100508	17669	0.0	5.6883807798969945
chr2	BIRC6	32521661	32521757	0	97	100508	17804	100508	17707	0.0	5.676173264810527
chr2	TTC27	32766467	32766549	51	83	2433	3468	2382	3385	0.6144578313253012	0.7036927621861152
chr2	TTC27	32780053	32780112	757	60	2433	3468	1676	3408	12.616666666666667	0.49178403755868544
chr2	LINC00486	32841012	32841233	255	222	1871	7058	1616	6836	1.1486486486486487	0.2363955529549444
chr2	LINC00486	32882698	32882826	0	129	1871	7058	1871	6929	0.0	0.2700245345648723
chr2	LINC00486	32928031	32928123	0	93	1871	7058	1871	6965	0.0	0.2686288585786073
chr2	LTBP1	33293159	33293282	0	124	1300	7385	1300	7261	0.0	0.17903869990359456
chr2	LTBP1	33342837	33342963	0	127	1300	7385	1300	7258	0.0	0.17911270322402867
chr2	RASGRP3	33481182	33481304	0	123	19447	10165	19447	10042	0.0	1.936566421031667
chr2	RASGRP3	33493053	33493172	0	120	19447	10165	19447	10045	0.0	1.9359880537580887
chr2	LINC01320	33886371	33886474	0	104	144	10145	144	10041	0.0	0.01434120107559008
chr2	LINC01320	34721998	34722121	0	124	144	10145	144	10021	0.0	0.014369823370921065
chr2	LINC01320	34732447	34732557	0	111	144	10145	144	10034	0.0	0.014351205899940203
chr2	LINC01320	34710451	34710513	0	63	144	10145	144	10082	0.0	0.01428288038087681
chr2	LINC01320	34735646	34735686	0	41	144	10145	144	10104	0.0	0.014251781472684086
chr2	LINC01320	34691590	34691669	0	80	144	10145	144	10065	0.0	0.014307004470938897
chr2	LINC01320	34721998	34722438	0	441	144	10145	144	9704	0.0	0.01483924154987634
chr2	LINC01320	34731454	34731538	0	85	144	10145	144	10060	0.0	0.014314115308151094
chr2	LINC01320	34731365	34731538	0	174	144	10145	144	9971	0.0	0.014441881456223047
chr2	LINC01320	34721998	34722074	0	77	144	10145	144	10068	0.0	0.014302741358760428
chr2	AC012593.1	35159546	35159628	0	83	182	4225	182	4142	0.0	0.04394012554321584
chr2	AC012593.1	35164119	35164242	0	124	182	4225	182	4101	0.0	0.04437941965374299
chr2	AC012593.1	35170177	35170349	0	173	182	4225	182	4052	0.0	0.04491609081934847
chr2	AC012593.1	35003083	35003126	0	44	182	4225	182	4181	0.0	0.04353025591963645
chr2	AC012593.1	35164127	35164242	0	116	182	4225	182	4109	0.0	0.044293015332197615
chr2	AC012593.1	35162930	35163059	0	130	182	4225	182	4095	0.0	0.044444444444444446
chr2	CRIM1	36396613	36396787	0	175	125	7291	125	7116	0.0	0.017566048341765037
chr2	VIT	36729425	36729491	0	67	46528	3727	46528	3660	0.0	12.71256830601093
chr2	VIT	36781726	36781771	0	46	46528	3727	46528	3681	0.0	12.640043466449335
chr2	VIT	36775001	36775067	606	67	46528	3727	45922	3660	9.044776119402986	12.546994535519126
chr2	VIT	36783339	36783402	0	64	46528	3727	46528	3663	0.0	12.702156702156703
chr2	CEBPZOS	37198493	37198672	51	180	1217	3317	1166	3137	0.2833333333333333	0.3716927000318776
chr2	NDUFAF7	37232105	37232266	0	162	14	3663	14	3501	0.0	0.003998857469294488
chr2	NDUFAF7	37236095	37236176	0	82	14	3663	14	3581	0.0	0.003909522479754258
chr2	NDUFAF7	37242634	37242693	0	60	14	3663	14	3603	0.0	0.0038856508465167916
chr2	QPCT	37352788	37352935	0	148	1665	2577	1665	2429	0.0	0.6854672704816797
chr2	RMDN2	37950510	37950595	0	86	153	6031	153	5945	0.0	0.025735912531539108
chr2	RMDN2	37951232	37952201	0	970	153	6031	153	5061	0.0	0.03023117960877297
chr2	RMDN2	38012602	38012649	0	48	153	6031	153	5983	0.0	0.0255724552899883
chr2	CYP1B1-AS1	38100923	38101066	0	144	51	8859	51	8715	0.0	0.00585197934595525
chr2	CYP1B1-AS1	38121984	38122225	0	242	51	8859	51	8617	0.0	0.005918533132180573
chr2	CYP1B1-AS1	38130919	38131190	0	272	51	8859	51	8587	0.0	0.005939210434377547
chr2	CYP1B1-AS1	38083995	38084110	0	116	51	8859	51	8743	0.0	0.005833238018986618
chr2	CYP1B1-AS1	38113360	38113507	0	148	51	8859	51	8711	0.0	0.00585466651360349
chr2	GALM	38698365	38698436	0	72	6	2626	6	2554	0.0	0.0023492560689115116
chr2	GEMIN6	38779257	38779325	0	69	525	4369	525	4300	0.0	0.12209302325581395
chr2	GEMIN6	38779257	38779441	0	185	525	4369	525	4184	0.0	0.12547801147227533
chr2	MORN2	38880178	38880229	0	52	0	1374	0	1322	0.0	0.0
chr2	MORN2	38881441	38881578	0	138	0	1374	0	1236	0.0	0.0
chr2	MORN2	38881475	38881578	0	104	0	1374	0	1270	0.0	0.0
chr2	ARHGEF33	38959840	38960648	612	809	353742	5091	353130	4282	0.7564894932014833	82.46847267631948
chr2	MAP4K3-DT	39518582	39518710	0	129	10240	10725	10240	10596	0.0	0.96640241600604
chr2	MAP4K3-DT	39587015	39587034	0	20	10240	10725	10240	10705	0.0	0.9565623540401681
chr2	MAP4K3-DT	39588448	39588567	306	120	10240	10725	9934	10605	2.55	0.9367279585101367
chr2	MAP4K3-DT	39584604	39587353	0	2750	10240	10725	10240	7975	0.0	1.284012539184953
chr2	MAP4K3-DT	39557981	39558046	0	66	10240	10725	10240	10659	0.0	0.9606904962942114
chr2	MAP4K3-DT	39588485	39588567	234	83	10240	10725	10006	10642	2.819277108433735	0.9402367975944371
chr2	MAP4K3-DT	39474526	39474627	0	102	10240	10725	10240	10623	0.0	0.963946154570272
chr2	MAP4K3-DT	39584604	39584810	0	207	10240	10725	10240	10518	0.0	0.9735691196044876
chr2	TMEM178A	39707048	39707186	0	139	807	2430	807	2291	0.0	0.3522479266695766
chr2	SLC8A1-AS1	40223629	40223751	0	123	102	8515	102	8392	0.0	0.01215443279313632
chr2	SLC8A1-AS1	39922848	39922889	0	42	102	8515	102	8473	0.0	0.012038239112474921
chr2	SLC8A1-AS1	40209966	40210024	0	59	102	8515	102	8456	0.0	0.012062440870387891
chr2	SLC8A1-AS1	40101160	40101257	0	98	102	8515	102	8417	0.0	0.012118331947249613
chr2	SLC8A1-AS1	40114001	40114103	0	103	102	8515	102	8412	0.0	0.012125534950071327
chr2	SLC8A1-AS1	40208374	40208451	0	78	102	8515	102	8437	0.0	0.012089605309944292
chr2	SLC8A1-AS1	40110944	40111009	0	66	102	8515	102	8449	0.0	0.012072434607645875
chr2	SLC8A1-AS1	40120703	40120800	0	98	102	8515	102	8417	0.0	0.012118331947249613
chr2	SLC8A1-AS1	40213108	40213218	0	111	102	8515	102	8404	0.0	0.01213707758210376
chr2	SLC8A1-AS1	40213168	40213218	0	51	102	8515	102	8464	0.0	0.012051039697542534
chr2	SLC8A1-AS1	40213168	40213479	0	312	102	8515	102	8203	0.0	0.012434475192002926
chr2	SLC8A1-AS1	40250298	40250509	0	212	102	8515	102	8303	0.0	0.012284716367577983
chr2	LINC01913	41877649	41877778	0	130	51	5091	51	4961	0.0	0.010280185446482563
chr2	LINC01913	41890350	41890418	0	69	51	5091	51	5022	0.0	0.01015531660692951
chr2	EML4	42261120	42261294	0	175	1586	8380	1586	8205	0.0	0.19329677026203534
chr2	EML4	42264918	42264951	0	34	1586	8380	1586	8346	0.0	0.19003115264797507
chr2	MTA3	42579106	42579200	69	95	8393	10362	8324	10267	0.7263157894736842	0.8107528976331937
chr2	MTA3	42609457	42609584	357	128	8393	10362	8036	10234	2.7890625	0.7852257181942545
chr2	MTA3	42640172	42640236	0	65	8393	10362	8393	10297	0.0	0.8150917743031951
chr2	MTA3	42704196	42704318	0	123	8393	10362	8393	10239	0.0	0.8197089559527297
chr2	MTA3	42704193	42704318	0	126	8393	10362	8393	10236	0.0	0.8199491989058226
chr2	MTA3	42752233	42752307	0	75	8393	10362	8393	10287	0.0	0.8158841255954117
chr2	MTA3	42581784	42581908	0	125	8393	10362	8393	10237	0.0	0.8198691022760575
chr2	PLEKHH2	43757118	43757264	0	147	1254	9879	1254	9732	0.0	0.12885326757090013
chr2	PLEKHH2	43679516	43679638	0	123	1254	9879	1254	9756	0.0	0.12853628536285364
chr2	DYNC2LI1	43787180	43787250	0	71	8810	2824	8810	2753	0.0	3.200145296040683
chr2	DYNC2LI1	43781627	43781764	0	138	8810	2824	8810	2686	0.0	3.2799702159344752
chr2	DYNC2LI1	43775708	43775788	0	81	8810	2824	8810	2743	0.0	3.2118118847976667
chr2	PPM1B	44201185	44202045	65256	861	73257	7115	8001	6254	75.79094076655052	1.2793412216181643
chr2	PPM1B	44209209	44209327	0	119	73257	7115	73257	6996	0.0	10.471269296740996
chr2	SLC3A1	44301002	44301127	0	126	0	6140	0	6014	0.0	0.0
chr2	LINC02583	46430175	46430203	0	29	0	1489	0	1460	0.0	0.0
chr2	RHOQ	46543753	46543812	0	60	101431	6433	101431	6373	0.0	15.915738270830065
chr2	RHOQ	46560523	46560689	0	167	101431	6433	101431	6266	0.0	16.18751994893074
chr2	RHOQ	46572727	46572786	0	60	101431	6433	101431	6373	0.0	15.915738270830065
chr2	LINC01118	46817369	46817433	345	65	22079	3369	21734	3304	5.3076923076923075	6.578087167070218
chr2	LINC01118	46817247	46817433	807	187	22079	3369	21272	3182	4.315508021390374	6.685103708359522
chr2	TTC7A	46994356	46994514	0	159	538	7210	538	7051	0.0	0.07630123386753652
chr2	TTC7A	47021861	47021979	0	119	538	7210	538	7091	0.0	0.07587082216894656
chr2	TTC7A	47023407	47023465	0	59	538	7210	538	7151	0.0	0.07523423297440918
chr2	TTC7A	47046314	47046431	0	118	538	7210	538	7092	0.0	0.07586012408347434
chr2	TTC7A	46958494	46958552	28	59	538	7210	510	7151	0.4745762711864407	0.07131869668577821
chr2	TTC7A	47047265	47047337	0	73	538	7210	538	7137	0.0	0.07538181308673111
chr2	TTC7A	46951601	46951733	0	133	538	7210	538	7077	0.0	0.07602091281616505
chr2	MSH2	47607391	47607581	0	191	70725	13680	70725	13489	0.0	5.243161094224924
chr2	MSH6	47795893	47796063	0	171	40178	10902	40178	10731	0.0	3.744105861522691
chr2	MSH6	47790926	47791123	0	198	40178	10902	40178	10704	0.0	3.7535500747384156
chr2	FOXN2	48328560	48328702	0	143	0	5473	0	5330	0.0	0.0
chr2	PPP1R21	48495678	48495771	0	94	0	3984	0	3890	0.0	0.0
chr2	PPP1R21	48505563	48505596	0	34	0	3984	0	3950	0.0	0.0
chr2	PPP1R21	48479483	48479556	0	74	0	3984	0	3910	0.0	0.0
chr2	STON1	48530712	48530829	0	118	7795	7055	7795	6937	0.0	1.1236845898803518
chr2	GTF2A1L	48620850	48620952	0	103	969	2063	969	1960	0.0	0.4943877551020408
chr2	ERLEC1	53808298	53808460	0	163	102	2607	102	2444	0.0	0.041734860883797055
chr2	ERLEC1	53814542	53814620	0	79	102	2607	102	2528	0.0	0.040348101265822785
chr2	ACYP2	54267295	54267365	0	71	7506	4979	7506	4908	0.0	1.5293398533007334
chr2	ACYP2	54222996	54223083	0	88	7506	4979	7506	4891	0.0	1.5346554896749132
chr2	C2ORF73	54358958	54359074	0	117	306	2412	306	2295	0.0	0.13333333333333333
chr2	C2ORF73	54334816	54335024	0	209	306	2412	306	2203	0.0	0.13890149795733092
chr2	C2ORF73	54334816	54334850	0	35	306	2412	306	2377	0.0	0.12873369793857803
chr2	C2ORF73	54343719	54343873	306	155	306	2412	0	2257	1.9741935483870967	0.0
chr2	C2ORF73	54360202	54360271	0	70	306	2412	306	2342	0.0	0.13065755764304013
chr2	C2ORF73	54360843	54360942	0	100	306	2412	306	2312	0.0	0.1323529411764706
chr2	EML6	54966999	54967103	0	105	166946	16043	166946	15938	0.0	10.474714518760196
chr2	EML6	54946659	54948014	102	1356	166946	16043	166844	14687	0.0752212389380531	11.35997821202424
chr2	EML6	54902420	54902541	0	122	166946	16043	166946	15921	0.0	10.485899126939263
chr2	EML6	54901940	54902141	0	202	166946	16043	166946	15841	0.0	10.538854870273342
chr2	EML6	54900696	54900896	0	201	166946	16043	166946	15842	0.0	10.53818962252241
chr2	EML6	54902424	54902541	0	118	166946	16043	166946	15925	0.0	10.48326530612245
chr2	EML6	54953295	54953316	210	22	166946	16043	166736	16021	9.545454545454545	10.407340365769928
chr2	AC012358.2	55329421	55329519	0	99	0	4927	0	4828	0.0	0.0
chr2	AC012358.2	55338975	55339269	0	295	0	4927	0	4632	0.0	0.0
chr2	AC012358.2	55329421	55329713	0	293	0	4927	0	4634	0.0	0.0
chr2	AC012358.2	55332138	55332261	0	124	0	4927	0	4803	0.0	0.0
chr2	AC012358.2	55329567	55329713	0	147	0	4927	0	4780	0.0	0.0
chr2	AC012358.2	55320828	55320928	0	101	0	4927	0	4826	0.0	0.0
chr2	AC012358.2	55317744	55317809	0	66	0	4927	0	4861	0.0	0.0
chr2	AC012358.2	55339149	55339269	0	121	0	4927	0	4806	0.0	0.0
chr2	AC012358.2	55339850	55339974	0	125	0	4927	0	4802	0.0	0.0
chr2	CFAP36	55520404	55520479	459	76	8415	2573	7956	2497	6.0394736842105265	3.1862234681617942
chr2	VRK2	58018015	58018086	0	72	0	3484	0	3412	0.0	0.0
chr2	VRK2	58026743	58026861	0	119	0	3484	0	3365	0.0	0.0
chr2	VRK2	58028297	58028398	0	102	0	3484	0	3382	0.0	0.0
chr2	VRK2	58084880	58084950	0	71	0	3484	0	3413	0.0	0.0
chr2	VRK2	58154758	58154802	0	45	0	3484	0	3439	0.0	0.0
chr2	VRK2	58154753	58154802	0	50	0	3484	0	3434	0.0	0.0
chr2	VRK2	58058351	58058488	0	138	0	3484	0	3346	0.0	0.0
chr2	LINC01795	58294518	58294562	0	45	3797	1525	3797	1480	0.0	2.5655405405405407
chr2	LINC01795	58279549	58279598	0	50	3797	1525	3797	1475	0.0	2.5742372881355933
chr2	LINC01122	58656649	58656711	0	63	0	11565	0	11502	0.0	0.0
chr2	LINC01122	58912718	58912746	0	29	0	11565	0	11536	0.0	0.0
chr2	LINC01122	58915679	58915902	0	224	0	11565	0	11341	0.0	0.0
chr2	LINC01122	58461777	58461845	0	69	0	11565	0	11496	0.0	0.0
chr2	LINC01122	58728357	58728475	0	119	0	11565	0	11446	0.0	0.0
chr2	LINC01122	58918695	58918853	0	159	0	11565	0	11406	0.0	0.0
chr2	LINC01122	59033169	59033215	0	47	0	11565	0	11518	0.0	0.0
chr2	LINC01122	58671433	58671462	0	30	0	11565	0	11535	0.0	0.0
chr2	LINC01122	58461058	58461125	0	68	0	11565	0	11497	0.0	0.0
chr2	LINC01122	59024835	59024990	0	156	0	11565	0	11409	0.0	0.0
chr2	LINC01122	58929608	58929753	0	146	0	11565	0	11419	0.0	0.0
chr2	AC007179.1	59437898	59438059	0	162	0	1185	0	1023	0.0	0.0
chr2	PAPOLG	60780706	60780779	0	74	51	7983	51	7909	0.0	0.006448349981034265
chr2	PAPOLG	60787510	60787620	0	111	51	7983	51	7872	0.0	0.0064786585365853655
chr2	PAPOLG	60771518	60771630	0	113	51	7983	51	7870	0.0	0.006480304955527319
chr2	PAPOLG	60794709	60794775	0	67	51	7983	51	7916	0.0	0.0064426478019201615
chr2	PAPOLG	60795289	60795336	0	48	51	7983	51	7935	0.0	0.006427221172022685
chr2	REL	60920382	60920478	0	97	470	13184	470	13087	0.0	0.03591350194849851
chr2	REL	60898969	60900884	51	1916	470	13184	419	11268	0.02661795407098121	0.03718494852680156
chr2	KIAA1841	61073457	61073551	0	95	1288	7719	1288	7624	0.0	0.1689401888772298
chr2	C2ORF74	61162841	61162955	27	115	1976	1523	1949	1408	0.23478260869565218	1.3842329545454546
chr2	C2ORF74	61157861	61158012	165	152	1976	1523	1811	1371	1.0855263157894737	1.3209336250911743
chr2	C2ORF74	61159317	61159439	28	123	1976	1523	1948	1400	0.22764227642276422	1.3914285714285715
chr2	AHSA2P	61183546	61183662	204	117	1275	8068	1071	7951	1.7435897435897436	0.134700037731103
chr2	AHSA2P	61185979	61186081	0	103	1275	8068	1275	7965	0.0	0.160075329566855
chr2	AHSA2P	61185838	61185865	0	28	1275	8068	1275	8040	0.0	0.15858208955223882
chr2	AC016727.1	61480299	61480583	162	285	6000	2338	5838	2053	0.5684210526315789	2.8436434486117874
chr2	COMMD1	61968968	61969130	0	163	2042	2400	2042	2237	0.0	0.9128296826106392
chr2	EHBP1	62706896	62707295	0	400	984	8254	984	7854	0.0	0.1252864782276547
chr2	EHBP1	62955516	62955660	0	145	984	8254	984	8109	0.0	0.12134665186829449
chr2	EHBP1	62858405	62858510	0	106	984	8254	984	8148	0.0	0.12076583210603829
chr2	EHBP1	62987930	62988038	126	109	984	8254	858	8145	1.1559633027522935	0.10534069981583793
chr2	EHBP1	62949093	62949162	0	70	984	8254	984	8184	0.0	0.12023460410557185
chr2	MDH1	63595422	63595519	0	98	768	5003	768	4905	0.0	0.1565749235474006
chr2	MDH1	63593123	63593628	0	506	768	5003	768	4497	0.0	0.17078052034689792
chr2	MDH1	63599169	63599292	0	124	768	5003	768	4879	0.0	0.15740930518548882
chr2	MDH1	63589960	63590084	0	125	768	5003	768	4878	0.0	0.15744157441574416
chr2	MDH1	63593439	63593628	0	190	768	5003	768	4813	0.0	0.15956783710783295
chr2	UGP2	63857549	63857718	0	170	0	6812	0	6642	0.0	0.0
chr2	UGP2	63842058	63842204	0	147	0	6812	0	6665	0.0	0.0
chr2	UGP2	63854883	63854936	0	54	0	6812	0	6758	0.0	0.0
chr2	UGP2	63842538	63842599	0	62	0	6812	0	6750	0.0	0.0
chr2	UGP2	63862840	63862928	0	89	0	6812	0	6723	0.0	0.0
chr2	UGP2	63855566	63855643	0	78	0	6812	0	6734	0.0	0.0
chr2	UGP2	63856787	63856882	0	96	0	6812	0	6716	0.0	0.0
chr2	UGP2	63857549	63857642	0	94	0	6812	0	6718	0.0	0.0
chr2	UGP2	63859179	63859391	0	213	0	6812	0	6599	0.0	0.0
chr2	UGP2	63883059	63883275	0	217	0	6812	0	6595	0.0	0.0
chr2	UGP2	63856305	63856433	0	129	0	6812	0	6683	0.0	0.0
chr2	UGP2	63856963	63857002	0	40	0	6812	0	6772	0.0	0.0
chr2	AC012368.1	64214466	64214534	0	69	10426	7851	10426	7782	0.0	1.3397584168594192
chr2	AC012368.1	64188457	64188562	0	106	10426	7851	10426	7745	0.0	1.3461588121368624
chr2	AC012368.1	64214128	64214254	0	127	10426	7851	10426	7724	0.0	1.3498187467633351
chr2	AC012368.1	64206974	64207045	0	72	10426	7851	10426	7779	0.0	1.3402750996272015
chr2	AC012368.1	64248323	64248538	0	216	10426	7851	10426	7635	0.0	1.3655533726260642
chr2	AC012368.1	64189224	64189583	8870	360	10426	7851	1556	7491	24.63888888888889	0.20771592577759979
chr2	AC012368.1	64206971	64207045	0	75	10426	7851	10426	7776	0.0	1.3407921810699588
chr2	AC012368.1	64227860	64227988	0	129	10426	7851	10426	7722	0.0	1.3501683501683501
chr2	AC012368.1	64229170	64229288	48	119	10426	7851	10378	7732	0.40336134453781514	1.342214174857734
chr2	LGALSL	64456287	64456465	0	179	0	3939	0	3760	0.0	0.0
chr2	LGALSL	64456267	64456465	0	199	0	3939	0	3740	0.0	0.0
chr2	AFTPH	64581189	64581273	0	85	0	5776	0	5691	0.0	0.0
chr2	AFTPH	64579485	64579546	0	62	0	5776	0	5714	0.0	0.0
chr2	SLC1A4	65016439	65016673	51	235	1479	6951	1428	6716	0.2170212765957447	0.21262656343061345
chr2	CEP68	65073935	65074149	0	215	306	6951	306	6736	0.0	0.04542755344418052
chr2	ACTR2	65241971	65242063	0	93	255	4324	255	4231	0.0	0.06026943984873552
chr2	ACTR2	65246184	65246307	0	124	255	4324	255	4200	0.0	0.060714285714285714
chr2	ACTR2	65242048	65242063	0	16	255	4324	255	4308	0.0	0.059192200557103065
chr2	AC007389.1	66081289	66081402	0	114	2316	12371	2316	12257	0.0	0.18895325120339398
chr2	MEIS1	66439842	66439984	0	143	242	8573	242	8430	0.0	0.02870699881376038
chr2	MEIS1	66512148	66512294	0	147	242	8573	242	8426	0.0	0.028720626631853787
chr2	MEIS1	66569049	66569145	0	97	242	8573	242	8476	0.0	0.028551203397829166
chr2	LINC01798	66697447	66697503	0	57	24	3925	24	3868	0.0	0.0062047569803516025
chr2	LINC01799	66934902	66934972	0	71	0	1685	0	1614	0.0	0.0
chr2	LINC01799	66933102	66933249	0	148	0	1685	0	1537	0.0	0.0
chr2	LINC01828	67264996	67265192	0	197	0	8104	0	7907	0.0	0.0
chr2	LINC01828	67287755	67287818	0	64	0	8104	0	8040	0.0	0.0
chr2	LINC01828	67283388	67283519	0	132	0	8104	0	7972	0.0	0.0
chr2	LINC01828	67287755	67287823	0	69	0	8104	0	8035	0.0	0.0
chr2	ETAA1	67399549	67399626	0	78	153	7483	153	7405	0.0	0.020661715057393653
chr2	LINC02831	67566775	67566972	0	198	0	3252	0	3054	0.0	0.0
chr2	LINC02831	67568007	67568156	0	150	0	3252	0	3102	0.0	0.0
chr2	LINC02831	67564802	67564886	0	85	0	3252	0	3167	0.0	0.0
chr2	LINC02831	67566775	67566884	0	110	0	3252	0	3142	0.0	0.0
chr2	LINC02831	67570735	67570788	0	54	0	3252	0	3198	0.0	0.0
chr2	LINC02831	67566779	67566884	0	106	0	3252	0	3146	0.0	0.0
chr2	LINC02831	67564802	67565423	0	622	0	3252	0	2630	0.0	0.0
chr2	LINC02831	67600078	67600140	0	63	0	3252	0	3189	0.0	0.0
chr2	LINC02831	67616088	67616195	0	108	0	3252	0	3144	0.0	0.0
chr2	PNO1	68161214	68161362	0	149	0	2638	0	2489	0.0	0.0
chr2	APLF	68490189	68490261	0	73	1931	7146	1931	7073	0.0	0.27301003817333525
chr2	APLF	68535282	68535383	0	102	1931	7146	1931	7044	0.0	0.27413401476433846
chr2	ARHGAP25	68787839	68787956	0	118	917	5449	917	5331	0.0	0.1720127555805665
chr2	ARHGAP25	68782232	68782320	0	89	917	5449	917	5360	0.0	0.1710820895522388
chr2	SNRNP27	69903180	69903245	0	66	0	1819	0	1753	0.0	0.0
chr2	MXD1	69921735	69921765	0	31	307	6360	307	6329	0.0	0.048506873123716224
chr2	VAX2	70963161	70963312	0	152	79	2993	79	2841	0.0	0.027807110172474482
chr2	VAX2	70963161	70963261	0	101	79	2993	79	2892	0.0	0.02731673582295989
chr2	ATP6V1B1	70964069	70964111	91	43	91	2671	0	2628	2.116279069767442	0.0
chr2	ANKRD53	70981935	70982100	0	166	0	2282	0	2116	0.0	0.0
chr2	ANKRD53	70984122	70984249	0	128	0	2282	0	2154	0.0	0.0
chr2	ANKRD53	70979660	70979860	0	201	0	2282	0	2081	0.0	0.0
chr2	NAGK	71070501	71070586	0	86	255	6678	255	6592	0.0	0.03868325242718446
chr2	NAGK	71071685	71071827	0	143	255	6678	255	6535	0.0	0.03902065799540933
chr2	NAGK	71072640	71072751	0	112	255	6678	255	6566	0.0	0.03883643009442583
chr2	NAGK	71070740	71070839	0	100	255	6678	255	6578	0.0	0.03876558224384311
chr2	ZNF638	71355718	71355780	0	63	42575	11438	42575	11375	0.0	3.742857142857143
chr2	ZNF638	71348752	71350271	7707	1520	42575	11438	34868	9918	5.070394736842105	3.515628150836862
chr2	ZNF638	71361644	71361695	0	52	42575	11438	42575	11386	0.0	3.7392411733708064
chr2	ZNF638	71348426	71350271	10413	1846	42575	11438	32162	9592	5.640845070422535	3.353002502085071
chr2	ZNF638	71422813	71424038	0	1226	42575	11438	42575	10212	0.0	4.1691147669408535
chr2	ZNF638	71428546	71428651	0	106	42575	11438	42575	11332	0.0	3.7570596540769503
chr2	ZNF638	71334500	71334596	0	97	42575	11438	42575	11341	0.0	3.7540781236222553
chr2	ZNF638	71433475	71433535	0	61	42575	11438	42575	11377	0.0	3.7421991737716445
chr2	DYSF	71513239	71513332	0	94	17746	8451	17746	8357	0.0	2.123489290415221
chr2	DYSF	71620546	71620609	65	64	17746	8451	17681	8387	1.015625	2.1081435555025636
chr2	DYSF	71549349	71549391	0	43	17746	8451	17746	8408	0.0	2.110608943862988
chr2	CCT7	73235549	73235645	22	97	12101	3397	12079	3300	0.2268041237113402	3.66030303030303
chr2	ALMS1	73489633	73491498	11707	1866	271625	14807	259918	12941	6.27384780278671	20.0848466115447
chr2	ALMS1	73534823	73534949	0	127	271625	14807	271625	14680	0.0	18.50306539509537
chr2	ALMS1	73550266	73550437	0	172	271625	14807	271625	14635	0.0	18.559959002391526
chr2	ALMS1	73601194	73601436	0	243	271625	14807	271625	14564	0.0	18.650439439714365
chr2	ALMS1	73408621	73408747	51	127	271625	14807	271574	14680	0.4015748031496063	18.499591280653952
chr2	ALMS1	73489633	73490158	0	526	271625	14807	271625	14281	0.0	19.0200266087809
chr2	STAMBP	73829404	73829510	2245	107	4975	7527	2730	7420	20.981308411214954	0.36792452830188677
chr2	ACTG2	73902359	73902488	0	130	0	3822	0	3692	0.0	0.0
chr2	ACTG2	73896751	73897314	0	564	0	3822	0	3258	0.0	0.0
chr2	DGUOK	73957124	73957240	26022	117	27486	1463	1464	1346	222.4102564102564	1.087667161961367
chr2	DGUOK	73938909	73939022	0	114	27486	1463	27486	1349	0.0	20.375092661230543
chr2	DGUOK	73950600	73950732	47	133	27486	1463	27439	1330	0.3533834586466165	20.630827067669173
chr2	DGUOK	73950626	73950732	47	107	27486	1463	27439	1356	0.4392523364485981	20.235250737463126
chr2	MTHFD2	74207703	74207826	561	124	4110	11414	3549	11290	4.524193548387097	0.31434898139946854
chr2	MTHFD2	74209941	74210049	0	109	4110	11414	4110	11305	0.0	0.3635559486952676
chr2	MTHFD2	74211740	74211866	0	127	4110	11414	4110	11287	0.0	0.3641357313723753
chr2	MTHFD2	74201381	74201479	0	99	4110	11414	4110	11315	0.0	0.36323464427750773
chr2	MTHFD2	74205704	74205889	0	186	4110	11414	4110	11228	0.0	0.36604916280726757
chr2	MTHFD2	74205981	74206088	0	108	4110	11414	4110	11306	0.0	0.36352379267645496
chr2	DCTN1-AS1	74391158	74391243	287	86	71349	4344	71062	4258	3.3372093023255816	16.689055894786286
chr2	DCTN1-AS1	74391477	74391615	408	139	71349	4344	70941	4205	2.935251798561151	16.87063020214031
chr2	WDR54	74424874	74424975	0	102	1261	2855	1261	2753	0.0	0.4580457682528151
chr2	WDR54	74422152	74422375	0	224	1261	2855	1261	2631	0.0	0.4792854427974154
chr2	INO80B	74455405	74455598	0	194	0	1446	0	1252	0.0	0.0
chr2	INO80B	74455390	74455598	0	209	0	1446	0	1237	0.0	0.0
chr2	WBP1	74458996	74459098	0	103	306	1671	306	1568	0.0	0.1951530612244898
chr2	WBP1	74458831	74458919	0	89	306	1671	306	1582	0.0	0.1934260429835651
chr2	WBP1	74458831	74459117	0	287	306	1671	306	1384	0.0	0.22109826589595374
chr2	TTC31	74490024	74490127	0	104	289	4040	289	3936	0.0	0.07342479674796748
chr2	TLX2	74515021	74515206	0	186	0	2815	0	2629	0.0	0.0
chr2	HTRA2	74530444	74530512	0	69	510	2623	510	2554	0.0	0.19968676585747847
chr2	HTRA2	74530910	74531105	52	196	510	2623	458	2427	0.2653061224489796	0.18871034198599093
chr2	HTRA2	74532618	74532714	0	97	510	2623	510	2526	0.0	0.20190023752969122
chr2	HTRA2	74530460	74530512	0	53	510	2623	510	2570	0.0	0.19844357976653695
chr2	DOK1	74555574	74555668	76	95	629	2957	553	2862	0.8	0.19322152341020266
chr2	DOK1	74555893	74556078	0	186	629	2957	629	2771	0.0	0.22699386503067484
chr2	SEMA4F	74656533	74656685	0	153	87250	6242	87250	6089	0.0	14.329118081786829
chr2	SEMA4F	74662731	74662825	84	95	87250	6242	87166	6147	0.8842105263157894	14.180250528713193
chr2	SEMA4F	74673676	74673828	0	153	87250	6242	87250	6089	0.0	14.329118081786829
chr2	SEMA4F	74675161	74675384	3	224	87250	6242	87247	6018	0.013392857142857142	14.497673645729478
chr2	SEMA4F	74657852	74657951	702	100	87250	6242	86548	6142	7.02	14.091175512862259
chr2	SEMA4F	74655266	74655387	483	122	87250	6242	86767	6120	3.959016393442623	14.177614379084968
chr2	LINC01291	74932198	74932289	0	92	0	4181	0	4089	0.0	0.0
chr2	MRPL19	75655063	75655302	0	240	1173	8956	1173	8716	0.0	0.13458008260670032
chr2	AC073091.1	76385251	76385352	0	102	0	2459	0	2357	0.0	0.0
chr2	AC073091.1	76395687	76395768	0	82	0	2459	0	2377	0.0	0.0
chr2	AC073091.1	76385229	76385352	0	124	0	2459	0	2335	0.0	0.0
chr2	AC012494.2	78095663	78095941	0	279	0	1400	0	1121	0.0	0.0
chr2	AC012494.2	78111899	78112100	0	202	0	1400	0	1198	0.0	0.0
chr2	AC012494.2	78111899	78112130	0	232	0	1400	0	1168	0.0	0.0
chr2	AC012494.2	78093516	78093666	0	151	0	1400	0	1249	0.0	0.0
chr2	AC012494.2	78111928	78112130	0	203	0	1400	0	1197	0.0	0.0
chr2	AC012494.2	78093554	78093666	0	113	0	1400	0	1287	0.0	0.0
chr2	AC012494.2	78111928	78112100	0	173	0	1400	0	1227	0.0	0.0
chr2	REG3G	79027033	79027171	0	139	0	1850	0	1711	0.0	0.0
chr2	CTNNA2	80608183	80608318	0	136	0	7576	0	7440	0.0	0.0
chr2	CTNNA2	79633697	79633840	0	144	0	7576	0	7432	0.0	0.0
chr2	CTNNA2	80619084	80619228	0	145	0	7576	0	7431	0.0	0.0
chr2	DNAH6	84525564	84525738	0	175	86525	13591	86525	13416	0.0	6.449388789505068
chr2	DNAH6	84528903	84529166	0	264	86525	13591	86525	13327	0.0	6.492458917986044
chr2	DNAH6	84685325	84685472	0	148	86525	13591	86525	13443	0.0	6.436435319497136
chr2	KCMF1	85013935	85014053	0	119	74516	7740	74516	7621	0.0	9.777719459388532
chr2	ELMOD3	85355075	85355170	0	96	153	6400	153	6304	0.0	0.02427030456852792
chr2	ELMOD3	85355554	85355598	0	45	153	6400	153	6355	0.0	0.024075531077891423
chr2	ELMOD3	85363096	85363166	0	71	153	6400	153	6329	0.0	0.024174435139832518
chr2	ELMOD3	85371439	85371562	0	124	153	6400	153	6276	0.0	0.024378585086042064
chr2	ELMOD3	85387097	85387225	0	129	153	6400	153	6271	0.0	0.02439802264391644
chr2	ELMOD3	85356601	85356667	0	67	153	6400	153	6333	0.0	0.024159166271909047
chr2	ELMOD3	85355554	85355716	0	163	153	6400	153	6237	0.0	0.024531024531024532
chr2	ELMOD3	85356966	85357252	0	287	153	6400	153	6113	0.0	0.025028627515131685
chr2	ELMOD3	85377343	85377474	0	132	153	6400	153	6268	0.0	0.02440970006381621
chr2	ELMOD3	85355554	85355896	0	343	153	6400	153	6057	0.0	0.02526002971768202
chr2	ELMOD3	85355554	85355784	0	231	153	6400	153	6169	0.0	0.024801426487275086
chr2	SH2D6	85428583	85428697	0	115	51	2703	51	2588	0.0	0.01970633693972179
chr2	SH2D6	85434472	85434497	0	26	51	2703	51	2677	0.0	0.01905117669032499
chr2	SH2D6	85435412	85435496	0	85	51	2703	51	2618	0.0	0.01948051948051948
chr2	SH2D6	85435268	85435496	0	229	51	2703	51	2474	0.0	0.020614389652384803
chr2	SH2D6	85431898	85431959	0	62	51	2703	51	2641	0.0	0.019310867095797046
chr2	VAMP8	85579741	85579874	107	134	15885	900	15778	766	0.7985074626865671	20.597911227154047
chr2	USP39	85621484	85621579	4209	96	28552	3963	24343	3867	43.84375	6.2950607706232224
chr2	USP39	85630720	85630946	276	227	28552	3963	28276	3736	1.2158590308370043	7.5685224839400425
chr2	USP39	85644947	85645083	0	137	28552	3963	28552	3826	0.0	7.462624150548876
chr2	USP39	85647929	85648016	0	88	28552	3963	28552	3875	0.0	7.368258064516129
chr2	GNLY	85694752	85694996	0	245	51	2772	51	2527	0.0	0.020182034032449545
chr2	GNLY	85694752	85694923	0	172	51	2772	51	2600	0.0	0.019615384615384614
chr2	GNLY	85694915	85694996	0	82	51	2772	51	2690	0.0	0.01895910780669145
chr2	GNLY	85698397	85698447	0	51	51	2772	51	2721	0.0	0.018743109151047408
chr2	PTCD3	86107117	86107200	0	84	459	9976	459	9892	0.0	0.04640113222806308
chr2	PTCD3	86118920	86119044	0	125	459	9976	459	9851	0.0	0.046594254390417214
chr2	PTCD3	86125794	86125880	0	87	459	9976	459	9889	0.0	0.04641520881787845
chr2	MRPL35	86207182	86207327	8	146	59	1662	51	1516	0.0547945205479452	0.033641160949868076
chr2	KDM3A	86441271	86441444	810	174	10373	8754	9563	8580	4.655172413793103	1.1145687645687645
chr2	AC015971.1	86605242	86605435	0	194	102	2869	102	2675	0.0	0.038130841121495326
chr2	ANAPC1P1	86873839	86874055	0	217	0	2573	0	2356	0.0	0.0
chr2	CYTOR	87583257	87583346	0	90	867	17288	867	17198	0.0	0.050412838702174674
chr2	CYTOR	87503486	87503624	0	139	867	17288	867	17149	0.0	0.05055688378331098
chr2	CYTOR	87480222	87480362	0	141	867	17288	867	17147	0.0	0.05056278066134018
chr2	CYTOR	87585170	87585272	51	103	867	17288	816	17185	0.49514563106796117	0.04748327029386092
chr2	CYTOR	87600068	87600222	0	155	867	17288	867	17133	0.0	0.05060409735597969
chr2	CYTOR	87470149	87470304	0	156	867	17288	867	17132	0.0	0.05060705113238384
chr2	CYTOR	87472739	87472885	0	147	867	17288	867	17141	0.0	0.05058047955195146
chr2	CYTOR	87572898	87573193	0	296	867	17288	867	16992	0.0	0.051024011299435026
chr2	CYTOR	87478121	87478230	0	110	867	17288	867	17178	0.0	0.05047153335661893
chr2	CYTOR	87480222	87480607	0	386	867	17288	867	16902	0.0	0.05129570465033724
chr2	CYTOR	87455751	87455973	260	223	867	17288	607	17065	1.1659192825112108	0.03556987987108116
chr2	CYTOR	87480222	87480423	0	202	867	17288	867	17086	0.0	0.050743298607046704
chr2	AC133644.2	87705904	87705970	0	67	1076	3873	1076	3806	0.0	0.28271150814503415
chr2	AC108479.1	88020509	88020601	0	93	1290	1216	1290	1123	0.0	1.1487088156723064
chr2	SMYD1	88093516	88093555	16	40	2293	3317	2277	3277	0.4	0.6948428440646933
chr2	THNSL2	88185327	88185479	0	153	0	6615	0	6462	0.0	0.0
chr2	THNSL2	88171226	88171307	0	82	0	6615	0	6533	0.0	0.0
chr2	THNSL2	88185550	88185724	0	175	0	6615	0	6440	0.0	0.0
chr2	ANKRD36BP2	88772972	88773044	0	73	68	4231	68	4158	0.0	0.016354016354016353
chr2	MAL	95047958	95048126	0	169	0	1458	0	1289	0.0	0.0
chr2	MAL	95049580	95049706	0	127	0	1458	0	1331	0.0	0.0
chr2	ZNF2	95180158	95180272	0	115	0	4001	0	3886	0.0	0.0
chr2	ZNF2	95176187	95176259	0	73	0	4001	0	3928	0.0	0.0
chr2	PROM2	95284968	95285115	0	148	0	4716	0	4568	0.0	0.0
chr2	FAHD2A	95405276	95405402	0	127	51	5683	51	5556	0.0	0.0091792656587473
chr2	AC008268.1	95666302	95666403	0	102	0	2062	0	1960	0.0	0.0
chr2	AC008268.1	95666302	95666424	0	123	0	2062	0	1939	0.0	0.0
chr2	STARD7-AS1	96237904	96238099	0	196	0	4416	0	4220	0.0	0.0
chr2	CIAO1	96267320	96267469	0	150	0	4735	0	4585	0.0	0.0
chr2	ITPRIPL1	96325746	96325849	0	104	3417	4337	3417	4233	0.0	0.8072289156626506
chr2	NCAPH	96341641	96341894	0	254	153	6563	153	6309	0.0	0.024251069900142655
chr2	NCAPH	96341713	96341894	0	182	153	6563	153	6381	0.0	0.023977433004231313
chr2	NCAPH	96341674	96341894	0	221	153	6563	153	6342	0.0	0.024124881740775782
chr2	NCAPH	96341391	96341894	0	504	153	6563	153	6059	0.0	0.02525169169830005
chr2	ARID5A	96549320	96549459	0	140	251	2685	251	2545	0.0	0.09862475442043223
chr2	FER1L5	96647063	96647155	0	93	4194	7511	4194	7418	0.0	0.5653815044486384
chr2	FER1L5	96654445	96654496	0	52	4194	7511	4194	7459	0.0	0.5622737632390401
chr2	FER1L5	96695296	96695297	0	2	4194	7511	4194	7509	0.0	0.5585297642828606
chr2	CNNM3	96825057	96825201	0	145	102	5407	102	5262	0.0	0.019384264538198404
chr2	ANKRD36	97164396	97164469	0	74	17028	11362	17028	11288	0.0	1.5085046066619419
chr2	AC159540.2	97284877	97285007	12	131	21131	1980	21119	1849	0.0916030534351145	11.421849648458627
chr2	AC159540.2	97285302	97285523	9818	222	21131	1980	11313	1758	44.22522522522522	6.435153583617748
chr2	AC159540.2	97284877	97285523	29089	647	21131	1980	-7958	1333	44.95981452859351	-5.969992498124531
chr2	C2ORF92	97667963	97668073	0	111	125	6194	125	6083	0.0	0.020549071181982573
chr2	C2ORF92	97688894	97688993	0	100	125	6194	125	6094	0.0	0.02051197899573351
chr2	C2ORF92	97690255	97690327	0	73	125	6194	125	6121	0.0	0.020421499754942004
chr2	C2ORF92	97701153	97701304	0	152	125	6194	125	6042	0.0	0.02068851373717312
chr2	C2ORF92	97674455	97674557	0	103	125	6194	125	6091	0.0	0.02052208175997373
chr2	C2ORF92	97671330	97671499	0	170	125	6194	125	6024	0.0	0.020750332005312084
chr2	C2ORF92	97675630	97675721	0	92	125	6194	125	6102	0.0	0.020485086856768274
chr2	C2ORF92	97671190	97671306	0	117	125	6194	125	6077	0.0	0.020569359881520487
chr2	C2ORF92	97671219	97671306	0	88	125	6194	125	6106	0.0	0.02047166721257779
chr2	C2ORF92	97671193	97671306	0	114	125	6194	125	6080	0.0	0.02055921052631579
chr2	C2ORF92	97674455	97674561	0	107	125	6194	125	6087	0.0	0.02053556760308855
chr2	C2ORF92	97675844	97675928	0	85	125	6194	125	6109	0.0	0.020461614012113275
chr2	C2ORF92	97694446	97694599	0	154	125	6194	125	6040	0.0	0.020695364238410598
chr2	C2ORF92	97671330	97671481	0	152	125	6194	125	6042	0.0	0.02068851373717312
chr2	C2ORF92	97702060	97702167	0	108	125	6194	125	6086	0.0	0.020538941833716726
chr2	VWA3B	98119519	98119763	51	245	10210	8007	10159	7762	0.20816326530612245	1.3088121618139654
chr2	VWA3B	98216754	98216975	0	222	10210	8007	10210	7785	0.0	1.3114964675658318
chr2	VWA3B	98228201	98228332	0	132	10210	8007	10210	7875	0.0	1.2965079365079366
chr2	VWA3B	98236389	98236477	0	89	10210	8007	10210	7918	0.0	1.2894670371305885
chr2	VWA3B	98269341	98269491	0	151	10210	8007	10210	7856	0.0	1.299643584521385
chr2	VWA3B	98119512	98119763	51	252	10210	8007	10159	7755	0.20238095238095238	1.309993552546744
chr2	VWA3B	98187974	98188129	0	156	10210	8007	10210	7851	0.0	1.300471277544262
chr2	VWA3B	98179243	98179317	0	75	10210	8007	10210	7932	0.0	1.2871911245587493
chr2	VWA3B	98242256	98242298	0	43	10210	8007	10210	7964	0.0	1.2820190858864893
chr2	CNGA3	98383387	98383441	0	55	8829	4353	8829	4298	0.0	2.054211261051652
chr2	INPP4A	98548954	98548969	0	16	2741	13221	2741	13205	0.0	0.2075728890571753
chr2	UNC50	98616431	98616533	81	103	545	2087	464	1984	0.7864077669902912	0.23387096774193547
chr2	C2ORF15	99147026	99147122	0	97	443	2063	443	1966	0.0	0.22533062054933875
chr2	LIPT1	99156300	99156426	0	127	19437	2283	19437	2156	0.0	9.01530612244898
chr2	LIPT1	99155481	99155544	0	64	19437	2283	19437	2219	0.0	8.759351059035602
chr2	MAP4K4	101863820	101864051	0	232	218220	11035	218220	10803	0.0	20.199944459872256
chr2	MAP4K4	101860824	101860986	0	163	218220	11035	218220	10872	0.0	20.071743929359823
chr2	MAP4K4	101871493	101871685	20	193	218220	11035	218200	10842	0.10362694300518134	20.125438111049622
chr2	MAP4K4	101868028	101868037	0	10	218220	11035	218220	11025	0.0	19.793197278911563
chr2	IL1R1	102157718	102157785	553	68	16662	6249	16109	6181	8.132352941176471	2.606212586960039
chr2	IL1R1	102165114	102165304	765	191	16662	6249	15897	6058	4.005235602094241	2.6241333773522615
chr2	IL1R1	102156145	102156246	1441	102	16662	6249	15221	6147	14.127450980392156	2.476167236050106
chr2	IL1RL1	102340665	102340828	612	164	3189	5719	2577	5555	3.731707317073171	0.4639063906390639
chr2	IL1RL1	102338115	102338325	51	211	3189	5719	3138	5508	0.24170616113744076	0.5697167755991286
chr2	IL1RL1	102341187	102341357	102	171	3189	5719	3087	5548	0.5964912280701754	0.5564167267483778
chr2	IL18R1	102373936	102373993	0	58	1285	4380	1285	4322	0.0	0.2973160573808422
chr2	IL18RAP	102423810	102424135	0	326	72470	2978	72470	2652	0.0	27.326546003016592
chr2	TMEM182	102757412	102757539	0	128	581	6001	581	5873	0.0	0.09892729439809297
chr2	TMEM182	102797862	102798000	0	139	581	6001	581	5862	0.0	0.09911293074036165
chr2	TMEM182	102758388	102758473	0	86	581	6001	581	5915	0.0	0.09822485207100591
chr2	LINC01965	104072130	104072289	0	160	51	5510	51	5350	0.0	0.009532710280373832
chr2	AC068535.1	104408221	104408392	0	172	0	2412	0	2240	0.0	0.0
chr2	LINC01102	104434498	104434523	0	26	0	7010	0	6984	0.0	0.0
chr2	LINC01102	104435939	104436119	0	181	0	7010	0	6829	0.0	0.0
chr2	LINC01102	104507964	104508084	0	121	0	7010	0	6889	0.0	0.0
chr2	LINC01102	104531388	104531608	0	221	0	7010	0	6789	0.0	0.0
chr2	LINC01102	104520195	104520657	0	463	0	7010	0	6547	0.0	0.0
chr2	AC018730.1	104853772	104853832	0	61	0	3750	0	3689	0.0	0.0
chr2	AC018730.1	104890351	104890414	0	64	0	3750	0	3686	0.0	0.0
chr2	MRPS9	105091321	105091433	0	113	0	1841	0	1728	0.0	0.0
chr2	NCK2	105881327	105882049	66255	723	72222	2982	5967	2259	91.6390041493776	2.641434262948207
chr2	ECRG4	106064280	106064362	0	83	0	1713	0	1630	0.0	0.0
chr2	ECRG4	106070789	106071005	0	217	0	1713	0	1496	0.0	0.0
chr2	LINC01886	107541442	107541489	0	48	0	2587	0	2539	0.0	0.0
chr2	LINC01886	107531548	107531779	0	232	0	2587	0	2355	0.0	0.0
chr2	LINC01886	107531659	107531779	0	121	0	2587	0	2466	0.0	0.0
chr2	LINC01886	107531647	107531779	0	133	0	2587	0	2454	0.0	0.0
chr2	SULT1C2	108298566	108298661	0	96	0	2947	0	2851	0.0	0.0
chr2	SULT1C2	108305414	108305595	0	182	0	2947	0	2765	0.0	0.0
chr2	SULT1C2	108300837	108300935	0	99	0	2947	0	2848	0.0	0.0
chr2	SULT1C2	108300899	108300935	0	37	0	2947	0	2910	0.0	0.0
chr2	SULT1C2	108300795	108300935	0	141	0	2947	0	2806	0.0	0.0
chr2	GCC2	108451027	108451112	51	86	5949	10494	5898	10408	0.5930232558139535	0.5666794773251345
chr2	LIMS1	108670780	108670847	0	68	0	7791	0	7723	0.0	0.0
chr2	LIMS1	108680968	108681112	0	145	0	7791	0	7646	0.0	0.0
chr2	RANBP2	108730773	108730885	0	113	102	12327	102	12214	0.0	0.00835107253970853
chr2	CCDC138	108788031	108788089	0	59	0	5316	0	5257	0.0	0.0
chr2	CCDC138	108873450	108873589	0	140	0	5316	0	5176	0.0	0.0
chr2	RGPD5	109801782	109801850	0	69	3739	14092	3739	14023	0.0	0.2666333880054197
chr2	RGPD5	109808749	109808895	714	147	3739	14092	3025	13945	4.857142857142857	0.21692362854069558
chr2	RGPD5	109801785	109801850	0	66	3739	14092	3739	14026	0.0	0.26657635819192926
chr2	AC013268.1	109937974	109938072	0	99	260	3474	260	3375	0.0	0.07703703703703704
chr2	AC013268.1	109963468	109963550	0	83	260	3474	260	3391	0.0	0.07667354762606901
chr2	AC013268.1	109963459	109963550	0	92	260	3474	260	3382	0.0	0.0768775872264932
chr2	LINC01123	109993634	109993819	153	186	2561	3299	2408	3113	0.8225806451612904	0.7735303565692259
chr2	AC140479.3	110261431	110261513	5544	83	5544	1957	0	1874	66.79518072289157	0.0
chr2	AC140479.3	110262650	110262765	0	116	5544	1957	5544	1841	0.0	3.011406844106464
chr2	ACOXL	110908788	110908905	0	118	3948	8196	3948	8078	0.0	0.48873483535528595
chr2	ACOXL	110963623	110963713	0	91	3948	8196	3948	8105	0.0	0.48710672424429363
chr2	ACOXL	111031626	111031714	43	89	3948	8196	3905	8107	0.48314606741573035	0.4816824966078697
chr2	ACOXL	111049217	111049288	0	72	3948	8196	3948	8124	0.0	0.4859675036927622
chr2	BCL2L11	111142312	111142391	0	80	24	6670	24	6590	0.0	0.0036418816388467377
chr2	BCL2L11	111124049	111124139	0	91	24	6670	24	6579	0.0	0.00364797081623347
chr2	BCL2L11	111150043	111150147	0	105	24	6670	24	6565	0.0	0.0036557501904036557
chr2	BCL2L11	111153779	111153904	0	126	24	6670	24	6544	0.0	0.003667481662591687
chr2	BCL2L11	111151821	111151893	0	73	24	6670	24	6597	0.0	0.0036380172805820826
chr2	BCL2L11	111144487	111144520	0	34	24	6670	24	6636	0.0	0.003616636528028933
chr2	BCL2L11	111161418	111161550	0	133	24	6670	24	6537	0.0	0.0036714089031665903
chr2	BCL2L11	111130131	111130247	0	117	24	6670	24	6553	0.0	0.0036624446818251184
chr2	MERTK	111929119	111929540	481	422	10793	4566	10312	4144	1.1398104265402844	2.488416988416988
chr2	MERTK	111929119	111929304	430	186	10793	4566	10363	4380	2.3118279569892475	2.365981735159817
chr2	MERTK	112020603	112020654	45	52	10793	4566	10748	4514	0.8653846153846154	2.3810367744793974
chr2	TMEM87B	112074911	112074962	86	52	8179	5342	8093	5290	1.6538461538461537	1.5298676748582232
chr2	TMEM87B	112077191	112077282	0	92	8179	5342	8179	5250	0.0	1.557904761904762
chr2	FBLN7	112165000	112165171	0	172	22059	6590	22059	6418	0.0	3.4370520411343097
chr2	FBLN7	112181738	112181876	0	139	22059	6590	22059	6451	0.0	3.4194698496357154
chr2	POLR1B	112547011	112547179	587	169	36163	8624	35576	8455	3.473372781065089	4.207687758722649
chr2	POLR1B	112545830	112545922	3941	93	36163	8624	32222	8531	42.376344086021504	3.7770484116750676
chr2	POLR1B	112547082	112547179	561	98	36163	8624	35602	8526	5.724489795918367	4.175697865353038
chr2	SLC20A1	112652888	112652947	0	60	8906	4934	8906	4874	0.0	1.827246614690193
chr2	IL37	112913791	112913854	150	64	201	845	51	781	2.34375	0.06530089628681178
chr2	IL37	112917128	112917248	0	121	201	845	201	724	0.0	0.2776243093922652
chr2	IL36G	112979220	112979325	391	106	3374	1379	2983	1273	3.688679245283019	2.343283582089552
chr2	IL1RN	113121447	113121618	0	172	2143	3112	2143	2940	0.0	0.7289115646258504
chr2	IL1RN	113120065	113120128	0	64	2143	3112	2143	3048	0.0	0.7030839895013123
chr2	PSD4	113182345	113183512	0	1168	703	13128	703	11960	0.0	0.05877926421404682
chr2	PSD4	113198739	113198884	50	146	703	13128	653	12982	0.3424657534246575	0.05030041596056078
chr2	PAX8-AS1	113216155	113216362	0	208	54157	13369	54157	13161	0.0	4.114960869234861
chr2	PAX8-AS1	113250766	113250922	0	157	54157	13369	54157	13212	0.0	4.099076597033
chr2	PAX8-AS1	113259263	113259584	1493	322	54157	13369	52664	13047	4.636645962732919	4.036483482792979
chr2	PAX8-AS1	113238089	113238212	918	124	54157	13369	53239	13245	7.403225806451613	4.019554548886372
chr2	PAX8-AS1	113255389	113255549	879	161	54157	13369	53278	13208	5.459627329192546	4.033767413688674
chr2	PAX8-AS1	113236512	113236622	0	111	54157	13369	54157	13258	0.0	4.084854427515462
chr2	PAX8-AS1	113239088	113239424	255	337	54157	13369	53902	13032	0.7566765578635015	4.136126457949662
chr2	PAX8-AS1	113236512	113236613	0	102	54157	13369	54157	13267	0.0	4.08208336473958
chr2	PAX8-AS1	113235791	113236613	0	823	54157	13369	54157	12546	0.0	4.316674637334609
chr2	PAX8-AS1	113250766	113250906	0	141	54157	13369	54157	13228	0.0	4.094118536437859
chr2	PAX8-AS1	113270200	113270307	442	108	54157	13369	53715	13261	4.092592592592593	4.050599502299978
chr2	CBWD2	113471032	113471089	0	58	38189	6917	38189	6859	0.0	5.56772124216358
chr2	CBWD2	113455555	113455643	0	89	38189	6917	38189	6828	0.0	5.592999414176918
chr2	CBWD2	113439019	113439117	0	99	38189	6917	38189	6818	0.0	5.601202698738633
chr2	CBWD2	113457064	113457209	0	146	38189	6917	38189	6771	0.0	5.640082705656476
chr2	LINC01961	113513746	113513815	8625	70	8880	1904	255	1834	123.21428571428571	0.1390403489640131
chr2	RABL2A	113640893	113641005	0	113	153	4010	153	3897	0.0	0.03926096997690531
chr2	RABL2A	113635050	113635130	0	81	153	4010	153	3929	0.0	0.03894120641384576
chr2	RABL2A	113627855	113628010	0	156	153	4010	153	3854	0.0	0.03969901401141671
chr2	ACTR3	113913171	113913227	0	57	7793	11958	7793	11901	0.0	0.6548189227795983
chr2	ACTR3	113916883	113917008	0	126	7793	11958	7793	11832	0.0	0.6586375929682218
chr2	ACTR3	113927344	113927455	0	112	7793	11958	7793	11846	0.0	0.6578591929765322
chr2	LINC01191	113980186	113980404	0	219	35880	2946	35880	2727	0.0	13.157315731573158
chr2	DPP10	115050147	115050219	0	73	667	10071	667	9998	0.0	0.06671334266853371
chr2	DPP10	115309238	115309353	0	116	667	10071	667	9955	0.0	0.06700150678051231
chr2	DPP10	115579113	115579266	0	154	667	10071	667	9917	0.0	0.06725824342038923
chr2	AC009303.2	118008670	118008954	0	285	0	4017	0	3732	0.0	0.0
chr2	INSIG2	118107089	118107189	0	101	102	3957	102	3856	0.0	0.026452282157676348
chr2	INSIG2	118096418	118096800	0	383	102	3957	102	3574	0.0	0.028539451594851706
chr2	INSIG2	118096418	118096426	0	9	102	3957	102	3948	0.0	0.025835866261398176
chr2	MARCO	118944792	118944925	0	134	0	2097	0	1963	0.0	0.0
chr2	STEAP3	119239362	119239430	0	69	0	4570	0	4501	0.0	0.0
chr2	STEAP3	119230619	119231034	0	416	0	4570	0	4154	0.0	0.0
chr2	STEAP3	119257456	119257688	0	233	0	4570	0	4337	0.0	0.0
chr2	DBI	119367558	119367644	0	87	0	2515	0	2428	0.0	0.0
chr2	DBI	119367402	119367528	0	127	0	2515	0	2388	0.0	0.0
chr2	CFAP221	119549084	119549185	0	102	4978	9690	4978	9588	0.0	0.5191906549853984
chr2	CFAP221	119562013	119562114	0	102	4978	9690	4978	9588	0.0	0.5191906549853984
chr2	CFAP221	119602617	119602762	301	146	4978	9690	4677	9544	2.0616438356164384	0.490046102263202
chr2	CFAP221	119608501	119608589	176	89	4978	9690	4802	9601	1.9775280898876404	0.5001562337256535
chr2	CFAP221	119556036	119556239	0	204	4978	9690	4978	9486	0.0	0.5247733502002951
chr2	CFAP221	119545111	119545273	0	163	4978	9690	4978	9527	0.0	0.5225149574892411
chr2	CFAP221	119557007	119557405	0	399	4978	9690	4978	9291	0.0	0.5357873210633947
chr2	TMEM177	119680831	119681123	0	293	102	2591	102	2298	0.0	0.044386422976501305
chr2	PTPN4	119885794	119885882	0	89	85337	13306	85337	13217	0.0	6.456608912763865
chr2	PTPN4	119926597	119926666	0	70	85337	13306	85337	13236	0.0	6.447340586279843
chr2	PTPN4	119791154	119791272	0	119	85337	13306	85337	13187	0.0	6.471297489952225
chr2	EPB41L5	120167876	120168007	0	132	7623	9237	7623	9105	0.0	0.8372322899505766
chr2	EPB41L5	120167879	120168007	0	129	7623	9237	7623	9108	0.0	0.8369565217391305
chr2	RALB	120280834	120280907	0	74	0	2870	0	2796	0.0	0.0
chr2	GLI2	120927360	120927466	0	107	36197	7685	36197	7578	0.0	4.776590129321721
chr2	NIFK-AS1	121650300	121650381	0	82	0	4745	0	4663	0.0	0.0
chr2	TSN	121763004	121763084	0	81	0	4403	0	4322	0.0	0.0
chr2	TSN	121757239	121757333	0	95	0	4403	0	4308	0.0	0.0
chr2	TSN	121758709	121758806	0	98	0	4403	0	4305	0.0	0.0
chr2	TSN	121757239	121757434	0	196	0	4403	0	4207	0.0	0.0
chr2	LINC01823	121796240	121796720	0	481	0	3336	0	2855	0.0	0.0
chr2	LINC01823	121795549	121795627	0	79	0	3336	0	3257	0.0	0.0
chr2	LINC01823	121796554	121796720	0	167	0	3336	0	3169	0.0	0.0
chr2	LINC01823	121791392	121791503	0	112	0	3336	0	3224	0.0	0.0
chr2	LINC01823	121799481	121799619	0	139	0	3336	0	3197	0.0	0.0
chr2	LINC01823	121791130	121791453	0	324	0	3336	0	3012	0.0	0.0
chr2	GYPC	126690254	126690311	0	58	51	3616	51	3558	0.0	0.01433389544688027
chr2	GYPC	126685827	126686645	0	819	51	3616	51	2797	0.0	0.018233821952091528
chr2	TEX51	126899835	126899853	0	19	0	1165	0	1146	0.0	0.0
chr2	TEX51	126899935	126900019	0	85	0	1165	0	1080	0.0	0.0
chr2	TEX51	126901364	126901404	0	41	0	1165	0	1124	0.0	0.0
chr2	TEX51	126899798	126899853	0	56	0	1165	0	1109	0.0	0.0
chr2	AC010976.1	127482827	127482975	0	149	0	5506	0	5357	0.0	0.0
chr2	AC010976.1	127468013	127468126	0	114	0	5506	0	5392	0.0	0.0
chr2	AC010976.1	127467672	127467848	0	177	0	5506	0	5329	0.0	0.0
chr2	AC010976.1	127486419	127486517	0	99	0	5506	0	5407	0.0	0.0
chr2	AC010976.1	127470354	127470455	0	102	0	5506	0	5404	0.0	0.0
chr2	AC010976.1	127487984	127488146	0	163	0	5506	0	5343	0.0	0.0
chr2	AC010976.1	127482880	127482975	0	96	0	5506	0	5410	0.0	0.0
chr2	MYO7B	127612249	127612327	0	79	53	8008	53	7929	0.0	0.006684323369907933
chr2	GPR17	127648057	127648286	0	230	0	2675	0	2445	0.0	0.0
chr2	GPR17	127650010	127650075	0	66	0	2675	0	2609	0.0	0.0
chr2	UGGT1	128103078	128103145	0	68	11231	11392	11231	11324	0.0	0.9917873542917697
chr2	UGGT1	128156391	128156415	0	25	11231	11392	11231	11367	0.0	0.9880355414797221
chr2	MZT2B	130183786	130183966	0	181	0	1525	0	1344	0.0	0.0
chr2	MZT2B	130182626	130182775	0	150	0	1525	0	1375	0.0	0.0
chr2	IMP4	130345778	130345933	0	156	0	3208	0	3052	0.0	0.0
chr2	PTPN18	130356599	130356655	0	57	0	5060	0	5003	0.0	0.0
chr2	CFC1B	130523168	130523278	0	111	0	1675	0	1564	0.0	0.0
chr2	CFC1B	130522789	130522904	0	116	0	1675	0	1559	0.0	0.0
chr2	PRSS40A	130574276	130574551	0	276	0	4289	0	4013	0.0	0.0
chr2	FAR2P3	130695466	130695591	0	126	51	3745	51	3619	0.0	0.014092290688035369
chr2	FAR2P3	130695894	130696048	0	155	51	3745	51	3590	0.0	0.014206128133704735
chr2	FAR2P3	130695236	130695334	0	99	51	3745	51	3646	0.0	0.013987931980252331
chr2	ARHGEF4	131040260	131040440	0	181	70764	7454	70764	7273	0.0	9.729685136807369
chr2	PLEKHB2	131144407	131144449	0	43	206281	6740	206281	6697	0.0	30.80200089592355
chr2	PLEKHB2	131140169	131140275	22	107	206281	6740	206259	6633	0.205607476635514	31.0958842152872
chr2	PLEKHB2	131140166	131140275	22	110	206281	6740	206259	6630	0.2	31.109954751131223
chr2	POTEE	131236731	131236802	0	72	102	4207	102	4135	0.0	0.024667472793228538
chr2	POTEE	131252525	131252570	0	46	102	4207	102	4161	0.0	0.024513338139870222
chr2	POTEE	131238193	131238238	0	46	102	4207	102	4161	0.0	0.024513338139870222
chr2	SMPD4BP	131519813	131519942	0	130	0	3933	0	3803	0.0	0.0
chr2	CCDC74A	131532588	131532781	0	194	51	3085	51	2891	0.0	0.01764095468695953
chr2	CCDC74A	131528492	131528627	0	136	51	3085	51	2949	0.0	0.017293997965412006
chr2	CCDC74A	131532709	131532781	0	73	51	3085	51	3012	0.0	0.01693227091633466
chr2	C2ORF27A	131733832	131733952	0	121	51	7103	51	6982	0.0	0.0073044972787167
chr2	C2ORF27A	131689138	131689352	0	215	51	7103	51	6888	0.0	0.007404181184668989
chr2	C2ORF27A	131728071	131728210	0	140	51	7103	51	6963	0.0	0.007324429125376993
chr2	C2ORF27A	131736539	131736686	0	148	51	7103	51	6955	0.0	0.007332854061826024
chr2	ZNF806	132307143	132307186	0	44	0	5166	0	5122	0.0	0.0
chr2	ACMSD	134861968	134862018	0	51	51	2727	51	2676	0.0	0.01905829596412556
chr2	ACMSD	134844364	134844471	0	108	51	2727	51	2619	0.0	0.019473081328751432
chr2	CCNT2	134945888	134945975	0	88	561	8883	561	8795	0.0	0.06378624218305856
chr2	CCNT2	134942611	134942674	0	64	561	8883	561	8819	0.0	0.0636126544959746
chr2	CCNT2	134945786	134945982	0	197	561	8883	561	8686	0.0	0.06458669122726227
chr2	RAB3GAP1	135167692	135167713	0	22	19139	5651	19139	5629	0.0	3.4000710605791435
chr2	R3HDM1	135565736	135565925	0	190	2745	7930	2745	7740	0.0	0.3546511627906977
chr2	R3HDM1	135604805	135605016	0	212	2745	7930	2745	7718	0.0	0.35566208862399584
chr2	R3HDM1	135622653	135622732	1020	80	2745	7930	1725	7850	12.75	0.2197452229299363
chr2	R3HDM1	135715549	135715694	11	146	2745	7930	2734	7784	0.07534246575342465	0.3512332990750257
chr2	R3HDM1	135616151	135616193	0	43	2745	7930	2745	7887	0.0	0.3480410802586535
chr2	R3HDM1	135641535	135641790	0	256	2745	7930	2745	7674	0.0	0.3577013291634089
chr2	R3HDM1	135568757	135568809	0	53	2745	7930	2745	7877	0.0	0.34848292497143585
chr2	R3HDM1	135616667	135616757	0	91	2745	7930	2745	7839	0.0	0.35017221584385766
chr2	R3HDM1	135641535	135641604	0	70	2745	7930	2745	7860	0.0	0.34923664122137404
chr2	R3HDM1	135649901	135650003	0	103	2745	7930	2745	7827	0.0	0.350709083940207
chr2	UBXN4	135747657	135747765	0	109	51	4422	51	4313	0.0	0.011824715974959425
chr2	UBXN4	135761817	135761911	0	95	51	4422	51	4327	0.0	0.011786457129651028
chr2	UBXN4	135753538	135754277	0	740	51	4422	51	3682	0.0	0.013851167843563281
chr2	DARS-AS1	136008866	136009073	44	208	3985	5976	3941	5768	0.21153846153846154	0.683252427184466
chr2	DARS-AS1	135997122	135997242	0	121	3985	5976	3985	5855	0.0	0.6806148590947908
chr2	DARS-AS1	135996191	135996408	0	218	3985	5976	3985	5758	0.0	0.69208058353595
chr2	DARS-AS1	136002000	136002126	0	127	3985	5976	3985	5849	0.0	0.6813130449649513
chr2	DARS-AS1	136003269	136003367	7	99	3985	5976	3978	5877	0.0707070707070707	0.6768759571209801
chr2	DARS-AS1	136003742	136003822	0	81	3985	5976	3985	5895	0.0	0.6759966072943172
chr2	DARS-AS1	136007195	136007583	221	389	3985	5976	3764	5587	0.5681233933161953	0.6737068194021837
chr2	DARS-AS1	136014655	136014762	0	108	3985	5976	3985	5868	0.0	0.679107021131561
chr2	DARS-AS1	136016266	136016346	0	81	3985	5976	3985	5895	0.0	0.6759966072943172
chr2	DARS-AS1	136012849	136012982	0	134	3985	5976	3985	5842	0.0	0.6821294077370763
chr2	DARS-AS1	136003244	136003367	7	124	3985	5976	3978	5852	0.056451612903225805	0.6797676008202324
chr2	DARS-AS1	136014048	136014134	0	87	3985	5976	3985	5889	0.0	0.6766853455595178
chr2	THSD7B	136906447	136906566	0	120	0	6794	0	6674	0.0	0.0
chr2	HNMT	137970164	137970217	0	54	0	4769	0	4715	0.0	0.0
chr2	SPOPL	138554438	138554535	0	98	0	6511	0	6413	0.0	0.0
chr2	KYNU	142918608	142918729	0	122	0	17465	0	17343	0.0	0.0
chr2	KYNU	142881344	142881430	0	87	0	17465	0	17378	0.0	0.0
chr2	KYNU	142879462	142879666	0	205	0	17465	0	17260	0.0	0.0
chr2	KYNU	142954021	142954067	0	47	0	17465	0	17418	0.0	0.0
chr2	ARHGAP15	143587685	143587817	0	133	51	6138	51	6005	0.0	0.008492922564529558
chr2	ZEB2-AS1	144519958	144520110	0	153	0	2254	0	2101	0.0	0.0
chr2	ZEB2-AS1	144519835	144520110	0	276	0	2254	0	1978	0.0	0.0
chr2	ZEB2-AS1	144518751	144518861	0	111	0	2254	0	2143	0.0	0.0
chr2	ZEB2-AS1	144519510	144520110	0	601	0	2254	0	1653	0.0	0.0
chr2	TEX41	144766369	144766530	0	162	7612	26381	7612	26219	0.0	0.29032381097677257
chr2	TEX41	144691038	144691110	0	73	7612	26381	7612	26308	0.0	0.2893416451269576
chr2	TEX41	144903665	144903803	0	139	7612	26381	7612	26242	0.0	0.2900693544699337
chr2	TEX41	145171997	145172131	80	135	7612	26381	7532	26246	0.5925925925925926	0.2869770631715309
chr2	TEX41	145057650	145057728	0	79	7612	26381	7612	26302	0.0	0.2894076496083948
chr2	TEX41	144763396	144763528	52	133	7612	26381	7560	26248	0.39097744360902253	0.28802194452910695
chr2	TEX41	144780973	144781258	0	286	7612	26381	7612	26095	0.0	0.2917033914543016
chr2	TEX41	144809307	144809414	0	108	7612	26381	7612	26273	0.0	0.28972709625851634
chr2	TEX41	144753114	144753205	0	92	7612	26381	7612	26289	0.0	0.28955076267640456
chr2	TEX41	144851044	144851158	0	115	7612	26381	7612	26266	0.0	0.2898043097540547
chr2	TEX41	144671606	144671664	0	59	7612	26381	7612	26322	0.0	0.289187751690601
chr2	TEX41	144863944	144863998	0	55	7612	26381	7612	26326	0.0	0.28914381220086605
chr2	TEX41	144940857	144940945	0	89	7612	26381	7612	26292	0.0	0.28951772402251635
chr2	TEX41	145070819	145070941	0	123	7612	26381	7612	26258	0.0	0.2898926041587326
chr2	TEX41	144768097	144768280	0	184	7612	26381	7612	26197	0.0	0.29056762224682214
chr2	TEX41	145113220	145113443	0	224	7612	26381	7612	26157	0.0	0.2910119662040754
chr2	TEX41	145164172	145164312	0	141	7612	26381	7612	26240	0.0	0.29009146341463415
chr2	TEX41	145181009	145181112	0	104	7612	26381	7612	26277	0.0	0.2896829927312859
chr2	TEX41	145016367	145016523	0	157	7612	26381	7612	26224	0.0	0.2902684563758389
chr2	TEX41	145171997	145172088	51	92	7612	26381	7561	26289	0.5543478260869565	0.28761078778196203
chr2	TEX41	145117555	145117653	0	99	7612	26381	7612	26282	0.0	0.28962788220074576
chr2	TEX41	144671601	144671664	0	64	7612	26381	7612	26317	0.0	0.28924269483603754
chr2	TEX41	145182045	145182093	0	49	7612	26381	7612	26332	0.0	0.28907792799635423
chr2	TEX41	144935343	144935483	0	141	7612	26381	7612	26240	0.0	0.29009146341463415
chr2	TEX41	144953174	144953292	0	119	7612	26381	7612	26262	0.0	0.2898484502322748
chr2	TEX41	144673486	144673605	0	120	7612	26381	7612	26261	0.0	0.2898594874528769
chr2	TEX41	144865394	144865460	0	67	7612	26381	7612	26314	0.0	0.2892756707456107
chr2	TEX41	145017531	145017611	0	81	7612	26381	7612	26300	0.0	0.28942965779467683
chr2	TEX41	145043886	145044067	0	182	7612	26381	7612	26199	0.0	0.2905454406656743
chr2	TEX41	145178876	145178967	0	92	7612	26381	7612	26289	0.0	0.28955076267640456
chr2	TEX41	145174889	145174996	0	108	7612	26381	7612	26273	0.0	0.28972709625851634
chr2	TEX41	145116412	145116821	0	410	7612	26381	7612	25971	0.0	0.29309614570097414
chr2	TEX41	145174889	145174992	0	104	7612	26381	7612	26277	0.0	0.2896829927312859
chr2	TEX41	145072523	145072823	0	301	7612	26381	7612	26080	0.0	0.29187116564417176
chr2	TEX41	145174886	145174992	0	107	7612	26381	7612	26274	0.0	0.289716069117759
chr2	TEX41	145090830	145090903	0	74	7612	26381	7612	26307	0.0	0.28935264378302356
chr2	TEX41	145116412	145116510	0	99	7612	26381	7612	26282	0.0	0.28962788220074576
chr2	TEX41	145043886	145044011	0	126	7612	26381	7612	26255	0.0	0.2899257284326795
chr2	TEX41	145034793	145034885	0	93	7612	26381	7612	26288	0.0	0.289561777236762
chr2	TEX41	145043625	145043775	0	151	7612	26381	7612	26230	0.0	0.29020205871139915
chr2	TEX41	145044365	145044463	0	99	7612	26381	7612	26282	0.0	0.28962788220074576
chr2	TEX41	145143033	145143181	1885	149	7612	26381	5727	26232	12.651006711409396	0.21832113449222323
chr2	TEX41	145178732	145178967	0	236	7612	26381	7612	26145	0.0	0.29114553451902847
chr2	TEX41	145072523	145072646	0	124	7612	26381	7612	26257	0.0	0.2899036447423544
chr2	TEX41	145181196	145181293	0	98	7612	26381	7612	26283	0.0	0.2896168626108131
chr2	TEX41	145224886	145224972	0	87	7612	26381	7612	26294	0.0	0.28949570244162165
chr2	LINC01911	146838630	146838745	0	116	0	3576	0	3460	0.0	0.0
chr2	LINC01911	146846628	146846818	0	191	0	3576	0	3385	0.0	0.0
chr2	LINC01911	146848248	146848411	0	164	0	3576	0	3412	0.0	0.0
chr2	LINC01911	146858511	146858644	0	134	0	3576	0	3442	0.0	0.0
chr2	LINC01911	146846751	146846818	0	68	0	3576	0	3508	0.0	0.0
chr2	LINC01911	146856647	146856807	0	161	0	3576	0	3415	0.0	0.0
chr2	LINC01911	146859537	146859601	0	65	0	3576	0	3511	0.0	0.0
chr2	LINC01911	146857978	146858111	0	134	0	3576	0	3442	0.0	0.0
chr2	LINC01911	146853870	146853954	0	85	0	3576	0	3491	0.0	0.0
chr2	ACVR2A	147845073	147845207	0	135	0	6398	0	6263	0.0	0.0
chr2	MBD5	148021647	148021684	0	38	102	23435	102	23397	0.0	0.004359533273496602
chr2	MBD5	148233244	148233395	0	152	102	23435	102	23283	0.0	0.004380878752738049
chr2	MBD5	148489385	148490594	102	1210	102	23435	0	22225	0.08429752066115702	0.0
chr2	MBD5	148447566	148447740	0	175	102	23435	102	23260	0.0	0.0043852106620808256
chr2	MBD5	148489385	148489500	0	116	102	23435	102	23319	0.0	0.004374115528110125
chr2	MBD5	148489385	148490787	102	1403	102	23435	0	22032	0.07270135424091233	0.0
chr2	KIF5C	148978921	148978990	0	70	2422	31919	2422	31849	0.0	0.07604634368426011
chr2	KIF5C	148997263	148997340	0	78	2422	31919	2422	31841	0.0	0.07606545020570962
chr2	KIF5C	149005392	149005464	0	73	2422	31919	2422	31846	0.0	0.07605350750486717
chr2	KIF5C	149008471	149008661	0	191	2422	31919	2422	31728	0.0	0.0763363590519415
chr2	KIF5C	149020175	149020382	0	208	2422	31919	2422	31711	0.0	0.07637728233105232
chr2	KIF5C	148952497	148952558	0	62	2422	31919	2422	31857	0.0	0.07602724675895407
chr2	LYPD6B	149160763	149160835	51	73	102	3562	51	3489	0.6986301369863014	0.014617368873602751
chr2	LYPD6B	149206018	149206195	0	178	102	3562	102	3384	0.0	0.030141843971631204
chr2	LYPD6	149464163	149464475	0	313	1497	4983	1497	4670	0.0	0.3205567451820128
chr2	LYPD6	149370519	149370617	0	99	1497	4983	1497	4884	0.0	0.30651105651105653
chr2	LINC01818	150326192	150326354	0	163	0	1773	0	1610	0.0	0.0
chr2	LINC02612	150629639	150629714	0	76	0	3285	0	3209	0.0	0.0
chr2	LINC02612	150629430	150629582	0	153	0	3285	0	3132	0.0	0.0
chr2	RIF1	151410413	151410527	0	115	0	13734	0	13619	0.0	0.0
chr2	RIF1	151468473	151468551	0	79	0	13734	0	13655	0.0	0.0
chr2	FMNL2	152622536	152622557	0	22	11671	6602	11671	6580	0.0	1.77370820668693
chr2	FMNL2	152643418	152643544	0	127	11671	6602	11671	6475	0.0	1.8024710424710424
chr2	ARL6IP6	152732530	152732580	0	51	0	3875	0	3824	0.0	0.0
chr2	ARL6IP6	152719897	152720004	0	108	0	3875	0	3767	0.0	0.0
chr2	GALNT13	154408983	154409082	0	100	51	6628	51	6528	0.0	0.0078125
chr2	GALNT13	153926287	153926339	0	53	51	6628	51	6575	0.0	0.007756653992395437
chr2	GALNT13	154446597	154446765	0	169	51	6628	51	6459	0.0	0.007895959126799815
chr2	GALNT13	154236045	154236180	0	136	51	6628	51	6492	0.0	0.007855822550831794
chr2	GALNT13	154446567	154446765	0	199	51	6628	51	6429	0.0	0.007932804479701353
chr2	KCNJ3	154709602	154709819	0	218	0	4912	0	4694	0.0	0.0
chr2	AC073225.1	155544224	155544329	0	106	102	17123	102	17017	0.0	0.005994005994005994
chr2	AC073225.1	155560440	155560542	0	103	102	17123	102	17020	0.0	0.005992949471210341
chr2	AC073225.1	155626640	155626788	0	149	102	17123	102	16974	0.0	0.006009190526687876
chr2	AC073225.1	155541659	155541739	0	81	102	17123	102	17042	0.0	0.005985213003168642
chr2	AC073225.1	155588816	155588966	0	151	102	17123	102	16972	0.0	0.0060098986566108886
chr2	AC073225.1	155608214	155608419	0	206	102	17123	102	16917	0.0	0.006029437843589289
chr2	AC073225.1	155608251	155608419	0	169	102	17123	102	16954	0.0	0.0060162793441075856
chr2	AC073225.1	155547296	155547356	0	61	102	17123	102	17062	0.0	0.0059781971632868365
chr2	GPD2	156495561	156495691	0	131	0	7188	0	7057	0.0	0.0
chr2	PKP4	158577270	158577383	91	114	576	8907	485	8793	0.7982456140350878	0.055157511656999884
chr2	PKP4	158676738	158676867	0	130	576	8907	576	8777	0.0	0.06562606813261934
chr2	PKP4	158533437	158533534	0	98	576	8907	576	8809	0.0	0.06538767169939834
chr2	PKP4	158533179	158533316	0	138	576	8907	576	8769	0.0	0.06568593910366062
chr2	DAPL1	158807671	158807790	0	120	28	1333	28	1213	0.0	0.023083264633140973
chr2	AC008277.1	159396476	159396536	0	61	0	1519	0	1458	0.0	0.0
chr2	MARCHF7	159745769	159745937	0	169	51	6301	51	6132	0.0	0.008317025440313111
chr2	MARCHF7	159747804	159748903	0	1100	51	6301	51	5201	0.0	0.009805806575658528
chr2	MARCHF7	159764625	159764674	0	50	51	6301	51	6251	0.0	0.008158694608862581
chr2	MARCHF7	159715680	159715766	0	87	51	6301	51	6214	0.0	0.008207273897650467
chr2	TANK	161230970	161231551	0	582	4044	5607	4044	5025	0.0	0.8047761194029851
chr2	TANK	161161284	161161412	0	129	4044	5607	4044	5478	0.0	0.7382256297918949
chr2	TANK	161202862	161202979	0	118	4044	5607	4044	5489	0.0	0.7367462197121516
chr2	TANK	161216388	161216442	0	55	4044	5607	4044	5552	0.0	0.728386167146974
chr2	TANK	161232732	161232809	0	78	4044	5607	4044	5529	0.0	0.7314161692892024
chr2	TANK	161232794	161232897	0	104	4044	5607	4044	5503	0.0	0.7348718880610576
chr2	TANK	161232755	161232809	0	55	4044	5607	4044	5552	0.0	0.728386167146974
chr2	LINC01806	161245423	161245467	0	45	204	2493	204	2448	0.0	0.08333333333333333
chr2	SLC4A10	161452122	161452193	0	72	124	7588	124	7516	0.0	0.016498137307078234
chr2	SLC4A10	161622228	161622371	0	144	124	7588	124	7444	0.0	0.016657710908113917
chr2	SLC4A10	161708693	161708829	22	137	124	7588	102	7451	0.16058394160583941	0.013689437659374581
chr2	SLC4A10	161977721	161977760	0	40	124	7588	124	7548	0.0	0.016428192898781134
chr2	SLC4A10	161873915	161874005	0	91	124	7588	124	7497	0.0	0.016539949313058556
chr2	SLC4A10	161902027	161902164	0	138	124	7588	124	7450	0.0	0.01664429530201342
chr2	GCA	162346581	162346665	0	85	125988	5335	125988	5250	0.0	23.997714285714284
chr2	AC019197.1	164912313	164912435	0	123	51	10285	51	10162	0.0	0.0050186971068687265
chr2	AC019197.1	164959054	164959143	0	90	51	10285	51	10195	0.0	0.005002452182442374
chr2	AC019197.1	164956764	164956795	0	32	51	10285	51	10253	0.0	0.004974153906173803
chr2	AC019197.1	164922077	164922288	0	212	51	10285	51	10073	0.0	0.005063039809391443
chr2	SCN2A	165308665	165308794	0	130	0	23956	0	23826	0.0	0.0
chr2	SCN2A	165327154	165327202	0	49	0	23956	0	23907	0.0	0.0
chr2	SCN2A	165245329	165245448	0	120	0	23956	0	23836	0.0	0.0
chr2	SCN2A	165290629	165290785	0	157	0	23956	0	23799	0.0	0.0
chr2	SCN2A	165320239	165320364	0	126	0	23956	0	23830	0.0	0.0
chr2	SCN2A	165328403	165328538	0	136	0	23956	0	23820	0.0	0.0
chr2	SCN2A	165357773	165357857	0	85	0	23956	0	23871	0.0	0.0
chr2	SCN2A	165349900	165350208	0	309	0	23956	0	23647	0.0	0.0
chr2	SCN2A	165350081	165350208	0	128	0	23956	0	23828	0.0	0.0
chr2	TTC21B-AS1	165934733	165934789	0	57	0	2563	0	2506	0.0	0.0
chr2	SCN1A-AS1	166104246	166104348	0	103	0	18935	0	18832	0.0	0.0
chr2	SCN1A-AS1	166109490	166109602	0	113	0	18935	0	18822	0.0	0.0
chr2	SCN1A-AS1	166027116	166027229	0	114	0	18935	0	18821	0.0	0.0
chr2	SCN1A-AS1	166036065	166036130	0	66	0	18935	0	18869	0.0	0.0
chr2	SCN1A-AS1	166249342	166249384	0	43	0	18935	0	18892	0.0	0.0
chr2	SCN1A-AS1	166277087	166277247	0	161	0	18935	0	18774	0.0	0.0
chr2	SCN1A-AS1	166012840	166012966	0	127	0	18935	0	18808	0.0	0.0
chr2	SCN1A-AS1	165984616	165984776	0	161	0	18935	0	18774	0.0	0.0
chr2	SCN1A-AS1	166059402	166059524	0	123	0	18935	0	18812	0.0	0.0
chr2	SCN1A-AS1	166137542	166137635	0	94	0	18935	0	18841	0.0	0.0
chr2	SCN1A-AS1	166133821	166133908	0	88	0	18935	0	18847	0.0	0.0
chr2	SCN1A-AS1	166171386	166171558	0	173	0	18935	0	18762	0.0	0.0
chr2	SCN1A-AS1	166263711	166263806	0	96	0	18935	0	18839	0.0	0.0
chr2	XIRP2	167242568	167251947	204	9380	0	7238	-204	-2142	0.021748400852878463	0.09523809523809523
chr2	XIRP2	167184541	167184640	0	100	0	7238	0	7138	0.0	0.0
chr2	CERS6	168766321	168766345	0	25	0	6862	0	6837	0.0	0.0
chr2	NOSTRIN	168811566	168811652	3307	87	35356	4668	32049	4581	38.01149425287356	6.99607072691552
chr2	NOSTRIN	168824633	168824717	0	85	35356	4668	35356	4583	0.0	7.714597425267292
chr2	NOSTRIN	168850835	168851006	0	172	35356	4668	35356	4496	0.0	7.8638790035587185
chr2	NOSTRIN	168818171	168818296	204	126	35356	4668	35152	4542	1.619047619047619	7.739321884632321
chr2	NOSTRIN	168855885	168856210	11	326	35356	4668	35345	4342	0.03374233128834356	8.140257945647168
chr2	G6PC2	168902444	168902554	0	111	0	3080	0	2969	0.0	0.0
chr2	G6PC2	168906663	168906779	0	117	0	3080	0	2963	0.0	0.0
chr2	DHRS9	169069452	169069717	0	266	0	3762	0	3496	0.0	0.0
chr2	DHRS9	169081050	169081152	0	103	0	3762	0	3659	0.0	0.0
chr2	DHRS9	169072574	169072685	0	112	0	3762	0	3650	0.0	0.0
chr2	DHRS9	169074254	169074466	0	213	0	3762	0	3549	0.0	0.0
chr2	BBS5	169497626	169497689	0	64	0	4221	0	4157	0.0	0.0
chr2	PPIG	169607103	169607148	0	46	23817	10326	23817	10280	0.0	2.3168287937743193
chr2	PPIG	169603641	169603694	0	54	23817	10326	23817	10272	0.0	2.3186331775700935
chr2	PPIG	169631598	169631647	3428	50	23817	10326	20389	10276	68.56	1.9841377968080964
chr2	PHOSPHO2	169697864	169697982	58	119	422	1494	364	1375	0.48739495798319327	0.2647272727272727
chr2	PHOSPHO2	169697360	169697531	141	172	422	1494	281	1322	0.8197674418604651	0.21255673222390317
chr2	PHOSPHO2	169697892	169697982	46	91	422	1494	376	1403	0.5054945054945055	0.26799714896650034
chr2	KLHL23	169735012	169736227	0	1216	26368	5523	26368	4307	0.0	6.12212677037381
chr2	SSB	169800951	169801026	0	76	0	4642	0	4566	0.0	0.0
chr2	SSB	169805997	169806113	0	117	0	4642	0	4525	0.0	0.0
chr2	UBR3	170055459	170055584	0	126	0	9972	0	9846	0.0	0.0
chr2	UBR3	170014814	170014865	0	52	0	9972	0	9920	0.0	0.0
chr2	UBR3	170016832	170016919	0	88	0	9972	0	9884	0.0	0.0
chr2	UBR3	170013840	170013972	0	133	0	9972	0	9839	0.0	0.0
chr2	MYO3B	170214728	170214828	0	101	28772	8275	28772	8174	0.0	3.5199412772204552
chr2	MYO3B	170501784	170501865	0	82	28772	8275	28772	8193	0.0	3.511778347369706
chr2	MYO3B	170646908	170646939	0	32	28772	8275	28772	8243	0.0	3.4904767681669293
chr2	AC007405.3	170777146	170777177	0	32	4593	2602	4593	2570	0.0	1.78715953307393
chr2	AC007405.3	170777376	170777425	0	50	4593	2602	4593	2552	0.0	1.7997648902821317
chr2	AC007405.3	170775652	170775719	258	68	4593	2602	4335	2534	3.7941176470588234	1.7107340173638517
chr2	GAD1	170844044	170844157	0	114	613	7161	613	7047	0.0	0.08698737051227473
chr2	GAD1	170848682	170848794	1	113	613	7161	612	7048	0.008849557522123894	0.08683314415437003
chr2	GAD1	170842568	170842648	0	81	613	7161	613	7080	0.0	0.0865819209039548
chr2	GORASP2	170929816	170929941	248	126	543	4718	295	4592	1.9682539682539681	0.06424216027874564
chr2	GORASP2	170929740	170929941	248	202	543	4718	295	4516	1.2277227722772277	0.06532329495128432
chr2	GORASP2	170936623	170936727	0	105	543	4718	543	4613	0.0	0.11771081725558205
chr2	DCAF17	171457970	171458075	87	106	380	7673	293	7567	0.8207547169811321	0.03872076119994714
chr2	DCAF17	171435082	171435186	0	105	380	7673	380	7568	0.0	0.05021141649048626
chr2	DCAF17	171458371	171458477	0	107	380	7673	380	7566	0.0	0.050224689399947134
chr2	DCAF17	171447385	171447503	0	119	380	7673	380	7554	0.0	0.05030447445062219
chr2	CYBRD1	171541584	171541793	0	210	51	5181	51	4971	0.0	0.010259505129752565
chr2	DYNC1I2	171712766	171712826	0	61	6878	5857	6878	5796	0.0	1.186680469289165
chr2	DYNC1I2	171707286	171707377	0	92	6878	5857	6878	5765	0.0	1.1930615784908933
chr2	DYNC1I2	171706546	171706564	0	19	6878	5857	6878	5838	0.0	1.1781431997259335
chr2	DYNC1I2	171707232	171707377	0	146	6878	5857	6878	5711	0.0	1.2043424969357381
chr2	DYNC1I2	171688470	171688648	0	179	6878	5857	6878	5678	0.0	1.2113420218386757
chr2	HAT1	171946707	171946783	0	77	1173	5990	1173	5913	0.0	0.19837645865043124
chr2	HAT1	171952880	171953001	0	122	1173	5990	1173	5868	0.0	0.19989775051124745
chr2	METAP1D	172065603	172065752	0	150	0	4501	0	4351	0.0	0.0
chr2	DLX1	172086653	172086853	0	201	266	3575	266	3374	0.0	0.07883817427385892
chr2	ITGA6	172489484	172489658	0	175	0	6738	0	6563	0.0	0.0
chr2	ITGA6	172501771	172501901	0	131	0	6738	0	6607	0.0	0.0
chr2	ITGA6	172470973	172471105	0	133	0	6738	0	6605	0.0	0.0
chr2	ITGA6	172472773	172472890	0	118	0	6738	0	6620	0.0	0.0
chr2	PDK1	172562219	172562291	0	73	140295	13131	140295	13058	0.0	10.743988359626282
chr2	PDK1	172564502	172564687	0	186	140295	13131	140295	12945	0.0	10.837775202780996
chr2	PDK1	172564051	172564130	0	80	140295	13131	140295	13051	0.0	10.749750976936634
chr2	PDK1	172562740	172562800	49	61	140295	13131	140246	13070	0.8032786885245902	10.730374904361133
chr2	PDK1	172568740	172568817	0	78	140295	13131	140295	13053	0.0	10.74810388416456
chr2	RAPGEF4	172960759	172960813	0	55	61870	6589	61870	6534	0.0	9.468931741659015
chr2	MAP3K20	173090997	173091190	0	194	86	13829	86	13635	0.0	0.006307297396406307
chr2	CDCA7	173358711	173358837	0	127	59861	3208	59861	3081	0.0	19.42908146705615
chr2	CDCA7	173366282	173366432	204	151	59861	3208	59657	3057	1.3509933774834437	19.51488387307818
chr2	CDCA7	173359386	173359491	80	106	59861	3208	59781	3102	0.7547169811320755	19.271760154738878
chr2	CDCA7	173359254	173359491	182	238	59861	3208	59679	2970	0.7647058823529411	20.093939393939394
chr2	CDCA7	173359342	173359491	154	150	59861	3208	59707	3058	1.0266666666666666	19.52485284499673
chr2	CDCA7	173363999	173364161	86	163	59861	3208	59775	3045	0.5276073619631901	19.63054187192118
chr2	SCRN3	174398274	174398442	0	169	224	4074	224	3905	0.0	0.05736235595390525
chr2	SCRN3	174400989	174401189	0	201	224	4074	224	3873	0.0	0.057836302607797575
chr2	SCRN3	174397335	174397404	0	70	224	4074	224	4004	0.0	0.055944055944055944
chr2	SCRN3	174398365	174398442	0	78	224	4074	224	3996	0.0	0.056056056056056056
chr2	SCRN3	174422884	174423047	0	164	224	4074	224	3910	0.0	0.05728900255754476
chr2	AC093459.1	175291392	175291501	0	110	0	1580	0	1470	0.0	0.0
chr2	AC093459.1	175442447	175442981	0	535	0	1580	0	1045	0.0	0.0
chr2	AC093459.1	175454607	175454684	0	78	0	1580	0	1502	0.0	0.0
chr2	HOXD10	176111382	176111516	0	135	0	2492	0	2357	0.0	0.0
chr2	MTX2	176270215	176270419	0	205	0	1729	0	1524	0.0	0.0
chr2	MTX2	176304240	176304365	0	126	0	1729	0	1603	0.0	0.0
chr2	HNRNPA3	177216502	177216592	0	91	132	6245	132	6154	0.0	0.021449463763405913
chr2	HNRNPA3	177217704	177217845	0	142	132	6245	132	6103	0.0	0.02162870719318368
chr2	HNRNPA3	177219407	177221976	0	2570	132	6245	132	3675	0.0	0.035918367346938776
chr2	AGPS	177551362	177551582	0	221	0	8861	0	8640	0.0	0.0
chr2	PDE11A-AS1	177701093	177701228	0	136	0	1847	0	1711	0.0	0.0
chr2	OSBPL6	178344285	178344360	0	76	18775	11517	18775	11441	0.0	1.6410278821781312
chr2	OSBPL6	178372125	178372233	0	109	18775	11517	18775	11408	0.0	1.6457748948106592
chr2	OSBPL6	178339671	178339764	0	94	18775	11517	18775	11423	0.0	1.643613761708833
chr2	CHROMR	178426365	178426661	0	297	11271	7002	11271	6705	0.0	1.6809843400447426
chr2	CHROMR	178426365	178426680	0	316	11271	7002	11271	6686	0.0	1.6857612922524678
chr2	CHROMR	178426365	178426505	0	141	11271	7002	11271	6861	0.0	1.6427634455618714
chr2	CHROMR	178415817	178415963	6833	147	11271	7002	4438	6855	46.48299319727891	0.6474106491611962
chr2	CHROMR	178426365	178426703	0	339	11271	7002	11271	6663	0.0	1.6915803692030618
chr2	PJVK	178454104	178454205	0	102	0	3976	0	3874	0.0	0.0
chr2	PJVK	178458509	178458627	0	119	0	3976	0	3857	0.0	0.0
chr2	PJVK	178460347	178460446	0	100	0	3976	0	3876	0.0	0.0
chr2	PJVK	178452457	178452569	0	113	0	3976	0	3863	0.0	0.0
chr2	PJVK	178459192	178459269	0	78	0	3976	0	3898	0.0	0.0
chr2	PJVK	178460347	178460420	0	74	0	3976	0	3902	0.0	0.0
chr2	PLEKHA3	178488967	178489014	0	48	4295	14216	4295	14168	0.0	0.30314793901750425
chr2	PLEKHA3	178502335	178502483	0	149	4295	14216	4295	14067	0.0	0.3053245183763418
chr2	TTN-AS1	178538697	178539890	0	1194	51	21966	51	20772	0.0	0.002455228191796649
chr2	TTN-AS1	178582990	178583181	0	192	51	21966	51	21774	0.0	0.002342243042160375
chr2	TTN-AS1	178591138	178591314	0	177	51	21966	51	21789	0.0	0.0023406305934186977
chr2	TTN-AS1	178598555	178598673	0	119	51	21966	51	21847	0.0	0.002334416624708198
chr2	TTN-AS1	178528723	178528813	0	91	51	21966	51	21875	0.0	0.0023314285714285715
chr2	TTN-AS1	178531313	178531578	0	266	51	21966	51	21700	0.0	0.002350230414746544
chr2	TTN-AS1	178599593	178599750	0	158	51	21966	51	21808	0.0	0.002338591342626559
chr2	TTN-AS1	178535731	178535828	0	98	51	21966	51	21868	0.0	0.002332174867386135
chr2	TTN-AS1	178756265	178756322	0	58	51	21966	51	21908	0.0	0.0023279167427423773
chr2	TTN-AS1	178571299	178571449	0	151	51	21966	51	21815	0.0	0.002337840935136374
chr2	TTN-AS1	178537603	178537691	0	89	51	21966	51	21877	0.0	0.002331215431731956
chr2	TTN-AS1	178737321	178737443	0	123	51	21966	51	21843	0.0	0.002334844114819393
chr2	TTN-AS1	178778711	178778755	0	45	51	21966	51	21921	0.0	0.002326536198166142
chr2	TTN-AS1	178583712	178583921	0	210	51	21966	51	21756	0.0	0.002344180915609487
chr2	TTN-AS1	178584572	178584993	0	422	51	21966	51	21544	0.0	0.0023672484218343853
chr2	TTN-AS1	178600557	178600667	0	111	51	21966	51	21855	0.0	0.0023335621139327386
chr2	TTN-AS1	178675992	178676105	0	114	51	21966	51	21852	0.0	0.0023338824821526635
chr2	TTN-AS1	178777857	178778755	0	899	51	21966	51	21067	0.0	0.0024208477713960224
chr2	TTN-AS1	178524086	178524223	0	138	51	21966	51	21828	0.0	0.002336448598130841
chr2	TTN-AS1	178536333	178536462	0	130	51	21966	51	21836	0.0	0.002335592599377175
chr2	TTN-AS1	178537360	178537447	0	88	51	21966	51	21878	0.0	0.0023311088764969377
chr2	TTN-AS1	178529284	178529336	0	53	51	21966	51	21913	0.0	0.0023273855702094647
chr2	TTN-AS1	178536878	178537228	0	351	51	21966	51	21615	0.0	0.002359472588480222
chr2	TTN-AS1	178538229	178538359	0	131	51	21966	51	21835	0.0	0.0023356995649187087
chr2	TTN-AS1	178583523	178583648	0	126	51	21966	51	21840	0.0	0.002335164835164835
chr2	TTN-AS1	178636573	178636698	51	126	51	21966	0	21840	0.40476190476190477	0.0
chr2	TTN-AS1	178641300	178641444	0	145	51	21966	51	21821	0.0	0.002337198111910545
chr2	TTN-AS1	178586610	178586841	0	232	51	21966	51	21734	0.0	0.00234655378669366
chr2	TTN-AS1	178608166	178608266	0	101	51	21966	51	21865	0.0	0.0023324948547907617
chr2	TTN-AS1	178644298	178644501	0	204	51	21966	51	21762	0.0	0.0023435346015991177
chr2	TTN-AS1	178675101	178675277	0	177	51	21966	51	21789	0.0	0.0023406305934186977
chr2	TTN-AS1	178613211	178613311	0	101	51	21966	51	21865	0.0	0.0023324948547907617
chr2	TTN-AS1	178758990	178759044	0	55	51	21966	51	21911	0.0	0.0023275980101318972
chr2	TTN-AS1	178777857	178778003	0	147	51	21966	51	21819	0.0	0.002337412347036986
chr2	AC092640.1	178997935	178998000	49	66	1356	2646	1307	2580	0.7424242424242424	0.5065891472868217
chr2	AC092640.1	178998723	178998809	695	87	1356	2646	661	2559	7.988505747126437	0.25830402500976946
chr2	UBE2E3	180980941	180980973	0	33	0	2985	0	2952	0.0	0.0
chr2	UBE2E3	180987337	180987394	0	58	0	2985	0	2927	0.0	0.0
chr2	UBE2E3	181075495	181075528	0	34	0	2985	0	2951	0.0	0.0
chr2	LINC01934	181225003	181225047	0	45	0	15079	0	15034	0.0	0.0
chr2	LINC01934	181283176	181283400	0	225	0	15079	0	14854	0.0	0.0
chr2	LINC01934	181238250	181238450	0	201	0	15079	0	14878	0.0	0.0
chr2	LINC01934	181208032	181208262	0	231	0	15079	0	14848	0.0	0.0
chr2	LINC01934	181341045	181341129	0	85	0	15079	0	14994	0.0	0.0
chr2	LINC01934	181262828	181262977	0	150	0	15079	0	14929	0.0	0.0
chr2	LINC01934	181354207	181354343	0	137	0	15079	0	14942	0.0	0.0
chr2	LINC01934	181256222	181256292	0	71	0	15079	0	15008	0.0	0.0
chr2	LINC01934	181363297	181363337	0	41	0	15079	0	15038	0.0	0.0
chr2	ITGA4	181475158	181475288	0	131	0	10591	0	10460	0.0	0.0
chr2	ITPRID2	181896029	181896079	0	51	1498	7648	1498	7597	0.0	0.19718309859154928
chr2	ITPRID2	181920596	181920662	0	67	1498	7648	1498	7581	0.0	0.19759926131117267
chr2	ITPRID2	181928160	181928278	0	119	1498	7648	1498	7529	0.0	0.1989640058440696
chr2	ITPRID2	181928160	181928199	0	40	1498	7648	1498	7608	0.0	0.19689800210304942
chr2	PPP1R1C	181962133	181962196	0	64	51	4899	51	4835	0.0	0.010548086866597724
chr2	PPP1R1C	181987838	181987899	0	62	51	4899	51	4837	0.0	0.01054372544965888
chr2	PPP1R1C	182117206	182117301	0	96	51	4899	51	4803	0.0	0.010618363522798251
chr2	PPP1R1C	182117206	182117468	0	263	51	4899	51	4636	0.0	0.01100086281276963
chr2	DNAJC10	182732498	182732542	0	45	305321	21606	305321	21561	0.0	14.160799591855666
chr2	DNAJC10	182736248	182736386	0	139	305321	21606	305321	21467	0.0	14.222807099268644
chr2	DNAJC10	182735555	182735593	0	39	305321	21606	305321	21567	0.0	14.156860017619511
chr2	DNAJC10	182752548	182752623	0	76	305321	21606	305321	21530	0.0	14.18118903855086
chr2	DNAJC10	182739544	182739709	0	166	305321	21606	305321	21440	0.0	14.240718283582089
chr2	DUSP19	183087039	183087192	0	154	51	5383	51	5229	0.0	0.009753298909925417
chr2	DUSP19	183087157	183087192	0	36	51	5383	51	5347	0.0	0.009538058724518421
chr2	NUP35	183118590	183118742	0	153	0	2638	0	2485	0.0	0.0
chr2	NUP35	183120005	183120114	0	110	0	2638	0	2528	0.0	0.0
chr2	NUP35	183151507	183151649	0	143	0	2638	0	2495	0.0	0.0
chr2	NUP35	183118326	183118408	0	83	0	2638	0	2555	0.0	0.0
chr2	NUP35	183130994	183131352	0	359	0	2638	0	2279	0.0	0.0
chr2	AC009315.1	185483033	185483091	0	59	0	3548	0	3489	0.0	0.0
chr2	FSIP2	185799696	185809133	3009	9438	159	17095	-2850	7657	0.31881754609027335	-0.37220843672456577
chr2	ZC3H15	186502495	186502587	0	93	0	3040	0	2947	0.0	0.0
chr2	ZC3H15	186499618	186499662	0	45	0	3040	0	2995	0.0	0.0
chr2	ZC3H15	186501272	186501425	0	154	0	3040	0	2886	0.0	0.0
chr2	ZC3H15	186502495	186502552	0	58	0	3040	0	2982	0.0	0.0
chr2	ZC3H15	186507394	186507474	0	81	0	3040	0	2959	0.0	0.0
chr2	GULP1	188541180	188541318	0	139	153	5838	153	5699	0.0	0.026846815230742234
chr2	GULP1	188589739	188589750	0	12	153	5838	153	5826	0.0	0.026261585993820804
chr2	GULP1	188582340	188582565	0	226	153	5838	153	5612	0.0	0.027263007840342125
chr2	COL3A1	188993360	188993459	0	100	138	6807	138	6707	0.0	0.020575518115401818
chr2	WDR75	189448800	189448834	0	35	17066	3312	17066	3277	0.0	5.207812023191944
chr2	ASNSD1	189663900	189663954	0	55	0	2491	0	2436	0.0	0.0
chr2	ANKAR	189705022	189705224	0	203	0	5784	0	5581	0.0	0.0
chr2	ANKAR	189711048	189711153	0	106	0	5784	0	5678	0.0	0.0
chr2	ANKAR	189743274	189743474	0	201	0	5784	0	5583	0.0	0.0
chr2	ANKAR	189728659	189728821	0	163	0	5784	0	5621	0.0	0.0
chr2	PMS1	189795768	189795951	0	184	127486	4376	127486	4192	0.0	30.411736641221374
chr2	PMS1	189805651	189805754	0	104	127486	4376	127486	4272	0.0	29.842228464419474
chr2	PMS1	189843963	189844080	0	118	127486	4376	127486	4258	0.0	29.940347581023953
chr2	PMS1	189863742	189864228	59251	487	127486	4376	68235	3889	121.66529774127311	17.545641553098484
chr2	PMS1	189785345	189785471	0	127	127486	4376	127486	4249	0.0	30.003765591903978
chr2	PMS1	189863742	189863974	0	233	127486	4376	127486	4143	0.0	30.771421675114652
chr2	PMS1	189867798	189867929	637	132	127486	4376	126849	4244	4.825757575757576	29.889019792648444
chr2	INPP1	190362626	190362687	0	62	816	3107	816	3045	0.0	0.26798029556650244
chr2	INPP1	190348887	190349031	0	145	816	3107	816	2962	0.0	0.275489534098582
chr2	INPP1	190359645	190359698	0	54	816	3107	816	3053	0.0	0.26727808712741563
chr2	MFSD6	190433326	190433392	0	67	153	5964	153	5897	0.0	0.025945395964049517
chr2	MFSD6	190415291	190415413	0	123	153	5964	153	5841	0.0	0.026194144838212634
chr2	MFSD6	190499831	190499856	0	26	153	5964	153	5938	0.0	0.025766251263051532
chr2	NAB1	190649830	190649982	845	153	34781	4801	33936	4648	5.522875816993464	7.301204819277109
chr2	NAB1	190683737	190683827	153	91	34781	4801	34628	4710	1.6813186813186813	7.352016985138004
chr2	NAB1	190655976	190656153	0	178	34781	4801	34781	4623	0.0	7.523469608479342
chr2	GLS	190954754	190954818	0	65	0	9139	0	9074	0.0	0.0
chr2	MYO1B	191400748	191400835	0	88	9111	9318	9111	9230	0.0	0.9871072589382448
chr2	MYO1B	191402631	191402718	0	88	9111	9318	9111	9230	0.0	0.9871072589382448
chr2	MYO1B	191379266	191379272	144	7	9111	9318	8967	9311	20.571428571428573	0.9630544517237676
chr2	NABP1	191682491	191682595	0	105	924	17438	924	17333	0.0	0.05330871747533606
chr2	CAVIN2-AS1	192031331	192031603	0	273	1371	4592	1371	4319	0.0	0.3174345913405881
chr2	CAVIN2-AS1	192031331	192031491	0	161	1371	4592	1371	4431	0.0	0.3094109681787407
chr2	CAVIN2-AS1	192032570	192032638	0	69	1371	4592	1371	4523	0.0	0.3031173999557816
chr2	CAVIN2-AS1	192036131	192036365	0	235	1371	4592	1371	4357	0.0	0.3146660546247418
chr2	CAVIN2-AS1	192035205	192035407	0	203	1371	4592	1371	4389	0.0	0.31237183868762813
chr2	PCGEM1	192753723	192753845	0	123	0	1716	0	1593	0.0	0.0
chr2	LINC01821	194374135	194374262	0	128	51	5214	51	5086	0.0	0.010027526543452615
chr2	LINC01821	194416195	194416418	0	224	51	5214	51	4990	0.0	0.010220440881763528
chr2	LINC01821	194365412	194365555	0	144	51	5214	51	5070	0.0	0.010059171597633136
chr2	LINC01821	194368840	194369072	0	233	51	5214	51	4981	0.0	0.010238907849829351
chr2	LINC01821	194350667	194350753	0	87	51	5214	51	5127	0.0	0.00994733762434172
chr2	LINC01821	194537431	194537473	0	43	51	5214	51	5171	0.0	0.009862695803519629
chr2	SLC39A10	195671656	195671720	0	65	0	6933	0	6868	0.0	0.0
chr2	CCDC150	196712144	196712252	0	109	51	9384	51	9275	0.0	0.0054986522911051215
chr2	CCDC150	196646340	196646504	0	165	51	9384	51	9219	0.0	0.005532053368044257
chr2	CCDC150	196712676	196712739	0	64	51	9384	51	9320	0.0	0.005472103004291845
chr2	CCDC150	196720173	196720234	0	62	51	9384	51	9322	0.0	0.00547092898519631
chr2	COQ10B	197459931	197460081	0	151	0	2698	0	2547	0.0	0.0
chr2	HSPE1	197501073	197501238	0	166	284	1592	284	1426	0.0	0.19915848527349228
chr2	MOB4	197535529	197535630	0	102	1732	4091	1732	3989	0.0	0.43419403359237907
chr2	MOB4	197548335	197548415	0	81	1732	4091	1732	4010	0.0	0.4319201995012469
chr2	MOB4	197523623	197523686	1372	64	1732	4091	360	4027	21.4375	0.0893965731313633
chr2	MOB4	197535529	197535605	0	77	1732	4091	1732	4014	0.0	0.43148978574987545
chr2	PLCL1	198001951	198002008	0	58	79893	5694	79893	5636	0.0	14.175479063165366
chr2	LINC01877	199624531	199624596	722	66	722	9864	0	9798	10.93939393939394	0.0
chr2	LINC01877	199608232	199608335	0	104	722	9864	722	9760	0.0	0.07397540983606557
chr2	LINC01877	199647673	199647856	0	184	722	9864	722	9680	0.0	0.07458677685950413
chr2	LINC01877	199647053	199647179	0	127	722	9864	722	9737	0.0	0.07415014891650405
chr2	MAIP1	199961780	199961928	0	149	0	1632	0	1483	0.0	0.0
chr2	SPATS2L	200389222	200389283	0	62	0	10302	0	10240	0.0	0.0
chr2	SPATS2L	200439121	200439328	0	208	0	10302	0	10094	0.0	0.0
chr2	SPATS2L	200329430	200329480	0	51	0	10302	0	10251	0.0	0.0
chr2	SPATS2L	200372108	200372251	0	144	0	10302	0	10158	0.0	0.0
chr2	SPATS2L	200308886	200309090	0	205	0	10302	0	10097	0.0	0.0
chr2	SPATS2L	200378140	200378371	0	232	0	10302	0	10070	0.0	0.0
chr2	SPATS2L	200383866	200384017	0	152	0	10302	0	10150	0.0	0.0
chr2	AOX1	200611383	200611493	0	111	1688	5447	1688	5336	0.0	0.31634182908545727
chr2	AOX1	200620649	200620819	0	171	1688	5447	1688	5276	0.0	0.3199393479909022
chr2	AOX3P	200728556	200728700	0	145	716	4333	716	4188	0.0	0.17096466093600765
chr2	AOX2P	200769819	200769949	0	131	13224	3864	13224	3733	0.0	3.5424591481382266
chr2	NIF3L1	200891735	200891789	0	55	112	2001	112	1946	0.0	0.05755395683453238
chr2	NIF3L1	200897075	200897214	0	140	112	2001	112	1861	0.0	0.06018269747447609
chr2	NIF3L1	200890522	200890585	0	64	112	2001	112	1937	0.0	0.05782137325761487
chr2	NDUFB3	201072338	201072361	0	24	16	846	16	822	0.0	0.019464720194647202
chr2	NDUFB3	201072278	201072361	0	84	16	846	16	762	0.0	0.02099737532808399
chr2	CFLAR	201129728	201130146	0	419	9972	22046	9972	21627	0.0	0.461090303786933
chr2	CFLAR	201142644	201142762	0	119	9972	22046	9972	21927	0.0	0.454781775892735
chr2	CFLAR	201149001	201149052	0	52	9972	22046	9972	21994	0.0	0.45339638083113576
chr2	CASP10	201187705	201187799	0	95	204	7593	204	7498	0.0	0.027207255268071485
chr2	CASP10	201203729	201203766	0	38	204	7593	204	7555	0.0	0.02700198544010589
chr2	CASP10	201208074	201208183	0	110	204	7593	204	7483	0.0	0.02726179339836964
chr2	CASP10	201205881	201205973	44	93	204	7593	160	7500	0.4731182795698925	0.021333333333333333
chr2	CASP8	201266460	201266791	0	332	10393	7205	10393	6873	0.0	1.512148988796741
chr2	CASP8	201274888	201274953	0	66	10393	7205	10393	7139	0.0	1.4558061353130691
chr2	CASP8	201266486	201266791	0	306	10393	7205	10393	6899	0.0	1.5064502101753878
chr2	CASP8	201272897	201272942	0	46	10393	7205	10393	7159	0.0	1.4517390697024724
chr2	CASP8	201269509	201269605	0	97	10393	7205	10393	7108	0.0	1.4621553179516038
chr2	STRADB	201469952	201470052	0	101	4401	3141	4401	3040	0.0	1.4476973684210526
chr2	CDK15	201800783	201800901	29	119	20099	6191	20070	6072	0.24369747899159663	3.3053359683794468
chr2	CDK15	201823664	201823727	0	64	20099	6191	20099	6127	0.0	3.280398237310266
chr2	CDK15	201872277	201872326	32	50	20099	6191	20067	6141	0.64	3.2677088422081093
chr2	KIAA2012	202076931	202077099	0	169	74307	7680	74307	7511	0.0	9.893090134469444
chr2	NOP58	202275112	202275189	0	78	5341	3274	5341	3196	0.0	1.6711514392991238
chr2	NOP58	202278211	202278329	0	119	5341	3274	5341	3155	0.0	1.6928684627575277
chr2	NOP58	202287659	202287724	0	66	5341	3274	5341	3208	0.0	1.6649002493765586
chr2	NOP58	202295673	202295837	0	165	5341	3274	5341	3109	0.0	1.717915728530074
chr2	BMPR2	202555251	202556531	0	1281	68207	12523	68207	11242	0.0	6.067158868528732
chr2	CARF	202941859	202941980	0	122	1123	10132	1123	10010	0.0	0.1121878121878122
chr2	CARF	202942739	202942967	0	229	1123	10132	1123	9903	0.0	0.11339997980409977
chr2	CARF	202961236	202961426	0	191	1123	10132	1123	9941	0.0	0.11296650236394729
chr2	CARF	202913033	202913114	0	82	1123	10132	1123	10050	0.0	0.1117412935323383
chr2	CARF	202938273	202938395	52	123	1123	10132	1071	10009	0.42276422764227645	0.10700369667299431
chr2	CARF	202924356	202924415	0	60	1123	10132	1123	10072	0.0	0.11149722001588562
chr2	CARF	202913033	202913102	0	70	1123	10132	1123	10062	0.0	0.11160803021268137
chr2	CARF	202924296	202924415	0	120	1123	10132	1123	10012	0.0	0.11216540151817819
chr2	CARF	202973481	202973584	0	104	1123	10132	1123	10028	0.0	0.11198643797367372
chr2	CARF	202934501	202934599	0	99	1123	10132	1123	10033	0.0	0.11193062892454898
chr2	CARF	202942762	202942967	0	206	1123	10132	1123	9926	0.0	0.11313721539391497
chr2	NBEAL1	203171927	203172023	51	97	25539	16436	25488	16339	0.5257731958762887	1.559948589264949
chr2	CYP20A1	203246754	203246921	0	168	3696	3471	3696	3303	0.0	1.1189827429609447
chr2	CYP20A1	203278572	203278688	0	117	3696	3471	3696	3354	0.0	1.1019677996422181
chr2	CYP20A1	203272669	203272748	0	80	3696	3471	3696	3391	0.0	1.089943969330581
chr2	CYP20A1	203272645	203272748	0	104	3696	3471	3696	3367	0.0	1.0977130977130978
chr2	CYP20A1	203245845	203245895	0	51	3696	3471	3696	3420	0.0	1.080701754385965
chr2	ABI2	203394699	203394846	0	148	125437	18798	125437	18650	0.0	6.725844504021448
chr2	ABI2	203395655	203395780	196	126	125437	18798	125241	18672	1.5555555555555556	6.707422879177378
chr2	ABI2	203411284	203411371	33	88	125437	18798	125404	18710	0.375	6.70251202565473
chr2	ABI2	203351554	203351678	153	125	125437	18798	125284	18673	1.224	6.709366464949392
chr2	ABI2	203396784	203396967	0	184	125437	18798	125437	18614	0.0	6.738852476630493
chr2	ABI2	203355153	203355324	814	172	125437	18798	124623	18626	4.732558139534884	6.6908085471920975
chr2	ABI2	203382188	203382206	0	19	125437	18798	125437	18779	0.0	6.679642153469301
chr2	ABI2	203342196	203342230	8	35	125437	18798	125429	18763	0.22857142857142856	6.684911794489154
chr2	ABI2	203374819	203374852	0	34	125437	18798	125437	18764	0.0	6.68498188019612
chr2	ABI2	203396883	203396967	0	85	125437	18798	125437	18713	0.0	6.70320098327366
chr2	ABI2	203375931	203376132	509	202	125437	18798	124928	18596	2.51980198019802	6.718003871800387
chr2	ABI2	203376056	203376132	307	77	125437	18798	125130	18721	3.987012987012987	6.683937823834197
chr2	ABI2	203395658	203395780	159	123	125437	18798	125278	18675	1.2926829268292683	6.708326639892905
chr2	CD28	203726632	203726989	51	358	3228	4840	3177	4482	0.1424581005586592	0.7088353413654619
chr2	CTLA4	203871377	203871487	0	111	76	2145	76	2034	0.0	0.03736479842674533
chr2	CTLA4	203870585	203870933	0	349	76	2145	76	1796	0.0	0.042316258351893093
chr2	CTLA4	203870585	203870648	0	64	76	2145	76	2081	0.0	0.03652090341182124
chr2	ICOS	203957798	203957883	0	86	5052	2635	5052	2549	0.0	1.9819537073362103
chr2	PARD3B	205158721	205158907	0	187	162	10729	162	10542	0.0	0.015367103016505406
chr2	PARD3B	205300529	205300736	0	208	162	10729	162	10521	0.0	0.015397775876817793
chr2	PARD3B	205440369	205440672	0	304	162	10729	162	10425	0.0	0.01553956834532374
chr2	NRP2	205792234	205792285	0	52	51	13919	51	13867	0.0	0.0036777962068219516
chr2	EEF1B2	206160886	206161132	0	247	0	1648	0	1401	0.0	0.0
chr2	GPR1-AS	206240442	206240588	0	147	51	3051	51	2904	0.0	0.01756198347107438
chr2	ZDBF2	206280549	206280593	0	45	51	10892	51	10847	0.0	0.004701760855536093
chr2	ZDBF2	206292010	206292116	0	107	51	10892	51	10785	0.0	0.004728789986091794
chr2	ZDBF2	206292013	206292116	0	104	51	10892	51	10788	0.0	0.004727474972191324
chr2	ADAM23	206609909	206610000	0	92	13699	6452	13699	6360	0.0	2.153930817610063
chr2	ADAM23	206605789	206605880	0	92	13699	6452	13699	6360	0.0	2.153930817610063
chr2	AC008269.1	206842992	206843212	0	221	5713	5561	5713	5340	0.0	1.0698501872659176
chr2	CREB1	207575271	207575454	0	184	0	10644	0	10460	0.0	0.0
chr2	CREB1	207555627	207555749	0	123	0	10644	0	10521	0.0	0.0
chr2	CREB1	207561118	207561160	0	43	0	10644	0	10601	0.0	0.0
chr2	CREB1	207534601	207534683	0	83	0	10644	0	10561	0.0	0.0
chr2	CREB1	207577109	207577224	0	116	0	10644	0	10528	0.0	0.0
chr2	CCNYL1	207733946	207734047	0	102	0	4720	0	4618	0.0	0.0
chr2	CCNYL1	207740654	207740706	0	53	0	4720	0	4667	0.0	0.0
chr2	PIKFYVE	208277536	208277708	0	173	25	10883	25	10710	0.0	0.002334267040149393
chr2	PIKFYVE	208304845	208305013	0	169	25	10883	25	10714	0.0	0.002333395557214859
chr2	PIKFYVE	208276711	208276830	0	120	25	10883	25	10763	0.0	0.0023227724612097
chr2	PIKFYVE	208274020	208274053	25	34	25	10883	0	10849	0.7352941176470589	0.0
chr2	PIKFYVE	208274017	208274053	25	37	25	10883	0	10846	0.6756756756756757	0.0
chr2	MAP2	209704449	209704620	0	172	108	11629	108	11457	0.0	0.009426551453260016
chr2	MAP2	209723594	209723687	0	94	108	11629	108	11535	0.0	0.009362808842652795
chr2	MAP2	209692624	209696350	0	3727	108	11629	108	7902	0.0	0.01366742596810934
chr2	MAP2	209696916	209697051	0	136	108	11629	108	11493	0.0	0.009397024275646046
chr2	MAP2	209690602	209690848	0	247	108	11629	108	11382	0.0	0.009488666315234581
chr2	MAP2	209687718	209687961	0	244	108	11629	108	11385	0.0	0.009486166007905139
chr2	MAP2	209692636	209696350	0	3715	108	11629	108	7914	0.0	0.013646702047005308
chr2	MAP2	209703986	209704034	0	49	108	11629	108	11580	0.0	0.00932642487046632
chr2	UNC80	209894162	209894366	0	205	357	17565	357	17360	0.0	0.02056451612903226
chr2	UNC80	209984855	209984912	0	58	357	17565	357	17507	0.0	0.02039184326269492
chr2	RPE	210009656	210009736	0	81	119	3448	119	3367	0.0	0.035343035343035345
chr2	RPE	210016203	210016257	0	55	119	3448	119	3393	0.0	0.03507220748600059
chr2	RPE	210017472	210017559	0	88	119	3448	119	3360	0.0	0.035416666666666666
chr2	RPE	210009638	210009736	0	99	119	3448	119	3349	0.0	0.03553299492385787
chr2	RPE	210003437	210003468	0	32	119	3448	119	3416	0.0	0.03483606557377049
chr2	RPE	210018152	210018221	0	70	119	3448	119	3378	0.0	0.03522794552989935
chr2	RPE	210017789	210017887	0	99	119	3448	119	3349	0.0	0.03553299492385787
chr2	AC006994.1	210218471	210218564	0	94	0	4465	0	4371	0.0	0.0
chr2	LANCL1-AS1	210442541	210442699	0	159	0	1675	0	1516	0.0	0.0
chr2	CPS1	210519550	210519670	0	121	5653	11064	5653	10943	0.0	0.5165859453531938
chr2	CPS1	210519550	210519784	0	235	5653	11064	5653	10829	0.0	0.5220241942931019
chr2	CPS1	210653736	210653879	0	144	5653	11064	5653	10920	0.0	0.5176739926739927
chr2	SPAG16	213310058	213310177	0	120	2126	8280	2126	8160	0.0	0.26053921568627453
chr2	SPAG16	213350527	213350645	0	119	2126	8280	2126	8161	0.0	0.26050729077318957
chr2	SPAG16	213297021	213297139	0	119	2126	8280	2126	8161	0.0	0.26050729077318957
chr2	SPAG16	213929959	213930145	0	187	2126	8280	2126	8093	0.0	0.26269615717286543
chr2	SPAG16	213317218	213317356	0	139	2126	8280	2126	8141	0.0	0.26114727920402897
chr2	VWC2L	214436628	214436758	0	131	51	5262	51	5131	0.0	0.00993958292730462
chr2	SNHG31	214960392	214960590	0	199	0	2559	0	2360	0.0	0.0
chr2	SNHG31	214842736	214842832	0	97	0	2559	0	2462	0.0	0.0
chr2	SNHG31	214947824	214947947	0	124	0	2559	0	2435	0.0	0.0
chr2	AC072062.1	215038942	215039041	29	100	29	3513	0	3413	0.29	0.0
chr2	AC072062.1	215025318	215025492	0	175	29	3513	29	3338	0.0	0.008687837028160575
chr2	AC072062.1	215032374	215032601	0	228	29	3513	29	3285	0.0	0.008828006088280061
chr2	ATIC	215319664	215319731	0	68	0	3806	0	3738	0.0	0.0
chr2	ATIC	215326821	215326978	0	158	0	3806	0	3648	0.0	0.0
chr2	AC012462.1	215456044	215456222	0	179	0	1648	0	1469	0.0	0.0
chr2	AC012668.3	215681497	215681589	0	93	19	3073	19	2980	0.0	0.0063758389261744965
chr2	AC012668.3	215683341	215683461	0	121	19	3073	19	2952	0.0	0.006436314363143632
chr2	AC012668.3	215688387	215688595	0	209	19	3073	19	2864	0.0	0.006634078212290503
chr2	TMEM169	216082146	216082232	0	87	0	3631	0	3544	0.0	0.0
chr2	XRCC5	216110466	216110551	0	86	1464	5487	1464	5401	0.0	0.271060914645436
chr2	SMARCAL1	216423632	216423683	0	52	0	5114	0	5062	0.0	0.0
chr2	SMARCAL1	216438419	216438485	0	67	0	5114	0	5047	0.0	0.0
chr2	SMARCAL1	216446661	216446718	0	58	0	5114	0	5056	0.0	0.0
chr2	RPL37A	216499831	216499866	0	36	0	5245	0	5209	0.0	0.0
chr2	RPL37A	216519331	216519390	0	60	0	5245	0	5185	0.0	0.0
chr2	RPL37A	216520713	216520774	0	62	0	5245	0	5183	0.0	0.0
chr2	AC073321.1	216598627	216598807	0	181	0	951	0	770	0.0	0.0
chr2	DIRC3-AS1	217296631	217296770	11	140	1649	8041	1638	7901	0.07857142857142857	0.20731552967978736
chr2	DIRC3-AS1	217303601	217303861	0	261	1649	8041	1649	7780	0.0	0.21195372750642674
chr2	DIRC3-AS1	217295903	217295987	10	85	1649	8041	1639	7956	0.11764705882352941	0.20600804424333835
chr2	RUFY4	218035316	218035394	0	79	51	3777	51	3698	0.0	0.013791238507301243
chr2	RUFY4	218073815	218073885	0	71	51	3777	51	3706	0.0	0.013761467889908258
chr2	RUFY4	218072778	218072885	0	108	51	3777	51	3669	0.0	0.013900245298446443
chr2	RUFY4	218073815	218073945	0	131	51	3777	51	3646	0.0	0.013987931980252331
chr2	ARPC2	218217371	218217544	0	174	0	6079	0	5905	0.0	0.0
chr2	ARPC2	218217462	218217544	0	83	0	6079	0	5996	0.0	0.0
chr2	ARPC2	218234848	218235044	0	197	0	6079	0	5882	0.0	0.0
chr2	ARPC2	218234351	218234397	0	47	0	6079	0	6032	0.0	0.0
chr2	ARPC2	218226995	218227097	0	103	0	6079	0	5976	0.0	0.0
chr2	ARPC2	218252944	218253032	0	89	0	6079	0	5990	0.0	0.0
chr2	SLC11A1	218384318	218384365	0	48	0	7083	0	7035	0.0	0.0
chr2	SLC11A1	218385411	218385485	0	75	0	7083	0	7008	0.0	0.0
chr2	SLC11A1	218382959	218383102	0	144	0	7083	0	6939	0.0	0.0
chr2	SLC11A1	218384242	218384365	0	124	0	7083	0	6959	0.0	0.0
chr2	CNOT9	218587304	218587400	0	97	153	5267	153	5170	0.0	0.029593810444874274
chr2	CNOT9	218573994	218574233	0	240	153	5267	153	5027	0.0	0.0304356475034812
chr2	CNOT9	218580994	218581114	0	121	153	5267	153	5146	0.0	0.029731830547998446
chr2	PLCD4	218615903	218616062	0	160	0	5717	0	5557	0.0	0.0
chr2	PLCD4	218615903	218615959	0	57	0	5717	0	5660	0.0	0.0
chr2	PLCD4	218630649	218630802	0	154	0	5717	0	5563	0.0	0.0
chr2	PLCD4	218633604	218633761	0	158	0	5717	0	5559	0.0	0.0
chr2	PLCD4	218633385	218633481	0	97	0	5717	0	5620	0.0	0.0
chr2	BCS1L	218660306	218660421	0	116	0	2642	0	2526	0.0	0.0
chr2	BCS1L	218660938	218661307	0	370	0	2642	0	2272	0.0	0.0
chr2	BCS1L	218662509	218662679	0	171	0	2642	0	2471	0.0	0.0
chr2	BCS1L	218660036	218660245	0	210	0	2642	0	2432	0.0	0.0
chr2	BCS1L	218660036	218660218	0	183	0	2642	0	2459	0.0	0.0
chr2	BCS1L	218660036	218660166	0	131	0	2642	0	2511	0.0	0.0
chr2	BCS1L	218660306	218660482	0	177	0	2642	0	2465	0.0	0.0
chr2	BCS1L	218662514	218662679	0	166	0	2642	0	2476	0.0	0.0
chr2	STK36	218688390	218688493	0	104	0	6432	0	6328	0.0	0.0
chr2	TTLL4	218727268	218727347	0	80	0	7190	0	7110	0.0	0.0
chr2	TTLL4	218747002	218747194	0	193	0	7190	0	6997	0.0	0.0
chr2	TTLL4	218747289	218747372	0	84	0	7190	0	7106	0.0	0.0
chr2	TTLL4	218748104	218748227	0	124	0	7190	0	7066	0.0	0.0
chr2	TTLL4	218728024	218728067	0	44	0	7190	0	7146	0.0	0.0
chr2	TTLL4	218736311	218736376	0	66	0	7190	0	7124	0.0	0.0
chr2	TTLL4	218747596	218747725	0	130	0	7190	0	7060	0.0	0.0
chr2	TTLL4	218747029	218747194	0	166	0	7190	0	7024	0.0	0.0
chr2	CYP27A1	218809576	218809767	0	192	0	2496	0	2304	0.0	0.0
chr2	WNT6	218871026	218871247	0	222	0	1723	0	1501	0.0	0.0
chr2	WNT10A	218889983	218890363	0	381	0	2853	0	2472	0.0	0.0
chr2	LINC00608	218977138	218977398	51	261	51	2164	0	1903	0.19540229885057472	0.0
chr2	RETREG2	219178921	219179028	0	108	459	5682	459	5574	0.0	0.08234660925726588
chr2	ZFAND2B	219207647	219207779	748	133	12355	2754	11607	2621	5.62406015037594	4.428462418924075
chr2	ZFAND2B	219207886	219208038	0	153	12355	2754	12355	2601	0.0	4.750096116878124
chr2	ZFAND2B	219208976	219209049	0	74	12355	2754	12355	2680	0.0	4.610074626865671
chr2	ZFAND2B	219207647	219207774	683	128	12355	2754	11672	2626	5.3359375	4.444782939832445
chr2	ANKZF1	219230227	219230405	0	179	255	4424	255	4245	0.0	0.06007067137809187
chr2	ANKZF1	219231927	219232040	0	114	255	4424	255	4310	0.0	0.05916473317865429
chr2	ANKZF1	219230227	219230350	0	124	255	4424	255	4300	0.0	0.05930232558139535
chr2	STK16	219246656	219246876	0	221	102	4345	102	4124	0.0	0.024733268671193017
chr2	STK16	219247112	219247246	0	135	102	4345	102	4210	0.0	0.024228028503562947
chr2	STK16	219247661	219247757	0	97	102	4345	102	4248	0.0	0.02401129943502825
chr2	STK16	219246521	219246876	0	356	102	4345	102	3989	0.0	0.025570318375532714
chr2	DNAJB2	219282836	219282929	51	94	102	5248	51	5154	0.5425531914893617	0.00989522700814901
chr2	SPEG	219447973	219449271	12157	1299	103040	14929	90883	13630	9.358737490377214	6.667865003668378
chr2	SPEG	219444024	219444059	0	36	103040	14929	103040	14893	0.0	6.918686631303297
chr2	SPEG	219444029	219444059	0	31	103040	14929	103040	14898	0.0	6.916364612699692
chr2	ASIC4	219532882	219532939	508	58	67430	4359	66922	4301	8.758620689655173	15.559637293652639
chr2	SLC4A3	219634419	219634604	561	186	4013	4977	3452	4791	3.0161290322580645	0.7205176372364851
chr2	ACSL3	222887829	222887888	0	60	0	7252	0	7192	0.0	0.0
chr2	ACSL3	222900673	222900780	0	108	0	7252	0	7144	0.0	0.0
chr2	RHBDD1	226838072	226838154	0	83	102	6916	102	6833	0.0	0.01492755744182643
chr2	RHBDD1	226839408	226839627	0	220	102	6916	102	6696	0.0	0.015232974910394265
chr2	COL4A3	227308898	227309076	0	179	323	9119	323	8940	0.0	0.036129753914988814
chr2	COL4A3	227310775	227310948	0	174	323	9119	323	8945	0.0	0.03610955841252096
chr2	MFF	227329605	227329659	0	55	0	4113	0	4058	0.0	0.0
chr2	MFF	227329605	227329783	0	179	0	4113	0	3934	0.0	0.0
chr2	MFF	227342744	227342819	0	76	0	4113	0	4037	0.0	0.0
chr2	MFF	227352513	227352573	0	61	0	4113	0	4052	0.0	0.0
chr2	MFF	227328677	227328789	0	113	0	4113	0	4000	0.0	0.0
chr2	MFF	227347225	227347384	0	160	0	4113	0	3953	0.0	0.0
chr2	MFF	227330625	227330846	0	222	0	4113	0	3891	0.0	0.0
chr2	MFF	227329605	227329697	0	93	0	4113	0	4020	0.0	0.0
chr2	AGFG1	227532137	227532209	0	73	51	9341	51	9268	0.0	0.00550280535174795
chr2	AGFG1	227531090	227531210	0	121	51	9341	51	9220	0.0	0.005531453362255965
chr2	AGFG1	227550058	227550106	0	49	51	9341	51	9292	0.0	0.005488592337494619
chr2	DAW1	227912253	227912469	0	217	588	2951	588	2734	0.0	0.2150694952450622
chr2	DAW1	227872148	227872399	0	252	588	2951	588	2699	0.0	0.21785846609855503
chr2	DAW1	227876442	227876494	0	53	588	2951	588	2898	0.0	0.2028985507246377
chr2	FBXO36	229932770	229932886	0	117	0	3960	0	3843	0.0	0.0
chr2	AC009950.1	230140067	230140146	0	80	102	5424	102	5344	0.0	0.01908682634730539
chr2	AC009950.1	230172424	230172515	0	92	102	5424	102	5332	0.0	0.019129782445611403
chr2	AC009950.1	230167296	230167652	0	357	102	5424	102	5067	0.0	0.020130254588513915
chr2	AC009950.1	230172569	230172802	51	234	102	5424	51	5190	0.21794871794871795	0.009826589595375723
chr2	SP140	230245862	230245940	0	79	0	5515	0	5436	0.0	0.0
chr2	SP140	230247915	230248065	0	151	0	5515	0	5364	0.0	0.0
chr2	SP140	230253315	230253417	0	103	0	5515	0	5412	0.0	0.0
chr2	SP140	230255451	230255532	0	82	0	5515	0	5433	0.0	0.0
chr2	SP140	230250980	230251061	0	82	0	5515	0	5433	0.0	0.0
chr2	SP140L	230328756	230328831	0	76	0	5249	0	5173	0.0	0.0
chr2	SP140L	230389918	230390023	0	106	0	5249	0	5143	0.0	0.0
chr2	SP140L	230400333	230400413	0	81	0	5249	0	5168	0.0	0.0
chr2	SP100	230417590	230417665	0	76	0	14166	0	14090	0.0	0.0
chr2	SP100	230464066	230464150	0	85	0	14166	0	14081	0.0	0.0
chr2	SP100	230507992	230508031	0	40	0	14166	0	14126	0.0	0.0
chr2	SP100	230440475	230440557	0	83	0	14166	0	14083	0.0	0.0
chr2	ITM2C	230864949	230865145	0	197	10006	2579	10006	2382	0.0	4.200671704450042
chr2	ITM2C	230873416	230873557	0	142	10006	2579	10006	2437	0.0	4.105867870332376
chr2	ITM2C	230876856	230876967	791	112	10006	2579	9215	2467	7.0625	3.7353060397243616
chr2	GCSIR	230895457	230895605	0	149	2086	4145	2086	3996	0.0	0.522022022022022
chr2	SPATA3	231000365	231000537	0	173	0	2820	0	2647	0.0	0.0
chr2	SPATA3	231006697	231006835	0	139	0	2820	0	2681	0.0	0.0
chr2	SPATA3	231004038	231004118	0	81	0	2820	0	2739	0.0	0.0
chr2	PSMD1	231062505	231062675	0	171	5976	14058	5976	13887	0.0	0.4303305249513934
chr2	PSMD1	231075510	231075571	0	62	5976	14058	5976	13996	0.0	0.42697913689625605
chr2	PSMD1	231078658	231078747	0	90	5976	14058	5976	13968	0.0	0.42783505154639173
chr2	PSMD1	231087116	231087181	0	66	5976	14058	5976	13992	0.0	0.42710120068610635
chr2	PSMD1	231146239	231146356	0	118	5976	14058	5976	13940	0.0	0.42869440459110475
chr2	PSMD1	231163634	231163727	0	94	5976	14058	5976	13964	0.0	0.4279576052706961
chr2	PSMD1	231165199	231165286	0	88	5976	14058	5976	13970	0.0	0.42777380100214746
chr2	PSMD1	231170578	231170721	0	144	5976	14058	5976	13914	0.0	0.4294954721862872
chr2	PSMD1	231166380	231166491	0	112	5976	14058	5976	13946	0.0	0.4285099670156317
chr2	PSMD1	231170565	231170721	0	157	5976	14058	5976	13901	0.0	0.42989712970289906
chr2	PSMD1	231163587	231163727	0	141	5976	14058	5976	13917	0.0	0.42940288855356756
chr2	PSMD1	231152716	231152811	0	96	5976	14058	5976	13962	0.0	0.42801890846583585
chr2	PSMD1	231138735	231138850	0	116	5976	14058	5976	13942	0.0	0.428632907760723
chr2	PSMD1	231062505	231062693	0	189	5976	14058	5976	13869	0.0	0.4308890330953926
chr2	ARMC9	231239942	231240041	0	100	9500	11701	9500	11601	0.0	0.8188949228514784
chr2	ARMC9	231270981	231271072	84	92	9500	11701	9416	11609	0.9130434782608695	0.8110948402101817
chr2	ARMC9	231288659	231288721	0	63	9500	11701	9500	11638	0.0	0.8162914590135762
chr2	PTMA	231708713	231708751	0	39	153	2703	153	2664	0.0	0.057432432432432436
chr2	COPS7B	231788554	231788732	0	179	0	4651	0	4472	0.0	0.0
chr2	COPS7B	231791732	231791808	0	77	0	4651	0	4574	0.0	0.0
chr2	COPS7B	231794262	231794351	0	90	0	4651	0	4561	0.0	0.0
chr2	COPS7B	231790921	231791173	0	253	0	4651	0	4398	0.0	0.0
chr2	COPS7B	231790950	231791173	0	224	0	4651	0	4427	0.0	0.0
chr2	COPS7B	231790946	231791173	0	228	0	4651	0	4423	0.0	0.0
chr2	COPS7B	231801139	231801207	0	69	0	4651	0	4582	0.0	0.0
chr2	COPS7B	231801154	231801207	0	54	0	4651	0	4597	0.0	0.0
chr2	COPS7B	231792053	231792278	0	226	0	4651	0	4425	0.0	0.0
chr2	DIS3L2	232111196	232111255	0	60	196828	10198	196828	10138	0.0	19.414874728743342
chr2	DIS3L2	232198526	232198776	0	251	196828	10198	196828	9947	0.0	19.78767467578164
chr2	DIS3L2	232259840	232260685	102	846	196828	10198	196726	9352	0.12056737588652482	21.035714285714285
chr2	DIS3L2	232331669	232331926	315	258	196828	10198	196513	9940	1.2209302325581395	19.769919517102615
chr2	CHRND	232527400	232527445	0	46	0	3144	0	3098	0.0	0.0
chr2	CHRND	232529938	232530139	0	202	0	3144	0	2942	0.0	0.0
chr2	CHRND	232528861	232528971	0	111	0	3144	0	3033	0.0	0.0
chr2	CHRNG	232541373	232541529	0	157	51	4374	51	4217	0.0	0.012093905620109082
chr2	EIF4E2	232557883	232558018	186	136	2925	6569	2739	6433	1.3676470588235294	0.4257733561324421
chr2	EIF4E2	232574262	232574341	549	80	2925	6569	2376	6489	6.8625	0.36615811373092927
chr2	EFHD1	232638405	232638484	0	80	22670	2673	22670	2593	0.0	8.742768993443887
chr2	GIGYF2	232703423	232703489	0	67	350	15277	350	15210	0.0	0.023011176857330704
chr2	GIGYF2	232734416	232734486	0	71	350	15277	350	15206	0.0	0.023017230040773377
chr2	GIGYF2	232700584	232700654	0	71	350	15277	350	15206	0.0	0.023017230040773377
chr2	GIGYF2	232722553	232722658	0	106	350	15277	350	15171	0.0	0.023070331553622044
chr2	GIGYF2	232776411	232776477	0	67	350	15277	350	15210	0.0	0.023011176857330704
chr2	GIGYF2	232724573	232724691	0	119	350	15277	350	15158	0.0	0.02309011742974007
chr2	GIGYF2	232731121	232731234	0	114	350	15277	350	15163	0.0	0.02308250346237552
chr2	GIGYF2	232719037	232719128	0	92	350	15277	350	15185	0.0	0.02304906157392163
chr2	GIGYF2	232731121	232731258	0	138	350	15277	350	15139	0.0	0.023119096373604597
chr2	GIGYF2	232698268	232698307	0	40	350	15277	350	15237	0.0	0.0229704009975717
chr2	GIGYF2	232765891	232765979	0	89	350	15277	350	15188	0.0	0.023044508822754807
chr2	INPP5D	233204125	233204717	4362	593	21346	8587	16984	7994	7.355817875210793	2.124593445083813
chr2	ATG16L1	233273990	233274041	0	52	402	4235	402	4183	0.0	0.09610327516136744
chr2	ATG16L1	233273720	233273777	0	58	402	4235	402	4177	0.0	0.0962413215226239
chr2	ATG16L1	233264891	233265143	0	253	402	4235	402	3982	0.0	0.10095429432446007
chr2	SAG	233309112	233309264	0	153	0	10539	0	10386	0.0	0.0
chr2	SAG	233316074	233316135	0	62	0	10539	0	10477	0.0	0.0
chr2	SAG	233320629	233320823	0	195	0	10539	0	10344	0.0	0.0
chr2	SAG	233309161	233309264	0	104	0	10539	0	10435	0.0	0.0
chr2	SAG	233320702	233320823	0	122	0	10539	0	10417	0.0	0.0
chr2	DGKD	233454356	233454464	306	109	106827	9821	106521	9712	2.8073394495412844	10.967977759472817
chr2	UGT1A6	233769530	233769664	0	135	3118	5052	3118	4917	0.0	0.6341264998983119
chr2	UGT1A6	233717792	233718032	0	241	3118	5052	3118	4811	0.0	0.6480981085013511
chr2	MROH2A	233779344	233779452	0	109	271	5773	271	5664	0.0	0.04784604519774011
chr2	MROH2A	233779346	233779452	0	107	271	5773	271	5666	0.0	0.047829156371337805
chr2	TRPM8	234014561	234014654	0	94	0	7914	0	7820	0.0	0.0
chr2	TRPM8	233947325	233947582	0	258	0	7914	0	7656	0.0	0.0
chr2	SPP2	234050970	234051095	0	126	0	1094	0	968	0.0	0.0
chr2	SH3BP4	234995302	234995376	0	75	51	7085	51	7010	0.0	0.007275320970042796
chr2	AGAP1	235930764	235930923	126	160	177	13980	51	13820	0.7875	0.003690303907380608
chr2	AGAP1	236014804	236014879	0	76	177	13980	177	13904	0.0	0.012730149597238205
chr2	COPS8	237086731	237086796	0	66	969	3426	969	3360	0.0	0.2883928571428571
chr2	COPS8	237094089	237094197	306	109	969	3426	663	3317	2.8073394495412844	0.1998794091046126
chr2	COPS8	237087463	237087563	0	101	969	3426	969	3325	0.0	0.2914285714285714
chr2	MLPH	237487397	237487437	28	41	840	6657	812	6616	0.6829268292682927	0.12273276904474002
chr2	MLPH	237540801	237540957	0	157	840	6657	840	6500	0.0	0.12923076923076923
chr2	MLPH	237519909	237520029	0	121	840	6657	840	6536	0.0	0.12851897184822522
chr2	MLPH	237527376	237527516	0	141	840	6657	840	6516	0.0	0.1289134438305709
chr2	MLPH	237534563	237534647	0	85	840	6657	840	6572	0.0	0.1278149726110773
chr2	MLPH	237553096	237553231	0	136	840	6657	840	6521	0.0	0.1288145989878853
chr2	AC104667.2	237591565	237591771	0	207	0	1660	0	1453	0.0	0.0
chr2	LRRFIP1	237723547	237723586	0	40	0	13249	0	13209	0.0	0.0
chr2	LRRFIP1	237751199	237751271	0	73	0	13249	0	13176	0.0	0.0
chr2	LRRFIP1	237727875	237727935	0	61	0	13249	0	13188	0.0	0.0
chr2	RAMP1	237874644	237874705	0	62	0	1153	0	1091	0.0	0.0
chr2	UBE2F	237986161	237986292	0	132	1036	3471	1036	3339	0.0	0.31027253668763105
chr2	UBE2F	238025341	238025412	0	72	1036	3471	1036	3399	0.0	0.30479552809649896
chr2	UBE2F	238030555	238030613	0	59	1036	3471	1036	3412	0.0	0.30363423212192264
chr2	UBE2F	237973091	237973225	0	135	1036	3471	1036	3336	0.0	0.3105515587529976
chr2	UBE2F	237987962	237987992	0	31	1036	3471	1036	3440	0.0	0.30116279069767443
chr2	UBE2F	238035877	238035940	0	64	1036	3471	1036	3407	0.0	0.3040798356325213
chr2	UBE2F	238003367	238003527	0	161	1036	3471	1036	3310	0.0	0.3129909365558912
chr2	UBE2F	238016532	238016633	0	102	1036	3471	1036	3369	0.0	0.3075096467794598
chr2	UBE2F	237994743	237994809	1036	67	1036	3471	0	3404	15.462686567164178	0.0
chr2	UBE2F	238016565	238016633	0	69	1036	3471	1036	3402	0.0	0.3045267489711934
chr2	SCLY	238083247	238083354	0	108	231	5749	231	5641	0.0	0.040950186137209715
chr2	SCLY	238093860	238093944	0	85	231	5749	231	5664	0.0	0.04078389830508475
chr2	UBE2F	237973648	237973747	0	100	1036	3471	1036	3371	0.0	0.30732720261050134
chr2	UBE2F	237990423	237990552	0	130	1036	3471	1036	3341	0.0	0.3100868003591739
chr2	UBE2F	238032221	238032254	0	34	1036	3471	1036	3437	0.0	0.3014256619144603
chr2	SCLY	238073782	238073847	0	66	231	5749	231	5683	0.0	0.0406475453105754
chr2	ESPNL	238116902	238117034	0	133	51	5189	51	5056	0.0	0.010087025316455696
chr2	ERFE	238164074	238164183	0	110	0	3590	0	3480	0.0	0.0
chr2	ASB1	238435710	238436013	51	304	7344	2402	7293	2098	0.16776315789473684	3.4761677788369876
chr2	ASB1	238433553	238433695	288	143	7344	2402	7056	2259	2.013986013986014	3.1235059760956174
chr2	CAPN10	240596680	240596942	0	263	0	6540	0	6277	0.0	0.0
chr2	CAPN10	240598351	240598397	0	47	0	6540	0	6493	0.0	0.0
chr2	CAPN10	240596318	240596521	0	204	0	6540	0	6336	0.0	0.0
chr2	CAPN10	240595933	240596152	0	220	0	6540	0	6320	0.0	0.0
chr2	CAPN10	240596849	240596942	0	94	0	6540	0	6446	0.0	0.0
chr2	AGXT	240873977	240874062	301	86	5065	4125	4764	4039	3.5	1.179499876206982
chr2	SNED1	241073265	241073364	11636	100	66190	11991	54554	11891	116.36	4.5878395425111425
chr2	SNED1	241087391	241087475	0	85	66190	11991	66190	11906	0.0	5.5593818242902735
chr2	PPP1R7	241153475	241153604	0	130	0	3700	0	3570	0.0	0.0
chr2	PPP1R7	241150258	241150547	0	290	0	3700	0	3410	0.0	0.0
chr2	PPP1R7	241153482	241153604	0	123	0	3700	0	3577	0.0	0.0
chr2	SEPTIN2	241324215	241324241	0	27	230	6771	230	6744	0.0	0.034104389086595494
chr2	SEPTIN2	241325992	241326113	0	122	230	6771	230	6649	0.0	0.03459166791998797
chr2	SEPTIN2	241335974	241336098	0	125	230	6771	230	6646	0.0	0.034607282575985554
chr2	SEPTIN2	241346165	241346249	0	85	230	6771	230	6686	0.0	0.03440023930601256
chr2	SEPTIN2	241317498	241317599	0	102	230	6771	230	6669	0.0	0.03448792922477133
chr2	SEPTIN2	241316421	241316540	0	120	230	6771	230	6651	0.0	0.034581265975041346
chr2	SEPTIN2	241320202	241320287	0	86	230	6771	230	6685	0.0	0.0344053851907255
chr2	SEPTIN2	241335958	241336098	0	141	230	6771	230	6630	0.0	0.03469079939668175
chr2	SEPTIN2	241316421	241316555	0	135	230	6771	230	6636	0.0	0.034659433393610606
chr2	SEPTIN2	241318236	241318344	230	109	230	6771	0	6662	2.110091743119266	0.0
chr2	SEPTIN2	241335321	241335351	0	31	230	6771	230	6740	0.0	0.03412462908011869
chr2	SEPTIN2	241316429	241316540	0	112	230	6771	230	6659	0.0	0.0345397206787806
chr2	SEPTIN2	241324408	241324662	0	255	230	6771	230	6516	0.0	0.035297728667894414
chr2	SEPTIN2	241325966	241326113	0	148	230	6771	230	6623	0.0	0.03472746489506266
chr2	FARP2	241493292	241493444	0	153	24600	13898	24600	13745	0.0	1.7897417242633684
chr2	FARP2	241404798	241404841	0	44	24600	13898	24600	13854	0.0	1.775660459073192
chr2	ATG4B	241651263	241651335	0	73	204	6287	204	6214	0.0	0.03282909559060187
chr2	ATG4B	241655270	241655343	0	74	204	6287	204	6213	0.0	0.03283437952679865
chr2	ATG4B	241659107	241659187	0	81	204	6287	204	6206	0.0	0.03287141475990976
chr2	ATG4B	241651883	241651974	0	92	204	6287	204	6195	0.0	0.03292978208232446
chr2	ATG4B	241653306	241653369	0	64	204	6287	204	6223	0.0	0.03278161658364133
chr2	ATG4B	241638260	241638370	0	111	204	6287	204	6176	0.0	0.033031088082901554
chr2	D2HGDH	241735132	241735516	0	385	0	4764	0	4379	0.0	0.0
chr2	D2HGDH	241748864	241749929	0	1066	0	4764	0	3698	0.0	0.0
chr2	D2HGDH	241749298	241749399	0	102	0	4764	0	4662	0.0	0.0
chr2	D2HGDH	241749293	241749399	0	107	0	4764	0	4657	0.0	0.0
chr2	NEU4	241814891	241815147	0	257	0	2880	0	2623	0.0	0.0
chr2	NEU4	241809781	241809925	0	145	0	2880	0	2735	0.0	0.0
chr2	NEU4	241813332	241813513	0	182	0	2880	0	2698	0.0	0.0
chr2	NEU4	241813332	241813669	0	338	0	2880	0	2542	0.0	0.0
chr2	RTP5	241870990	241871171	0	182	1147	2609	1147	2427	0.0	0.47259991759373715
chr2	LINC01237	241934073	241934210	0	138	0	1604	0	1466	0.0	0.0
chr2	LINC01881	242116182	242116232	0	51	41197	1821	41197	1770	0.0	23.275141242937853
chr2	LINC01881	242114638	242114741	504	104	41197	1821	40693	1717	4.846153846153846	23.700058241118228
chr2	LINC01881	242130654	242130866	0	213	41197	1821	41197	1608	0.0	25.62002487562189
chr3	LINC01986	14770	14831	0	62	0	2024	0	1962	0.0	0.0
chr3	LINC01986	20556	20597	0	42	0	2024	0	1982	0.0	0.0
chr3	CHL1	244612	244692	0	81	51	11729	51	11648	0.0	0.004378434065934066
chr3	CHL1	342983	343031	0	49	51	11729	51	11680	0.0	0.004366438356164384
chr3	CHL1	398226	398385	0	160	51	11729	51	11569	0.0	0.0044083326130175465
chr3	LINC01266	749857	749942	0	86	0	11866	0	11780	0.0	0.0
chr3	LINC01266	840714	840810	0	97	0	11866	0	11769	0.0	0.0
chr3	LINC01266	798148	798265	0	118	0	11866	0	11748	0.0	0.0
chr3	LINC01266	827006	827133	0	128	0	11866	0	11738	0.0	0.0
chr3	CNTN6	1128266	1128377	0	112	0	5532	0	5420	0.0	0.0
chr3	CNTN6	1173203	1173318	0	116	0	5532	0	5416	0.0	0.0
chr3	CNTN6	1147926	1148063	0	138	0	5532	0	5394	0.0	0.0
chr3	CNTN4	2099273	2099649	0	377	0	8815	0	8438	0.0	0.0
chr3	CNTN4	2100557	2100639	0	83	0	8815	0	8732	0.0	0.0
chr3	CNTN4	2883144	2883247	0	104	0	8815	0	8711	0.0	0.0
chr3	CNTN4	2262345	2262430	0	86	0	8815	0	8729	0.0	0.0
chr3	CNTN4	2629525	2629579	0	55	0	8815	0	8760	0.0	0.0
chr3	TRNT1	3136675	3136797	0	123	0	5803	0	5680	0.0	0.0
chr3	TRNT1	3140509	3140648	0	140	0	5803	0	5663	0.0	0.0
chr3	TRNT1	3129013	3129188	0	176	0	5803	0	5627	0.0	0.0
chr3	TRNT1	3137259	3137453	0	195	0	5803	0	5608	0.0	0.0
chr3	TRNT1	3146429	3146623	0	195	0	5803	0	5608	0.0	0.0
chr3	TRNT1	3139588	3139710	0	123	0	5803	0	5680	0.0	0.0
chr3	TRNT1	3146429	3146563	0	135	0	5803	0	5668	0.0	0.0
chr3	TRNT1	3127945	3128018	0	74	0	5803	0	5729	0.0	0.0
chr3	TRNT1	3146415	3146623	0	209	0	5803	0	5594	0.0	0.0
chr3	TRNT1	3140509	3140578	0	70	0	5803	0	5733	0.0	0.0
chr3	TRNT1	3142893	3143058	0	166	0	5803	0	5637	0.0	0.0
chr3	AC023480.1	4030037	4030125	0	89	0	2206	0	2117	0.0	0.0
chr3	SETMAR	4312897	4313229	0	333	255	3571	255	3238	0.0	0.07875231624459543
chr3	SETMAR	4313646	4313761	0	116	255	3571	255	3455	0.0	0.07380607814761216
chr3	ITPR1	4653841	4653886	0	46	21536	30866	21536	30820	0.0	0.6987670343932512
chr3	ITPR1	4795064	4795187	0	124	21536	30866	21536	30742	0.0	0.7005399778804242
chr3	ITPR1	4727125	4727173	0	49	21536	30866	21536	30817	0.0	0.6988350585715677
chr3	ITPR1	4727122	4727173	0	52	21536	30866	21536	30814	0.0	0.6989030959953269
chr3	ITPR1	4799354	4799387	0	34	21536	30866	21536	30832	0.0	0.6984950700570836
chr3	ITPR1	4709691	4709729	0	39	21536	30866	21536	30827	0.0	0.6986083627988452
chr3	ARL8B	5128459	5128584	0	126	4094	3554	4094	3428	0.0	1.1942823803967328
chr3	EDEM1	5199591	5199695	0	105	69052	6752	69052	6647	0.0	10.388445915450578
chr3	AC069277.1	6710452	6710543	0	92	1620	6372	1620	6280	0.0	0.25796178343949044
chr3	AC069277.1	6578044	6578137	0	94	1620	6372	1620	6278	0.0	0.25804396304555594
chr3	AC069277.1	6697831	6697947	0	117	1620	6372	1620	6255	0.0	0.2589928057553957
chr3	AC069277.1	6706635	6706728	0	94	1620	6372	1620	6278	0.0	0.25804396304555594
chr3	AC069277.1	6694776	6694877	0	102	1620	6372	1620	6270	0.0	0.2583732057416268
chr3	AC069277.1	6720086	6720271	0	186	1620	6372	1620	6186	0.0	0.2618816682832202
chr3	AC069277.1	6694724	6694877	0	154	1620	6372	1620	6218	0.0	0.2605339337407527
chr3	AC069277.1	6697395	6697511	0	117	1620	6372	1620	6255	0.0	0.2589928057553957
chr3	AC069277.1	6734498	6734648	0	151	1620	6372	1620	6221	0.0	0.260408294486417
chr3	AC069277.1	6695284	6695461	0	178	1620	6372	1620	6194	0.0	0.26154342912495965
chr3	AC069277.1	6697782	6697947	0	166	1620	6372	1620	6206	0.0	0.26103770544634225
chr3	GRM7	6786591	6786686	0	96	0	8241	0	8145	0.0	0.0
chr3	GRM7	6884219	6884306	0	88	0	8241	0	8153	0.0	0.0
chr3	GRM7	7686356	7686448	0	93	0	8241	0	8148	0.0	0.0
chr3	GRM7	7691209	7691328	0	120	0	8241	0	8121	0.0	0.0
chr3	GRM7	7691038	7691106	0	69	0	8241	0	8172	0.0	0.0
chr3	AC018832.1	8089903	8090157	0	255	51	1329	51	1074	0.0	0.04748603351955307
chr3	LMCD1	8532736	8532825	0	90	639	9033	639	8943	0.0	0.07145253270714526
chr3	LMCD1	8537184	8537440	0	257	639	9033	639	8776	0.0	0.07281221513217867
chr3	LMCD1	8514924	8514995	3	72	639	9033	636	8961	0.041666666666666664	0.07097422162705055
chr3	SRGAP3-AS2	9193428	9193490	0	63	0	1442	0	1379	0.0	0.0
chr3	SRGAP3-AS2	9193282	9193490	0	209	0	1442	0	1233	0.0	0.0
chr3	SRGAP3-AS2	9193317	9193490	0	174	0	1442	0	1268	0.0	0.0
chr3	SRGAP3-AS2	9193374	9193490	0	117	0	1442	0	1325	0.0	0.0
chr3	THUMPD3	9363834	9364038	0	205	1581	5167	1581	4962	0.0	0.3186215235792019
chr3	SETD5	9424466	9424526	2497	61	345674	12159	343177	12098	40.9344262295082	28.366424202347496
chr3	SETD5	9429826	9430051	4755	226	345674	12159	340919	11933	21.039823008849556	28.569429313667978
chr3	SETD5	9433369	9433562	57626	194	345674	12159	288048	11965	297.0412371134021	24.074216464688675
chr3	SETD5	9434589	9434630	446	42	345674	12159	345228	12117	10.619047619047619	28.491210695716763
chr3	SETD5	9436849	9436888	469	40	345674	12159	345205	12119	11.725	28.484610941496822
chr3	SETD5	9422722	9423257	16947	536	345674	12159	328727	11623	31.617537313432837	28.282457196937106
chr3	SETD5	9436067	9436140	2411	74	345674	12159	343263	12085	32.58108108108108	28.404054613156806
chr3	SETD5	9434044	9434181	1358	138	345674	12159	344316	12021	9.840579710144928	28.64287496880459
chr3	SETD5	9468518	9468575	0	58	345674	12159	345674	12101	0.0	28.565738368729857
chr3	MTMR14	9668718	9668794	42	77	1215	3678	1173	3601	0.5454545454545454	0.3257428492085532
chr3	MTMR14	9687820	9687891	0	72	1215	3678	1215	3606	0.0	0.3369384359400998
chr3	MTMR14	9689963	9690143	0	181	1215	3678	1215	3497	0.0	0.34744066342579355
chr3	MTMR14	9697710	9697866	0	157	1215	3678	1215	3521	0.0	0.3450724226072139
chr3	MTMR14	9650327	9650529	102	203	1215	3678	1113	3475	0.5024630541871922	0.32028776978417267
chr3	CPNE9	9715973	9716035	224	63	67632	2337	67408	2274	3.5555555555555554	29.6429199648197
chr3	BRPF1	9744223	9744508	0	286	180397	6082	180397	5796	0.0	31.1243961352657
chr3	BRPF1	9733172	9733370	765	199	180397	6082	179632	5883	3.8442211055276383	30.534081251062382
chr3	BRPF1	9742351	9742541	852	191	180397	6082	179545	5891	4.460732984293194	30.4778475640808
chr3	OGG1	9750944	9751192	0	249	35008	7070	35008	6821	0.0	5.132385280750623
chr3	OGG1	9754703	9754885	7	183	35008	7070	35001	6887	0.03825136612021858	5.082183824597067
chr3	OGG1	9759233	9759286	0	54	35008	7070	35008	7016	0.0	4.989737742303307
chr3	OGG1	9759186	9759286	0	101	35008	7070	35008	6969	0.0	5.023389295451285
chr3	OGG1	9756470	9756621	0	152	35008	7070	35008	6918	0.0	5.060422087308471
chr3	ARPC4	9801660	9801756	64	97	188349	3616	188285	3519	0.6597938144329897	53.5052571753339
chr3	ARPC4	9799878	9800067	10994	190	188349	3616	177355	3426	57.863157894736844	51.76736719206071
chr3	TTLL3	9810620	9810709	160	90	362171	7028	362011	6938	1.7777777777777777	52.17800518881522
chr3	ARPC4	9803535	9803707	7672	173	188349	3616	180677	3443	44.346820809248555	52.47661922741795
chr3	ARPC4	9800184	9800296	4868	113	188349	3616	183481	3503	43.07964601769911	52.378247216671426
chr3	TTLL3	9816073	9816202	211	130	362171	7028	361960	6898	1.623076923076923	52.47318063206727
chr3	TTLL3	9817644	9817759	72	116	362171	7028	362099	6912	0.6206896551724138	52.387008101851855
chr3	TTLL3	9818554	9818920	0	367	362171	7028	362171	6661	0.0	54.37186608617325
chr3	TTLL3	9818821	9818920	0	100	362171	7028	362171	6928	0.0	52.27641454965358
chr3	TTLL3	9833103	9833245	44849	143	362171	7028	317322	6885	313.6293706293706	46.08888888888889
chr3	TTLL3	9825799	9825948	73612	150	362171	7028	288559	6878	490.74666666666667	41.953911020645535
chr3	TTLL3	9834680	9834907	24948	228	362171	7028	337223	6800	109.42105263157895	49.591617647058825
chr3	TTLL3	9834426	9834503	1036	78	362171	7028	361135	6950	13.282051282051283	51.96187050359712
chr3	TTLL3	9827214	9827240	522	27	362171	7028	361649	7001	19.333333333333332	51.65676331952578
chr3	IL17RE	9903396	9903412	0	17	839	4690	839	4673	0.0	0.17954205007489835
chr3	IL17RE	9904031	9904151	0	121	839	4690	839	4569	0.0	0.1836288028014883
chr3	IL17RE	9909216	9909283	0	68	839	4690	839	4622	0.0	0.1815231501514496
chr3	IL17RE	9906363	9906461	0	99	839	4690	839	4591	0.0	0.18274885645828795
chr3	IL17RC	9918334	9918409	0	76	12687	3519	12687	3443	0.0	3.684867847807145
chr3	IL17RC	9920924	9920969	0	46	12687	3519	12687	3473	0.0	3.6530377195508206
chr3	IL17RC	9930027	9930149	0	123	12687	3519	12687	3396	0.0	3.7358657243816253
chr3	IL17RC	9930399	9930459	0	61	12687	3519	12687	3458	0.0	3.6688837478311163
chr3	IL17RC	9928579	9928630	0	52	12687	3519	12687	3467	0.0	3.659359676954139
chr3	IL17RC	9932819	9932858	411	40	12687	3519	12276	3479	10.275	3.5286001724633516
chr3	IL17RC	9918499	9918609	0	111	12687	3519	12687	3408	0.0	3.722711267605634
chr3	IL17RC	9918534	9918609	0	76	12687	3519	12687	3443	0.0	3.684867847807145
chr3	IL17RC	9917518	9917633	0	116	12687	3519	12687	3403	0.0	3.7281810167499265
chr3	CRELD1	9934419	9934612	6219	194	156318	3805	150099	3611	32.05670103092783	41.56715591248962
chr3	CRELD1	9938014	9938106	37	93	156318	3805	156281	3712	0.3978494623655914	42.1015625
chr3	CRELD1	9942812	9942896	0	85	156318	3805	156318	3720	0.0	42.020967741935486
chr3	CRELD1	9937561	9937672	0	112	156318	3805	156318	3693	0.0	42.32818846466287
chr3	CRELD1	9943993	9944095	0	103	156318	3805	156318	3702	0.0	42.22528363047002
chr3	CRELD1	9943901	9944095	0	195	156318	3805	156318	3610	0.0	43.30138504155125
chr3	EMC3-AS1	9988371	9988477	1816	107	246989	2562	245173	2455	16.97196261682243	99.86680244399186
chr3	FANCD2	10052386	10052497	0	112	231280	7736	231280	7624	0.0	30.335781741867788
chr3	FANCD2	10067208	10067317	1004	110	231280	7736	230276	7626	9.127272727272727	30.196170993968003
chr3	FANCD2	10090291	10090385	0	95	231280	7736	231280	7641	0.0	30.268289490904333
chr3	FANCD2	10094288	10094363	0	76	231280	7736	231280	7660	0.0	30.193211488250654
chr3	FANCD2	10032298	10032423	617	126	231280	7736	230663	7610	4.896825396825397	30.310512483574243
chr3	VHL	10146513	10146636	0	124	12003	4894	12003	4770	0.0	2.516352201257862
chr3	TATDN2	10279220	10279927	715	708	23501	5581	22786	4873	1.0098870056497176	4.675969628565565
chr3	SLC6A1	11018597	11018698	0	102	0	12472	0	12370	0.0	0.0
chr3	SLC6A1	11020212	11020322	0	111	0	12472	0	12361	0.0	0.0
chr3	SLC6A1	11015671	11015733	0	63	0	12472	0	12409	0.0	0.0
chr3	SLC6A1	11017842	11017974	0	133	0	12472	0	12339	0.0	0.0
chr3	SLC6A1	11012598	11012762	0	165	0	12472	0	12307	0.0	0.0
chr3	SLC6A1	11008311	11008363	0	53	0	12472	0	12419	0.0	0.0
chr3	SLC6A1	11013994	11014184	0	191	0	12472	0	12281	0.0	0.0
chr3	SLC6A1	11014717	11014874	0	158	0	12472	0	12314	0.0	0.0
chr3	SLC6A1	11014065	11014184	0	120	0	12472	0	12352	0.0	0.0
chr3	SLC6A1	11014031	11014184	0	154	0	12472	0	12318	0.0	0.0
chr3	SLC6A1	11015671	11015790	0	120	0	12472	0	12352	0.0	0.0
chr3	SLC6A1	11019207	11019269	0	63	0	12472	0	12409	0.0	0.0
chr3	SLC6A1	11011286	11011325	0	40	0	12472	0	12432	0.0	0.0
chr3	ATG7	11281036	11281102	662	67	98972	8862	98310	8795	9.880597014925373	11.177942012507106
chr3	ATG7	11306942	11307060	306	119	98972	8862	98666	8743	2.5714285714285716	11.285142399633992
chr3	ATG7	11280993	11281102	672	110	98972	8862	98300	8752	6.109090909090909	11.231718464351005
chr3	ATG7	11282192	11282438	1358	247	98972	8862	97614	8615	5.497975708502024	11.330702263493906
chr3	ATG7	11313303	11313420	0	118	98972	8862	98972	8744	0.0	11.318847209515097
chr3	ATG7	11332971	11333093	120	123	98972	8862	98852	8739	0.975609756097561	11.311591715299233
chr3	ATG7	11379971	11380052	0	82	98972	8862	98972	8780	0.0	11.272437357630979
chr3	ATG7	11426803	11426926	0	124	98972	8862	98972	8738	0.0	11.326619363698788
chr3	PPARG	12312379	12312453	0	75	4942	4552	4942	4477	0.0	1.1038641947732857
chr3	PPARG	12379703	12379931	0	229	4942	4552	4942	4323	0.0	1.1431876012028683
chr3	PPARG	12416703	12417154	0	452	4942	4552	4942	4100	0.0	1.2053658536585365
chr3	PPARG	12344806	12344894	0	89	4942	4552	4942	4463	0.0	1.1073269101501233
chr3	PPARG	12301520	12301849	0	330	4942	4552	4942	4222	0.0	1.1705352913311227
chr3	PPARG	12297868	12297940	0	73	4942	4552	4942	4479	0.0	1.1033712882339808
chr3	PPARG	12371850	12372111	0	262	4942	4552	4942	4290	0.0	1.151981351981352
chr3	PPARG	12399347	12399490	0	144	4942	4552	4942	4408	0.0	1.1211433756805809
chr3	TSEN2	12505153	12505231	0	79	54797	4706	54797	4627	0.0	11.842878755132915
chr3	TSEN2	12532661	12532773	0	113	54797	4706	54797	4593	0.0	11.930546483779665
chr3	MKRN2	12568874	12569003	239	130	78645	8723	78406	8593	1.8384615384615384	9.124403584312812
chr3	MKRN2	12570324	12570583	7555	260	78645	8723	71090	8463	29.057692307692307	8.400094529126788
chr3	MKRN2	12568874	12568997	233	124	78645	8723	78412	8599	1.8790322580645162	9.118734736597279
chr3	CAND2	12806388	12806496	0	109	1918	5586	1918	5477	0.0	0.35019171079057876
chr3	HDAC11	13496735	13496852	0	118	102	5097	102	4979	0.0	0.020486041373769835
chr3	HDAC11	13483463	13483564	0	102	102	5097	102	4995	0.0	0.02042042042042042
chr3	HDAC11	13501870	13501933	0	64	102	5097	102	5033	0.0	0.02026624279753626
chr3	HDAC11	13498512	13498555	0	44	102	5097	102	5053	0.0	0.020186028102117552
chr3	HDAC11	13500712	13500789	0	78	102	5097	102	5019	0.0	0.020322773460848775
chr3	HDAC11	13502883	13502980	0	98	102	5097	102	4999	0.0	0.020404080816163232
chr3	FBLN2	13621774	13621915	0	142	9680	4777	9680	4635	0.0	2.0884573894282634
chr3	LINC00620	13715945	13715968	0	24	349	1052	349	1028	0.0	0.33949416342412453
chr3	TPRXL	13955205	13955316	0	112	255	3521	255	3409	0.0	0.0748019947198592
chr3	TPRXL	14028275	14028384	0	110	255	3521	255	3411	0.0	0.07475813544415127
chr3	TPRXL	13955561	13955654	0	94	255	3521	255	3427	0.0	0.07440910417274584
chr3	TPRXL	14063378	14063508	0	131	255	3521	255	3390	0.0	0.0752212389380531
chr3	TPRXL	14057137	14057184	0	48	255	3521	255	3473	0.0	0.0734235531241002
chr3	TMEM43	14128854	14129085	0	232	314	3511	314	3279	0.0	0.09576090271424215
chr3	XPC-AS1	14147954	14148701	1224	748	2119	4026	895	3278	1.6363636363636365	0.273032336790726
chr3	XPC-AS1	14151363	14151441	0	79	2119	4026	2119	3947	0.0	0.5368634405877882
chr3	XPC-AS1	14149506	14149602	0	97	2119	4026	2119	3929	0.0	0.5393229829473148
chr3	SLC6A6	14443623	14443863	696	241	158348	8272	157652	8031	2.887966804979253	19.630432075706636
chr3	SLC6A6	14468087	14468212	0	126	158348	8272	158348	8146	0.0	19.438742941320893
chr3	SLC6A6	14443627	14443863	684	237	158348	8272	157664	8035	2.8860759493670884	19.6221530802738
chr3	SLC6A6	14444737	14444866	1467	130	158348	8272	156881	8142	11.284615384615385	19.268115942028984
chr3	FGD5	14926069	14926198	0	130	51	8116	51	7986	0.0	0.006386175807663411
chr3	NR2C2	15004556	15004613	0	58	15956	11841	15956	11783	0.0	1.3541542900789272
chr3	CAPN7	15210801	15210922	0	122	474	5619	474	5497	0.0	0.08622885210114609
chr3	CAPN7	15212103	15212212	0	110	474	5619	474	5509	0.0	0.08604102377927028
chr3	CAPN7	15241452	15241588	0	137	474	5619	474	5482	0.0	0.08646479387085006
chr3	CAPN7	15232110	15232158	0	49	474	5619	474	5570	0.0	0.0850987432675045
chr3	SH3BP5-AS1	15258108	15258183	0	76	12888	6880	12888	6804	0.0	1.8941798941798942
chr3	EAF1	15432086	15432223	40	138	2099	3557	2059	3419	0.2898550724637681	0.6022228721848494
chr3	BTD	15632590	15632866	0	277	168001	13089	168001	12812	0.0	13.112784889166406
chr3	BTD	15631426	15631495	6	70	168001	13089	167995	13019	0.08571428571428572	12.903832859666641
chr3	BTD	15630001	15630120	0	120	168001	13089	168001	12969	0.0	12.954044259387771
chr3	BTD	15602136	15602310	6019	175	168001	13089	161982	12914	34.394285714285715	12.54313148520985
chr3	BTD	15644315	15644931	1261	617	168001	13089	166740	12472	2.0437601296596433	13.36914688903143
chr3	OXNAD1	16271658	16271722	0	65	34065	6108	34065	6043	0.0	5.637100777759391
chr3	OXNAD1	16272144	16272321	0	178	34065	6108	34065	5930	0.0	5.744519392917369
chr3	LINC00690	16525430	16525585	0	156	0	3568	0	3412	0.0	0.0
chr3	LINC00690	16536552	16536666	0	115	0	3568	0	3453	0.0	0.0
chr3	LINC00690	16536588	16536666	0	79	0	3568	0	3489	0.0	0.0
chr3	LINC00690	16536767	16536982	0	216	0	3568	0	3352	0.0	0.0
chr3	SATB1-AS1	18465293	18465358	0	66	0	12779	0	12713	0.0	0.0
chr3	SATB1-AS1	18473711	18473858	0	148	0	12779	0	12631	0.0	0.0
chr3	SATB1-AS1	18472361	18472459	0	99	0	12779	0	12680	0.0	0.0
chr3	SATB1-AS1	18527950	18528139	0	190	0	12779	0	12589	0.0	0.0
chr3	SATB1-AS1	18528075	18528139	0	65	0	12779	0	12714	0.0	0.0
chr3	SATB1-AS1	18516044	18516178	0	135	0	12779	0	12644	0.0	0.0
chr3	SATB1-AS1	18529980	18530185	0	206	0	12779	0	12573	0.0	0.0
chr3	SATB1-AS1	18585386	18585442	0	57	0	12779	0	12722	0.0	0.0
chr3	SATB1-AS1	18511531	18511628	0	98	0	12779	0	12681	0.0	0.0
chr3	SATB1-AS1	18548063	18548193	0	131	0	12779	0	12648	0.0	0.0
chr3	SATB1-AS1	18586869	18586908	0	40	0	12779	0	12739	0.0	0.0
chr3	SATB1-AS1	18546790	18546952	0	163	0	12779	0	12616	0.0	0.0
chr3	SATB1-AS1	18529980	18530326	0	347	0	12779	0	12432	0.0	0.0
chr3	SATB1-AS1	18665839	18665895	0	57	0	12779	0	12722	0.0	0.0
chr3	SATB1-AS1	18568106	18568154	0	49	0	12779	0	12730	0.0	0.0
chr3	SATB1-AS1	18527784	18528139	0	356	0	12779	0	12423	0.0	0.0
chr3	SATB1-AS1	18843135	18843176	0	42	0	12779	0	12737	0.0	0.0
chr3	SATB1-AS1	18585619	18585762	0	144	0	12779	0	12635	0.0	0.0
chr3	SATB1-AS1	18530938	18531039	0	102	0	12779	0	12677	0.0	0.0
chr3	SATB1-AS1	18584916	18585043	0	128	0	12779	0	12651	0.0	0.0
chr3	KCNH8	19346651	19346734	0	84	0	6105	0	6021	0.0	0.0
chr3	RAB5A	19970547	19970717	0	171	52	3774	52	3603	0.0	0.014432417429919511
chr3	SGO1-AS1	20177216	20177250	0	35	2971	6600	2971	6565	0.0	0.45255140898705254
chr3	UBE2E2	23499607	23499740	0	134	0	3250	0	3116	0.0	0.0
chr3	UBE2E2	23323514	23323586	0	73	0	3250	0	3177	0.0	0.0
chr3	UBE2E1	23811459	23811510	0	52	6850	3357	6850	3305	0.0	2.0726172465960664
chr3	UBE2E1	23888237	23888261	0	25	6850	3357	6850	3332	0.0	2.0558223289315727
chr3	RPL15	23917532	23917665	0	134	7244	6231	7244	6097	0.0	1.1881253075282927
chr3	NR1D2	23963223	23963330	0	108	578119	5803	578119	5695	0.0	101.5134328358209
chr3	THRB-AS1	24496663	24496818	0	156	51	7672	51	7516	0.0	0.006785524215007983
chr3	THRB-AS1	24499231	24499374	0	144	51	7672	51	7528	0.0	0.00677470775770457
chr3	RARB	25569757	25569918	0	162	0	3708	0	3546	0.0	0.0
chr3	RARB	25593502	25593707	0	206	0	3708	0	3502	0.0	0.0
chr3	RARB	25593640	25593707	0	68	0	3708	0	3640	0.0	0.0
chr3	LINC01980	27802113	27802218	0	106	0	4756	0	4650	0.0	0.0
chr3	LINC01980	27848700	27848764	0	65	0	4756	0	4691	0.0	0.0
chr3	LINC01980	27806531	27806622	0	92	0	4756	0	4664	0.0	0.0
chr3	LINC01980	27840278	27840387	0	110	0	4756	0	4646	0.0	0.0
chr3	LINC01980	27802763	27802850	0	88	0	4756	0	4668	0.0	0.0
chr3	LINC01980	27826057	27826211	0	155	0	4756	0	4601	0.0	0.0
chr3	LINC01980	27802113	27802370	0	258	0	4756	0	4498	0.0	0.0
chr3	LINC01980	27807952	27808008	0	57	0	4756	0	4699	0.0	0.0
chr3	LINC01980	27802113	27802850	0	738	0	4756	0	4018	0.0	0.0
chr3	LINC01980	27806453	27806622	0	170	0	4756	0	4586	0.0	0.0
chr3	LINC01980	27806451	27806622	0	172	0	4756	0	4584	0.0	0.0
chr3	LINC01980	27841727	27841925	0	199	0	4756	0	4557	0.0	0.0
chr3	LINC01980	27826057	27826164	0	108	0	4756	0	4648	0.0	0.0
chr3	LINC01980	27823528	27823617	0	90	0	4756	0	4666	0.0	0.0
chr3	LINC01980	27841727	27841823	0	97	0	4756	0	4659	0.0	0.0
chr3	CMC1	28263290	28263380	0	91	3644	7283	3644	7192	0.0	0.5066740823136818
chr3	ZCWPW2	28390497	28390617	169	121	1291	4551	1122	4430	1.396694214876033	0.2532731376975169
chr3	ZCWPW2	28478813	28478931	0	119	1291	4551	1291	4432	0.0	0.29129061371841153
chr3	ZCWPW2	28351573	28351623	0	51	1291	4551	1291	4500	0.0	0.2868888888888889
chr3	ZCWPW2	28398037	28398232	255	196	1291	4551	1036	4355	1.3010204081632653	0.23788748564867968
chr3	ZCWPW2	28478288	28478387	0	100	1291	4551	1291	4451	0.0	0.2900471804088969
chr3	RBMS3	29899704	29899755	0	52	559	18380	559	18328	0.0	0.030499781754692274
chr3	RBMS3	29944206	29944254	27	49	559	18380	532	18331	0.5510204081632653	0.02902187551142873
chr3	RBMS3	28898483	28898562	0	80	559	18380	559	18300	0.0	0.030546448087431694
chr3	RBMS3	29880778	29880817	0	40	559	18380	559	18340	0.0	0.030479825517993456
chr3	TGFBR2	30623198	30623273	0	76	76420	6861	76420	6785	0.0	11.263080324244658
chr3	OSBPL10-AS1	31718778	31718924	51	147	1130	2319	1079	2172	0.3469387755102041	0.4967771639042357
chr3	OSBPL10-AS1	31718745	31718924	51	180	1130	2319	1079	2139	0.2833333333333333	0.5044413277232351
chr3	GPD1L	32138586	32138727	0	142	29	4164	29	4022	0.0	0.0072103431128791645
chr3	GPD1L	32128075	32128253	0	179	29	4164	29	3985	0.0	0.007277289836888331
chr3	CMTM8	32357372	32357546	0	175	0	1174	0	999	0.0	0.0
chr3	CMTM7	32452391	32452473	0	83	1122	3730	1122	3647	0.0	0.3076501233890869
chr3	CMTM7	32449453	32449552	0	100	1122	3730	1122	3630	0.0	0.3090909090909091
chr3	CNOT10	32704810	32704972	0	163	40685	4488	40685	4325	0.0	9.406936416184971
chr3	CNOT10	32713226	32713369	0	144	40685	4488	40685	4344	0.0	9.365791896869245
chr3	CNOT10	32720113	32720231	0	119	40685	4488	40685	4369	0.0	9.31219958800641
chr3	CNOT10	32764454	32764490	37	37	40685	4488	40648	4451	1.0	9.13232981352505
chr3	CNOT10	32737409	32737490	37	82	40685	4488	40648	4406	0.45121951219512196	9.225601452564684
chr3	CRTAP	33129938	33130067	2152	130	90426	6668	88274	6538	16.553846153846155	13.501682471703885
chr3	FBXL2	33297868	33297962	0	95	3152	7427	3152	7332	0.0	0.4298963447899618
chr3	FBXL2	33358966	33359021	0	56	3152	7427	3152	7371	0.0	0.4276217609550943
chr3	FBXL2	33317476	33317613	0	138	3152	7427	3152	7289	0.0	0.43243243243243246
chr3	FBXL2	33359282	33359357	0	76	3152	7427	3152	7351	0.0	0.4287851992926133
chr3	FBXL2	33364624	33364719	0	96	3152	7427	3152	7331	0.0	0.4299549856772609
chr3	PDCD6IP	33812071	33812126	0	56	171570	8689	171570	8633	0.0	19.87374029885324
chr3	PDCD6IP	33821954	33822082	0	129	171570	8689	171570	8560	0.0	20.04322429906542
chr3	PDCD6IP	33841896	33842074	590	179	171570	8689	170980	8510	3.2960893854748603	20.09165687426557
chr3	PDCD6IP	33827621	33827739	0	119	171570	8689	171570	8570	0.0	20.019836639439905
chr3	PDCD6IP	33811096	33811191	0	96	171570	8689	171570	8593	0.0	19.96625160013965
chr3	PDCD6IP	33835253	33835318	198	66	171570	8689	171372	8623	3.0	19.873825814681666
chr3	LINC01811	34170844	34170920	0	77	0	7983	0	7906	0.0	0.0
chr3	LINC01811	34298852	34298919	0	68	0	7983	0	7915	0.0	0.0
chr3	LINC01811	34346221	34346289	0	69	0	7983	0	7914	0.0	0.0
chr3	LINC01811	34409260	34409349	0	90	0	7983	0	7893	0.0	0.0
chr3	LINC01811	34386890	34387077	0	188	0	7983	0	7795	0.0	0.0
chr3	LINC01811	34323347	34323598	0	252	0	7983	0	7731	0.0	0.0
chr3	LINC01811	34367379	34367468	0	90	0	7983	0	7893	0.0	0.0
chr3	LINC01811	34409260	34409361	0	102	0	7983	0	7881	0.0	0.0
chr3	LINC01811	34435292	34435456	0	165	0	7983	0	7818	0.0	0.0
chr3	LINC01811	34559178	34559369	0	192	0	7983	0	7791	0.0	0.0
chr3	LINC01811	34300690	34300841	0	152	0	7983	0	7831	0.0	0.0
chr3	LINC01811	34551885	34551988	0	104	0	7983	0	7879	0.0	0.0
chr3	LINC01811	34551406	34551570	0	165	0	7983	0	7818	0.0	0.0
chr3	ARPP21	35680825	35680917	0	93	0	9631	0	9538	0.0	0.0
chr3	ARPP21	35687738	35687883	0	146	0	9631	0	9485	0.0	0.0
chr3	ARPP21	35706973	35707082	0	110	0	9631	0	9521	0.0	0.0
chr3	ARPP21	35738213	35738318	0	106	0	9631	0	9525	0.0	0.0
chr3	ARPP21	35708968	35709070	0	103	0	9631	0	9528	0.0	0.0
chr3	ARPP21	35717297	35717357	0	61	0	9631	0	9570	0.0	0.0
chr3	ARPP21	35707450	35707541	0	92	0	9631	0	9539	0.0	0.0
chr3	ARPP21	35717297	35717361	0	65	0	9631	0	9566	0.0	0.0
chr3	STAC	36443363	36443640	0	278	47203	4410	47203	4132	0.0	11.423765730880929
chr3	MLH1	37004400	37004474	0	75	27312	6920	27312	6845	0.0	3.9900657414170926
chr3	MLH1	37008813	37008905	0	93	27312	6920	27312	6827	0.0	4.000585908891168
chr3	MLH1	37017505	37017599	22	95	27312	6920	27290	6825	0.23157894736842105	3.9985347985347985
chr3	MLH1	37020309	37020463	0	155	27312	6920	27312	6765	0.0	4.037250554323725
chr3	MLH1	37042267	37042331	0	65	27312	6920	27312	6855	0.0	3.9842450765864332
chr3	MLH1	37047518	37047683	0	166	27312	6920	27312	6754	0.0	4.043825880959432
chr3	MLH1	37048516	37048609	5596	94	27312	6920	21716	6826	59.53191489361702	3.1813653677116904
chr3	MLH1	36996618	36996709	0	92	27312	6920	27312	6828	0.0	4.0
chr3	MLH1	37000954	37001053	0	100	27312	6920	27312	6820	0.0	4.004692082111437
chr3	MLH1	36996623	36996709	0	87	27312	6920	27312	6833	0.0	3.9970730279525832
chr3	MLH1	37000954	37001048	0	95	27312	6920	27312	6825	0.0	4.001758241758242
chr3	MLH1	36995388	36995645	0	258	27312	6920	27312	6662	0.0	4.0996697688381865
chr3	MLH1	36994829	36994953	0	125	27312	6920	27312	6795	0.0	4.019426048565121
chr3	MLH1	36997155	36997300	0	146	27312	6920	27312	6774	0.0	4.031886625332152
chr3	MLH1	37014431	37014544	0	114	27312	6920	27312	6806	0.0	4.012929767851896
chr3	MLH1	36994829	36994903	0	75	27312	6920	27312	6845	0.0	3.9900657414170926
chr3	MLH1	37048903	37049017	0	115	27312	6920	27312	6805	0.0	4.013519470977223
chr3	MLH1	37040185	37040294	0	110	27312	6920	27312	6810	0.0	4.01057268722467
chr3	GOLGA4	37286013	37286061	98	49	113066	10768	112968	10719	2.0	10.53904282115869
chr3	GOLGA4	37337142	37337163	0	22	113066	10768	113066	10746	0.0	10.521682486506608
chr3	GOLGA4	37361242	37361305	56	64	113066	10768	113010	10704	0.875	10.557735426008968
chr3	GOLGA4	37273535	37273601	0	67	113066	10768	113066	10701	0.0	10.56592841790487
chr3	GOLGA4	37266841	37266940	0	100	113066	10768	113066	10668	0.0	10.598612673415824
chr3	C3ORF35	37399476	37399659	357	184	9485	7262	9128	7078	1.940217391304348	1.289629838937553
chr3	C3ORF35	37412369	37412488	0	120	9485	7262	9485	7142	0.0	1.3280593671240548
chr3	ITGA9	37803822	37803942	0	121	52	8298	52	8177	0.0	0.006359300476947536
chr3	CTDSPL	37957110	37957143	0	34	929	3408	929	3374	0.0	0.27534084173088325
chr3	CTDSPL	37911672	37911827	0	156	929	3408	929	3252	0.0	0.28567035670356705
chr3	VILL	38000921	38001000	294	80	2015	5326	1721	5246	3.675	0.32805947388486467
chr3	DLEC1	38085273	38085447	0	175	4891	7451	4891	7276	0.0	0.6722100054975261
chr3	DLEC1	38092789	38092880	0	92	4891	7451	4891	7359	0.0	0.6646283462426961
chr3	DLEC1	38094878	38095071	0	194	4891	7451	4891	7257	0.0	0.6739699600385834
chr3	DLEC1	38122070	38122194	0	125	4891	7451	4891	7326	0.0	0.6676221676221676
chr3	MYD88	38139863	38139998	0	136	0	3206	0	3070	0.0	0.0
chr3	MYD88	38140387	38140568	0	182	0	3206	0	3024	0.0	0.0
chr3	MYD88	38140387	38140549	0	163	0	3206	0	3043	0.0	0.0
chr3	MYD88	38140387	38140592	0	206	0	3206	0	3000	0.0	0.0
chr3	OXSR1	38193281	38193418	0	138	48703	6090	48703	5952	0.0	8.182627688172044
chr3	SLC22A13	38274603	38274758	267	156	113324	3007	113057	2851	1.7115384615384615	39.65520869870221
chr3	SLC22A13	38276286	38276395	2	110	113324	3007	113322	2897	0.01818181818181818	39.117017604418365
chr3	XYLB	38362936	38363017	0	82	22229	6350	22229	6268	0.0	3.546426292278239
chr3	XYLB	38360338	38360408	0	71	22229	6350	22229	6279	0.0	3.540213409778627
chr3	XYLB	38373114	38373279	0	166	22229	6350	22229	6184	0.0	3.5945989650711514
chr3	EXOG	38496842	38496929	0	88	28599	4763	28599	4675	0.0	6.117433155080214
chr3	EXOG	38498925	38498989	0	65	28599	4763	28599	4698	0.0	6.087484035759898
chr3	EXOG	38497628	38497778	94	151	28599	4763	28505	4612	0.6225165562913907	6.180615784908933
chr3	EXOG	38499680	38499747	0	68	28599	4763	28599	4695	0.0	6.091373801916933
chr3	EXOG	38500089	38500164	0	76	28599	4763	28599	4687	0.0	6.101770855557926
chr3	EXOG	38497628	38497684	20	57	28599	4763	28579	4706	0.3508771929824561	6.0728856778580536
chr3	EXOG	38513749	38513868	0	120	28599	4763	28599	4643	0.0	6.159595089381865
chr3	EXOG	38519261	38519377	294	117	28599	4763	28305	4646	2.5128205128205128	6.092337494619027
chr3	WDR48	39065810	39065889	0	80	284	4856	284	4776	0.0	0.059463986599664995
chr3	WDR48	39066726	39066875	0	150	284	4856	284	4706	0.0	0.060348491287717805
chr3	WDR48	39066745	39066875	0	131	284	4856	284	4725	0.0	0.06010582010582011
chr3	WDR48	39065790	39065889	0	100	284	4856	284	4756	0.0	0.05971404541631623
chr3	TTC21A	39110028	39110139	0	112	245711	7452	245711	7340	0.0	33.47561307901908
chr3	TTC21A	39112457	39112580	59	124	245711	7452	245652	7328	0.47580645161290325	33.52237991266376
chr3	TTC21A	39110850	39111017	0	168	245711	7452	245711	7284	0.0	33.73297638660077
chr3	TTC21A	39110028	39110233	0	206	245711	7452	245711	7246	0.0	33.90988131382832
chr3	SLC25A38	39391440	39391620	0	181	0	2674	0	2493	0.0	0.0
chr3	SLC25A38	39389361	39389389	0	29	0	2674	0	2645	0.0	0.0
chr3	MOBP	39480039	39480123	0	85	0	9245	0	9160	0.0	0.0
chr3	MOBP	39499466	39499532	0	67	0	9245	0	9178	0.0	0.0
chr3	MOBP	39502534	39502914	0	381	0	9245	0	8864	0.0	0.0
chr3	MOBP	39499866	39500067	0	202	0	9245	0	9043	0.0	0.0
chr3	MOBP	39502462	39502876	0	415	0	9245	0	8830	0.0	0.0
chr3	MOBP	39502534	39502876	0	343	0	9245	0	8902	0.0	0.0
chr3	MYRIP	40151047	40151184	0	138	0	5889	0	5751	0.0	0.0
chr3	MYRIP	40233858	40234053	0	196	0	5889	0	5693	0.0	0.0
chr3	MYRIP	40233895	40234053	0	159	0	5889	0	5730	0.0	0.0
chr3	ENTPD3	40394629	40394753	0	125	5	3600	5	3475	0.0	0.0014388489208633094
chr3	ENTPD3	40394308	40394431	0	124	5	3600	5	3476	0.0	0.0014384349827387803
chr3	ZNF619	40481862	40482016	0	155	16984	5338	16984	5183	0.0	3.2768666795292303
chr3	ZNF619	40483673	40483723	0	51	16984	5338	16984	5287	0.0	3.2124077926990733
chr3	ZNF619	40483652	40483723	0	72	16984	5338	16984	5266	0.0	3.22521838207368
chr3	ZNF619	40482229	40482349	0	121	16984	5338	16984	5217	0.0	3.255510829978915
chr3	ZNF620	40507842	40507941	281	100	29332	3791	29051	3691	2.81	7.8707667298835
chr3	ZNF619	40482199	40482349	0	151	16984	5338	16984	5187	0.0	3.274339695392327
chr3	ZNF620	40508655	40508774	0	120	29332	3791	29332	3671	0.0	7.990193407790793
chr3	ZNF621	40529318	40529445	4598	128	52753	8951	48155	8823	35.921875	5.457894140315085
chr3	CTNNB1	41235723	41235843	0	121	556	9254	556	9133	0.0	0.06087813423847586
chr3	CTNNB1	41224189	41224321	0	133	556	9254	556	9121	0.0	0.060958228264444685
chr3	CTNNB1	41224020	41224081	0	62	556	9254	556	9192	0.0	0.060487380330722366
chr3	CTNNB1	41224953	41224991	0	39	556	9254	556	9215	0.0	0.060336408030385244
chr3	CTNNB1	41238370	41238445	0	76	556	9254	556	9178	0.0	0.060579646981913274
chr3	CTNNB1	41222333	41222345	0	13	556	9254	556	9241	0.0	0.06016664863110053
chr3	CTNNB1	41235726	41235843	0	118	556	9254	556	9136	0.0	0.06085814360770578
chr3	TRAK1	42193823	42193898	0	76	1072	10821	1072	10745	0.0	0.09976733364355514
chr3	TRAK1	42220498	42220591	0	94	1072	10821	1072	10727	0.0	0.09993474410366365
chr3	TRAK1	42151334	42151432	0	99	1072	10821	1072	10722	0.0	0.09998134676366349
chr3	VIPR1	42512750	42512949	0	200	51	7402	51	7202	0.0	0.00708136628714246
chr3	VIPR1	42527990	42528123	0	134	51	7402	51	7268	0.0	0.00701706108970831
chr3	VIPR1	42530778	42530932	0	155	51	7402	51	7247	0.0	0.0070373947840485715
chr3	VIPR1	42513748	42513854	0	107	51	7402	51	7295	0.0	0.0069910897875257024
chr3	VIPR1	42527392	42527496	0	105	51	7402	51	7297	0.0	0.006989173632999863
chr3	NKTR	42620015	42620043	0	29	193016	17018	193016	16989	0.0	11.361233739478486
chr3	NKTR	42627199	42627227	540	29	193016	17018	192476	16989	18.620689655172413	11.329448466654894
chr3	CCDC13-AS1	42740974	42741087	0	114	0	2374	0	2260	0.0	0.0
chr3	ACKR2	42819630	42819711	0	82	26862	5475	26862	5393	0.0	4.980901168180975
chr3	ACKR2	42839093	42839279	102	187	26862	5475	26760	5288	0.5454545454545454	5.0605143721633885
chr3	ACKR2	42851295	42851454	73	160	26862	5475	26789	5315	0.45625	5.040263405456256
chr3	ACKR2	42864465	42864859	0	395	26862	5475	26862	5080	0.0	5.287795275590551
chr3	ZNF662	42908792	42908909	0	118	1275	5905	1275	5787	0.0	0.22032141005702435
chr3	ZNF662	42913200	42913302	0	103	1275	5905	1275	5802	0.0	0.21975180972078592
chr3	GASK1A	43032266	43033553	0	1288	0	4402	0	3114	0.0	0.0
chr3	SNRK	43289739	43289789	0	51	1219	6991	1219	6940	0.0	0.17564841498559078
chr3	SNRK	43303097	43303792	0	696	1219	6991	1219	6295	0.0	0.19364575059571087
chr3	SNRK	43299753	43299815	0	63	1219	6991	1219	6928	0.0	0.1759526558891455
chr3	ABHD5	43714946	43715058	0	113	714	7414	714	7301	0.0	0.0977948226270374
chr3	ABHD5	43717670	43717857	0	188	714	7414	714	7226	0.0	0.0988098533075007
chr3	ABHD5	43690380	43690710	0	331	714	7414	714	7083	0.0	0.10080474375264718
chr3	ABHD5	43702214	43702587	0	374	714	7414	714	7040	0.0	0.10142045454545455
chr3	ABHD5	43733879	43733963	0	85	714	7414	714	7329	0.0	0.09742120343839542
chr3	ABHD5	43694902	43695153	0	252	714	7414	714	7162	0.0	0.09969282323373359
chr3	ABHD5	43702386	43702587	0	202	714	7414	714	7212	0.0	0.09900166389351081
chr3	ABHD5	43717765	43717857	0	93	714	7414	714	7321	0.0	0.09752766015571643
chr3	TCAIM	44357740	44357876	0	137	100200	8758	100200	8621	0.0	11.622781579863124
chr3	TCAIM	44391207	44391331	0	125	100200	8758	100200	8633	0.0	11.6066257384455
chr3	ZKSCAN7	44556929	44557470	0	542	0	4213	0	3671	0.0	0.0
chr3	ZKSCAN7	44567911	44568003	0	93	0	4213	0	4120	0.0	0.0
chr3	ZKSCAN7	44569924	44570665	0	742	0	4213	0	3471	0.0	0.0
chr3	ZNF660	44587129	44587250	0	122	9966	6518	9966	6396	0.0	1.5581613508442778
chr3	ZNF197	44630813	44630946	612	134	816	6691	204	6557	4.567164179104478	0.031111788927863353
chr3	ZNF35	44652556	44652701	0	146	279	2653	279	2507	0.0	0.1112883925009972
chr3	ZNF502	44714590	44714688	0	99	9110	3260	9110	3161	0.0	2.8819993672888327
chr3	KIF15	44774394	44774437	0	44	14903	5319	14903	5275	0.0	2.82521327014218
chr3	KIF15	44826995	44827193	0	199	14903	5319	14903	5120	0.0	2.9107421875
chr3	TGM4	44887688	44887795	291	108	46680	5458	46389	5350	2.6944444444444446	8.670841121495327
chr3	LARS2	45400244	45400373	0	130	45968	12201	45968	12071	0.0	3.8081352000662747
chr3	LARS2	45391582	45391648	0	67	45968	12201	45968	12134	0.0	3.788363276743036
chr3	LARS2	45500026	45500144	0	119	45968	12201	45968	12082	0.0	3.8046681013077306
chr3	LARS2	45509414	45509495	0	82	45968	12201	45968	12119	0.0	3.793052232032346
chr3	LARS2	45399563	45399692	0	130	45968	12201	45968	12071	0.0	3.8081352000662747
chr3	LARS2	45389032	45389106	0	75	45968	12201	45968	12126	0.0	3.7908626092693387
chr3	LARS2	45519692	45519790	0	99	45968	12201	45968	12102	0.0	3.798380432986283
chr3	SACM1L	45706779	45706907	228	129	79362	7303	79134	7174	1.7674418604651163	11.030666294954
chr3	SACM1L	45690347	45690387	574	41	79362	7303	78788	7262	14.0	10.849352795373175
chr3	CCR9	45897560	45897646	0	87	0	2811	0	2724	0.0	0.0
chr3	CCR9	45894905	45894954	0	50	0	2811	0	2761	0.0	0.0
chr3	CCR3	46264386	46264455	0	70	0	2535	0	2465	0.0	0.0
chr3	CCR3	46264386	46264446	0	61	0	2535	0	2474	0.0	0.0
chr3	CCR2	46354861	46354956	0	96	0	3009	0	2913	0.0	0.0
chr3	CCRL2	46407755	46407781	0	27	0	2751	0	2724	0.0	0.0
chr3	PTH1R	46901024	46901085	0	62	0	2734	0	2672	0.0	0.0
chr3	PTH1R	46902900	46902951	0	52	0	2734	0	2682	0.0	0.0
chr3	NBEAL2	46992474	46992555	0	82	9997	10192	9997	10110	0.0	0.9888229475766568
chr3	NBEAL2	46998958	46999117	0	160	9997	10192	9997	10032	0.0	0.9965111642743222
chr3	NBEAL2	47004971	47005096	0	126	9997	10192	9997	10066	0.0	0.9931452414067157
chr3	NBEAL2	47007065	47007155	194	91	9997	10192	9803	10101	2.131868131868132	0.9704979704979705
chr3	NBEAL2	47007524	47007697	0	174	9997	10192	9997	10018	0.0	0.9979037732082252
chr3	NBEAL2	47007240	47007350	0	111	9997	10192	9997	10081	0.0	0.9916674933042356
chr3	NRADDP	47012622	47012765	663	144	3408	1732	2745	1588	4.604166666666667	1.728589420654912
chr3	KLHL18	47297561	47297672	27	112	31610	7076	31583	6964	0.24107142857142858	4.535180930499712
chr3	KLHL18	47319652	47319783	272	132	31610	7076	31338	6944	2.0606060606060606	4.512960829493087
chr3	PTPN23	47396142	47396217	0	76	1443	5900	1443	5824	0.0	0.24776785714285715
chr3	PTPN23	47404651	47404779	0	129	1443	5900	1443	5771	0.0	0.2500433200485185
chr3	DHX30	47822096	47822231	688	136	22831	7768	22143	7632	5.0588235294117645	2.9013364779874213
chr3	DHX30	47819235	47819264	0	30	22831	7768	22831	7738	0.0	2.950504006203153
chr3	DHX30	47815962	47816128	0	167	22831	7768	22831	7601	0.0	3.003683725825549
chr3	ZNF589	48267917	48268160	11	244	116	5529	105	5285	0.045081967213114756	0.019867549668874173
chr3	ZNF589	48267914	48270969	116	3056	116	5529	0	2473	0.03795811518324607	0.0
chr3	FBXW12	48372683	48372857	0	175	0	3503	0	3328	0.0	0.0
chr3	FBXW12	48378316	48378526	0	211	0	3503	0	3292	0.0	0.0
chr3	FBXW12	48372656	48372857	0	202	0	3503	0	3301	0.0	0.0
chr3	FBXW12	48378382	48378526	0	145	0	3503	0	3358	0.0	0.0
chr3	ATRIP	48457258	48457416	0	159	67106	5446	67106	5287	0.0	12.692642330243995
chr3	ATRIP	48450492	48450575	0	84	67106	5446	67106	5362	0.0	12.515106303618053
chr3	ATRIP	48464581	48464662	0	82	67106	5446	67106	5364	0.0	12.510439970171515
chr3	ATRIP	48461360	48461445	1426	86	67106	5446	65680	5360	16.58139534883721	12.253731343283581
chr3	TREX1	48466629	48466641	21	13	11041	1427	11020	1414	1.6153846153846154	7.793493635077794
chr3	ARIH2	48927461	48927813	0	353	100980	7097	100980	6744	0.0	14.973309608540925
chr3	ARIH2	48922747	48922811	14	65	100980	7097	100966	7032	0.2153846153846154	14.358077360637088
chr3	ARIH2	48945135	48945181	0	47	100980	7097	100980	7050	0.0	14.323404255319149
chr3	ARIH2	48961611	48961679	2304	69	100980	7097	98676	7028	33.391304347826086	14.040409789413774
chr3	ARIH2	48924717	48924839	84	123	100980	7097	100896	6974	0.6829268292682927	14.467450530542013
chr3	ARIH2	48924717	48924971	324	255	100980	7097	100656	6842	1.2705882352941176	14.71148786904414
chr3	ARIH2	48922348	48922468	0	121	100980	7097	100980	6976	0.0	14.475344036697248
chr3	ARIH2	48921479	48921576	21456	98	100980	7097	79524	6999	218.9387755102041	11.362194599228461
chr3	WDR6	49008926	49009024	2414	99	160033	4997	157619	4898	24.383838383838384	32.1802776643528
chr3	WDR6	49011420	49011516	25	97	160033	4997	160008	4900	0.25773195876288657	32.65469387755102
chr3	KLHDC8B	49175061	49175163	0	103	1125	2082	1125	1979	0.0	0.5684689236988378
chr3	IHO1	49244403	49244452	0	50	3176	4346	3176	4296	0.0	0.7392923649906891
chr3	DAG1	49476848	49476905	0	58	4259	6735	4259	6677	0.0	0.6378613149618092
chr3	DAG1	49492822	49492973	0	152	4259	6735	4259	6583	0.0	0.646969466808446
chr3	DAG1	49470964	49471049	0	86	4259	6735	4259	6649	0.0	0.6405474507444728
chr3	DAG1	49487253	49487415	51	163	4259	6735	4208	6572	0.3128834355828221	0.6402921485088253
chr3	DAG1	49476848	49476900	0	53	4259	6735	4259	6682	0.0	0.6373840167614486
chr3	DAG1	49488625	49488745	0	121	4259	6735	4259	6614	0.0	0.6439371031146054
chr3	DAG1	49492826	49492973	0	148	4259	6735	4259	6587	0.0	0.6465765902535296
chr3	APEH	49676055	49676219	0	165	1028	4242	1028	4077	0.0	0.25214618592102034
chr3	APEH	49676377	49676515	0	139	1028	4242	1028	4103	0.0	0.2505483792347063
chr3	APEH	49675182	49675309	0	128	1028	4242	1028	4114	0.0	0.2498784637822071
chr3	APEH	49674488	49674621	0	134	1028	4242	1028	4108	0.0	0.25024342745861733
chr3	RNF123	49713737	49713825	20538	89	600657	6716	580119	6627	230.76404494382024	87.53870529651427
chr3	RBM6	50048244	50048319	35	76	34941	7225	34906	7149	0.4605263157894737	4.882640928801231
chr3	RBM6	49967197	49968748	813	1552	34941	7225	34128	5673	0.523840206185567	6.015864621893178
chr3	RBM6	49999439	49999513	0	75	34941	7225	34941	7150	0.0	4.886853146853147
chr3	RBM6	49967469	49968748	0	1280	34941	7225	34941	5945	0.0	5.877375946173255
chr3	RBM6	50060800	50060835	0	36	34941	7225	34941	7189	0.0	4.860342189456113
chr3	RBM5	50100531	50100605	0	75	69973	8339	69973	8264	0.0	8.467207163601161
chr3	RBM5	50104247	50104308	0	62	69973	8339	69973	8277	0.0	8.453908420925456
chr3	RBM5	50110378	50110463	481	86	69973	8339	69492	8253	5.593023255813954	8.420210832424573
chr3	RBM5	50092978	50093042	0	65	69973	8339	69973	8274	0.0	8.456973652405125
chr3	SEMA3F	50175095	50175188	0	94	34547	4840	34547	4746	0.0	7.2791824694479565
chr3	SLC38A3	50207335	50207477	0	143	102139	3688	102139	3545	0.0	28.81212976022567
chr3	SLC38A3	50215385	50215459	0	75	102139	3688	102139	3613	0.0	28.269858843066704
chr3	GNAI2	50251619	50251743	47	125	2938	6852	2891	6727	0.376	0.4297606659729448
chr3	GNAI2	50252099	50252142	0	44	2938	6852	2938	6808	0.0	0.431551116333725
chr3	SEMA3B	50275301	50275459	0	159	47685	5099	47685	4940	0.0	9.652834008097166
chr3	CYB561D2	50352008	50352046	60	39	26695	1930	26635	1891	1.5384615384615385	14.08514013749339
chr3	HEMK1	50572114	50572208	0	95	10790	17946	10790	17851	0.0	0.6044479300879503
chr3	MAPKAPK3	50647122	50647203	266	82	18720	3892	18454	3810	3.2439024390243905	4.843569553805774
chr3	MANF	51386908	51387046	0	139	255	2143	255	2004	0.0	0.12724550898203593
chr3	RAD54L2	51630271	51630388	0	118	68536	11508	68536	11390	0.0	6.017208077260755
chr3	TEX264	51672340	51672392	740	53	62004	2470	61264	2417	13.962264150943396	25.34712453454696
chr3	TEX264	51684412	51684634	521	223	62004	2470	61483	2247	2.336322869955157	27.362260792167334
chr3	TEX264	51672209	51672301	7343	93	62004	2470	54661	2377	78.95698924731182	22.995793016407237
chr3	TEX264	51674270	51674562	1428	293	62004	2470	60576	2177	4.873720136518771	27.825447864033073
chr3	GRM2	51713963	51714121	673	159	104926	4215	104253	4056	4.232704402515723	25.703402366863905
chr3	IQCF4P	51818208	51818471	0	264	0	1177	0	913	0.0	0.0
chr3	PARP3	51942929	51943046	0	118	53	2938	53	2820	0.0	0.01879432624113475
chr3	ABHD14A-ACY1	51984046	51984158	0	113	7419	4173	7419	4060	0.0	1.8273399014778324
chr3	ABHD14A-ACY1	51985360	51985465	0	106	7419	4173	7419	4067	0.0	1.8241947381362182
chr3	ABHD14A-ACY1	51985851	51985946	0	96	7419	4173	7419	4077	0.0	1.8197203826342898
chr3	ABHD14A-ACY1	51986414	51986504	1167	91	7419	4173	6252	4082	12.824175824175825	1.5316021558059774
chr3	ABHD14A-ACY1	51977870	51978082	1131	213	7419	4173	6288	3960	5.309859154929577	1.587878787878788
chr3	ABHD14A-ACY1	51985206	51985271	0	66	7419	4173	7419	4107	0.0	1.806428049671293
chr3	ABHD14A-ACY1	51988523	51988603	337	81	7419	4173	7082	4092	4.160493827160494	1.73069403714565
chr3	ABHD14A-ACY1	51978258	51978374	0	117	7419	4173	7419	4056	0.0	1.8291420118343196
chr3	ABHD14A-ACY1	51980392	51980628	189	237	7419	4173	7230	3936	0.7974683544303798	1.836890243902439
chr3	ABHD14A-ACY1	51986987	51987196	51	210	7419	4173	7368	3963	0.24285714285714285	1.8591975775927327
chr3	ABHD14A-ACY1	51984060	51984158	0	99	7419	4173	7419	4074	0.0	1.821060382916053
chr3	ABHD14A-ACY1	51985400	51985465	0	66	7419	4173	7419	4107	0.0	1.806428049671293
chr3	ALAS1	52208082	52208247	0	166	90	2548	90	2382	0.0	0.037783375314861464
chr3	ALAS1	52198671	52198848	0	178	90	2548	90	2370	0.0	0.0379746835443038
chr3	PPM1M	52246973	52247228	499	256	230645	3294	230146	3038	1.94921875	75.7557603686636
chr3	PPM1M	52248636	52248700	0	65	230645	3294	230645	3229	0.0	71.42923505729328
chr3	GLYCTK	52291746	52291922	0	177	1199245	4647	1199245	4470	0.0	268.28747203579417
chr3	GLYCTK	52290303	52290719	309174	417	1199245	4647	890071	4230	741.4244604316547	210.41867612293143
chr3	GLYCTK	52291744	52291922	0	179	1199245	4647	1199245	4468	0.0	268.4075649059982
chr3	DNAH1	52361660	52361766	0	107	22903	13950	22903	13843	0.0	1.654482409882251
chr3	DNAH1	52389460	52389586	0	127	22903	13950	22903	13823	0.0	1.6568762207914345
chr3	DNAH1	52398031	52398162	255	132	22903	13950	22648	13818	1.9318181818181819	1.639021566073238
chr3	PHF7	52422221	52422338	1109	118	4031	2348	2922	2230	9.398305084745763	1.3103139013452916
chr3	PHF7	52422759	52422881	360	123	4031	2348	3671	2225	2.926829268292683	1.6498876404494383
chr3	NISCH	52490074	52490231	0	158	82289	8309	82289	8151	0.0	10.095571095571096
chr3	NISCH	52480878	52481037	0	160	82289	8309	82289	8149	0.0	10.09804884034851
chr3	NISCH	52480878	52481109	0	232	82289	8309	82289	8077	0.0	10.188064875572614
chr3	STAB1	52523651	52523756	21570	106	484887	10045	463317	9939	203.49056603773585	46.61605795351645
chr3	GNL3	52686768	52686827	0	60	83	3110	83	3050	0.0	0.02721311475409836
chr3	ITIH3	52805807	52805840	0	34	48959	4810	48959	4776	0.0	10.25104690117253
chr3	PRKCD	53165103	53165215	0	113	48947	3643	48947	3530	0.0	13.86600566572238
chr3	PRKCD	53173492	53173608	0	117	48947	3643	48947	3526	0.0	13.881735677821894
chr3	PRKCD	53173526	53173608	0	83	48947	3643	48947	3560	0.0	13.749157303370787
chr3	CACNA1D	53732814	53732962	0	149	1326	18895	1326	18746	0.0	0.07073509015256588
chr3	CACNA1D	53761997	53762081	0	85	1326	18895	1326	18810	0.0	0.07049441786283892
chr3	CACNA1D	53802146	53802173	0	28	1326	18895	1326	18867	0.0	0.07028144379074575
chr3	CACNA1D	53718681	53718741	0	61	1326	18895	1326	18834	0.0	0.07040458744823191
chr3	CACNA1D	53769972	53770017	0	46	1326	18895	1326	18849	0.0	0.0703485596052841
chr3	CACNA1D	53762550	53762634	0	85	1326	18895	1326	18810	0.0	0.07049441786283892
chr3	CACNA1D	53710394	53710478	0	85	1326	18895	1326	18810	0.0	0.07049441786283892
chr3	CACNA1D	53732817	53732962	0	146	1326	18895	1326	18749	0.0	0.07072377193450317
chr3	CACNA1D	53770423	53770552	0	130	1326	18895	1326	18765	0.0	0.0706634692246203
chr3	IL17RB	53855293	53855341	0	49	4974	3054	4974	3005	0.0	1.6552412645590682
chr3	CACNA2D3	54503491	54503654	0	164	0	4759	0	4595	0.0	0.0
chr3	CACNA2D3	54816852	54816870	0	19	0	4759	0	4740	0.0	0.0
chr3	CACNA2D3	54879349	54879411	0	63	0	4759	0	4696	0.0	0.0
chr3	CCDC66	56559568	56559594	0	27	5721	7437	5721	7410	0.0	0.7720647773279352
chr3	CCDC66	56560861	56561012	0	152	5721	7437	5721	7285	0.0	0.7853122855181881
chr3	CCDC66	56571180	56571302	0	123	5721	7437	5721	7314	0.0	0.7821985233798195
chr3	CCDC66	56592969	56593101	1386	133	5721	7437	4335	7304	10.421052631578947	0.5935104052573932
chr3	CCDC66	56565133	56565204	0	72	5721	7437	5721	7365	0.0	0.7767820773930754
chr3	CCDC66	56572336	56572428	0	93	5721	7437	5721	7344	0.0	0.7790032679738562
chr3	CCDC66	56561256	56561378	0	123	5721	7437	5721	7314	0.0	0.7821985233798195
chr3	APPL1	57238044	57238116	0	73	33950	7541	33950	7468	0.0	4.5460632029994645
chr3	APPL1	57230713	57230767	0	55	33950	7541	33950	7486	0.0	4.535132246860806
chr3	ARF4-AS1	57600058	57600169	0	112	459	668	459	556	0.0	0.8255395683453237
chr3	SLMAP	57871635	57871698	0	64	104133	15102	104133	15038	0.0	6.924657534246576
chr3	SLMAP	57907883	57908006	0	124	104133	15102	104133	14978	0.0	6.952396848711444
chr3	SLMAP	57896246	57896371	510	126	104133	15102	103623	14976	4.0476190476190474	6.919270833333333
chr3	SLMAP	57909075	57909150	102	76	104133	15102	104031	15026	1.3421052631578947	6.923399440968987
chr3	SLMAP	57922888	57923023	0	136	104133	15102	104133	14966	0.0	6.95797140184418
chr3	SLMAP	57925844	57925934	44	91	104133	15102	104089	15011	0.4835164835164835	6.934181600159882
chr3	SLMAP	57864806	57864857	0	52	104133	15102	104133	15050	0.0	6.919136212624585
chr3	SLMAP	57865241	57865292	0	52	104133	15102	104133	15050	0.0	6.919136212624585
chr3	SLMAP	57908167	57908227	0	61	104133	15102	104133	15041	0.0	6.923276377900406
chr3	SLMAP	57856559	57856648	0	90	104133	15102	104133	15012	0.0	6.936650679456434
chr3	SLMAP	57890040	57890100	0	61	104133	15102	104133	15041	0.0	6.923276377900406
chr3	SLMAP	57820612	57820705	0	94	104133	15102	104133	15008	0.0	6.93849946695096
chr3	SLMAP	57883960	57884026	110	67	104133	15102	104023	15035	1.6417910447761195	6.918722979714
chr3	FLNB	58131926	58132019	1038	94	587413	14001	586375	13907	11.042553191489361	42.16401812037103
chr3	FLNB	58141857	58141929	338	73	587413	14001	587075	13928	4.63013698630137	42.150703618609995
chr3	FLNB	58150104	58150227	1325	124	587413	14001	586088	13877	10.685483870967742	42.23448872234633
chr3	FLNB	58141857	58141896	57	40	587413	14001	587356	13961	1.425	42.07119833822792
chr3	FLNB	58152707	58152854	784	148	587413	14001	586629	13853	5.297297297297297	42.3467119035588
chr3	ABHD6	58249877	58249942	6	66	14830	2874	14824	2808	0.09090909090909091	5.279202279202279
chr3	ABHD6	58258402	58258624	0	223	14830	2874	14830	2651	0.0	5.5941154281403245
chr3	HTD2	58315721	58315819	0	99	12153	3707	12153	3608	0.0	3.3683481152993346
chr3	HTD2	58310506	58310591	0	86	12153	3707	12153	3621	0.0	3.356255178127589
chr3	PXK	58365873	58365924	0	52	513657	5376	513657	5324	0.0	96.47952667167543
chr3	PXK	58412900	58412963	0	64	513657	5376	513657	5312	0.0	96.69747740963855
chr3	PXK	58420535	58420568	0	34	513657	5376	513657	5342	0.0	96.15443654062149
chr3	PXK	58382513	58382700	0	188	513657	5376	513657	5188	0.0	99.00867386276022
chr3	PXK	58369430	58369478	0	49	513657	5376	513657	5327	0.0	96.42519241599399
chr3	PXK	58423460	58423494	130	35	513657	5376	513527	5341	3.7142857142857144	96.14809960681521
chr3	KCTD6	58494152	58494408	0	257	0	3063	0	2806	0.0	0.0
chr3	KCTD6	58500310	58500403	0	94	0	3063	0	2969	0.0	0.0
chr3	CFAP20DC-AS1	58914872	58914931	0	60	296	3986	296	3926	0.0	0.07539480387162506
chr3	CFAP20DC-AS1	58866541	58866636	296	96	296	3986	0	3890	3.0833333333333335	0.0
chr3	CFAP20DC-AS1	58970357	58970568	0	212	296	3986	296	3774	0.0	0.0784313725490196
chr3	AC126121.3	59090332	59090385	0	54	183	3768	183	3714	0.0	0.049273021001615507
chr3	AC126121.3	59071504	59071706	0	203	183	3768	183	3565	0.0	0.05133239831697055
chr3	PTPRG	62231224	62231311	0	88	31330	14657	31330	14569	0.0	2.1504564486237903
chr3	C3ORF14	62319720	62319832	154	113	148612	4396	148458	4283	1.3628318584070795	34.66215269670791
chr3	C3ORF14	62319282	62319411	24454	130	148612	4396	124158	4266	188.1076923076923	29.10407876230661
chr3	LINC00698	63122255	63122319	0	65	167	2757	167	2692	0.0	0.062035661218424965
chr3	LINC00698	62953706	62953780	0	75	167	2757	167	2682	0.0	0.06226696495152871
chr3	LINC00698	63102691	63102799	0	109	167	2757	167	2648	0.0	0.06306646525679759
chr3	SYNPR	63480831	63480956	0	126	0	4059	0	3933	0.0	0.0
chr3	SYNPR	63556542	63556741	0	200	0	4059	0	3859	0.0	0.0
chr3	SYNPR	63609124	63609316	0	193	0	4059	0	3866	0.0	0.0
chr3	SYNPR	63452072	63452115	0	44	0	4059	0	4015	0.0	0.0
chr3	SYNPR	63610473	63610553	0	81	0	4059	0	3978	0.0	0.0
chr3	SYNPR	63445543	63445576	0	34	0	4059	0	4025	0.0	0.0
chr3	SNTN	63663696	63663786	0	91	0	5141	0	5050	0.0	0.0
chr3	ATXN7	63864897	63864999	51	103	413321	14346	413270	14243	0.49514563106796117	29.01565681387348
chr3	ATXN7	63873748	63873846	0	99	413321	14346	413321	14247	0.0	29.011090054046466
chr3	ATXN7	63997620	63997687	564	68	413321	14346	412757	14278	8.294117647058824	28.90860064434795
chr3	ADAMTS9-AS1	64582517	64582646	197	130	1880	6303	1683	6173	1.5153846153846153	0.27263891138830393
chr3	ADAMTS9-AS1	64583272	64583511	0	240	1880	6303	1880	6063	0.0	0.31007751937984496
chr3	ADAMTS9-AS1	64568658	64569071	0	414	1880	6303	1880	5889	0.0	0.31923925963661065
chr3	ADAMTS9-AS1	64568658	64569059	0	402	1880	6303	1880	5901	0.0	0.3185900694797492
chr3	ADAMTS9-AS1	64565404	64565561	0	158	1880	6303	1880	6145	0.0	0.305939788445891
chr3	ADAMTS9-AS1	64583965	64584101	0	137	1880	6303	1880	6166	0.0	0.30489782679208566
chr3	LINC02040	65188705	65188896	0	192	0	858	0	666	0.0	0.0
chr3	SLC25A26	66236543	66236700	0	158	1530	5541	1530	5383	0.0	0.2842281255805313
chr3	SLC25A26	66362859	66362929	0	71	1530	5541	1530	5470	0.0	0.2797074954296161
chr3	SLC25A26	66356030	66356084	0	55	1530	5541	1530	5486	0.0	0.2788917243893547
chr3	SLC25A26	66371201	66371413	0	213	1530	5541	1530	5328	0.0	0.28716216216216217
chr3	SLC25A26	66304452	66304537	0	86	1530	5541	1530	5455	0.0	0.2804766269477543
chr3	KBTBD8	66998980	66999191	0	212	0	4740	0	4528	0.0	0.0
chr3	SUCLG2-AS1	67670959	67671004	0	46	237	11137	237	11091	0.0	0.021368677305923723
chr3	SUCLG2-AS1	67670881	67671004	0	124	237	11137	237	11013	0.0	0.02152002179242713
chr3	SUCLG2-AS1	67669815	67669909	0	95	237	11137	237	11042	0.0	0.021463502988589022
chr3	SUCLG2-AS1	67670828	67671004	0	177	237	11137	237	10960	0.0	0.021624087591240876
chr3	SUCLG2-AS1	67693548	67693682	0	135	237	11137	237	11002	0.0	0.0215415379021996
chr3	AC109587.1	69029864	69029994	1173	131	11575	3711	10402	3580	8.954198473282442	2.905586592178771
chr3	AC109587.1	69014137	69014201	0	65	11575	3711	11575	3646	0.0	3.1747120131651125
chr3	AC109587.1	69034974	69035150	0	177	11575	3711	11575	3534	0.0	3.2753254102999434
chr3	AC109587.1	69033849	69033956	48	108	11575	3711	11527	3603	0.4444444444444444	3.199278379128504
chr3	AC109587.1	69040374	69040457	7	84	11575	3711	11568	3627	0.08333333333333333	3.1894127377998345
chr3	ARL6IP5	69099971	69100069	252	99	181331	2213	181079	2114	2.5454545454545454	85.65704824976348
chr3	ARL6IP5	69089811	69089960	119	150	181331	2213	181212	2063	0.7933333333333333	87.83906931652933
chr3	SAMMSON	70084725	70084829	0	105	52998	15618	52998	15513	0.0	3.416360471862309
chr3	SAMMSON	70065245	70065318	0	74	52998	15618	52998	15544	0.0	3.409547092125579
chr3	SAMMSON	70137595	70137667	0	73	52998	15618	52998	15545	0.0	3.4093277581215826
chr3	SAMMSON	70009123	70009285	918	163	52998	15618	52080	15455	5.631901840490798	3.3697832416693627
chr3	AC105265.2	72061895	72061965	0	71	0	501	0	430	0.0	0.0
chr3	LINC00870	72159868	72160102	0	235	154	8768	154	8533	0.0	0.01804757998359311
chr3	PPP4R2	73047185	73047356	7939	172	16995	5957	9056	5785	46.156976744186046	1.56542783059637
chr3	PPP4R2	73063672	73063747	0	76	16995	5957	16995	5881	0.0	2.8898146573711956
chr3	LINC02018	75436218	75436352	0	135	204	6501	204	6366	0.0	0.03204524033930255
chr3	LINC02018	75447086	75447296	0	211	204	6501	204	6290	0.0	0.032432432432432434
chr3	LINC02018	75451209	75451402	0	194	204	6501	204	6307	0.0	0.03234501347708895
chr3	LINC02018	75439784	75439846	0	63	204	6501	204	6438	0.0	0.03168685927306617
chr3	LINC02018	75448357	75448476	0	120	204	6501	204	6381	0.0	0.031969910672308414
chr3	LINC02018	75437249	75437275	0	27	204	6501	204	6474	0.0	0.03151065801668211
chr3	LINC02018	75446467	75446535	0	69	204	6501	204	6432	0.0	0.03171641791044776
chr3	LINC02018	75451068	75451402	0	335	204	6501	204	6166	0.0	0.03308465780084333
chr3	LINC02018	75436130	75436352	0	223	204	6501	204	6278	0.0	0.03249442497610704
chr3	LINC02018	75436162	75436352	0	191	204	6501	204	6310	0.0	0.03232963549920761
chr3	LINC02018	75437103	75437275	0	173	204	6501	204	6328	0.0	0.032237673830594185
chr3	LINC02018	75451379	75451402	0	24	204	6501	204	6477	0.0	0.031496062992125984
chr3	LINC02018	75437055	75437275	0	221	204	6501	204	6280	0.0	0.03248407643312102
chr3	LINC02018	75439753	75439846	0	94	204	6501	204	6407	0.0	0.03184017480880287
chr3	LINC00960	75673846	75674006	1276	161	1480	6551	204	6390	7.925465838509317	0.03192488262910798
chr3	LINC00960	75675967	75676128	0	162	1480	6551	1480	6389	0.0	0.23164814524964783
chr3	LINC00960	75673193	75673238	0	46	1480	6551	1480	6505	0.0	0.2275172943889316
chr3	ROBO2	77527402	77527414	0	13	0	13345	0	13332	0.0	0.0
chr3	ROBO2	77632473	77632656	0	184	0	13345	0	13161	0.0	0.0
chr3	ROBO2	77564449	77564588	0	140	0	13345	0	13205	0.0	0.0
chr3	ROBO2	77602934	77603060	0	127	0	13345	0	13218	0.0	0.0
chr3	ROBO2	77642670	77642943	0	274	0	13345	0	13071	0.0	0.0
chr3	AC117461.1	79438821	79438931	0	111	0	2074	0	1963	0.0	0.0
chr3	AC117461.1	79432116	79432236	0	121	0	2074	0	1953	0.0	0.0
chr3	LINC02050	80784040	80784117	0	78	0	1266	0	1188	0.0	0.0
chr3	LINC02050	80771369	80771470	0	102	0	1266	0	1164	0.0	0.0
chr3	LINC02050	80780092	80780245	0	154	0	1266	0	1112	0.0	0.0
chr3	LINC02027	81045363	81045462	0	100	51	3715	51	3615	0.0	0.014107883817427386
chr3	LINC02027	81094632	81094764	0	133	51	3715	51	3582	0.0	0.01423785594639866
chr3	LINC02027	81041615	81041679	0	65	51	3715	51	3650	0.0	0.013972602739726028
chr3	AC129807.1	81857089	81857231	0	143	0	2464	0	2321	0.0	0.0
chr3	AC129807.1	81859673	81859849	0	177	0	2464	0	2287	0.0	0.0
chr3	AC129807.1	81921573	81921733	0	161	0	2464	0	2303	0.0	0.0
chr3	AC129807.1	81851114	81851178	0	65	0	2464	0	2399	0.0	0.0
chr3	AC129807.1	81860424	81860534	0	111	0	2464	0	2353	0.0	0.0
chr3	AC129807.1	81921670	81921733	0	64	0	2464	0	2400	0.0	0.0
chr3	LINC02008	82042724	82042790	0	67	0	4761	0	4694	0.0	0.0
chr3	LINC02008	82058927	82059052	0	126	0	4761	0	4635	0.0	0.0
chr3	LINC02008	82070812	82070866	0	55	0	4761	0	4706	0.0	0.0
chr3	LINC02008	82204463	82204642	0	180	0	4761	0	4581	0.0	0.0
chr3	CADM2	85726521	85726548	0	28	510	9898	510	9870	0.0	0.05167173252279635
chr3	CADM2	85979163	85979283	0	121	510	9898	510	9777	0.0	0.052163240257747774
chr3	LINC00506	87136184	87136324	0	141	2499	9734	2499	9593	0.0	0.26050244970290837
chr3	CHMP2B	87240698	87240790	0	93	0	8249	0	8156	0.0	0.0
chr3	CHMP2B	87240322	87240453	0	132	0	8249	0	8117	0.0	0.0
chr3	CHMP2B	87240326	87240453	0	128	0	8249	0	8121	0.0	0.0
chr3	ARL13B	94003658	94003908	0	251	0	4021	0	3770	0.0	0.0
chr3	ARL13B	93995873	93995944	0	72	0	4021	0	3949	0.0	0.0
chr3	ARL13B	93996562	93996684	0	123	0	4021	0	3898	0.0	0.0
chr3	ARL13B	93995877	93995944	0	68	0	4021	0	3953	0.0	0.0
chr3	ARL13B	94035330	94035436	0	107	0	4021	0	3914	0.0	0.0
chr3	LINC00879	94971270	94971354	0	85	102	6020	102	5935	0.0	0.017186183656276326
chr3	LINC00879	94962898	94963096	0	199	102	6020	102	5821	0.0	0.01752276241195671
chr3	LINC00879	94962931	94963096	0	166	102	6020	102	5854	0.0	0.01742398360095661
chr3	LINC00879	94962936	94963096	0	161	102	6020	102	5859	0.0	0.017409114183307733
chr3	LINC00879	94962931	94963006	0	76	102	6020	102	5944	0.0	0.017160161507402422
chr3	LINC00879	94969669	94969797	0	129	102	6020	102	5891	0.0	0.01731454761500594
chr3	LINC00879	95024514	95024636	0	123	102	6020	102	5897	0.0	0.017296930642699677
chr3	LINC00879	95088157	95088294	0	138	102	6020	102	5882	0.0	0.017341040462427744
chr3	LINC00879	94938640	94938675	0	36	102	6020	102	5984	0.0	0.017045454545454544
chr3	LINC00879	94960979	94961030	0	52	102	6020	102	5968	0.0	0.017091152815013406
chr3	LINC00879	94980369	94980539	0	171	102	6020	102	5849	0.0	0.017438878440759104
chr3	LINC00879	94962901	94963096	0	196	102	6020	102	5824	0.0	0.017513736263736264
chr3	LINC00879	95047261	95047427	0	167	102	6020	102	5853	0.0	0.01742696053305997
chr3	LINC00879	95097590	95097658	0	69	102	6020	102	5951	0.0	0.017139976474542094
chr3	EPHA6	97592611	97592737	51	127	460	6325	409	6198	0.4015748031496063	0.06598902871894159
chr3	EPHA6	97466418	97466482	0	65	460	6325	460	6260	0.0	0.07348242811501597
chr3	EPHA6	97606159	97606248	55	90	460	6325	405	6235	0.6111111111111112	0.06495589414595028
chr3	EPHA6	97745358	97745563	0	206	460	6325	460	6119	0.0	0.07517568230102958
chr3	EPHA6	97646118	97646310	0	193	460	6325	460	6132	0.0	0.07501630789302022
chr3	EPHA6	97612377	97612475	0	99	460	6325	460	6226	0.0	0.0738837134596852
chr3	EPHA6	97447717	97447833	0	117	460	6325	460	6208	0.0	0.0740979381443299
chr3	ARL6	97765990	97766089	0	100	0	2345	0	2245	0.0	0.0
chr3	ARL6	97791770	97791826	0	57	0	2345	0	2288	0.0	0.0
chr3	ARL6	97766631	97766690	0	60	0	2345	0	2285	0.0	0.0
chr3	ARL6	97791952	97791965	0	14	0	2345	0	2331	0.0	0.0
chr3	ST3GAL6	98756368	98756540	51	173	51	6312	0	6139	0.2947976878612717	0.0
chr3	ST3GAL6	98768429	98768529	0	101	51	6312	51	6211	0.0	0.008211238125905651
chr3	ST3GAL6	98771120	98771190	0	71	51	6312	51	6241	0.0	0.008171767344976766
chr3	ST3GAL6	98773919	98773983	0	65	51	6312	51	6247	0.0	0.008163918680966864
chr3	ST3GAL6	98784944	98785040	0	97	51	6312	51	6215	0.0	0.008205953338696701
chr3	COL8A1	99675659	99675721	0	63	306	9418	306	9355	0.0	0.03270978086584714
chr3	COL8A1	99691398	99691568	0	171	306	9418	306	9247	0.0	0.03309181356115497
chr3	CMSS1	100051231	100051306	0	76	10916	7224	10916	7148	0.0	1.5271404588696138
chr3	CMSS1	100141529	100141645	0	117	10916	7224	10916	7107	0.0	1.5359504713662586
chr3	TBC1D23	100283606	100283811	0	206	3356	5196	3356	4990	0.0	0.6725450901803607
chr3	TBC1D23	100311832	100311877	0	46	3356	5196	3356	5150	0.0	0.6516504854368932
chr3	NIT2	100345584	100345678	0	95	0	9224	0	9129	0.0	0.0
chr3	TMEM45A	100519532	100519608	0	77	21071	5900	21071	5823	0.0	3.6185814872059074
chr3	TFG	100747413	100747454	0	42	51	6506	51	6464	0.0	0.007889851485148515
chr3	TFG	100747360	100747454	0	95	51	6506	51	6411	0.0	0.007955077211043519
chr3	TFG	100742155	100742200	0	46	51	6506	51	6460	0.0	0.007894736842105263
chr3	TFG	100747245	100747308	0	64	51	6506	51	6442	0.0	0.007916796026078858
chr3	TFG	100731741	100731895	0	155	51	6506	51	6351	0.0	0.00803023145961266
chr3	TFG	100710970	100711068	0	99	51	6506	51	6407	0.0	0.007960043702200718
chr3	TFG	100739360	100739485	0	126	51	6506	51	6380	0.0	0.00799373040752351
chr3	PCNP	101579789	101580004	6831	216	30654	3051	23823	2835	31.625	8.403174603174604
chr3	PCNP	101579588	101580004	18644	417	30654	3051	12010	2634	44.70983213429257	4.5596051632498105
chr3	PCNP	101579841	101580004	1303	164	30654	3051	29351	2887	7.945121951219512	10.1666089366124
chr3	PCNP	101585436	101585511	0	76	30654	3051	30654	2975	0.0	10.303865546218487
chr3	CEP97	101728835	101728937	0	103	255	8894	255	8791	0.0	0.029006938914799225
chr3	CEP97	101728813	101728937	0	125	255	8894	255	8769	0.0	0.029079712624016422
chr3	CEP97	101763108	101763186	0	79	255	8894	255	8815	0.0	0.028927963698241632
chr3	NXPE3	101779733	101779900	0	168	51	9079	51	8911	0.0	0.005723263382336438
chr3	NXPE3	101779733	101779934	0	202	51	9079	51	8877	0.0	0.005745184183845894
chr3	NFKBIZ	101848891	101849917	0	1027	0	5643	0	4616	0.0	0.0
chr3	NFKBIZ	101857072	101857183	0	112	0	5643	0	5531	0.0	0.0
chr3	NFKBIZ	101829612	101829688	0	77	0	5643	0	5566	0.0	0.0
chr3	ZPLD1	102436859	102436973	0	115	13	5153	13	5038	0.0	0.0025803890432711395
chr3	ALCAM	105552143	105552182	0	40	1128	6612	1128	6572	0.0	0.17163724893487523
chr3	DUBR	107246007	107248831	306	2825	3354	13361	3048	10536	0.10831858407079646	0.28929384965831434
chr3	DUBR	107247063	107247088	0	26	3354	13361	3354	13335	0.0	0.2515185601799775
chr3	DUBR	107246007	107246052	0	46	3354	13361	3354	13315	0.0	0.25189635749155087
chr3	DUBR	107246007	107246137	0	131	3354	13361	3354	13230	0.0	0.25351473922902495
chr3	DUBR	107248577	107248831	0	255	3354	13361	3354	13106	0.0	0.25591332214253015
chr3	DUBR	107325606	107325691	0	86	3354	13361	3354	13275	0.0	0.2526553672316384
chr3	DUBR	107285319	107285531	0	213	3354	13361	3354	13148	0.0	0.2550958320657134
chr3	DUBR	107246007	107247088	102	1082	3354	13361	3252	12279	0.09426987060998152	0.2648424138773516
chr3	DUBR	107246994	107247088	0	95	3354	13361	3354	13266	0.0	0.25282677521483493
chr3	DUBR	107245137	107245218	1825	82	3354	13361	1529	13279	22.25609756097561	0.11514421266661647
chr3	DUBR	107246007	107246209	0	203	3354	13361	3354	13158	0.0	0.2549019607843137
chr3	DUBR	107285319	107286177	0	859	3354	13361	3354	12502	0.0	0.26827707566789316
chr3	DUBR	107286014	107286177	0	164	3354	13361	3354	13197	0.0	0.25414867015230735
chr3	LINC01990	107433064	107433203	0	140	4648	1872	4648	1732	0.0	2.6836027713625867
chr3	LINC01990	107460672	107460790	0	119	4648	1872	4648	1753	0.0	2.6514546491728463
chr3	LINC01990	107461187	107461390	0	204	4648	1872	4648	1668	0.0	2.7865707434052758
chr3	BBX	107772627	107773636	7701	1010	167415	11767	159714	10757	7.624752475247525	14.847448173282514
chr3	BBX	107791239	107791299	0	61	167415	11767	167415	11706	0.0	14.301640184520759
chr3	BBX	107661827	107661944	0	118	167415	11767	167415	11649	0.0	14.371619881534896
chr3	BBX	107789786	107789876	160	91	167415	11767	167255	11676	1.7582417582417582	14.324683110654334
chr3	BBX	107711274	107711364	0	91	167415	11767	167415	11676	0.0	14.338386433710175
chr3	BBX	107657061	107657172	0	112	167415	11767	167415	11655	0.0	14.364221364221365
chr3	BBX	107677426	107677470	0	45	167415	11767	167415	11722	0.0	14.282119092305068
chr3	BBX	107659567	107659770	0	204	167415	11767	167415	11563	0.0	14.47850903744703
chr3	HHLA2	108310654	108310741	0	88	2414	2940	2414	2852	0.0	0.8464235624123422
chr3	HHLA2	108328269	108328347	0	79	2414	2940	2414	2861	0.0	0.8437609227542817
chr3	HHLA2	108351787	108351877	1156	91	2414	2940	1258	2849	12.703296703296703	0.44155844155844154
chr3	HHLA2	108375749	108375800	150	52	2414	2940	2264	2888	2.8846153846153846	0.7839335180055401
chr3	HHLA2	108302655	108302794	0	140	2414	2940	2414	2800	0.0	0.8621428571428571
chr3	DZIP3	108605334	108605438	0	105	51	6978	51	6873	0.0	0.007420340462680052
chr3	DZIP3	108686444	108686584	0	141	51	6978	51	6837	0.0	0.007459412022817025
chr3	DZIP3	108603018	108603234	0	217	51	6978	51	6761	0.0	0.007543262830942169
chr3	TRAT1	108830669	108830780	0	112	0	2462	0	2350	0.0	0.0
chr3	TRAT1	108838933	108838967	0	35	0	2462	0	2427	0.0	0.0
chr3	C3ORF85	109148252	109148386	0	135	0	2477	0	2342	0.0	0.0
chr3	LINC01205	109459882	109459928	0	47	0	6613	0	6566	0.0	0.0
chr3	LINC01205	109562231	109562259	0	29	0	6613	0	6584	0.0	0.0
chr3	NECTIN3	111118655	111118952	0	298	0	7708	0	7410	0.0	0.0
chr3	CD96	111577501	111577549	640	49	18765	5571	18125	5522	13.061224489795919	3.282325244476639
chr3	PLCXD2	111732618	111732703	561	86	11920	8983	11359	8897	6.523255813953488	1.2767224907272114
chr3	PHLDB2	111932268	111932397	0	130	612	12336	612	12206	0.0	0.05013927576601671
chr3	PHLDB2	111949701	111949890	0	190	612	12336	612	12146	0.0	0.05038695866952083
chr3	PHLDB2	111958274	111958295	0	22	612	12336	612	12314	0.0	0.04969952899139191
chr3	PHLDB2	111957235	111957250	0	16	612	12336	612	12320	0.0	0.04967532467532468
chr3	PHLDB2	111960144	111960180	0	37	612	12336	612	12299	0.0	0.04976014310106513
chr3	ABHD10	111986263	111986375	0	113	0	3032	0	2919	0.0	0.0
chr3	ABHD10	111981783	111981967	0	185	0	3032	0	2847	0.0	0.0
chr3	ABHD10	111990699	111990751	0	53	0	3032	0	2979	0.0	0.0
chr3	TAGLN3	112011762	112011865	0	104	0	1722	0	1618	0.0	0.0
chr3	TMPRSS7	112046973	112047012	0	40	26066	3071	26066	3031	0.0	8.599802045529529
chr3	TMPRSS7	112047407	112047520	0	114	26066	3071	26066	2957	0.0	8.81501521812648
chr3	CD200	112340901	112340983	0	83	1760	2999	1760	2916	0.0	0.6035665294924554
chr3	CD200	112335942	112336017	0	76	1760	2999	1760	2923	0.0	0.6021211084502224
chr3	SLC35A5	112570539	112570670	0	132	0	4736	0	4604	0.0	0.0
chr3	GTPBP8	112993025	112993124	0	100	5503	3804	5503	3704	0.0	1.4856911447084233
chr3	GTPBP8	112995134	112995265	51	132	5503	3804	5452	3672	0.38636363636363635	1.4847494553376905
chr3	GTPBP8	112995136	112995265	51	130	5503	3804	5452	3674	0.3923076923076923	1.4839412084921066
chr3	AC078785.1	113061786	113062010	0	225	2433	6852	2433	6627	0.0	0.36713444997736533
chr3	BOC	113285371	113285565	0	195	102	8933	102	8738	0.0	0.011673151750972763
chr3	BOC	113285438	113285565	0	128	102	8933	102	8805	0.0	0.011584327086882453
chr3	SIDT1	113607040	113607114	534	75	4956	7503	4422	7428	7.12	0.5953150242326333
chr3	SIDT1	113615062	113615077	0	16	4956	7503	4956	7487	0.0	0.6619473754507813
chr3	ATP6V1A	113780731	113780783	0	53	51365	5135	51365	5082	0.0	10.10724124360488
chr3	GRAMD1C	113876164	113876260	0	97	0	5906	0	5809	0.0	0.0
chr3	GRAMD1C	113844502	113844649	0	148	0	5906	0	5758	0.0	0.0
chr3	QTRT2	114067986	114068063	0	78	408	8066	408	7988	0.0	0.05107661492238358
chr3	QTRT2	114070625	114070838	0	214	408	8066	408	7852	0.0	0.05196128374936322
chr3	QTRT2	114056998	114057106	0	109	408	8066	408	7957	0.0	0.0512756063843157
chr3	QTRT2	114082962	114083003	0	42	408	8066	408	8024	0.0	0.05084745762711865
chr3	ZBTB20-AS1	114366695	114366881	0	187	918	5834	918	5647	0.0	0.16256419337701433
chr3	ZBTB20-AS1	114357167	114357227	0	61	918	5834	918	5773	0.0	0.1590161094751429
chr3	ZBTB20-AS1	114359348	114359508	0	161	918	5834	918	5673	0.0	0.16181914331041777
chr3	ZBTB20-AS1	114367131	114367221	0	91	918	5834	918	5743	0.0	0.15984676998084624
chr3	ZBTB20-AS1	114367134	114367221	0	88	918	5834	918	5746	0.0	0.15976331360946747
chr3	ZBTB20-AS1	114387670	114387775	0	106	918	5834	918	5728	0.0	0.16026536312849163
chr3	ZBTB20-AS1	114375793	114375836	0	44	918	5834	918	5790	0.0	0.15854922279792746
chr3	AC026341.1	115190887	115191009	0	123	0	4777	0	4654	0.0	0.0
chr3	AC026341.1	115205240	115205317	0	78	0	4777	0	4699	0.0	0.0
chr3	GAP43	115663520	115663916	0	397	0	1905	0	1508	0.0	0.0
chr3	TUSC7	116710203	116710421	0	219	0	2806	0	2587	0.0	0.0
chr3	AC092691.3	117790622	117790847	0	226	0	1974	0	1748	0.0	0.0
chr3	IGSF11-AS1	118945867	118946035	5524	169	11782	1608	6258	1439	32.68639053254438	4.3488533703961085
chr3	TEX55	119148179	119148323	0	145	2637	1965	2637	1820	0.0	1.4489010989010989
chr3	UPK1B	119186713	119186810	495	98	21011	2265	20516	2167	5.051020408163265	9.467466543608676
chr3	UPK1B	119175997	119176109	0	113	21011	2265	21011	2152	0.0	9.763475836431226
chr3	UPK1B	119186678	119186810	495	133	21011	2265	20516	2132	3.7218045112781954	9.622889305816136
chr3	POGLUT1	119478333	119478474	0	142	153	4635	153	4493	0.0	0.03405297128867127
chr3	TIMMDC1	119500694	119500860	0	167	0	2722	0	2555	0.0	0.0
chr3	TIMMDC1	119503531	119503620	0	90	0	2722	0	2632	0.0	0.0
chr3	TIMMDC1	119513640	119513719	0	80	0	2722	0	2642	0.0	0.0
chr3	TIMMDC1	119503953	119504021	0	69	0	2722	0	2653	0.0	0.0
chr3	ADPRH	119580484	119580636	0	153	37130	4454	37130	4301	0.0	8.632876075331318
chr3	ADPRH	119582133	119582467	36789	335	37130	4454	341	4119	109.8179104477612	0.08278708424374848
chr3	ADPRH	119580550	119580636	0	87	37130	4454	37130	4367	0.0	8.502404396610945
chr3	PLA1A	119606773	119606975	0	203	0	2183	0	1980	0.0	0.0
chr3	AC023494.1	119668260	119668316	0	57	0	939	0	882	0.0	0.0
chr3	CFAP91	119706808	119706885	0	78	4853	6291	4853	6213	0.0	0.781104136488009
chr3	CFAP91	119707403	119707561	0	159	4853	6291	4853	6132	0.0	0.7914220482713633
chr3	NDUFB4	120601110	120601257	0	148	0	1312	0	1164	0.0	0.0
chr3	GTF2E1	120749744	120749951	0	208	51	3376	51	3168	0.0	0.016098484848484848
chr3	GTF2E1	120749847	120749951	0	105	51	3376	51	3271	0.0	0.0155915622133904
chr3	GTF2E1	120750522	120751000	0	479	51	3376	51	2897	0.0	0.017604418363824648
chr3	STXBP5L	121282265	121282337	0	73	4757	11115	4757	11042	0.0	0.4308096359355189
chr3	STXBP5L	121378715	121378886	0	172	4757	11115	4757	10943	0.0	0.43470711870602213
chr3	STXBP5L	121324492	121324585	0	94	4757	11115	4757	11021	0.0	0.4316305235459577
chr3	EAF2	121854686	121854823	0	138	0	1780	0	1642	0.0	0.0
chr3	EAF2	121836644	121836794	0	151	0	1780	0	1629	0.0	0.0
chr3	SLC15A2	121911573	121911666	0	94	0	5879	0	5785	0.0	0.0
chr3	CD86	122091600	122091650	336	51	1734	3432	1398	3381	6.588235294117647	0.4134871339840284
chr3	CD86	122103511	122103847	0	337	1734	3432	1734	3095	0.0	0.5602584814216478
chr3	CD86	122109264	122109408	0	145	1734	3432	1734	3287	0.0	0.5275327045938546
chr3	CASR	122275811	122276042	171	232	347114	12030	346943	11798	0.7370689655172413	29.406933378538735
chr3	FAM162A	122401375	122401535	0	161	6688	3799	6688	3638	0.0	1.8383727322704784
chr3	DTX3L	122568488	122570024	0	1537	6683	5773	6683	4236	0.0	1.57766761095373
chr3	PARP15	122626826	122627033	0	208	2317	5496	2317	5288	0.0	0.43816187594553707
chr3	PARP14	122692300	122692543	0	244	612	9853	612	9609	0.0	0.06369029035279425
chr3	PARP14	122699389	122701635	0	2247	612	9853	612	7606	0.0	0.0804627925322114
chr3	SLC49A4	122806856	122806950	0	95	205914	3331	205914	3236	0.0	63.632262051915944
chr3	PDIA5	123130479	123130616	0	138	0	3918	0	3780	0.0	0.0
chr3	SEC22A	123204715	123204813	0	99	1071	4714	1071	4615	0.0	0.23206933911159264
chr3	SEC22A	123204715	123204784	0	70	1071	4714	1071	4644	0.0	0.23062015503875968
chr3	KALRN	124637207	124637303	0	97	62418	24411	62418	24314	0.0	2.567162951386033
chr3	UMPS	124731505	124731604	10197	100	54657	7521	44460	7421	101.97	5.991106319902978
chr3	UMPS	124735092	124735246	0	155	54657	7521	54657	7366	0.0	7.420173771382026
chr3	FAM86JP	125918863	125918926	0	64	0	2527	0	2463	0.0	0.0
chr3	FAM86JP	125924965	125925115	0	151	0	2527	0	2376	0.0	0.0
chr3	ROPN1B	125971116	125971162	0	47	0	3137	0	3090	0.0	0.0
chr3	ROPN1B	125970038	125970151	0	114	0	3137	0	3023	0.0	0.0
chr3	AC079848.2	126215417	126215697	0	281	0	3126	0	2845	0.0	0.0
chr3	AC079848.2	126246463	126246617	0	155	0	3126	0	2971	0.0	0.0
chr3	AC079848.2	126245401	126245475	0	75	0	3126	0	3051	0.0	0.0
chr3	AC016924.1	126288012	126288123	0	112	572	5692	572	5580	0.0	0.1025089605734767
chr3	NUP210P1	126666220	126666301	0	82	1735	1202	1735	1120	0.0	1.5491071428571428
chr3	CHCHD6	126780339	126780430	0	92	23547	2771	23547	2679	0.0	8.789473684210526
chr3	MCM2	127617968	127618081	0	114	0	4732	0	4618	0.0	0.0
chr3	MCM2	127610778	127610985	0	208	0	4732	0	4524	0.0	0.0
chr3	ABTB1	127679572	127679679	0	108	0	3340	0	3232	0.0	0.0
chr3	KBTBD12	127922949	127924131	0	1183	3468	5361	3468	4178	0.0	0.8300622307324078
chr3	KBTBD12	127927763	127928034	0	272	3468	5361	3468	5089	0.0	0.6814698369031243
chr3	SEC61A1	128052834	128052902	0	69	44802	4631	44802	4562	0.0	9.820692678649715
chr3	EEFSEC	128264616	128264781	0	166	44076	2402	44076	2236	0.0	19.711985688729875
chr3	EEFSEC	128358216	128358373	0	158	44076	2402	44076	2244	0.0	19.641711229946523
chr3	EEFSEC	128262127	128262224	0	98	44076	2402	44076	2304	0.0	19.130208333333332
chr3	RAB7A	128806371	128806590	6740	220	23000	6281	16260	6061	30.636363636363637	2.6827256228345155
chr3	RAB7A	128795359	128795420	150	62	23000	6281	22850	6219	2.4193548387096775	3.6742241517928926
chr3	RAB7A	128811145	128811257	51	113	23000	6281	22949	6168	0.45132743362831856	3.720654993514916
chr3	RAB7A	128788913	128789070	0	158	23000	6281	23000	6123	0.0	3.7563285970929283
chr3	RAB7A	128806371	128806449	1276	79	23000	6281	21724	6202	16.151898734177216	3.5027410512737824
chr3	RAB7A	128807542	128807671	2655	130	23000	6281	20345	6151	20.423076923076923	3.3075922614209072
chr3	RAB7A	128799271	128799430	0	160	23000	6281	23000	6121	0.0	3.7575559549093285
chr3	ACAD9	128884656	128884746	22	91	37713	4320	37691	4229	0.24175824175824176	8.912508867344526
chr3	ACAD9	128884674	128884746	20	73	37713	4320	37693	4247	0.273972602739726	8.87520602778432
chr3	ACAD9	128884652	128884746	26	95	37713	4320	37687	4225	0.2736842105263158	8.92
chr3	COPG1	129274063	129274136	0	74	1204	4374	1204	4300	0.0	0.28
chr3	HMCES	129290678	129290804	0	127	2556	2754	2556	2627	0.0	0.972972972972973
chr3	HMCES	129288853	129288997	51	145	2556	2754	2505	2609	0.35172413793103446	0.9601379839018781
chr3	H1-10-AS1	129323889	129323997	0	109	3546	3254	3546	3145	0.0	1.1275039745627982
chr3	IFT122	129456113	129456264	0	152	906	9056	906	8904	0.0	0.10175202156334232
chr3	IFT122	129461227	129461304	0	78	906	9056	906	8978	0.0	0.10091334372911562
chr3	IFT122	129466889	129467066	0	178	906	9056	906	8878	0.0	0.10205001126379815
chr3	IFT122	129492140	129492194	0	55	906	9056	906	9001	0.0	0.10065548272414176
chr3	IFT122	129495445	129495607	0	163	906	9056	906	8893	0.0	0.10187788147981558
chr3	IFT122	129464634	129464781	0	148	906	9056	906	8908	0.0	0.10170633138751684
chr3	IFT122	129451913	129451998	0	86	906	9056	906	8970	0.0	0.10100334448160535
chr3	IFT122	129458598	129458677	0	80	906	9056	906	8976	0.0	0.10093582887700535
chr3	IFT122	129460853	129461006	0	154	906	9056	906	8902	0.0	0.10177488204897776
chr3	IFT122	129459314	129459451	0	138	906	9056	906	8918	0.0	0.10159228526575466
chr3	IFT122	129457921	129458015	0	95	906	9056	906	8961	0.0	0.10110478741211919
chr3	IFT122	129463559	129463626	0	68	906	9056	906	8988	0.0	0.10080106809078772
chr3	LINC02021	130116836	130117092	0	257	0	4061	0	3804	0.0	0.0
chr3	LINC02021	130150380	130150484	0	105	0	4061	0	3956	0.0	0.0
chr3	COL6A4P2	130231445	130231508	0	64	3	3954	3	3890	0.0	0.0007712082262210797
chr3	COL6A4P2	130247036	130247072	0	37	3	3954	3	3917	0.0	0.0007658922644881287
chr3	COL6A4P2	130248616	130248751	0	136	3	3954	3	3818	0.0	0.000785751702462022
chr3	COL6A5	130477036	130477139	0	104	21107	9473	21107	9369	0.0	2.2528551606361407
chr3	COL6A5	130471681	130471926	0	246	21107	9473	21107	9227	0.0	2.2875257396770348
chr3	COL6A6	130649068	130649562	18055	495	24780	9757	6725	9262	36.474747474747474	0.7260850788166703
chr3	COL6A6	130589973	130590036	0	64	24780	9757	24780	9693	0.0	2.5564840606623336
chr3	ATP2C1	130932021	130932138	0	118	1224	8544	1224	8426	0.0	0.14526465701400426
chr3	ATP2C1	130979248	130979419	0	172	1224	8544	1224	8372	0.0	0.14620162446249402
chr3	ATP2C1	131001219	131001344	0	126	1224	8544	1224	8418	0.0	0.14540270848182466
chr3	ATP2C1	131001219	131001314	0	96	1224	8544	1224	8448	0.0	0.14488636363636365
chr3	ATP2C1	130894707	130894775	0	69	1224	8544	1224	8475	0.0	0.14442477876106194
chr3	ATP2C1	130894589	130894775	561	187	1224	8544	663	8357	3.0	0.07933468948187149
chr3	ATP2C1	130894730	130894775	0	46	1224	8544	1224	8498	0.0	0.1440338903271358
chr3	NEK11	131080422	131080588	0	167	654	5196	654	5029	0.0	0.1300457347385166
chr3	NEK11	131168829	131168937	0	109	654	5196	654	5087	0.0	0.1285630037350108
chr3	NEK11	131273477	131273574	0	98	654	5196	654	5098	0.0	0.12828560219693996
chr3	NEK11	131027929	131028002	0	74	654	5196	654	5122	0.0	0.12768449824287387
chr3	NEK11	131133276	131133355	0	80	654	5196	654	5116	0.0	0.12783424550430023
chr3	AC107027.1	131508780	131508901	0	122	0	1234	0	1112	0.0	0.0
chr3	AC107027.1	131518561	131518668	0	108	0	1234	0	1126	0.0	0.0
chr3	ACP3	132337455	132337554	13009	100	26234	2760	13225	2660	130.09	4.9718045112781954
chr3	ACP3	132331646	132331733	51	88	26234	2760	26183	2672	0.5795454545454546	9.799026946107784
chr3	DNAJC13	132484362	132484488	0	127	1188	9689	1188	9562	0.0	0.12424179042041414
chr3	DNAJC13	132484362	132484493	0	132	1188	9689	1188	9557	0.0	0.1243067908339437
chr3	DNAJC13	132537157	132537266	0	110	1188	9689	1188	9579	0.0	0.1240212965862825
chr3	UBA5	132675816	132675923	0	108	239	7275	239	7167	0.0	0.03334728617273615
chr3	UBA5	132660898	132661048	0	151	239	7275	239	7124	0.0	0.03354856822010107
chr3	NPHP3-AS1	132726360	132726426	0	67	102	5228	102	5161	0.0	0.019763611703158303
chr3	TMEM108	133379751	133381161	11524	1411	13847	8388	2323	6977	8.167257264351523	0.3329511251254121
chr3	TMEM108	133378341	133378556	153	216	13847	8388	13694	8172	0.7083333333333334	1.6757219774840921
chr3	TMEM108	133074314	133074358	0	45	13847	8388	13847	8343	0.0	1.6597147309121418
chr3	TMEM108	133303203	133303337	1069	135	13847	8388	12778	8253	7.9185185185185185	1.548285471949594
chr3	TF	133748411	133748584	18	174	4859	22311	4841	22137	0.10344827586206896	0.21868365180467092
chr3	TF	133748411	133748669	738	259	4859	22311	4121	22052	2.8494208494208495	0.18687647378922548
chr3	TF	133774878	133774939	0	62	4859	22311	4859	22249	0.0	0.21839183783540833
chr3	CEP63	134546384	134546501	0	118	0	8593	0	8475	0.0	0.0
chr3	CEP63	134547334	134547472	0	139	0	8593	0	8454	0.0	0.0
chr3	CEP63	134488018	134488090	0	73	0	8593	0	8520	0.0	0.0
chr3	EPHB1	134977965	134978077	0	113	0	6987	0	6874	0.0	0.0
chr3	PPP2R3A	136001058	136003493	33825	2436	41391	7802	7566	5366	13.885467980295566	1.4099888184867686
chr3	PPP2R3A	136079149	136079283	40	135	41391	7802	41351	7667	0.2962962962962963	5.3933742011216905
chr3	PCCB	136256554	136256623	0	70	969	7380	969	7310	0.0	0.1325581395348837
chr3	PCCB	136260478	136260535	0	58	969	7380	969	7322	0.0	0.1323408904670855
chr3	PCCB	136327154	136327255	0	102	969	7380	969	7278	0.0	0.13314097279472384
chr3	PCCB	136326325	136326385	0	61	969	7380	969	7319	0.0	0.13239513594753383
chr3	PCCB	136260262	136260355	0	94	969	7380	969	7286	0.0	0.1329947845182542
chr3	PCCB	136261951	136262065	0	115	969	7380	969	7265	0.0	0.1333792154163799
chr3	PCCB	136259175	136259235	0	61	969	7380	969	7319	0.0	0.13239513594753383
chr3	PCCB	136252302	136252389	0	88	969	7380	969	7292	0.0	0.13288535381239716
chr3	NCK1	136867430	136867525	0	96	0	5120	0	5024	0.0	0.0
chr3	NCK1	136889078	136889301	0	224	0	5120	0	4896	0.0	0.0
chr3	IL20RB	136991937	136992088	0	152	0	2453	0	2301	0.0	0.0
chr3	IL20RB	136986693	136986784	0	92	0	2453	0	2361	0.0	0.0
chr3	LINC01210	137774527	137774614	147	88	8426	3221	8279	3133	1.6704545454545454	2.6425151611873603
chr3	LINC01210	137774523	137774614	147	92	8426	3221	8279	3129	1.5978260869565217	2.6458932566315116
chr3	CLDN18	138024606	138024724	0	119	143	3721	143	3602	0.0	0.039700166574125485
chr3	ARMC8	138209816	138209893	0	78	1338	9550	1338	9472	0.0	0.14125844594594594
chr3	ARMC8	138237481	138237572	0	92	1338	9550	1338	9458	0.0	0.1414675407062804
chr3	ARMC8	138241782	138241983	0	202	1338	9550	1338	9348	0.0	0.14313222079589216
chr3	ARMC8	138188454	138188530	0	77	1338	9550	1338	9473	0.0	0.14124353425525177
chr3	ARMC8	138228917	138229010	0	94	1338	9550	1338	9456	0.0	0.141497461928934
chr3	ARMC8	138188400	138188530	0	131	1338	9550	1338	9419	0.0	0.14205329652829388
chr3	MRAS	138372865	138373076	21414	212	68357	6268	46943	6056	101.00943396226415	7.751486129458389
chr3	FAIM	138610603	138611037	0	435	1468	4080	1468	3645	0.0	0.4027434842249657
chr3	FAIM	138619710	138619770	0	61	1468	4080	1468	4019	0.0	0.365264991291366
chr3	MRPS22	139349327	139349434	0	108	1202	5370	1202	5262	0.0	0.22843025465602432
chr3	AC046134.2	139419556	139419680	0	125	0	9175	0	9050	0.0	0.0
chr3	AC046134.2	139561652	139561748	0	97	0	9175	0	9078	0.0	0.0
chr3	AC046134.2	139459930	139459985	0	56	0	9175	0	9119	0.0	0.0
chr3	SLC25A36	140959462	140959540	0	79	4811	9584	4811	9505	0.0	0.5061546554445029
chr3	SLC25A36	140968682	140968730	0	49	4811	9584	4811	9535	0.0	0.5045621394861038
chr3	SLC25A36	140966999	140967036	0	38	4811	9584	4811	9546	0.0	0.5039807249109575
chr3	SLC25A36	140966347	140966434	0	88	4811	9584	4811	9496	0.0	0.5066343723673126
chr3	SLC25A36	140966933	140967036	0	104	4811	9584	4811	9480	0.0	0.5074894514767933
chr3	SPSB4	141132188	141132310	561	123	871	3802	310	3679	4.560975609756097	0.08426202772492525
chr3	PXYLP1	141305755	141307776	558	2022	18731	13365	18173	11343	0.27596439169139464	1.6021334743894913
chr3	PXYLP1	141262242	141262340	0	99	18731	13365	18731	13266	0.0	1.4119553746419418
chr3	PXYLP1	141234885	141234956	0	72	18731	13365	18731	13293	0.0	1.40908748965621
chr3	PXYLP1	141234215	141234318	0	104	18731	13365	18731	13261	0.0	1.4124877460221703
chr3	PXYLP1	141232332	141232435	0	104	18731	13365	18731	13261	0.0	1.4124877460221703
chr3	ZBTB38	141396258	141396503	0	246	561	12786	561	12540	0.0	0.04473684210526316
chr3	ZBTB38	141427633	141427821	0	189	561	12786	561	12597	0.0	0.044534412955465584
chr3	ZBTB38	141438242	141438365	0	124	561	12786	561	12662	0.0	0.044305796872531986
chr3	ZBTB38	141438267	141438365	0	99	561	12786	561	12687	0.0	0.04421849136911799
chr3	RNF7	141743508	141743556	46	49	4641	2786	4595	2737	0.9387755102040817	1.6788454512239679
chr3	RNF7	141742643	141742907	0	265	4641	2786	4641	2521	0.0	1.8409361364537882
chr3	ATP1B3	141902135	141902227	309	93	13757	2630	13448	2537	3.3225806451612905	5.30074891604257
chr3	ATP1B3	141916554	141916574	0	21	13757	2630	13757	2609	0.0	5.272901494825604
chr3	ATP1B3	141916375	141916440	0	66	13757	2630	13757	2564	0.0	5.3654446177847115
chr3	PLS1	142664201	142664307	0	107	6476	5310	6476	5203	0.0	1.2446665385354603
chr3	PLS1	142627815	142627908	0	94	6476	5310	6476	5216	0.0	1.241564417177914
chr3	PLS1	142645295	142645580	0	286	6476	5310	6476	5024	0.0	1.289012738853503
chr3	PLS1	142619452	142619638	0	187	6476	5310	6476	5123	0.0	1.2641030646105798
chr3	PLS1	142597236	142597348	0	113	6476	5310	6476	5197	0.0	1.2461035212622666
chr3	TRPC1	142743484	142743586	7074	103	9472	4420	2398	4317	68.67961165048544	0.5554783414408154
chr3	TRPC1	142736378	142736533	459	156	9472	4420	9013	4264	2.9423076923076925	2.1137429643527206
chr3	AC021074.3	142938474	142938653	0	180	51	5484	51	5304	0.0	0.009615384615384616
chr3	AC021074.3	142936422	142936646	0	225	51	5484	51	5259	0.0	0.009697661152310326
chr3	AC021074.3	142936603	142936646	0	44	51	5484	51	5440	0.0	0.009375
chr3	AC021074.3	142935840	142935898	0	59	51	5484	51	5425	0.0	0.009400921658986176
chr3	AC021074.3	142937825	142938264	17	440	51	5484	34	5044	0.038636363636363635	0.0067406819984139575
chr3	AC021074.3	142941081	142941101	0	21	51	5484	51	5463	0.0	0.009335529928610654
chr3	AC021074.3	142938242	142938264	17	23	51	5484	34	5461	0.7391304347826086	0.0062259659403039735
chr3	PAQR9-AS1	142990014	142990137	0	124	0	4326	0	4202	0.0	0.0
chr3	U2SURP	143054942	143055119	0	178	0	10970	0	10792	0.0	0.0
chr3	U2SURP	143023974	143024018	0	45	0	10970	0	10925	0.0	0.0
chr3	U2SURP	143024483	143024548	0	66	0	10970	0	10904	0.0	0.0
chr3	AC055758.2	145946403	145946621	0	219	51	1122	51	903	0.0	0.05647840531561462
chr3	LINC02010	146923300	146923324	0	25	0	4235	0	4210	0.0	0.0
chr3	AC092958.1	147959787	147959841	0	55	51	3684	51	3629	0.0	0.014053458252962248
chr3	AC092958.1	147940558	147940619	0	62	51	3684	51	3622	0.0	0.014080618442849255
chr3	LINC02032	148079375	148079643	0	269	0	2478	0	2209	0.0	0.0
chr3	LINC02032	148079034	148079643	0	610	0	2478	0	1868	0.0	0.0
chr3	LINC02046	148312110	148312252	0	143	51	3775	51	3632	0.0	0.014041850220264317
chr3	LINC02046	148360131	148360177	0	47	51	3775	51	3728	0.0	0.013680257510729614
chr3	LINC02046	148341254	148341337	0	84	51	3775	51	3691	0.0	0.013817393660254673
chr3	LINC02046	148398678	148398776	0	99	51	3775	51	3676	0.0	0.013873775843307944
chr3	LINC02046	148361079	148361150	0	72	51	3775	51	3703	0.0	0.013772616797191467
chr3	LINC02046	148362197	148362301	0	105	51	3775	51	3670	0.0	0.013896457765667575
chr3	AGTR1	148707943	148708027	0	85	132114	3461	132114	3376	0.0	39.133293838862556
chr3	AGTR1	148731190	148731316	0	127	132114	3461	132114	3334	0.0	39.62627474505099
chr3	AGTR1	148730337	148730509	76	173	132114	3461	132038	3288	0.4393063583815029	40.157542579075425
chr3	CPB1	148840873	148840975	51	103	3058	3615	3007	3512	0.49514563106796117	0.8562072892938497
chr3	GYG1	149024052	149024272	0	221	0	7100	0	6879	0.0	0.0
chr3	GYG1	149026451	149026502	0	52	0	7100	0	7048	0.0	0.0
chr3	GYG1	148992657	148992772	0	116	0	7100	0	6984	0.0	0.0
chr3	GYG1	149009275	149009402	0	128	0	7100	0	6972	0.0	0.0
chr3	HPS3	149140003	149140498	0	496	307	5964	307	5468	0.0	0.05614484272128749
chr3	HPS3	149170470	149170573	0	104	307	5964	307	5860	0.0	0.052389078498293516
chr3	TM4SF1-AS1	149384992	149385169	0	178	867	2333	867	2155	0.0	0.40232018561484917
chr3	TM4SF4	149475822	149475912	0	91	0	1535	0	1444	0.0	0.0
chr3	RNF13	149813924	149814026	0	103	1428	3524	1428	3421	0.0	0.4174218064893306
chr3	RNF13	149960055	149960136	0	82	1428	3524	1428	3442	0.0	0.4148750726321906
chr3	RNF13	149822517	149822573	0	57	1428	3524	1428	3467	0.0	0.41188347274300546
chr3	RNF13	149852515	149852596	0	82	1428	3524	1428	3442	0.0	0.4148750726321906
chr3	RNF13	149902071	149902162	0	92	1428	3524	1428	3432	0.0	0.4160839160839161
chr3	RNF13	149846010	149846140	0	131	1428	3524	1428	3393	0.0	0.4208664898320071
chr3	TSC22D2	150423048	150423120	0	73	353009	11682	353009	11609	0.0	30.408217762081144
chr3	TSC22D2	150457075	150457127	0	53	353009	11682	353009	11629	0.0	30.355920543468915
chr3	TSC22D2	150438197	150438354	174	158	353009	11682	352835	11524	1.1012658227848102	30.617407150295037
chr3	EIF2A	150567692	150567766	0	75	51	5921	51	5846	0.0	0.008723913787204926
chr3	EIF2A	150575648	150575762	0	115	51	5921	51	5806	0.0	0.00878401653461936
chr3	EIF2A	150581617	150581746	0	130	51	5921	51	5791	0.0	0.00880676912450354
chr3	EIF2A	150558387	150558462	0	76	51	5921	51	5845	0.0	0.00872540633019675
chr3	EIF2A	150562541	150562660	0	120	51	5921	51	5801	0.0	0.008791587657300466
chr3	EIF2A	150565190	150565226	0	37	51	5921	51	5884	0.0	0.00866757307953773
chr3	EIF2A	150562556	150562660	0	105	51	5921	51	5816	0.0	0.008768913342503439
chr3	EIF2A	150557584	150557678	0	95	51	5921	51	5826	0.0	0.008753861997940269
chr3	SELENOT	150618708	150618928	0	221	0	4144	0	3923	0.0	0.0
chr3	SELENOT	150618708	150618803	0	96	0	4144	0	4048	0.0	0.0
chr3	ERICH6-AS1	150719446	150719548	0	103	102	5697	102	5594	0.0	0.018233821952091528
chr3	CLRN1-AS1	151075110	151075252	0	143	0	3071	0	2928	0.0	0.0
chr3	MED12L	151192549	151192654	0	106	102	12667	102	12561	0.0	0.008120372581800811
chr3	MED12L	151416311	151416422	0	112	102	12667	102	12555	0.0	0.008124253285543608
chr3	AADACL2	151740645	151740868	0	224	153	5076	153	4852	0.0	0.03153338829348722
chr3	AADACP1	151775694	151775764	0	71	0	2017	0	1946	0.0	0.0
chr3	AADACP1	151773429	151773652	0	224	0	2017	0	1793	0.0	0.0
chr3	AADACP1	151776803	151776975	0	173	0	2017	0	1844	0.0	0.0
chr3	MBNL1	152299404	152300367	0	964	137	8493	137	7529	0.0	0.018196307610572452
chr3	MBNL1	152432716	152432920	0	205	137	8493	137	8288	0.0	0.01652992277992278
chr3	MBNL1	152446703	152446757	0	55	137	8493	137	8438	0.0	0.016236074899265228
chr3	MBNL1	152456266	152456361	0	96	137	8493	137	8397	0.0	0.016315350720495416
chr3	MBNL1	152455541	152455577	0	37	137	8493	137	8456	0.0	0.01620151371807001
chr3	MBNL1	152447619	152447773	0	155	137	8493	137	8338	0.0	0.01643079875269849
chr3	MBNL1	152396166	152396224	0	59	137	8493	137	8434	0.0	0.01624377519563671
chr3	MBNL1	152458129	152458193	0	65	137	8493	137	8428	0.0	0.01625533934504034
chr3	MBNL1	152447724	152447773	0	50	137	8493	137	8443	0.0	0.016226459789174464
chr3	MME	155156979	155157069	51	91	51	9595	0	9504	0.5604395604395604	0.0
chr3	LINC01487	155255438	155255574	0	137	51	1600	51	1463	0.0	0.034859876965140126
chr3	LINC01487	155242900	155243015	0	116	51	1600	51	1484	0.0	0.03436657681940701
chr3	KCNAB1	156474733	156474820	0	88	8916	6763	8916	6675	0.0	1.3357303370786517
chr3	KCNAB1	156421615	156421659	0	45	8916	6763	8916	6718	0.0	1.3271807085442096
chr3	LEKR1	156852767	156852982	0	216	51	5318	51	5102	0.0	0.00999607996863975
chr3	LEKR1	156927428	156927604	0	177	51	5318	51	5141	0.0	0.0099202489787979
chr3	LINC02029	157086903	157087021	0	119	0	2326	0	2207	0.0	0.0
chr3	AC092944.1	157213543	157213775	0	233	0	8586	0	8353	0.0	0.0
chr3	AC092944.1	157284977	157286341	0	1365	0	8586	0	7221	0.0	0.0
chr3	AC092944.1	157286271	157286341	0	71	0	8586	0	8515	0.0	0.0
chr3	SLC66A1L	157571954	157572043	0	90	153	3154	153	3064	0.0	0.04993472584856397
chr3	SLC66A1L	157553229	157553340	0	112	153	3154	153	3042	0.0	0.05029585798816568
chr3	RSRC1	158203071	158203245	0	175	52024	5081	52024	4906	0.0	10.6041581736649
chr3	RSRC1	158543334	158543487	3877	154	52024	5081	48147	4927	25.175324675324674	9.77207225492186
chr3	RSRC1	158225656	158225733	0	78	52024	5081	52024	5003	0.0	10.398560863481912
chr3	RSRC1	158132085	158132263	0	179	52024	5081	52024	4902	0.0	10.61281109751122
chr3	MLF1	158598079	158598208	0	130	102	3749	102	3619	0.0	0.028184581376070737
chr3	MLF1	158602806	158602939	0	134	102	3749	102	3615	0.0	0.028215767634854772
chr3	MLF1	158592433	158592581	0	149	102	3749	102	3600	0.0	0.028333333333333332
chr3	MLF1	158588851	158588924	0	74	102	3749	102	3675	0.0	0.027755102040816326
chr3	MLF1	158588859	158588924	0	66	102	3749	102	3683	0.0	0.027694814010317675
chr3	MLF1	158593381	158593426	0	46	102	3749	102	3703	0.0	0.027545233594382934
chr3	MLF1	158598128	158598208	0	81	102	3749	102	3668	0.0	0.027808069792802616
chr3	MLF1	158582655	158582929	0	275	102	3749	102	3474	0.0	0.02936096718480138
chr3	MLF1	158593381	158593421	0	41	102	3749	102	3708	0.0	0.02750809061488673
chr3	MLF1	158596348	158596423	0	76	102	3749	102	3673	0.0	0.02777021508303839
chr3	MLF1	158573297	158573433	0	137	102	3749	102	3612	0.0	0.02823920265780731
chr3	MLF1	158572975	158573039	0	65	102	3749	102	3684	0.0	0.02768729641693811
chr3	GFM1	158690162	158690323	0	162	51	10963	51	10801	0.0	0.004721785019905564
chr3	GFM1	158650004	158650061	0	58	51	10963	51	10905	0.0	0.004676753782668501
chr3	MFSD1	158805361	158805474	63	114	182	3754	119	3640	0.5526315789473685	0.032692307692307694
chr3	AC080013.1	158733950	158734037	0	88	0	4565	0	4477	0.0	0.0
chr3	AC080013.1	158742371	158742481	0	111	0	4565	0	4454	0.0	0.0
chr3	MFSD1	158821596	158821653	0	58	182	3754	182	3696	0.0	0.04924242424242424
chr3	MFSD1	158825177	158825301	0	125	182	3754	182	3629	0.0	0.050151556902728024
chr3	MFSD1	158805340	158805474	84	135	182	3754	98	3619	0.6222222222222222	0.027079303675048357
chr3	IQCJ-SCHIP1	159252726	159252799	0	74	406	4426	406	4352	0.0	0.09329044117647059
chr3	IQCJ-SCHIP1	159252726	159252807	0	82	406	4426	406	4344	0.0	0.0934622467771639
chr3	IQCJ-SCHIP1	159764442	159765138	202	697	406	4426	204	3729	0.2898134863701578	0.054706355591311345
chr3	IQCJ-SCHIP1	159764442	159765099	202	658	406	4426	204	3768	0.3069908814589666	0.054140127388535034
chr3	IL12A	159993011	159993125	486	115	6459	1635	5973	1520	4.226086956521739	3.9296052631578946
chr3	IL12A	159993450	159993492	0	43	6459	1635	6459	1592	0.0	4.057160804020101
chr3	SMC4	160400821	160400965	0	145	153	7681	153	7536	0.0	0.020302547770700636
chr3	SMC4	160400599	160400965	0	367	153	7681	153	7314	0.0	0.02091878589007383
chr3	SMC4	160401989	160402093	0	105	153	7681	153	7576	0.0	0.02019535374868004
chr3	SMC4	160431031	160431205	0	175	153	7681	153	7506	0.0	0.02038369304556355
chr3	SMC4	160400627	160400965	0	339	153	7681	153	7342	0.0	0.020839008444565512
chr3	SMC4	160401914	160402093	0	180	153	7681	153	7501	0.0	0.020397280362618318
chr3	SMC4	160412325	160412453	0	129	153	7681	153	7552	0.0	0.020259533898305086
chr3	PPM1L	160939655	160939755	0	101	255	12452	255	12351	0.0	0.020646101530240466
chr3	LINC01322	165374258	165374424	0	167	0	14499	0	14332	0.0	0.0
chr3	LINC01322	165460538	165460632	0	95	0	14499	0	14404	0.0	0.0
chr3	LINC01322	165491195	165491266	0	72	0	14499	0	14427	0.0	0.0
chr3	LINC01322	165460451	165460632	0	182	0	14499	0	14317	0.0	0.0
chr3	LINC01322	165345471	165345525	0	55	0	14499	0	14444	0.0	0.0
chr3	LINC01322	165511510	165511651	0	142	0	14499	0	14357	0.0	0.0
chr3	LINC01322	165446042	165446263	0	222	0	14499	0	14277	0.0	0.0
chr3	LINC01322	165495220	165495290	0	71	0	14499	0	14428	0.0	0.0
chr3	LINC01322	165495220	165495266	0	47	0	14499	0	14452	0.0	0.0
chr3	LINC01322	165389888	165390111	0	224	0	14499	0	14275	0.0	0.0
chr3	LINC01322	165300499	165300634	0	136	0	14499	0	14363	0.0	0.0
chr3	LINC01322	165474079	165474241	0	163	0	14499	0	14336	0.0	0.0
chr3	LINC01322	165258405	165258523	0	119	0	14499	0	14380	0.0	0.0
chr3	LINC01322	165474079	165474237	0	159	0	14499	0	14340	0.0	0.0
chr3	LINC01322	165602439	165602552	0	114	0	14499	0	14385	0.0	0.0
chr3	LRRC77P	167914826	167914970	0	145	0	5364	0	5219	0.0	0.0
chr3	LRRC77P	167920564	167920791	0	228	0	5364	0	5136	0.0	0.0
chr3	LRRC77P	167919368	167919430	0	63	0	5364	0	5301	0.0	0.0
chr3	LRRC77P	167917298	167917496	0	199	0	5364	0	5165	0.0	0.0
chr3	LRRC77P	167915756	167915910	0	155	0	5364	0	5209	0.0	0.0
chr3	EGFEM1P	168314070	168314176	0	107	0	4669	0	4562	0.0	0.0
chr3	MYNN	169784621	169784708	0	88	621	5175	621	5087	0.0	0.12207587969333596
chr3	MYNN	169774030	169774097	0	68	621	5175	621	5107	0.0	0.12159780693166243
chr3	MYNN	169783729	169783858	0	130	621	5175	621	5045	0.0	0.12309217046580773
chr3	SAMD7	169926212	169926325	0	114	204	2522	204	2408	0.0	0.08471760797342193
chr3	SEC62	169969286	169969383	11	98	38728	7317	38717	7219	0.11224489795918367	5.363208200581798
chr3	GPR160	170077122	170077923	20805	802	25001	4391	4196	3589	25.94139650872818	1.1691278907773752
chr3	GPR160	170083364	170083522	0	159	25001	4391	25001	4232	0.0	5.907608695652174
chr3	SKIL	170384532	170384765	0	234	1326	7601	1326	7367	0.0	0.17999185557214606
chr3	SKIL	170384532	170384627	0	96	1326	7601	1326	7505	0.0	0.17668221185876082
chr3	ECT2	172752149	172752472	0	324	0	5475	0	5151	0.0	0.0
chr3	ECT2	172755482	172755575	0	94	0	5475	0	5381	0.0	0.0
chr3	ECT2	172752149	172752436	0	288	0	5475	0	5187	0.0	0.0
chr3	ECT2	172752149	172752272	0	124	0	5475	0	5351	0.0	0.0
chr3	ECT2	172818547	172818814	0	268	0	5475	0	5207	0.0	0.0
chr3	NAALADL2	175324174	175324325	0	152	40	13578	40	13426	0.0	0.0029792939073439596
chr3	NAALADL2	175447228	175447372	0	145	40	13578	40	13433	0.0	0.0029777413831608723
chr3	NAALADL2	175460044	175460175	0	132	40	13578	40	13446	0.0	0.0029748624126134165
chr3	LINC00578	177539394	177539493	0	100	0	6327	0	6227	0.0	0.0
chr3	LINC00578	177629416	177629555	0	140	0	6327	0	6187	0.0	0.0
chr3	LINC00578	177751910	177752065	0	156	0	6327	0	6171	0.0	0.0
chr3	LINC00578	177669081	177669184	0	104	0	6327	0	6223	0.0	0.0
chr3	LINC02015	177820716	177820889	0	174	0	2528	0	2354	0.0	0.0
chr3	LINC02015	177896563	177896895	0	333	0	2528	0	2195	0.0	0.0
chr3	LINC01014	178456613	178456774	0	162	51	555	51	393	0.0	0.1297709923664122
chr3	KCNMB2	178795141	178795218	0	78	102	3552	102	3474	0.0	0.02936096718480138
chr3	KCNMB2	178824557	178824682	0	126	102	3552	102	3426	0.0	0.0297723292469352
chr3	PIK3CA	179219195	179219277	0	83	2258	13620	2258	13537	0.0	0.16680209795375636
chr3	PIK3CA	179233288	179233371	0	84	2258	13620	2258	13536	0.0	0.1668144208037825
chr3	ZNF639	179325041	179325322	966	282	316069	6830	315103	6548	3.425531914893617	48.122021991447774
chr3	ZNF639	179324949	179324993	37	45	316069	6830	316032	6785	0.8222222222222222	46.57803979366249
chr3	MFN1	179377041	179377168	0	128	3218	5649	3218	5521	0.0	0.5828654229306285
chr3	ACTL6A	179575402	179575504	0	103	0	3491	0	3388	0.0	0.0
chr3	NDUFB5	179614970	179615059	0	90	0	5543	0	5453	0.0	0.0
chr3	NDUFB5	179618414	179618521	0	108	0	5543	0	5435	0.0	0.0
chr3	NDUFB5	179616982	179617044	0	63	0	5543	0	5480	0.0	0.0
chr3	NDUFB5	179615984	179616049	0	66	0	5543	0	5477	0.0	0.0
chr3	NDUFB5	179615982	179616049	0	68	0	5543	0	5475	0.0	0.0
chr3	NDUFB5	179614951	179615059	0	109	0	5543	0	5434	0.0	0.0
chr3	NDUFB5	179615555	179615615	0	61	0	5543	0	5482	0.0	0.0
chr3	NDUFB5	179607757	179607812	0	56	0	5543	0	5487	0.0	0.0
chr3	USP13	179690240	179690301	0	62	0	8177	0	8115	0.0	0.0
chr3	USP13	179757051	179757078	0	28	0	8177	0	8149	0.0	0.0
chr3	FXR1	180935137	180935231	0	95	139	11810	139	11715	0.0	0.01186513017498933
chr3	FXR1	180914651	180914995	0	345	139	11810	139	11465	0.0	0.012123855211513301
chr3	FXR1	180975312	180975404	0	93	139	11810	139	11717	0.0	0.01186310489033029
chr3	FXR1	180933333	180933386	0	54	139	11810	139	11756	0.0	0.011823749574685268
chr3	FXR1	180971074	180971155	0	82	139	11810	139	11728	0.0	0.011851978171896316
chr3	SOX2-OT	181030569	181030689	0	121	51	31226	51	31105	0.0	0.0016396077800996623
chr3	SOX2-OT	181056696	181056786	0	91	51	31226	51	31135	0.0	0.001638027942829613
chr3	SOX2-OT	181610860	181610929	0	70	51	31226	51	31156	0.0	0.0016369238669919116
chr3	SOX2-OT	181715184	181715292	0	109	51	31226	51	31117	0.0	0.0016389754796413535
chr3	SOX2-OT	181003774	181003933	0	160	51	31226	51	31066	0.0	0.0016416661301744673
chr3	SOX2-OT	181630854	181631004	0	151	51	31226	51	31075	0.0	0.0016411906677393402
chr3	SOX2-OT	181604291	181604340	0	50	51	31226	51	31176	0.0	0.0016358737490377213
chr3	SOX2-OT	181699597	181699883	0	287	51	31226	51	30939	0.0	0.0016484049258217784
chr3	SOX2-OT	181601310	181601389	0	80	51	31226	51	31146	0.0	0.0016374494317087267
chr3	SOX2-OT	181690833	181691002	0	170	51	31226	51	31056	0.0	0.0016421947449768162
chr3	SOX2-OT	181610608	181610745	0	138	51	31226	51	31088	0.0	0.0016405043746783325
chr3	SOX2-OT	181610856	181610929	0	74	51	31226	51	31152	0.0	0.0016371340523882896
chr3	SOX2-OT	181737270	181737361	0	92	51	31226	51	31134	0.0	0.0016380805550202352
chr3	SOX2-OT	181736374	181736542	0	169	51	31226	51	31057	0.0	0.0016421418681778666
chr3	SOX2-OT	181732463	181732612	0	150	51	31226	51	31076	0.0	0.0016411378555798686
chr3	SOX2-OT	181722201	181722298	0	98	51	31226	51	31128	0.0	0.0016383962991518889
chr3	SOX2-OT	181774260	181774415	0	156	51	31226	51	31070	0.0	0.0016414547795300933
chr3	SOX2-OT	181774247	181774415	0	169	51	31226	51	31057	0.0	0.0016421418681778666
chr3	SOX2-OT	181778534	181778669	0	136	51	31226	51	31090	0.0	0.0016403988420714056
chr3	SOX2-OT	181778534	181778662	0	129	51	31226	51	31097	0.0	0.001640029584847413
chr3	SOX2-OT	181814212	181814516	0	305	51	31226	51	30921	0.0	0.001649364509556612
chr3	SOX2-OT	181825603	181825744	0	142	51	31226	51	31084	0.0	0.0016407154806331232
chr3	SOX2-OT	181825627	181825744	0	118	51	31226	51	31108	0.0	0.0016394496592516395
chr3	SOX2-OT	181701399	181701449	0	51	51	31226	51	31175	0.0	0.0016359262229350441
chr3	SOX2-OT	181722204	181722298	0	95	51	31226	51	31131	0.0	0.00163823841187241
chr3	LINC01206	182000188	182000506	0	319	0	11383	0	11064	0.0	0.0
chr3	LINC01206	181971563	181971734	0	172	0	11383	0	11211	0.0	0.0
chr3	LINC01206	181984369	181984491	0	123	0	11383	0	11260	0.0	0.0
chr3	LINC01206	181971563	181971719	0	157	0	11383	0	11226	0.0	0.0
chr3	LINC01206	181984369	181984431	0	63	0	11383	0	11320	0.0	0.0
chr3	LINC01206	182000188	182000508	0	321	0	11383	0	11062	0.0	0.0
chr3	LINC01206	182000188	182000445	0	258	0	11383	0	11125	0.0	0.0
chr3	LINC01206	182000188	182000469	0	282	0	11383	0	11101	0.0	0.0
chr3	LINC01206	182000107	182000506	0	400	0	11383	0	10983	0.0	0.0
chr3	LINC01206	182000107	182000445	0	339	0	11383	0	11044	0.0	0.0
chr3	LINC01206	182002773	182002845	0	73	0	11383	0	11310	0.0	0.0
chr3	LINC01206	181984723	181984827	0	105	0	11383	0	11278	0.0	0.0
chr3	LINC01206	181973542	181973661	0	120	0	11383	0	11263	0.0	0.0
chr3	LINC01206	182001533	182001760	0	228	0	11383	0	11155	0.0	0.0
chr3	LINC01206	181984727	181984827	0	101	0	11383	0	11282	0.0	0.0
chr3	LINC01206	181957100	181957294	0	195	0	11383	0	11188	0.0	0.0
chr3	ATP11B	182885950	182886010	0	61	1149	9220	1149	9159	0.0	0.1254503766786767
chr3	ATP11B	182902480	182902566	0	87	1149	9220	1149	9133	0.0	0.12580751122303735
chr3	ATP11B	182908458	182908505	0	48	1149	9220	1149	9172	0.0	0.1252725686873092
chr3	KLHL24	183644085	183644167	0	83	72711	8653	72711	8570	0.0	8.48436406067678
chr3	KLHL24	183643479	183643542	5167	64	72711	8653	67544	8589	80.734375	7.864012108510886
chr3	KLHL24	183636220	183636311	0	92	72711	8653	72711	8561	0.0	8.493283494918819
chr3	HTR3D	184036368	184036540	0	173	827932	1963	827932	1790	0.0	462.531843575419
chr3	HTR3E	184101484	184101529	224	46	224	2479	0	2433	4.869565217391305	0.0
chr3	EIF2B5	184140417	184140730	0	314	255	6302	255	5988	0.0	0.042585170340681364
chr3	EIF2B5	184140417	184140740	0	324	255	6302	255	5978	0.0	0.04265640682502509
chr3	EIF2B5	184138846	184138939	102	94	255	6302	153	6208	1.0851063829787233	0.02464561855670103
chr3	EIF2B5	184140417	184140615	0	199	255	6302	255	6103	0.0	0.04178272980501393
chr3	EIF2B5	184135663	184135916	0	254	255	6302	255	6048	0.0	0.042162698412698416
chr3	EIF2B5	184140079	184140157	144	79	255	6302	111	6223	1.8227848101265822	0.01783705608227543
chr3	DVL3	184166445	184166522	0	78	0	6169	0	6091	0.0	0.0
chr3	DVL3	184156359	184156447	0	89	0	6169	0	6080	0.0	0.0
chr3	DVL3	184162604	184162801	0	198	0	6169	0	5971	0.0	0.0
chr3	AP2M1	184177542	184177611	0	70	140	4554	140	4484	0.0	0.031222123104371096
chr3	AP2M1	184178217	184178223	0	7	140	4554	140	4547	0.0	0.030789531559269848
chr3	AP2M1	184180644	184180650	0	7	140	4554	140	4547	0.0	0.030789531559269848
chr3	AP2M1	184180644	184180741	0	98	140	4554	140	4456	0.0	0.03141831238779174
chr3	AP2M1	184180841	184180844	0	4	140	4554	140	4550	0.0	0.03076923076923077
chr3	ECE2	184278491	184278557	0	67	357	4745	357	4678	0.0	0.07631466438648996
chr3	ECE2	184276480	184276567	0	88	357	4745	357	4657	0.0	0.07665879321451578
chr3	ECE2	184276480	184276705	0	226	357	4745	357	4519	0.0	0.07899977871210445
chr3	PSMD2	184301846	184302071	0	226	459	4392	459	4166	0.0	0.11017762842054729
chr3	PSMD2	184306750	184306834	0	85	459	4392	459	4307	0.0	0.10657069886231715
chr3	PSMD2	184301793	184302071	0	279	459	4392	459	4113	0.0	0.11159737417943107
chr3	PSMD2	184301857	184302071	0	215	459	4392	459	4177	0.0	0.10988747905195116
chr3	EIF4G1	184316712	184316733	0	22	0	7868	0	7846	0.0	0.0
chr3	EIF4G1	184315488	184315545	0	58	0	7868	0	7810	0.0	0.0
chr3	EIF4G1	184317320	184317497	0	178	0	7868	0	7690	0.0	0.0
chr3	EIF4G1	184317320	184317431	0	112	0	7868	0	7756	0.0	0.0
chr3	EIF4G1	184317716	184317816	0	101	0	7868	0	7767	0.0	0.0
chr3	FAM131A	184338386	184338529	0	144	28	7862	28	7718	0.0	0.003627882871210158
chr3	FAM131A	184337310	184337371	0	62	28	7862	28	7800	0.0	0.0035897435897435897
chr3	FAM131A	184341723	184341817	0	95	28	7862	28	7767	0.0	0.003604995493755633
chr3	POLR2H	184362872	184363565	0	694	0	3089	0	2395	0.0	0.0
chr3	POLR2H	184366716	184366800	0	85	0	3089	0	3004	0.0	0.0
chr3	CHRD	184381079	184381130	0	52	0	6337	0	6285	0.0	0.0
chr3	CHRD	184383522	184383642	0	121	0	6337	0	6216	0.0	0.0
chr3	CHRD	184387373	184387477	0	105	0	6337	0	6232	0.0	0.0
chr3	CHRD	184381075	184381130	0	56	0	6337	0	6281	0.0	0.0
chr3	LINC02054	184422952	184423132	0	181	5464	4067	5464	3886	0.0	1.4060730828615542
chr3	LINC02054	184425696	184425838	765	143	5464	4067	4699	3924	5.34965034965035	1.1975025484199797
chr3	AC107294.2	184734034	184734100	166	67	778	3702	612	3635	2.4776119402985075	0.16836313617606602
chr3	AC107294.2	184726102	184726205	0	104	778	3702	778	3598	0.0	0.2162312395775431
chr3	AC107294.2	184728833	184728905	0	73	778	3702	778	3629	0.0	0.2143841278589143
chr3	AC107294.2	184727399	184727580	0	182	778	3702	778	3520	0.0	0.22102272727272726
chr3	AC107294.2	184734034	184734240	727	207	778	3702	51	3495	3.5120772946859904	0.014592274678111588
chr3	VPS8	184839697	184839758	0	62	1130	9433	1130	9371	0.0	0.1205847828406787
chr3	VPS8	184843239	184843245	0	7	1130	9433	1130	9426	0.0	0.11988117971568003
chr3	VPS8	184839697	184839752	0	56	1130	9433	1130	9377	0.0	0.12050762503999146
chr3	VPS8	184824146	184824232	0	87	1130	9433	1130	9346	0.0	0.12090734003851915
chr3	VPS8	184824930	184825048	0	119	1130	9433	1130	9314	0.0	0.12132273996134851
chr3	VPS8	184836246	184836330	0	85	1130	9433	1130	9348	0.0	0.12088147197261447
chr3	VPS8	184893233	184893412	0	180	1130	9433	1130	9253	0.0	0.12212255484707663
chr3	VPS8	184882348	184882433	0	86	1130	9433	1130	9347	0.0	0.12089440462180379
chr3	VPS8	184922428	184922483	264	56	1130	9433	866	9377	4.714285714285714	0.0923536312253386
chr3	MAP3K13	185437446	185437630	0	185	79540	12248	79540	12063	0.0	6.593716322639476
chr3	MAP3K13	185443444	185443636	0	193	79540	12248	79540	12055	0.0	6.598092077975943
chr3	SENP2	185598411	185598545	0	135	8371	6876	8371	6741	0.0	1.2418038866636998
chr3	SENP2	185598957	185599024	0	68	8371	6876	8371	6808	0.0	1.2295828437132785
chr3	SENP2	185598991	185599024	0	34	8371	6876	8371	6842	0.0	1.2234726688102895
chr3	SENP2	185617479	185617611	24	133	8371	6876	8347	6743	0.18045112781954886	1.237876316179742
chr3	SENP2	185598393	185598545	0	153	8371	6876	8371	6723	0.0	1.2451286627993454
chr3	IGF2BP2-AS1	185728686	185728870	0	185	153	3425	153	3240	0.0	0.04722222222222222
chr3	NMRAL2P	185968478	185968649	0	172	0	2634	0	2462	0.0	0.0
chr3	NMRAL2P	185968478	185968708	0	231	0	2634	0	2403	0.0	0.0
chr3	NMRAL2P	185968478	185968717	0	240	0	2634	0	2394	0.0	0.0
chr3	LINC02020	186441844	186442081	0	238	51	3478	51	3240	0.0	0.01574074074074074
chr3	LINC02020	186440981	186441121	0	141	51	3478	51	3337	0.0	0.015283188492658075
chr3	LINC02020	186440981	186441179	0	199	51	3478	51	3279	0.0	0.01555352241537054
chr3	LINC02020	186444905	186445953	0	1049	51	3478	51	2429	0.0	0.02099629477151091
chr3	LINC02020	186441017	186441121	0	105	51	3478	51	3373	0.0	0.015120071153276016
chr3	LINC02020	186440981	186442081	51	1101	51	3478	0	2377	0.04632152588555858	0.0
chr3	LINC02020	186444905	186445833	0	929	51	3478	51	2549	0.0	0.02000784621420165
chr3	FETUB	186641029	186641140	0	112	204	2000	204	1888	0.0	0.10805084745762712
chr3	FETUB	186642470	186642558	0	89	204	2000	204	1911	0.0	0.10675039246467818
chr3	KNG1	186727236	186727344	0	109	593	2509	593	2400	0.0	0.24708333333333332
chr3	EIF4A2	186787494	186787584	18	91	1242	5023	1224	4932	0.1978021978021978	0.24817518248175183
chr3	EIF4A2	186787478	186787584	306	107	1242	5023	936	4916	2.8598130841121496	0.1903986981285598
chr3	EIF4A2	186784961	186785101	46	141	1242	5023	1196	4882	0.3262411347517731	0.24498156493240475
chr3	EIF4A2	186788309	186788416	0	108	1242	5023	1242	4915	0.0	0.25269582909460836
chr3	ADIPOQ	186845556	186845607	0	52	150656	4603	150656	4551	0.0	33.10393320149418
chr3	ST6GAL1	186942347	186942427	0	81	0	9537	0	9456	0.0	0.0
chr3	ST6GAL1	187042653	187043310	0	658	0	9537	0	8879	0.0	0.0
chr3	ST6GAL1	187038741	187038873	0	133	0	9537	0	9404	0.0	0.0
chr3	ST6GAL1	186963784	186963926	0	143	0	9537	0	9394	0.0	0.0
chr3	ST6GAL1	186948854	186948938	0	85	0	9537	0	9452	0.0	0.0
chr3	ST6GAL1	187041916	187041966	0	51	0	9537	0	9486	0.0	0.0
chr3	ST6GAL1	187038391	187038491	0	101	0	9537	0	9436	0.0	0.0
chr3	ST6GAL1	187038394	187038491	0	98	0	9537	0	9439	0.0	0.0
chr3	ST6GAL1	187064519	187064616	0	98	0	9537	0	9439	0.0	0.0
chr3	AC108681.1	187804216	187804386	0	171	0	781	0	610	0.0	0.0
chr3	LPP	188406111	188406313	0	203	295	25561	295	25358	0.0	0.011633409574887609
chr3	LPP	188312834	188312918	0	85	295	25561	295	25476	0.0	0.011579525828230491
chr3	LPP	188225404	188225527	0	124	295	25561	295	25437	0.0	0.011597279553406455
chr3	LPP	188341662	188341719	0	58	295	25561	295	25503	0.0	0.011567266596086735
chr3	TPRG1	189147583	189147647	0	65	1275	9563	1275	9498	0.0	0.13423878711307644
chr3	TP63	189890788	189890882	0	95	458	7496	458	7401	0.0	0.06188352925280367
chr3	TP63	189889339	189889484	0	146	458	7496	458	7350	0.0	0.06231292517006803
chr3	TP63	189808271	189808526	263	256	458	7496	195	7240	1.02734375	0.026933701657458564
chr3	TP63	189844196	189844412	0	217	458	7496	458	7279	0.0	0.06292073086962495
chr3	IL1RAP	190629349	190629498	0	150	0	11579	0	11429	0.0	0.0
chr3	IL1RAP	190550341	190550505	0	165	0	11579	0	11414	0.0	0.0
chr3	IL1RAP	190556129	190556216	0	88	0	11579	0	11491	0.0	0.0
chr3	IL1RAP	190554632	190554693	0	62	0	11579	0	11517	0.0	0.0
chr3	CCDC50	191375061	191375589	0	529	51	9195	51	8666	0.0	0.005885068082160166
chr3	AC073365.1	191557261	191557384	0	124	0	8311	0	8187	0.0	0.0
chr3	AC073365.1	191559677	191559754	0	78	0	8311	0	8233	0.0	0.0
chr3	AC073365.1	191546050	191546115	0	66	0	8311	0	8245	0.0	0.0
chr3	AC073365.1	191568205	191568341	0	137	0	8311	0	8174	0.0	0.0
chr3	AC073365.1	191531649	191531707	0	59	0	8311	0	8252	0.0	0.0
chr3	AC073365.1	191585327	191585362	0	36	0	8311	0	8275	0.0	0.0
chr3	AC073365.1	191539293	191539529	0	237	0	8311	0	8074	0.0	0.0
chr3	AC073365.1	191530815	191530850	0	36	0	8311	0	8275	0.0	0.0
chr3	AC073365.1	191559677	191559969	0	293	0	8311	0	8018	0.0	0.0
chr3	AC073365.1	191557261	191557288	0	28	0	8311	0	8283	0.0	0.0
chr3	AC073365.1	191559677	191559750	0	74	0	8311	0	8237	0.0	0.0
chr3	AC073365.1	191546050	191546111	0	62	0	8311	0	8249	0.0	0.0
chr3	AC073365.1	191473550	191473688	0	139	0	8311	0	8172	0.0	0.0
chr3	OPA1	193626091	193626202	0	112	102	9079	102	8967	0.0	0.011375041820006692
chr3	OPA1	193642974	193643049	0	76	102	9079	102	9003	0.0	0.011329556814395202
chr3	OPA1	193645552	193645625	0	74	102	9079	102	9005	0.0	0.011327040533037201
chr3	OPA1	193648069	193648134	0	66	102	9079	102	9013	0.0	0.0113169865749473
chr3	OPA1	193617783	193617837	0	55	102	9079	102	9024	0.0	0.011303191489361703
chr3	OPA1	193617177	193617285	0	109	102	9079	102	8970	0.0	0.01137123745819398
chr3	OPA1	193689068	193689170	0	103	102	9079	102	8976	0.0	0.011363636363636364
chr3	OPA1	193668314	193668484	0	171	102	9079	102	8908	0.0	0.011450381679389313
chr3	OPA1	193596799	193596946	0	148	102	9079	102	8931	0.0	0.011420893516963387
chr3	OPA1	193603499	193603557	0	59	102	9079	102	9020	0.0	0.01130820399113082
chr3	OPA1	193646484	193646579	0	96	102	9079	102	8983	0.0	0.011354781253478793
chr3	OPA1	193628508	193628616	0	109	102	9079	102	8970	0.0	0.01137123745819398
chr3	OPA1	193631754	193631769	0	16	102	9079	102	9063	0.0	0.011254551473022179
chr3	OPA1	193642764	193642845	0	82	102	9079	102	8997	0.0	0.011337112370790263
chr3	OPA1	193667370	193667455	0	86	102	9079	102	8993	0.0	0.011342155009451797
chr3	LINC00884	194490509	194490594	0	86	4050	9432	4050	9346	0.0	0.4333404665097368
chr3	TMEM44-AS1	194589473	194589626	0	154	0	1583	0	1429	0.0	0.0
chr3	LINC01968	194718855	194718978	0	124	1495	9041	1495	8917	0.0	0.16765728383985645
chr3	LINC01968	194714978	194715182	0	205	1495	9041	1495	8836	0.0	0.16919420552286102
chr3	LINC01968	194726726	194726848	0	123	1495	9041	1495	8918	0.0	0.16763848396501457
chr3	LINC01968	194709273	194709397	0	125	1495	9041	1495	8916	0.0	0.167676087931808
chr3	LINC01968	194743689	194743761	0	73	1495	9041	1495	8968	0.0	0.16670383586083853
chr3	LINC01968	194747417	194747539	0	123	1495	9041	1495	8918	0.0	0.16763848396501457
chr3	LINC01968	194747947	194748040	0	94	1495	9041	1495	8947	0.0	0.16709511568123395
chr3	LINC01968	194768452	194768608	0	157	1495	9041	1495	8884	0.0	0.16828005402971635
chr3	LINC01968	194715403	194715652	0	250	1495	9041	1495	8791	0.0	0.17006028893186212
chr3	LINC01968	194747950	194748040	0	91	1495	9041	1495	8950	0.0	0.1670391061452514
chr3	LINC01968	194820560	194820731	0	172	1495	9041	1495	8869	0.0	0.16856466343443455
chr3	LINC01968	194770770	194770876	0	107	1495	9041	1495	8934	0.0	0.16733825833892993
chr3	LINC01968	194769739	194769811	0	73	1495	9041	1495	8968	0.0	0.16670383586083853
chr3	MUC20-OT1	195663623	195663767	549	145	133092	13794	132543	13649	3.786206896551724	9.710821305590153
chr3	MUC20-OT1	195663623	195663832	663	210	133092	13794	132429	13584	3.157142857142857	9.748895759717314
chr3	MUC20-OT1	195689338	195689438	1806	101	133092	13794	131286	13693	17.88118811881188	9.587818593441904
chr3	MUC20-OT1	195701379	195701669	9816	291	133092	13794	123276	13503	33.7319587628866	9.129526771828482
chr3	MUC20-OT1	195685817	195685939	8588	123	133092	13794	124504	13671	69.82113821138212	9.107161144027504
chr3	MUC20-OT1	195688201	195688319	2255	119	133092	13794	130837	13675	18.949579831932773	9.56760511882998
chr3	MUC20-OT1	195686603	195686718	7025	116	133092	13794	126067	13678	60.560344827586206	9.21677145781547
chr3	MUC20-OT1	195707005	195707126	714	122	133092	13794	132378	13672	5.852459016393443	9.682416617905208
chr3	MUC20-OT1	195688532	195688797	2467	266	133092	13794	130625	13528	9.274436090225564	9.655898876404494
chr3	MUC20-OT1	195696360	195696589	9149	230	133092	13794	123943	13564	39.778260869565216	9.1376437629018
chr3	MUC20-OT1	195708133	195708268	2754	136	133092	13794	130338	13658	20.25	9.542978474154342
chr3	MUC20-OT1	195689545	195689608	793	64	133092	13794	132299	13730	12.390625	9.635761107064821
chr3	MUC20-OT1	195686297	195686389	1467	93	133092	13794	131625	13701	15.774193548387096	9.606962995401796
chr3	MUC20-OT1	195688197	195688319	2287	123	133092	13794	130805	13671	18.59349593495935	9.568063784653646
chr3	MUC20-OT1	195701379	195701432	8253	54	133092	13794	124839	13740	152.83333333333334	9.085807860262008
chr3	MUC20-OT1	195699029	195699207	50	179	133092	13794	133042	13615	0.27932960893854747	9.77172236503856
chr3	MUC20-OT1	195708133	195708435	5219	303	133092	13794	127873	13491	17.224422442244226	9.47839300274257
chr3	MUC20-OT1	195701379	195701495	9185	117	133092	13794	123907	13677	78.5042735042735	9.05951597572567
chr3	MUC20-OT1	195701587	195701669	193	83	133092	13794	132899	13711	2.325301204819277	9.692874334475968
chr3	MUC20-OT1	195708428	195708513	796	86	133092	13794	132296	13708	9.255813953488373	9.651006711409396
chr3	MUC20-OT1	195702182	195702442	1911	261	133092	13794	131181	13533	7.32183908045977	9.693416093992463
chr3	MUC20-OT1	195708133	195708387	4051	255	133092	13794	129041	13539	15.886274509803922	9.53105842381269
chr3	MUC20-OT1	195707028	195707126	664	99	133092	13794	132428	13695	6.707070707070707	9.669806498722162
chr3	MUC20-OT1	195718026	195718196	0	171	133092	13794	133092	13623	0.0	9.769654261175953
chr3	MUC20-OT1	195708428	195708435	176	8	133092	13794	132916	13786	22.0	9.641375308283767
chr3	MUC20-OT1	195708428	195708555	1081	128	133092	13794	132011	13666	8.4453125	9.659812673788965
chr3	MUC20-OT1	195722500	195722818	204	319	133092	13794	132888	13475	0.6394984326018809	9.861818181818181
chr3	MUC20-OT1	195717913	195718196	0	284	133092	13794	133092	13510	0.0	9.851369356032569
chr3	MUC20-OT1	195729647	195729739	0	93	133092	13794	133092	13701	0.0	9.714035471863367
chr3	MUC20-OT1	195729342	195729551	51	210	133092	13794	133041	13584	0.24285714285714285	9.793948763250883
chr3	MUC20-OT1	195718023	195718196	0	174	133092	13794	133092	13620	0.0	9.77180616740088
chr3	MUC20-OT1	195718043	195718196	0	154	133092	13794	133092	13640	0.0	9.757478005865103
chr3	MUC20-OT1	195715020	195715082	263	63	133092	13794	132829	13731	4.174603174603175	9.673658145801472
chr3	SLC51A	196228808	196228920	246	113	25793	5092	25547	4979	2.1769911504424777	5.130949989957823
chr3	PIGX	196728701	196728755	691	55	14731	4459	14040	4404	12.563636363636364	3.188010899182561
chr3	PIGX	196726654	196726771	0	118	14731	4459	14731	4341	0.0	3.393457728633955
chr3	PIGX	196721176	196721356	0	181	14731	4459	14731	4278	0.0	3.443431510051426
chr3	PAK2	196827195	196827333	0	139	25033	6285	25033	6146	0.0	4.0730556459485845
chr3	SENP5	196885150	196886694	0	1545	2925	6245	2925	4700	0.0	0.6223404255319149
chr3	SENP5	196923413	196923551	0	139	2925	6245	2925	6106	0.0	0.4790370127743203
chr3	SENP5	196927795	196927879	0	85	2925	6245	2925	6160	0.0	0.47483766233766234
chr3	MELTF-AS1	197004096	197004359	0	264	765	1110	765	846	0.0	0.9042553191489362
chr3	FYTTD1	197770131	197770244	1772	114	5566	7912	3794	7798	15.543859649122806	0.4865350089766607
chr3	FYTTD1	197763465	197763638	306	174	5566	7912	5260	7738	1.7586206896551724	0.6797622124579995
chr3	FYTTD1	197755669	197755834	255	166	5566	7912	5311	7746	1.536144578313253	0.6856442034598502
chr3	LRCH3	197820324	197820430	0	107	255	12658	255	12551	0.0	0.02031710620667676
chr3	LRCH3	197858833	197858905	0	73	255	12658	255	12585	0.0	0.02026221692491061
chr3	LRCH3	197866111	197866219	0	109	255	12658	255	12549	0.0	0.020320344250537893
chr3	LRCH3	197880511	197880757	0	247	255	12658	255	12411	0.0	0.020546289581822575
chr3	LRCH3	197865422	197865471	0	50	255	12658	255	12608	0.0	0.0202252538071066
chr3	RPL35A	197953487	197953660	0	174	2297	2565	2297	2391	0.0	0.9606859054788791
chr3	LMLN	198003014	198003125	0	112	0	8699	0	8587	0.0	0.0
chr3	FRG2FP	198110643	198110732	0	90	0	1159	0	1069	0.0	0.0
chr3	FRG2FP	198110961	198111039	0	79	0	1159	0	1080	0.0	0.0
chr3	CHL1-AS2	196606	196702	0	97	0	3876	0	3779	0.0	0.0
chr3	CNTN4-AS1	3059214	3059380	0	167	0	2084	0	1917	0.0	0.0
chr3	IL5RA	3074781	3074866	0	86	72	6583	72	6497	0.0	0.011082037863629367
chr3	IL5RA	3105467	3105536	0	70	72	6583	72	6513	0.0	0.011054813450023031
chr3	CRBN	3152455	3152587	0	133	11204	7022	11204	6889	0.0	1.6263608651473362
chr3	CRBN	3175162	3175269	459	108	11204	7022	10745	6914	4.25	1.5540931443448076
chr3	CRBN	3175162	3175266	402	105	11204	7022	10802	6917	3.8285714285714287	1.561659679051612
chr3	SUMF1	4449265	4449340	0	76	40321	6965	40321	6889	0.0	5.852953984613151
chr3	SUMF1	4376329	4376389	453	61	40321	6965	39868	6904	7.426229508196721	5.774623406720742
chr3	AC018816.1	4825745	4825862	0	118	337	1261	337	1143	0.0	0.29483814523184604
chr3	AC018816.1	4817432	4817551	0	120	337	1261	337	1141	0.0	0.2953549517966696
chr3	BHLHE40-AS1	4949558	4949698	0	141	408	4557	408	4416	0.0	0.09239130434782608
chr3	BHLHE40-AS1	4959197	4959385	0	189	408	4557	408	4368	0.0	0.09340659340659341
chr3	GRM7-AS3	6635086	6635197	0	112	278	3700	278	3588	0.0	0.07748049052396878
chr3	GRM7-AS3	6640933	6641066	0	134	278	3700	278	3566	0.0	0.07795849691531127
chr3	LMCD1-AS1	8194915	8195073	0	159	8888	11271	8888	11112	0.0	0.7998560115190785
chr3	LMCD1-AS1	8611493	8611639	44	147	8888	11271	8844	11124	0.29931972789115646	0.7950377562028047
chr3	SSUH2	8634397	8634645	0	249	4953	6307	4953	6058	0.0	0.8175965665236051
chr3	SSUH2	8639947	8640069	0	123	4953	6307	4953	6184	0.0	0.8009379042690815
chr3	SSUH2	8659489	8659801	0	313	4953	6307	4953	5994	0.0	0.8263263263263263
chr3	SSUH2	8671893	8672035	0	143	4953	6307	4953	6164	0.0	0.8035366645035691
chr3	RAD18	8913643	8913720	459	78	4337	6999	3878	6921	5.884615384615385	0.560323652651351
chr3	RAD18	8948508	8948570	153	63	4337	6999	4184	6936	2.4285714285714284	0.6032295271049596
chr3	RAD18	8958919	8959001	0	83	4337	6999	4337	6916	0.0	0.6270965876229034
chr3	SRGAP3	9032649	9032752	0	104	77639	18958	77639	18854	0.0	4.117906014638804
chr3	SRGAP3	9028099	9028130	0	32	77639	18958	77639	18926	0.0	4.102240304343232
chr3	SRGAP3	9014741	9014841	0	101	77639	18958	77639	18857	0.0	4.117250888264305
chr3	SRGAP3	9049260	9049469	0	210	77639	18958	77639	18748	0.0	4.141188393428632
chr3	SRGAP3	9330527	9330596	0	70	77639	18958	77639	18888	0.0	4.110493434985176
chr3	AC026191.1	9355800	9355859	0	60	0	1656	0	1596	0.0	0.0
chr3	THUMPD3-AS1	9391426	9391826	4230	401	7555	6225	3325	5824	10.54862842892768	0.5709134615384616
chr3	THUMPD3-AS1	9391678	9391826	1160	149	7555	6225	6395	6076	7.785234899328859	1.0525016458196181
chr3	THUMPD3-AS1	9395505	9395579	0	75	7555	6225	7555	6150	0.0	1.2284552845528456
chr3	CAMK1	9759487	9759575	0	89	468	2727	468	2638	0.0	0.177407126611069
chr3	CAMK1	9765758	9765890	0	133	468	2727	468	2594	0.0	0.18041634541249035
chr3	CAMK1	9766124	9766213	0	90	468	2727	468	2637	0.0	0.17747440273037543
chr3	RPUSD3	9838984	9839171	158	188	953267	5249	953109	5061	0.8404255319148937	188.32424422050977
chr3	RPUSD3	9839031	9839171	102	141	953267	5249	953165	5108	0.723404255319149	186.60238841033672
chr3	RPUSD3	9842198	9842243	0	46	953267	5249	953267	5203	0.0	183.21487603305786
chr3	RPUSD3	9843464	9843601	5105	138	953267	5249	948162	5111	36.992753623188406	185.5139894345529
chr3	CIDEC	9877065	9877219	3852	155	18063	1418	14211	1263	24.851612903225806	11.251781472684085
chr3	CIDEC	9870444	9870474	222	31	18063	1418	17841	1387	7.161290322580645	12.863013698630137
chr3	CIDEC	9878941	9879054	143	114	18063	1418	17920	1304	1.2543859649122806	13.742331288343559
chr3	EMC3	9981633	9981747	246	115	51014	4281	50768	4166	2.139130434782609	12.186269803168507
chr3	AC022007.1	10010170	10010402	1624	233	410471	4728	408847	4495	6.969957081545064	90.9559510567297
chr3	GHRL	10286703	10286812	0	110	183332	2081	183332	1971	0.0	93.01471334348047
chr3	GHRL	10290072	10290209	310	138	183332	2081	183022	1943	2.246376811594203	94.19557385486361
chr3	GHRL	10290715	10291451	179376	737	183332	2081	3956	1344	243.38670284938942	2.943452380952381
chr3	GHRL	10290715	10290990	34327	276	183332	2081	149005	1805	124.3731884057971	82.55124653739612
chr3	GHRL	10289761	10289878	1038	118	183332	2081	182294	1963	8.796610169491526	92.86500254712175
chr3	GHRL	10289761	10289875	1017	115	183332	2081	182315	1966	8.843478260869565	92.73397761953204
chr3	GHRL	10290715	10290912	20661	198	183332	2081	162671	1883	104.34848484848484	86.38927243759957
chr3	SEC13	10319138	10319172	165	35	377315	4364	377150	4329	4.714285714285714	87.12173712173713
chr3	SEC13	10319138	10319316	4328	179	377315	4364	372987	4185	24.178770949720672	89.1247311827957
chr3	SEC13	10319256	10319316	1834	61	377315	4364	375481	4303	30.065573770491802	87.2602835231234
chr3	ATP2B2	10386479	10386512	12	34	625982	10290	625970	10256	0.35294117647058826	61.034516380655226
chr3	ATP2B2	10331910	10332037	639	128	625982	10290	625343	10162	4.9921875	61.53739421373745
chr3	ATP2B2	10331982	10332037	105	56	625982	10290	625877	10234	1.875	61.15663474692202
chr3	ATP2B2	10385267	10385327	0	61	625982	10290	625982	10229	0.0	61.19679343044286
chr3	ATP2B2	10338725	10338915	1071	191	625982	10290	624911	10099	5.607329842931938	61.87850282206159
chr3	ATP2B2	10379242	10379284	12	43	625982	10290	625970	10247	0.27906976744186046	61.08812335317654
chr3	ATP2B2	10336128	10336300	3058	173	625982	10290	622924	10117	17.67630057803468	61.572007512108335
chr3	VGLL4	11671261	11671394	0	134	26626	7253	26626	7119	0.0	3.740132041016997
chr3	VGLL4	11693044	11693163	0	120	26626	7253	26626	7133	0.0	3.7327912519276603
chr3	TAMM41	11807832	11807895	0	64	13951	5499	13951	5435	0.0	2.56688132474701
chr3	TAMM41	11833002	11833151	1939	150	13951	5499	12012	5349	12.926666666666666	2.2456533931575997
chr3	TAMM41	11830721	11830874	1079	154	13951	5499	12872	5345	7.0064935064935066	2.4082319925163707
chr3	TAMM41	11844890	11845096	4924	207	13951	5499	9027	5292	23.78743961352657	1.7057823129251701
chr3	MKRN2OS	12543179	12543229	18	51	37811	3058	37793	3007	0.35294117647058826	12.568340538742934
chr3	RAF1	12606200	12606299	555	100	10916	7443	10361	7343	5.55	1.411003676971265
chr3	RAF1	12611949	12612062	0	114	10916	7443	10916	7329	0.0	1.489425569654796
chr3	RAF1	12603477	12603537	0	61	10916	7443	10916	7382	0.0	1.478732050934706
chr3	TMEM40	12743899	12743989	0	91	357	3311	357	3220	0.0	0.1108695652173913
chr3	TMEM40	12748654	12748792	0	139	357	3311	357	3172	0.0	0.11254728877679697
chr3	IQSEC1	12902772	12902822	0	51	50786	10028	50786	9977	0.0	5.090307707727774
chr3	CHCHD4	14121916	14122086	0	171	0	1777	0	1606	0.0	0.0
chr3	XPC	14168256	14168380	1698	125	47503	4652	45805	4527	13.584	10.118179810028717
chr3	MRPS25	15053379	15053467	136	89	4595	4677	4459	4588	1.5280898876404494	0.9718831734960767
chr3	MRPS25	15053290	15053467	363	178	4595	4677	4232	4499	2.039325842696629	0.9406534785507891
chr3	RBSN	15082366	15082608	2028	243	193240	7927	191212	7684	8.345679012345679	24.884435190005206
chr3	RBSN	15098118	15098274	5986	157	193240	7927	187254	7770	38.12738853503185	24.0996138996139
chr3	RBSN	15091338	15091493	31770	156	193240	7927	161470	7771	203.65384615384616	20.778535581006306
chr3	COL6A4P1	15173455	15174061	0	607	62	4580	62	3973	0.0	0.015605336018122326
chr3	SH3BP5	15271600	15271671	0	72	9389	4631	9389	4559	0.0	2.0594428602763766
chr3	SH3BP5	15273115	15273405	765	291	9389	4631	8624	4340	2.6288659793814433	1.9870967741935484
chr3	METTL6	15411244	15411437	0	194	25987	6989	25987	6795	0.0	3.824429727740986
chr3	METTL6	15424954	15425089	0	136	25987	6989	25987	6853	0.0	3.7920618707135563
chr3	METTL6	15415497	15415583	0	87	25987	6989	25987	6902	0.0	3.7651405389742103
chr3	METTL6	15414729	15414914	0	186	25987	6989	25987	6803	0.0	3.8199323827723064
chr3	COLQ	15488205	15488307	0	103	27067	3998	27067	3895	0.0	6.949165596919127
chr3	HACL1	15571667	15571769	0	103	1686	2788	1686	2685	0.0	0.6279329608938548
chr3	HACL1	15574976	15575082	0	107	1686	2788	1686	2681	0.0	0.628869824692279
chr3	HACL1	15586524	15586602	0	79	1686	2788	1686	2709	0.0	0.6223698781838317
chr3	HACL1	15589539	15589612	0	74	1686	2788	1686	2714	0.0	0.6212232866617539
chr3	HACL1	15591599	15591680	24	82	1686	2788	1662	2706	0.2926829268292683	0.614190687361419
chr3	HACL1	15585247	15585342	12	96	1686	2788	1674	2692	0.125	0.6218424962852898
chr3	ANKRD28	15714577	15714656	307	80	140842	11300	140535	11220	3.8375	12.525401069518717
chr3	ANKRD28	15751749	15751820	0	72	140842	11300	140842	11228	0.0	12.543819023868899
chr3	ANKRD28	15814239	15814309	0	71	140842	11300	140842	11229	0.0	12.542701932496215
chr3	DPH3	16264154	16264229	0	76	51	4480	51	4404	0.0	0.011580381471389645
chr3	RFTN1	16416111	16416211	0	101	7624	4790	7624	4689	0.0	1.6259330347622094
chr3	TBC1D5	17291894	17292001	0	108	221	11311	221	11203	0.0	0.019726858877086494
chr3	TBC1D5	17428449	17428519	0	71	221	11311	221	11240	0.0	0.019661921708185055
chr3	TBC1D5	17562018	17562142	0	125	221	11311	221	11186	0.0	0.019756838905775075
chr3	TBC1D5	17233684	17233750	0	67	221	11311	221	11244	0.0	0.019654927072216295
chr3	TBC1D5	17518901	17518995	0	95	221	11311	221	11216	0.0	0.019703994293865906
chr3	TBC1D5	17623848	17623913	0	66	221	11311	221	11245	0.0	0.019653179190751446
chr3	TBC1D5	17622647	17622765	0	119	221	11311	221	11192	0.0	0.019746247319513938
chr3	TBC1D5	17576413	17576549	0	137	221	11311	221	11174	0.0	0.01977805620189726
chr3	TBC1D5	17547015	17547076	0	62	221	11311	221	11249	0.0	0.019646190772513113
chr3	SATB1	18351312	18351408	0	97	102	11420	102	11323	0.0	0.00900821337101475
chr3	SATB1	18436788	18436871	0	84	102	11420	102	11336	0.0	0.00899788285109386
chr3	EFHB	19888443	19888651	0	209	51	4179	51	3970	0.0	0.012846347607052897
chr3	EFHB	19920504	19920567	0	64	51	4179	51	4115	0.0	0.012393681652490888
chr3	SGO1	20174248	20175055	153	808	10761	3751	10608	2943	0.18935643564356436	3.6044852191641183
chr3	SGO1	20175004	20175055	0	52	10761	3751	10761	3699	0.0	2.9091646390916464
chr3	ZNF385D	21441685	21441742	0	58	1054	13099	1054	13041	0.0	0.08082202285100835
chr3	ZNF385D	21459331	21459449	0	119	1054	13099	1054	12980	0.0	0.08120184899845917
chr3	ZNF385D	21511621	21511757	0	137	1054	13099	1054	12962	0.0	0.08131461194260145
chr3	NKIRAS1	23911328	23911450	681	123	13810	2968	13129	2845	5.536585365853658	4.614762741652021
chr3	NKIRAS1	23911328	23911446	681	119	13810	2968	13129	2849	5.722689075630252	4.6082836082836085
chr3	THRB	24228937	24229001	0	65	300	10954	300	10889	0.0	0.02755073927817063
chr3	THRB	24297225	24297371	0	147	300	10954	300	10807	0.0	0.027759785324326824
chr3	THRB	24483922	24484095	96	174	300	10954	204	10780	0.5517241379310345	0.018923933209647494
chr3	THRB	24237990	24238081	0	92	300	10954	300	10862	0.0	0.02761922297919352
chr3	THRB	24297225	24297323	0	99	300	10954	300	10855	0.0	0.027637033625057577
chr3	THRB	24318357	24318494	0	138	300	10954	300	10816	0.0	0.027736686390532544
chr3	THRB	24430100	24430172	0	73	300	10954	300	10881	0.0	0.027570995312930797
chr3	THRB	24348557	24348614	0	58	300	10954	300	10896	0.0	0.02753303964757709
chr3	TOP2B	25618417	25618509	0	93	10930	6082	10930	5989	0.0	1.8250125229587577
chr3	NGLY1	25720013	25720191	0	179	5733	6316	5733	6137	0.0	0.9341697897995763
chr3	NGLY1	25732318	25732483	0	166	5733	6316	5733	6150	0.0	0.9321951219512196
chr3	NGLY1	25739576	25739799	0	224	5733	6316	5733	6092	0.0	0.9410702560735391
chr3	NGLY1	25740402	25740450	0	49	5733	6316	5733	6267	0.0	0.9147917663954045
chr3	NGLY1	25737333	25737455	0	123	5733	6316	5733	6193	0.0	0.9257225900209914
chr3	NGLY1	25736003	25736149	0	147	5733	6316	5733	6169	0.0	0.9293240395526017
chr3	NGLY1	25720129	25720191	0	63	5733	6316	5733	6253	0.0	0.9168399168399168
chr3	NGLY1	25761677	25761708	1198	32	5733	6316	4535	6284	37.4375	0.7216740929344366
chr3	NEK10	27143444	27143474	0	31	28237	7836	28237	7805	0.0	3.6178090967328633
chr3	NEK10	27162460	27162601	0	142	28237	7836	28237	7694	0.0	3.670002599428126
chr3	NEK10	27290616	27290754	150	139	28237	7836	28087	7697	1.079136690647482	3.649084058724178
chr3	NEK10	27363686	27363844	0	159	28237	7836	28237	7677	0.0	3.6781294776605447
chr3	NEK10	27367522	27367562	0	41	28237	7836	28237	7795	0.0	3.622450288646568
chr3	SLC4A7	27409355	27409530	0	176	83485	9251	83485	9075	0.0	9.199449035812671
chr3	SLC4A7	27421621	27421779	39	159	83485	9251	83446	9092	0.24528301886792453	9.177958644962604
chr3	SLC4A7	27379248	27379356	0	109	83485	9251	83485	9142	0.0	9.132028002625246
chr3	SLC4A7	27431297	27431669	42630	373	83485	9251	40855	8878	114.28954423592494	4.6018247353007435
chr3	SLC4A7	27422780	27422840	442	61	83485	9251	83043	9190	7.245901639344262	9.036235038084875
chr3	LINC01967	28010469	28010564	0	96	0	2810	0	2714	0.0	0.0
chr3	AZI2	28341511	28341647	0	137	3550	6285	3550	6148	0.0	0.5774235523747561
chr3	AZI2	28341511	28341596	0	86	3550	6285	3550	6199	0.0	0.5726730117760929
chr3	RBMS3-AS3	29274281	29274424	0	144	1	5926	1	5782	0.0	0.00017295053614666206
chr3	OSBPL10	31830039	31830231	0	193	490450	12095	490450	11902	0.0	41.20736010754495
chr3	OSBPL10	31879654	31879830	51	177	490450	12095	490399	11918	0.288135593220339	41.14775969122336
chr3	OSBPL10	31797754	31797841	0	88	490450	12095	490450	12007	0.0	40.84700591321729
chr3	DYNC1LI1	32566612	32566735	357	124	7980	5790	7623	5666	2.879032258064516	1.34539357571479
chr3	GLB1	33058088	33058269	51104	182	54556	4250	3452	4068	280.7912087912088	0.8485742379547689
chr3	GLB1	33072543	33072713	1366	171	54556	4250	53190	4079	7.988304093567251	13.039960774699681
chr3	GLB1	33065462	33065557	51	96	54556	4250	54505	4154	0.53125	13.121088107847857
chr3	GLB1	33077093	33077237	153	145	54556	4250	54403	4105	1.0551724137931036	13.252862362971985
chr3	SUSD5	33174885	33175074	0	190	555	4607	555	4417	0.0	0.12565089427213041
chr3	UBP1	33408689	33408797	0	109	13797	7661	13797	7552	0.0	1.8269332627118644
chr3	UBP1	33396744	33396878	0	135	13797	7661	13797	7526	0.0	1.8332447515280361
chr3	CLASP2	33510557	33510764	0	208	29679	15265	29679	15057	0.0	1.971109782825264
chr3	CLASP2	33574472	33574496	0	25	29679	15265	29679	15240	0.0	1.9474409448818897
chr3	CLASP2	33577201	33577264	0	64	29679	15265	29679	15201	0.0	1.9524373396487074
chr3	CLASP2	33563963	33563966	0	4	29679	15265	29679	15261	0.0	1.9447611558875566
chr3	CLASP2	33566731	33566734	0	4	29679	15265	29679	15261	0.0	1.9447611558875566
chr3	CLASP2	33514579	33514679	0	101	29679	15265	29679	15164	0.0	1.9572012661566869
chr3	CLASP2	33559124	33559175	0	52	29679	15265	29679	15213	0.0	1.9508972589232894
chr3	CLASP2	33658973	33659009	0	37	29679	15265	29679	15228	0.0	1.9489755713159969
chr3	TRANK1	36838371	36838504	0	134	1424	12161	1424	12027	0.0	0.11840026606801364
chr3	TRANK1	36908322	36908454	0	133	1424	12161	1424	12028	0.0	0.118390422347855
chr3	TRANK1	36850153	36851417	51	1265	1424	12161	1373	10896	0.04031620553359684	0.12600954478707782
chr3	TRANK1	36929314	36929415	0	102	1424	12161	1424	12059	0.0	0.11808607678912016
chr3	TRANK1	36834386	36834475	0	90	1424	12161	1424	12071	0.0	0.11796868527876729
chr3	LRRFIP2	37066223	37066325	0	103	395946	10009	395946	9906	0.0	39.97032101756511
chr3	LRRFIP2	37072789	37072882	164	94	395946	10009	395782	9915	1.7446808510638299	39.917498739283914
chr3	LRRFIP2	37091466	37091538	51	73	395946	10009	395895	9936	0.6986301369863014	39.84450483091788
chr3	LRRFIP2	37115053	37115095	83	43	395946	10009	395863	9966	1.930232558139535	39.72135259883604
chr3	LRRFIP2	37127629	37127680	60	52	395946	10009	395886	9957	1.1538461538461537	39.75956613437783
chr3	LRRFIP2	37121634	37121691	31	58	395946	10009	395915	9951	0.5344827586206896	39.78645362275148
chr3	LRRFIP2	37154613	37154656	0	44	395946	10009	395946	9965	0.0	39.73366783743101
chr3	ITGA9-AS1	37808703	37808880	0	178	8307	14074	8307	13896	0.0	0.5977979274611399
chr3	ITGA9-AS1	37821013	37821100	0	88	8307	14074	8307	13986	0.0	0.5939510939510939
chr3	ITGA9-AS1	37728429	37728530	0	102	8307	14074	8307	13972	0.0	0.5945462353277985
chr3	ITGA9-AS1	37834678	37834767	0	90	8307	14074	8307	13984	0.0	0.5940360411899314
chr3	ITGA9-AS1	37749535	37749664	0	130	8307	14074	8307	13944	0.0	0.5957401032702238
chr3	ITGA9-AS1	37806078	37806185	0	108	8307	14074	8307	13966	0.0	0.5948016611771445
chr3	ITGA9-AS1	37790842	37790911	0	70	8307	14074	8307	14004	0.0	0.5931876606683805
chr3	ITGA9-AS1	37818809	37818930	0	122	8307	14074	8307	13952	0.0	0.5953985091743119
chr3	ITGA9-AS1	37806078	37806228	0	151	8307	14074	8307	13923	0.0	0.5966386554621849
chr3	ITGA9-AS1	37851423	37851492	0	70	8307	14074	8307	14004	0.0	0.5931876606683805
chr3	ITGA9-AS1	37818679	37818930	0	252	8307	14074	8307	13822	0.0	0.6009984083345391
chr3	ACAA1	38133951	38134009	0	59	661	6653	661	6594	0.0	0.10024264482863209
chr3	ACAA1	38131925	38132005	0	81	661	6653	661	6572	0.0	0.10057821059038345
chr3	ACAA1	38126161	38126341	0	181	661	6653	661	6472	0.0	0.10213226205191595
chr3	ACAA1	38129289	38129388	0	100	661	6653	661	6553	0.0	0.10086983061193347
chr3	ACAA1	38131595	38131638	0	44	661	6653	661	6609	0.0	0.10001513088213043
chr3	ACAA1	38134508	38134552	0	45	661	6653	661	6608	0.0	0.10003026634382567
chr3	SCN5A	38579333	38579495	3022	163	51437	10059	48415	9896	18.539877300613497	4.892380759902991
chr3	SCN5A	38557230	38557284	0	55	51437	10059	51437	10004	0.0	5.141643342662935
chr3	SCN5A	38579333	38579492	2873	160	51437	10059	48564	9899	17.95625	4.90595009596929
chr3	SCN11A	38886124	38886238	0	115	102	11921	102	11806	0.0	0.008639674741656785
chr3	SCN11A	38896844	38897225	0	382	102	11921	102	11539	0.0	0.008839587485917323
chr3	SCN11A	38921075	38921255	0	181	102	11921	102	11740	0.0	0.00868824531516184
chr3	SCN11A	38960784	38960847	0	64	102	11921	102	11857	0.0	0.008602513283292569
chr3	SCN11A	38848072	38848151	0	80	102	11921	102	11841	0.0	0.008614137319483153
chr3	SCN11A	38892085	38892139	0	55	102	11921	102	11866	0.0	0.008595988538681949
chr3	SCN11A	38947042	38947086	0	45	102	11921	102	11876	0.0	0.008588750421017177
chr3	GORASP1	39100746	39100877	0	132	24431	5965	24431	5833	0.0	4.188410766329505
chr3	GORASP1	39100304	39100454	0	151	24431	5965	24431	5814	0.0	4.202098383212935
chr3	GORASP1	39101509	39101570	0	62	24431	5965	24431	5903	0.0	4.138743012027782
chr3	XIRP1	39186088	39189525	24094	3438	140151	6469	116057	3031	7.008144269924375	38.29000329924118
chr3	EIF1B-AS1	40248183	40248471	0	289	15694	19255	15694	18966	0.0	0.8274807550353264
chr3	ENTPD3-AS1	40451704	40451782	0	79	45	5559	45	5480	0.0	0.008211678832116789
chr3	ULK4	41954621	41954807	0	187	368509	6325	368509	6138	0.0	60.03730856956663
chr3	ULK4	41937228	41937340	0	113	368509	6325	368509	6212	0.0	59.322118480360594
chr3	ULK4	41937294	41937340	0	47	368509	6325	368509	6278	0.0	58.69847085058936
chr3	VIPR1-AS1	42511714	42511909	0	196	51	4487	51	4291	0.0	0.011885341412258214
chr3	VIPR1-AS1	42516781	42516836	0	56	51	4487	51	4431	0.0	0.011509817197020988
chr3	VIPR1-AS1	42530859	42530958	0	100	51	4487	51	4387	0.0	0.011625256439480283
chr3	VIPR1-AS1	42508811	42508935	0	125	51	4487	51	4362	0.0	0.011691884456671253
chr3	VIPR1-AS1	42512057	42512292	0	236	51	4487	51	4251	0.0	0.011997177134791814
chr3	VIPR1-AS1	42521476	42521577	0	102	51	4487	51	4385	0.0	0.011630558722919042
chr3	VIPR1-AS1	42528548	42528658	0	111	51	4487	51	4376	0.0	0.011654478976234004
chr3	VIPR1-AS1	42512057	42512311	0	255	51	4487	51	4232	0.0	0.012051039697542534
chr3	VIPR1-AS1	42507892	42508006	51	115	51	4487	0	4372	0.4434782608695652	0.0
chr3	VIPR1-AS1	42509184	42509371	0	188	51	4487	51	4299	0.0	0.011863224005582694
chr3	VIPR1-AS1	42530576	42530602	0	27	51	4487	51	4460	0.0	0.011434977578475336
chr3	VIPR1-AS1	42530859	42531052	0	194	51	4487	51	4293	0.0	0.011879804332634521
chr3	VIPR1-AS1	42529339	42529461	0	123	51	4487	51	4364	0.0	0.011686526122823098
chr3	SEC22C	42555929	42555995	0	67	3137	8177	3137	8110	0.0	0.38680641183723796
chr3	SEC22C	42563764	42563880	0	117	3137	8177	3137	8060	0.0	0.3892059553349876
chr3	SEC22C	42563764	42563980	0	217	3137	8177	3137	7960	0.0	0.3940954773869347
chr3	SEC22C	42566743	42566836	0	94	3137	8177	3137	8083	0.0	0.38809847828776445
chr3	SEC22C	42565775	42565883	0	109	3137	8177	3137	8068	0.0	0.38882002974714924
chr3	SEC22C	42580442	42580505	0	64	3137	8177	3137	8113	0.0	0.3866633797608776
chr3	AC006059.1	42632628	42632695	74	68	29965	3108	29891	3040	1.088235294117647	9.832565789473684
chr3	HHATL	42698707	42698902	0	196	34955	2901	34955	2705	0.0	12.922365988909426
chr3	HHATL	42701131	42701190	4888	60	34955	2901	30067	2841	81.46666666666667	10.583245336149243
chr3	CCDC13	42730466	42730589	0	124	108566	7092	108566	6968	0.0	15.58065442020666
chr3	HIGD1A	42786027	42786162	102	136	255	3029	153	2893	0.75	0.05288627722087798
chr3	HIGD1A	42794156	42794275	0	120	255	3029	255	2909	0.0	0.08765898934341698
chr3	HIGD1A	42794156	42794299	0	144	255	3029	255	2885	0.0	0.08838821490467938
chr3	POMGNT2	43090487	43090609	0	123	7809	2674	7809	2551	0.0	3.061152489219914
chr3	ANO10	43576691	43577261	0	571	15588	5236	15588	4665	0.0	3.3414790996784567
chr3	ANO10	43600383	43600581	73	199	15588	5236	15515	5037	0.36683417085427134	3.0802064721064126
chr3	ANO10	43598531	43598666	0	136	15588	5236	15588	5100	0.0	3.0564705882352943
chr3	ANO10	43551471	43551588	0	118	15588	5236	15588	5118	0.0	3.045720984759672
chr3	ANO10	43618019	43618086	0	68	15588	5236	15588	5168	0.0	3.01625386996904
chr3	ANO10	43652946	43653040	0	95	15588	5236	15588	5141	0.0	3.032094923166699
chr3	ZNF445	44458243	44458364	0	122	80629	18652	80629	18530	0.0	4.351268213707502
chr3	ZNF852	44502964	44503056	0	93	2275	2285	2275	2192	0.0	1.0378649635036497
chr3	ZDHHC3	44959130	44959460	3436	331	12673	12129	9237	11798	10.380664652567976	0.7829293100525513
chr3	ZDHHC3	44932906	44932990	0	85	12673	12129	12673	12044	0.0	1.0522251743606774
chr3	ZDHHC3	44958587	44958685	2183	99	12673	12129	10490	12030	22.050505050505052	0.8719866999168745
chr3	SLC6A20	45772504	45772615	757	112	12051	4633	11294	4521	6.758928571428571	2.498119884981199
chr3	SLC6A20	45782082	45782223	830	142	12051	4633	11221	4491	5.845070422535211	2.4985526608773103
chr3	LZTFL1	45827355	45827459	0	105	0	7195	0	7090	0.0	0.0
chr3	LZTFL1	45831072	45831138	0	67	0	7195	0	7128	0.0	0.0
chr3	LZTFL1	45837926	45838051	0	126	0	7195	0	7069	0.0	0.0
chr3	LZTFL1	45854985	45855074	0	90	0	7195	0	7105	0.0	0.0
chr3	LZTFL1	45837926	45838047	0	122	0	7195	0	7073	0.0	0.0
chr3	FYCO1	45938195	45938255	0	61	33209	8909	33209	8848	0.0	3.753277576853526
chr3	XCR1	46022155	46022277	0	123	12546	5168	12546	5045	0.0	2.486818632309217
chr3	LTF	46460564	46460597	0	34	0	3990	0	3956	0.0	0.0
chr3	LRRC2	46551466	46551610	0	145	0	5644	0	5499	0.0	0.0
chr3	PRSS46P	46732819	46732852	0	34	0	1020	0	986	0.0	0.0
chr3	PRSS43P	46755409	46755672	0	264	0	1677	0	1413	0.0	0.0
chr3	PRSS43P	46756404	46756629	0	226	0	1677	0	1451	0.0	0.0
chr3	PRSS44P	46810155	46810310	0	156	0	1079	0	923	0.0	0.0
chr3	CCDC12	46976937	46977040	0	104	2597	3358	2597	3254	0.0	0.7980946527350953
chr3	SETD2	47080915	47081083	0	169	54056	10270	54056	10101	0.0	5.351549351549352
chr3	SETD2	47119451	47119780	102	330	54056	10270	53954	9940	0.3090909090909091	5.427967806841046
chr3	SETD2	47105996	47106120	169	125	54056	10270	53887	10145	1.352	5.311680630852637
chr3	SETD2	47064554	47064630	700	77	54056	10270	53356	10193	9.090909090909092	5.234572746002159
chr3	KIF9	47243050	47243245	1222	196	11408	5311	10186	5115	6.23469387755102	1.9913978494623656
chr3	KIF9	47271236	47271461	460	226	11408	5311	10948	5085	2.0353982300884956	2.152999016715831
chr3	KIF9	47273551	47273658	234	108	11408	5311	11174	5203	2.1666666666666665	2.1476071497213147
chr3	KIF9	47282139	47282385	320	247	11408	5311	11088	5064	1.2955465587044535	2.18957345971564
chr3	KIF9	47263832	47263899	0	68	11408	5311	11408	5243	0.0	2.1758535189776844
chr3	KIF9	47280951	47281195	337	245	11408	5311	11071	5066	1.3755102040816327	2.1853533359652584
chr3	SCAP	47423932	47424045	0	114	19182	6315	19182	6201	0.0	3.093372036768263
chr3	ELP6	47510183	47510254	367	72	10124	3043	9757	2971	5.097222222222222	3.284079434533827
chr3	ELP6	47511147	47511226	0	80	10124	3043	10124	2963	0.0	3.416807289908876
chr3	ELP6	47510148	47510254	561	107	10124	3043	9563	2936	5.242990654205608	3.2571525885558583
chr3	ELP6	47503124	47503449	0	326	10124	3043	10124	2717	0.0	3.7261685682738315
chr3	CSPG5	47569151	47569227	0	77	0	3353	0	3276	0.0	0.0
chr3	CSPG5	47569070	47569227	0	158	0	3353	0	3195	0.0	0.0
chr3	SMARCC1	47738028	47738110	0	83	160116	7655	160116	7572	0.0	21.14580031695721
chr3	MAP4	47853162	47853352	226	191	920579	14847	920353	14656	1.1832460732984293	62.7970114628821
chr3	MAP4	47871226	47871286	0	61	920579	14847	920579	14786	0.0	62.26017854727445
chr3	MAP4	47875684	47875900	546	217	920579	14847	920033	14630	2.5161290322580645	62.88673957621326
chr3	MAP4	47869213	47869327	102	115	920579	14847	920477	14732	0.8869565217391304	62.48146891121368
chr3	MAP4	47921764	47921878	0	115	920579	14847	920579	14732	0.0	62.48839261471626
chr3	MAP4	47909037	47912421	311426	3385	920579	14847	609153	11462	92.00177252584933	53.145437096492756
chr3	MAP4	47987382	47987433	0	52	920579	14847	920579	14795	0.0	62.22230483271375
chr3	MAP4	47867245	47867338	419	94	920579	14847	920160	14753	4.457446808510638	62.371043177658784
chr3	MAP4	48013474	48013517	0	44	920579	14847	920579	14803	0.0	62.18867797068162
chr3	CDC25A	48180720	48180840	0	121	0	4148	0	4027	0.0	0.0
chr3	NME6	48295074	48295235	0	162	19432	6219	19432	6057	0.0	3.2081888723790657
chr3	NME6	48298426	48298523	877	98	19432	6219	18555	6121	8.948979591836734	3.031367423623591
chr3	NME6	48296118	48296158	0	41	19432	6219	19432	6178	0.0	3.1453544836516674
chr3	NME6	48300430	48300634	0	205	19432	6219	19432	6014	0.0	3.231127369471234
chr3	NME6	48300526	48300634	0	109	19432	6219	19432	6110	0.0	3.1803600654664486
chr3	NME6	48296118	48296236	241	119	19432	6219	19191	6100	2.0252100840336134	3.1460655737704917
chr3	NME6	48300276	48300723	102	448	19432	6219	19330	5771	0.22767857142857142	3.3495061514468896
chr3	PLXNB1	48418916	48419039	0	124	93	9551	93	9427	0.0	0.009865280577065875
chr3	PLXNB1	48420223	48420257	0	35	93	9551	93	9516	0.0	0.009773013871374527
chr3	SHISA5	48476819	48477091	870	273	40429	4383	39559	4110	3.1868131868131866	9.625060827250609
chr3	SHISA5	48503094	48503193	113	100	40429	4383	40316	4283	1.13	9.413028251225777
chr3	SHISA5	48502320	48502452	2856	133	40429	4383	37573	4250	21.473684210526315	8.84070588235294
chr3	SHISA5	48502320	48502543	5104	224	40429	4383	35325	4159	22.785714285714285	8.493628276027891
chr3	PFKFB4	48525564	48525669	0	106	58304	6039	58304	5933	0.0	9.827068936457104
chr3	PFKFB4	48556085	48556233	3329	149	58304	6039	54975	5890	22.34228187919463	9.333616298811545
chr3	PFKFB4	48556085	48556222	3191	138	58304	6039	55113	5901	23.1231884057971	9.33960345704118
chr3	UQCRC1	48605769	48605856	0	88	5774	3165	5774	3077	0.0	1.8765030874228144
chr3	SLC26A6	48628621	48628714	0	94	15762	4986	15762	4892	0.0	3.221995094031071
chr3	SLC26A6	48632244	48632396	189	153	15762	4986	15573	4833	1.2352941176470589	3.2222222222222223
chr3	SLC26A6	48631879	48632092	1114	214	15762	4986	14648	4772	5.205607476635514	3.069572506286672
chr3	SLC26A6	48632244	48632337	90	94	15762	4986	15672	4892	0.9574468085106383	3.2035977105478333
chr3	NCKIPSD	48679376	48679457	4219	82	126445	3266	122226	3184	51.451219512195124	38.38756281407035
chr3	IP6K2	48693269	48693338	1699	70	116050	5121	114351	5051	24.271428571428572	22.63927935062364
chr3	IP6K2	48711366	48711459	17550	94	116050	5121	98500	5027	186.70212765957447	19.59419136662025
chr3	IP6K2	48708119	48708237	0	119	116050	5121	116050	5002	0.0	23.200719712115156
chr3	IP6K2	48715314	48715527	4106	214	116050	5121	111944	4907	19.186915887850468	22.81312410841655
chr3	IP6K2	48694458	48694525	683	68	116050	5121	115367	5053	10.044117647058824	22.83138729467643
chr3	IP6K2	48694693	48694824	5117	132	116050	5121	110933	4989	38.765151515151516	22.235518139907796
chr3	IP6K2	48715388	48715527	1147	140	116050	5121	114903	4981	8.192857142857143	23.068259385665527
chr3	IP6K2	48694701	48694824	4953	124	116050	5121	111097	4997	39.943548387096776	22.23273964378627
chr3	IP6K2	48716431	48716477	647	47	116050	5121	115403	5074	13.76595744680851	22.74398896334253
chr3	PRKAR2A	48752175	48752317	3	143	5391	2432	5388	2289	0.02097902097902098	2.3538663171690692
chr3	PRKAR2A	48756378	48756444	0	67	5391	2432	5391	2365	0.0	2.279492600422833
chr3	PRKAR2A	48807648	48807684	0	37	5391	2432	5391	2395	0.0	2.2509394572025054
chr3	SLC25A20	48895754	48895815	84	62	6673	1908	6589	1846	1.3548387096774193	3.5693391115926327
chr3	DALRD3	49016611	49016673	633	63	364607	2755	363974	2692	10.047619047619047	135.20579494799406
chr3	DALRD3	49018399	49018553	70	155	364607	2755	364537	2600	0.45161290322580644	140.20653846153846
chr3	IMPDH2	49028247	49028322	2971	76	53854	4064	50883	3988	39.0921052631579	12.759027081243731
chr3	IMPDH2	49025994	49026066	430	73	53854	4064	53424	3991	5.890410958904109	13.38611876722626
chr3	IMPDH2	49028198	49028322	3025	125	53854	4064	50829	3939	24.2	12.904036557501904
chr3	QRICH1	49092396	49092456	2	61	61691	3888	61689	3827	0.03278688524590164	16.119414685131957
chr3	QARS1	49097991	49098117	0	127	1937	3938	1937	3811	0.0	0.5082655471004985
chr3	QARS1	49098191	49098258	0	68	1937	3938	1937	3870	0.0	0.500516795865633
chr3	QARS1	49101354	49101441	0	88	1937	3938	1937	3850	0.0	0.5031168831168831
chr3	QARS1	49101619	49101705	0	87	1937	3938	1937	3851	0.0	0.5029862373409504
chr3	QARS1	49104323	49104471	51	149	1937	3938	1886	3789	0.3422818791946309	0.4977566640274479
chr3	QARS1	49097109	49097287	0	179	1937	3938	1937	3759	0.0	0.5152966214418728
chr3	QARS1	49097133	49097287	0	155	1937	3938	1937	3783	0.0	0.5120274914089347
chr3	QARS1	49104372	49104471	51	100	1937	3938	1886	3838	0.51	0.491401771756123
chr3	QARS1	49097991	49098092	0	102	1937	3938	1937	3836	0.0	0.5049530761209593
chr3	QARS1	49104356	49104471	51	116	1937	3938	1886	3822	0.4396551724137931	0.4934589220303506
chr3	QARS1	49098191	49098251	0	61	1937	3938	1937	3877	0.0	0.4996131029146247
chr3	QARS1	49104616	49104698	0	83	1937	3938	1937	3855	0.0	0.5024643320363165
chr3	QARS1	49104323	49104465	51	143	1937	3938	1886	3795	0.35664335664335667	0.49696969696969695
chr3	USP19	49117436	49117570	0	135	56009	5602	56009	5467	0.0	10.244924089994512
chr3	USP19	49117058	49117361	51	304	56009	5602	55958	5298	0.16776315789473684	10.562098905247263
chr3	USP4	49278813	49278902	0	90	26610	7226	26610	7136	0.0	3.728979820627803
chr3	USP4	49300466	49300691	0	226	26610	7226	26610	7000	0.0	3.8014285714285716
chr3	USP4	49311513	49311654	803	142	26610	7226	25807	7084	5.654929577464789	3.6429983060417843
chr3	USP4	49335468	49335596	325	129	26610	7226	26285	7097	2.5193798449612403	3.7036776102578552
chr3	RHOA	49368427	49368548	0	122	336553	4270	336553	4148	0.0	81.13621022179363
chr3	RHOA	49362495	49362626	0	132	336553	4270	336553	4138	0.0	81.33228612856452
chr3	RHOA	49360927	49361066	8042	140	336553	4270	328511	4130	57.44285714285714	79.54261501210654
chr3	RHOA	49406711	49406806	40	96	336553	4270	336513	4174	0.4166666666666667	80.62122664111165
chr3	AMT	49417817	49417973	0	157	2780	4678	2780	4521	0.0	0.614908206149082
chr3	AMT	49419259	49419405	154	147	2780	4678	2626	4531	1.0476190476190477	0.5795630103729861
chr3	AMT	49420210	49420342	255	133	2780	4678	2525	4545	1.9172932330827068	0.5555555555555556
chr3	AMT	49421491	49421572	1	82	2780	4678	2779	4596	0.012195121951219513	0.6046562228024369
chr3	NICN1	49425882	49425996	0	115	6730	2933	6730	2818	0.0	2.3882185947480483
chr3	AMT	49422103	49422271	0	169	2780	4678	2780	4509	0.0	0.6165446884009759
chr3	AMT	49422103	49422257	0	155	2780	4678	2780	4523	0.0	0.6146363033384922
chr3	AMT	49418970	49419151	0	182	2780	4678	2780	4496	0.0	0.6183274021352313
chr3	AMT	49420214	49420342	255	129	2780	4678	2525	4549	1.9767441860465116	0.5550670477027918
chr3	AMT	49421981	49422049	0	69	2780	4678	2780	4609	0.0	0.603167715339553
chr3	AMT	49419259	49419335	154	77	2780	4678	2626	4601	2.0	0.5707454901108455
chr3	AMT	49419259	49419393	154	135	2780	4678	2626	4543	1.1407407407407408	0.5780321373541712
chr3	AMT	49419709	49419788	0	80	2780	4678	2780	4598	0.0	0.6046107003044802
chr3	AMT	49417932	49417973	0	42	2780	4678	2780	4636	0.0	0.5996548748921484
chr3	AMT	49421959	49422049	0	91	2780	4678	2780	4587	0.0	0.6060606060606061
chr3	MST1	49687363	49687478	0	116	714	4051	714	3935	0.0	0.18144853875476494
chr3	MST1	49687749	49687897	0	149	714	4051	714	3902	0.0	0.18298308559712967
chr3	GMPPB	49722595	49722754	776	160	964203	6681	963427	6521	4.85	147.74221745131115
chr3	GMPPB	49722230	49722358	1133	129	964203	6681	963070	6552	8.782945736434108	146.98870573870573
chr3	IP6K1	49747817	49748168	102	352	10204	2590	10102	2238	0.2897727272727273	4.513851653261841
chr3	CDHR4	49791440	49791471	0	32	6194	3124	6194	3092	0.0	2.003234152652005
chr3	CDHR4	49792467	49792610	0	144	6194	3124	6194	2980	0.0	2.078523489932886
chr3	CDHR4	49791440	49791468	0	29	6194	3124	6194	3095	0.0	2.001292407108239
chr3	UBA7	49812647	49812738	834	92	5918	4028	5084	3936	9.065217391304348	1.2916666666666667
chr3	TRAIP	49844540	49844580	0	41	2329	3275	2329	3234	0.0	0.720160791589363
chr3	CAMKV	49859769	49859881	0	113	157	3414	157	3301	0.0	0.047561345046955465
chr3	MST1R	49895166	49895373	102	208	1469	5135	1367	4927	0.49038461538461536	0.27745078140856505
chr3	MST1R	49895960	49896107	34	148	1469	5135	1435	4987	0.22972972972972974	0.2877481451774614
chr3	MON1A	49911525	49912011	0	487	3378	6358	3378	5871	0.0	0.575370464997445
chr3	MON1A	49924533	49924673	1819	141	3378	6358	1559	6217	12.900709219858156	0.25076403410004827
chr3	IFRD2	50289446	50289628	12493	183	611703	3353	599210	3170	68.26775956284153	189.02523659305993
chr3	IFRD2	50290387	50290472	57363	86	611703	3353	554340	3267	667.0116279069767	169.67860422405877
chr3	HYAL3	50293631	50293721	247133	91	472550	1973	225417	1882	2715.747252747253	119.77523910733262
chr3	NAA80	50297806	50298083	243	278	346868	2186	346625	1908	0.8741007194244604	181.66928721174006
chr3	HYAL1	50300987	50301077	0	91	1662	3091	1662	3000	0.0	0.554
chr3	HYAL2	50321365	50321773	51	409	1148	3005	1097	2596	0.12469437652811736	0.4225731895223421
chr3	HYAL2	50321567	50321773	51	207	1148	3005	1097	2798	0.2463768115942029	0.39206576125804143
chr3	TUSC2	50327037	50327219	70724	183	777192	2409	706468	2226	386.46994535519127	317.37106918238993
chr3	TUSC2	50327027	50327219	80115	193	777192	2409	697077	2216	415.10362694300517	314.56543321299637
chr3	TUSC2	50327027	50327224	80140	198	777192	2409	697052	2211	404.74747474747477	315.26549072817727
chr3	RASSF1	50332049	50332154	610	106	70896	2894	70286	2788	5.754716981132075	25.210186513629843
chr3	RASSF1	50337904	50338023	4395	120	70896	2894	66501	2774	36.625	23.97296322999279
chr3	RASSF1	50337904	50338011	4089	108	70896	2894	66807	2786	37.861111111111114	23.97954055994257
chr3	ZMYND10	50342014	50342140	276	127	4584	2382	4308	2255	2.173228346456693	1.910421286031042
chr3	ZMYND10	50343306	50343444	532	139	4584	2382	4052	2243	3.827338129496403	1.806509139545252
chr3	NPRL2	50349664	50349833	2247	170	13677	2878	11430	2708	13.217647058823529	4.22082717872969
chr3	NPRL2	50349664	50349828	2138	165	13677	2878	11539	2713	12.957575757575757	4.253225211942499
chr3	CACNA2D2	50373064	50373085	292	22	329426	6548	329134	6526	13.272727272727273	50.43426294820717
chr3	C3ORF18	50565465	50565861	0	397	65	3252	65	2855	0.0	0.02276707530647986
chr3	C3ORF18	50566005	50566094	0	90	65	3252	65	3162	0.0	0.020556609740670462
chr3	C3ORF18	50565525	50565700	0	176	65	3252	65	3076	0.0	0.021131339401820545
chr3	C3ORF18	50562372	50562588	0	217	65	3252	65	3035	0.0	0.0214168039538715
chr3	CISH	50610372	50610529	260	158	14910	3280	14650	3122	1.6455696202531647	4.692504804612428
chr3	IQCF1	51902789	51902839	0	51	0	768	0	717	0.0	0.0
chr3	PCBP4	51959894	51960023	0	130	5471	3664	5471	3534	0.0	1.5481041312959818
chr3	PCBP4	51961940	51962088	0	149	5471	3664	5471	3515	0.0	1.5564722617354196
chr3	PCBP4	51962809	51962892	0	84	5471	3664	5471	3580	0.0	1.5282122905027933
chr3	PCBP4	51961748	51962088	0	341	5471	3664	5471	3323	0.0	1.6464038519410171
chr3	PCBP4	51961748	51961894	0	147	5471	3664	5471	3517	0.0	1.5555871481376173
chr3	ABHD14B	51971459	51971698	29124	240	305653	2831	276529	2591	121.35	106.72674642994983
chr3	ABHD14B	51971459	51971892	46628	434	305653	2831	259025	2397	107.43778801843318	108.06216103462661
chr3	ABHD14B	51971811	51971892	459	82	305653	2831	305194	2749	5.597560975609756	111.02000727537286
chr3	RPL29	51994772	51994857	849	86	170076	1436	169227	1350	9.872093023255815	125.35333333333334
chr3	POC1A	52096568	52096712	0	145	1884	2285	1884	2140	0.0	0.8803738317757009
chr3	TWF2	52229660	52229782	0	123	34412	3540	34412	3417	0.0	10.070822358794263
chr3	TWF2	52231943	52232122	14	180	34412	3540	34398	3360	0.07777777777777778	10.2375
chr3	TWF2	52231943	52232117	9	175	34412	3540	34403	3365	0.05142857142857143	10.223774145616641
chr3	TWF2	52231943	52232096	0	154	34412	3540	34412	3386	0.0	10.163024217365622
chr3	TWF2	52229340	52229542	0	203	34412	3540	34412	3337	0.0	10.312256517830386
chr3	BAP1	52407173	52407316	0	144	29616	4068	29616	3924	0.0	7.5474006116207955
chr3	BAP1	52408473	52408606	11979	134	29616	4068	17637	3934	89.3955223880597	4.483223182511439
chr3	SEMA3G	52443015	52443069	72	55	675439	5064	675367	5009	1.309090909090909	134.83070473148334
chr3	NT5DC2	52528445	52528539	0	95	178063	4574	178063	4479	0.0	39.75507925876312
chr3	NT5DC2	52528860	52528935	0	76	178063	4574	178063	4498	0.0	39.587149844375276
chr3	NT5DC2	52528511	52528539	0	29	178063	4574	178063	4545	0.0	39.17777777777778
chr3	PBRM1	52554723	52554879	0	157	271308	9463	271308	9306	0.0	29.154094132817537
chr3	PBRM1	52643247	52643343	835	97	271308	9463	270473	9366	8.608247422680412	28.878176382660687
chr3	PBRM1	52558248	52558413	700	166	271308	9463	270608	9297	4.216867469879518	29.10702377110896
chr3	PBRM1	52624896	52624941	267	46	271308	9463	271041	9417	5.804347826086956	28.782096208983752
chr3	PBRM1	52603520	52603732	0	213	271308	9463	271308	9250	0.0	29.330594594594594
chr3	PBRM1	52682091	52682233	10	143	271308	9463	271298	9320	0.06993006993006994	29.10922746781116
chr3	PBRM1	52681703	52681820	0	118	271308	9463	271308	9345	0.0	29.032423756019263
chr3	PBRM1	52684855	52684914	0	60	271308	9463	271308	9403	0.0	28.85334467723067
chr3	GLT8D1	52696233	52696318	8188	86	8821	3420	633	3334	95.20930232558139	0.1898620275944811
chr3	GLT8D1	52703798	52703928	0	131	8821	3420	8821	3289	0.0	2.681970203709334
chr3	GLT8D1	52704723	52704952	255	230	8821	3420	8566	3190	1.108695652173913	2.685266457680251
chr3	GLT8D1	52703086	52703255	77	170	8821	3420	8744	3250	0.45294117647058824	2.6904615384615385
chr3	NEK4	52749691	52749829	0	139	61510	6410	61510	6271	0.0	9.808642959655558
chr3	NEK4	52768337	52768604	51	268	61510	6410	61459	6142	0.19029850746268656	10.006349723217193
chr3	NEK4	52747329	52747451	0	123	61510	6410	61510	6287	0.0	9.783680610784158
chr3	NEK4	52768337	52768566	51	230	61510	6410	61459	6180	0.2217391304347826	9.944822006472492
chr3	ITIH4	52818051	52818168	0	118	204	4681	204	4563	0.0	0.044707429322813935
chr3	ITIH4	52829118	52829279	0	162	204	4681	204	4519	0.0	0.04514273069263111
chr3	AC006254.1	52831407	52831478	0	72	492	6358	492	6286	0.0	0.07826916958320077
chr3	STIMATE-MUSTN1	52834939	52835003	0	65	841	6283	841	6218	0.0	0.1352524927629463
chr3	STIMATE	52895877	52895955	115	79	2353	1951	2238	1872	1.4556962025316456	1.1955128205128205
chr3	SFMBT1	53043135	53043254	0	120	4675	5707	4675	5587	0.0	0.836763916234115
chr3	SFMBT1	53018085	53018228	0	144	4675	5707	4675	5563	0.0	0.840373898975373
chr3	RFT1	53119883	53120021	64	139	105687	5492	105623	5353	0.460431654676259	19.73155240052307
chr3	RFT1	53123723	53123840	2969	118	105687	5492	102718	5374	25.161016949152543	19.113881652400448
chr3	TKT	53228055	53228149	0	95	5756	8000	5756	7905	0.0	0.7281467425679949
chr3	TKT	53237796	53237820	0	25	5756	8000	5756	7975	0.0	0.721755485893417
chr3	TKT	53237796	53237921	0	126	5756	8000	5756	7874	0.0	0.7310134620269241
chr3	TKT	53243582	53243622	0	41	5756	8000	5756	7959	0.0	0.7232064329689659
chr3	DCP1A	53304176	53304290	0	115	11606	6113	11606	5998	0.0	1.9349783261087028
chr3	DCP1A	53338090	53338145	255	56	11606	6113	11351	6057	4.553571428571429	1.8740300478784877
chr3	ERC2	55683793	55683859	0	67	31232	8060	31232	7993	0.0	3.9074189916176656
chr3	ERC2	55985976	55985988	0	13	31232	8060	31232	8047	0.0	3.881197961973406
chr3	ERC2	55606779	55606966	0	188	31232	8060	31232	7872	0.0	3.967479674796748
chr3	ERC2	56003098	56003134	0	37	31232	8060	31232	8023	0.0	3.8928081764925837
chr3	TASOR	56624827	56625006	162	180	49831	9849	49669	9669	0.9	5.136932464577516
chr3	TASOR	56638705	56638765	0	61	49831	9849	49831	9788	0.0	5.091029832447895
chr3	TASOR	56662384	56662490	0	107	49831	9849	49831	9742	0.0	5.115068774378978
chr3	ARHGEF3	56751055	56751132	0	78	1120	6495	1120	6417	0.0	0.17453638772011842
chr3	ARHGEF3	57035087	57035176	0	90	1120	6495	1120	6405	0.0	0.17486338797814208
chr3	ARHGEF3	57007181	57007336	51	156	1120	6495	1069	6339	0.3269230769230769	0.1686385865278435
chr3	ARHGEF3	57076745	57076892	0	148	1120	6495	1120	6347	0.0	0.17646132030880732
chr3	ARHGEF3	56898549	56898638	0	90	1120	6495	1120	6405	0.0	0.17486338797814208
chr3	ARHGEF3	56975761	56975820	0	60	1120	6495	1120	6435	0.0	0.17404817404817405
chr3	IL17RD	57169231	57169394	0	164	2845	9578	2845	9414	0.0	0.3022094752496282
chr3	HESX1	57198390	57198492	0	103	0	1500	0	1397	0.0	0.0
chr3	HESX1	57211334	57211502	0	169	0	1500	0	1331	0.0	0.0
chr3	DNAH12	57301734	57301939	5351	206	73138	13352	67787	13146	25.975728155339805	5.156473452000609
chr3	DNAH12	57314493	57314631	304	139	73138	13352	72834	13213	2.1870503597122304	5.512298493907515
chr3	ARF4	57583897	57584007	0	111	5239	2603	5239	2492	0.0	2.102327447833066
chr3	ARF4	57584383	57584464	306	82	5239	2603	4933	2521	3.731707317073171	1.9567631892106307
chr3	ARF4	57583897	57584032	0	136	5239	2603	5239	2467	0.0	2.1236319416295095
chr3	DENND6A	57659117	57659180	0	64	12657	4973	12657	4909	0.0	2.578325524546751
chr3	DNASE1L3	58193342	58193439	0	98	0	3002	0	2904	0.0	0.0
chr3	DNASE1L3	58205470	58205560	0	91	0	3002	0	2911	0.0	0.0
chr3	PDHB	58433630	58433684	0	55	51	4248	51	4193	0.0	0.012163129024564751
chr3	ACOX2	58530465	58530638	0	174	693	3288	693	3114	0.0	0.22254335260115607
chr3	ACOX2	58510978	58511054	0	77	693	3288	693	3211	0.0	0.21582061663033322
chr3	FAM107A	58570325	58570423	0	99	0	5329	0	5230	0.0	0.0
chr3	FAM3D	58653673	58653781	0	109	0	1637	0	1528	0.0	0.0
chr3	CFAP20DC	58806394	58806456	0	63	7335	9238	7335	9175	0.0	0.7994550408719346
chr3	CFAP20DC	58734471	58734558	27	88	7335	9238	7308	9150	0.3068181818181818	0.7986885245901639
chr3	CFAP20DC	58737155	58737224	0	70	7335	9238	7335	9168	0.0	0.800065445026178
chr3	CFAP20DC	58913707	58913864	0	158	7335	9238	7335	9080	0.0	0.8078193832599119
chr3	CFAP20DC	58849031	58849409	254	379	7335	9238	7081	8859	0.6701846965699209	0.7993001467434248
chr3	CFAP20DC	58913697	58913864	0	168	7335	9238	7335	9070	0.0	0.8087100330760749
chr3	CFAP20DC	58794179	58794330	0	152	7335	9238	7335	9086	0.0	0.8072859344045785
chr3	CFAP20DC	58992507	58992615	0	109	7335	9238	7335	9129	0.0	0.8034834045349983
chr3	FHIT	60765523	60765563	0	41	0	5456	0	5415	0.0	0.0
chr3	PTPRG-AS1	62317105	62317192	0	88	40815	7308	40815	7220	0.0	5.653047091412742
chr3	PTPRG-AS1	62294699	62294778	0	80	40815	7308	40815	7228	0.0	5.646790260099612
chr3	PTPRG-AS1	62317807	62317903	0	97	40815	7308	40815	7211	0.0	5.660102620995701
chr3	PTPRG-AS1	62317807	62317900	0	94	40815	7308	40815	7214	0.0	5.657748821735514
chr3	PTPRG-AS1	62292613	62292717	0	105	40815	7308	40815	7203	0.0	5.666389004581425
chr3	PTPRG-AS1	62313893	62313970	0	78	40815	7308	40815	7230	0.0	5.645228215767635
chr3	CADPS	62445764	62445797	0	34	0	14019	0	13985	0.0	0.0
chr3	CADPS	62530653	62530812	0	160	0	14019	0	13859	0.0	0.0
chr3	CADPS	62467297	62467312	0	16	0	14019	0	14003	0.0	0.0
chr3	CADPS	62481722	62481869	0	148	0	14019	0	13871	0.0	0.0
chr3	CADPS	62493644	62493665	0	22	0	14019	0	13997	0.0	0.0
chr3	CADPS	62512750	62512768	0	19	0	14019	0	14000	0.0	0.0
chr3	CADPS	62513637	62513706	0	70	0	14019	0	13949	0.0	0.0
chr3	CADPS	62498145	62498154	0	10	0	14019	0	14009	0.0	0.0
chr3	CADPS	62544847	62544859	0	13	0	14019	0	14006	0.0	0.0
chr3	AC104162.1	63758245	63758478	0	234	618	3626	618	3392	0.0	0.1821933962264151
chr3	AC104162.1	63784730	63784854	0	125	618	3626	618	3501	0.0	0.17652099400171378
chr3	AC104162.1	63787107	63787213	0	107	618	3626	618	3519	0.0	0.17561807331628304
chr3	THOC7	63839655	63839773	0	119	2144	1759	2144	1640	0.0	1.3073170731707318
chr3	THOC7	63846103	63846217	0	115	2144	1759	2144	1644	0.0	1.3041362530413625
chr3	PSMD6	64013438	64013607	0	170	51	8946	51	8776	0.0	0.00581130355515041
chr3	PSMD6	64022642	64022801	0	160	51	8946	51	8786	0.0	0.00580468927839745
chr3	PSMD6	64022738	64022801	0	64	51	8946	51	8882	0.0	0.005741950011258726
chr3	ADAMTS9	64655791	64655875	0	85	183	10621	183	10536	0.0	0.017369020501138952
chr3	ADAMTS9	64521493	64521668	0	176	183	10621	183	10445	0.0	0.01752034466251795
chr3	MAGI1	65359063	65359152	0	90	726	11686	726	11596	0.0	0.0626077957916523
chr3	MAGI1	65375744	65375945	0	202	726	11686	726	11484	0.0	0.06321839080459771
chr3	MAGI1	65387142	65387226	26	85	726	11686	700	11601	0.3058823529411765	0.06033962589431945
chr3	MAGI1	65448021	65448057	0	37	726	11686	726	11649	0.0	0.06232294617563739
chr3	MAGI1	65375744	65375948	0	205	726	11686	726	11481	0.0	0.06323490985105827
chr3	LRIG1	66401608	66401680	0	73	2842	7069	2842	6996	0.0	0.40623213264722696
chr3	UBA3	69075429	69075510	266	82	54769	4125	54503	4043	3.2439024390243905	13.48083106604007
chr3	UBA3	69080111	69080153	0	43	54769	4125	54769	4082	0.0	13.4171974522293
chr3	FRMD4B	69249225	69249248	0	24	102	11238	102	11214	0.0	0.00909577314071696
chr3	FOXP1	70972554	70972676	0	123	30918	26565	30918	26442	0.0	1.1692761515770365
chr3	FOXP1	71000971	71001059	0	89	30918	26565	30918	26476	0.0	1.1677745883063908
chr3	FOXP1	71198201	71198392	0	192	30918	26565	30918	26373	0.0	1.1723353429643955
chr3	FOXP1	71359149	71359244	0	96	30918	26565	30918	26469	0.0	1.1680834183384337
chr3	FOXP1	71493425	71493555	0	131	30918	26565	30918	26434	0.0	1.169630021941439
chr3	FOXP1	71581548	71581697	0	150	30918	26565	30918	26415	0.0	1.1704713231118682
chr3	FOXP1	70972010	70972180	0	171	30918	26565	30918	26394	0.0	1.1714025914980677
chr3	FOXP1	71296432	71296445	0	14	30918	26565	30918	26551	0.0	1.1644759142781815
chr3	FOXP1	70970735	70970805	0	71	30918	26565	30918	26494	0.0	1.1669812032913112
chr3	FOXP1	71335159	71335281	0	123	30918	26565	30918	26442	0.0	1.1692761515770365
chr3	EIF4E3	71699613	71699708	0	96	1887	10820	1887	10724	0.0	0.1759604625139873
chr3	FOXP1	71335159	71335277	0	119	30918	26565	30918	26446	0.0	1.1690992966800273
chr3	FOXP1	71130497	71130584	0	88	30918	26565	30918	26477	0.0	1.1677304830607698
chr3	FOXP1	71467250	71467315	0	66	30918	26565	30918	26499	0.0	1.1667610098494283
chr3	EIF4E3	71696459	71696520	0	62	1887	10820	1887	10758	0.0	0.175404350250976
chr3	EIF4E3	71693874	71693941	0	68	1887	10820	1887	10752	0.0	0.17550223214285715
chr3	PROK2	71774444	71774507	21	64	21	1617	0	1553	0.328125	0.0
chr3	LINC00877	72060509	72060611	0	103	0	8637	0	8534	0.0	0.0
chr3	LINC00877	72234147	72234244	0	98	0	8637	0	8539	0.0	0.0
chr3	SHQ1	72844358	72844423	50	66	9091	5849	9041	5783	0.7575757575757576	1.563375410686495
chr3	SHQ1	72844358	72844453	50	96	9091	5849	9041	5753	0.5208333333333334	1.5715278984877454
chr3	OR7E22P	75361951	75362039	0	89	0	1280	0	1191	0.0	0.0
chr3	FAM86DP	75429135	75429237	0	103	0	3442	0	3339	0.0	0.0
chr3	ZNF717	75783305	75783364	0	60	20578	7528	20578	7468	0.0	2.7554900910551687
chr3	ZNF717	75784914	75785002	0	89	20578	7528	20578	7439	0.0	2.766232020432854
chr3	ROBO1	78647628	78647655	466	28	15378	11098	14912	11070	16.642857142857142	1.3470641373080396
chr3	ROBO1	78693347	78693356	0	10	15378	11098	15378	11088	0.0	1.3869047619047619
chr3	LINC00971	84863705	84864005	0	301	5	8753	5	8452	0.0	0.0005915759583530525
chr3	LINC00971	84868902	84869024	0	123	5	8753	5	8630	0.0	0.0005793742757821553
chr3	LINC00971	84868781	84868843	0	63	5	8753	5	8690	0.0	0.0005753739930955121
chr3	POU1F1	87264287	87264512	0	226	12175	1572	12175	1346	0.0	9.045319465081723
chr3	CGGBP1	88057190	88057292	0	103	51	5365	51	5262	0.0	0.009692132269099202
chr3	CGGBP1	88058018	88058223	0	206	51	5365	51	5159	0.0	0.009885636751308394
chr3	PROS1	93876965	93877191	0	227	181	5212	181	4985	0.0	0.036308926780341026
chr3	PROS1	93928701	93928797	0	97	181	5212	181	5115	0.0	0.035386119257087
chr3	PROS1	93881130	93881318	0	189	181	5212	181	5023	0.0	0.036034242484570975
chr3	PROS1	93923774	93923894	0	121	181	5212	181	5091	0.0	0.03555293655470438
chr3	RIOX2	97952151	97952252	0	102	0	6599	0	6497	0.0	0.0
chr3	CLDND1	98521652	98521718	180	67	1035661	4629	1035481	4562	2.6865671641791047	226.97961420429635
chr3	CLDND1	98521652	98521703	180	52	1035661	4629	1035481	4577	3.4615384615384617	226.23574393707668
chr3	CLDND1	98521132	98521442	1236	311	1035661	4629	1034425	4318	3.9742765273311895	239.5611394163965
chr3	CLDND1	98521652	98521696	180	45	1035661	4629	1035481	4584	4.0	225.8902705061082
chr3	CLDND1	98516799	98516879	97124	81	1035661	4629	938537	4548	1199.0617283950617	206.36257695690412
chr3	CLDND1	98521329	98521442	668	114	1035661	4629	1034993	4515	5.859649122807017	229.2343300110742
chr3	CLDND1	98521132	98521437	1171	306	1035661	4629	1034490	4323	3.826797385620915	239.29909784871617
chr3	ST3GAL6-AS1	98715649	98715777	0	129	408	9394	408	9265	0.0	0.044036697247706424
chr3	ST3GAL6-AS1	98718418	98718521	0	104	408	9394	408	9290	0.0	0.04391819160387513
chr3	ST3GAL6-AS1	98714407	98714498	39	92	408	9394	369	9302	0.42391304347826086	0.03966888841109439
chr3	ST3GAL6-AS1	98718423	98718521	0	99	408	9394	408	9295	0.0	0.04389456697149005
chr3	ST3GAL6-AS1	98715375	98715521	0	147	408	9394	408	9247	0.0	0.04412241808153996
chr3	DCBLD2	98890391	98890456	0	66	0	11299	0	11233	0.0	0.0
chr3	FILIP1L	99874287	99874486	0	200	8304	5543	8304	5343	0.0	1.5541830432341381
chr3	ABI3BP	100787727	100787802	0	76	3080	9536	3080	9460	0.0	0.32558139534883723
chr3	ABI3BP	100792690	100792768	0	79	3080	9536	3080	9457	0.0	0.32568467801628426
chr3	ABI3BP	100795803	100795851	128	49	3080	9536	2952	9487	2.6122448979591835	0.31116264361758195
chr3	ABI3BP	100828392	100828452	0	61	3080	9536	3080	9475	0.0	0.325065963060686
chr3	ABI3BP	100829580	100829664	0	85	3080	9536	3080	9451	0.0	0.32589144005925297
chr3	ABI3BP	100830577	100830634	0	58	3080	9536	3080	9478	0.0	0.3249630723781389
chr3	ABI3BP	100838209	100838284	0	76	3080	9536	3080	9460	0.0	0.32558139534883723
chr3	ABI3BP	100840071	100840164	0	94	3080	9536	3080	9442	0.0	0.32620207583139166
chr3	ABI3BP	100851874	100851940	0	67	3080	9536	3080	9469	0.0	0.3252719400147851
chr3	ABI3BP	100862837	100862909	0	73	3080	9536	3080	9463	0.0	0.3254781781676001
chr3	ABI3BP	100864001	100864076	0	76	3080	9536	3080	9460	0.0	0.32558139534883723
chr3	ABI3BP	100926301	100926481	0	181	3080	9536	3080	9355	0.0	0.32923570283270975
chr3	ABI3BP	100796408	100796468	0	61	3080	9536	3080	9475	0.0	0.325065963060686
chr3	ABI3BP	100837123	100837171	0	49	3080	9536	3080	9487	0.0	0.3246547907663118
chr3	ABI3BP	100821053	100821113	0	61	3080	9536	3080	9475	0.0	0.325065963060686
chr3	ABI3BP	100838401	100838464	0	64	3080	9536	3080	9472	0.0	0.3251689189189189
chr3	ABI3BP	100835600	100835660	0	61	3080	9536	3080	9475	0.0	0.325065963060686
chr3	ABI3BP	100945579	100945676	0	98	3080	9536	3080	9438	0.0	0.32634032634032634
chr3	SENP7	101398860	101399055	0	196	2477	6421	2477	6225	0.0	0.39791164658634537
chr3	SENP7	101417592	101417790	1090	199	2477	6421	1387	6222	5.477386934673367	0.22291867566698811
chr3	SENP7	101501069	101501119	831	51	2477	6421	1646	6370	16.294117647058822	0.2583987441130298
chr3	RPL24	101682428	101682492	0	65	0	1683	0	1618	0.0	0.0
chr3	CBLB	105681478	105681610	0	133	510	10339	510	10206	0.0	0.04997060552616108
chr3	CBLB	105724025	105724189	0	165	510	10339	510	10174	0.0	0.050127776685669354
chr3	CBLB	105749621	105749765	0	145	510	10339	510	10194	0.0	0.050029429075927015
chr3	CBLB	105671020	105671046	0	27	510	10339	510	10312	0.0	0.049456943366951125
chr3	CBLB	105671023	105671046	0	24	510	10339	510	10315	0.0	0.04944255937954435
chr3	CBLB	105839422	105839470	0	49	510	10339	510	10290	0.0	0.04956268221574344
chr3	CBLB	105681292	105681610	26	319	510	10339	484	10020	0.08150470219435736	0.048303393213572854
chr3	CBLB	105672336	105672462	0	127	510	10339	510	10212	0.0	0.0499412455934195
chr3	LINC00882	107040074	107040116	0	43	4552	18708	4552	18665	0.0	0.24387891776051432
chr3	LINC00882	107129887	107129992	0	106	4552	18708	4552	18602	0.0	0.24470487044403827
chr3	LINC00882	107049796	107049902	0	107	4552	18708	4552	18601	0.0	0.24471802591258535
chr3	LINC00882	107057669	107057932	48	264	4552	18708	4504	18444	0.18181818181818182	0.24419865538928648
chr3	LINC00882	106843178	106843256	0	79	4552	18708	4552	18629	0.0	0.24435020666702453
chr3	LINC00882	106913041	106913166	0	126	4552	18708	4552	18582	0.0	0.2449682488429663
chr3	LINC00882	106909800	106909864	0	65	4552	18708	4552	18643	0.0	0.24416671136619642
chr3	LINC00882	106913024	106913166	0	143	4552	18708	4552	18565	0.0	0.2451925666576892
chr3	LINC00882	106913041	106913169	0	129	4552	18708	4552	18579	0.0	0.2450078045104688
chr3	LINC00882	106878989	106879072	0	84	4552	18708	4552	18624	0.0	0.24441580756013745
chr3	LINC00882	106925927	106926375	0	449	4552	18708	4552	18259	0.0	0.24930171422312283
chr3	LINC00882	107007065	107007164	0	100	4552	18708	4552	18608	0.0	0.24462596732588135
chr3	LINC00882	107112059	107112146	0	88	4552	18708	4552	18620	0.0	0.24446831364124597
chr3	LINC00882	107129192	107129317	0	126	4552	18708	4552	18582	0.0	0.2449682488429663
chr3	LINC00882	107110591	107110653	0	63	4552	18708	4552	18645	0.0	0.24414052024671493
chr3	LINC00882	107114752	107114843	0	92	4552	18708	4552	18616	0.0	0.2445208422862054
chr3	LINC00882	107139443	107139637	0	195	4552	18708	4552	18513	0.0	0.24588127261924053
chr3	LINC00882	107220726	107220895	0	170	4552	18708	4552	18538	0.0	0.24554968173481498
chr3	LINC00882	107129887	107129989	0	103	4552	18708	4552	18605	0.0	0.24466541252351517
chr3	LINC00882	107135625	107135712	0	88	4552	18708	4552	18620	0.0	0.24446831364124597
chr3	LINC00882	107171266	107171331	0	66	4552	18708	4552	18642	0.0	0.24417980903336553
chr3	LINC00882	107202913	107202981	0	69	4552	18708	4552	18639	0.0	0.24421911046729974
chr3	AC063944.1	107299901	107300152	0	252	296	3050	296	2798	0.0	0.10578984989278056
chr3	AC063944.1	107320329	107320422	0	94	296	3050	296	2956	0.0	0.10013531799729364
chr3	AC063944.1	107324307	107324502	0	196	296	3050	296	2854	0.0	0.10371408549404344
chr3	LINC00635	107841895	107842019	0	125	738	7071	738	6946	0.0	0.1062482004031097
chr3	LINC00635	107849822	107849971	0	150	738	7071	738	6921	0.0	0.10663198959687907
chr3	LINC00635	107876129	107876186	0	58	738	7071	738	7013	0.0	0.105233138457151
chr3	LINC00635	107848905	107849118	0	214	738	7071	738	6857	0.0	0.10762724223421322
chr3	LINC00635	107867310	107867425	0	116	738	7071	738	6955	0.0	0.10611071171818835
chr3	LINC00635	107872967	107873026	0	60	738	7071	738	7011	0.0	0.10526315789473684
chr3	LINC00635	107853872	107854054	0	183	738	7071	738	6888	0.0	0.10714285714285714
chr3	LINC00635	107850296	107850351	126	56	738	7071	612	7015	2.25	0.08724162508909479
chr3	LINC00635	107855129	107855229	0	101	738	7071	738	6970	0.0	0.10588235294117647
chr3	LINC00635	107854653	107854694	0	42	738	7071	738	7029	0.0	0.10499359795134443
chr3	LINC00635	107855312	107855384	0	73	738	7071	738	6998	0.0	0.1054587024864247
chr3	LINC00635	107853872	107853959	0	88	738	7071	738	6983	0.0	0.10568523557210369
chr3	LINC00635	107876434	107876531	0	98	738	7071	738	6973	0.0	0.1058367990821741
chr3	LINC00635	107877312	107877497	0	186	738	7071	738	6885	0.0	0.10718954248366012
chr3	LINC00635	107866231	107866505	0	275	738	7071	738	6796	0.0	0.10859329017068864
chr3	LINC00635	107876454	107876531	0	78	738	7071	738	6993	0.0	0.10553410553410554
chr3	LINC00635	107867310	107867577	0	268	738	7071	738	6803	0.0	0.10848155225635749
chr3	LINC00635	107849033	107849118	0	86	738	7071	738	6985	0.0	0.10565497494631353
chr3	LINC00635	107855312	107855425	0	114	738	7071	738	6957	0.0	0.10608020698576973
chr3	LINC00635	107853872	107855229	0	1358	738	7071	738	5713	0.0	0.12917906528969017
chr3	LINC00635	107877901	107878077	0	177	738	7071	738	6894	0.0	0.10704960835509138
chr3	LINC00635	107872325	107872480	0	156	738	7071	738	6915	0.0	0.10672451193058569
chr3	LINC00635	107875458	107875574	0	117	738	7071	738	6954	0.0	0.10612597066436583
chr3	LINC00635	107859130	107859261	0	132	738	7071	738	6939	0.0	0.10635538261997406
chr3	LINC00635	107856007	107856324	0	318	738	7071	738	6753	0.0	0.10928476232785429
chr3	LINC00635	107866651	107866753	0	103	738	7071	738	6968	0.0	0.10591274397244546
chr3	CD47	108049618	108049651	0	34	102	8247	102	8213	0.0	0.01241933520029222
chr3	CD47	108055519	108055566	0	48	102	8247	102	8199	0.0	0.012440541529454811
chr3	CD47	108050577	108050602	0	26	102	8247	102	8221	0.0	0.012407249726310668
chr3	IFT57	108219409	108219572	0	164	802	3544	802	3380	0.0	0.23727810650887574
chr3	CIP2A	108585665	108585749	0	85	0	4607	0	4522	0.0	0.0
chr3	MORC1	109007028	109007091	0	64	14	3775	14	3711	0.0	0.00377256804095931
chr3	NECTIN3-AS1	111052503	111052659	0	157	644	3269	644	3112	0.0	0.2069408740359897
chr3	GCSAM	112125225	112125254	0	30	0	3757	0	3727	0.0	0.0
chr3	GCSAM	112128016	112128061	0	46	0	3757	0	3711	0.0	0.0
chr3	GCSAM	112128016	112128228	0	213	0	3757	0	3544	0.0	0.0
chr3	GCSAM	112132636	112132910	0	275	0	3757	0	3482	0.0	0.0
chr3	SLC9C1	112264199	112264343	170	145	69069	4237	68899	4092	1.1724137931034482	16.837487781036167
chr3	SLC9C1	112269915	112270077	2298	163	69069	4237	66771	4074	14.098159509202453	16.389543446244478
chr3	SLC9C1	112286703	112286878	1173	176	69069	4237	67896	4061	6.6647727272727275	16.719034720512187
chr3	BTLA	112471211	112471355	0	145	0	3616	0	3471	0.0	0.0
chr3	CCDC80	112607175	112607256	0	82	51	12973	51	12891	0.0	0.0039562485454968585
chr3	CD200R1L	112837941	112838010	0	70	0	1720	0	1650	0.0	0.0
chr3	CD200R1L	112841246	112841344	0	99	0	1720	0	1621	0.0	0.0
chr3	CD200R1	112947855	112947924	0	70	385	3897	385	3827	0.0	0.10060099294486544
chr3	CD200R1	112931105	112931171	0	67	385	3897	385	3830	0.0	0.10052219321148825
chr3	NEPRO	113010642	113010704	0	63	7232	6041	7232	5978	0.0	1.2097691535630646
chr3	NEPRO	113017447	113017602	0	156	7232	6041	7232	5885	0.0	1.2288870008496178
chr3	NEPRO	113013948	113014032	0	85	7232	6041	7232	5956	0.0	1.214237743451981
chr3	CFAP44	113344515	113344712	306	198	8321	12198	8015	12000	1.5454545454545454	0.6679166666666667
chr3	CFAP44	113373410	113373556	241	147	8321	12198	8080	12051	1.6394557823129252	0.6704837772798938
chr3	CFAP44	113401583	113401739	0	157	8321	12198	8321	12041	0.0	0.6910555601694212
chr3	CFAP44	113409105	113409322	0	218	8321	12198	8321	11980	0.0	0.6945742904841402
chr3	CFAP44	113427186	113427339	51	154	8321	12198	8270	12044	0.33116883116883117	0.6866489538359349
chr3	CFAP44	113293951	113294038	0	88	8321	12198	8321	12110	0.0	0.6871180842279108
chr3	CFAP44	113366038	113366309	0	272	8321	12198	8321	11926	0.0	0.6977192688244173
chr3	NAA50	113723421	113723541	0	121	390	1410	390	1289	0.0	0.30256012412723043
chr3	CCDC191	114053596	114053635	0	40	0	5304	0	5264	0.0	0.0
chr3	CCDC191	114036985	114037094	0	110	0	5304	0	5194	0.0	0.0
chr3	CCDC191	114046590	114046732	0	143	0	5304	0	5161	0.0	0.0
chr3	CCDC191	114039384	114039488	0	105	0	5304	0	5199	0.0	0.0
chr3	DRD3	114175925	114176193	0	269	0	3182	0	2913	0.0	0.0
chr3	ZBTB20	114350273	114351878	0	1606	102	32044	102	30438	0.0	0.0033510743150009857
chr3	ZBTB20	114380776	114380940	51	165	102	32044	51	31879	0.3090909090909091	0.0015997992408795759
chr3	ZBTB20	114693527	114693575	0	49	102	32044	102	31995	0.0	0.0031879981247069857
chr3	ZBTB20	115071218	115071414	0	197	102	32044	102	31847	0.0	0.0032028134518164975
chr3	ZBTB20	114710267	114710313	0	47	102	32044	102	31997	0.0	0.0031877988561427634
chr3	ZBTB20	114713975	114714015	0	41	102	32044	102	32003	0.0	0.0031872011998875104
chr3	LINC02024	117680938	117680972	0	35	0	1048	0	1013	0.0	0.0
chr3	LINC02024	117688346	117688901	0	556	0	1048	0	492	0.0	0.0
chr3	LINC02024	117688718	117688901	0	184	0	1048	0	864	0.0	0.0
chr3	AC068633.1	118648066	118648172	0	107	0	2255	0	2148	0.0	0.0
chr3	IGSF11	119112649	119112778	0	130	1823	4915	1823	4785	0.0	0.38098223615464993
chr3	IGSF11	118949228	118949318	0	91	1823	4915	1823	4824	0.0	0.37790215588723053
chr3	IGSF11	119112673	119112778	0	106	1823	4915	1823	4809	0.0	0.37908088999792056
chr3	B4GALT4	119229846	119230244	1837	399	200397	6991	198560	6592	4.6040100250626566	30.12135922330097
chr3	B4GALT4	119235144	119235227	133	84	200397	6991	200264	6907	1.5833333333333333	28.994353554365137
chr3	B4GALT4	119236852	119237070	0	219	200397	6991	200397	6772	0.0	29.591996455995275
chr3	B4GALT4	119240360	119240530	0	171	200397	6991	200397	6820	0.0	29.383724340175952
chr3	B4GALT4	119236152	119236251	12709	100	200397	6991	187688	6891	127.09	27.23668553185314
chr3	TMEM39A	119435754	119435935	0	182	5846	5677	5846	5495	0.0	1.0638762511373976
chr3	TMEM39A	119451208	119451317	204	110	5846	5677	5642	5567	1.8545454545454545	1.0134722471708282
chr3	TMEM39A	119458017	119458240	153	224	5846	5677	5693	5453	0.6830357142857143	1.04401247019989
chr3	CD80	119529841	119529937	51	97	32962	3220	32911	3123	0.5257731958762887	10.538264489273136
chr3	POPDC2	119654504	119654613	0	110	255	1450	255	1340	0.0	0.19029850746268656
chr3	POPDC2	119643366	119643449	0	84	255	1450	255	1366	0.0	0.18667642752562225
chr3	COX17	119674672	119674788	0	117	154	1920	154	1803	0.0	0.08541320022185246
chr3	COX17	119676861	119676966	0	106	154	1920	154	1814	0.0	0.08489525909592062
chr3	GSK3B	119843254	119843353	0	100	6764	16821	6764	16721	0.0	0.4045212606901501
chr3	GSK3B	119863418	119863605	0	188	6764	16821	6764	16633	0.0	0.40666145614140564
chr3	GSK3B	119876412	119876508	0	97	6764	16821	6764	16724	0.0	0.4044486964840947
chr3	GSK3B	119905754	119905852	0	99	6764	16821	6764	16722	0.0	0.40449706972850136
chr3	GSK3B	119912703	119912810	0	108	6764	16821	6764	16713	0.0	0.40471489259857596
chr3	GSK3B	119923372	119923483	0	112	6764	16821	6764	16709	0.0	0.4048117780836675
chr3	GSK3B	119947267	119947351	0	85	6764	16821	6764	16736	0.0	0.40415869980879543
chr3	GSK3B	120002045	120002239	0	195	6764	16821	6764	16626	0.0	0.40683267171899434
chr3	GSK3B	119866589	119866628	0	40	6764	16821	6764	16781	0.0	0.40307490614385316
chr3	GSK3B	119831101	119831251	0	151	6764	16821	6764	16670	0.0	0.4057588482303539
chr3	GSK3B	119840796	119840862	0	67	6764	16821	6764	16754	0.0	0.4037244837053838
chr3	GSK3B	119840796	119840935	0	140	6764	16821	6764	16681	0.0	0.40549127750134883
chr3	GSK3B	119847354	119847452	0	99	6764	16821	6764	16722	0.0	0.40449706972850136
chr3	GSK3B	119875079	119875185	0	107	6764	16821	6764	16714	0.0	0.4046906784731363
chr3	GSK3B	119900557	119900613	0	57	6764	16821	6764	16764	0.0	0.40348365545215936
chr3	GSK3B	119880244	119880498	714	255	6764	16821	6050	16566	2.8	0.3652058432934927
chr3	GSK3B	119881160	119881270	0	111	6764	16821	6764	16710	0.0	0.404787552363854
chr3	GSK3B	119880244	119880510	714	267	6764	16821	6050	16554	2.6741573033707864	0.3654705811284282
chr3	GSK3B	119882636	119882834	780	199	6764	16821	5984	16622	3.919597989949749	0.36000481289856817
chr3	GSK3B	119912703	119912800	0	98	6764	16821	6764	16723	0.0	0.40447288165998924
chr3	GSK3B	119906791	119906916	204	126	6764	16821	6560	16695	1.619047619047619	0.39293201557352503
chr3	GSK3B	119976484	119976545	0	62	6764	16821	6764	16759	0.0	0.4036040336535593
chr3	GSK3B	119981956	119982125	0	170	6764	16821	6764	16651	0.0	0.4062218485376254
chr3	GSK3B	120000551	120000723	0	173	6764	16821	6764	16648	0.0	0.4062950504565113
chr3	GSK3B	120021578	120021626	0	49	6764	16821	6764	16772	0.0	0.40329119961841164
chr3	FSTL1	120415922	120416027	0	106	1581	4552	1581	4446	0.0	0.35560053981106615
chr3	HGD	120638454	120638581	0	128	49	2676	49	2548	0.0	0.019230769230769232
chr3	HGD	120674900	120674989	0	90	49	2676	49	2586	0.0	0.01894818252126837
chr3	RABL3	120694152	120694224	0	73	0	6437	0	6364	0.0	0.0
chr3	RABL3	120698422	120698573	0	152	0	6437	0	6285	0.0	0.0
chr3	RABL3	120709779	120709909	0	131	0	6437	0	6306	0.0	0.0
chr3	RABL3	120698422	120698520	0	99	0	6437	0	6338	0.0	0.0
chr3	AC072026.2	120888073	120888245	0	173	5	4443	5	4270	0.0	0.00117096018735363
chr3	POLQ	121460049	121460234	0	186	96849	9414	96849	9228	0.0	10.495123537061119
chr3	HCLS1	121637145	121637256	0	112	2474	5108	2474	4996	0.0	0.4951961569255404
chr3	HCLS1	121642926	121642981	0	56	2474	5108	2474	5052	0.0	0.4897070467141726
chr3	GOLGB1	121719645	121719753	0	109	51	11889	51	11780	0.0	0.00432937181663837
chr3	GOLGB1	121719645	121719768	0	124	51	11889	51	11765	0.0	0.004334891627709307
chr3	GOLGB1	121722261	121722378	0	118	51	11889	51	11771	0.0	0.00433268201512191
chr3	GOLGB1	121668313	121668508	51	196	51	11889	0	11693	0.2602040816326531	0.0
chr3	IQCB1	121795456	121795566	0	111	17	3066	17	2955	0.0	0.005752961082910322
chr3	IQCB1	121808915	121809009	0	95	17	3066	17	2971	0.0	0.00572197913160552
chr3	IQCB1	121828469	121828632	0	164	17	3066	17	2902	0.0	0.00585802894555479
chr3	ILDR1	121994181	121994313	0	133	0	3003	0	2870	0.0	0.0
chr3	KPNA1	122453869	122454001	0	133	42970	8433	42970	8300	0.0	5.17710843373494
chr3	KPNA1	122457725	122457848	0	124	42970	8433	42970	8309	0.0	5.17150078228427
chr3	SEMA5B	122961139	122961301	342	163	6618	8546	6276	8383	2.098159509202454	0.7486579983299535
chr3	SEMA5B	123027097	123027233	0	137	6618	8546	6618	8409	0.0	0.7870139136639315
chr3	ADCY5	123296979	123297054	0	76	13932	8233	13932	8157	0.0	1.7079808753218095
chr3	ADCY5	123367904	123368046	2843	143	13932	8233	11089	8090	19.88111888111888	1.3707045735475896
chr3	MYLK	123647223	123647427	0	205	5247	18744	5247	18539	0.0	0.28302497437833757
chr3	MYLK	123732895	123733102	0	208	5247	18744	5247	18536	0.0	0.2830707811825637
chr3	MYLK	123752330	123752538	0	209	5247	18744	5247	18535	0.0	0.2830860534124629
chr3	MYLK	123835867	123835935	0	69	5247	18744	5247	18675	0.0	0.2809638554216867
chr3	MYLK	123629473	123629626	75	154	5247	18744	5172	18590	0.487012987012987	0.27821409359870897
chr3	CCDC14	123955842	123955965	0	124	0	7677	0	7553	0.0	0.0
chr3	CCDC14	123956739	123956795	0	57	0	7677	0	7620	0.0	0.0
chr3	CCDC14	123955842	123956795	0	954	0	7677	0	6723	0.0	0.0
chr3	ROPN1	123981378	123981424	0	47	0	4526	0	4479	0.0	0.0
chr3	ROPN1	123991180	123991293	0	114	0	4526	0	4412	0.0	0.0
chr3	ITGB5	124809021	124809156	0	136	692	6538	692	6402	0.0	0.10809122149328335
chr3	ITGB5	124817620	124817710	0	91	692	6538	692	6447	0.0	0.10733674577322785
chr3	ITGB5	124857231	124857313	0	83	692	6538	692	6455	0.0	0.10720371804802478
chr3	HEG1	125014712	125015012	0	301	3200	9984	3200	9683	0.0	0.3304760921202107
chr3	HEG1	124971042	124971148	0	107	3200	9984	3200	9877	0.0	0.3239850156930242
chr3	SLC12A8	125177742	125177974	51	233	4248	5608	4197	5375	0.21888412017167383	0.7808372093023256
chr3	SLC12A8	125119865	125119891	0	27	4248	5608	4248	5581	0.0	0.761153915068984
chr3	SLC12A8	125177742	125177964	51	223	4248	5608	4197	5385	0.22869955156950672	0.7793871866295264
chr3	ZNF148	125331157	125331238	0	82	6477	3608	6477	3526	0.0	1.8369256948383437
chr3	ZNF148	125314936	125315053	27	118	6477	3608	6450	3490	0.2288135593220339	1.848137535816619
chr3	ZNF148	125338821	125338911	0	91	6477	3608	6477	3517	0.0	1.8416263861245379
chr3	SNX4	125489407	125489463	0	57	0	2723	0	2666	0.0	0.0
chr3	SNX4	125504622	125504744	0	123	0	2723	0	2600	0.0	0.0
chr3	SNX4	125480246	125480319	0	74	0	2723	0	2649	0.0	0.0
chr3	LINC02614	125870710	125870817	0	108	51	6139	51	6031	0.0	0.008456309069806002
chr3	LINC02614	125872072	125872253	0	182	51	6139	51	5957	0.0	0.008561356387443344
chr3	LINC02614	125875073	125875166	0	94	51	6139	51	6045	0.0	0.008436724565756825
chr3	LINC02614	125848229	125848447	0	219	51	6139	51	5920	0.0	0.008614864864864865
chr3	LINC02614	125861703	125861821	0	119	51	6139	51	6020	0.0	0.008471760797342192
chr3	LINC02614	125887161	125887226	0	66	51	6139	51	6073	0.0	0.008397826444920138
chr3	LINC02614	125887719	125887914	0	196	51	6139	51	5943	0.0	0.008581524482584554
chr3	LINC02614	125908781	125908874	0	94	51	6139	51	6045	0.0	0.008436724565756825
chr3	LINC02614	125915219	125915475	0	257	51	6139	51	5882	0.0	0.008670520231213872
chr3	SLC41A3	126050942	126051050	0	109	414	5485	414	5376	0.0	0.07700892857142858
chr3	SLC41A3	126033606	126033678	0	73	414	5485	414	5412	0.0	0.07649667405764966
chr3	SLC41A3	126050897	126051050	0	154	414	5485	414	5331	0.0	0.07765897580191333
chr3	SLC41A3	126056357	126056513	0	157	414	5485	414	5328	0.0	0.0777027027027027
chr3	SLC41A3	126073152	126073269	414	118	414	5485	0	5367	3.5084745762711864	0.0
chr3	SLC41A3	126067946	126068246	0	301	414	5485	414	5184	0.0	0.0798611111111111
chr3	SLC41A3	126067485	126067586	0	102	414	5485	414	5383	0.0	0.07690878692179082
chr3	ALDH1L1	126114556	126114656	0	101	141123	13574	141123	13473	0.0	10.474504564684926
chr3	ALDH1L1	126158404	126158639	8860	236	141123	13574	132263	13338	37.54237288135593	9.916254310991153
chr3	ALDH1L1	126131383	126131534	0	152	141123	13574	141123	13422	0.0	10.51430487259723
chr3	ALDH1L1	126159382	126159566	1266	185	141123	13574	139857	13389	6.8432432432432435	10.445664351333184
chr3	CCDC37-DT	126393482	126393534	0	53	0	912	0	859	0.0	0.0
chr3	CCDC37-DT	126393482	126393653	0	172	0	912	0	740	0.0	0.0
chr3	TXNRD3	126615354	126615462	0	109	618	3790	618	3681	0.0	0.16788916055419723
chr3	LINC01471	127499684	127499730	0	47	51	6875	51	6828	0.0	0.007469244288224956
chr3	LINC01471	127532798	127532913	0	116	51	6875	51	6759	0.0	0.007545494895694629
chr3	LINC01471	127535185	127535463	0	279	51	6875	51	6596	0.0	0.007731958762886598
chr3	LINC01471	127535185	127535404	0	220	51	6875	51	6655	0.0	0.007663410969196093
chr3	LINC01471	127499684	127499742	0	59	51	6875	51	6816	0.0	0.007482394366197183
chr3	LINC01471	127535185	127535347	0	163	51	6875	51	6712	0.0	0.007598331346841478
chr3	LINC01471	127535185	127535561	0	377	51	6875	51	6498	0.0	0.007848568790397045
chr3	LINC01471	127532384	127532443	0	60	51	6875	51	6815	0.0	0.007483492296404989
chr3	LINC01471	127535185	127535785	0	601	51	6875	51	6274	0.0	0.008128785463818936
chr3	LINC01471	127532384	127532446	0	63	51	6875	51	6812	0.0	0.007486788021139166
chr3	TPRA1	127575402	127575505	0	104	104	5638	104	5534	0.0	0.0187929165160824
chr3	TPRA1	127575748	127575809	0	62	104	5638	104	5576	0.0	0.018651362984218076
chr3	TPRA1	127590409	127590592	0	184	104	5638	104	5454	0.0	0.01906857352401907
chr3	TPRA1	127588069	127588160	0	92	104	5638	104	5546	0.0	0.01875225387666787
chr3	TPRA1	127591889	127591950	0	62	104	5638	104	5576	0.0	0.018651362984218076
chr3	MGLL	127694974	127695190	0	217	217912	11869	217912	11652	0.0	18.70168211465843
chr3	MGLL	127710575	127710665	0	91	217912	11869	217912	11778	0.0	18.501613177109867
chr3	MGLL	127715852	127715930	0	79	217912	11869	217912	11790	0.0	18.482782018659883
chr3	MGLL	127692965	127693201	0	237	217912	11869	217912	11632	0.0	18.733837689133424
chr3	RUVBL1	128087705	128087808	175	104	1092	4913	917	4809	1.6826923076923077	0.19068413391557495
chr3	GATA2	128492003	128492222	388	220	8983	4485	8595	4265	1.7636363636363637	2.015240328253224
chr3	RPN1	128644534	128644646	867	113	84134	3959	83267	3846	7.672566371681416	21.650286011440457
chr3	ISY1	129134073	129134195	0	123	15750	3885	15750	3762	0.0	4.186602870813397
chr3	RAB43	129092499	129092593	0	95	816	4999	816	4904	0.0	0.16639477977161501
chr3	ISY1	129137130	129137196	0	67	15750	3885	15750	3818	0.0	4.125196437925616
chr3	ISY1	129134831	129134954	0	124	15750	3885	15750	3761	0.0	4.187716032969955
chr3	ISY1	129144067	129144189	0	123	15750	3885	15750	3762	0.0	4.186602870813397
chr3	RPL32P3	129396216	129396420	0	205	373	4487	373	4282	0.0	0.08710882765063055
chr3	RPL32P3	129397039	129397140	0	102	373	4487	373	4385	0.0	0.08506271379703535
chr3	EFCAB12	129421366	129421803	0	438	2499	7796	2499	7358	0.0	0.33963033432998097
chr3	MBD4	129436460	129437308	0	849	0	3360	0	2511	0.0	0.0
chr3	MBD4	129436442	129437308	0	867	0	3360	0	2493	0.0	0.0
chr3	PLXND1	129584384	129584562	0	179	23190	9501	23190	9322	0.0	2.4876635915039693
chr3	TMCC1	129860939	129861012	0	74	3206	8156	3206	8082	0.0	0.396683989111606
chr3	TMCC1	129880308	129880559	0	252	3206	8156	3206	7904	0.0	0.4056174089068826
chr3	TMCC1	129867009	129867098	0	90	3206	8156	3206	8066	0.0	0.39747086536077364
chr3	FAM86HP	130103740	130104006	0	267	0	1310	0	1043	0.0	0.0
chr3	FAM86HP	130105529	130105631	0	103	0	1310	0	1207	0.0	0.0
chr3	ASTE1	131015181	131015256	0	76	51	3157	51	3081	0.0	0.016553067185978577
chr3	ASTE1	131016989	131017049	0	61	51	3157	51	3096	0.0	0.016472868217054265
chr3	ASTE1	131025473	131025594	0	122	51	3157	51	3035	0.0	0.016803953871499175
chr3	AC010210.1	131354308	131354388	0	81	0	6702	0	6621	0.0	0.0
chr3	MRPL3	131498178	131498277	0	100	0	2662	0	2562	0.0	0.0
chr3	MRPL3	131501843	131501924	0	82	0	2662	0	2580	0.0	0.0
chr3	CPNE4	132034566	132035442	0	877	0	5868	0	4991	0.0	0.0
chr3	CPNE4	132034566	132034759	0	194	0	5868	0	5674	0.0	0.0
chr3	CPNE4	132039524	132039605	0	82	0	5868	0	5786	0.0	0.0
chr3	ACAD11	132575771	132575926	0	156	0	4422	0	4266	0.0	0.0
chr3	NPHP3	132682702	132682818	0	117	51	9222	51	9105	0.0	0.005601317957166392
chr3	NPHP3	132696730	132696813	0	84	51	9222	51	9138	0.0	0.005581089954038083
chr3	NPHP3	132699352	132699450	0	99	51	9222	51	9123	0.0	0.005590266359750082
chr3	NPHP3	132717954	132718117	0	164	51	9222	51	9058	0.0	0.0056303819827776555
chr3	TOPBP1	133652462	133652629	6158	168	7546	7110	1388	6942	36.654761904761905	0.19994237971766063
chr3	TOPBP1	133652462	133652614	5798	153	7546	7110	1748	6957	37.89542483660131	0.25125772603133534
chr3	TOPBP1	133652462	133652547	2254	86	7546	7110	5292	7024	26.209302325581394	0.7534168564920274
chr3	RAB6B	133864583	133864642	0	60	67754	5656	67754	5596	0.0	12.107576840600428
chr3	RAB6B	133885534	133885665	0	132	67754	5656	67754	5524	0.0	12.265387400434468
chr3	RAB6B	133885570	133885665	0	96	67754	5656	67754	5560	0.0	12.185971223021582
chr3	SLCO2A1	133947255	133947445	0	191	1459	5144	1459	4953	0.0	0.2945689481122552
chr3	SLCO2A1	133954965	133955193	58	229	1459	5144	1401	4915	0.25327510917030566	0.28504577822990845
chr3	RYK	134177940	134178073	0	134	220760	8180	220760	8046	0.0	27.43723589361173
chr3	AMOTL2	134373515	134373602	0	88	0	6413	0	6325	0.0	0.0
chr3	KY	134608648	134608839	102	192	153	9018	51	8826	0.53125	0.005778382053025153
chr3	KY	134643315	134643378	0	64	153	9018	153	8954	0.0	0.01708733526915345
chr3	AC092969.1	135357271	135357382	0	112	101	9666	101	9554	0.0	0.0105714883818296
chr3	STAG1	136363365	136363467	0	103	4701	7880	4701	7777	0.0	0.6044747331876045
chr3	STAG1	136464880	136464988	0	109	4701	7880	4701	7771	0.0	0.6049414489769657
chr3	STAG1	136341440	136341551	0	112	4701	7880	4701	7768	0.0	0.6051750772399588
chr3	STAG1	136518247	136518415	0	169	4701	7880	4701	7711	0.0	0.6096485540137466
chr3	STAG1	136591444	136591549	0	106	4701	7880	4701	7774	0.0	0.6047080010290713
chr3	STAG1	136586801	136586926	0	126	4701	7880	4701	7754	0.0	0.6062677327830797
chr3	NCK1-DT	136858517	136858603	0	87	51	5008	51	4921	0.0	0.010363747205852468
chr3	DZIP1L	138071642	138071835	0	194	7570	5033	7570	4839	0.0	1.5643728042984089
chr3	DZIP1L	138084112	138084253	408	142	7570	5033	7162	4891	2.8732394366197185	1.4643222244939684
chr3	DZIP1L	138112363	138112500	51	138	7570	5033	7519	4895	0.3695652173913043	1.5360572012257405
chr3	NME9	138304872	138305027	0	156	2884	3719	2884	3563	0.0	0.8094302554027505
chr3	NME9	138318147	138318219	0	73	2884	3719	2884	3646	0.0	0.7910038398244652
chr3	NME9	138327030	138327128	0	99	2884	3719	2884	3620	0.0	0.7966850828729282
chr3	NME9	138315526	138315643	0	118	2884	3719	2884	3601	0.0	0.8008886420438767
chr3	NME9	138324174	138324594	1005	421	2884	3719	1879	3298	2.3871733966745845	0.5697392359005458
chr3	CEP70	138572858	138572932	0	75	859	4206	859	4131	0.0	0.20793996610990076
chr3	CEP70	138572858	138572984	0	127	859	4206	859	4079	0.0	0.2105908310860505
chr3	CEP70	138572858	138572914	0	57	859	4206	859	4149	0.0	0.20703784044348036
chr3	PIK3CB	138684624	138684803	0	180	5568	7866	5568	7686	0.0	0.7244340359094458
chr3	PIK3CB	138704442	138704493	0	52	5568	7866	5568	7814	0.0	0.7125671871000768
chr3	PIK3CB	138707158	138707289	0	132	5568	7866	5568	7734	0.0	0.7199379363847944
chr3	PIK3CB	138734633	138734804	0	172	5568	7866	5568	7694	0.0	0.7236807902261503
chr3	PIK3CB	138796462	138796567	0	106	5568	7866	5568	7760	0.0	0.7175257731958763
chr3	PIK3CB	138770050	138770117	0	68	5568	7866	5568	7798	0.0	0.7140292382662221
chr3	COPB2	139373665	139373808	0	144	0	16215	0	16071	0.0	0.0
chr3	COPB2	139379771	139379907	0	137	0	16215	0	16078	0.0	0.0
chr3	COPB2	139373665	139373833	0	169	0	16215	0	16046	0.0	0.0
chr3	COPB2	139385003	139385200	0	198	0	16215	0	16017	0.0	0.0
chr3	COPB2	139385003	139385429	0	427	0	16215	0	15788	0.0	0.0
chr3	RBP2	139480497	139480592	0	96	0	851	0	755	0.0	0.0
chr3	NMNAT3	139575582	139575994	0	413	0	12995	0	12582	0.0	0.0
chr3	NMNAT3	139627615	139627764	0	150	0	12995	0	12845	0.0	0.0
chr3	NMNAT3	139637962	139638062	0	101	0	12995	0	12894	0.0	0.0
chr3	NMNAT3	139573597	139573680	0	84	0	12995	0	12911	0.0	0.0
chr3	NMNAT3	139582926	139583208	0	283	0	12995	0	12712	0.0	0.0
chr3	NMNAT3	139634610	139634647	0	38	0	12995	0	12957	0.0	0.0
chr3	NMNAT3	139572106	139572233	0	128	0	12995	0	12867	0.0	0.0
chr3	NMNAT3	139578871	139579055	0	185	0	12995	0	12810	0.0	0.0
chr3	AC010181.1	140454361	140454418	0	58	0	1066	0	1008	0.0	0.0
chr3	TFDP2	141995019	141995141	0	123	3308	11917	3308	11794	0.0	0.2804816008139732
chr3	TFDP2	142005440	142005544	0	105	3308	11917	3308	11812	0.0	0.2800541821876058
chr3	TFDP2	142093060	142093127	0	68	3308	11917	3308	11849	0.0	0.2791796776099249
chr3	TFDP2	141993537	141993585	0	49	3308	11917	3308	11868	0.0	0.2787327266599259
chr3	TFDP2	142054114	142054149	31	36	3308	11917	3277	11881	0.8611111111111112	0.2758185337934517
chr3	TFDP2	142000251	142000354	0	104	3308	11917	3308	11813	0.0	0.2800304749005333
chr3	TFDP2	142101734	142101841	0	108	3308	11917	3308	11809	0.0	0.2801253281395546
chr3	GK5	142184710	142185793	2491	1084	24687	6036	22196	4952	2.297970479704797	4.482229402261712
chr3	GK5	142173075	142173197	0	123	24687	6036	24687	5913	0.0	4.175038051750381
chr3	XRN1	142313135	142313174	0	40	2555	12028	2555	11988	0.0	0.2131297964631298
chr3	XRN1	142329433	142329615	0	183	2555	12028	2555	11845	0.0	0.2157028281975517
chr3	ATR	142450465	142450602	816	138	93754	22010	92938	21872	5.913043478260869	4.249177029992684
chr3	ATR	142560262	142560454	0	193	93754	22010	93754	21817	0.0	4.297291103268094
chr3	ATR	142562231	142563109	4930	879	93754	22010	88824	21131	5.608646188850967	4.2034924991718325
chr3	ATR	142562231	142562348	1386	118	93754	22010	92368	21892	11.745762711864407	4.219258176502832
chr3	PCOLCE2	142843244	142843309	0	66	357	3533	357	3467	0.0	0.10297086818575137
chr3	SLC9A9	143796825	143796903	0	79	0	4059	0	3980	0.0	0.0
chr3	SLC9A9	143832018	143832221	0	204	0	4059	0	3855	0.0	0.0
chr3	PLOD2	146077861	146077924	0	64	458	6735	458	6671	0.0	0.06865537400689552
chr3	PLOD2	146123264	146123325	0	62	458	6735	458	6673	0.0	0.06863479694290424
chr3	PLSCR4	146199812	146200039	0	228	561	4242	561	4014	0.0	0.1397608370702541
chr3	PLSCR4	146222064	146222092	0	29	561	4242	561	4213	0.0	0.13315926892950392
chr3	PLSCR4	146223732	146223777	0	46	561	4242	561	4196	0.0	0.13369876072449952
chr3	PLSCR4	146250556	146250637	0	82	561	4242	561	4160	0.0	0.13485576923076922
chr3	PLSCR4	146201034	146201077	0	44	561	4242	561	4198	0.0	0.13363506431634112
chr3	PLSCR2	146460171	146460284	0	114	0	2724	0	2610	0.0	0.0
chr3	PLSCR1	146521832	146522053	0	222	0	3554	0	3332	0.0	0.0
chr3	PLSCR1	146528613	146528831	0	219	0	3554	0	3335	0.0	0.0
chr3	PLSCR1	146536539	146536565	0	27	0	3554	0	3527	0.0	0.0
chr3	PLSCR1	146537995	146538044	0	50	0	3554	0	3504	0.0	0.0
chr3	PLSCR1	146541133	146541180	0	48	0	3554	0	3506	0.0	0.0
chr3	PLSCR1	146521543	146521705	0	163	0	3554	0	3391	0.0	0.0
chr3	PLSCR1	146521543	146522053	0	511	0	3554	0	3043	0.0	0.0
chr3	PLSCR1	146521543	146521701	0	159	0	3554	0	3395	0.0	0.0
chr3	PLSCR1	146521832	146521981	0	150	0	3554	0	3404	0.0	0.0
chr3	ZIC4	147395851	147396469	0	619	0	7806	0	7187	0.0	0.0
chr3	ZIC4	147405674	147405849	0	176	0	7806	0	7630	0.0	0.0
chr3	CP	149176249	149176412	0	164	846	6555	846	6391	0.0	0.1323736504459396
chr3	CP	149186519	149186732	0	214	846	6555	846	6341	0.0	0.13341744204384168
chr3	CP	149217865	149217985	0	121	846	6555	846	6434	0.0	0.1314889648741063
chr3	CPHL1P	149230738	149230901	0	164	49791	3958	49791	3794	0.0	13.123616236162361
chr3	TM4SF1	149375442	149375588	3585	147	21594	3498	18009	3351	24.387755102040817	5.374216651745748
chr3	COMMD2	149750256	149750382	0	127	51	4899	51	4772	0.0	0.01068734283319363
chr3	SERP1	150545702	150545778	0	77	51	5463	51	5386	0.0	0.009468993687337541
chr3	AC020636.2	150893323	150893415	0	93	0	1341	0	1248	0.0	0.0
chr3	CLRN1	150940480	150940519	0	40	51	3358	51	3318	0.0	0.015370705244122965
chr3	CLRN1	150943819	150943991	0	173	51	3358	51	3185	0.0	0.016012558869701727
chr3	CLRN1	150945528	150945679	0	152	51	3358	51	3206	0.0	0.015907673112913287
chr3	GPR171	151200908	151200997	0	90	0	1218	0	1128	0.0	0.0
chr3	P2RY14	151261386	151261438	0	53	0	2895	0	2842	0.0	0.0
chr3	AADACL2-AS1	151917614	151917741	0	128	0	640	0	512	0.0	0.0
chr3	ARHGEF26-AS1	154108668	154108785	0	118	12460	7258	12460	7140	0.0	1.7450980392156863
chr3	ARHGEF26-AS1	154119685	154119808	0	124	12460	7258	12460	7134	0.0	1.7465657415194842
chr3	ARHGEF26-AS1	154060013	154060062	0	50	12460	7258	12460	7208	0.0	1.7286348501664817
chr3	ARHGEF26-AS1	154119685	154119783	0	99	12460	7258	12460	7159	0.0	1.7404665456069284
chr3	ARHGEF26-AS1	154028405	154028562	0	158	12460	7258	12460	7100	0.0	1.7549295774647888
chr3	DHX36	154280762	154280862	0	101	51	10578	51	10477	0.0	0.0048678056695618975
chr3	DHX36	154284582	154284669	0	88	51	10578	51	10490	0.0	0.004861773117254528
chr3	DHX36	154288865	154288964	0	100	51	10578	51	10478	0.0	0.004867341095628937
chr3	PLCH1	155486146	155486206	0	61	47107	7204	47107	7143	0.0	6.594848103037939
chr3	PLCH1	155483348	155483376	0	29	47107	7204	47107	7175	0.0	6.565435540069687
chr3	C3ORF33	155775700	155775848	0	149	13491	2068	13491	1919	0.0	7.030224075039083
chr3	C3ORF33	155805596	155805723	0	128	13491	2068	13491	1940	0.0	6.954123711340206
chr3	SLC33A1	155833467	155833585	0	119	0	4422	0	4303	0.0	0.0
chr3	SLC33A1	155833856	155834041	0	186	0	4422	0	4236	0.0	0.0
chr3	C3ORF33	155804050	155804173	0	124	13491	2068	13491	1944	0.0	6.939814814814815
chr3	SLC33A1	155842431	155842619	0	189	0	4422	0	4233	0.0	0.0
chr3	SLC33A1	155833467	155834041	0	575	0	4422	0	3847	0.0	0.0
chr3	SLC33A1	155845012	155845076	0	65	0	4422	0	4357	0.0	0.0
chr3	CCNL1	157151728	157151930	0	203	3715	6386	3715	6183	0.0	0.6008410156881773
chr3	CCNL1	157157010	157157083	0	74	3715	6386	3715	6312	0.0	0.5885614702154626
chr3	CCNL1	157151916	157151930	0	15	3715	6386	3715	6371	0.0	0.5831109715900172
chr3	CCNL1	157156935	157157083	0	149	3715	6386	3715	6237	0.0	0.5956389289722623
chr3	CCNL1	157151485	157151591	0	107	3715	6386	3715	6279	0.0	0.5916547220895046
chr3	CCNL1	157157006	157157083	0	78	3715	6386	3715	6308	0.0	0.5889346861128726
chr3	VEPH1	157313620	157313755	0	136	2564	6465	2564	6329	0.0	0.40511929214725867
chr3	VEPH1	157499394	157499656	0	263	2564	6465	2564	6202	0.0	0.4134150274105127
chr3	VEPH1	157495211	157495506	0	296	2564	6465	2564	6169	0.0	0.41562651969525044
chr3	VEPH1	157493186	157493293	0	108	2564	6465	2564	6357	0.0	0.40333490640239106
chr3	VEPH1	157489054	157489160	0	107	2564	6465	2564	6358	0.0	0.40327146901541366
chr3	VEPH1	157499394	157499675	0	282	2564	6465	2564	6183	0.0	0.4146854277858645
chr3	VEPH1	157505277	157505409	0	133	2564	6465	2564	6332	0.0	0.4049273531269741
chr3	SHOX2	158105057	158105129	0	73	102	3842	102	3769	0.0	0.027062881400902097
chr3	SHOX2	158105057	158105125	0	69	102	3842	102	3773	0.0	0.02703419029949642
chr3	AC106707.1	158561396	158561505	0	110	1796	1135	1796	1025	0.0	1.7521951219512195
chr3	RARRES1	158710737	158710933	0	197	0	2037	0	1840	0.0	0.0
chr3	IL12A-AS1	159994236	159994305	0	70	5991	11401	5991	11331	0.0	0.5287265025152237
chr3	IL12A-AS1	159997843	159998317	0	475	5991	11401	5991	10926	0.0	0.5483250961010434
chr3	IL12A-AS1	160025469	160025534	4844	66	5991	11401	1147	11335	73.39393939393939	0.1011910013233348
chr3	IL12A-AS1	159997843	159998105	0	263	5991	11401	5991	11138	0.0	0.5378883102891003
chr3	IL12A-AS1	160007781	160007875	0	95	5991	11401	5991	11306	0.0	0.529895630638599
chr3	IL12A-AS1	160009111	160009257	30	147	5991	11401	5961	11254	0.20408163265306123	0.5296783365914342
chr3	IL12A-AS1	160011465	160011551	0	87	5991	11401	5991	11314	0.0	0.5295209474986742
chr3	IFT80	160366042	160366152	0	111	4165	7073	4165	6962	0.0	0.5982476299913818
chr3	IFT80	160391545	160391643	0	99	4165	7073	4165	6974	0.0	0.5972182391740751
chr3	IFT80	160343650	160343815	0	166	4165	7073	4165	6907	0.0	0.603011437671927
chr3	IFT80	160366092	160366152	0	61	4165	7073	4165	7012	0.0	0.5939817455790074
chr3	IFT80	160377832	160377890	0	59	4165	7073	4165	7014	0.0	0.593812375249501
chr3	IFT80	160394152	160394310	0	159	4165	7073	4165	6914	0.0	0.602400925658085
chr3	TRIM59	160448725	160448795	0	71	0	7827	0	7756	0.0	0.0
chr3	TRIM59	160447731	160447842	0	112	0	7827	0	7715	0.0	0.0
chr3	KPNA4	160509799	160509871	0	73	0	13663	0	13590	0.0	0.0
chr3	KPNA4	160521778	160521910	0	133	0	13663	0	13530	0.0	0.0
chr3	KPNA4	160525020	160525132	0	113	0	13663	0	13550	0.0	0.0
chr3	KPNA4	160564504	160564640	0	137	0	13663	0	13526	0.0	0.0
chr3	KPNA4	160564520	160564640	0	121	0	13663	0	13542	0.0	0.0
chr3	KPNA4	160504000	160504067	0	68	0	13663	0	13595	0.0	0.0
chr3	B3GALNT1	161101138	161101233	0	96	102	6044	102	5948	0.0	0.01714862138533961
chr3	B3GALNT1	161089943	161090062	0	120	102	6044	102	5924	0.0	0.017218095881161376
chr3	B3GALNT1	161103112	161103205	0	94	102	6044	102	5950	0.0	0.017142857142857144
chr3	B3GALNT1	161104784	161104895	0	112	102	6044	102	5932	0.0	0.017194875252865813
chr3	B3GALNT1	161103957	161104105	0	149	102	6044	102	5895	0.0	0.017302798982188294
chr3	B3GALNT1	161089959	161090062	0	104	102	6044	102	5940	0.0	0.01717171717171717
chr3	B3GALNT1	161101444	161101631	0	188	102	6044	102	5856	0.0	0.017418032786885244
chr3	B3GALNT1	161089943	161090066	0	124	102	6044	102	5920	0.0	0.01722972972972973
chr3	SPTSSB	161347964	161348103	0	140	0	2437	0	2297	0.0	0.0
chr3	LINC01192	163199873	163199951	0	79	97	7521	97	7442	0.0	0.013034130610051061
chr3	LINC01192	163203417	163203515	46	99	97	7521	51	7422	0.46464646464646464	0.0068714632174616
chr3	LINC01192	163275195	163275319	0	125	97	7521	97	7396	0.0	0.013115197404002164
chr3	LINC01192	163220100	163220187	0	88	97	7521	97	7433	0.0	0.013049912552132382
chr3	LINC01192	163124386	163124486	0	101	97	7521	97	7420	0.0	0.01307277628032345
chr3	LINC01192	163249264	163249381	0	118	97	7521	97	7403	0.0	0.013102796163717411
chr3	LINC01192	163187067	163187264	0	198	97	7521	97	7323	0.0	0.013245937457326232
chr3	LINC01192	163249264	163249374	0	111	97	7521	97	7410	0.0	0.013090418353576248
chr3	LINC01192	163184064	163184133	0	70	97	7521	97	7451	0.0	0.013018386793718964
chr3	LINC01192	163112460	163112617	0	158	97	7521	97	7363	0.0	0.013173977998098602
chr3	LINC01192	163184064	163184129	0	66	97	7521	97	7455	0.0	0.01301140174379611
chr3	LINC01192	163202081	163202249	0	169	97	7521	97	7352	0.0	0.013193688792165398
chr3	LINC01192	163303983	163304098	0	116	97	7521	97	7405	0.0	0.013099257258609049
chr3	LINC01192	163207642	163207757	0	116	97	7521	97	7405	0.0	0.013099257258609049
chr3	LINC01324	164717571	164717791	0	221	0	848	0	627	0.0	0.0
chr3	BCHE	165829516	165831041	0	1526	51	3079	51	1553	0.0	0.032839665164198326
chr3	BCHE	165827985	165828069	0	85	51	3079	51	2994	0.0	0.017034068136272545
chr3	BCHE	165777716	165777795	0	80	51	3079	51	2999	0.0	0.017005668556185394
chr3	ZBBX	167288866	167288983	0	118	384	4593	384	4475	0.0	0.08581005586592179
chr3	ZBBX	167315749	167315829	0	81	384	4593	384	4512	0.0	0.0851063829787234
chr3	ZBBX	167373705	167373787	0	83	384	4593	384	4510	0.0	0.08514412416851441
chr3	ZBBX	167379637	167379792	0	156	384	4593	384	4437	0.0	0.08654496281271129
chr3	ZBBX	167368687	167368804	0	118	384	4593	384	4475	0.0	0.08581005586592179
chr3	ZBBX	167252125	167252211	0	87	384	4593	384	4506	0.0	0.085219707057257
chr3	ZBBX	167248607	167248649	0	43	384	4593	384	4550	0.0	0.0843956043956044
chr3	SERPINI2	167473736	167473827	0	92	411	2847	411	2755	0.0	0.14918330308529945
chr3	WDR49	167527819	167528017	0	199	0	3913	0	3714	0.0	0.0
chr3	WDR49	167626851	167627292	0	442	0	3913	0	3471	0.0	0.0
chr3	PDCD10	167687614	167687693	0	80	1531	3179	1531	3099	0.0	0.4940303323652791
chr3	PDCD10	167720061	167720273	0	213	1531	3179	1531	2966	0.0	0.5161834120026972
chr3	PDCD10	167725400	167725473	0	74	1531	3179	1531	3105	0.0	0.4930756843800322
chr3	PDCD10	167734213	167734345	1	133	1531	3179	1530	3046	0.007518796992481203	0.5022980958634274
chr3	PDCD10	167734213	167734246	1	34	1531	3179	1530	3145	0.029411764705882353	0.4864864864864865
chr3	PDCD10	167734213	167734350	1	138	1531	3179	1530	3041	0.007246376811594203	0.5031239723775074
chr3	PDCD10	167697850	167697978	0	129	1531	3179	1531	3050	0.0	0.5019672131147541
chr3	GOLIM4	168040785	168040869	0	85	0	4600	0	4515	0.0	0.0
chr3	MECOM	169107925	169107952	0	28	0	9118	0	9090	0.0	0.0
chr3	MECOM	169144996	169145058	0	63	0	9118	0	9055	0.0	0.0
chr3	MECOM	169086512	169086565	0	54	0	9118	0	9064	0.0	0.0
chr3	MECOM	169133349	169133474	0	126	0	9118	0	8992	0.0	0.0
chr3	MECOM	169565968	169566040	0	73	0	9118	0	9045	0.0	0.0
chr3	LRRC34	169795484	169795611	0	128	17569	2712	17569	2584	0.0	6.799148606811145
chr3	LRRC34	169800658	169800754	0	97	17569	2712	17569	2615	0.0	6.718546845124283
chr3	LRRC34	169808627	169808745	1843	119	17569	2712	15726	2593	15.487394957983193	6.064789818742769
chr3	LRRC31	169860560	169860728	0	169	5116	3135	5116	2966	0.0	1.724881995954147
chr3	AC008040.1	169954519	169955207	153	689	1887	7981	1734	7292	0.2220609579100145	0.23779484366428963
chr3	PHC3	170149085	170149244	408	160	24143	16850	23735	16690	2.55	1.4221090473337328
chr3	PHC3	170145422	170145521	0	100	24143	16850	24143	16750	0.0	1.4413731343283582
chr3	PHC3	170128339	170128387	0	49	24143	16850	24143	16801	0.0	1.436997797750134
chr3	PHC3	170176864	170176925	0	62	24143	16850	24143	16788	0.0	1.4381105551584465
chr3	AC026316.5	170733846	170733942	0	97	0	1786	0	1689	0.0	0.0
chr3	EIF5A2	170894291	170894423	0	133	1711	5546	1711	5413	0.0	0.31609089229632364
chr3	EIF5A2	170894291	170894383	0	93	1711	5546	1711	5453	0.0	0.31377223546671557
chr3	SLC2A2	171005942	171006105	0	164	0	3422	0	3258	0.0	0.0
chr3	SLC2A2	171009957	171010082	0	126	0	3422	0	3296	0.0	0.0
chr3	SLC2A2	171014468	171014731	0	264	0	3422	0	3158	0.0	0.0
chr3	TNIK	171107182	171107206	0	25	1646	6345	1646	6320	0.0	0.26044303797468354
chr3	TNIK	171128713	171128878	0	166	1646	6345	1646	6179	0.0	0.26638614662566756
chr3	TNIK	171139469	171139556	0	88	1646	6345	1646	6257	0.0	0.2630653667891961
chr3	PLD1	171686684	171686798	49	115	3314	11660	3265	11545	0.4260869565217391	0.2828064097011693
chr3	PLD1	171737531	171737659	0	129	3314	11660	3314	11531	0.0	0.28739918480617466
chr3	TNFSF10	172511616	172511659	748	44	14182	3448	13434	3404	17.0	3.946533490011751
chr3	LINC02068	172574272	172574340	0	69	0	3672	0	3603	0.0	0.0
chr3	NCEH1	172647885	172648114	0	230	0	4813	0	4583	0.0	0.0
chr3	NCEH1	172647861	172648114	0	254	0	4813	0	4559	0.0	0.0
chr3	SPATA16	172922229	172922284	0	56	0	2141	0	2085	0.0	0.0
chr3	NLGN1-AS1	173912545	173912617	0	73	0	819	0	746	0.0	0.0
chr3	LINC01208	176636308	176636533	0	226	0	5627	0	5401	0.0	0.0
chr3	TBL1XR1	177053772	177053918	0	147	152	10475	152	10328	0.0	0.01471727343144849
chr3	TBL1XR1	177064919	177065022	0	104	152	10475	152	10371	0.0	0.014656253013209912
chr3	TBL1XR1	177098465	177098541	0	77	152	10475	152	10398	0.0	0.014618195806885939
chr3	TBL1XR1	177037636	177037842	0	207	152	10475	152	10268	0.0	0.014803272302298403
chr3	TBL1XR1	177110808	177110887	0	80	152	10475	152	10395	0.0	0.014622414622414622
chr3	TBL1XR1	177079826	177079945	0	120	152	10475	152	10355	0.0	0.014678899082568808
chr3	TBL1XR1	177131362	177131449	0	88	152	10475	152	10387	0.0	0.014633676711273708
chr3	TBL1XR1	177086964	177087041	0	78	152	10475	152	10397	0.0	0.014619601808213908
chr3	TBL1XR1	177160870	177160988	0	119	152	10475	152	10356	0.0	0.014677481653147934
chr3	TBL1XR1	177091150	177091180	0	31	152	10475	152	10444	0.0	0.014553810800459595
chr3	TBL1XR1	177078631	177078778	0	148	152	10475	152	10327	0.0	0.014718698557180207
chr3	AC117453.1	178191507	178191597	0	91	0	10965	0	10874	0.0	0.0
chr3	AC117453.1	178371750	178371819	0	70	0	10965	0	10895	0.0	0.0
chr3	KCNMB2-AS1	178757079	178757136	0	58	2835	4760	2835	4702	0.0	0.6029349213100809
chr3	KCNMB2-AS1	178859488	178859623	0	136	2835	4760	2835	4624	0.0	0.6131055363321799
chr3	ZMAT3	179071326	179071447	255	122	11806	4793	11551	4671	2.0901639344262297	2.4729180047099124
chr3	KCNMB3	179242808	179243284	0	477	459	5833	459	5356	0.0	0.08569828230022405
chr3	GNB4	179405189	179405406	0	218	27652	7989	27652	7771	0.0	3.5583579976836957
chr3	GNB4	179420888	179420927	0	40	27652	7989	27652	7949	0.0	3.4786765630896967
chr3	GNB4	179424111	179424284	0	174	27652	7989	27652	7815	0.0	3.5383237364043505
chr3	GNB4	179437740	179437899	5612	160	27652	7989	22040	7829	35.075	2.815174351769064
chr3	MRPL47	179602651	179602797	0	147	0	1372	0	1225	0.0	0.0
chr3	MRPL47	179602651	179602737	0	87	0	1372	0	1285	0.0	0.0
chr3	PEX5L	179879928	179880123	0	196	0	10258	0	10062	0.0	0.0
chr3	PEX5L	179898141	179898246	0	106	0	10258	0	10152	0.0	0.0
chr3	PEX5L	179971593	179971665	0	73	0	10258	0	10185	0.0	0.0
chr3	PEX5L	179900669	179900735	0	67	0	10258	0	10191	0.0	0.0
chr3	PEX5L	179973158	179973318	0	161	0	10258	0	10097	0.0	0.0
chr3	PEX5L	179971593	179971660	0	68	0	10258	0	10190	0.0	0.0
chr3	CCDC39	180614995	180615077	0	83	21930	11338	21930	11255	0.0	1.948467347845402
chr3	CCDC39	180619810	180619970	0	161	21930	11338	21930	11177	0.0	1.9620649548179296
chr3	CCDC39	180654761	180654953	62	193	21930	11338	21868	11145	0.32124352331606215	1.9621354867653655
chr3	CCDC39	180679290	180679382	16894	93	21930	11338	5036	11245	181.65591397849462	0.447843485993775
chr3	AC108734.4	180847506	180847624	0	119	51	3116	51	2997	0.0	0.01701701701701702
chr3	AC108734.4	180810409	180810470	0	62	51	3116	51	3054	0.0	0.01669941060903733
chr3	DNAJC19	180986942	180987022	0	81	0	3243	0	3162	0.0	0.0
chr3	DNAJC19	180988177	180988229	0	53	0	3243	0	3190	0.0	0.0
chr3	DNAJC19	180986997	180987022	0	26	0	3243	0	3217	0.0	0.0
chr3	DNAJC19	180986947	180987022	0	76	0	3243	0	3167	0.0	0.0
chr3	AC068308.1	181439976	181440034	0	59	0	6618	0	6559	0.0	0.0
chr3	AC068308.1	181436157	181436191	0	35	0	6618	0	6583	0.0	0.0
chr3	DCUN1D1	182985503	182985622	0	120	26	8289	26	8169	0.0	0.0031827641082139797
chr3	DCUN1D1	182980834	182980935	0	102	26	8289	26	8187	0.0	0.003175766459020398
chr3	MCCC1	183025754	183025804	0	51	5639	4334	5639	4283	0.0	1.3166005136586505
chr3	MCCC1	183037217	183037434	0	218	5639	4334	5639	4116	0.0	1.370019436345967
chr3	MCCC1	183072365	183072487	0	123	5639	4334	5639	4211	0.0	1.3391118499168844
chr3	MCCC1	183092408	183092545	0	138	5639	4334	5639	4196	0.0	1.3438989513822688
chr3	MCCC1	183086692	183086788	0	97	5639	4334	5639	4237	0.0	1.3308945008260562
chr3	MCCC1	183029092	183029189	0	98	5639	4334	5639	4236	0.0	1.331208687440982
chr3	MCCC1	183094558	183094605	0	48	5639	4334	5639	4286	0.0	1.315678954736351
chr3	MCCC1	183086692	183086784	0	93	5639	4334	5639	4241	0.0	1.3296392360292384
chr3	MCCC1	183090935	183091031	0	97	5639	4334	5639	4237	0.0	1.3308945008260562
chr3	LAMP3	183160856	183160957	0	102	255	3795	255	3693	0.0	0.06904955320877336
chr3	KLHL6	183499589	183499827	0	239	99282	10287	99282	10048	0.0	9.88077229299363
chr3	PARL	183833723	183833825	0	103	650517	2279	650517	2176	0.0	298.9508272058824
chr3	PARL	183842297	183842447	51	151	650517	2279	650466	2128	0.33774834437086093	305.6701127819549
chr3	PARL	183866624	183866765	0	142	650517	2279	650517	2137	0.0	304.4066448291998
chr3	PARL	183856431	183856551	50	121	650517	2279	650467	2158	0.4132231404958678	301.4212233549583
chr3	PARL	183833491	183833589	0	99	650517	2279	650517	2180	0.0	298.40229357798165
chr3	PARL	183842297	183842384	51	88	650517	2279	650466	2191	0.5795454545454546	296.8808763121862
chr3	ABCC5	183949752	183949881	0	130	322291	10992	322291	10862	0.0	29.671423310624196
chr3	ABCC5	183942432	183942515	0	84	322291	10992	322291	10908	0.0	29.546296296296298
chr3	ABCC5	183985303	183985378	0	76	322291	10992	322291	10916	0.0	29.52464272627336
chr3	ABCC5	183985303	183985455	0	153	322291	10992	322291	10839	0.0	29.73438509087554
chr3	ABCC5	184009888	184009977	0	90	322291	10992	322291	10902	0.0	29.56255732893047
chr3	ALG3	184245197	184245358	0	162	51	3286	51	3124	0.0	0.016325224071702945
chr3	ALG3	184245712	184245812	0	101	51	3286	51	3185	0.0	0.016012558869701727
chr3	ALG3	184245467	184245615	0	149	51	3286	51	3137	0.0	0.01625757092763787
chr3	CLCN2	184346934	184347021	0	88	0	7330	0	7242	0.0	0.0
chr3	CLCN2	184352012	184352117	0	106	0	7330	0	7224	0.0	0.0
chr3	CLCN2	184353661	184353795	0	135	0	7330	0	7195	0.0	0.0
chr3	CLCN2	184354903	184354973	0	71	0	7330	0	7259	0.0	0.0
chr3	CLCN2	184357778	184357856	0	79	0	7330	0	7251	0.0	0.0
chr3	CLCN2	184358681	184358813	0	133	0	7330	0	7197	0.0	0.0
chr3	CLCN2	184356513	184356611	0	99	0	7330	0	7231	0.0	0.0
chr3	CLCN2	184357619	184357698	0	80	0	7330	0	7250	0.0	0.0
chr3	CLCN2	184353541	184353795	0	255	0	7330	0	7075	0.0	0.0
chr3	CLCN2	184358681	184358783	0	103	0	7330	0	7227	0.0	0.0
chr3	LIPH	185527483	185527585	240	103	5706	4108	5466	4005	2.3300970873786406	1.3647940074906366
chr3	LIPH	185524070	185524160	0	91	5706	4108	5706	4017	0.0	1.4204630321135177
chr3	LIPH	185546876	185546972	1607	97	5706	4108	4099	4011	16.567010309278352	1.0219396659187234
chr3	IGF2BP2	185672540	185672669	0	130	682604	5350	682604	5220	0.0	130.7670498084291
chr3	TRA2B	185919436	185919496	0	61	0	11300	0	11239	0.0	0.0
chr3	TRA2B	185926600	185926734	0	135	0	11300	0	11165	0.0	0.0
chr3	TRA2B	185931576	185931852	0	277	0	11300	0	11023	0.0	0.0
chr3	ETV5	186084168	186084280	0	113	0	5754	0	5641	0.0	0.0
chr3	DGKG	186260438	186260513	434	76	56127	11004	55693	10928	5.7105263157894735	5.096357979502196
chr3	DGKG	186268800	186268917	51	118	56127	11004	56076	10886	0.4322033898305085	5.151203380488701
chr3	DGKG	186279850	186279973	51	124	56127	11004	56076	10880	0.4112903225806452	5.154044117647059
chr3	LINC02052	186456916	186457061	0	146	102	3834	102	3688	0.0	0.027657266811279828
chr3	LINC02052	186456163	186456257	0	95	102	3834	102	3739	0.0	0.027280021396095214
chr3	LINC02052	186479704	186479805	0	102	102	3834	102	3732	0.0	0.027331189710610933
chr3	TBCCD1	186563993	186564372	0	380	149	3408	149	3028	0.0	0.04920739762219287
chr3	AC068631.1	186647041	186647162	0	122	15112	10018	15112	9896	0.0	1.5270816491511723
chr3	AC068631.1	186642220	186642294	0	75	15112	10018	15112	9943	0.0	1.5198632203560294
chr3	AC068631.1	186651809	186651871	0	63	15112	10018	15112	9955	0.0	1.5180311401305877
chr3	AC068631.1	186666967	186667261	0	295	15112	10018	15112	9723	0.0	1.5542528026329323
chr3	AC068631.1	186668911	186669043	0	133	15112	10018	15112	9885	0.0	1.528780981284775
chr3	AC068631.1	186721219	186721344	0	126	15112	10018	15112	9892	0.0	1.5276991508289526
chr3	AC068631.1	186736538	186736650	0	113	15112	10018	15112	9905	0.0	1.5256940938919739
chr3	AC068631.1	186714739	186714858	0	120	15112	10018	15112	9898	0.0	1.5267730854718125
chr3	AC068631.1	186714447	186714539	0	93	15112	10018	15112	9925	0.0	1.5226196473551636
chr3	AC068631.1	186721219	186721416	0	198	15112	10018	15112	9820	0.0	1.5389002036659878
chr3	AC068631.1	186734712	186734834	0	123	15112	10018	15112	9895	0.0	1.5272359777665487
chr3	AC068631.1	186721742	186722089	0	348	15112	10018	15112	9670	0.0	1.5627714581178904
chr3	AC068631.1	186736746	186736883	0	138	15112	10018	15112	9880	0.0	1.5295546558704454
chr3	AC068631.1	186742072	186742249	0	178	15112	10018	15112	9840	0.0	1.5357723577235773
chr3	AC068631.1	186745109	186745202	0	94	15112	10018	15112	9924	0.0	1.5227730753728335
chr3	AC068631.1	186746698	186746795	17	98	15112	10018	15095	9920	0.17346938775510204	1.5216733870967742
chr3	AC068631.1	186746698	186746820	42	123	15112	10018	15070	9895	0.34146341463414637	1.5229914098029307
chr3	RFC4	186790325	186790406	0	82	3691	2909	3691	2827	0.0	1.3056243367527414
chr3	RFC4	186805559	186805598	0	40	3691	2909	3691	2869	0.0	1.2865109794353433
chr3	RPL39L	187127998	187128062	0	65	0	1038	0	973	0.0	0.0
chr3	MASP1	187285824	187286056	0	233	255	9431	255	9198	0.0	0.027723418134377037
chr3	MASP1	187291244	187291350	0	107	255	9431	255	9324	0.0	0.02734877734877735
chr3	MASP1	187285824	187286077	0	254	255	9431	255	9177	0.0	0.02778685845047401
chr3	MASP1	187291244	187291488	0	245	255	9431	255	9186	0.0	0.02775963422599608
chr3	BCL6	187726730	187726898	0	169	0	5524	0	5355	0.0	0.0
chr3	GMNC	190859744	190859819	0	76	51	3969	51	3893	0.0	0.013100436681222707
chr3	UTS2B	191276806	191276844	0	39	0	3865	0	3826	0.0	0.0
chr3	UTS2B	191304491	191304548	0	58	0	3865	0	3807	0.0	0.0
chr3	UTS2B	191273385	191273564	0	180	0	3865	0	3685	0.0	0.0
chr3	UTS2B	191294559	191294726	0	168	0	3865	0	3697	0.0	0.0
chr3	FGF12	192360427	192360538	0	112	0	7205	0	7093	0.0	0.0
chr3	FGF12	192727180	192727323	0	144	0	7205	0	7061	0.0	0.0
chr3	ATP13A5	193372219	193372285	0	67	20597	5709	20597	5642	0.0	3.650655795817086
chr3	ATP13A4	193438474	193438584	0	111	14585	9023	14585	8912	0.0	1.6365574506283662
chr3	OPA1-AS1	193619600	193619686	0	87	0	500	0	413	0.0	0.0
chr3	LINC02028	194010289	194010429	0	141	1802	10141	1802	10000	0.0	0.1802
chr3	LINC02028	194023106	194023207	0	102	1802	10141	1802	10039	0.0	0.17949995019424245
chr3	LINC02028	194015550	194015635	0	86	1802	10141	1802	10055	0.0	0.17921432123321732
chr3	LINC02028	194052359	194052442	0	84	1802	10141	1802	10057	0.0	0.17917868151536243
chr3	LINC02028	194058059	194058147	0	89	1802	10141	1802	10052	0.0	0.17926780740151213
chr3	LINC02028	194029645	194029753	0	109	1802	10141	1802	10032	0.0	0.17962519936204147
chr3	LINC02028	194046469	194046679	0	211	1802	10141	1802	9930	0.0	0.18147029204431017
chr3	LINC02028	194043743	194043855	0	113	1802	10141	1802	10028	0.0	0.17969684882329479
chr3	LINC02028	194057636	194057815	0	180	1802	10141	1802	9961	0.0	0.18090553157313521
chr3	LINC02028	194057632	194057815	0	184	1802	10141	1802	9957	0.0	0.18097820628703426
chr3	LINC02036	194210613	194210710	0	98	6988	3513	6988	3415	0.0	2.0462664714494876
chr3	LINC02036	194211207	194211350	51	144	6988	3513	6937	3369	0.3541666666666667	2.0590679726921937
chr3	LRRC15	194363355	194363412	0	58	44640	5941	44640	5883	0.0	7.58796532381438
chr3	ATP13A3	194457093	194457174	0	82	1662	13292	1662	13210	0.0	0.12581377744133232
chr3	ATP13A3	194412198	194412288	0	91	1662	13292	1662	13201	0.0	0.1258995530641618
chr3	ATP13A3	194424401	194424432	0	32	1662	13292	1662	13260	0.0	0.1253393665158371
chr3	TMEM44	194617635	194617776	0	142	51	4577	51	4435	0.0	0.011499436302142051
chr3	TMEM44	194625896	194625990	0	95	51	4577	51	4482	0.0	0.011378848728246318
chr3	TMEM44	194593040	194593073	0	34	51	4577	51	4543	0.0	0.011226062073519701
chr3	TMEM44	194593040	194593070	0	31	51	4577	51	4546	0.0	0.011218653761548614
chr3	TMEM44	194625896	194625926	0	31	51	4577	51	4546	0.0	0.011218653761548614
chr3	LSG1	194660741	194660886	0	146	0	4817	0	4671	0.0	0.0
chr3	XXYLT1	195207424	195207498	0	75	4096	5414	4096	5339	0.0	0.7671848660797902
chr3	XXYLT1	195270088	195270205	1298	118	4096	5414	2798	5296	11.0	0.5283232628398792
chr3	ACAP2	195392089	195392147	188	59	26449	10066	26261	10007	3.1864406779661016	2.624263015888878
chr3	ACAP2	195295195	195295300	0	106	26449	10066	26449	9960	0.0	2.655522088353414
chr3	ACAP2	195312946	195312967	0	22	26449	10066	26449	10044	0.0	2.6333134209478297
chr3	ACAP2	195325443	195325455	0	13	26449	10066	26449	10053	0.0	2.6309559335521735
chr3	PPP1R2	195523691	195523786	0	96	0	4053	0	3957	0.0	0.0
chr3	PPP1R2	195524818	195524896	0	79	0	4053	0	3974	0.0	0.0
chr3	PPP1R2	195527757	195527902	0	146	0	4053	0	3907	0.0	0.0
chr3	APOD	195577061	195577183	0	123	272	2030	272	1907	0.0	0.1426324069218668
chr3	APOD	195582616	195582739	0	124	272	2030	272	1906	0.0	0.14270724029380902
chr3	APOD	195583066	195583202	272	137	272	2030	0	1893	1.9854014598540146	0.0
chr3	MUC4	195754212	195754372	0	161	821377	19948	821377	19787	0.0	41.51094152726537
chr3	MUC4	195770215	195770371	0	157	821377	19948	821377	19791	0.0	41.502551664898185
chr3	MUC4	195766662	195766751	0	90	821377	19948	821377	19858	0.0	41.3625239198308
chr3	MUC4	195770677	195770886	0	210	821377	19948	821377	19738	0.0	41.61399331239234
chr3	MUC4	195778302	195778455	42579	154	821377	19948	778798	19794	276.487012987013	39.345155097504296
chr3	MUC4	195778789	195791497	764559	12709	821377	19948	56818	7239	60.158863797308996	7.848874153888659
chr3	TNK2	195867168	195867264	0	97	366	8460	366	8363	0.0	0.04376419944995815
chr3	TNK2	195882050	195882328	0	279	366	8460	366	8181	0.0	0.044737807114044736
chr3	TNK2	195884811	195885033	50	223	366	8460	316	8237	0.2242152466367713	0.038363481850188175
chr3	TNK2	195869496	195869541	0	46	366	8460	366	8414	0.0	0.04349893035417162
chr3	TNK2	195867168	195867258	0	91	366	8460	366	8369	0.0	0.043732823515354284
chr3	TNK2	195876443	195876508	0	66	366	8460	366	8394	0.0	0.04360257326661901
chr3	TNK2	195882444	195882527	0	84	366	8460	366	8376	0.0	0.04369627507163324
chr3	TNK2	195882285	195882328	0	44	366	8460	366	8416	0.0	0.04348859315589353
chr3	TNK2	195885412	195885543	0	132	366	8460	366	8328	0.0	0.04394812680115274
chr3	SDHAP1	195960299	195960423	561	125	144163	3371	143602	3246	4.488	44.23967960566851
chr3	SDHAP1	195968218	195968385	90	168	144163	3371	144073	3203	0.5357142857142857	44.98064314704964
chr3	SDHAP1	195984491	195984737	23613	247	144163	3371	120550	3124	95.59919028340082	38.58834827144686
chr3	SDHAP1	195984593	195984737	23613	145	144163	3371	120550	3226	162.84827586206896	37.36825790452573
chr3	TFRC	196073929	196074125	0	197	29078	7608	29078	7411	0.0	3.9236270408851706
chr3	TFRC	196075158	196075360	12844	203	29078	7608	16234	7405	63.27093596059113	2.1923024983119515
chr3	ZDHHC19	196199345	196199522	12991	178	60122	2438	47131	2260	72.98314606741573	20.85442477876106
chr3	PCYT1A	196283474	196283538	0	65	44728	7356	44728	7291	0.0	6.134686599917707
chr3	PCYT1A	196267279	196267365	0	87	44728	7356	44728	7269	0.0	6.153253542440501
chr3	TCTEX1D2	196305655	196305773	0	119	10208	1253	10208	1134	0.0	9.001763668430335
chr3	TM4SF19	196326954	196327032	0	79	0	1901	0	1822	0.0	0.0
chr3	UBXN7	196393553	196393619	0	67	306	11261	306	11194	0.0	0.02733607289619439
chr3	UBXN7	196407245	196407393	0	149	306	11261	306	11112	0.0	0.0275377969762419
chr3	RNF168	196488606	196488683	0	78	19033	5353	19033	5275	0.0	3.6081516587677727
chr3	WDR53	196567190	196567307	0	118	14704	1801	14704	1683	0.0	8.736779560308973
chr3	CEP19	196708527	196708727	684	201	1143	2161	459	1960	3.4029850746268657	0.23418367346938776
chr3	NCBP2	196941486	196941602	0	117	0	4358	0	4241	0.0	0.0
chr3	DLG1	197069218	197069260	0	43	47199	16100	47199	16057	0.0	2.939465653609018
chr3	DLG1	197081050	197081117	0	68	47199	16100	47199	16032	0.0	2.9440494011976046
chr3	DLG1	197119409	197119530	0	122	47199	16100	47199	15978	0.0	2.95399924896733
chr3	DLG1	197142717	197142768	0	52	47199	16100	47199	16048	0.0	2.9411141575274176
chr3	DLG1	197161639	197161738	0	100	47199	16100	47199	16000	0.0	2.9499375
chr3	DLG1	197149742	197149796	0	55	47199	16100	47199	16045	0.0	2.9416640698036773
chr3	DLG1	197068501	197068537	0	37	47199	16100	47199	16063	0.0	2.9383676772707465
chr3	DLG1	197068501	197068522	0	22	47199	16100	47199	16078	0.0	2.9356263216818013
chr3	DLG1	197155668	197155763	0	96	47199	16100	47199	16004	0.0	2.9492001999500124
chr3	DLG1	197075836	197075870	0	35	47199	16100	47199	16065	0.0	2.9380018674136323
chr3	DLG1	197076585	197076682	0	98	47199	16100	47199	16002	0.0	2.9495688038995125
chr3	DLG1	197270699	197270784	2673	86	47199	16100	44526	16014	31.08139534883721	2.780442113150993
chr3	DLG1	197297352	197297426	0	75	47199	16100	47199	16025	0.0	2.9453354134165366
chr3	DLG1	197076585	197076685	0	101	47199	16100	47199	15999	0.0	2.9501218826176636
chr3	DLG1	197141229	197141353	0	125	47199	16100	47199	15975	0.0	2.9545539906103286
chr3	BDH1	197546360	197546486	0	127	365591	10256	365591	10129	0.0	36.09349392832461
chr3	BDH1	197554561	197554713	0	153	365591	10256	365591	10103	0.0	36.18638028308423
chr3	BDH1	197538305	197538952	1479	648	365591	10256	364112	9608	2.2824074074074074	37.89675270607827
chr3	BDH1	197555341	197555507	204	167	365591	10256	365387	10089	1.221556886227545	36.21637426900585
chr3	AC132008.2	197622186	197622330	0	145	24973	2727	24973	2582	0.0	9.671959721146399
chr3	AC132008.2	197624471	197624720	0	250	24973	2727	24973	2477	0.0	10.081953976584579
chr3	AC132008.2	197621703	197621868	0	166	24973	2727	24973	2561	0.0	9.751269035532994
chr3	RUBCN	197696953	197697049	0	97	41115	11010	41115	10913	0.0	3.767524970219005
chr3	RUBCN	197717976	197718130	102	155	41115	11010	41013	10855	0.6580645161290323	3.7782588668816213
chr3	RUBCN	197699186	197699231	0	46	41115	11010	41115	10964	0.0	3.75
chr3	RUBCN	197691073	197691148	0	76	41115	11010	41115	10934	0.0	3.76028900676788
chr3	IQCG	197891445	197891547	0	103	7858	4487	7858	4384	0.0	1.79242700729927
chr3	IQCG	197945619	197945686	704	68	7858	4487	7154	4419	10.352941176470589	1.618918307309346
chr3	IQCG	197949372	197949449	142	78	7858	4487	7716	4409	1.8205128205128205	1.7500567022000453
chr4	ABCA11P	437445	437511	937	67	9637	2794	8700	2727	13.985074626865671	3.1903190319031904
chr4	ZNF721	472574	472701	0	128	13415	6398	13415	6270	0.0	2.139553429027113
chr4	PDE6B-AS1	654064	654213	153	150	2805	2333	2652	2183	1.02	1.2148419606046725
chr4	ATP5ME	673911	673966	93	56	8541	936	8448	880	1.6607142857142858	9.6
chr4	GAK	859605	859722	0	118	148340	14541	148340	14423	0.0	10.284961519794772
chr4	GAK	896459	896549	311	91	148340	14541	148029	14450	3.4175824175824174	10.244221453287198
chr4	GAK	904636	904779	0	144	148340	14541	148340	14397	0.0	10.303535458776134
chr4	GAK	859361	859493	0	133	148340	14541	148340	14408	0.0	10.295669072737368
chr4	GAK	912734	912794	0	61	148340	14541	148340	14480	0.0	10.244475138121548
chr4	GAK	913606	913668	0	63	148340	14541	148340	14478	0.0	10.245890316342036
chr4	DGKQ	961687	961834	331	148	24271	5008	23940	4860	2.2364864864864864	4.925925925925926
chr4	DGKQ	965490	965529	0	40	24271	5008	24271	4968	0.0	4.885466988727858
chr4	SLC26A1	992720	992935	0	216	11580	4299	11580	4083	0.0	2.8361498897869213
chr4	RNF212	1056837	1057004	102	168	276	5018	174	4850	0.6071428571428571	0.035876288659793816
chr4	RNF212	1081418	1081467	0	50	276	5018	276	4968	0.0	0.05555555555555555
chr4	RNF212	1108342	1108404	0	63	276	5018	276	4955	0.0	0.05570131180625631
chr4	RNF212	1099715	1099927	0	213	276	5018	276	4805	0.0	0.05744016649323621
chr4	TMED11P	1117147	1117273	0	127	0	758	0	631	0.0	0.0
chr4	SPON2	1179447	1179541	0	95	110474	5995	110474	5900	0.0	18.724406779661017
chr4	SPON2	1201268	1201462	92	195	110474	5995	110382	5800	0.4717948717948718	19.03137931034483
chr4	CTBP1	1225359	1225566	2438	208	90974	5959	88536	5751	11.721153846153847	15.394887845592072
chr4	CTBP1	1241324	1241519	1444	196	90974	5959	89530	5763	7.36734693877551	15.535311469720632
chr4	CTBP1	1238182	1238337	10	156	90974	5959	90964	5803	0.0641025641025641	15.675340341202826
chr4	FAM53A	1644188	1644342	0	155	855	3942	855	3787	0.0	0.22577237919197254
chr4	SLBP	1703595	1703700	156	106	17551	1892	17395	1786	1.471698113207547	9.739641657334827
chr4	SLBP	1711873	1711990	22	118	17551	1892	17529	1774	0.1864406779661017	9.881059751972943
chr4	TMEM129	1717515	1717675	699	161	36563	3448	35864	3287	4.341614906832298	10.91086096744752
chr4	TMEM129	1717515	1717703	978	189	36563	3448	35585	3259	5.174603174603175	10.918993556305615
chr4	NELFA	1991543	1991715	15948	173	373039	5076	357091	4903	92.18497109826589	72.83112380175403
chr4	NELFA	1991543	1991730	15948	188	373039	5076	357091	4888	84.82978723404256	73.05462356792144
chr4	NELFA	2006997	2007199	0	203	373039	5076	373039	4873	0.0	76.5522265544839
chr4	NELFA	2007971	2008046	443	76	373039	5076	372596	5000	5.828947368421052	74.5192
chr4	NELFA	2007962	2008046	475	85	373039	5076	372564	4991	5.588235294117647	74.64716489681426
chr4	POLN	2176265	2176334	0	70	25609	5714	25609	5644	0.0	4.537384833451453
chr4	POLN	2131232	2131290	0	59	25609	5714	25609	5655	0.0	4.5285587975243144
chr4	POLN	2179307	2179465	0	159	25609	5714	25609	5555	0.0	4.61008100810081
chr4	HAUS3	2231834	2232160	7147	327	152924	9687	145777	9360	21.856269113149846	15.574465811965812
chr4	HAUS3	2241519	2241790	2409	272	152924	9687	150515	9415	8.856617647058824	15.98672331386086
chr4	HAUS3	2241519	2241781	1493	263	152924	9687	151431	9424	5.67680608365019	16.068654499151105
chr4	HAUS3	2241519	2241837	7204	319	152924	9687	145720	9368	22.58307210031348	15.555081127241674
chr4	MXD4	2255154	2255351	2420	198	172969	6880	170549	6682	12.222222222222221	25.523645615085304
chr4	MXD4	2258884	2259057	453	174	172969	6880	172516	6706	2.603448275862069	25.725618848792127
chr4	ZFYVE28	2335704	2335794	0	91	449	9633	449	9542	0.0	0.04705512471180046
chr4	ZFYVE28	2353932	2354073	0	142	449	9633	449	9491	0.0	0.047307975977241595
chr4	TNIP2	2744696	2744945	2131	250	15177	2658	13046	2408	8.524	5.417774086378738
chr4	MFSD10	2931554	2931663	53792	110	955023	2703	901231	2593	489.0181818181818	347.5630543771693
chr4	HTT-AS	3069977	3070173	196	197	298	2254	102	2057	0.9949238578680203	0.049586776859504134
chr4	LRPAP1	3516386	3516718	161576	333	304414	11827	142838	11494	485.21321321321324	12.427179397946755
chr4	FAM86EP	3947143	3948220	918	1078	2208	2974	1290	1896	0.8515769944341373	0.680379746835443
chr4	FAM86EP	3954959	3955033	0	75	2208	2974	2208	2899	0.0	0.7616419454984478
chr4	FAM86EP	3948089	3948220	51	132	2208	2974	2157	2842	0.38636363636363635	0.758972554539057
chr4	FAM86EP	3949447	3949549	300	103	2208	2974	1908	2871	2.912621359223301	0.664576802507837
chr4	FAM86EP	3951138	3951219	561	82	2208	2974	1647	2892	6.841463414634147	0.5695020746887967
chr4	FAM86EP	3949447	3949592	300	146	2208	2974	1908	2828	2.0547945205479454	0.6746817538896747
chr4	STX18	4425163	4425222	0	60	9789	5361	9789	5301	0.0	1.8466327108092813
chr4	CYTL1	5016835	5016964	3003	130	3003	993	0	863	23.1	0.0
chr4	CYTL1	5017134	5017179	0	46	3003	993	3003	947	0.0	3.171066525871172
chr4	EVC2	5708046	5708140	0	95	3584	5527	3584	5432	0.0	0.6597938144329897
chr4	CRMP1	5861025	5861210	0	186	45800	5869	45800	5683	0.0	8.059123702269927
chr4	JAKMIP1	6078938	6078998	0	61	51	3837	51	3776	0.0	0.01350635593220339
chr4	JAKMIP1	6105472	6105967	0	496	51	3837	51	3341	0.0	0.015264890751272074
chr4	JAKMIP1	6054747	6054803	0	57	51	3837	51	3780	0.0	0.013492063492063493
chr4	PPP2R2C	6378406	6378572	0	167	6842	8702	6842	8535	0.0	0.8016403046280024
chr4	LINC02482	6671429	6671502	0	74	1564	3288	1564	3214	0.0	0.4866210329807094
chr4	LINC02447	7097322	7097379	0	58	0	2543	0	2485	0.0	0.0
chr4	AFAP1	7781375	7781627	0	253	426318	10058	426318	9805	0.0	43.479653238143804
chr4	ABLIM2	8020201	8020303	0	103	51	5158	51	5055	0.0	0.010089020771513354
chr4	ABLIM2	8032647	8032680	0	34	51	5158	51	5124	0.0	0.009953161592505855
chr4	ABLIM2	8027758	8027857	0	100	51	5158	51	5058	0.0	0.010083036773428233
chr4	ABLIM2	8019617	8019671	0	55	51	5158	51	5103	0.0	0.009994121105232217
chr4	ACOX3	8373560	8373628	87	69	4121	3867	4034	3798	1.2608695652173914	1.0621379673512374
chr4	ACOX3	8416377	8416535	0	159	4121	3867	4121	3708	0.0	1.1113807982740023
chr4	AC108519.1	9151094	9151266	0	173	51	10108	51	9935	0.0	0.0051333668847508805
chr4	SLC2A9	9996780	9996941	0	162	0	6650	0	6488	0.0	0.0
chr4	SLC2A9	10040129	10040264	0	136	0	6650	0	6514	0.0	0.0
chr4	ZNF518B	10454804	10454988	836	185	137082	10919	136246	10734	4.518918918918919	12.692938326812
chr4	RAB28	13460698	13460828	306	131	11835	2232	11529	2101	2.33587786259542	5.487386958591147
chr4	RAB28	13369870	13369965	11094	96	11835	2232	741	2136	115.5625	0.34691011235955055
chr4	RAB28	13371794	13371867	0	74	11835	2232	11835	2158	0.0	5.484244670991659
chr4	LINC01097	13528921	13529102	204	182	204	2231	0	2049	1.120879120879121	0.0
chr4	BOD1L1	13572701	13572842	280	142	37507	15890	37227	15748	1.971830985915493	2.3639192278384558
chr4	BOD1L1	13623389	13626312	0	2924	37507	15890	37507	12966	0.0	2.892719420021595
chr4	LINC00504	14614279	14614416	0	138	153	5105	153	4967	0.0	0.03080330179182605
chr4	LINC00504	14716094	14716169	0	76	153	5105	153	5029	0.0	0.03042354344800159
chr4	CPEB2-DT	14990453	14990554	0	102	0	3100	0	2998	0.0	0.0
chr4	FBXL5	15640787	15640883	0	97	14535	4396	14535	4299	0.0	3.3810188415910676
chr4	FBXL5	15644492	15644708	0	217	14535	4396	14535	4179	0.0	3.478104809763101
chr4	FBXL5	15641523	15641627	0	105	14535	4396	14535	4291	0.0	3.3873223024935912
chr4	FBXL5	15644492	15644657	0	166	14535	4396	14535	4230	0.0	3.4361702127659575
chr4	FBXL5	15656228	15656342	1029	115	14535	4396	13506	4281	8.947826086956521	3.1548703573931323
chr4	PROM1	15979880	15979904	0	25	0	7501	0	7476	0.0	0.0
chr4	PROM1	15979394	15979463	0	70	0	7501	0	7431	0.0	0.0
chr4	PROM1	16035734	16035761	0	28	0	7501	0	7473	0.0	0.0
chr4	PROM1	16038945	16039001	0	57	0	7501	0	7444	0.0	0.0
chr4	PROM1	15980276	15980301	0	26	0	7501	0	7475	0.0	0.0
chr4	PROM1	16055236	16055449	0	214	0	7501	0	7287	0.0	0.0
chr4	TAPT1	16170652	16170729	561	78	18572	6756	18011	6678	7.1923076923076925	2.69706498951782
chr4	TAPT1	16213767	16213898	0	132	18572	6756	18572	6624	0.0	2.803743961352657
chr4	TAPT1	16202461	16202580	0	120	18572	6756	18572	6636	0.0	2.7986738999397227
chr4	TAPT1	16196657	16196723	0	67	18572	6756	18572	6689	0.0	2.776498729256989
chr4	LDB2	16505839	16505982	0	144	0	5476	0	5332	0.0	0.0
chr4	LDB2	16674199	16674319	0	121	0	5476	0	5355	0.0	0.0
chr4	LDB2	16752406	16752458	0	53	0	5476	0	5423	0.0	0.0
chr4	LINC02493	17181851	17181896	0	46	102	2097	102	2051	0.0	0.04973183812774257
chr4	QDPR	17490661	17490745	472	85	35962	3043	35490	2958	5.552941176470588	11.997971602434077
chr4	QDPR	17509270	17509363	51	94	35962	3043	35911	2949	0.5425531914893617	12.177348253645304
chr4	QDPR	17492231	17492340	12670	110	35962	3043	23292	2933	115.18181818181819	7.941356972383225
chr4	QDPR	17509933	17509975	0	43	35962	3043	35962	3000	0.0	11.987333333333334
chr4	AC006160.1	17588317	17588481	0	165	78912	2132	78912	1967	0.0	40.117946110828676
chr4	LCORL	17886067	17886161	0	95	197422	16931	197422	16836	0.0	11.726181990971726
chr4	LCORL	17909093	17909345	97	253	197422	16931	197325	16678	0.383399209486166	11.831454610864611
chr4	LCORL	17962969	17963049	0	81	197422	16931	197422	16850	0.0	11.716439169139466
chr4	LCORL	17873387	17878213	10353	4827	197422	16931	187069	12104	2.144810441267868	15.45513879709187
chr4	LCORL	17866998	17867025	0	28	197422	16931	197422	16903	0.0	11.679701828077857
chr4	LCORL	17884274	17884752	112	479	197422	16931	197310	16452	0.23382045929018788	11.993070751276441
chr4	LCORL	17960264	17960311	0	48	197422	16931	197422	16883	0.0	11.693537878339157
chr4	KCNIP4	20882607	20882709	0	103	67349	4251	67349	4148	0.0	16.236499517839924
chr4	KCNIP4	21762920	21763032	0	113	67349	4251	67349	4138	0.0	16.275737071048816
chr4	ADGRA3	22454865	22454937	0	73	65175	9289	65175	9216	0.0	7.071940104166667
chr4	PPARGC1A	23820434	23820638	0	205	102	10896	102	10691	0.0	0.00954073519782995
chr4	DHX15	24529600	24529770	26888	171	194478	8183	167590	8012	157.23976608187135	20.917373939091362
chr4	CCDC149	24821054	24821087	34	34	6337	9685	6303	9651	1.0	0.6530929437364004
chr4	CCDC149	24894991	24895118	0	128	6337	9685	6337	9557	0.0	0.6630741864601862
chr4	SEPSECS	25127263	25127357	705	95	26618	6251	25913	6156	7.421052631578948	4.209389213775179
chr4	SEPSECS	25158952	25159107	459	156	26618	6251	26159	6095	2.9423076923076925	4.291878589007383
chr4	SEPSECS	25159627	25159764	372	138	26618	6251	26246	6113	2.6956521739130435	4.293472926549976
chr4	SEPSECS	25159509	25159764	376	256	26618	6251	26242	5995	1.46875	4.377314428690576
chr4	SEL1L3	25757687	25757790	0	104	384	7498	384	7394	0.0	0.05193400054097917
chr4	SEL1L3	25847293	25847864	0	572	384	7498	384	6926	0.0	0.055443257291365865
chr4	AC016687.3	33811624	33811692	0	69	0	3625	0	3556	0.0	0.0
chr4	LINC02484	34121260	34121455	0	196	51	3792	51	3596	0.0	0.01418242491657397
chr4	LINC02505	36584664	36584796	0	133	0	2189	0	2056	0.0	0.0
chr4	LINC01258	38493992	38494098	0	107	0	2576	0	2469	0.0	0.0
chr4	KLF3-AS1	38625601	38625762	0	162	3199	6467	3199	6305	0.0	0.5073750991276764
chr4	KLF3-AS1	38635955	38636058	0	104	3199	6467	3199	6363	0.0	0.5027502750275028
chr4	KLF3-AS1	38620071	38620162	0	92	3199	6467	3199	6375	0.0	0.5018039215686274
chr4	KLF3-AS1	38625462	38625503	0	42	3199	6467	3199	6425	0.0	0.4978988326848249
chr4	TLR10	38775774	38775963	0	190	0	1194	0	1004	0.0	0.0
chr4	TLR10	38776109	38776426	0	318	0	1194	0	876	0.0	0.0
chr4	TLR1	38800856	38800948	0	93	330	4545	330	4452	0.0	0.07412398921832884
chr4	TLR1	38804305	38804382	0	78	330	4545	330	4467	0.0	0.07387508394895903
chr4	TLR1	38804753	38804787	0	35	330	4545	330	4510	0.0	0.07317073170731707
chr4	TLR6	38843638	38843791	0	154	446	1723	446	1569	0.0	0.28425748884639895
chr4	RFC1	39326562	39326640	0	79	25020	6752	25020	6673	0.0	3.7494380338678255
chr4	RFC1	39341486	39341665	0	180	25020	6752	25020	6572	0.0	3.807060255629945
chr4	RPL9	39458393	39458598	7559	206	512155	4943	504596	4737	36.69417475728155	106.52227147983956
chr4	RPL9	39458393	39458440	2974	48	512155	4943	509181	4895	61.958333333333336	104.02063329928498
chr4	RPL9	39458393	39458441	3035	49	512155	4943	509120	4894	61.93877551020408	104.02942378422559
chr4	UGDH	39510660	39510861	0	202	10220	3990	10220	3788	0.0	2.6979936642027456
chr4	UGDH	39521350	39521519	0	170	10220	3990	10220	3820	0.0	2.675392670157068
chr4	UGDH	39527052	39527119	0	68	10220	3990	10220	3922	0.0	2.6058133605303415
chr4	UGDH	39521350	39521544	0	195	10220	3990	10220	3795	0.0	2.6930171277997363
chr4	SMIM14	39556427	39556570	0	144	25763	3667	25763	3523	0.0	7.312801589554357
chr4	SMIM14	39572414	39572463	246	50	25763	3667	25517	3617	4.92	7.054741498479403
chr4	SMIM14	39611965	39612110	0	146	25763	3667	25763	3521	0.0	7.316955410394774
chr4	PDS5A	39910243	39910338	247	96	105406	12238	105159	12142	2.5729166666666665	8.660764289243946
chr4	RBM47	40436440	40436647	0	208	485	8557	485	8349	0.0	0.05809078931608576
chr4	RBM47	40437770	40438924	357	1155	485	8557	128	7402	0.3090909090909091	0.017292623615239124
chr4	RBM47	40436440	40436885	0	446	485	8557	485	8111	0.0	0.059795339662187155
chr4	RBM47	40455474	40455595	0	122	485	8557	485	8435	0.0	0.05749851807943094
chr4	RBM47	40544421	40544506	0	86	485	8557	485	8471	0.0	0.057254161256050054
chr4	APBB2	40935076	40935139	0	64	26951	11681	26951	11617	0.0	2.3199621244727555
chr4	APBB2	41033235	41033304	0	70	26951	11681	26951	11611	0.0	2.321160968047541
chr4	APBB2	41065575	41065673	0	99	26951	11681	26951	11582	0.0	2.3269728889656363
chr4	APBB2	40842369	40842375	0	7	26951	11681	26951	11674	0.0	2.308634572554394
chr4	APBB2	41138041	41138156	0	116	26951	11681	26951	11565	0.0	2.3303934284479033
chr4	ATP8A1	42485495	42485668	0	174	306	10764	306	10590	0.0	0.028895184135977338
chr4	ATP8A1	42569160	42569205	0	46	306	10764	306	10718	0.0	0.02855010263108789
chr4	ATP8A1	42590810	42590884	0	75	306	10764	306	10689	0.0	0.02862756104406399
chr4	ATP8A1	42594288	42594362	0	75	306	10764	306	10689	0.0	0.02862756104406399
chr4	AC114757.1	43981597	43981647	0	51	51	9122	51	9071	0.0	0.005622312865174733
chr4	AC114757.1	43993012	43993112	0	101	51	9122	51	9021	0.0	0.005653475224476222
chr4	AC114757.1	43992592	43993112	0	521	51	9122	51	8601	0.0	0.005929543076386466
chr4	AC114757.1	43992592	43992831	0	240	51	9122	51	8882	0.0	0.005741950011258726
chr4	YIPF7	44635921	44636085	0	165	0	1821	0	1656	0.0	0.0
chr4	GNPDA2	44718308	44718410	0	103	89964	2710	89964	2607	0.0	34.508630609896436
chr4	GNPDA2	44722083	44722242	0	160	89964	2710	89964	2550	0.0	35.28
chr4	GABRA2	46332614	46332682	0	69	0	16399	0	16330	0.0	0.0
chr4	GABRA2	46256194	46256374	0	181	0	16399	0	16218	0.0	0.0
chr4	COX7B2	46876638	46876737	0	100	0	822	0	722	0.0	0.0
chr4	COX7B2	46903875	46904014	0	140	0	822	0	682	0.0	0.0
chr4	GABRA4	46971082	46971235	0	154	0	11246	0	11092	0.0	0.0
chr4	GABRA4	46992827	46992946	0	120	0	11246	0	11126	0.0	0.0
chr4	CORIN	47653552	47653660	0	109	8641	9500	8641	9391	0.0	0.9201363007134491
chr4	CORIN	47680140	47680251	0	112	8641	9500	8641	9388	0.0	0.9204303365999148
chr4	CORIN	47786724	47786925	0	202	8641	9500	8641	9298	0.0	0.9293396429339643
chr4	NFXL1	47877011	47877191	668	181	4294	4518	3626	4337	3.6906077348066297	0.8360617938667282
chr4	CNGA1	47970895	47971100	0	206	1020	3603	1020	3397	0.0	0.3002649396526347
chr4	CNGA1	47981392	47981500	0	109	1020	3603	1020	3494	0.0	0.2919290211791643
chr4	TXK	48073934	48074053	0	120	1270	3481	1270	3361	0.0	0.3778637310324308
chr4	TXK	48076401	48076466	0	66	1270	3481	1270	3415	0.0	0.3718887262079063
chr4	TEC	48145078	48145295	816	218	6390	4023	5574	3805	3.743119266055046	1.4649145860709594
chr4	TEC	48163701	48163767	0	67	6390	4023	6390	3956	0.0	1.615267947421638
chr4	FRYL	48502827	48502845	0	19	17069	18237	17069	18218	0.0	0.9369305082885059
chr4	FRYL	48539970	48540068	0	99	17069	18237	17069	18138	0.0	0.941062961737788
chr4	FRYL	48561467	48561636	0	170	17069	18237	17069	18067	0.0	0.9447611667681408
chr4	FRYL	48684672	48684795	0	124	17069	18237	17069	18113	0.0	0.942361839562745
chr4	FRYL	48710518	48710698	0	181	17069	18237	17069	18056	0.0	0.9453367301727957
chr4	FRYL	48523487	48523496	0	10	17069	18237	17069	18227	0.0	0.9364678773248477
chr4	OCIAD2	48892771	48892889	0	119	2273	2490	2273	2371	0.0	0.9586672290172923
chr4	OCIAD2	48899828	48899925	1865	98	2273	2490	408	2392	19.03061224489796	0.1705685618729097
chr4	OCIAD2	48897803	48897857	0	55	2273	2490	2273	2435	0.0	0.9334702258726899
chr4	SGCB	52031864	52031961	0	98	0	4365	0	4267	0.0	0.0
chr4	SGCB	52031851	52031961	0	111	0	4365	0	4254	0.0	0.0
chr4	USP46	52631063	52631144	0	82	0	8909	0	8827	0.0	0.0
chr4	USP46	52656295	52656572	0	278	0	8909	0	8631	0.0	0.0
chr4	USP46	52658173	52658281	0	109	0	8909	0	8800	0.0	0.0
chr4	USP46	52629633	52629685	0	53	0	8909	0	8856	0.0	0.0
chr4	ERVMER34-1	52750709	52750829	0	121	23508	4027	23508	3906	0.0	6.018433179723503
chr4	SCFD2	52907456	52907591	0	136	673	3186	673	3050	0.0	0.22065573770491803
chr4	LNX1	53591387	53591515	0	129	21594	5644	21594	5515	0.0	3.915503173164098
chr4	CHIC2	54014062	54014119	0	58	102	1239	102	1181	0.0	0.0863674851820491
chr4	SRD5A3-AS1	55377606	55377770	0	165	0	4773	0	4608	0.0	0.0
chr4	SRD5A3-AS1	55369605	55369727	0	123	0	4773	0	4650	0.0	0.0
chr4	SRD5A3-AS1	55377606	55377836	0	231	0	4773	0	4542	0.0	0.0
chr4	SRD5A3-AS1	55382506	55382562	0	57	0	4773	0	4716	0.0	0.0
chr4	SRD5A3-AS1	55380795	55380879	0	85	0	4773	0	4688	0.0	0.0
chr4	SRD5A3-AS1	55383764	55383882	0	119	0	4773	0	4654	0.0	0.0
chr4	SRD5A3-AS1	55377606	55377786	0	181	0	4773	0	4592	0.0	0.0
chr4	SRD5A3-AS1	55383291	55383433	0	143	0	4773	0	4630	0.0	0.0
chr4	SRD5A3-AS1	55383291	55383359	0	69	0	4773	0	4704	0.0	0.0
chr4	SRD5A3-AS1	55387271	55387541	0	271	0	4773	0	4502	0.0	0.0
chr4	SRD5A3-AS1	55386702	55386890	0	189	0	4773	0	4584	0.0	0.0
chr4	SRD5A3-AS1	55393416	55393715	0	300	0	4773	0	4473	0.0	0.0
chr4	CLOCK	55509911	55510065	0	155	0	11559	0	11404	0.0	0.0
chr4	CLOCK	55486392	55486549	0	158	0	11559	0	11401	0.0	0.0
chr4	NMU	55605274	55605349	0	76	0	986	0	910	0.0	0.0
chr4	NMU	55607297	55607348	0	52	0	986	0	934	0.0	0.0
chr4	NMU	55616337	55616385	0	49	0	986	0	937	0.0	0.0
chr4	NMU	55607436	55607466	0	31	0	986	0	955	0.0	0.0
chr4	AASDH	56371450	56371643	0	194	4110	4669	4110	4475	0.0	0.9184357541899442
chr4	AASDH	56378147	56378464	0	318	4110	4669	4110	4351	0.0	0.9446104343829005
chr4	AASDH	56382476	56382597	35	122	4110	4669	4075	4547	0.28688524590163933	0.8961952936001759
chr4	AASDH	56384069	56384341	0	273	4110	4669	4110	4396	0.0	0.934940855323021
chr4	AASDH	56345126	56345290	16	165	4110	4669	4094	4504	0.09696969696969697	0.9089698046181173
chr4	PPAT	56403979	56404118	405	140	3964	4069	3559	3929	2.892857142857143	0.9058284550776279
chr4	HOPX	56650682	56650812	0	131	0	3242	0	3111	0.0	0.0
chr4	HOPX	56657774	56657899	0	126	0	3242	0	3116	0.0	0.0
chr4	HOPX	56676498	56676566	0	69	0	3242	0	3173	0.0	0.0
chr4	ADGRL3-AS1	62155941	62156041	0	101	0	958	0	857	0.0	0.0
chr4	ADGRL3-AS1	62127046	62127087	0	42	0	958	0	916	0.0	0.0
chr4	ADGRL3-AS1	62161746	62161863	0	118	0	958	0	840	0.0	0.0
chr4	TECRL	64281040	64281086	0	47	0	6035	0	5988	0.0	0.0
chr4	LINC02232	64939955	64940036	0	82	0	6375	0	6293	0.0	0.0
chr4	LINC02232	64977488	64977629	0	142	0	6375	0	6233	0.0	0.0
chr4	LINC02232	65008781	65008912	0	132	0	6375	0	6243	0.0	0.0
chr4	LINC02232	65004402	65004501	0	100	0	6375	0	6275	0.0	0.0
chr4	LINC02232	64939272	64939365	0	94	0	6375	0	6281	0.0	0.0
chr4	EPHA5	65376997	65377063	0	67	51	9851	51	9784	0.0	0.005212591986917416
chr4	AC104806.2	67419893	67420049	0	157	0	2410	0	2253	0.0	0.0
chr4	AC104806.2	67455458	67455565	0	108	0	2410	0	2302	0.0	0.0
chr4	CENPC	67510672	67511025	0	354	0	8516	0	8162	0.0	0.0
chr4	UBA6	67624125	67624253	0	129	51	10788	51	10659	0.0	0.004784688995215311
chr4	UBA6	67633344	67633473	0	130	51	10788	51	10658	0.0	0.004785137924563708
chr4	TMPRSS11D	67835082	67835121	0	40	102	3040	102	3000	0.0	0.034
chr4	TMPRSS11D	67842557	67842625	0	69	102	3040	102	2971	0.0	0.03433187478963312
chr4	TMPRSS11D	67859556	67859678	0	123	102	3040	102	2917	0.0	0.03496743229345218
chr4	TMPRSS11A	67924127	67924166	0	40	0	3961	0	3921	0.0	0.0
chr4	TMPRSS11GP	67994521	67994586	0	66	102	1279	102	1213	0.0	0.08408903544929926
chr4	TMPRSS11BNL	68185366	68185509	51	144	51	4327	0	4183	0.3541666666666667	0.0
chr4	TMPRSS11BNL	68212361	68212477	0	117	51	4327	51	4210	0.0	0.012114014251781473
chr4	YTHDC1	68332793	68332847	0	55	95619	7051	95619	6996	0.0	13.667667238421956
chr4	YTHDC1	68344048	68344080	0	33	95619	7051	95619	7018	0.0	13.624821886577372
chr4	UGT2A3	68943281	68943378	0	98	3468	3082	3468	2984	0.0	1.1621983914209115
chr4	UGT2B4	69485207	69485427	0	221	0	2514	0	2293	0.0	0.0
chr4	UGT2B4	69495140	69495410	0	271	0	2514	0	2243	0.0	0.0
chr4	UGT2A1	69596249	69596381	0	133	0	3689	0	3556	0.0	0.0
chr4	UGT2A1	69638898	69639528	0	631	0	3689	0	3058	0.0	0.0
chr4	UGT2A1	69635690	69635822	0	133	0	3689	0	3556	0.0	0.0
chr4	SULT1B1	69760207	69760250	0	44	234	7270	234	7226	0.0	0.03238306116800443
chr4	JCHAIN	70665859	70665886	0	28	0	1554	0	1526	0.0	0.0
chr4	JCHAIN	70664101	70664149	0	49	0	1554	0	1505	0.0	0.0
chr4	GRSF1	70831538	70831674	0	137	51	7579	51	7442	0.0	0.006852996506315507
chr4	GC	71746150	71746205	0	56	393	2110	393	2054	0.0	0.19133398247322297
chr4	GC	71752517	71752650	0	134	393	2110	393	1976	0.0	0.19888663967611336
chr4	GC	71754977	71755107	0	131	393	2110	393	1979	0.0	0.19858514401212735
chr4	COX18	73068028	73068129	0	102	0	6983	0	6881	0.0	0.0
chr4	COX18	73068028	73068133	0	106	0	6983	0	6877	0.0	0.0
chr4	ANKRD17	73139530	73140283	0	754	4318	12081	4318	11327	0.0	0.38121303081133573
chr4	ANKRD17	73147240	73147432	2010	193	4318	12081	2308	11888	10.414507772020725	0.19414535666218036
chr4	RASSF6	73582188	73582290	0	103	51	6644	51	6541	0.0	0.0077969729399174435
chr4	BTC	74750572	74750719	0	148	1538	2659	1538	2511	0.0	0.6125049780963759
chr4	RCHY1	75491610	75491637	0	28	0	5692	0	5664	0.0	0.0
chr4	RCHY1	75509176	75509296	0	121	0	5692	0	5571	0.0	0.0
chr4	RCHY1	75491582	75491637	0	56	0	5692	0	5636	0.0	0.0
chr4	G3BP2	75646337	75646456	51	120	408	11241	357	11121	0.425	0.032101429727542485
chr4	G3BP2	75647028	75647157	0	130	408	11241	408	11111	0.0	0.036720367203672034
chr4	G3BP2	75653982	75654081	0	100	408	11241	408	11141	0.0	0.03662148819675074
chr4	G3BP2	75656923	75657014	0	92	408	11241	408	11149	0.0	0.03659521033276527
chr4	G3BP2	75657556	75657730	0	175	408	11241	408	11066	0.0	0.03686969094523766
chr4	G3BP2	75658842	75658924	0	83	408	11241	408	11158	0.0	0.03656569277648324
chr4	G3BP2	75661930	75662049	0	120	408	11241	408	11121	0.0	0.036687348260048554
chr4	G3BP2	75662212	75662520	0	309	408	11241	408	10932	0.0	0.03732162458836443
chr4	G3BP2	75661930	75662073	0	144	408	11241	408	11097	0.0	0.03676669370100027
chr4	G3BP2	75654592	75654745	0	154	408	11241	408	11087	0.0	0.036799855686840445
chr4	G3BP2	75694797	75694929	0	133	408	11241	408	11108	0.0	0.036730284479654304
chr4	G3BP2	75694797	75695073	0	277	408	11241	408	10964	0.0	0.037212696096315216
chr4	G3BP2	75694792	75694929	0	138	408	11241	408	11103	0.0	0.03674682518238314
chr4	G3BP2	75724055	75724176	0	122	408	11241	408	11119	0.0	0.03669394729741883
chr4	G3BP2	75720876	75720969	0	94	408	11241	408	11147	0.0	0.03660177626267157
chr4	G3BP2	75662689	75662841	0	153	408	11241	408	11088	0.0	0.0367965367965368
chr4	G3BP2	75662765	75662841	0	77	408	11241	408	11164	0.0	0.03654604084557506
chr4	G3BP2	75646662	75646911	0	250	408	11241	408	10991	0.0	0.03712128104813029
chr4	G3BP2	75656923	75656962	0	40	408	11241	408	11201	0.0	0.03642531916793144
chr4	G3BP2	75662212	75662525	0	314	408	11241	408	10927	0.0	0.03733870229706232
chr4	G3BP2	75657800	75657893	0	94	408	11241	408	11147	0.0	0.03660177626267157
chr4	G3BP2	75657556	75657695	0	140	408	11241	408	11101	0.0	0.036753445635528334
chr4	G3BP2	75662381	75662525	0	145	408	11241	408	11096	0.0	0.03677000720980533
chr4	G3BP2	75713125	75713336	0	212	408	11241	408	11029	0.0	0.03699338108622722
chr4	G3BP2	75722196	75722244	0	49	408	11241	408	11192	0.0	0.036454610436025735
chr4	G3BP2	75722196	75722247	0	52	408	11241	408	11189	0.0	0.036464384663508806
chr4	PPEF2	75881330	75881985	0	656	0	4998	0	4342	0.0	0.0
chr4	NAAA	75918760	75918789	0	30	204	2984	204	2954	0.0	0.06905890318212593
chr4	NAAA	75914867	75914985	0	119	204	2984	204	2865	0.0	0.0712041884816754
chr4	SDAD1	75967276	75967334	0	59	107	3458	107	3399	0.0	0.0314798470138276
chr4	SDAD1	75974075	75974133	56	59	107	3458	51	3399	0.9491525423728814	0.01500441306266549
chr4	SDAD1	75977645	75977756	0	112	107	3458	107	3346	0.0	0.03197848176927675
chr4	NUP54	76124648	76124756	46	109	68	4007	22	3898	0.42201834862385323	0.005643919958953309
chr4	NUP54	76134174	76134362	0	189	68	4007	68	3818	0.0	0.0178103719224725
chr4	NUP54	76136185	76136412	0	228	68	4007	68	3779	0.0	0.01799417835406192
chr4	NUP54	76144148	76144292	0	145	68	4007	68	3862	0.0	0.017607457276022784
chr4	NUP54	76145554	76145577	0	24	68	4007	68	3983	0.0	0.017072558373085613
chr4	NUP54	76147478	76147640	0	163	68	4007	68	3844	0.0	0.01768990634755463
chr4	NUP54	76145982	76146129	0	148	68	4007	68	3859	0.0	0.01762114537444934
chr4	SCARB2	76175790	76175910	0	121	153	15139	153	15018	0.0	0.010187774670395526
chr4	SCARB2	76176436	76176528	0	93	153	15139	153	15046	0.0	0.010168815632061677
chr4	SCARB2	76180210	76180354	0	145	153	15139	153	14994	0.0	0.01020408163265306
chr4	SCARB2	76184656	76184780	0	125	153	15139	153	15014	0.0	0.010190488877048088
chr4	CCDC158	76396268	76396486	0	219	5201	5887	5201	5668	0.0	0.9176076217360621
chr4	CCDC158	76414260	76414364	550	105	5201	5887	4651	5782	5.238095238095238	0.8043929436181252
chr4	SHROOM3-AS1	76742807	76742900	0	94	306	4352	306	4258	0.0	0.07186472522310944
chr4	CCNI	77055149	77055380	9688	232	17077	4058	7389	3826	41.758620689655174	1.9312598013591218
chr4	CCNI	77066248	77066405	0	158	17077	4058	17077	3900	0.0	4.378717948717949
chr4	CNOT6L	77744717	77744875	0	159	0	9382	0	9223	0.0	0.0
chr4	PAQR3	78888060	78888148	0	89	0	7282	0	7193	0.0	0.0
chr4	PAQR3	78922828	78922983	0	156	0	7282	0	7126	0.0	0.0
chr4	PAQR3	78935120	78935283	0	164	0	7282	0	7118	0.0	0.0
chr4	PAQR3	78922140	78922421	0	282	0	7282	0	7000	0.0	0.0
chr4	PAQR3	78935120	78935176	0	57	0	7282	0	7225	0.0	0.0
chr4	PAQR3	78933075	78933231	0	157	0	7282	0	7125	0.0	0.0
chr4	NAA11	79294004	79294114	0	111	51	2722	51	2611	0.0	0.019532746074301034
chr4	ANTXR2	80024636	80024755	0	120	527	5611	527	5491	0.0	0.09597523219814241
chr4	PRKG2	81153429	81153555	0	127	2668	5137	2668	5010	0.0	0.5325349301397205
chr4	RASGEF1B	81457498	81457621	0	124	102	10205	102	10081	0.0	0.01011804384485666
chr4	HNRNPD	82356536	82356683	0	148	102	3903	102	3755	0.0	0.027163781624500664
chr4	HNRNPD	82371527	82371584	0	58	102	3903	102	3845	0.0	0.026527958387516256
chr4	HNRNPD	82354894	82355001	0	108	102	3903	102	3795	0.0	0.026877470355731226
chr4	HNRNPD	82359470	82359639	0	170	102	3903	102	3733	0.0	0.027323868202518083
chr4	HNRNPDL	82426462	82426633	0	172	0	4690	0	4518	0.0	0.0
chr4	HNRNPDL	82425562	82425667	0	106	0	4690	0	4584	0.0	0.0
chr4	TMEM150C	82509669	82509787	0	119	0	3507	0	3388	0.0	0.0
chr4	SEC31A	82821036	82821108	0	73	102	8631	102	8558	0.0	0.01191867258705305
chr4	SEC31A	82842139	82842481	0	343	102	8631	102	8288	0.0	0.012306949806949807
chr4	SEC31A	82861630	82861708	0	79	102	8631	102	8552	0.0	0.011927034611786716
chr4	SEC31A	82862533	82862572	0	40	102	8631	102	8591	0.0	0.011872890233965778
chr4	SEC31A	82880798	82880922	0	125	102	8631	102	8506	0.0	0.011991535386785799
chr4	SEC31A	82881857	82881940	0	84	102	8631	102	8547	0.0	0.011934011934011933
chr4	SEC31A	82830936	82830975	0	40	102	8631	102	8591	0.0	0.011872890233965778
chr4	SEC31A	82842184	82842481	0	298	102	8631	102	8333	0.0	0.012240489619584783
chr4	SEC31A	82881857	82881937	0	81	102	8631	102	8550	0.0	0.011929824561403509
chr4	SEC31A	82845200	82845293	0	94	102	8631	102	8537	0.0	0.01194799109757526
chr4	THAP9-AS1	82897988	82898062	0	75	0	4254	0	4179	0.0	0.0
chr4	THAP9-AS1	82899712	82899737	0	26	0	4254	0	4228	0.0	0.0
chr4	LIN54	82946257	82946474	0	218	51	3486	51	3268	0.0	0.015605875152998777
chr4	LIN54	82978882	82979006	0	125	51	3486	51	3361	0.0	0.01517405534067242
chr4	PLAC8	83107803	83107950	0	148	0	3797	0	3649	0.0	0.0
chr4	PLAC8	83104895	83105020	0	126	0	3797	0	3671	0.0	0.0
chr4	COQ2	83267089	83267208	578	120	16491	2785	15913	2665	4.816666666666666	5.9711069418386495
chr4	COQ2	83269859	83269993	2251	135	16491	2785	14240	2650	16.674074074074074	5.373584905660377
chr4	HPSE	83306202	83306317	0	116	121992	4700	121992	4584	0.0	26.612565445026178
chr4	HPSE	83310721	83310890	0	170	121992	4700	121992	4530	0.0	26.929801324503313
chr4	HPSE	83313113	83313287	0	175	121992	4700	121992	4525	0.0	26.959558011049722
chr4	HPSE	83308844	83308951	0	108	121992	4700	121992	4592	0.0	26.566202090592334
chr4	HELQ	83446834	83447035	0	202	54	3602	54	3400	0.0	0.01588235294117647
chr4	HELQ	83443516	83443614	0	99	54	3602	54	3503	0.0	0.015415358264344847
chr4	ABRAXAS1	83472221	83472288	0	68	103	7552	103	7484	0.0	0.013762693746659541
chr4	ABRAXAS1	83483991	83484166	0	176	103	7552	103	7376	0.0	0.013964208242950108
chr4	AC079160.1	84149218	84149256	0	39	454944	4984	454944	4945	0.0	92.00080889787664
chr4	AC079160.1	84148046	84148130	0	85	454944	4984	454944	4899	0.0	92.86466625842009
chr4	WDFY3	84726860	84726911	0	52	91	15989	91	15937	0.0	0.005709983058292025
chr4	WDFY3	84808333	84808417	0	85	91	15989	91	15904	0.0	0.005721830985915493
chr4	WDFY3	84932269	84932363	0	95	91	15989	91	15894	0.0	0.005725430980244117
chr4	WDFY3	84844455	84844509	0	55	91	15989	91	15934	0.0	0.005711058114723233
chr4	MAPK10	86098523	86098595	0	73	153	36649	153	36576	0.0	0.004183070866141733
chr4	MAPK10	86103185	86103244	0	60	153	36649	153	36589	0.0	0.00418158462926016
chr4	MAPK10	86159297	86159467	0	171	153	36649	153	36478	0.0	0.004194308898514173
chr4	MAPK10	86194335	86194407	0	73	153	36649	153	36576	0.0	0.004183070866141733
chr4	MAPK10	86354529	86354644	0	116	153	36649	153	36533	0.0	0.004187994416007445
chr4	MAPK10	86194308	86194407	0	100	153	36649	153	36549	0.0	0.004186161044077813
chr4	MAPK10	86029196	86029274	0	79	153	36649	153	36570	0.0	0.004183757178014766
chr4	MAPK10	86194318	86194407	0	90	153	36649	153	36559	0.0	0.004185016001531771
chr4	MAPK10	86089205	86089277	0	73	153	36649	153	36576	0.0	0.004183070866141733
chr4	MAPK10	86101051	86101217	0	167	153	36649	153	36482	0.0	0.004193849021435228
chr4	MAPK10	86453029	86453181	0	153	153	36649	153	36496	0.0	0.004192240245506357
chr4	MAPK10	86321843	86322029	0	187	153	36649	153	36462	0.0	0.004196149415830179
chr4	MAPK10	86399746	86399806	0	61	153	36649	153	36588	0.0	0.004181698917677927
chr4	MAPK10	86277049	86277223	0	175	153	36649	153	36474	0.0	0.004194768876459944
chr4	MAPK10	86194308	86194335	0	28	153	36649	153	36621	0.0	0.004177930695502581
chr4	MAPK10	86429677	86429805	0	129	153	36649	153	36520	0.0	0.004189485213581599
chr4	MAPK10	86029196	86029287	0	92	153	36649	153	36557	0.0	0.004185244959925596
chr4	MAPK10	86370713	86370867	0	155	153	36649	153	36494	0.0	0.004192469995067683
chr4	MAPK10	86335075	86335156	0	82	153	36649	153	36567	0.0	0.0041841004184100415
chr4	MAPK10	86040872	86040984	0	113	153	36649	153	36536	0.0	0.004187650536457193
chr4	MAPK10	86340338	86340423	0	86	153	36649	153	36563	0.0	0.004184558159888412
chr4	MAPK10	86356461	86356519	0	59	153	36649	153	36590	0.0	0.004181470347089369
chr4	MAPK10	86151990	86152196	0	207	153	36649	153	36442	0.0	0.004198452335217606
chr4	MAPK10	86151990	86152144	0	155	153	36649	153	36494	0.0	0.004192469995067683
chr4	MAPK10	86152462	86152629	0	168	153	36649	153	36481	0.0	0.004193963981250514
chr4	MAPK10	86352164	86352224	0	61	153	36649	153	36588	0.0	0.004181698917677927
chr4	MAPK10	86356665	86357052	0	388	153	36649	153	36261	0.0	0.004219409282700422
chr4	MAPK10	86090304	86090437	0	134	153	36649	153	36515	0.0	0.004190058879912365
chr4	MAPK10	86098523	86099285	0	763	153	36649	153	35886	0.0	0.004263501086774786
chr4	MAPK10	86332542	86332727	0	186	153	36649	153	36463	0.0	0.004196034336176398
chr4	MAPK10	86358207	86358312	0	106	153	36649	153	36543	0.0	0.004186848370412938
chr4	MAPK10	86308661	86308754	0	94	153	36649	153	36555	0.0	0.004185473943373
chr4	MAPK10	86384099	86384236	0	138	153	36649	153	36511	0.0	0.004190517926104462
chr4	MAPK10	86392313	86392432	0	120	153	36649	153	36529	0.0	0.0041884530099373105
chr4	SLC10A6	86827992	86828168	0	177	102	1629	102	1452	0.0	0.07024793388429752
chr4	AC093827.5	86932221	86932319	0	99	259	2486	259	2387	0.0	0.10850439882697947
chr4	C4ORF36	86890047	86890138	0	92	259	1920	259	1828	0.0	0.14168490153172866
chr4	C4ORF36	86890047	86890158	0	112	259	1920	259	1808	0.0	0.14325221238938052
chr4	KLHL8	87185250	87185799	0	550	102	6706	102	6156	0.0	0.016569200779727095
chr4	KLHL8	87185250	87185571	0	322	102	6706	102	6384	0.0	0.015977443609022556
chr4	KLHL8	87183202	87183389	0	188	102	6706	102	6518	0.0	0.01564897207732433
chr4	KLHL8	87195323	87195690	0	368	102	6706	102	6338	0.0	0.016093404859577155
chr4	HSD17B13	87318328	87318436	0	109	0	2384	0	2275	0.0	0.0
chr4	HSD17B11	87374698	87374830	0	133	145	2343	145	2210	0.0	0.06561085972850679
chr4	SPARCL1	87504821	87504923	0	103	0	3494	0	3391	0.0	0.0
chr4	SPARCL1	87497130	87497239	0	110	0	3494	0	3384	0.0	0.0
chr4	SPARCL1	87530544	87530631	0	88	0	3494	0	3406	0.0	0.0
chr4	SPARCL1	87528125	87528233	0	109	0	3494	0	3385	0.0	0.0
chr4	SPARCL1	87528554	87528614	0	61	0	3494	0	3433	0.0	0.0
chr4	ABCG2	88211665	88211803	0	139	10523	5621	10523	5482	0.0	1.9195549069682598
chr4	PPM1K	88265000	88265135	0	136	83516	10583	83516	10447	0.0	7.994256724418493
chr4	PPM1K	88278143	88278642	12037	500	83516	10583	71479	10083	24.074	7.089060795398195
chr4	PPM1K	88278535	88278642	999	108	83516	10583	82517	10475	9.25	7.877517899761337
chr4	FAM13A	88767982	88768059	0	78	2524	13191	2524	13113	0.0	0.19248074429955006
chr4	FAM13A	88805010	88805052	0	43	2524	13191	2524	13148	0.0	0.19196836020687558
chr4	FAM13A	88737471	88737555	0	85	2524	13191	2524	13106	0.0	0.19258354951930415
chr4	FAM13A	88990972	88991150	102	179	2524	13191	2422	13012	0.5698324022346368	0.18613587457731326
chr4	FAM13A	88790585	88790627	0	43	2524	13191	2524	13148	0.0	0.19196836020687558
chr4	SNCA	89828142	89828184	0	43	920	6216	920	6173	0.0	0.14903612506074843
chr4	SNCA	89729193	89729277	0	85	920	6216	920	6131	0.0	0.1500570869352471
chr4	SNCA	89836460	89836529	0	70	920	6216	920	6146	0.0	0.14969085584119754
chr4	SNCA	89836742	89836789	0	48	920	6216	920	6168	0.0	0.14915693904020752
chr4	UNC5C	95222209	95222266	0	58	4289	10703	4289	10645	0.0	0.4029121653358384
chr4	TSPAN5	98484384	98484441	0	58	102	5216	102	5158	0.0	0.019775106630476928
chr4	TSPAN5	98484398	98484598	0	201	102	5216	102	5015	0.0	0.020338983050847456
chr4	EIF4E	98884921	98885061	0	141	0	13445	0	13304	0.0	0.0
chr4	EIF4E	98909677	98909959	0	283	0	13445	0	13162	0.0	0.0
chr4	EIF4E	98886453	98886546	0	94	0	13445	0	13351	0.0	0.0
chr4	ADH5	99081974	99082116	0	143	0	4877	0	4734	0.0	0.0
chr4	ADH5	99082001	99082116	0	116	0	4877	0	4761	0.0	0.0
chr4	ADH5	99079819	99079991	0	173	0	4877	0	4704	0.0	0.0
chr4	ADH4	99127208	99127344	0	137	103	2447	103	2310	0.0	0.04458874458874459
chr4	ADH4	99143165	99143305	0	141	103	2447	103	2306	0.0	0.04466608846487424
chr4	ADH4	99143043	99143071	0	29	103	2447	103	2418	0.0	0.04259718775847808
chr4	ADH4	99143165	99143379	0	215	103	2447	103	2232	0.0	0.04614695340501792
chr4	ADH6	99210081	99210298	0	218	255	4148	255	3930	0.0	0.0648854961832061
chr4	ADH6	99213605	99213747	0	143	255	4148	255	4005	0.0	0.06367041198501873
chr4	ADH6	99207445	99207581	0	137	255	4148	255	4011	0.0	0.06357516828721017
chr4	ADH1B	99320792	99320914	0	123	13218	7188	13218	7065	0.0	1.8709129511677283
chr4	ADH1C	99347744	99347846	357	103	357	1584	0	1481	3.466019417475728	0.0
chr4	ADH1C	99351012	99351132	0	121	357	1584	357	1463	0.0	0.24401913875598086
chr4	ADH7	99432618	99432731	0	114	4510	3120	4510	3006	0.0	1.5003326679973386
chr4	LAMTOR3	99893954	99894000	0	47	255	4171	255	4124	0.0	0.061833171677982544
chr4	DNAJB14	99930449	99930621	0	173	1620	9371	1620	9198	0.0	0.1761252446183953
chr4	DNAJB14	99924759	99924815	0	57	1620	9371	1620	9314	0.0	0.17393171569680052
chr4	DNAJB14	99928541	99928617	0	77	1620	9371	1620	9294	0.0	0.17430600387346676
chr4	DNAJB14	99906037	99906153	0	117	1620	9371	1620	9254	0.0	0.17505943375837477
chr4	DNAJB14	99910348	99910375	0	28	1620	9371	1620	9343	0.0	0.17339184416140427
chr4	DNAJB14	99927716	99927838	0	123	1620	9371	1620	9248	0.0	0.17517301038062283
chr4	EMCN	100447532	100447571	0	40	1784	5193	1784	5153	0.0	0.346206093537745
chr4	PPP3CA	101029165	101029195	0	31	0	5231	0	5200	0.0	0.0
chr4	PPP3CA	101063231	101063357	0	127	0	5231	0	5104	0.0	0.0
chr4	PPP3CA	101195915	101196116	0	202	0	5231	0	5029	0.0	0.0
chr4	PPP3CA	101108073	101108161	0	89	0	5231	0	5142	0.0	0.0
chr4	PPP3CA	101171083	101171226	0	144	0	5231	0	5087	0.0	0.0
chr4	SLC39A8	102307435	102307605	0	171	15750	6496	15750	6325	0.0	2.4901185770750986
chr4	SLC39A8	102344443	102344915	0	473	15750	6496	15750	6023	0.0	2.6149759256184626
chr4	AC098487.1	102419696	102419794	0	99	51	998	51	899	0.0	0.05672969966629588
chr4	AC098487.1	102419263	102419359	0	97	51	998	51	901	0.0	0.05660377358490566
chr4	AC098487.1	102430396	102430498	0	103	51	998	51	895	0.0	0.05698324022346369
chr4	MANBA	102722870	102723041	0	172	61	8306	61	8134	0.0	0.00749938529628719
chr4	MANBA	102633250	102633473	0	224	61	8306	61	8082	0.0	0.007547636723583271
chr4	MANBA	102670915	102671011	0	97	61	8306	61	8209	0.0	0.0074308685588987695
chr4	MANBA	102658858	102659028	0	171	61	8306	61	8135	0.0	0.007498463429625077
chr4	MANBA	102667819	102668031	0	213	61	8306	61	8093	0.0	0.007537377980971209
chr4	MANBA	102679610	102679709	0	100	61	8306	61	8206	0.0	0.007433585181574458
chr4	MANBA	102672008	102672146	0	139	61	8306	61	8167	0.0	0.007469082894575731
chr4	MANBA	102671892	102672054	0	163	61	8306	61	8143	0.0	0.007491096647427238
chr4	MANBA	102672008	102672054	0	47	61	8306	61	8259	0.0	0.007385882068046979
chr4	MANBA	102753822	102753995	0	174	61	8306	61	8132	0.0	0.00750122970978849
chr4	UBE2D3	102798927	102798977	0	51	51	9483	51	9432	0.0	0.005407124681933842
chr4	UBE2D3	102826484	102826636	0	153	51	9483	51	9330	0.0	0.005466237942122186
chr4	UBE2D3	102825238	102825317	0	80	51	9483	51	9403	0.0	0.005423800914601723
chr4	UBE2D3	102809067	102809159	0	93	51	9483	51	9390	0.0	0.005431309904153354
chr4	UBE2D3	102826484	102826619	0	136	51	9483	51	9347	0.0	0.0054562961377982245
chr4	UBE2D3	102809067	102809184	0	118	51	9483	51	9365	0.0	0.005445808862786973
chr4	UBE2D3	102827591	102827741	0	151	51	9483	51	9332	0.0	0.00546506643806258
chr4	SLC9B1	102945192	102945320	0	129	0	2968	0	2839	0.0	0.0
chr4	SLC9B1	102949256	102949427	0	172	0	2968	0	2796	0.0	0.0
chr4	SLC9B1	102912007	102912129	0	123	0	2968	0	2845	0.0	0.0
chr4	SLC9B1	102989799	102989941	0	143	0	2968	0	2825	0.0	0.0
chr4	SLC9B1	102905513	102905650	0	138	0	2968	0	2830	0.0	0.0
chr4	SLC9B2	103028746	103028883	0	138	51	8631	51	8493	0.0	0.006004945249028612
chr4	SLC9B2	103057800	103057971	0	172	51	8631	51	8459	0.0	0.00602908145170824
chr4	BDH2	103091619	103091737	0	119	51	5225	51	5106	0.0	0.0099882491186839
chr4	BDH2	103097635	103097754	0	120	51	5225	51	5105	0.0	0.00999020568070519
chr4	BDH2	103098643	103098802	0	160	51	5225	51	5065	0.0	0.010069101678183614
chr4	CENPE	103195113	103195233	0	121	34267	9977	34267	9856	0.0	3.4767654220779223
chr4	CENPE	103163478	103163553	0	76	34267	9977	34267	9901	0.0	3.460963539036461
chr4	AC105460.1	103556946	103557234	12829	289	93515	2274	80686	1985	44.391003460207614	40.64785894206549
chr4	AC105460.1	103556965	103557234	12829	270	93515	2274	80686	2004	47.51481481481481	40.262475049900196
chr4	AC105460.1	103552025	103552152	0	128	93515	2274	93515	2146	0.0	43.57642124883504
chr4	PPA2	105437949	105438036	0	88	0	4491	0	4403	0.0	0.0
chr4	PPA2	105449349	105449403	0	55	0	4491	0	4436	0.0	0.0
chr4	PPA2	105456680	105456745	0	66	0	4491	0	4425	0.0	0.0
chr4	PPA2	105424195	105424322	0	128	0	4491	0	4363	0.0	0.0
chr4	PPA2	105456247	105456291	0	45	0	4491	0	4446	0.0	0.0
chr4	PPA2	105453597	105453642	0	46	0	4491	0	4445	0.0	0.0
chr4	PPA2	105456695	105456745	0	51	0	4491	0	4440	0.0	0.0
chr4	PPA2	105447994	105448093	0	100	0	4491	0	4391	0.0	0.0
chr4	INTS12	105705689	105705949	0	261	51	3907	51	3646	0.0	0.013987931980252331
chr4	INTS12	105703647	105703809	0	163	51	3907	51	3744	0.0	0.013621794871794872
chr4	INTS12	105702885	105703023	0	139	51	3907	51	3768	0.0	0.013535031847133758
chr4	INTS12	105707918	105708162	0	245	51	3907	51	3662	0.0	0.013926815947569634
chr4	GSTCD-AS1	105821058	105821194	0	137	0	835	0	698	0.0	0.0
chr4	GSTCD-AS1	105826111	105826122	0	12	0	835	0	823	0.0	0.0
chr4	TBCK	106194717	106194754	33	38	2156	10864	2123	10826	0.868421052631579	0.1961019767227046
chr4	TBCK	106254946	106255047	0	102	2156	10864	2156	10762	0.0	0.20033451031406802
chr4	TBCK	106237490	106237538	0	49	2156	10864	2156	10815	0.0	0.19935275080906148
chr4	TBCK	106251078	106251194	0	117	2156	10864	2156	10747	0.0	0.20061412487205732
chr4	TBCK	106309926	106309967	0	42	2156	10864	2156	10822	0.0	0.19922380336351875
chr4	DKK2	107127941	107128009	0	69	1412	4341	1412	4272	0.0	0.33052434456928836
chr4	CYP2U1-AS1	107887081	107887230	0	150	153	6869	153	6719	0.0	0.022771245721089448
chr4	CYP2U1-AS1	107866907	107867645	0	739	153	6869	153	6130	0.0	0.024959216965742253
chr4	CYP2U1-AS1	107874844	107874892	0	49	153	6869	153	6820	0.0	0.022434017595307918
chr4	LEF1	108089124	108089257	0	134	0	5235	0	5101	0.0	0.0
chr4	LEF1	108063622	108063663	0	42	0	5235	0	5193	0.0	0.0
chr4	LEF1	108081585	108081669	0	85	0	5235	0	5150	0.0	0.0
chr4	LEF1	108063622	108063657	0	36	0	5235	0	5199	0.0	0.0
chr4	RPL34-DT	108608522	108608650	0	129	10404	4579	10404	4450	0.0	2.337977528089888
chr4	ETNPPL	108759748	108759890	0	143	167	2934	167	2791	0.0	0.05983518452167682
chr4	ETNPPL	108759748	108759908	0	161	167	2934	167	2773	0.0	0.06022358456545258
chr4	ETNPPL	108760187	108760306	0	120	167	2934	167	2814	0.0	0.059346126510305616
chr4	COL25A1	108819251	108819329	0	79	14410	6485	14410	6406	0.0	2.249453637215111
chr4	COL25A1	108825195	108825222	0	28	14410	6485	14410	6457	0.0	2.2316865417376492
chr4	COL25A1	108852901	108852925	8	25	14410	6485	14402	6460	0.32	2.2294117647058824
chr4	COL25A1	108862500	108862545	0	46	14410	6485	14410	6439	0.0	2.2379251436558474
chr4	COL25A1	108819811	108819898	17	88	14410	6485	14393	6397	0.19318181818181818	2.249960919180866
chr4	COL25A1	108838097	108838178	0	82	14410	6485	14410	6403	0.0	2.250507574574418
chr4	COL25A1	108834354	108834390	176	37	14410	6485	14234	6448	4.756756756756757	2.207506203473945
chr4	SEC24B-AS1	109382248	109382419	0	172	51	5559	51	5387	0.0	0.00946723593837015
chr4	SEC24B-AS1	109430579	109430760	0	182	51	5559	51	5377	0.0	0.009484842849172401
chr4	SEC24B-AS1	109405649	109405773	0	125	51	5559	51	5434	0.0	0.009385351490614648
chr4	SEC24B-AS1	109430579	109430780	0	202	51	5559	51	5357	0.0	0.009520253873436624
chr4	CASP6	109696409	109696486	0	78	0	1950	0	1872	0.0	0.0
chr4	PLA2G12A	109718682	109718759	0	78	8466	5225	8466	5147	0.0	1.6448416553332037
chr4	CFI	109757762	109757783	0	22	0	4871	0	4849	0.0	0.0
chr4	PLA2G12A	109718688	109718759	0	72	8466	5225	8466	5153	0.0	1.6429264506112944
chr4	CFI	109757935	109757959	0	25	0	4871	0	4846	0.0	0.0
chr4	ELOVL6	110093105	110093134	0	30	51	7282	51	7252	0.0	0.007032542746828461
chr4	PITX2	110632342	110632480	5269	139	34309	5796	29040	5657	37.906474820143885	5.133462966236521
chr4	PITX2	110634157	110634391	8642	235	34309	5796	25667	5561	36.774468085106385	4.615536773961518
chr4	PITX2	110636780	110638154	0	1375	34309	5796	34309	4421	0.0	7.760461434064691
chr4	ZGRF1	112548252	112548380	0	129	0	9135	0	9006	0.0	0.0
chr4	ZGRF1	112628620	112628851	0	232	0	9135	0	8903	0.0	0.0
chr4	ZGRF1	112629758	112630015	0	258	0	9135	0	8877	0.0	0.0
chr4	MIR302CHG	112647414	112647467	0	54	0	748	0	694	0.0	0.0
chr4	CAMK2D	113455725	113455821	0	97	1310	7387	1310	7290	0.0	0.17969821673525377
chr4	CAMK2D	113504975	113505035	0	61	1310	7387	1310	7326	0.0	0.1788151788151788
chr4	CAMK2D	113508235	113508268	0	34	1310	7387	1310	7353	0.0	0.17815857473140215
chr4	CAMK2D	113502935	113502977	0	43	1310	7387	1310	7344	0.0	0.17837690631808278
chr4	ARSJ	113906664	113906745	0	82	0	4875	0	4793	0.0	0.0
chr4	NDST4	115076058	115077282	0	1225	982	3735	982	2510	0.0	0.3912350597609562
chr4	NDST4	114842675	114842773	0	99	982	3735	982	3636	0.0	0.2700770077007701
chr4	NDST4	114977186	114977274	0	89	982	3735	982	3646	0.0	0.26933625891387825
chr4	LINC02262	117351192	117351238	0	47	0	2351	0	2304	0.0	0.0
chr4	LINC02262	117321311	117321363	0	53	0	2351	0	2298	0.0	0.0
chr4	PRSS12	118294938	118295061	0	124	0	5485	0	5361	0.0	0.0
chr4	METTL14-DT	118678043	118678138	0	96	204	7533	204	7437	0.0	0.02743041549011698
chr4	SEC24D	118817263	118817412	0	150	153	9953	153	9803	0.0	0.01560746710190758
chr4	SEC24D	118825440	118825618	0	179	153	9953	153	9774	0.0	0.01565377532228361
chr4	SEC24D	118766528	118766823	0	296	153	9953	153	9657	0.0	0.015843429636533086
chr4	SEC24D	118816743	118816850	0	108	153	9953	153	9845	0.0	0.015540883697308279
chr4	GTF2IP12	119410516	119410658	0	143	13891	10047	13891	9904	0.0	1.4025646203554119
chr4	GTF2IP12	119429419	119429609	0	191	13891	10047	13891	9856	0.0	1.4093952922077921
chr4	GTF2IP12	119444873	119445027	0	155	13891	10047	13891	9892	0.0	1.404266073594824
chr4	GTF2IP12	119410516	119410712	0	197	13891	10047	13891	9850	0.0	1.410253807106599
chr4	LINC01365	119801351	119801394	0	44	0	747	0	703	0.0	0.0
chr4	LINC01365	119800128	119800280	0	153	0	747	0	594	0.0	0.0
chr4	MAD2L1	120061974	120062095	0	122	0	5522	0	5400	0.0	0.0
chr4	MAD2L1	120065671	120065818	0	148	0	5522	0	5374	0.0	0.0
chr4	PRDM5	120754552	120754638	0	87	39	9538	39	9451	0.0	0.0041265474552957355
chr4	PRDM5	120816831	120816924	0	94	39	9538	39	9444	0.0	0.004129606099110546
chr4	PRDM5	120812550	120812814	0	265	39	9538	39	9273	0.0	0.0042057586541572305
chr4	TNIP3	121138623	121138684	0	62	0	3766	0	3704	0.0	0.0
chr4	QRFPR	121334488	121334619	0	132	0	2837	0	2705	0.0	0.0
chr4	ANXA5	121684676	121684771	0	96	153	2700	153	2604	0.0	0.0587557603686636
chr4	ANXA5	121696580	121696624	0	45	153	2700	153	2655	0.0	0.0576271186440678
chr4	ANXA5	121686287	121686372	0	86	153	2700	153	2614	0.0	0.058530986993114
chr4	TRPC3	121914779	121914944	0	166	51	9224	51	9058	0.0	0.0056303819827776555
chr4	TRPC3	121930770	121930828	0	59	51	9224	51	9165	0.0	0.005564648117839607
chr4	CETN4P	122730819	122731683	41951	865	67841	3670	25890	2805	48.49826589595376	9.229946524064172
chr4	CETN4P	122732051	122732193	265	143	67841	3670	67576	3527	1.8531468531468531	19.159625744258577
chr4	NUDT6	122897623	122897678	0	56	0	1904	0	1848	0.0	0.0
chr4	LINC02516	124541129	124541214	0	86	0	2620	0	2534	0.0	0.0
chr4	ANKRD50	124709999	124711274	0	1276	102	8803	102	7527	0.0	0.013551215623754484
chr4	AC093772.1	127411306	127411434	0	129	0	2660	0	2531	0.0	0.0
chr4	AC097462.3	127557077	127557183	0	107	0	3935	0	3828	0.0	0.0
chr4	MFSD8	127921859	127921963	0	105	0	7255	0	7150	0.0	0.0
chr4	MFSD8	127930682	127930817	0	136	0	7255	0	7119	0.0	0.0
chr4	MFSD8	127938782	127938838	0	57	0	7255	0	7198	0.0	0.0
chr4	MFSD8	127939852	127939997	0	146	0	7255	0	7109	0.0	0.0
chr4	MFSD8	127942044	127942158	0	115	0	7255	0	7140	0.0	0.0
chr4	MFSD8	127943751	127943992	0	242	0	7255	0	7013	0.0	0.0
chr4	MFSD8	127949803	127949847	0	45	0	7255	0	7210	0.0	0.0
chr4	MFSD8	127965071	127965208	0	138	0	7255	0	7117	0.0	0.0
chr4	MFSD8	127921859	127921982	0	124	0	7255	0	7131	0.0	0.0
chr4	MFSD8	127939480	127939601	0	122	0	7255	0	7133	0.0	0.0
chr4	MFSD8	127921117	127921198	0	82	0	7255	0	7173	0.0	0.0
chr4	MFSD8	127938782	127938836	0	55	0	7255	0	7200	0.0	0.0
chr4	MFSD8	127965071	127965222	0	152	0	7255	0	7103	0.0	0.0
chr4	SCLT1	128965226	128965318	0	93	12956	9011	12956	8918	0.0	1.4527921058533304
chr4	SCLT1	128942995	128943188	0	194	12956	9011	12956	8817	0.0	1.4694340478620846
chr4	LINC02466	129696291	129696350	0	60	3986	3930	3986	3870	0.0	1.0299741602067183
chr4	LINC02466	129746234	129746277	0	44	3986	3930	3986	3886	0.0	1.0257334019557385
chr4	LINC02466	129744307	129744379	0	73	3986	3930	3986	3857	0.0	1.0334456831734509
chr4	LINC02466	129725600	129725789	0	190	3986	3930	3986	3740	0.0	1.0657754010695186
chr4	LINC02466	129744307	129744523	48	217	3986	3930	3938	3713	0.22119815668202766	1.060597899272825
chr4	AC105383.1	133140585	133140659	0	75	0	11465	0	11390	0.0	0.0
chr4	AC105383.1	133145603	133145745	0	143	0	11465	0	11322	0.0	0.0
chr4	AC105383.1	133140585	133140656	0	72	0	11465	0	11393	0.0	0.0
chr4	AC105383.1	133140469	133140511	0	43	0	11465	0	11422	0.0	0.0
chr4	AC105383.1	133110785	133110910	0	126	0	11465	0	11339	0.0	0.0
chr4	AC105383.1	133097639	133097724	0	86	0	11465	0	11379	0.0	0.0
chr4	AC015631.1	134166485	134166648	0	164	0	8668	0	8504	0.0	0.0
chr4	AC015631.1	134156377	134156552	0	176	0	8668	0	8492	0.0	0.0
chr4	AC015631.1	134156426	134156552	0	127	0	8668	0	8541	0.0	0.0
chr4	AC015631.1	134326545	134326640	0	96	0	8668	0	8572	0.0	0.0
chr4	LINC02511	136813649	136813731	0	83	50	3399	50	3316	0.0	0.015078407720144753
chr4	LINC02511	136916174	136916226	0	53	50	3399	50	3346	0.0	0.014943215780035863
chr4	LINC02511	137097717	137097807	0	91	50	3399	50	3308	0.0	0.015114873035066506
chr4	LINC02511	137089986	137090041	0	56	50	3399	50	3343	0.0	0.014956625785222853
chr4	PCDH18	137529601	137531742	0	2142	51	6690	51	4548	0.0	0.011213720316622692
chr4	LINC00616	138098158	138098272	0	115	0	6060	0	5945	0.0	0.0
chr4	LINC00616	138095283	138095420	0	138	0	6060	0	5922	0.0	0.0
chr4	LINC00616	138048379	138048606	0	228	0	6060	0	5832	0.0	0.0
chr4	LINC00616	138032172	138032516	0	345	0	6060	0	5715	0.0	0.0
chr4	LINC00616	138028592	138028702	0	111	0	6060	0	5949	0.0	0.0
chr4	LINC00616	138098452	138098513	0	62	0	6060	0	5998	0.0	0.0
chr4	LINC00616	138097968	138098272	0	305	0	6060	0	5755	0.0	0.0
chr4	LINC00616	138095283	138095418	0	136	0	6060	0	5924	0.0	0.0
chr4	LINC00616	138047940	138047977	0	38	0	6060	0	6022	0.0	0.0
chr4	LINC00616	138083368	138083433	0	66	0	6060	0	5994	0.0	0.0
chr4	SLC7A11	138182296	138182393	0	98	0	9657	0	9559	0.0	0.0
chr4	SLC7A11	138185120	138185244	0	125	0	9657	0	9532	0.0	0.0
chr4	ELF2	139067683	139067770	0	88	1001	8575	1001	8487	0.0	0.1179450924944032
chr4	NDUFC1	139292529	139292609	0	81	0	2585	0	2504	0.0	0.0
chr4	NDUFC1	139297384	139297443	0	60	0	2585	0	2525	0.0	0.0
chr4	NDUFC1	139296331	139296367	0	37	0	2585	0	2548	0.0	0.0
chr4	AC097376.3	139419869	139419923	0	55	0	4044	0	3989	0.0	0.0
chr4	SETD7	139548018	139548119	0	102	357	13932	357	13830	0.0	0.025813449023861172
chr4	SETD7	139606359	139606456	0	98	357	13932	357	13834	0.0	0.025805985253722713
chr4	MAML3	139889356	139890967	0	1612	0	6988	0	5376	0.0	0.0
chr4	SCOC-AS1	140289592	140290119	1632	528	33574	4236	31942	3708	3.090909090909091	8.614347357065803
chr4	SCOC-AS1	140362709	140362818	0	110	33574	4236	33574	4126	0.0	8.13717886572952
chr4	CLGN	140426703	140426787	0	85	29808	2838	29808	2753	0.0	10.827460951689066
chr4	MGAT4D	140471774	140471821	0	48	408	2816	408	2768	0.0	0.14739884393063585
chr4	MGAT4D	140474812	140474946	0	135	408	2816	408	2681	0.0	0.15218202163371877
chr4	MGAT4D	140482326	140482485	0	160	408	2816	408	2656	0.0	0.1536144578313253
chr4	RNF150	140996957	140997034	0	78	306	11023	306	10945	0.0	0.027957971676564643
chr4	INPP4B	142467956	142468055	0	100	899	14202	899	14102	0.0	0.06374982272018154
chr4	INPP4B	142096084	142096193	0	110	899	14202	899	14092	0.0	0.06379506102753335
chr4	INPP4B	142347373	142347556	0	184	899	14202	899	14018	0.0	0.06413183050363817
chr4	INPP4B	142383961	142384116	0	156	899	14202	899	14046	0.0	0.0640039869001851
chr4	INPP4B	142423695	142423817	0	123	899	14202	899	14079	0.0	0.06385396690105831
chr4	INPP4B	142660776	142660896	0	121	899	14202	899	14081	0.0	0.06384489737944748
chr4	GYPB	143997539	143997558	0	20	0	1716	0	1696	0.0	0.0
chr4	GYPB	144001184	144001283	0	100	0	1716	0	1616	0.0	0.0
chr4	GYPB	143997539	143997634	0	96	0	1716	0	1620	0.0	0.0
chr4	GYPB	144016801	144016884	0	84	0	1716	0	1632	0.0	0.0
chr4	GYPB	144002570	144002694	0	125	0	1716	0	1591	0.0	0.0
chr4	GYPB	143999410	143999449	0	40	0	1716	0	1676	0.0	0.0
chr4	GYPB	144000382	144000475	0	94	0	1716	0	1622	0.0	0.0
chr4	GYPB	144008391	144008449	0	59	0	1716	0	1657	0.0	0.0
chr4	GYPA	144114688	144114767	0	80	16240	4262	16240	4182	0.0	3.8833094213295074
chr4	GYPA	144118713	144118752	0	40	16240	4262	16240	4222	0.0	3.8465182378019898
chr4	GYPA	144119685	144119781	357	97	16240	4262	15883	4165	3.6804123711340204	3.8134453781512607
chr4	GYPA	144120489	144120588	0	100	16240	4262	16240	4162	0.0	3.901970206631427
chr4	AC098588.3	144213068	144213117	0	50	4346	1918	4346	1868	0.0	2.3265524625267666
chr4	GYPA	144127877	144128035	612	159	16240	4262	15628	4103	3.849056603773585	3.8089203022178895
chr4	GYPA	144138160	144138340	0	181	16240	4262	16240	4081	0.0	3.979416809605489
chr4	GYPA	144138160	144138243	0	84	16240	4262	16240	4178	0.0	3.887027285782671
chr4	GYPA	144116853	144116939	3989	87	16240	4262	12251	4175	45.85057471264368	2.93437125748503
chr4	GYPA	144122871	144122989	0	119	16240	4262	16240	4143	0.0	3.919864832247164
chr4	HHIP-AS1	144645287	144645467	0	181	0	2159	0	1978	0.0	0.0
chr4	HHIP-AS1	144652701	144652776	0	76	0	2159	0	2083	0.0	0.0
chr4	ANAPC10	145095984	145096111	0	128	8057	4412	8057	4284	0.0	1.880718954248366
chr4	ANAPC10	145064571	145064692	0	122	8057	4412	8057	4290	0.0	1.878088578088578
chr4	ANAPC10	145097687	145097760	0	74	8057	4412	8057	4338	0.0	1.8573075149838636
chr4	ANAPC10	145097494	145097562	0	69	8057	4412	8057	4343	0.0	1.8551692378540179
chr4	OTUD4	145178513	145178570	0	58	538	9541	538	9483	0.0	0.05673310133923864
chr4	LINC02266	145336204	145336288	0	85	0	1730	0	1645	0.0	0.0
chr4	ZNF827	145763401	145763468	0	68	5491	16799	5491	16731	0.0	0.3281931743470205
chr4	ZNF827	145763089	145763122	0	34	5491	16799	5491	16765	0.0	0.32752758723531167
chr4	ZNF827	145902165	145903215	1734	1051	5491	16799	3757	15748	1.6498572787821122	0.2385699771399543
chr4	ZNF827	145763089	145763117	0	29	5491	16799	5491	16770	0.0	0.3274299344066786
chr4	LINC01095	146117384	146117527	0	144	1957	3553	1957	3409	0.0	0.5740686418304488
chr4	LINC01095	146113641	146113756	0	116	1957	3553	1957	3437	0.0	0.5693919115507711
chr4	SLC10A7	146509912	146510049	0	138	61	6702	61	6564	0.0	0.009293113954905546
chr4	SLC10A7	146442782	146442821	0	40	61	6702	61	6662	0.0	0.009156409486640649
chr4	SLC10A7	146256825	146256936	0	112	61	6702	61	6590	0.0	0.009256449165402124
chr4	SLC10A7	146503848	146503924	0	77	61	6702	61	6625	0.0	0.009207547169811321
chr4	TTC29	146942583	146942684	0	102	252	3350	252	3248	0.0	0.07758620689655173
chr4	TTC29	146831640	146831794	0	155	252	3350	252	3195	0.0	0.07887323943661972
chr4	TTC29	146944096	146944333	0	238	252	3350	252	3112	0.0	0.08097686375321336
chr4	TTC29	146944096	146944350	0	255	252	3350	252	3095	0.0	0.08142164781906301
chr4	PRMT9	147680322	147680471	0	150	0	3964	0	3814	0.0	0.0
chr4	NR3C2	148154550	148154901	0	352	306	6620	306	6268	0.0	0.04881940012763242
chr4	NR3C2	148152468	148152613	0	146	306	6620	306	6474	0.0	0.047265987025023166
chr4	IQCM	149514524	149514742	0	219	0	2908	0	2689	0.0	0.0
chr4	IQCM	149691737	149691791	0	55	0	2908	0	2853	0.0	0.0
chr4	IQCM	149748692	149748755	0	64	0	2908	0	2844	0.0	0.0
chr4	LRBA	150277852	150278004	0	153	178	16823	178	16670	0.0	0.010677864427114577
chr4	LRBA	150597082	150597115	0	34	178	16823	178	16789	0.0	0.010602179998808744
chr4	LRBA	150353730	150353924	0	195	178	16823	178	16628	0.0	0.010704835217705076
chr4	LRBA	150266398	150266441	0	44	178	16823	178	16779	0.0	0.010608498718636391
chr4	SH3D19	151165588	151165696	0	109	13664	7208	13664	7099	0.0	1.9247781377658826
chr4	SH3D19	151144219	151144288	0	70	13664	7208	13664	7138	0.0	1.9142616979546092
chr4	SH3D19	151181688	151181729	0	42	13664	7208	13664	7166	0.0	1.9067820262349986
chr4	SH3D19	151226167	151226240	0	74	13664	7208	13664	7134	0.0	1.9153350154191198
chr4	GATB	151679812	151679891	0	80	0	9197	0	9117	0.0	0.0
chr4	GATB	151716008	151716131	0	124	0	9197	0	9073	0.0	0.0
chr4	GATB	151716875	151717074	0	200	0	9197	0	8997	0.0	0.0
chr4	FBXW7	152412479	152412529	0	51	12424	9870	12424	9819	0.0	1.2653019655769426
chr4	FBXW7	152534940	152535033	0	94	12424	9870	12424	9776	0.0	1.2708674304418985
chr4	FBXW7	152451659	152451776	0	118	12424	9870	12424	9752	0.0	1.2739950779327318
chr4	RNF175	153728206	153728361	0	156	624	3914	624	3758	0.0	0.1660457690260777
chr4	RNF175	153748644	153748786	51	143	624	3914	573	3771	0.35664335664335667	0.15194908512330946
chr4	RNF175	153751437	153751475	0	39	624	3914	624	3875	0.0	0.16103225806451613
chr4	RNF175	153748644	153748827	51	184	624	3914	573	3730	0.27717391304347827	0.15361930294906168
chr4	PLRG1	154537285	154537479	0	195	12171	4940	12171	4745	0.0	2.5650158061116963
chr4	PLRG1	154546122	154546213	43	92	12171	4940	12128	4848	0.4673913043478261	2.5016501650165015
chr4	PLRG1	154549663	154549772	46	110	12171	4940	12125	4830	0.41818181818181815	2.510351966873706
chr4	MAP9	155355715	155355884	0	170	992	8872	992	8702	0.0	0.11399678234888531
chr4	MAP9	155375775	155375914	0	140	992	8872	992	8732	0.0	0.11360513055428309
chr4	MAP9	155375775	155375870	0	96	992	8872	992	8776	0.0	0.11303555150410209
chr4	LINC02272	156636567	156636606	0	40	153	610	153	570	0.0	0.26842105263157895
chr4	PDGFC	156861428	156861489	0	62	0	6013	0	5951	0.0	0.0
chr4	PDGFC	156767772	156767876	0	105	0	6013	0	5908	0.0	0.0
chr4	GASK1B	158170465	158171599	0	1135	51	5026	51	3891	0.0	0.013107170393215111
chr4	C4ORF45	158960285	158960344	0	60	0	1493	0	1433	0.0	0.0
chr4	FSTL5	161510397	161510424	0	28	169	5343	169	5315	0.0	0.031796801505174034
chr4	NPY1R	163326217	163326298	0	82	0	3904	0	3822	0.0	0.0
chr4	MARCHF1	163612270	163613038	0	769	24	10135	24	9366	0.0	0.0025624599615631004
chr4	MARCHF1	163854020	163854169	0	150	24	10135	24	9985	0.0	0.0024036054081121683
chr4	MARCHF1	163988500	163988709	0	210	24	10135	24	9925	0.0	0.0024181360201511333
chr4	MARCHF1	163555848	163555973	0	126	24	10135	24	10009	0.0	0.002397841942251973
chr4	TMEM192	165111648	165111679	0	32	0	10191	0	10159	0.0	0.0
chr4	SPOCK3	166792169	166792289	0	121	0	4501	0	4380	0.0	0.0
chr4	SPOCK3	167062491	167062537	0	47	0	4501	0	4454	0.0	0.0
chr4	SPOCK3	166912619	166912743	0	125	0	4501	0	4376	0.0	0.0
chr4	SPOCK3	167000348	167000463	0	116	0	4501	0	4385	0.0	0.0
chr4	SPOCK3	167083237	167083246	0	10	0	4501	0	4491	0.0	0.0
chr4	SPOCK3	167119793	167119874	0	82	0	4501	0	4419	0.0	0.0
chr4	SPOCK3	167062641	167062650	0	10	0	4501	0	4491	0.0	0.0
chr4	SPOCK3	167011221	167011302	0	82	0	4501	0	4419	0.0	0.0
chr4	DDX60	168265464	168265614	0	151	92	6563	92	6412	0.0	0.014348097317529632
chr4	DDX60L	168419301	168419397	0	97	981	12203	981	12106	0.0	0.08103419791838758
chr4	DDX60L	168419301	168419384	0	84	981	12203	981	12119	0.0	0.08094727287730011
chr4	DDX60L	168475995	168476120	0	126	981	12203	981	12077	0.0	0.08122878198228037
chr4	CBR4	168864371	168864586	0	216	51	5120	51	4904	0.0	0.010399673735725938
chr4	CBR4	169007635	169007756	0	122	51	5120	51	4998	0.0	0.01020408163265306
chr4	CBR4	169005884	169005914	0	31	51	5120	51	5089	0.0	0.01002161524857536
chr4	CBR4	169008951	169008999	0	49	51	5120	51	5071	0.0	0.010057187931374483
chr4	CBR4	169008951	169009054	0	104	51	5120	51	5016	0.0	0.010167464114832535
chr4	NEK1	169508768	169508852	0	85	15902	8391	15902	8306	0.0	1.9145196243679268
chr4	NEK1	169555719	169555851	0	133	15902	8391	15902	8258	0.0	1.92564785662388
chr4	NEK1	169561479	169561554	0	76	15902	8391	15902	8315	0.0	1.9124473842453398
chr4	NEK1	169602007	169602104	0	98	15902	8391	15902	8293	0.0	1.9175208006752682
chr4	LINC02275	169923060	169923187	1275	128	16957	4372	15682	4244	9.9609375	3.6950989632422244
chr4	LINC02275	169942705	169942843	0	139	16957	4372	16957	4233	0.0	4.005905976848571
chr4	MFAP3L	170005579	170006010	0	432	255	8210	255	7778	0.0	0.03278477757778349
chr4	MFAP3L	170001964	170002226	0	263	255	8210	255	7947	0.0	0.03208758021895055
chr4	MFAP3L	170006602	170006736	0	135	255	8210	255	8075	0.0	0.031578947368421054
chr4	AC105285.1	173166123	173166299	0	177	0	6261	0	6084	0.0	0.0
chr4	AC105285.1	173164977	173165132	0	156	0	6261	0	6105	0.0	0.0
chr4	AC105285.1	173165991	173166018	0	28	0	6261	0	6233	0.0	0.0
chr4	SCRG1	173389594	173389892	0	299	0	5112	0	4813	0.0	0.0
chr4	SCRG1	173398261	173398434	0	174	0	5112	0	4938	0.0	0.0
chr4	LINC02268	174097622	174097829	0	208	2257	3430	2257	3222	0.0	0.7004965859714463
chr4	LINC02268	174114040	174114272	0	233	2257	3430	2257	3197	0.0	0.7059743509540194
chr4	FBXO8	174256026	174256145	702	120	4190	2099	3488	1979	5.85	1.7625063163213743
chr4	FBXO8	174269053	174269167	408	115	4190	2099	3782	1984	3.5478260869565217	1.90625
chr4	HPGD	174493150	174493314	0	165	51	5539	51	5374	0.0	0.009490137700037217
chr4	HPGD	174517970	174518077	0	108	51	5539	51	5431	0.0	0.009390535812925796
chr4	HPGD	174521943	174522067	0	125	51	5539	51	5414	0.0	0.009420022164758035
chr4	HPGD	174508695	174508792	0	98	51	5539	51	5441	0.0	0.00937327697114501
chr4	HPGD	174495547	174495624	0	78	51	5539	51	5461	0.0	0.00933894891045596
chr4	GLRA3	174656742	174656787	0	46	51	9539	51	9493	0.0	0.005372379648161804
chr4	GPM6A	175812190	175812249	0	60	51	7064	51	7004	0.0	0.007281553398058253
chr4	GPM6A	175786871	175786917	0	47	51	7064	51	7017	0.0	0.007268063274903805
chr4	GPM6A	175961236	175961341	0	106	51	7064	51	6958	0.0	0.007329692440356425
chr4	GPM6A	175781208	175781297	0	90	51	7064	51	6974	0.0	0.0073128763980499
chr4	GPM6A	175787335	175787425	0	91	51	7064	51	6973	0.0	0.007313925139825039
chr4	AC097518.2	177270862	177270986	0	125	13	6326	13	6201	0.0	0.0020964360587002098
chr4	AC097518.2	177115725	177115878	13	154	13	6326	0	6172	0.08441558441558442	0.0
chr4	AGA	177436275	177436351	0	77	0	2614	0	2537	0.0	0.0
chr4	AGA	177439575	177439688	0	114	0	2614	0	2500	0.0	0.0
chr4	AGA	177436297	177436351	0	55	0	2614	0	2559	0.0	0.0
chr4	TENM3-AS1	182084853	182085174	0	322	15	5430	15	5108	0.0	0.0029365700861393894
chr4	DCTD	182914922	182915058	0	137	0	3477	0	3340	0.0	0.0
chr4	DCTD	182916722	182916857	0	136	0	3477	0	3341	0.0	0.0
chr4	DCTD	182916418	182916539	0	122	0	3477	0	3355	0.0	0.0
chr4	DCTD	182915880	182915888	0	9	0	3477	0	3468	0.0	0.0
chr4	DCTD	182916672	182916857	0	186	0	3477	0	3291	0.0	0.0
chr4	RWDD4	183646350	183646353	0	4	0	2762	0	2758	0.0	0.0
chr4	RWDD4	183651217	183651327	0	111	0	2762	0	2651	0.0	0.0
chr4	RWDD4	183651217	183651323	0	107	0	2762	0	2655	0.0	0.0
chr4	RWDD4	183655880	183655961	0	82	0	2762	0	2680	0.0	0.0
chr4	LINC02363	184350088	184350278	0	191	0	2723	0	2532	0.0	0.0
chr4	LINC02362	184378964	184379129	0	166	108591	5072	108591	4906	0.0	22.134325315939666
chr4	LINC02362	184378498	184379129	0	632	108591	5072	108591	4440	0.0	24.457432432432434
chr4	LINC02362	184368412	184368467	7002	56	108591	5072	101589	5016	125.03571428571429	20.25299043062201
chr4	IRF2	184407178	184407283	0	106	816	3036	816	2930	0.0	0.2784982935153584
chr4	IRF2	184428673	184428797	765	125	816	3036	51	2911	6.12	0.017519752662315355
chr4	CASP3	184644530	184644722	0	193	17803	2908	17803	2715	0.0	6.557274401473297
chr4	CASP3	184631036	184631157	1842	122	17803	2908	15961	2786	15.098360655737705	5.729002153625269
chr4	CASP3	184648464	184648631	0	168	17803	2908	17803	2740	0.0	6.497445255474452
chr4	CASP3	184648502	184648631	0	130	17803	2908	17803	2778	0.0	6.408567314614831
chr4	CENPU	184700819	184700881	0	63	0	3274	0	3211	0.0	0.0
chr4	ACSL1	184770398	184770476	0	79	363	6161	363	6082	0.0	0.05968431437027294
chr4	ACSL1	184780331	184780433	0	103	363	6161	363	6058	0.0	0.05992076592934962
chr4	ACSL1	184803319	184803546	0	228	363	6161	363	5933	0.0	0.06118321254003034
chr4	ACSL1	184788378	184788513	0	136	363	6161	363	6025	0.0	0.06024896265560166
chr4	ACSL1	184770254	184770332	0	79	363	6161	363	6082	0.0	0.05968431437027294
chr4	LINC01093	184897334	184897567	0	234	0	3158	0	2924	0.0	0.0
chr4	LINC01093	184897334	184897588	0	255	0	3158	0	2903	0.0	0.0
chr4	LINC01093	184898620	184898769	0	150	0	3158	0	3008	0.0	0.0
chr4	LINC01093	184897347	184897567	0	221	0	3158	0	2937	0.0	0.0
chr4	LINC01093	184898646	184898769	0	124	0	3158	0	3034	0.0	0.0
chr4	LINC01093	184897334	184898769	0	1436	0	3158	0	1722	0.0	0.0
chr4	LINC01093	184897347	184897588	0	242	0	3158	0	2916	0.0	0.0
chr4	LINC01093	184897669	184897746	0	78	0	3158	0	3080	0.0	0.0
chr4	LINC01093	184897347	184897570	0	224	0	3158	0	2934	0.0	0.0
chr4	LINC01093	184897334	184897749	0	416	0	3158	0	2742	0.0	0.0
chr4	LINC01093	184897669	184897749	0	81	0	3158	0	3077	0.0	0.0
chr4	LINC01093	184897347	184897746	0	400	0	3158	0	2758	0.0	0.0
chr4	LINC01093	184897334	184897746	0	413	0	3158	0	2745	0.0	0.0
chr4	CCDC110	185462993	185463049	0	57	1796	3546	1796	3489	0.0	0.5147606764115793
chr4	CCDC110	185461048	185461159	0	112	1796	3546	1796	3434	0.0	0.5230052417006407
chr4	CCDC110	185452220	185452373	0	154	1796	3546	1796	3392	0.0	0.5294811320754716
chr4	CCDC110	185457161	185457329	428	169	1796	3546	1368	3377	2.532544378698225	0.40509327805744744
chr4	CCDC110	185460893	185460953	0	61	1796	3546	1796	3485	0.0	0.5153515064562411
chr4	CCDC110	185470579	185470716	0	138	1796	3546	1796	3408	0.0	0.5269953051643192
chr4	PDLIM3	185508298	185508562	0	265	102	9020	102	8755	0.0	0.011650485436893204
chr4	PDLIM3	185523361	185523446	0	86	102	9020	102	8934	0.0	0.011417058428475487
chr4	PDLIM3	185525019	185525171	0	153	102	9020	102	8867	0.0	0.011503326942596143
chr4	PDLIM3	185514702	185514890	0	189	102	9020	102	8831	0.0	0.011550220813044956
chr4	SORBS2	185606584	185607349	16027	766	166990	11677	150963	10911	20.922976501305484	13.835853725598021
chr4	SORBS2	185622913	185624494	29623	1582	166990	11677	137367	10095	18.725031605562577	13.6074294205052
chr4	SORBS2	185635354	185635411	108	58	166990	11677	166882	11619	1.8620689655172413	14.36285394612273
chr4	SORBS2	185651783	185651828	0	46	166990	11677	166990	11631	0.0	14.357320952626601
chr4	SORBS2	185638876	185639035	0	160	166990	11677	166990	11517	0.0	14.499435616914127
chr4	SORBS2	185676996	185677638	120911	643	166990	11677	46079	11034	188.04199066874028	4.176092079028457
chr4	SORBS2	185684753	185684846	192	94	166990	11677	166798	11583	2.0425531914893615	14.400241733575067
chr4	SORBS2	185684753	185684842	192	90	166990	11677	166798	11587	2.1333333333333333	14.395270561836542
chr4	SORBS2	185690561	185690611	367	51	166990	11677	166623	11626	7.196078431372549	14.331928436263548
chr4	SORBS2	185894296	185894373	0	78	166990	11677	166990	11599	0.0	14.396930769893956
chr4	SORBS2	185638078	185638162	0	85	166990	11677	166990	11592	0.0	14.405624568668047
chr4	SORBS2	185734098	185734154	0	57	166990	11677	166990	11620	0.0	14.37091222030981
chr4	SORBS2	185733997	185734154	0	158	166990	11677	166990	11519	0.0	14.496918135254797
chr4	SORBS2	185775059	185775111	0	53	166990	11677	166990	11624	0.0	14.365966964900206
chr4	SORBS2	185775226	185775366	0	141	166990	11677	166990	11536	0.0	14.475554785020805
chr4	F11-AS1	186424089	186424236	51	148	4397	3452	4346	3304	0.34459459459459457	1.3153753026634383
chr4	F11-AS1	186428704	186428850	0	147	4397	3452	4397	3305	0.0	1.3304084720121028
chr4	FAT1	186590367	186590403	0	37	348	16199	348	16162	0.0	0.02153198861527039
chr4	FAT1	186590504	186590695	0	192	348	16199	348	16007	0.0	0.021740488536265385
chr4	FAT1	186592692	186592752	0	61	348	16199	348	16138	0.0	0.02156401041021192
chr4	LINC02492	187582420	187582530	0	111	7373	2773	7373	2662	0.0	2.7697220135236664
chr4	LINC02492	187592742	187592927	0	186	7373	2773	7373	2587	0.0	2.850019327406262
chr4	LINC02492	187558076	187558264	0	189	7373	2773	7373	2584	0.0	2.853328173374613
chr4	LINC02492	187555060	187555144	0	85	7373	2773	7373	2688	0.0	2.7429315476190474
chr4	LINC02492	187533351	187533609	0	259	7373	2773	7373	2514	0.0	2.9327764518695307
chr4	LINC02492	187592883	187592927	0	45	7373	2773	7373	2728	0.0	2.7027126099706744
chr4	LINC02492	187555567	187555640	0	74	7373	2773	7373	2699	0.0	2.731752500926269
chr4	TRIML2	188097323	188097346	0	24	0	2931	0	2907	0.0	0.0
chr4	TRIML2	188098204	188098279	0	76	0	2931	0	2855	0.0	0.0
chr4	TRIML2	188092786	188093022	0	237	0	2931	0	2694	0.0	0.0
chr4	FRG1-DT	189864592	189864786	0	195	102	5113	102	4918	0.0	0.02074013826758845
chr4	ZNF595	59429	59556	73	128	32658	3934	32585	3806	0.5703125	8.561481870730425
chr4	ZNF595	60057	60153	459	97	32658	3934	32199	3837	4.731958762886598	8.391712275215012
chr4	ZNF141	372663	373007	1273	345	3486	3523	2213	3178	3.689855072463768	0.696349905601007
chr4	PIGG	501100	501170	26	71	153216	8690	153190	8619	0.36619718309859156	17.773523610627684
chr4	PIGG	521055	521227	3940	173	153216	8690	149276	8517	22.77456647398844	17.526828695550076
chr4	PIGG	521055	521273	4869	219	153216	8690	148347	8471	22.232876712328768	17.51233620587888
chr4	PIGG	527038	527230	1927	193	153216	8690	151289	8497	9.984455958549223	17.80498999646934
chr4	PIGG	530435	530745	3682	311	153216	8690	149534	8379	11.839228295819936	17.84628237259816
chr4	PIGG	521055	521249	4138	195	153216	8690	149078	8495	21.22051282051282	17.5489111241907
chr4	PIGG	506760	506866	0	107	153216	8690	153216	8583	0.0	17.8511010136316
chr4	AC116565.1	582123	582230	0	108	0	3016	0	2908	0.0	0.0
chr4	PDE6B	656244	656292	40	49	37127	5076	37087	5027	0.8163265306122449	7.377561169683708
chr4	PDE6B	667855	668006	27448	152	37127	5076	9679	4924	180.57894736842104	1.9656783103168156
chr4	PDE6B	653436	653707	0	272	37127	5076	37127	4804	0.0	7.728351373855121
chr4	PDE6B	667855	667941	0	87	37127	5076	37127	4989	0.0	7.441771898175987
chr4	PCGF3	732443	732498	0	56	75216	6655	75216	6599	0.0	11.398090619790878
chr4	PCGF3	732399	732498	0	100	75216	6655	75216	6555	0.0	11.474599542334095
chr4	TMEM175	947708	947892	357	185	50348	3599	49991	3414	1.9297297297297298	14.642940831868776
chr4	TMEM175	948410	948615	201	206	50348	3599	50147	3393	0.9757281553398058	14.779546124373711
chr4	TMEM175	951645	951717	1479	73	50348	3599	48869	3526	20.26027397260274	13.859614293817357
chr4	TMEM175	951681	951717	1138	37	50348	3599	49210	3562	30.756756756756758	13.815272318921954
chr4	TMEM175	948115	948154	24	40	50348	3599	50324	3559	0.6	14.139926945771284
chr4	TMEM175	948510	948615	153	106	50348	3599	50195	3493	1.4433962264150944	14.370168909247065
chr4	TMEM175	945998	946126	1331	129	50348	3599	49017	3470	10.317829457364342	14.125936599423632
chr4	IDUA	987808	987949	2302	142	10889	3973	8587	3831	16.211267605633804	2.241451318193683
chr4	IDUA	987808	987911	2233	104	10889	3973	8656	3869	21.471153846153847	2.2372706125613853
chr4	MAEA	1315396	1315600	153	205	42338	6602	42185	6397	0.7463414634146341	6.594497420665937
chr4	MAEA	1323494	1323608	0	115	42338	6602	42338	6487	0.0	6.526591644828118
chr4	MAEA	1297955	1298115	260	161	42338	6602	42078	6441	1.6149068322981366	6.532836516068933
chr4	MAEA	1322380	1322503	406	124	42338	6602	41932	6478	3.274193548387097	6.472985489348565
chr4	MAEA	1327626	1327703	5	78	42338	6602	42333	6524	0.0641025641025641	6.488810545677499
chr4	UVSSA	1366319	1366431	482	113	80182	15270	79700	15157	4.265486725663717	5.258296496668206
chr4	UVSSA	1364507	1364571	0	65	80182	15270	80182	15205	0.0	5.2733969089115424
chr4	UVSSA	1380640	1380747	3252	108	80182	15270	76930	15162	30.11111111111111	5.073868882733149
chr4	TACC3	1727707	1728787	8636	1081	218739	7099	210103	6018	7.988899167437558	34.91242937853107
chr4	FGFR3	1806256	1806327	310	72	12294	4866	11984	4794	4.305555555555555	2.499791405924072
chr4	FGFR3	1802913	1803064	91	152	12294	4866	12203	4714	0.5986842105263158	2.588672040729741
chr4	FGFR3	1803691	1803836	466	146	12294	4866	11828	4720	3.191780821917808	2.5059322033898304
chr4	NSD2	1938450	1938532	735	83	957502	19329	956767	19246	8.855421686746988	49.71251169074093
chr4	NSD2	1952107	1952231	51	125	957502	19329	957451	19204	0.408	49.85685273901271
chr4	NSD2	1893729	1893909	1295	181	957502	19329	956207	19148	7.154696132596685	49.93769584290788
chr4	NSD2	1899220	1899395	0	176	957502	19329	957502	19153	0.0	49.99227275100507
chr4	NSD2	1942338	1942432	4780	95	957502	19329	952722	19234	50.31578947368421	49.53322241863367
chr4	NSD2	1942338	1942565	7884	228	957502	19329	949618	19101	34.578947368421055	49.71561698340401
chr4	NSD2	1953813	1953982	25799	170	957502	19329	931703	19159	151.75882352941176	48.630043321676496
chr4	NSD2	1912090	1912194	0	105	957502	19329	957502	19224	0.0	49.80763628797337
chr4	NSD2	1939653	1939778	3320	126	957502	19329	954182	19203	26.349206349206348	49.68921522678748
chr4	CFAP99	2445130	2445308	0	179	0	5011	0	4832	0.0	0.0
chr4	RNF4	2497006	2497121	272	116	366296	7130	366024	7014	2.3448275862068964	52.18477331052181
chr4	RNF4	2490336	2490502	0	167	366296	7130	366296	6963	0.0	52.60606060606061
chr4	RNF4	2500658	2500738	0	81	366296	7130	366296	7049	0.0	51.96425024826217
chr4	RNF4	2512437	2512597	974	161	366296	7130	365322	6969	6.049689440993789	52.42100731812312
chr4	RNF4	2490336	2490411	0	76	366296	7130	366296	7054	0.0	51.92741706833002
chr4	RNF4	2499336	2499419	0	84	366296	7130	366296	7046	0.0	51.98637524836787
chr4	RNF4	2470986	2471109	51	124	366296	7130	366245	7006	0.4112903225806452	52.27590636597203
chr4	FAM193A	2708145	2708268	0	124	17487	6976	17487	6852	0.0	2.5521015761821366
chr4	FAM193A	2655057	2655129	0	73	17487	6976	17487	6903	0.0	2.533246414602347
chr4	FAM193A	2719979	2720072	345	94	17487	6976	17142	6882	3.6702127659574466	2.4908456843940714
chr4	FAM193A	2715321	2715493	0	173	17487	6976	17487	6803	0.0	2.570483610171983
chr4	SH3BP2	2809778	2809829	0	52	95348	12298	95348	12246	0.0	7.786052588600359
chr4	SH3BP2	2829492	2830147	0	656	95348	12298	95348	11642	0.0	8.190001717917884
chr4	SH3BP2	2831922	2831978	0	57	95348	12298	95348	12241	0.0	7.789232905808349
chr4	SH3BP2	2823394	2823569	0	176	95348	12298	95348	12122	0.0	7.8656987295825775
chr4	SH3BP2	2814810	2814917	0	108	95348	12298	95348	12190	0.0	7.821821164889253
chr4	SH3BP2	2823394	2823573	0	180	95348	12298	95348	12118	0.0	7.868295098201023
chr4	ADD1	2881897	2882060	202	164	337989	11643	337787	11479	1.2317073170731707	29.426517989371895
chr4	ADD1	2914883	2915040	979	158	337989	11643	337010	11485	6.19620253164557	29.343491510666087
chr4	ADD1	2926641	2926675	50	35	337989	11643	337939	11608	1.4285714285714286	29.11259476223294
chr4	ADD1	2884514	2884666	0	153	337989	11643	337989	11490	0.0	29.41592689295039
chr4	ADD1	2867971	2868129	0	159	337989	11643	337989	11484	0.0	29.431295715778475
chr4	ADD1	2926638	2926675	62	38	337989	11643	337927	11605	1.631578947368421	29.11908660060319
chr4	ADD1	2909338	2909431	3142	94	337989	11643	334847	11549	33.42553191489362	28.9935925188328
chr4	ADD1	2926284	2926316	84	33	337989	11643	337905	11610	2.5454545454545454	29.1046511627907
chr4	GRK4	2984512	2984608	0	97	10352	4756	10352	4659	0.0	2.221936037776347
chr4	GRK4	3035385	3035523	0	139	10352	4756	10352	4617	0.0	2.242148581329868
chr4	GRK4	3038375	3038513	0	139	10352	4756	10352	4617	0.0	2.242148581329868
chr4	GRK4	3037373	3037511	0	139	10352	4756	10352	4617	0.0	2.242148581329868
chr4	HTT	3233162	3233353	533	192	186437	18141	185904	17949	2.7760416666666665	10.357345813137222
chr4	HTT	3202976	3203066	27	91	186437	18141	186410	18050	0.2967032967032967	10.327423822714682
chr4	RGS12	3386415	3386437	0	23	91409	13133	91409	13110	0.0	6.972463768115942
chr4	RGS12	3428557	3428711	0	155	91409	13133	91409	12978	0.0	7.043381106487902
chr4	HGFAC	3445875	3445896	74	22	4266	2771	4192	2749	3.3636363636363638	1.5249181520552928
chr4	DOK7	3463505	3463551	0	47	0	4047	0	4000	0.0	0.0
chr4	AL590235.1	3546169	3546348	119	180	272	938	153	758	0.6611111111111111	0.20184696569920843
chr4	ZBTB49	4306137	4306184	0	48	7101	2879	7101	2831	0.0	2.5083009537265983
chr4	ZBTB49	4313040	4313114	0	75	7101	2879	7101	2804	0.0	2.532453637660485
chr4	NSG1	4385856	4387173	0	1318	1530	4365	1530	3047	0.0	0.5021332458155563
chr4	NSG1	4391474	4391591	0	118	1530	4365	1530	4247	0.0	0.36025429715093005
chr4	NSG1	4385856	4386643	0	788	1530	4365	1530	3577	0.0	0.4277327369303886
chr4	NSG1	4387118	4387173	0	56	1530	4365	1530	4309	0.0	0.3550707820840102
chr4	STX18-AS1	4648976	4649542	0	567	12842	21284	12842	20717	0.0	0.6198773953757784
chr4	STK32B	5416844	5416934	0	91	221	5226	221	5135	0.0	0.043037974683544304
chr4	STK32B	5446672	5446776	0	105	221	5226	221	5121	0.0	0.043155633665299745
chr4	STK32B	5140196	5140306	0	111	221	5226	221	5115	0.0	0.043206256109481915
chr4	WFS1	6277454	6277687	0	234	205285	4521	205285	4287	0.0	47.885467693025426
chr4	WFS1	6277450	6277687	0	238	205285	4521	205285	4283	0.0	47.93018911977586
chr4	KIAA0232	6804522	6804606	0	85	82698	8511	82698	8426	0.0	9.81462140992167
chr4	TBC1D14	7007523	7007625	212	103	288644	6280	288432	6177	2.058252427184466	46.69451189898009
chr4	SH3TC1	8205166	8205366	0	201	0	8635	0	8434	0.0	0.0
chr4	SH3TC1	8209747	8209822	0	76	0	8635	0	8559	0.0	0.0
chr4	SH3TC1	8216956	8217167	0	212	0	8635	0	8423	0.0	0.0
chr4	SH3TC1	8236277	8236428	0	152	0	8635	0	8483	0.0	0.0
chr4	SH3TC1	8209664	8209822	0	159	0	8635	0	8476	0.0	0.0
chr4	SH3TC1	8204782	8205053	0	272	0	8635	0	8363	0.0	0.0
chr4	SH3TC1	8215171	8215242	0	72	0	8635	0	8563	0.0	0.0
chr4	SH3TC1	8232706	8233065	0	360	0	8635	0	8275	0.0	0.0
chr4	LINC02517	8321956	8322243	0	288	102	1963	102	1675	0.0	0.0608955223880597
chr4	LINC02517	8322125	8322243	0	119	102	1963	102	1844	0.0	0.055314533622559656
chr4	LINC02517	8321956	8322032	0	77	102	1963	102	1886	0.0	0.05408271474019088
chr4	TRMT44	8446475	8446590	0	116	41127	7662	41127	7546	0.0	5.450172276702889
chr4	CPZ	8599452	8599582	0	131	0	3293	0	3162	0.0	0.0
chr4	CPZ	8599452	8599485	0	34	0	3293	0	3259	0.0	0.0
chr4	AC005699.1	11763458	11763501	0	44	510	4472	510	4428	0.0	0.11517615176151762
chr4	AC005699.1	11768727	11768810	0	84	510	4472	510	4388	0.0	0.1162260711030082
chr4	AC005699.1	11778185	11778535	0	351	510	4472	510	4121	0.0	0.12375636981315215
chr4	AC005699.1	11770611	11770688	0	78	510	4472	510	4394	0.0	0.11606736458807465
chr4	AC005699.1	11773592	11773664	0	73	510	4472	510	4399	0.0	0.11593543987269835
chr4	AC005699.1	11770616	11770688	0	73	510	4472	510	4399	0.0	0.11593543987269835
chr4	AC005699.1	11740796	11740939	0	144	510	4472	510	4328	0.0	0.1178373382624769
chr4	AC005699.1	11778182	11778535	0	354	510	4472	510	4118	0.0	0.1238465274405051
chr4	AC005699.1	11776279	11776344	0	66	510	4472	510	4406	0.0	0.11575124829777576
chr4	LINC02270	12246934	12246970	0	37	0	1314	0	1277	0.0	0.0
chr4	LINC01085	14127076	14127258	420	183	420	2592	0	2409	2.2950819672131146	0.0
chr4	CPEB2	15008337	15008427	0	91	127634	7383	127634	7292	0.0	17.503291278113
chr4	CPEB2	15040463	15040487	25	25	127634	7383	127609	7358	1.0	17.342892090241914
chr4	CC2D2A	15473221	15473255	21	35	12919	12486	12898	12451	0.6	1.0359007308649908
chr4	CC2D2A	15574149	15574326	0	178	12919	12486	12919	12308	0.0	1.0496425089372765
chr4	CC2D2A	15596084	15596207	0	124	12919	12486	12919	12362	0.0	1.0450574340721566
chr4	CC2D2A	15479218	15479328	0	111	12919	12486	12919	12375	0.0	1.043959595959596
chr4	CC2D2A	15479222	15479328	0	107	12919	12486	12919	12379	0.0	1.0436222635107844
chr4	CC2D2A	15561587	15561602	0	16	12919	12486	12919	12470	0.0	1.0360064153969526
chr4	CC2D2A	15576603	15576624	0	22	12919	12486	12919	12464	0.0	1.03650513478819
chr4	CC2D2A	15576603	15577094	0	492	12919	12486	12919	11994	0.0	1.0771218942804737
chr4	CC2D2A	15596143	15596207	0	65	12919	12486	12919	12421	0.0	1.0400933902262297
chr4	BST1	15704919	15704964	14553	46	23511	2878	8958	2832	316.3695652173913	3.163135593220339
chr4	BST1	15736052	15736131	793	80	23511	2878	22718	2798	9.9125	8.119370979270908
chr4	CD38	15824880	15825016	0	137	3128	6865	3128	6728	0.0	0.464922711058264
chr4	CD38	15824880	15824998	0	119	3128	6865	3128	6746	0.0	0.4636821820337978
chr4	LAP3	17582287	17582393	255	107	97782	3618	97527	3511	2.383177570093458	27.77755625178012
chr4	NCAPG	17815273	17815358	0	86	50489	4868	50489	4782	0.0	10.558134671685487
chr4	SLIT2	20525148	20525172	0	25	137140	9063	137140	9038	0.0	15.173710998008408
chr4	SLIT2	20489942	20489954	0	13	137140	9063	137140	9050	0.0	15.153591160220994
chr4	SLIT2	20490802	20490814	0	13	137140	9063	137140	9050	0.0	15.153591160220994
chr4	SLIT2	20573233	20573260	0	28	137140	9063	137140	9035	0.0	15.178749308245711
chr4	SLIT2	20554307	20554340	0	34	137140	9063	137140	9029	0.0	15.188835972975966
chr4	PACRGL	20707802	20707870	0	69	77872	7747	77872	7678	0.0	10.142224537640011
chr4	PACRGL	20709682	20709773	1134	92	77872	7747	76738	7655	12.326086956521738	10.024559111691705
chr4	PACRGL	20724807	20724888	0	82	77872	7747	77872	7665	0.0	10.159425962165688
chr4	PACRGL	20701757	20701884	0	128	77872	7747	77872	7619	0.0	10.220763879774248
chr4	PACRGL	20702140	20702221	2426	82	77872	7747	75446	7665	29.585365853658537	9.842922374429223
chr4	PACRGL	20700670	20700787	0	118	77872	7747	77872	7629	0.0	10.207366627343033
chr4	PACRGL	20713431	20713539	357	109	77872	7747	77515	7638	3.2752293577981653	10.148599109714585
chr4	PACRGL	20701518	20701667	0	150	77872	7747	77872	7597	0.0	10.250361984994077
chr4	PACRGL	20702650	20702740	0	91	77872	7747	77872	7656	0.0	10.171368861024034
chr4	PACRGL	20712787	20712922	408	136	77872	7747	77464	7611	3.0	10.177900407305216
chr4	PACRGL	20716106	20716248	0	143	77872	7747	77872	7604	0.0	10.24092582851131
chr4	PACRGL	20701725	20701884	0	160	77872	7747	77872	7587	0.0	10.263872413338605
chr4	PACRGL	20701509	20701667	0	159	77872	7747	77872	7588	0.0	10.262519768054823
chr4	PACRGL	20718815	20718976	0	162	77872	7747	77872	7585	0.0	10.266578773895848
chr4	AC097512.1	23083696	23083788	0	93	0	7737	0	7644	0.0	0.0
chr4	AC097512.1	22999584	22999712	0	129	0	7737	0	7608	0.0	0.0
chr4	AC097512.1	23032831	23032868	0	38	0	7737	0	7699	0.0	0.0
chr4	AC097512.1	23003149	23003243	0	95	0	7737	0	7642	0.0	0.0
chr4	AC097512.1	23004836	23004928	0	93	0	7737	0	7644	0.0	0.0
chr4	AC097512.1	23001413	23001537	0	125	0	7737	0	7612	0.0	0.0
chr4	AC097512.1	23038003	23038097	0	95	0	7737	0	7642	0.0	0.0
chr4	AC097512.1	23055838	23055915	0	78	0	7737	0	7659	0.0	0.0
chr4	AC097512.1	23127177	23127246	0	70	0	7737	0	7667	0.0	0.0
chr4	LINC02473	24665341	24665420	0	80	1326	2277	1326	2197	0.0	0.6035502958579881
chr4	SMIM20	25928312	25928369	135	58	153	1617	18	1559	2.3275862068965516	0.011545862732520847
chr4	RBPJ	26320699	26320815	0	117	196733	9040	196733	8923	0.0	22.047853860809145
chr4	RBPJ	26429897	26430053	0	157	196733	9040	196733	8883	0.0	22.14713497692221
chr4	RBPJ	26430418	26430522	3719	105	196733	9040	193014	8935	35.41904761904762	21.60201454952434
chr4	RBPJ	26362445	26362628	0	184	196733	9040	196733	8856	0.0	22.214656729900632
chr4	RBPJ	26410041	26410292	0	252	196733	9040	196733	8788	0.0	22.386549840691853
chr4	STIM2	27007982	27008006	0	25	120838	8406	120838	8381	0.0	14.418088533587877
chr4	STIM2	27019399	27021068	16374	1670	120838	8406	104464	6736	9.804790419161677	15.508313539192399
chr4	STIM2	27021000	27021068	112	69	120838	8406	120726	8337	1.6231884057971016	14.480748470672903
chr4	STIM2	27021493	27021612	1212	120	120838	8406	119626	8286	10.1	14.437122857832488
chr4	LINC02364	29003482	29003638	0	157	0	1744	0	1587	0.0	0.0
chr4	LINC02364	29012714	29012792	0	79	0	1744	0	1665	0.0	0.0
chr4	LINC02364	29000783	29000865	0	83	0	1744	0	1661	0.0	0.0
chr4	LINC02364	29005889	29006131	0	243	0	1744	0	1501	0.0	0.0
chr4	LINC02364	29008673	29008747	0	75	0	1744	0	1669	0.0	0.0
chr4	LINC02364	29012893	29013024	0	132	0	1744	0	1612	0.0	0.0
chr4	LINC02472	29273183	29273269	0	87	0	1037	0	950	0.0	0.0
chr4	LINC02472	29215287	29215486	0	200	0	1037	0	837	0.0	0.0
chr4	PCDH7	30869021	30869087	0	67	27060	9622	27060	9555	0.0	2.8320251177394034
chr4	LINC02501	31522290	31522439	0	150	0	1163	0	1013	0.0	0.0
chr4	LINC02501	31509138	31509309	0	172	0	1163	0	991	0.0	0.0
chr4	LINC02506	32146052	32146267	0	216	0	2011	0	1795	0.0	0.0
chr4	LINC02506	32104854	32104915	0	62	0	2011	0	1949	0.0	0.0
chr4	LINC02506	32157955	32158081	0	127	0	2011	0	1884	0.0	0.0
chr4	LINC02506	32155313	32155406	0	94	0	2011	0	1917	0.0	0.0
chr4	AC016687.2	33881581	33881754	0	174	0	7125	0	6951	0.0	0.0
chr4	AC016687.2	33884309	33884379	0	71	0	7125	0	7054	0.0	0.0
chr4	AC016687.2	33892135	33892245	0	111	0	7125	0	7014	0.0	0.0
chr4	AC016687.2	33974210	33974539	0	330	0	7125	0	6795	0.0	0.0
chr4	AC016687.2	33890305	33890367	0	63	0	7125	0	7062	0.0	0.0
chr4	DTHD1	36283975	36284591	0	617	0	7392	0	6775	0.0	0.0
chr4	AL136537.1	37100714	37100904	0	191	0	3825	0	3634	0.0	0.0
chr4	AL136537.1	37099033	37099746	0	714	0	3825	0	3111	0.0	0.0
chr4	AL136537.1	37077131	37077250	0	120	0	3825	0	3705	0.0	0.0
chr4	PGM2	37844363	37844553	0	191	59935	3602	59935	3411	0.0	17.571093520961593
chr4	PGM2	37839516	37839683	357	168	59935	3602	59578	3434	2.125	17.34944670937682
chr4	TBC1D1	38051898	38052060	0	163	77728	8862	77728	8699	0.0	8.935279917231865
chr4	TBC1D1	38053105	38053225	0	121	77728	8862	77728	8741	0.0	8.892346413453838
chr4	TBC1D1	38060619	38060658	0	40	77728	8862	77728	8822	0.0	8.810700521423714
chr4	LINC02278	38565836	38566029	0	194	0	2048	0	1854	0.0	0.0
chr4	FAM114A1	38878070	38878426	1020	357	92421	4744	91401	4387	2.857142857142857	20.834511055390927
chr4	FAM114A1	38868397	38868546	0	150	92421	4744	92421	4594	0.0	20.117762298650412
chr4	KLHL5	39062558	39063035	1122	478	7631	5158	6509	4680	2.3472803347280333	1.3908119658119658
chr4	KLHL5	39075964	39076147	0	184	7631	5158	7631	4974	0.0	1.5341777241656613
chr4	KLHL5	39063571	39063797	433	227	7631	5158	7198	4931	1.907488986784141	1.4597444737375787
chr4	WDR19	39185725	39185817	0	93	12077	8810	12077	8717	0.0	1.3854537111391534
chr4	WDR19	39186538	39186604	0	67	12077	8810	12077	8743	0.0	1.3813336383392427
chr4	WDR19	39194543	39194659	0	117	12077	8810	12077	8693	0.0	1.389278730012654
chr4	WDR19	39199477	39199593	0	117	12077	8810	12077	8693	0.0	1.389278730012654
chr4	LIAS	39463524	39463605	0	82	91228	9122	91228	9040	0.0	10.091592920353982
chr4	LIAS	39465045	39465202	7947	158	91228	9122	83281	8964	50.29746835443038	9.290606871932173
chr4	LIAS	39467517	39468427	1739	911	91228	9122	89489	8211	1.9088913282107574	10.898672512483254
chr4	LIAS	39462195	39462289	0	95	91228	9122	91228	9027	0.0	10.106126066245707
chr4	LIAS	39468118	39468427	311	310	91228	9122	90917	8812	1.0032258064516129	10.317408079891058
chr4	LIAS	39473099	39473211	0	113	91228	9122	91228	9009	0.0	10.126318126318127
chr4	LIAS	39467517	39467646	0	130	91228	9122	91228	8992	0.0	10.145462633451958
chr4	LIAS	39466016	39466117	1882	102	91228	9122	89346	9020	18.45098039215686	9.905321507760533
chr4	LIAS	39465284	39465342	1171	59	91228	9122	90057	9063	19.847457627118644	9.9367759020192
chr4	AC108471.2	39650376	39650454	0	79	4764	3742	4764	3663	0.0	1.3005733005733007
chr4	AC108471.2	39654386	39654509	2112	124	4764	3742	2652	3618	17.032258064516128	0.7330016583747927
chr4	UBE2K	39737419	39737513	0	95	575999	5157	575999	5062	0.0	113.78881864875544
chr4	UBE2K	39777681	39777810	1128	130	575999	5157	574871	5027	8.676923076923076	114.3566739606127
chr4	UBE2K	39745751	39745810	0	60	575999	5157	575999	5097	0.0	113.0074553659015
chr4	UBE2K	39755656	39755739	255	84	575999	5157	575744	5073	3.0357142857142856	113.49181943623103
chr4	N4BP2	40097226	40097569	0	344	15133	9830	15133	9486	0.0	1.5952983343875184
chr4	N4BP2	40100035	40100126	0	92	15133	9830	15133	9738	0.0	1.5540151981926473
chr4	RHOH	40235176	40235358	0	183	204	6620	204	6437	0.0	0.03169178188597173
chr4	RHOH	40197100	40197300	0	201	204	6620	204	6419	0.0	0.03178065119177442
chr4	RHOH	40197120	40197300	0	181	204	6620	204	6439	0.0	0.031681938189159806
chr4	RHOH	40235192	40235358	0	167	204	6620	204	6453	0.0	0.03161320316132032
chr4	RHOH	40200511	40200565	0	55	204	6620	204	6565	0.0	0.031073876618431074
chr4	RHOH	40212663	40212791	0	129	204	6620	204	6491	0.0	0.031428131258665844
chr4	RHOH	40218146	40218298	0	153	204	6620	204	6467	0.0	0.03154476573372506
chr4	NSUN7	40790601	40790745	0	145	712	5892	712	5747	0.0	0.1238907255959631
chr4	NSUN7	40807060	40807184	0	125	712	5892	712	5767	0.0	0.12346107161435756
chr4	UCHL1	41261875	41261923	198	49	15787	2218	15589	2169	4.040816326530612	7.187183033656063
chr4	LIMCH1	41524408	41524478	0	71	0	10455	0	10384	0.0	0.0
chr4	LIMCH1	41603874	41603905	0	32	0	10455	0	10423	0.0	0.0
chr4	LIMCH1	41670717	41670792	0	76	0	10455	0	10379	0.0	0.0
chr4	LIMCH1	41494535	41494606	0	72	0	10455	0	10383	0.0	0.0
chr4	LIMCH1	41638931	41638967	0	37	0	10455	0	10418	0.0	0.0
chr4	LIMCH1	41687839	41687917	0	79	0	10455	0	10376	0.0	0.0
chr4	TMEM33	41939195	41939383	1867	189	344307	7774	342440	7585	9.878306878306878	45.14700065919578
chr4	TMEM33	41939720	41939828	0	109	344307	7774	344307	7665	0.0	44.919373776908024
chr4	SLC30A9	42018388	42018505	0	118	123636	7219	123636	7101	0.0	17.411068863540347
chr4	SLC30A9	42070525	42070691	204	167	123636	7219	123432	7052	1.221556886227545	17.503119682359614
chr4	AC080132.1	43778527	43778731	0	205	0	10484	0	10279	0.0	0.0
chr4	GUF1	44680440	44680552	153	113	42241	4473	42088	4360	1.3539823008849559	9.653211009174312
chr4	GUF1	44695614	44695734	572	121	42241	4473	41669	4352	4.7272727272727275	9.574678308823529
chr4	GABRB1	47032416	47032484	0	69	0	2963	0	2894	0.0	0.0
chr4	AC107068.2	47875176	47875331	75	156	126	2267	51	2111	0.4807692307692308	0.024159166271909047
chr4	NIPAL1	48032992	48033083	0	92	3111	3240	3111	3148	0.0	0.9882465057179162
chr4	SLAIN2	48394575	48394653	0	79	397149	6316	397149	6237	0.0	63.67628667628668
chr4	SLAIN2	48387365	48387466	0	102	397149	6316	397149	6214	0.0	63.91197296427422
chr4	OCIAD1	48833400	48833481	1103	82	232704	3485	231601	3403	13.451219512195122	68.05789009697325
chr4	OCIAD1	48857212	48857365	827	154	232704	3485	231877	3331	5.37012987012987	69.61182827979586
chr4	OCIAD1	48831226	48831496	0	271	232704	3485	232704	3214	0.0	72.40323584318607
chr4	OCIAD1	48831226	48831398	0	173	232704	3485	232704	3312	0.0	70.26086956521739
chr4	OCIAD1	48831226	48831249	0	24	232704	3485	232704	3461	0.0	67.23605894250217
chr4	OCIAD1	48832619	48832682	408	64	232704	3485	232296	3421	6.375	67.90295235311312
chr4	OCIAD1	48831226	48831433	0	208	232704	3485	232704	3277	0.0	71.01129081476961
chr4	OCIAD1	48837159	48837252	264	94	232704	3485	232440	3391	2.8085106382978724	68.54615157770569
chr4	OCIAD1	48832619	48832761	408	143	232704	3485	232296	3342	2.8531468531468533	69.50807899461401
chr4	DCUN1D4	51863669	51863709	0	41	0	6539	0	6498	0.0	0.0
chr4	DCUN1D4	51891759	51891851	0	93	0	6539	0	6446	0.0	0.0
chr4	DCUN1D4	51860542	51860663	0	122	0	6539	0	6417	0.0	0.0
chr4	DCUN1D4	51848204	51848367	0	164	0	6539	0	6375	0.0	0.0
chr4	DCUN1D4	51899269	51899378	0	110	0	6539	0	6429	0.0	0.0
chr4	DCUN1D4	51911069	51911174	0	106	0	6539	0	6433	0.0	0.0
chr4	DCUN1D4	51908919	51908975	0	57	0	6539	0	6482	0.0	0.0
chr4	DCUN1D4	51887122	51887244	0	123	0	6539	0	6416	0.0	0.0
chr4	DCUN1D4	51905188	51905320	0	133	0	6539	0	6406	0.0	0.0
chr4	SPATA18	52060418	52060524	0	107	0	4988	0	4881	0.0	0.0
chr4	SPATA18	52069820	52069916	0	97	0	4988	0	4891	0.0	0.0
chr4	SPATA18	52062219	52062332	0	114	0	4988	0	4874	0.0	0.0
chr4	DANCR	52712823	52712959	0	137	7182	7739	7182	7602	0.0	0.9447513812154696
chr4	DANCR	52713493	52713542	0	50	7182	7739	7182	7689	0.0	0.9340616465079984
chr4	DANCR	52714198	52714238	0	41	7182	7739	7182	7698	0.0	0.9329696024941543
chr4	DANCR	52713493	52713702	0	210	7182	7739	7182	7529	0.0	0.9539115420374552
chr4	FIP1L1	53379072	53379117	46	46	13287	4818	13241	4772	1.0	2.7747275775356246
chr4	FIP1L1	53391429	53391498	0	70	13287	4818	13287	4748	0.0	2.798441449031171
chr4	FIP1L1	53414614	53414722	0	109	13287	4818	13287	4709	0.0	2.8216181779571032
chr4	FIP1L1	53440581	53440608	0	28	13287	4818	13287	4790	0.0	2.7739039665970773
chr4	PDGFRA	54261094	54261412	102	319	14124	8586	14022	8267	0.31974921630094044	1.6961412846256199
chr4	PDGFRA	54240037	54240115	0	79	14124	8586	14124	8507	0.0	1.6602797696015046
chr4	PDGFRA	54278818	54278971	420	154	14124	8586	13704	8432	2.727272727272727	1.625237191650854
chr4	SRD5A3	55367587	55367722	0	136	0	7681	0	7545	0.0	0.0
chr4	SRD5A3	55364073	55364271	0	199	0	7681	0	7482	0.0	0.0
chr4	SRD5A3	55361116	55361250	0	135	0	7681	0	7546	0.0	0.0
chr4	TMEM165	55403235	55403338	0	104	92	6798	92	6694	0.0	0.013743651030773827
chr4	EXOC1	55888887	55888932	0	46	31	5360	31	5314	0.0	0.005833646970267219
chr4	CRACD	56297839	56297996	2742	158	18481	6766	15739	6608	17.354430379746834	2.381809927360775
chr4	CRACD	56196343	56196427	0	85	18481	6766	18481	6681	0.0	2.7662026642718156
chr4	CRACD	56324103	56324266	0	164	18481	6766	18481	6602	0.0	2.7993032414419874
chr4	CRACD	56301225	56301247	117	23	18481	6766	18364	6743	5.086956521739131	2.723416876761086
chr4	AC068620.3	56414232	56414316	0	85	1785	2281	1785	2196	0.0	0.8128415300546448
chr4	PAICS	56446356	56446377	0	22	8008	7527	8008	7505	0.0	1.0670219853431047
chr4	SRP72	56483138	56483270	0	133	6771	4758	6771	4625	0.0	1.464
chr4	ARL9	56511184	56511347	0	164	0	2259	0	2095	0.0	0.0
chr4	REST	56919786	56919870	0	85	918	7466	918	7381	0.0	0.12437339113941201
chr4	REST	56927614	56927664	0	51	918	7466	918	7415	0.0	0.12380310182063385
chr4	POLR2B	56990747	56990898	0	152	73	5303	73	5151	0.0	0.0141720054358377
chr4	POLR2B	56985279	56985457	0	179	73	5303	73	5124	0.0	0.014246682279469165
chr4	POLR2B	56985259	56985457	0	199	73	5303	73	5104	0.0	0.014302507836990596
chr4	IGFBP7-AS1	57188169	57188319	0	151	6326	3695	6326	3544	0.0	1.7849887133182845
chr4	IGFBP7-AS1	57201785	57201820	72	36	6326	3695	6254	3659	2.0	1.7092101667122164
chr4	LINC02380	57426978	57427109	0	132	45	2890	45	2758	0.0	0.016316171138506162
chr4	LINC02380	57462373	57462418	0	46	45	2890	45	2844	0.0	0.015822784810126583
chr4	AC013724.1	57492439	57492672	0	234	0	1716	0	1482	0.0	0.0
chr4	LINC02496	60788333	60788452	0	120	0	1318	0	1198	0.0	0.0
chr4	ADGRL3	61912718	61912757	0	40	0	14022	0	13982	0.0	0.0
chr4	ADGRL3	62028854	62028881	0	28	0	14022	0	13994	0.0	0.0
chr4	ADGRL3	62068165	62068217	0	53	0	14022	0	13969	0.0	0.0
chr4	ADGRL3	61517314	61517518	0	205	0	14022	0	13817	0.0	0.0
chr4	ADGRL3	62063504	62063633	0	130	0	14022	0	13892	0.0	0.0
chr4	UBA6-AS1	67720421	67721051	0	631	0	13708	0	13077	0.0	0.0
chr4	UBA6-AS1	68077278	68077421	0	144	0	13708	0	13564	0.0	0.0
chr4	UBA6-AS1	67754158	67754240	0	83	0	13708	0	13625	0.0	0.0
chr4	UBA6-AS1	67716922	67717021	0	100	0	13708	0	13608	0.0	0.0
chr4	UBA6-AS1	68077462	68077630	0	169	0	13708	0	13539	0.0	0.0
chr4	TMPRSS11E	68471459	68471623	0	165	7078	2134	7078	1969	0.0	3.59471813103098
chr4	UGT2B7	69107174	69107262	0	89	0	2268	0	2179	0.0	0.0
chr4	UGT2B7	69108102	69108322	0	221	0	2268	0	2047	0.0	0.0
chr4	AC111000.4	69201171	69201284	0	114	38437	3031	38437	2917	0.0	13.17689406924923
chr4	CSN1S1	69937120	69937144	0	25	0	1014	0	989	0.0	0.0
chr4	CSN1S1	69940020	69940044	0	25	0	1014	0	989	0.0	0.0
chr4	STATH	69999779	69999809	0	31	0	2054	0	2023	0.0	0.0
chr4	HTN3	70032077	70032107	0	31	0	2041	0	2010	0.0	0.0
chr4	CSN1S2AP	70071229	70071253	0	25	0	899	0	874	0.0	0.0
chr4	CSN1S2AP	70073004	70073031	0	28	0	899	0	871	0.0	0.0
chr4	PRR27	70154745	70154791	0	47	0	4239	0	4192	0.0	0.0
chr4	ODAM	70196691	70196733	0	43	0	1574	0	1531	0.0	0.0
chr4	ODAM	70201453	70201501	0	49	0	1574	0	1525	0.0	0.0
chr4	ODAM	70200101	70200149	0	49	0	1574	0	1525	0.0	0.0
chr4	OPRPN	70399270	70399336	0	67	153	1052	153	985	0.0	0.15532994923857868
chr4	MUC7	70474006	70474075	0	70	0	2802	0	2732	0.0	0.0
chr4	RUFY3	70804347	70804416	0	70	188	8987	188	8917	0.0	0.021083323987888303
chr4	RUFY3	70741626	70741680	0	55	188	8987	188	8932	0.0	0.02104791759964174
chr4	RUFY3	70802955	70802983	0	29	188	8987	188	8958	0.0	0.020986827416834115
chr4	MOB1B	70942822	70942882	0	61	51	8811	51	8750	0.0	0.005828571428571429
chr4	MOB1B	70950699	70950811	0	113	51	8811	51	8698	0.0	0.00586341687744309
chr4	DCK	71025815	71025931	0	117	0	2944	0	2827	0.0	0.0
chr4	DCK	71028622	71028719	0	98	0	2944	0	2846	0.0	0.0
chr4	SLC4A4	71563792	71563889	0	98	27231	8798	27231	8700	0.0	3.13
chr4	NPFFR2	72128584	72128919	0	336	0	2366	0	2030	0.0	0.0
chr4	NPFFR2	72068912	72069023	0	112	0	2366	0	2254	0.0	0.0
chr4	ALB	73405115	73405173	0	59	1078	3401	1078	3342	0.0	0.3225613405146619
chr4	ALB	73408593	73408805	0	213	1078	3401	1078	3188	0.0	0.33814303638644916
chr4	ALB	73417530	73417669	51	140	1078	3401	1027	3261	0.36428571428571427	0.3149340693038945
chr4	ALB	73420253	73420321	0	69	1078	3401	1078	3332	0.0	0.3235294117647059
chr4	ALB	73405120	73405173	0	54	1078	3401	1078	3347	0.0	0.32207947415596055
chr4	ALB	73406628	73406761	0	134	1078	3401	1078	3267	0.0	0.32996632996632996
chr4	AFP	73434469	73434610	123	142	123	3219	0	3077	0.8661971830985915	0.0
chr4	AFP	73455235	73455290	0	56	123	3219	123	3163	0.0	0.038887132469174836
chr4	MTHFD2L	74143392	74143467	51	76	3621	8834	3570	8758	0.6710526315789473	0.4076273121717287
chr4	MTHFD2L	74160054	74160088	0	35	3621	8834	3621	8799	0.0	0.41152403682236616
chr4	EPGN	74309092	74309182	0	91	1326	3305	1326	3214	0.0	0.41257000622277534
chr4	EPGN	74313017	74313170	0	154	1326	3305	1326	3151	0.0	0.42081878768644876
chr4	EPGN	74314128	74314326	0	199	1326	3305	1326	3106	0.0	0.42691564713457825
chr4	EPGN	74309092	74309155	0	64	1326	3305	1326	3241	0.0	0.4091329836470225
chr4	EPGN	74313017	74313044	0	28	1326	3305	1326	3277	0.0	0.4046383887702167
chr4	AREG	74452543	74452655	0	113	51	1648	51	1535	0.0	0.03322475570032573
chr4	PARM1	75012424	75013150	675	727	4857	5038	4182	4311	0.9284731774415406	0.9700765483646486
chr4	AC096759.2	75407894	75408012	0	119	0	804	0	685	0.0	0.0
chr4	THAP6	75514869	75514991	0	123	102	7138	102	7015	0.0	0.014540270848182466
chr4	THAP6	75515432	75515532	0	101	102	7138	102	7037	0.0	0.014494813130595424
chr4	THAP6	75521735	75521861	0	127	102	7138	102	7011	0.0	0.014548566538296961
chr4	THAP6	75539858	75539959	0	102	102	7138	102	7036	0.0	0.014496873223422399
chr4	ODAPH	75563209	75563345	0	137	0	2019	0	1882	0.0	0.0
chr4	ODAPH	75556540	75556584	0	45	0	2019	0	1974	0.0	0.0
chr4	USO1	75760593	75760605	0	13	0	4630	0	4617	0.0	0.0
chr4	USO1	75795335	75795356	0	22	0	4630	0	4608	0.0	0.0
chr4	ART3	76058591	76058625	0	35	51	3298	51	3263	0.0	0.01562978853815507
chr4	ART3	76097643	76097676	0	34	51	3298	51	3264	0.0	0.015625
chr4	ART3	76081823	76082535	0	713	51	3298	51	2585	0.0	0.019729206963249517
chr4	ART3	76057989	76058070	0	82	51	3298	51	3216	0.0	0.01585820895522388
chr4	ART3	76104596	76104629	0	34	51	3298	51	3264	0.0	0.015625
chr4	ART3	76107760	76107793	0	34	51	3298	51	3264	0.0	0.015625
chr4	ART3	76105521	76105554	0	34	51	3298	51	3264	0.0	0.015625
chr4	FAM47E	76217578	76217688	0	111	102	3721	102	3610	0.0	0.028254847645429362
chr4	FAM47E	76268659	76268813	0	155	102	3721	102	3566	0.0	0.02860347728547392
chr4	FAM47E-STBD1	76271567	76271768	0	202	0	3250	0	3048	0.0	0.0
chr4	FAM47E	76256177	76256523	0	347	102	3721	102	3374	0.0	0.03023117960877297
chr4	FAM47E	76268659	76268768	0	110	102	3721	102	3611	0.0	0.028247022985322626
chr4	FAM47E-STBD1	76278068	76278224	0	157	0	3250	0	3093	0.0	0.0
chr4	FAM47E-STBD1	76289901	76290060	0	160	0	3250	0	3090	0.0	0.0
chr4	SHROOM3	76738760	76741926	102	3167	61342	13852	61240	10685	0.032207136090937796	5.731399157697707
chr4	SEPTIN11	77036769	77036837	0	69	18471	7910	18471	7841	0.0	2.3556944267312843
chr4	SEPTIN11	76987808	76987870	0	63	18471	7910	18471	7847	0.0	2.3538932075952594
chr4	SEPTIN11	76995780	76995938	0	159	18471	7910	18471	7751	0.0	2.383047348729196
chr4	SEPTIN11	77036772	77036837	0	66	18471	7910	18471	7844	0.0	2.354793472718001
chr4	MRPL1	77871743	77871855	0	113	31074	1636	31074	1523	0.0	20.403151674326985
chr4	MRPL1	77949796	77949878	22335	83	31074	1636	8739	1553	269.09638554216866	5.627173213135866
chr4	FRAS1	78421862	78422000	0	139	55	19284	55	19145	0.0	0.002872812744841995
chr4	ANXA3	78571032	78571173	0	142	0	4911	0	4769	0.0	0.0
chr4	ANXA3	78573179	78573267	0	89	0	4911	0	4822	0.0	0.0
chr4	ANXA3	78552184	78552345	0	162	0	4911	0	4749	0.0	0.0
chr4	LINC01094	78649600	78649709	0	110	5248	5306	5248	5196	0.0	1.0100076982294073
chr4	LINC01094	78673342	78673414	0	73	5248	5306	5248	5233	0.0	1.0028664246130328
chr4	LINC01094	78662917	78663011	0	95	5248	5306	5248	5211	0.0	1.007100364613318
chr4	LINC01094	78648392	78648475	0	84	5248	5306	5248	5222	0.0	1.0049789352738414
chr4	LINC01094	78662917	78662972	0	56	5248	5306	5248	5250	0.0	0.9996190476190476
chr4	BMP2K	78860035	78860079	0	45	23677	9955	23677	9910	0.0	2.3892028254288595
chr4	LINC01088	78972999	78973052	0	54	372	10645	372	10591	0.0	0.035124162024360306
chr4	LINC01088	79195835	79195932	0	98	372	10645	372	10547	0.0	0.03527069308808192
chr4	LINC01088	79307063	79307231	0	169	372	10645	372	10476	0.0	0.035509736540664374
chr4	LINC00989	79513784	79513902	0	119	3315	6191	3315	6072	0.0	0.5459486166007905
chr4	PRDM8	80196012	80196124	0	113	0	4602	0	4489	0.0	0.0
chr4	FGF5	80274908	80275012	0	105	0	5786	0	5681	0.0	0.0
chr4	CFAP299	80944809	80944939	0	131	0	4474	0	4343	0.0	0.0
chr4	CFAP299	80639717	80639835	0	119	0	4474	0	4355	0.0	0.0
chr4	CFAP299	80420213	80420323	0	111	0	4474	0	4363	0.0	0.0
chr4	CFAP299	80608332	80608383	0	52	0	4474	0	4422	0.0	0.0
chr4	PRKG2-AS1	81172073	81172100	0	28	102	874	102	846	0.0	0.12056737588652482
chr4	PRKG2-AS1	81175997	81176037	0	41	102	874	102	833	0.0	0.12244897959183673
chr4	ENOPH1	82451042	82451245	0	204	90	2031	90	1827	0.0	0.04926108374384237
chr4	THAP9	82905860	82905926	0	67	24	4341	24	4274	0.0	0.005615348619560131
chr4	THAP9	82910696	82910811	0	116	24	4341	24	4225	0.0	0.005680473372781065
chr4	COPS4	83045625	83045705	0	81	561	3579	561	3498	0.0	0.16037735849056603
chr4	COPS4	83068437	83068522	0	86	561	3579	561	3493	0.0	0.16060692814199828
chr4	COPS4	83045596	83045705	0	110	561	3579	561	3469	0.0	0.16171807437301816
chr4	COPS4	83065059	83065155	0	97	561	3579	561	3482	0.0	0.16111430212521538
chr4	COPS4	83073205	83073353	0	149	561	3579	561	3430	0.0	0.16355685131195336
chr4	MRPS18C	83459739	83459797	0	59	204	3399	204	3340	0.0	0.06107784431137724
chr4	MRPS18C	83458345	83458429	153	85	204	3399	51	3314	1.8	0.015389257694628847
chr4	CDS1	84604242	84604370	0	129	0	4322	0	4193	0.0	0.0
chr4	WDFY3-AS2	84969724	84969876	0	153	51	8359	51	8206	0.0	0.0062149646600048744
chr4	WDFY3-AS2	85000690	85000765	0	76	51	8359	51	8283	0.0	0.006157189424121695
chr4	WDFY3-AS2	85005473	85005568	0	96	51	8359	51	8263	0.0	0.006172092460365485
chr4	WDFY3-AS2	84969775	84969876	0	102	51	8359	51	8257	0.0	0.006176577449436842
chr4	WDFY3-AS2	84967609	84967640	0	32	51	8359	51	8327	0.0	0.006124654737600576
chr4	WDFY3-AS2	85002537	85002737	0	201	51	8359	51	8158	0.0	0.0062515322382937
chr4	ARHGAP24	85923647	85923770	0	124	2445	7888	2445	7764	0.0	0.31491499227202474
chr4	PTPN13	86753008	86753065	0	58	2860	9546	2860	9488	0.0	0.301433389544688
chr4	AFF1	87046165	87046286	0	122	51	10993	51	10871	0.0	0.004691380737742618
chr4	AFF1	87089983	87090070	0	88	51	10993	51	10905	0.0	0.004676753782668501
chr4	NUDT9	87438276	87438372	0	97	0	3188	0	3091	0.0	0.0
chr4	NUDT9	87449141	87449253	0	113	0	3188	0	3075	0.0	0.0
chr4	NUDT9	87434980	87435220	0	241	0	3188	0	2947	0.0	0.0
chr4	DMP1	87659430	87659478	0	49	2244	2715	2244	2666	0.0	0.8417104276069017
chr4	MEPE	87839684	87839777	0	94	11191	2485	11191	2391	0.0	4.680468423253869
chr4	MEPE	87837638	87837774	0	137	11191	2485	11191	2348	0.0	4.76618398637138
chr4	MEPE	87839926	87840032	0	107	11191	2485	11191	2378	0.0	4.706055508830951
chr4	MEPE	87839926	87840054	0	129	11191	2485	11191	2356	0.0	4.75
chr4	SPP1	87980045	87980126	0	82	867	2329	867	2247	0.0	0.38584779706275035
chr4	SPP1	87980392	87980434	0	43	867	2329	867	2286	0.0	0.37926509186351703
chr4	PKD2	88046641	88046870	0	230	27048	5545	27048	5315	0.0	5.088993414863594
chr4	PKD2	88057982	88058103	6249	122	27048	5545	20799	5423	51.221311475409834	3.835330997602803
chr4	PPM1K-DT	88319330	88319425	0	96	51	2598	51	2502	0.0	0.02038369304556355
chr4	PPM1K-DT	88311795	88311871	0	77	51	2598	51	2521	0.0	0.02023006743355811
chr4	PPM1K-DT	88325100	88325688	0	589	51	2598	51	2009	0.0	0.02538576406172225
chr4	HERC6	88424594	88424702	0	109	25691	5803	25691	5694	0.0	4.51194239550404
chr4	HERC6	88396850	88396987	0	138	25691	5803	25691	5665	0.0	4.53503971756399
chr4	HERC6	88404875	88404997	0	123	25691	5803	25691	5680	0.0	4.52306338028169
chr4	HERC3	88597949	88598087	0	139	0	6999	0	6860	0.0	0.0
chr4	HERC3	88667891	88668081	0	191	0	6999	0	6808	0.0	0.0
chr4	HERC3	88676217	88676241	0	25	0	6999	0	6974	0.0	0.0
chr4	HERC3	88597968	88598087	0	120	0	6999	0	6879	0.0	0.0
chr4	FAM13A-AS1	88722150	88722344	0	195	408	9133	408	8938	0.0	0.04564779592750056
chr4	CCSER1	90663844	90663935	0	92	435	10502	435	10410	0.0	0.04178674351585014
chr4	CCSER1	90325595	90325707	0	113	435	10502	435	10389	0.0	0.0418712099335836
chr4	CCSER1	90403923	90404019	0	97	435	10502	435	10405	0.0	0.041806823642479576
chr4	CCSER1	90727203	90727297	0	95	435	10502	435	10407	0.0	0.04179878927644855
chr4	CCSER1	90693388	90693498	0	111	435	10502	435	10391	0.0	0.041863150803580024
chr4	CCSER1	90918229	90918327	0	99	435	10502	435	10403	0.0	0.04181486109776026
chr4	CCSER1	90911254	90911357	0	104	435	10502	435	10398	0.0	0.04183496826312753
chr4	CCSER1	91283808	91283854	0	47	435	10502	435	10455	0.0	0.04160688665710186
chr4	GRID2	93084994	93085279	0	286	212	10642	212	10356	0.0	0.020471224410969487
chr4	SMARCAD1	94248480	94248553	0	74	495	6342	495	6268	0.0	0.07897255902999362
chr4	SMARCAD1	94213034	94213152	0	119	495	6342	495	6223	0.0	0.07954362847501205
chr4	PDLIM5	94523723	94523875	0	153	0	10424	0	10271	0.0	0.0
chr4	PDLIM5	94584985	94585003	0	19	0	10424	0	10405	0.0	0.0
chr4	PDLIM5	94575615	94576034	0	420	0	10424	0	10004	0.0	0.0
chr4	PDLIM5	94575942	94576034	0	93	0	10424	0	10331	0.0	0.0
chr4	PDLIM5	94656817	94656911	0	95	0	10424	0	10329	0.0	0.0
chr4	STPG2-AS1	97463544	97463592	0	49	0	4117	0	4068	0.0	0.0
chr4	RAP1GDS1	98343138	98343261	0	124	1020	5439	1020	5315	0.0	0.19190968955785512
chr4	RAP1GDS1	98352475	98352601	0	127	1020	5439	1020	5312	0.0	0.19201807228915663
chr4	RAP1GDS1	98379016	98379163	0	148	1020	5439	1020	5291	0.0	0.1927801927801928
chr4	RAP1GDS1	98404476	98404602	0	127	1020	5439	1020	5312	0.0	0.19201807228915663
chr4	RAP1GDS1	98296917	98296990	0	74	1020	5439	1020	5365	0.0	0.19012115563839702
chr4	RAP1GDS1	98391951	98392080	0	130	1020	5439	1020	5309	0.0	0.19212657750988887
chr4	RAP1GDS1	98343138	98343319	0	182	1020	5439	1020	5257	0.0	0.1940270116035762
chr4	METAP1	99037934	99037941	0	8	102	3921	102	3913	0.0	0.02606695629951444
chr4	METAP1	99005768	99005866	0	99	102	3921	102	3822	0.0	0.026687598116169546
chr4	METAP1	99045178	99045310	0	133	102	3921	102	3788	0.0	0.02692713833157339
chr4	METAP1	99048732	99048876	0	145	102	3921	102	3776	0.0	0.02701271186440678
chr4	METAP1	99005768	99005870	0	103	102	3921	102	3818	0.0	0.02671555788370875
chr4	METAP1	99036042	99036089	0	48	102	3921	102	3873	0.0	0.026336173508907823
chr4	METAP1	99031507	99031662	0	156	102	3921	102	3765	0.0	0.027091633466135457
chr4	METAP1	99037766	99037941	0	176	102	3921	102	3745	0.0	0.027236315086782377
chr4	AP002026.1	99188644	99188855	0	212	4466	7378	4466	7166	0.0	0.6232207647222997
chr4	AP002026.1	99254373	99254439	0	67	4466	7378	4466	7311	0.0	0.6108603474216934
chr4	C4ORF17	99535963	99536156	51	194	873	3264	822	3070	0.26288659793814434	0.26775244299674267
chr4	MTTP	99574808	99574970	0	163	1759	5317	1759	5154	0.0	0.3412883197516492
chr4	MTTP	99570699	99570865	0	167	1759	5317	1759	5150	0.0	0.3415533980582524
chr4	MTTP	99570703	99570865	0	163	1759	5317	1759	5154	0.0	0.3412883197516492
chr4	DAPP1	99853217	99853348	40	132	810	4600	770	4468	0.30303030303030304	0.17233661593554164
chr4	DAPP1	99866556	99866618	0	63	810	4600	810	4537	0.0	0.17853206964954815
chr4	H2AZ1-DT	100007901	100008231	0	331	55394	4875	55394	4544	0.0	12.190580985915492
chr4	H2AZ1-DT	100024938	100025080	0	143	55394	4875	55394	4732	0.0	11.70625528317836
chr4	BANK1	101829807	101830206	0	400	18010	6171	18010	5771	0.0	3.120776295269451
chr4	NFKB1	102510879	102510949	0	71	0	5107	0	5036	0.0	0.0
chr4	NFKB1	102596830	102596872	0	43	0	5107	0	5064	0.0	0.0
chr4	NFKB1	102582572	102582634	0	63	0	5107	0	5044	0.0	0.0
chr4	CISD2	102882791	102882873	0	83	0	6358	0	6275	0.0	0.0
chr4	CISD2	102882770	102882873	0	104	0	6358	0	6254	0.0	0.0
chr4	LINC02428	103343091	103343235	0	145	0	3869	0	3724	0.0	0.0
chr4	LINC02428	103425054	103425185	0	132	0	3869	0	3737	0.0	0.0
chr4	LINC02428	103437717	103437842	0	126	0	3869	0	3743	0.0	0.0
chr4	LINC02428	103438706	103438763	0	58	0	3869	0	3811	0.0	0.0
chr4	AC105460.2	103569300	103569402	0	103	0	933	0	830	0.0	0.0
chr4	AC096577.1	104943523	104943645	0	123	0	1964	0	1841	0.0	0.0
chr4	AC096577.1	104923610	104923825	0	216	0	1964	0	1748	0.0	0.0
chr4	TET2	105190359	105190486	0	128	198	12501	198	12373	0.0	0.01600258627656995
chr4	TET2	105241338	105241429	0	92	198	12501	198	12409	0.0	0.015956160850995247
chr4	TET2	105190359	105190505	0	147	198	12501	198	12354	0.0	0.016027197668771247
chr4	NPNT	105912187	105912238	0	52	4	4548	4	4496	0.0	0.0008896797153024911
chr4	NPNT	105958470	105958557	0	88	4	4548	4	4460	0.0	0.0008968609865470852
chr4	NPNT	105932613	105932703	0	91	4	4548	4	4457	0.0	0.0008974646623289208
chr4	NPNT	105967187	105967444	0	258	4	4548	4	4290	0.0	0.0009324009324009324
chr4	AIMP1	106320865	106321451	1989	587	132800	8611	130811	8024	3.3884156729131174	16.302467597208373
chr4	AIMP1	106324984	106325118	30	135	132800	8611	132770	8476	0.2222222222222222	15.664228409627183
chr4	AIMP1	106320797	106320889	0	93	132800	8611	132800	8518	0.0	15.590514205212491
chr4	AIMP1	106338779	106338965	663	187	132800	8611	132137	8424	3.5454545454545454	15.685778727445394
chr4	AIMP1	106321176	106321451	1581	276	132800	8611	131219	8335	5.728260869565218	15.743131373725255
chr4	LINC02173	106449010	106449087	0	78	0	928	0	850	0.0	0.0
chr4	SGMS2	107895309	107896008	0	700	0	7647	0	6947	0.0	0.0
chr4	HADH	108009758	108009887	0	130	51	6977	51	6847	0.0	0.007448517598948445
chr4	HADH	108019539	108019666	0	128	51	6977	51	6849	0.0	0.007446342531756461
chr4	HADH	108032326	108032377	0	52	51	6977	51	6925	0.0	0.007364620938628159
chr4	HADH	108027687	108027760	0	74	51	6977	51	6903	0.0	0.007388092133854845
chr4	HADH	108027938	108028069	0	132	51	6977	51	6845	0.0	0.007450693937180424
chr4	HADH	108028860	108028869	0	10	51	6977	51	6967	0.0	0.007320223912731448
chr4	HADH	108004663	108004917	0	255	51	6977	51	6722	0.0	0.00758702767033621
chr4	HADH	108004545	108004917	0	373	51	6977	51	6604	0.0	0.007722592368261659
chr4	HADH	108024434	108024568	0	135	51	6977	51	6842	0.0	0.007453960830166618
chr4	RPL34	108621630	108621696	0	67	16168	2419	16168	2352	0.0	6.874149659863946
chr4	OSTC	108655563	108655657	0	95	0	1622	0	1527	0.0	0.0
chr4	OSTC	108657449	108657647	0	199	0	1622	0	1423	0.0	0.0
chr4	OSTC	108663232	108663306	0	75	0	1622	0	1547	0.0	0.0
chr4	SEC24B	109449416	109449509	0	94	313	5244	313	5150	0.0	0.06077669902912621
chr4	SEC24B	109481676	109481781	0	106	313	5244	313	5138	0.0	0.06091864538731024
chr4	LRIT3	109865118	109865275	0	158	408	3997	408	3839	0.0	0.10627767647824954
chr4	EGF	109959311	109959437	0	127	0	7523	0	7396	0.0	0.0
chr4	EGF	109993246	109993369	0	124	0	7523	0	7399	0.0	0.0
chr4	EGF	110008151	110008230	0	80	0	7523	0	7443	0.0	0.0
chr4	AP1AR	112262987	112263086	0	100	85	6514	85	6414	0.0	0.013252260679763019
chr4	ALPK1	112430447	112432581	0	2135	102	12349	102	10214	0.0	0.00998629332289015
chr4	ALPK1	112382397	112382552	0	156	102	12349	102	12193	0.0	0.008365455589272533
chr4	ALPK1	112343011	112343173	0	163	102	12349	102	12186	0.0	0.008370260955194485
chr4	LARP7	112645550	112645662	0	113	0	3712	0	3599	0.0	0.0
chr4	LARP7	112644424	112644488	0	65	0	3712	0	3647	0.0	0.0
chr4	LARP7	112637643	112637787	0	145	0	3712	0	3567	0.0	0.0
chr4	LARP7	112638617	112638673	0	57	0	3712	0	3655	0.0	0.0
chr4	ANK2	113258049	113258148	0	100	20092	17468	20092	17368	0.0	1.1568401658222018
chr4	ANK2	113343016	113343142	0	127	20092	17468	20092	17341	0.0	1.158641370163197
chr4	ANK2	113348275	113348308	0	34	20092	17468	20092	17434	0.0	1.1524607089595045
chr4	ANK2	113350227	113350249	0	23	20092	17468	20092	17445	0.0	1.1517340212095155
chr4	ANK2	113374763	113374946	0	184	20092	17468	20092	17284	0.0	1.1624623929645916
chr4	ANK2	113278459	113278558	0	100	20092	17468	20092	17368	0.0	1.1568401658222018
chr4	ANK2	113373284	113373449	0	166	20092	17468	20092	17302	0.0	1.1612530343312912
chr4	ANK2	113237598	113237622	0	25	20092	17468	20092	17443	0.0	1.1518660780828986
chr4	ANK2	113331971	113332070	0	100	20092	17468	20092	17368	0.0	1.1568401658222018
chr4	ANK2	113372532	113372625	0	94	20092	17468	20092	17374	0.0	1.156440658455163
chr4	ANK2	113353044	113359299	6519	6256	20092	17468	13573	11212	1.042039641943734	1.2105779521940778
chr4	ANK2	113373089	113373173	0	85	20092	17468	20092	17383	0.0	1.1558419145141805
chr4	ANK2	113323758	113323794	0	37	20092	17468	20092	17431	0.0	1.1526590557053524
chr4	ANK2	113374731	113374946	0	216	20092	17468	20092	17252	0.0	1.1646185949455137
chr4	ANK2	113255734	113255932	0	199	20092	17468	20092	17269	0.0	1.1634721176674967
chr4	ANK2	112949104	112949215	0	112	20092	17468	20092	17356	0.0	1.157640009218714
chr4	ANK2	113151079	113151124	44	46	20092	17468	20048	17422	0.9565217391304348	1.150728963379635
chr4	ANK2	113313683	113313695	0	13	20092	17468	20092	17455	0.0	1.1510741907762818
chr4	ANK2	113258312	113258411	0	100	20092	17468	20092	17368	0.0	1.1568401658222018
chr4	ANK2	113304223	113304277	294	55	20092	17468	19798	17413	5.345454545454546	1.1369666341239304
chr4	ANK2	113378089	113378181	41	93	20092	17468	20051	17375	0.44086021505376344	1.1540143884892087
chr4	UGT8	114619422	114619525	0	104	663	3880	663	3776	0.0	0.17558262711864406
chr4	LINC02263	117372363	117372471	0	109	0	12565	0	12456	0.0	0.0
chr4	LINC02263	117365226	117365379	0	154	0	12565	0	12411	0.0	0.0
chr4	LINC02263	117372363	117372541	0	179	0	12565	0	12386	0.0	0.0
chr4	LINC01378	117428693	117428767	0	75	0	5792	0	5717	0.0	0.0
chr4	LINC01378	117620855	117620992	0	138	0	5792	0	5654	0.0	0.0
chr4	LINC01378	117428696	117428767	0	72	0	5792	0	5720	0.0	0.0
chr4	LINC01378	117576966	117576990	0	25	0	5792	0	5767	0.0	0.0
chr4	LINC01378	117586980	117587050	0	71	0	5792	0	5721	0.0	0.0
chr4	LINC01378	117665776	117665882	0	107	0	5792	0	5685	0.0	0.0
chr4	LINC02264	117834444	117834486	0	43	0	936	0	893	0.0	0.0
chr4	LINC02264	117861161	117861221	0	61	0	936	0	875	0.0	0.0
chr4	LINC02264	117869147	117869280	0	134	0	936	0	802	0.0	0.0
chr4	SNHG8	118279106	118279137	0	32	0	6609	0	6577	0.0	0.0
chr4	SNHG8	118278943	118279137	0	195	0	6609	0	6414	0.0	0.0
chr4	SNHG8	118278933	118279137	0	205	0	6609	0	6404	0.0	0.0
chr4	METTL14	118705610	118705821	0	212	0	6850	0	6638	0.0	0.0
chr4	METTL14	118686549	118686699	0	151	0	6850	0	6699	0.0	0.0
chr4	USP53	119214069	119214222	154	154	613	9528	459	9374	1.0	0.048965222957115424
chr4	USP53	119266299	119266333	0	35	613	9528	613	9493	0.0	0.06457389655535657
chr4	AC093752.1	119457970	119458170	663	201	13109	5140	12446	4939	3.298507462686567	2.5199433083620164
chr4	AC093752.1	119488644	119488717	0	74	13109	5140	13109	5066	0.0	2.5876431109356495
chr4	AC093752.1	119457970	119458077	0	108	13109	5140	13109	5032	0.0	2.605127186009539
chr4	AC093752.1	119543752	119543845	108	94	13109	5140	13001	5046	1.148936170212766	2.5764962346413
chr4	AC073475.1	120150542	120150621	0	80	418	4244	418	4164	0.0	0.10038424591738712
chr4	EXOSC9	121804621	121804759	0	139	956	3262	956	3123	0.0	0.30611591418507844
chr4	EXOSC9	121813233	121813380	0	148	956	3262	956	3114	0.0	0.30700064226075785
chr4	EXOSC9	121816143	121816194	0	52	956	3262	956	3210	0.0	0.29781931464174455
chr4	KIAA1109	122226706	122226835	0	130	0	18530	0	18400	0.0	0.0
chr4	KIAA1109	122316347	122316548	0	202	0	18530	0	18328	0.0	0.0
chr4	KIAA1109	122325854	122325917	0	64	0	18530	0	18466	0.0	0.0
chr4	ADAD1	122379371	122379445	0	75	0	2712	0	2637	0.0	0.0
chr4	BBS12	122733903	122734091	1192	189	360750	3434	359558	3245	6.306878306878307	110.80369799691833
chr4	SPATA5	122952198	122952270	0	73	112	9332	112	9259	0.0	0.01209633869748353
chr4	SPRY1	123397610	123397856	0	247	52	3968	52	3721	0.0	0.013974737973662993
chr4	LINC01091	123708573	123708677	0	105	13800	11515	13800	11410	0.0	1.2094653812445224
chr4	LINC01091	123854034	123854107	280	74	13800	11515	13520	11441	3.7837837837837838	1.1817148850624946
chr4	LINC01091	123924096	123924200	0	105	13800	11515	13800	11410	0.0	1.2094653812445224
chr4	LINC01091	123825993	123826173	438	181	13800	11515	13362	11334	2.4198895027624308	1.1789306511381683
chr4	LINC01091	123930947	123931004	644	58	13800	11515	13156	11457	11.10344827586207	1.1482936196211924
chr4	LINC01091	123910393	123910504	161	112	13800	11515	13639	11403	1.4375	1.1960887485749365
chr4	LINC01091	123934570	123934684	0	115	13800	11515	13800	11400	0.0	1.2105263157894737
chr4	FAT4	125463562	125463667	0	106	663	21289	663	21183	0.0	0.03129868290610395
chr4	FAT4	125316399	125321586	0	5188	663	21289	663	16101	0.0	0.04117756661076952
chr4	LINC02379	126070707	126070813	0	107	0	1913	0	1806	0.0	0.0
chr4	LINC02379	126070710	126070813	0	104	0	1913	0	1809	0.0	0.0
chr4	LINC02379	126067312	126067480	0	169	0	1913	0	1744	0.0	0.0
chr4	LINC02379	126067312	126067420	0	109	0	1913	0	1804	0.0	0.0
chr4	INTU	127704227	127704290	0	64	0	16061	0	15997	0.0	0.0
chr4	INTU	127710912	127711102	0	191	0	16061	0	15870	0.0	0.0
chr4	HSPA4L	127798586	127798709	0	124	153	11461	153	11337	0.0	0.01349563376554644
chr4	PLK4	127883265	127883357	0	93	0	4400	0	4307	0.0	0.0
chr4	PLK4	127883261	127883357	0	97	0	4400	0	4303	0.0	0.0
chr4	PLK4	127891578	127891681	0	104	0	4400	0	4296	0.0	0.0
chr4	ABHD18	127989720	127989821	0	102	0	6723	0	6621	0.0	0.0
chr4	ABHD18	128021136	128021238	0	103	0	6723	0	6620	0.0	0.0
chr4	ABHD18	128001715	128001760	0	46	0	6723	0	6677	0.0	0.0
chr4	ABHD18	127965953	127966056	0	104	0	6723	0	6619	0.0	0.0
chr4	LARP1B	128082164	128082305	0	142	191	8844	191	8702	0.0	0.021948977246609973
chr4	LARP1B	128162193	128162317	0	125	191	8844	191	8719	0.0	0.02190618190159422
chr4	LARP1B	128176871	128176907	0	37	191	8844	191	8807	0.0	0.02168729419779721
chr4	LARP1B	128206427	128206537	0	111	191	8844	191	8733	0.0	0.021871063781060344
chr4	LARP1B	128209855	128209993	0	139	191	8844	191	8705	0.0	0.021941412981045377
chr4	LINC02615	128512903	128512984	0	82	506	5871	506	5789	0.0	0.08740715149421316
chr4	JADE1	128846374	128846532	0	159	42296	9067	42296	8908	0.0	4.748091603053435
chr4	JADE1	128816366	128816463	400	98	42296	9067	41896	8969	4.081632653061225	4.67120080276508
chr4	C4ORF33	129109306	129109358	0	53	204	7024	204	6971	0.0	0.029264094104145745
chr4	LINC02465	129812661	129812760	0	100	12658	6408	12658	6308	0.0	2.0066582117945466
chr4	LINC02465	129812377	129812760	0	384	12658	6408	12658	6024	0.0	2.101261620185923
chr4	LINC02465	129813673	129813785	0	113	12658	6408	12658	6295	0.0	2.0108022239872914
chr4	LINC02465	129825339	129825452	0	114	12658	6408	12658	6294	0.0	2.011121703209406
chr4	LINC02465	129900537	129900654	7	118	12658	6408	12651	6290	0.059322033898305086	2.011287758346582
chr4	LINC02465	129908633	129908703	0	71	12658	6408	12658	6337	0.0	1.9974751459681237
chr4	LINC02465	129865077	129865109	0	33	12658	6408	12658	6375	0.0	1.9855686274509803
chr4	LINC02465	129807003	129807148	0	146	12658	6408	12658	6262	0.0	2.021398914084957
chr4	LINC02465	129936145	129936278	51	134	12658	6408	12607	6274	0.3805970149253731	2.0094038890659864
chr4	LINC02465	129788911	129789224	9448	314	12658	6408	3210	6094	30.089171974522294	0.5267476206104365
chr4	LINC02465	129836434	129836661	0	228	12658	6408	12658	6180	0.0	2.048220064724919
chr4	LINC02465	129896556	129896755	0	200	12658	6408	12658	6208	0.0	2.0389819587628866
chr4	LINC02465	129905818	129905925	0	108	12658	6408	12658	6300	0.0	2.009206349206349
chr4	LINC02465	129822601	129822699	0	99	12658	6408	12658	6309	0.0	2.0063401489935013
chr4	LINC02377	131469542	131469623	0	82	0	2793	0	2711	0.0	0.0
chr4	SNHG27	131777062	131777258	0	197	0	4138	0	3941	0.0	0.0
chr4	SNHG27	131774279	131774369	0	91	0	4138	0	4047	0.0	0.0
chr4	SLC7A11-AS1	138171532	138171706	0	175	0	6172	0	5997	0.0	0.0
chr4	SLC7A11-AS1	138159807	138159892	0	86	0	6172	0	6086	0.0	0.0
chr4	LINC00499	138313290	138313324	0	35	50	20150	50	20115	0.0	0.002485707183693761
chr4	LINC00499	138313290	138313401	0	112	50	20150	50	20038	0.0	0.0024952590078850183
chr4	LINC00499	138349717	138349850	0	134	50	20150	50	20016	0.0	0.002498001598721023
chr4	LINC00499	138346666	138346832	0	167	50	20150	50	19983	0.0	0.0025021268077866188
chr4	LINC00499	138361295	138361402	0	108	50	20150	50	20042	0.0	0.0024947610018960184
chr4	LINC00499	138502011	138502121	0	111	50	20150	50	20039	0.0	0.00249513448774889
chr4	LINC00499	138521555	138521698	0	144	50	20150	50	20006	0.0	0.0024992502249325203
chr4	AC093766.1	138795058	138795214	0	157	51	2903	51	2746	0.0	0.018572469045884922
chr4	AC093766.1	138800063	138800107	0	45	51	2903	51	2858	0.0	0.017844646606018196
chr4	AC093766.1	138790389	138790462	0	74	51	2903	51	2829	0.0	0.018027571580063628
chr4	AC093766.1	138795061	138795214	0	154	51	2903	51	2749	0.0	0.018552200800291015
chr4	AC093766.1	138800063	138800155	0	93	51	2903	51	2810	0.0	0.018149466192170817
chr4	AC093766.1	138790389	138790610	0	222	51	2903	51	2681	0.0	0.019022752704214847
chr4	AC093766.1	138789321	138789442	51	122	51	2903	0	2781	0.4180327868852459	0.0
chr4	MGST2	139678542	139678642	0	101	0	3181	0	3080	0.0	0.0
chr4	MGST2	139695196	139695267	0	72	0	3181	0	3109	0.0	0.0
chr4	SCOC	140379568	140379652	0	85	479	6302	479	6217	0.0	0.07704680714170822
chr4	SCOC	140376674	140376778	0	105	479	6302	479	6197	0.0	0.07729546554784573
chr4	SCOC	140373936	140374316	306	381	479	6302	173	5921	0.8031496062992126	0.02921803749366661
chr4	ZNF330	141224606	141224677	0	72	0	2504	0	2432	0.0	0.0
chr4	IL15	141721058	141721177	0	120	0	7886	0	7766	0.0	0.0
chr4	USP38	143204416	143204532	0	117	51	7842	51	7725	0.0	0.006601941747572815
chr4	GAB1	143457679	143457769	0	91	161	9819	161	9728	0.0	0.01655016447368421
chr4	GAB1	143434087	143434168	0	82	161	9819	161	9737	0.0	0.01653486700215672
chr4	GAB1	143417432	143417550	0	119	161	9819	161	9700	0.0	0.0165979381443299
chr4	AC107223.1	143973109	143973251	0	143	2211	15940	2211	15797	0.0	0.13996328416787998
chr4	AC107223.1	143978919	143979068	0	150	2211	15940	2211	15790	0.0	0.14002533248891705
chr4	AC107223.1	143970424	143970538	0	115	2211	15940	2211	15825	0.0	0.13971563981042653
chr4	AC109811.1	144858798	144858905	0	108	331	2927	331	2819	0.0	0.11741752394466123
chr4	ABCE1	145110967	145111064	0	98	0	5939	0	5841	0.0	0.0
chr4	ABCE1	145121603	145121813	0	211	0	5939	0	5728	0.0	0.0
chr4	SMAD1	145483073	145483176	0	104	0	5209	0	5105	0.0	0.0
chr4	SMAD1	145513240	145513378	0	139	0	5209	0	5070	0.0	0.0
chr4	MMAA	145651061	145651147	0	87	12963	8168	12963	8081	0.0	1.6041331518376438
chr4	MMAA	145651127	145651147	0	21	12963	8168	12963	8147	0.0	1.591137842150485
chr4	EDNRA	147485611	147486101	0	491	357	4247	357	3756	0.0	0.0950479233226837
chr4	EDNRA	147519850	147519978	0	129	357	4247	357	4118	0.0	0.08669256920835357
chr4	EDNRA	147532505	147532704	0	200	357	4247	357	4047	0.0	0.08821349147516679
chr4	LINC02507	147575442	147575565	0	124	102	1933	102	1809	0.0	0.05638474295190713
chr4	LINC02507	147570787	147570930	0	144	102	1933	102	1789	0.0	0.05701509223029626
chr4	ARHGAP10	148063147	148063300	0	154	0	6733	0	6579	0.0	0.0
chr4	DCLK2	150248304	150248385	0	82	0	4436	0	4354	0.0	0.0
chr4	DCLK2	150253473	150253556	0	84	0	4436	0	4352	0.0	0.0
chr4	DCLK2	150199027	150199078	0	52	0	4436	0	4384	0.0	0.0
chr4	DCLK2	150254425	150254438	0	14	0	4436	0	4422	0.0	0.0
chr4	RPS3A	151100974	151101162	0	189	0	2240	0	2051	0.0	0.0
chr4	RPS3A	151100484	151100588	0	105	0	2240	0	2135	0.0	0.0
chr4	RPS3A	151100974	151101085	0	112	0	2240	0	2128	0.0	0.0
chr4	RPS3A	151100974	151101012	0	39	0	2240	0	2201	0.0	0.0
chr4	FAM160A1	151454700	151454808	0	109	0	5292	0	5183	0.0	0.0
chr4	FAM160A1	151482523	151482648	0	126	0	5292	0	5166	0.0	0.0
chr4	FAM160A1	151534694	151534900	0	207	0	5292	0	5085	0.0	0.0
chr4	ARFIP1	152870752	152870848	0	97	0	3791	0	3694	0.0	0.0
chr4	TRIM2	153324077	153324148	0	72	1268	14876	1268	14804	0.0	0.08565252634423129
chr4	TRIM2	153153231	153153270	0	40	1268	14876	1268	14836	0.0	0.08546778107306552
chr4	TRIM2	153270337	153270519	0	183	1268	14876	1268	14693	0.0	0.08629959844824066
chr4	TRIM2	153295312	153296036	0	725	1268	14876	1268	14151	0.0	0.08960497491343368
chr4	AC013477.1	153397218	153397333	0	116	102	5906	102	5790	0.0	0.017616580310880828
chr4	AC013477.1	153408970	153409015	0	46	102	5906	102	5860	0.0	0.0174061433447099
chr4	TRIM2	153270334	153270519	0	186	1268	14876	1268	14690	0.0	0.08631722260040844
chr4	TRIM2	153315484	153315588	0	105	1268	14876	1268	14771	0.0	0.08584388328481483
chr4	TRIM2	153291731	153291816	0	86	1268	14876	1268	14790	0.0	0.08573360378634212
chr4	TRIM2	153222242	153223039	0	798	1268	14876	1268	14078	0.0	0.0900696121608183
chr4	TRIM2	153281464	153281565	0	102	1268	14876	1268	14774	0.0	0.08582645187491539
chr4	TRIM2	153290813	153290906	0	94	1268	14876	1268	14782	0.0	0.08578000270599377
chr4	TRIM2	153222242	153222759	0	518	1268	14876	1268	14358	0.0	0.08831313553419697
chr4	TRIM2	153237869	153237957	0	89	1268	14876	1268	14787	0.0	0.08575099749780213
chr4	TRIM2	153290651	153290769	0	119	1268	14876	1268	14757	0.0	0.08592532357525243
chr4	TRIM2	153325781	153325911	0	131	1268	14876	1268	14745	0.0	0.0859952526280095
chr4	TMEM131L	153473844	153473888	0	45	0	6430	0	6385	0.0	0.0
chr4	TLR2	153702226	153702510	0	285	1265	3469	1265	3184	0.0	0.39729899497487436
chr4	AC079298.3	154201747	154201831	0	85	1764	3268	1764	3183	0.0	0.5541941564561734
chr4	AC079298.3	154272167	154272286	0	120	1764	3268	1764	3148	0.0	0.5603557814485387
chr4	FGB	154569513	154569799	0	287	0	4382	0	4095	0.0	0.0
chr4	FGB	154565185	154565235	0	51	0	4382	0	4331	0.0	0.0
chr4	RBM46	154820362	154820422	0	61	0	4035	0	3974	0.0	0.0
chr4	AC097467.3	155342259	155342424	0	166	48	5378	48	5212	0.0	0.00920951650038373
chr4	AC097467.3	155346296	155346560	0	265	48	5378	48	5113	0.0	0.009387834930569137
chr4	AC097467.3	155349380	155349457	0	78	48	5378	48	5300	0.0	0.009056603773584906
chr4	AC097467.3	155352291	155352354	0	64	48	5378	48	5314	0.0	0.009032743695897629
chr4	AC097467.3	155329733	155329953	0	221	48	5378	48	5157	0.0	0.009307737056428156
chr4	AC097467.3	155354208	155354373	0	166	48	5378	48	5212	0.0	0.00920951650038373
chr4	AC097467.3	155309003	155309076	0	74	48	5378	48	5304	0.0	0.00904977375565611
chr4	AC097467.3	155351026	155351207	0	182	48	5378	48	5196	0.0	0.009237875288683603
chr4	AC097467.3	155339968	155340034	0	67	48	5378	48	5311	0.0	0.009037845980041424
chr4	AC097467.3	155346423	155346560	0	138	48	5378	48	5240	0.0	0.00916030534351145
chr4	AC097467.3	155361200	155361322	0	123	48	5378	48	5255	0.0	0.009134157944814463
chr4	AC097467.3	155362263	155362304	0	42	48	5378	48	5336	0.0	0.008995502248875561
chr4	AC097467.3	155362464	155362529	0	66	48	5378	48	5312	0.0	0.009036144578313253
chr4	AC097467.3	155362816	155363070	0	255	48	5378	48	5123	0.0	0.009369510052703494
chr4	AC107208.1	155512336	155512441	0	106	0	3887	0	3781	0.0	0.0
chr4	GUCY1A1	155668089	155668183	0	95	102	10473	102	10378	0.0	0.00982848333012141
chr4	GUCY1A1	155696755	155696849	0	95	102	10473	102	10378	0.0	0.00982848333012141
chr4	GUCY1B1	155772601	155772697	0	97	0	3961	0	3864	0.0	0.0
chr4	GUCY1B1	155759786	155759860	0	75	0	3961	0	3886	0.0	0.0
chr4	GUCY1B1	155785263	155785329	0	67	0	3961	0	3894	0.0	0.0
chr4	GUCY1B1	155772601	155772753	0	153	0	3961	0	3808	0.0	0.0
chr4	GUCY1B1	155759355	155759541	0	187	0	3961	0	3774	0.0	0.0
chr4	TDO2	155858847	155858898	0	52	0	5282	0	5230	0.0	0.0
chr4	GLRB	157152717	157153010	0	294	0	3300	0	3006	0.0	0.0
chr4	GLRB	157091370	157091382	0	13	0	3300	0	3287	0.0	0.0
chr4	GLRB	157084663	157084724	0	62	0	3300	0	3238	0.0	0.0
chr4	GRIA2	157220907	157221130	0	224	0	8804	0	8580	0.0	0.0
chr4	GRIA2	157360708	157360749	0	42	0	8804	0	8762	0.0	0.0
chr4	GRIA2	157361537	157361652	0	116	0	8804	0	8688	0.0	0.0
chr4	FAM198B-AS1	158172251	158172416	0	166	0	5647	0	5481	0.0	0.0
chr4	FAM198B-AS1	158198787	158198870	0	84	0	5647	0	5563	0.0	0.0
chr4	FAM198B-AS1	158176911	158177046	0	136	0	5647	0	5511	0.0	0.0
chr4	TMEM144	158212060	158212220	0	161	0	7537	0	7376	0.0	0.0
chr4	TMEM144	158211458	158211574	0	117	0	7537	0	7420	0.0	0.0
chr4	TMEM144	158211452	158211574	0	123	0	7537	0	7414	0.0	0.0
chr4	TMEM144	158211532	158211574	0	43	0	7537	0	7494	0.0	0.0
chr4	TMEM144	158235437	158235505	0	69	0	7537	0	7468	0.0	0.0
chr4	RXFP1	158593400	158593499	0	100	80	5710	80	5610	0.0	0.0142602495543672
chr4	RXFP1	158626819	158626891	0	73	80	5710	80	5637	0.0	0.014191946070604932
chr4	RXFP1	158607047	158607131	0	85	80	5710	80	5625	0.0	0.014222222222222223
chr4	RXFP1	158610632	158610685	0	54	80	5710	80	5656	0.0	0.014144271570014143
chr4	ETFDH	158680466	158680607	0	142	0	4508	0	4366	0.0	0.0
chr4	ETFDH	158682194	158682424	0	231	0	4508	0	4277	0.0	0.0
chr4	FNIP2	158833800	158833890	0	91	51	9317	51	9226	0.0	0.005527856058963798
chr4	RAPGEF2	159344035	159344059	0	25	0	13313	0	13288	0.0	0.0
chr4	RAPGEF2	159351058	159351133	0	76	0	13313	0	13237	0.0	0.0
chr4	RAPGEF2	159243773	159243791	0	19	0	13313	0	13294	0.0	0.0
chr4	RAPGEF2	159351058	159351181	0	124	0	13313	0	13189	0.0	0.0
chr4	TMA16	163515312	163515461	0	150	0	3154	0	3004	0.0	0.0
chr4	TRIM60	165039200	165039252	0	53	0	3021	0	2968	0.0	0.0
chr4	TRIM60	165039441	165039615	0	175	0	3021	0	2846	0.0	0.0
chr4	KLHL2	165228806	165228913	0	108	0	3948	0	3840	0.0	0.0
chr4	KLHL2	165238777	165238899	0	123	0	3948	0	3825	0.0	0.0
chr4	KLHL2	165263196	165263359	0	164	0	3948	0	3784	0.0	0.0
chr4	KLHL2	165305607	165305725	0	119	0	3948	0	3829	0.0	0.0
chr4	KLHL2	165223937	165224057	0	121	0	3948	0	3827	0.0	0.0
chr4	MSMO1	165333339	165333625	0	287	0	2856	0	2569	0.0	0.0
chr4	TLL1	166044364	166044433	0	70	3920	8130	3920	8060	0.0	0.48635235732009924
chr4	TLL1	165919833	165919939	0	107	3920	8130	3920	8023	0.0	0.4885952885454319
chr4	PALLD	168896548	168896599	0	52	4	9643	4	9591	0.0	0.0004170576582212491
chr4	PALLD	168925232	168925278	0	47	4	9643	4	9596	0.0	0.00041684035014589413
chr4	PALLD	168507359	168507698	0	340	4	9643	4	9303	0.0	0.00042996882726002364
chr4	PALLD	168877722	168878394	0	673	4	9643	4	8970	0.0	0.0004459308807134894
chr4	CLCN3	169695611	169695692	0	82	929	8113	929	8031	0.0	0.11567675258373801
chr4	CLCN3	169717791	169717867	0	77	929	8113	929	8036	0.0	0.11560477849676457
chr4	LINC01612	170278943	170279103	0	161	0	2193	0	2032	0.0	0.0
chr4	LINC01612	170273658	170273964	0	307	0	2193	0	1886	0.0	0.0
chr4	LINC01612	170278363	170278468	0	106	0	2193	0	2087	0.0	0.0
chr4	HAND2-AS1	173536847	173536970	0	124	0	14033	0	13909	0.0	0.0
chr4	HAND2-AS1	173530966	173531078	0	113	0	14033	0	13920	0.0	0.0
chr4	HAND2-AS1	173559096	173559201	0	106	0	14033	0	13927	0.0	0.0
chr4	HAND2-AS1	173530799	173531078	0	280	0	14033	0	13753	0.0	0.0
chr4	HAND2-AS1	173533912	173534122	0	211	0	14033	0	13822	0.0	0.0
chr4	HAND2-AS1	173530799	173530850	0	52	0	14033	0	13981	0.0	0.0
chr4	HAND2-AS1	173588440	173588555	0	116	0	14033	0	13917	0.0	0.0
chr4	HAND2-AS1	173579390	173579556	0	167	0	14033	0	13866	0.0	0.0
chr4	LINC02269	173856283	173856466	0	184	0	3896	0	3712	0.0	0.0
chr4	LINC02269	173878215	173878280	0	66	0	3896	0	3830	0.0	0.0
chr4	LINC02269	173833922	173834011	0	90	0	3896	0	3806	0.0	0.0
chr4	LINC02269	173925877	173925957	0	81	0	3896	0	3815	0.0	0.0
chr4	LINC02269	173735369	173735543	0	175	0	3896	0	3721	0.0	0.0
chr4	LINC02269	173923111	173923281	0	171	0	3896	0	3725	0.0	0.0
chr4	LINC02269	173928494	173928644	0	151	0	3896	0	3745	0.0	0.0
chr4	LINC02269	173928489	173928644	0	156	0	3896	0	3740	0.0	0.0
chr4	LINC02269	173925639	173925766	0	128	0	3896	0	3768	0.0	0.0
chr4	LINC02269	173928494	173928617	0	124	0	3896	0	3772	0.0	0.0
chr4	LINC02269	173906696	173906768	0	73	0	3896	0	3823	0.0	0.0
chr4	LINC02269	173928489	173928617	0	129	0	3896	0	3767	0.0	0.0
chr4	CEP44	174297965	174298062	102	98	3707	6686	3605	6588	1.0408163265306123	0.5472070431086824
chr4	CEP44	174285433	174285574	170	142	3707	6686	3537	6544	1.1971830985915493	0.5404951100244498
chr4	ADAM29	174920686	174920792	0	107	0	5967	0	5860	0.0	0.0
chr4	ADAM29	174936932	174937013	0	82	0	5967	0	5885	0.0	0.0
chr4	ADAM29	174918929	174918990	0	62	0	5967	0	5905	0.0	0.0
chr4	ADAM29	174930985	174931174	0	190	0	5967	0	5777	0.0	0.0
chr4	WDR17	176115795	176115979	0	185	51	7834	51	7649	0.0	0.006667538240292849
chr4	WDR17	176096462	176096585	0	124	51	7834	51	7710	0.0	0.006614785992217899
chr4	WDR17	176166123	176166144	0	22	51	7834	51	7812	0.0	0.006528417818740399
chr4	AC093801.1	176679699	176679750	0	52	0	386	0	334	0.0	0.0
chr4	NEIL3	177322458	177322580	0	123	0	2924	0	2801	0.0	0.0
chr4	WWC2	183240182	183240262	0	81	255	10028	255	9947	0.0	0.025635870111591436
chr4	STOX2	184009157	184011423	0	2267	9674	11373	9674	9106	0.0	1.0623764550845596
chr4	STOX2	184011586	184011635	0	50	9674	11373	9674	11323	0.0	0.8543672171685949
chr4	PRIMPOL	184661773	184661903	0	131	0	2804	0	2673	0.0	0.0
chr4	PRIMPOL	184682247	184682336	0	90	0	2804	0	2714	0.0	0.0
chr4	PRIMPOL	184657084	184657320	0	237	0	2804	0	2567	0.0	0.0
chr4	PRIMPOL	184657081	184657320	0	240	0	2804	0	2564	0.0	0.0
chr4	PRIMPOL	184665916	184666064	0	149	0	2804	0	2655	0.0	0.0
chr4	AC084871.3	184844121	184844468	0	348	102	1579	102	1231	0.0	0.08285946385052803
chr4	AC084871.3	184844121	184844203	0	83	102	1579	102	1496	0.0	0.06818181818181818
chr4	LINC02436	185054978	185055341	0	364	0	7067	0	6703	0.0	0.0
chr4	LINC02436	185062456	185062816	0	361	0	7067	0	6706	0.0	0.0
chr4	LINC02436	185069960	185070030	0	71	0	7067	0	6996	0.0	0.0
chr4	LINC02436	185096481	185096621	0	141	0	7067	0	6926	0.0	0.0
chr4	LINC02436	185054978	185055237	0	260	0	7067	0	6807	0.0	0.0
chr4	LINC02436	185069938	185070030	0	93	0	7067	0	6974	0.0	0.0
chr4	LINC02436	185069929	185070049	0	121	0	7067	0	6946	0.0	0.0
chr4	LINC02436	185053104	185053188	0	85	0	7067	0	6982	0.0	0.0
chr4	LINC02436	185069960	185070049	0	90	0	7067	0	6977	0.0	0.0
chr4	LINC02436	185081097	185081200	0	104	0	7067	0	6963	0.0	0.0
chr4	LINC02436	185069929	185070030	0	102	0	7067	0	6965	0.0	0.0
chr4	LINC02436	185063247	185063334	0	88	0	7067	0	6979	0.0	0.0
chr4	LINC02436	185071986	185072073	0	88	0	7067	0	6979	0.0	0.0
chr4	LINC02436	185062456	185062591	0	136	0	7067	0	6931	0.0	0.0
chr4	LINC02436	185064445	185064564	0	120	0	7067	0	6947	0.0	0.0
chr4	LINC02436	185071567	185072073	0	507	0	7067	0	6560	0.0	0.0
chr4	LINC02436	185091360	185091450	0	91	0	7067	0	6976	0.0	0.0
chr4	SNX25	185351444	185351609	0	166	1001	5091	1001	4925	0.0	0.203248730964467
chr4	ANKRD37	185396831	185396950	1938	120	8118	2016	6180	1896	16.15	3.259493670886076
chr4	C4ORF47	185431981	185432201	51	221	969	1374	918	1153	0.23076923076923078	0.7961838681699913
chr4	C4ORF47	185436283	185436359	0	77	969	1374	969	1297	0.0	0.7471087124132614
chr4	FAM149A	186149565	186149704	520	140	724	5237	204	5097	3.7142857142857144	0.04002354326074161
chr4	FAM149A	186149592	186149704	520	113	724	5237	204	5124	4.601769911504425	0.03981264637002342
chr4	FAM149A	186151902	186152045	0	144	724	5237	724	5093	0.0	0.1421559002552523
chr4	KLKB1	186257225	186257365	0	141	7276	2934	7276	2793	0.0	2.6050841389187256
chr4	KLKB1	186228870	186228989	0	120	7276	2934	7276	2814	0.0	2.585643212508884
chr4	F11	186286414	186286510	289	97	15087	3921	14798	3824	2.979381443298969	3.8697698744769875
chr4	AC110772.2	187060033	187060077	0	45	0	1441	0	1396	0.0	0.0
chr4	AC097521.1	187632649	187632834	0	186	1468	6484	1468	6298	0.0	0.23308986979993648
chr4	AC097521.1	187622641	187622740	0	100	1468	6484	1468	6384	0.0	0.2299498746867168
chr4	AC097521.1	187621676	187621910	0	235	1468	6484	1468	6249	0.0	0.23491758681389022
chr4	ZFP42	187999107	187999273	0	167	0	2656	0	2489	0.0	0.0
chr4	LINC02434	188160215	188160332	0	118	0	1294	0	1176	0.0	0.0
chr4	LINC01060	188477637	188477912	0	276	0	5920	0	5644	0.0	0.0
chr4	LINC01060	188476697	188476756	0	60	0	5920	0	5860	0.0	0.0
chr4	LINC01060	188588594	188588713	0	120	0	5920	0	5800	0.0	0.0
chr4	FRG1	189941908	189942004	0	97	0	1559	0	1462	0.0	0.0
chr4	FRG1	189941832	189942004	0	173	0	1559	0	1386	0.0	0.0
chr4	FRG1	189941908	189942000	0	93	0	1559	0	1466	0.0	0.0
chr4	FRG1	189961428	189961550	0	123	0	1559	0	1436	0.0	0.0
chr5	SDHA	235143	235339	79170	197	1269287	7050	1190117	6853	401.8781725888325	173.66365095578578
chr5	SDHA	225418	225562	26925	145	1269287	7050	1242362	6905	185.68965517241378	179.92208544532946
chr5	PDCD6	272710	272772	716	63	1015817	9301	1015101	9238	11.365079365079366	109.88319982680234
chr5	PDCD6	306601	306760	57909	160	1015817	9301	957908	9141	361.93125	104.79247347117384
chr5	SDHA	220239	220337	735	99	1269287	7050	1268552	6951	7.424242424242424	182.49920874694288
chr5	PDCD6	306601	306754	46001	154	1015817	9301	969816	9147	298.7077922077922	106.02558215808462
chr5	PDCD6-AHRR	427636	427690	149	55	1364710	5888	1364561	5833	2.709090909090909	233.93811074918565
chr5	PDCD6	304176	304221	0	46	1015817	9301	1015817	9255	0.0	109.75872501350621
chr5	PDCD6	311292	311402	2852	111	1015817	9301	1012965	9190	25.693693693693692	110.22470076169749
chr5	EXOC3	444925	445064	306	140	695878	8157	695572	8017	2.1857142857142855	86.76213047274541
chr5	NKD2	1037519	1037698	51	180	1407	2618	1356	2438	0.2833333333333333	0.5561936013125512
chr5	AC124852.1	2103519	2103783	0	265	714	14286	714	14021	0.0	0.0509236145781328
chr5	C5ORF38	2753284	2753355	0	72	0	1929	0	1857	0.0	0.0
chr5	C5ORF38	2752621	2752754	0	134	0	1929	0	1795	0.0	0.0
chr5	LINC01377	3178667	3178893	0	227	0	1133	0	906	0.0	0.0
chr5	LINC01020	5051207	5051256	0	50	0	4734	0	4684	0.0	0.0
chr5	LINC01020	5059563	5059681	0	119	0	4734	0	4615	0.0	0.0
chr5	LINC01020	5057561	5057828	0	268	0	4734	0	4466	0.0	0.0
chr5	LINC01020	5051177	5051256	0	80	0	4734	0	4654	0.0	0.0
chr5	ADAMTS16	5236968	5237099	14	132	28548	5886	28534	5754	0.10606060606060606	4.958985053875565
chr5	LINC01018	6583602	6583801	0	200	139452	7086	139452	6886	0.0	20.25152483299448
chr5	LINC01018	6586227	6586346	0	120	139452	7086	139452	6966	0.0	20.01894918173988
chr5	LINC01018	6583701	6583801	0	101	139452	7086	139452	6985	0.0	19.964495347172512
chr5	LINC01018	6584637	6584695	0	59	139452	7086	139452	7027	0.0	19.84516863526398
chr5	SRD5A1	6644807	6645309	2172	503	419286	7638	417114	7135	4.318091451292246	58.46026629292221
chr5	SRD5A1	6651841	6652008	7292	168	419286	7638	411994	7470	43.404761904761905	55.15314591700134
chr5	AC122710.1	6870457	6870621	0	165	0	2026	0	1861	0.0	0.0
chr5	LINC02142	7386923	7387050	0	128	0	1327	0	1199	0.0	0.0
chr5	MTRR	7856786	7856892	0	107	287337	6426	287337	6319	0.0	45.47191011235955
chr5	MTRR	7873372	7873512	1761	141	287337	6426	285576	6285	12.48936170212766	45.43770883054893
chr5	MTRR	7886614	7886703	868	90	287337	6426	286469	6336	9.644444444444444	45.21291035353536
chr5	MTRR	7873372	7873526	2293	155	287337	6426	285044	6271	14.793548387096774	45.454313506617765
chr5	MTRR	7870769	7870923	1794	155	287337	6426	285543	6271	11.574193548387097	45.533886142560995
chr5	MTRR	7872229	7872305	0	77	287337	6426	287337	6349	0.0	45.25704835407151
chr5	AC091953.1	8528476	8528678	0	203	0	1238	0	1035	0.0	0.0
chr5	AC091953.1	8528510	8528678	0	169	0	1238	0	1069	0.0	0.0
chr5	LINC02199	8868966	8869018	0	53	0	8746	0	8693	0.0	0.0
chr5	LINC02199	8873735	8873859	0	125	0	8746	0	8621	0.0	0.0
chr5	LINC02221	9859714	9859884	0	171	0	1485	0	1314	0.0	0.0
chr5	LINC02221	9889609	9889943	0	335	0	1485	0	1150	0.0	0.0
chr5	CCT5	10254673	10254838	230030	166	3041094	5425	2811064	5259	1385.7228915662652	534.5244343030995
chr5	CCT5	10254765	10254838	228685	74	3041094	5425	2812409	5351	3090.337837837838	525.5856849187068
chr5	MARCHF6	10381799	10381943	13886	145	928397	8776	914511	8631	95.76551724137931	105.95655196385124
chr5	MARCHF6	10386993	10387066	352	74	928397	8776	928045	8702	4.756756756756757	106.64732245460813
chr5	ANKRD33B	10624724	10625181	357	458	265570	10048	265213	9590	0.7794759825327511	27.655161626694472
chr5	LINC01194	12595696	12595778	0	83	5639	3128	5639	3045	0.0	1.851888341543514
chr5	TRIO	14507121	14507260	9707	140	1180599	17006	1170892	16866	69.33571428571429	69.42321830902407
chr5	OTULINL	14601350	14601442	134	93	4397	2763	4263	2670	1.4408602150537635	1.5966292134831461
chr5	OTULIN	14673641	14673718	0	78	542706	8760	542706	8682	0.0	62.50932964754665
chr5	LINC02217	17437189	17437213	0	25	0	8721	0	8696	0.0	0.0
chr5	LINC02217	17411891	17412008	0	118	0	8721	0	8603	0.0	0.0
chr5	LINC02217	17404557	17404729	0	173	0	8721	0	8548	0.0	0.0
chr5	LINC02223	17762153	17762295	0	143	88	7967	88	7824	0.0	0.011247443762781187
chr5	LINC02223	17787464	17787568	0	105	88	7967	88	7862	0.0	0.011193080641058254
chr5	LINC02223	17850182	17850373	0	192	88	7967	88	7775	0.0	0.011318327974276527
chr5	LINC02223	17873019	17873086	0	68	88	7967	88	7899	0.0	0.011140650715280415
chr5	LINC02223	17920226	17920309	0	84	88	7967	88	7883	0.0	0.011163262717239629
chr5	LINC02241	20807852	20807913	0	62	518	9146	518	9084	0.0	0.05702333773667988
chr5	LINC02241	20895482	20895567	0	86	518	9146	518	9060	0.0	0.05717439293598234
chr5	LINC02241	20937178	20937257	0	80	518	9146	518	9066	0.0	0.057136554158394
chr5	LINC02241	20670566	20670611	0	46	518	9146	518	9100	0.0	0.05692307692307692
chr5	LINC02241	20814328	20814398	0	71	518	9146	518	9075	0.0	0.05707988980716253
chr5	LINC02241	20612824	20612873	0	50	518	9146	518	9096	0.0	0.056948109058927
chr5	LINC02241	20852057	20852103	0	47	518	9146	518	9099	0.0	0.05692933289372459
chr5	LINC02241	20660711	20660768	0	58	518	9146	518	9088	0.0	0.05699823943661972
chr5	LINC02241	20736954	20737101	0	148	518	9146	518	8998	0.0	0.057568348521893756
chr5	LINC02241	20838436	20838487	0	52	518	9146	518	9094	0.0	0.05696063338464922
chr5	LINC02241	20934174	20934244	0	71	518	9146	518	9075	0.0	0.05707988980716253
chr5	LINC02241	20751563	20751844	0	282	518	9146	518	8864	0.0	0.05843862815884476
chr5	LINC02241	20612824	20613033	0	210	518	9146	518	8936	0.0	0.057967770814682185
chr5	LINC02241	20925178	20925288	0	111	518	9146	518	9035	0.0	0.057332595462091865
chr5	LINC02241	20736954	20737145	0	192	518	9146	518	8954	0.0	0.05785123966942149
chr5	LINC02241	20699728	20699855	0	128	518	9146	518	9018	0.0	0.057440674207141273
chr5	LINC02241	20705720	20705817	0	98	518	9146	518	9048	0.0	0.057250221043324494
chr5	LINC02241	20749523	20749607	0	85	518	9146	518	9061	0.0	0.057168082993047126
chr5	LINC02241	20838433	20838487	0	55	518	9146	518	9091	0.0	0.05697943020569794
chr5	LINC02241	20807852	20807865	0	14	518	9146	518	9132	0.0	0.056723609286027155
chr5	LINC02241	20935377	20935466	0	90	518	9146	518	9056	0.0	0.05719964664310954
chr5	AC091938.1	22755015	22755086	0	72	0	4537	0	4465	0.0	0.0
chr5	LINC02211	25298978	25299060	0	83	133852	5542	133852	5459	0.0	24.519509067594797
chr5	PURPL	27438376	27438530	0	155	102	4915	102	4760	0.0	0.02142857142857143
chr5	PURPL	27476086	27476158	0	73	102	4915	102	4842	0.0	0.021065675340768277
chr5	PURPL	27484925	27485029	0	105	102	4915	102	4810	0.0	0.021205821205821207
chr5	PURPL	27494234	27494335	0	102	102	4915	102	4813	0.0	0.021192603365884063
chr5	PURPL	27489281	27489386	0	106	102	4915	102	4809	0.0	0.021210230817217717
chr5	PURPL	27494118	27494335	0	218	102	4915	102	4697	0.0	0.021715988929103685
chr5	PURPL	27493569	27494335	0	767	102	4915	102	4148	0.0	0.02459016393442623
chr5	PURPL	27477638	27477801	0	164	102	4915	102	4751	0.0	0.02146916438644496
chr5	PURPL	27493569	27493687	0	119	102	4915	102	4796	0.0	0.021267723102585488
chr5	PURPL	27476068	27476158	0	91	102	4915	102	4824	0.0	0.021144278606965175
chr5	LINC02109	29146270	29146461	0	192	0	5628	0	5436	0.0	0.0
chr5	LINC02109	29148602	29148912	0	311	0	5628	0	5317	0.0	0.0
chr5	LINC02109	29211311	29211413	0	103	0	5628	0	5525	0.0	0.0
chr5	C5ORF22	31540948	31541011	51	64	363258	3849	363207	3785	0.796875	95.95957727873184
chr5	C5ORF22	31534958	31535051	0	94	363258	3849	363258	3755	0.0	96.73981358189081
chr5	PDZD2	32069568	32069650	0	83	19111	15956	19111	15873	0.0	1.203994203994204
chr5	PDZD2	32101104	32101239	5	136	19111	15956	19106	15820	0.03676470588235294	1.2077117572692795
chr5	SUB1	32598960	32599069	9564	110	1415982	9276	1406418	9166	86.94545454545455	153.43857735108008
chr5	SUB1	32571090	32571174	78	85	1415982	9276	1415904	9191	0.9176470588235294	154.05331302361006
chr5	SUB1	32588511	32588584	184	74	1415982	9276	1415798	9202	2.4864864864864864	153.85763964355576
chr5	SUB1	32594570	32594872	4503	303	1415982	9276	1411479	8973	14.861386138613861	157.30290872617854
chr5	SUB1	32586368	32586501	1955	134	1415982	9276	1414027	9142	14.58955223880597	154.6737037847298
chr5	SUB1	32586428	32586501	438	74	1415982	9276	1415544	9202	5.918918918918919	153.83003694848946
chr5	LINC02160	33248541	33248651	0	111	0	2617	0	2506	0.0	0.0
chr5	TARS1	33448540	33448731	60246	192	669723	4126	609477	3934	313.78125	154.92552109811896
chr5	TARS1	33452340	33452439	0	100	669723	4126	669723	4026	0.0	166.349478390462
chr5	TARS1	33446643	33446764	138	122	669723	4126	669585	4004	1.1311475409836065	167.229020979021
chr5	TARS1	33446606	33446764	153	159	669723	4126	669570	3967	0.9622641509433962	168.78497605243257
chr5	RAI14	34813573	34813660	1441	88	323911	7612	322470	7524	16.375	42.85885167464115
chr5	RAI14	34667262	34667379	0	118	323911	7612	323911	7494	0.0	43.22271150253536
chr5	RAI14	34658995	34659072	211	78	323911	7612	323700	7534	2.7051282051282053	42.96522431643218
chr5	RAI14	34685031	34685081	0	51	323911	7612	323911	7561	0.0	42.83970374289115
chr5	RAI14	34688067	34688248	1029	182	323911	7612	322882	7430	5.653846153846154	43.45652759084791
chr5	RAI14	34716054	34716221	0	168	323911	7612	323911	7444	0.0	43.51303062869425
chr5	TTC23L	34845486	34845673	0	188	957	2550	957	2362	0.0	0.40516511430990687
chr5	TTC23L	34850184	34850308	0	125	957	2550	957	2425	0.0	0.39463917525773196
chr5	TTC23L	34868904	34869013	0	110	957	2550	957	2440	0.0	0.39221311475409837
chr5	TTC23L	34888454	34888537	0	84	957	2550	957	2466	0.0	0.3880778588807786
chr5	DNAJC21	34949542	34949677	804	136	301849	9571	301045	9435	5.911764705882353	31.90726020137785
chr5	SPEF2	35644354	35644525	77	172	17900	16187	17823	16015	0.4476744186046512	1.1128941617233843
chr5	SPEF2	35702152	35702319	0	168	17900	16187	17900	16019	0.0	1.1174230601161121
chr5	SPEF2	35791507	35791575	0	69	17900	16187	17900	16118	0.0	1.110559622781983
chr5	IL7R	35873479	35873648	7264	170	406768	5933	399504	5763	42.72941176470588	69.32222800624675
chr5	IL7R	35874448	35874542	812	95	406768	5933	405956	5838	8.547368421052632	69.53682768071258
chr5	SKP2	36163644	36163756	1977	113	760021	10355	758044	10242	17.495575221238937	74.0132786565124
chr5	SKP2	36168312	36168447	9516	136	760021	10355	750505	10219	69.97058823529412	73.44211762403366
chr5	SKP2	36178597	36178810	1390	214	760021	10355	758631	10141	6.4953271028037385	74.80830292870526
chr5	SKP2	36164534	36164695	1180	162	760021	10355	758841	10193	7.283950617283951	74.44726773275778
chr5	SKP2	36159772	36159874	0	103	760021	10355	760021	10252	0.0	74.13392508778774
chr5	SKP2	36191522	36191702	0	181	760021	10355	760021	10174	0.0	74.70228032239041
chr5	SKP2	36191411	36191702	0	292	760021	10355	760021	10063	0.0	75.52628440822816
chr5	SKP2	36152770	36153042	34048	273	760021	10355	725973	10082	124.71794871794872	72.0068438801825
chr5	SKP2	36164627	36164695	449	69	760021	10355	759572	10286	6.507246376811594	73.84522652148551
chr5	SKP2	36192620	36192695	51	76	760021	10355	759970	10279	0.6710526315789473	73.93423484774783
chr5	SLC1A3	36629449	36629587	45	139	53849	6239	53804	6100	0.3237410071942446	8.82032786885246
chr5	SLC1A3	36683863	36683998	338	136	53849	6239	53511	6103	2.485294117647059	8.767982959200394
chr5	SLC1A3	36607223	36607311	0	89	53849	6239	53849	6150	0.0	8.755934959349593
chr5	NIPBL	37057185	37057332	946	148	115810	12568	114864	12420	6.391891891891892	9.24830917874396
chr5	NIPBL	37060843	37061018	2451	176	115810	12568	113359	12392	13.926136363636363	9.14775661717237
chr5	WDR70	37379488	37379554	2184	67	136878	5558	134694	5491	32.59701492537314	24.52995811327627
chr5	WDR70	37687909	37688007	0	99	136878	5558	136878	5459	0.0	25.07382304451365
chr5	LINC02119	38040916	38040974	0	59	0	4422	0	4363	0.0	0.0
chr5	LINC02119	38148467	38148601	0	135	0	4422	0	4287	0.0	0.0
chr5	LINC02119	38132442	38132538	0	97	0	4422	0	4325	0.0	0.0
chr5	LINC02119	38041247	38041291	0	45	0	4422	0	4377	0.0	0.0
chr5	EGFLAM	38418065	38418255	0	191	0	6208	0	6017	0.0	0.0
chr5	EGFLAM	38445678	38445702	0	25	0	6208	0	6183	0.0	0.0
chr5	EGFLAM	38305431	38305617	0	187	0	6208	0	6021	0.0	0.0
chr5	LIFR-AS1	38615573	38615659	0	87	2220	7564	2220	7477	0.0	0.2969105256118764
chr5	LIFR-AS1	38646631	38646714	0	84	2220	7564	2220	7480	0.0	0.2967914438502674
chr5	LIFR-AS1	38640928	38641029	0	102	2220	7564	2220	7462	0.0	0.2975073706781024
chr5	AC114977.1	40486375	40486498	0	124	0	938	0	814	0.0	0.0
chr5	FBXO4	41927012	41927248	15591	237	152663	3022	137072	2785	65.78481012658227	49.217953321364455
chr5	FBXO4	41939440	41939616	6223	177	152663	3022	146440	2845	35.15819209039548	51.472759226713535
chr5	FBXO4	41928517	41928691	315	175	152663	3022	152348	2847	1.8	53.511766772040744
chr5	GHR	42629037	42629103	0	67	6967	6970	6967	6903	0.0	1.0092713313052295
chr5	GHR	42688889	42689019	30	131	6967	6970	6937	6839	0.22900763358778625	1.0143295803480041
chr5	GHR	42718051	42718121	0	71	6967	6970	6967	6899	0.0	1.0098565009421656
chr5	GHR	42514079	42514364	0	286	6967	6970	6967	6684	0.0	1.0423399162178337
chr5	AC008945.2	42817066	42817351	0	286	0	1807	0	1521	0.0	0.0
chr5	AC008945.2	42910724	42910843	0	120	0	1807	0	1687	0.0	0.0
chr5	AC025171.3	43019235	43019316	192	82	7929	1782	7737	1700	2.341463414634146	4.551176470588235
chr5	AC025171.3	43023918	43024097	126	180	7929	1782	7803	1602	0.7	4.870786516853933
chr5	AC025171.3	43023918	43024109	126	192	7929	1782	7803	1590	0.65625	4.907547169811321
chr5	ZNF131	43139164	43139309	8377	146	325812	8233	317435	8087	57.37671232876713	39.2525040187956
chr5	ZNF131	43161248	43161931	57855	684	325812	8233	267957	7549	84.58333333333333	35.49569479401245
chr5	ZNF131	43167929	43168029	606	101	325812	8233	325206	8132	6.0	39.99090014756518
chr5	NNT	43612907	43613137	38801	231	578620	10606	539819	10375	167.96969696969697	52.03074698795181
chr5	NNT	43619086	43619119	52	34	578620	10606	578568	10572	1.5294117647058822	54.72644721906924
chr5	NNT	43700118	43700237	2702	120	578620	10606	575918	10486	22.516666666666666	54.92256341789052
chr5	NNT	43619031	43619119	205	89	578620	10606	578415	10517	2.303370786516854	54.99809831701055
chr5	NNT	43604594	43604670	0	77	578620	10606	578620	10529	0.0	54.954886503941495
chr5	NNT	43609142	43609346	18150	205	578620	10606	560470	10401	88.53658536585365	53.88616479184694
chr5	NNT	43647923	43648440	2704	518	578620	10606	575916	10088	5.22007722007722	57.08921490880254
chr5	NNT	43612907	43613481	60176	575	578620	10606	518444	10031	104.65391304347825	51.68417904496062
chr5	NNT	43609515	43609551	5	37	578620	10606	578615	10569	0.13513513513513514	54.74642823351311
chr5	NNT	43624031	43624120	663	90	578620	10606	577957	10516	7.366666666666666	54.95977558006847
chr5	NNT	43647923	43648182	1276	260	578620	10606	577344	10346	4.907692307692308	55.80359559249952
chr5	PARP8	50668070	50668125	0	56	0	10081	0	10025	0.0	0.0
chr5	PARP8	50750150	50750188	0	39	0	10081	0	10042	0.0	0.0
chr5	PARP8	50760291	50760362	0	72	0	10081	0	10009	0.0	0.0
chr5	PARP8	50788522	50788589	0	68	0	10081	0	10013	0.0	0.0
chr5	PARP8	50821212	50821338	0	127	0	10081	0	9954	0.0	0.0
chr5	PARP8	50757118	50757215	0	98	0	10081	0	9983	0.0	0.0
chr5	PARP8	50759642	50759732	0	91	0	10081	0	9990	0.0	0.0
chr5	ITGA2	53026747	53026868	0	122	102	7926	102	7804	0.0	0.013070220399794977
chr5	ITGA2	53073117	53073259	0	143	102	7926	102	7783	0.0	0.013105486316330463
chr5	ITGA2	53078771	53078874	0	104	102	7926	102	7822	0.0	0.013040143185885963
chr5	ITGA2	53048642	53048770	0	129	102	7926	102	7797	0.0	0.013081954597922277
chr5	AC008966.1	53112239	53113034	0	796	0	7567	0	6771	0.0	0.0
chr5	NDUFS4	53573607	53573731	0	125	55	1181	55	1056	0.0	0.052083333333333336
chr5	NDUFS4	53658550	53658624	0	75	55	1181	55	1106	0.0	0.04972875226039783
chr5	NDUFS4	53604806	53604895	0	90	55	1181	55	1091	0.0	0.05041246562786435
chr5	NDUFS4	53604723	53604895	0	173	55	1181	55	1008	0.0	0.054563492063492064
chr5	LINC01033	54396996	54397134	0	139	41	3578	41	3439	0.0	0.0119220703692934
chr5	LINC01033	54395348	54395417	0	70	41	3578	41	3508	0.0	0.011687571265678449
chr5	LINC01033	54401642	54401865	0	224	41	3578	41	3354	0.0	0.012224209898628503
chr5	LINC01033	54317551	54317788	0	238	41	3578	41	3340	0.0	0.012275449101796407
chr5	LINC01033	54400436	54400532	0	97	41	3578	41	3481	0.0	0.01177822464808963
chr5	LINC01033	54340192	54340309	0	118	41	3578	41	3460	0.0	0.011849710982658959
chr5	LINC01033	54403522	54403788	0	267	41	3578	41	3311	0.0	0.012382965871337965
chr5	LINC01033	54402756	54403788	0	1033	41	3578	41	2545	0.0	0.016110019646365423
chr5	LINC01033	54400436	54400598	0	163	41	3578	41	3415	0.0	0.012005856515373352
chr5	GPX8	55161051	55161255	0	205	13126	3883	13126	3678	0.0	3.5687873844480698
chr5	GPX8	55160329	55160396	603	68	13126	3883	12523	3815	8.867647058823529	3.2825688073394494
chr5	GPX8	55160993	55161255	0	263	13126	3883	13126	3620	0.0	3.6259668508287293
chr5	MTREX	55328698	55328811	0	114	1856	6375	1856	6261	0.0	0.296438268647181
chr5	DDX4	55760199	55760277	0	79	0	3844	0	3765	0.0	0.0
chr5	DDX4	55785296	55785344	0	49	0	3844	0	3795	0.0	0.0
chr5	DDX4	55790575	55790705	0	131	0	3844	0	3713	0.0	0.0
chr5	DDX4	55767880	55767940	0	61	0	3844	0	3783	0.0	0.0
chr5	DDX4	55779963	55780065	0	103	0	3844	0	3741	0.0	0.0
chr5	IL31RA	55868790	55868908	0	119	0	6391	0	6272	0.0	0.0
chr5	IL31RA	55853321	55853567	0	247	0	6391	0	6144	0.0	0.0
chr5	IL31RA	55852194	55852312	0	119	0	6391	0	6272	0.0	0.0
chr5	IL31RA	55866610	55866754	0	145	0	6391	0	6246	0.0	0.0
chr5	SETD9	56911168	56911536	0	369	0	2601	0	2232	0.0	0.0
chr5	SETD9	56911168	56911502	0	335	0	2601	0	2266	0.0	0.0
chr5	GPBP1	57214073	57214193	0	121	816	5939	816	5818	0.0	0.14025438294946718
chr5	GPBP1	57237112	57237172	0	61	816	5939	816	5878	0.0	0.1388227288193263
chr5	GPBP1	57221375	57221396	0	22	816	5939	816	5917	0.0	0.13790772350853472
chr5	LINCR-0003	57581605	57581688	0	84	0	4731	0	4647	0.0	0.0
chr5	LINCR-0003	57577833	57577924	0	92	0	4731	0	4639	0.0	0.0
chr5	LINCR-0003	57578835	57578914	0	80	0	4731	0	4651	0.0	0.0
chr5	LINCR-0003	57577698	57577924	0	227	0	4731	0	4504	0.0	0.0
chr5	PART1	60542649	60542830	0	182	51	12711	51	12529	0.0	0.004070556309362279
chr5	PART1	60529403	60529543	0	141	51	12711	51	12570	0.0	0.004057279236276849
chr5	PART1	60533931	60534019	0	89	51	12711	51	12622	0.0	0.004040564094438283
chr5	PART1	60521019	60521643	0	625	51	12711	51	12086	0.0	0.004219758398146616
chr5	PART1	60521019	60522966	0	1948	51	12711	51	10763	0.0	0.004738455820867788
chr5	NDUFAF2	61073124	61073214	0	91	0	6915	0	6824	0.0	0.0
chr5	NDUFAF2	61098991	61099032	0	42	0	6915	0	6873	0.0	0.0
chr5	C5ORF64	61633847	61633970	0	124	51271	22226	51271	22102	0.0	2.319744819473351
chr5	C5ORF64	61686882	61687070	3141	189	51271	22226	48130	22037	16.61904761904762	2.1840540908472117
chr5	C5ORF64	61751669	61751770	0	102	51271	22226	51271	22124	0.0	2.317438076297234
chr5	C5ORF64	61750336	61750544	0	209	51271	22226	51271	22017	0.0	2.3287005495753283
chr5	C5ORF64	61703865	61704108	0	244	51271	22226	51271	21982	0.0	2.3324083340915296
chr5	C5ORF64	61713873	61713969	0	97	51271	22226	51271	22129	0.0	2.316914456143522
chr5	C5ORF64	61643326	61643400	0	75	51271	22226	51271	22151	0.0	2.31461333574105
chr5	C5ORF64	61693495	61693560	442	66	51271	22226	50829	22160	6.696969696969697	2.293727436823105
chr5	AC008877.1	61881246	61881292	0	47	86	913	86	866	0.0	0.09930715935334873
chr5	KIF2A	62372437	62372551	0	115	102	12836	102	12721	0.0	0.008018237559940257
chr5	KIF2A	62308308	62308511	0	204	102	12836	102	12632	0.0	0.008074730842305257
chr5	KIF2A	62354314	62354369	0	56	102	12836	102	12780	0.0	0.007981220657276996
chr5	IPO11	62476682	62476753	0	72	102	7579	102	7507	0.0	0.013587318502730785
chr5	IPO11	62422504	62422568	0	65	102	7579	102	7514	0.0	0.013574660633484163
chr5	IPO11	62601763	62601848	0	86	102	7579	102	7493	0.0	0.013612705191512078
chr5	IPO11	62579400	62579483	0	84	102	7579	102	7495	0.0	0.013609072715143429
chr5	RGS7BP	64507710	64507877	68	168	8692	4635	8624	4467	0.40476190476190477	1.9306021938661293
chr5	SHISAL2B	64694086	64694199	0	114	1275	1241	1275	1127	0.0	1.1313220940550133
chr5	SHISAL2B	64694086	64694182	0	97	1275	1241	1275	1144	0.0	1.1145104895104896
chr5	PPWD1	65563802	65563839	0	38	594	3309	594	3271	0.0	0.18159584225007644
chr5	PPWD1	65568917	65568994	0	78	594	3309	594	3231	0.0	0.18384401114206128
chr5	PPWD1	65567512	65567615	0	104	594	3309	594	3205	0.0	0.18533541341653667
chr5	TRAPPC13	65637695	65637780	0	86	0	3663	0	3577	0.0	0.0
chr5	TRAPPC13	65655635	65655653	0	19	0	3663	0	3644	0.0	0.0
chr5	NLN	65758566	65758826	0	261	51	10957	51	10696	0.0	0.004768137621540763
chr5	NLN	65740894	65741000	0	107	51	10957	51	10850	0.0	0.004700460829493088
chr5	ERBIN	66075023	66075230	0	208	153	10160	153	9952	0.0	0.01537379421221865
chr5	ERBIN	66076874	66076949	0	76	153	10160	153	10084	0.0	0.015172550575168585
chr5	ERBIN	66072168	66072291	0	124	153	10160	153	10036	0.0	0.015245117576723794
chr5	ERBIN	66068876	66069020	0	145	153	10160	153	10015	0.0	0.01527708437343984
chr5	SREK1	66158808	66158932	0	125	241	17083	241	16958	0.0	0.014211581554428589
chr5	AC092353.1	66307093	66307313	0	221	612	4196	612	3975	0.0	0.15396226415094338
chr5	AC092353.1	66322832	66322940	0	109	612	4196	612	4087	0.0	0.14974308783949106
chr5	AC092353.1	66307671	66307775	0	105	612	4196	612	4091	0.0	0.14959667562943046
chr5	AC092353.1	66307134	66307313	0	180	612	4196	612	4016	0.0	0.15239043824701196
chr5	AC092353.1	66307031	66307313	0	283	612	4196	612	3913	0.0	0.15640173779708663
chr5	MAST4	67149388	67149589	0	202	153	14654	153	14452	0.0	0.010586769997232216
chr5	MAST4	66916982	66917018	0	37	153	14654	153	14617	0.0	0.010467264144489292
chr5	MAST4	66902648	66902736	0	89	153	14654	153	14565	0.0	0.010504634397528322
chr5	MAST4	66963718	66963787	0	70	153	14654	153	14584	0.0	0.010490948985189248
chr5	MAST4	66870777	66870852	0	76	153	14654	153	14578	0.0	0.010495266840444505
chr5	MAST4	66964039	66964061	0	23	153	14654	153	14631	0.0	0.010457248308386303
chr5	MAST4	66963706	66963787	0	82	153	14654	153	14572	0.0	0.01049958825144112
chr5	MAST4	67094156	67094165	0	10	153	14654	153	14644	0.0	0.010447965036875171
chr5	AC112206.2	67620145	67620289	51	145	140	5824	89	5679	0.35172413793103446	0.015671773199506956
chr5	AC112206.2	67763974	67764093	0	120	140	5824	140	5704	0.0	0.024544179523141654
chr5	AC112206.2	67790448	67790538	0	91	140	5824	140	5733	0.0	0.02442002442002442
chr5	AC112206.2	67797628	67797756	0	129	140	5824	140	5695	0.0	0.024582967515364356
chr5	AC112206.2	67797349	67797756	0	408	140	5824	140	5416	0.0	0.0258493353028065
chr5	AC112206.2	67797349	67797507	0	159	140	5824	140	5665	0.0	0.02471315092674316
chr5	AC112206.2	67801625	67801698	0	74	140	5824	140	5750	0.0	0.02434782608695652
chr5	AC112206.2	67804279	67804325	0	47	140	5824	140	5777	0.0	0.024234031504240954
chr5	AC112206.2	67797349	67797492	0	144	140	5824	140	5680	0.0	0.02464788732394366
chr5	AC112206.2	67797393	67797507	0	115	140	5824	140	5709	0.0	0.024522683482221055
chr5	PIK3R1	68292258	68292361	0	104	192	10428	192	10324	0.0	0.018597442851607904
chr5	SLC30A5	69100806	69100929	0	124	84	5249	84	5125	0.0	0.016390243902439025
chr5	SLC30A5	69104630	69104716	0	87	84	5249	84	5162	0.0	0.016272762495156915
chr5	SLC30A5	69128003	69128132	0	130	84	5249	84	5119	0.0	0.016409454971674155
chr5	CCNB1	69174250	69174409	77	160	77	2442	0	2282	0.48125	0.0
chr5	CCNB1	69177238	69177349	0	112	77	2442	77	2330	0.0	0.03304721030042918
chr5	CCNB1	69177290	69177349	0	60	77	2442	77	2382	0.0	0.03232577665827036
chr5	CENPH	69195716	69195791	28	76	2657	2227	2629	2151	0.3684210526315789	1.2222222222222223
chr5	CENPH	69197052	69197109	0	58	2657	2227	2657	2169	0.0	1.2249884739511296
chr5	CENPH	69195716	69195750	0	35	2657	2227	2657	2192	0.0	1.2121350364963503
chr5	MRPS36	69226337	69226401	0	65	1901	1563	1901	1498	0.0	1.2690253671562082
chr5	CDK7	69252417	69252451	0	35	3451	2383	3451	2348	0.0	1.4697614991482113
chr5	CDK7	69254601	69254669	0	69	3451	2383	3451	2314	0.0	1.4913569576490924
chr5	CDK7	69258042	69258153	7	112	3451	2383	3444	2271	0.0625	1.5165125495376486
chr5	CDK7	69259817	69259936	0	120	3451	2383	3451	2263	0.0	1.5249668581528943
chr5	CDK7	69254601	69254667	0	67	3451	2383	3451	2316	0.0	1.4900690846286702
chr5	CDK7	69255459	69255528	0	70	3451	2383	3451	2313	0.0	1.492001729355815
chr5	CDK7	69250744	69250831	84	88	3451	2383	3367	2295	0.9545454545454546	1.4671023965141612
chr5	RAD17	69371034	69371171	286	138	22970	4169	22684	4031	2.072463768115942	5.627387744976432
chr5	RAD17	69372033	69372217	4794	185	22970	4169	18176	3984	25.913513513513514	4.562248995983936
chr5	RAD17	69373829	69374087	3160	259	22970	4169	19810	3910	12.200772200772201	5.0664961636828645
chr5	RAD17	69410492	69410550	0	59	22970	4169	22970	4110	0.0	5.588807785888078
chr5	RAD17	69371453	69371557	2357	105	22970	4169	20613	4064	22.447619047619046	5.072096456692913
chr5	RAD17	69392770	69392892	153	123	22970	4169	22817	4046	1.2439024390243902	5.639396935244686
chr5	MARVELD2	69424600	69424636	0	37	4055	4722	4055	4685	0.0	0.8655282817502669
chr5	OCLN	69509140	69509819	510	680	5558	6771	5048	6091	0.75	0.8287637497947792
chr5	GTF2H2C	69562672	69562770	0	99	552	6782	552	6683	0.0	0.08259763579230885
chr5	GTF2H2C	69566588	69566625	0	38	552	6782	552	6744	0.0	0.08185053380782918
chr5	GTF2H2C	69567726	69567777	42	52	552	6782	510	6730	0.8076923076923077	0.07578008915304606
chr5	GTF2H2C	69568152	69568207	0	56	552	6782	552	6726	0.0	0.08206958073148975
chr5	SMN2	70069234	70069330	0	97	4803	2998	4803	2901	0.0	1.655635987590486
chr5	SMN2	70066933	70067134	0	202	4803	2998	4803	2796	0.0	1.7178111587982832
chr5	SMN2	70071281	70071390	0	110	4803	2998	4803	2888	0.0	1.6630886426592797
chr5	SMN2	70076520	70076574	0	55	4803	2998	4803	2943	0.0	1.6320081549439347
chr5	SMN2	70069025	70069142	104	118	4803	2998	4699	2880	0.8813559322033898	1.6315972222222221
chr5	GTF2H2B	70421734	70421771	0	38	5479	3998	5479	3960	0.0	1.3835858585858587
chr5	GTF2H2B	70417821	70417919	123	99	5479	3998	5356	3899	1.2424242424242424	1.3736855604001026
chr5	GTF2H2B	70421736	70421771	0	36	5479	3998	5479	3962	0.0	1.3828874305906107
chr5	SERF1A	70901411	70901471	0	61	2042	2908	2042	2847	0.0	0.7172462240955392
chr5	SMN1	70942357	70942558	34	202	555953	3108	555919	2906	0.16831683168316833	191.30041293874743
chr5	SMN1	70944657	70944753	0	97	555953	3108	555953	3011	0.0	184.6406509465294
chr5	SMN1	70946706	70946815	51	110	555953	3108	555902	2998	0.4636363636363636	185.4242828552368
chr5	SMN1	70951940	70951994	0	55	555953	3108	555953	3053	0.0	182.1005568293482
chr5	SMN1	70944448	70944565	0	118	555953	3108	555953	2990	0.0	185.93745819397992
chr5	BDP1	71549419	71549606	242	188	342130	12440	341888	12252	1.2872340425531914	27.904668625530526
chr5	BDP1	71539556	71539649	0	94	342130	12440	342130	12346	0.0	27.711809492953183
chr5	BDP1	71562774	71562895	0	122	342130	12440	342130	12318	0.0	27.774801104075337
chr5	MCCC2	71626639	71626753	1528	115	45742	5197	44214	5082	13.28695652173913	8.700118063754427
chr5	MAP1B	72116421	72116453	0	33	740302	12551	740302	12518	0.0	59.13899984023007
chr5	MAP1B	72193277	72193328	158	52	740302	12551	740144	12499	3.0384615384615383	59.21625730058405
chr5	PTCD2	72326611	72326741	0	131	23015	11876	23015	11745	0.0	1.9595572584078331
chr5	PTCD2	72331257	72331375	0	119	23015	11876	23015	11757	0.0	1.9575571999659778
chr5	PTCD2	72335017	72335096	0	80	23015	11876	23015	11796	0.0	1.9510851135978298
chr5	TNPO1	72855773	72855923	390	151	18137	12007	17747	11856	2.5827814569536423	1.496879217273954
chr5	TNPO1	72875614	72875737	1391	124	18137	12007	16746	11883	11.21774193548387	1.4092400908861398
chr5	FCHO2	72989426	72989501	0	76	6400	6094	6400	6018	0.0	1.0634762379528082
chr5	FCHO2	73015625	73015724	0	100	6400	6094	6400	5994	0.0	1.0677344010677343
chr5	AC116345.1	73289754	73289951	51	198	51	2303	0	2105	0.25757575757575757	0.0
chr5	BTF3	73499133	73499202	0	70	0	5245	0	5175	0.0	0.0
chr5	BTF3	73502487	73502601	0	115	0	5245	0	5130	0.0	0.0
chr5	BTF3	73504346	73504403	0	58	0	5245	0	5187	0.0	0.0
chr5	BTF3	73503936	73504028	0	93	0	5245	0	5152	0.0	0.0
chr5	UTP15	73567261	73567434	0	174	32	6337	32	6163	0.0	0.005192276488723025
chr5	ARHGEF28	73897961	73898093	0	133	102	12567	102	12434	0.0	0.008203313495254947
chr5	ARHGEF28	73923086	73923164	0	79	102	12567	102	12488	0.0	0.008167841127482383
chr5	ARHGEF28	73627117	73627289	0	173	102	12567	102	12394	0.0	0.008229788607390673
chr5	LINC01333	74325811	74325937	0	127	510	3595	510	3468	0.0	0.14705882352941177
chr5	LINC01333	74338971	74339125	0	155	510	3595	510	3440	0.0	0.14825581395348839
chr5	LINC01333	74324430	74324518	0	89	510	3595	510	3506	0.0	0.14546491728465488
chr5	LINC01333	74324406	74324518	0	113	510	3595	510	3482	0.0	0.14646754738655945
chr5	HEXB	74716586	74716673	0	88	31524	4800	31524	4712	0.0	6.690152801358234
chr5	NSA2	74773867	74774060	0	194	0	4969	0	4775	0.0	0.0
chr5	HMGCR	75355055	75355214	0	160	0	6074	0	5914	0.0	0.0
chr5	HMGCR	75359397	75359556	0	160	0	6074	0	5914	0.0	0.0
chr5	HMGCR	75359169	75359310	0	142	0	6074	0	5932	0.0	0.0
chr5	POLK	75547009	75547157	0	149	113487	8391	113487	8242	0.0	13.769352099005095
chr5	POLK	75590343	75590440	0	98	113487	8391	113487	8293	0.0	13.684673821295068
chr5	POLK	75593877	75594049	0	173	113487	8391	113487	8218	0.0	13.809564370893161
chr5	POLK	75593965	75594049	0	85	113487	8391	113487	8306	0.0	13.663255477967734
chr5	POLK	75568676	75568790	0	115	113487	8391	113487	8276	0.0	13.712783953600773
chr5	POLK	75596221	75597178	0	958	113487	8391	113487	7433	0.0	15.267994080452038
chr5	POLK	75568705	75568790	0	86	113487	8391	113487	8305	0.0	13.664900662251656
chr5	ANKDD1B	75669251	75669383	0	133	60	3255	60	3122	0.0	0.019218449711723255
chr5	ANKDD1B	75620314	75620413	0	100	60	3255	60	3155	0.0	0.01901743264659271
chr5	IQGAP2	76640932	76641103	0	172	252	7905	252	7733	0.0	0.03258761153497996
chr5	IQGAP2	76677217	76677350	0	134	252	7905	252	7771	0.0	0.03242825891133702
chr5	IQGAP2	76611019	76611183	0	165	252	7905	252	7740	0.0	0.03255813953488372
chr5	IQGAP2	76628684	76628752	0	69	252	7905	252	7836	0.0	0.03215926493108729
chr5	ZBED3-AS1	77089345	77089403	0	59	51	16340	51	16281	0.0	0.0031324857195503962
chr5	ZBED3-AS1	77100235	77100391	0	157	51	16340	51	16183	0.0	0.0031514552307977508
chr5	ZBED3-AS1	77098654	77098747	0	94	51	16340	51	16246	0.0	0.003139234273051828
chr5	ZBED3-AS1	77087486	77087619	0	134	51	16340	51	16206	0.0	0.0031469825990373935
chr5	ZBED3-AS1	77105655	77105689	0	35	51	16340	51	16305	0.0	0.0031278748850045997
chr5	PDE8B	77349418	77349559	0	142	1358	5620	1358	5478	0.0	0.24790069368382622
chr5	PDE8B	77408892	77409057	0	166	1358	5620	1358	5454	0.0	0.248991565823249
chr5	ZBED3-AS1	77118319	77118521	0	203	51	16340	51	16137	0.0	0.003160438743260829
chr5	ZBED3-AS1	77134304	77134585	0	282	51	16340	51	16058	0.0	0.003175987046954789
chr5	ZBED3-AS1	77092491	77092533	0	43	51	16340	51	16297	0.0	0.00312941032091796
chr5	ZBED3-AS1	77098654	77098669	0	16	51	16340	51	16324	0.0	0.003124234256309728
chr5	ZBED3-AS1	77100325	77100391	0	67	51	16340	51	16273	0.0	0.003134025686720334
chr5	ZBED3-AS1	77088440	77088472	0	33	51	16340	51	16307	0.0	0.0031274912614214757
chr5	ZBED3-AS1	77139260	77139317	0	58	51	16340	51	16282	0.0	0.0031322933300577324
chr5	ZBED3-AS1	77088744	77088799	0	56	51	16340	51	16284	0.0	0.0031319086219602065
chr5	ZBED3-AS1	77139265	77139317	0	53	51	16340	51	16287	0.0	0.0031313317369681343
chr5	ZBED3-AS1	77146116	77147162	0	1047	51	16340	51	15293	0.0	0.0033348590858562743
chr5	PDE8B	77311993	77312053	0	61	1358	5620	1358	5559	0.0	0.2442885411045152
chr5	SCAMP1	78388836	78388914	0	79	1845	6758	1845	6679	0.0	0.2762389579278335
chr5	SCAMP1	78421800	78421960	0	161	1845	6758	1845	6597	0.0	0.27967257844474763
chr5	SCAMP1	78449932	78450034	0	103	1845	6758	1845	6655	0.0	0.2772351615326822
chr5	SCAMP1	78370619	78370805	0	187	1845	6758	1845	6571	0.0	0.28077918125095114
chr5	BHMT2	79071092	79071215	0	124	714	3744	714	3620	0.0	0.19723756906077347
chr5	BHMT2	79080686	79080878	0	193	714	3744	714	3551	0.0	0.20107012109264996
chr5	TENT2	79649061	79649190	0	130	156	5274	156	5144	0.0	0.030326594090202177
chr5	TENT2	79656957	79657001	0	45	156	5274	156	5229	0.0	0.02983362019506598
chr5	TENT2	79615074	79615163	0	90	156	5274	156	5184	0.0	0.03009259259259259
chr5	ZFYVE16	80448025	80448404	51	380	550	13810	499	13430	0.13421052631578947	0.037155621742367834
chr5	ZFYVE16	80472760	80472923	0	164	550	13810	550	13646	0.0	0.04030485123845816
chr5	ZFYVE16	80411645	80411773	0	129	550	13810	550	13681	0.0	0.04020173963891528
chr5	ZFYVE16	80427491	80427545	0	55	550	13810	550	13755	0.0	0.039985459832788076
chr5	ZFYVE16	80435761	80435854	0	94	550	13810	550	13716	0.0	0.04009915427238262
chr5	ZFYVE16	80448282	80448404	0	123	550	13810	550	13687	0.0	0.040184116314751224
chr5	ZFYVE16	80443793	80443920	0	128	550	13810	550	13682	0.0	0.04019880134483263
chr5	MSH3	80848447	80848612	0	166	1568	5357	1568	5191	0.0	0.30206125987285687
chr5	MSH3	80830636	80830740	0	105	1568	5357	1568	5252	0.0	0.2985529322162985
chr5	RASGRF2	81216963	81216994	0	32	586	11063	586	11031	0.0	0.053123016952225544
chr5	CKMT2	81254992	81255214	0	223	1019	2343	1019	2120	0.0	0.48066037735849054
chr5	CKMT2	81256914	81257000	0	87	1019	2343	1019	2256	0.0	0.4516843971631206
chr5	CKMT2	81244041	81244205	0	165	1019	2343	1019	2178	0.0	0.46786042240587694
chr5	ZCCHC9	81304740	81305141	0	402	0	5131	0	4729	0.0	0.0
chr5	ATG10	81973154	81973301	0	148	255	5459	255	5311	0.0	0.04801355676897006
chr5	ATG10	81976192	81976327	0	136	255	5459	255	5323	0.0	0.04790531655081721
chr5	ATG10	82242796	82242882	0	87	255	5459	255	5372	0.0	0.04746835443037975
chr5	ATG10	82252561	82252659	0	99	255	5459	255	5360	0.0	0.04757462686567164
chr5	ATP6AP1L	82304933	82305481	0	549	13602	7245	13602	6696	0.0	2.031362007168459
chr5	VCAN	83519348	83522309	0	2962	0	13298	0	10336	0.0	0.0
chr5	VCAN	83537006	83542268	0	5263	0	13298	0	8035	0.0	0.0
chr5	EDIL3-DT	84385887	84386055	0	169	0	8926	0	8757	0.0	0.0
chr5	NBPF22P	86284371	86284394	0	24	1060	1612	1060	1588	0.0	0.6675062972292192
chr5	COX7C	86619738	86619878	0	141	3926	1972	3926	1831	0.0	2.144183506280721
chr5	RASA1	87366350	87366495	0	146	51	5265	51	5119	0.0	0.009962883375659308
chr5	RASA1	87269160	87269287	0	128	51	5265	51	5137	0.0	0.009927973525403932
chr5	RASA1	87330937	87330983	0	47	51	5265	51	5218	0.0	0.009773859716366424
chr5	TMEM161B-AS1	88426640	88426801	0	162	613	27299	613	27137	0.0	0.02258908501308177
chr5	TMEM161B-AS1	88410072	88410194	0	123	613	27299	613	27176	0.0	0.02255666764792464
chr5	TMEM161B-AS1	88282714	88282866	0	153	613	27299	613	27146	0.0	0.022581595815221397
chr5	TMEM161B-AS1	88283009	88283086	0	78	613	27299	613	27221	0.0	0.022519378421071965
chr5	TMEM161B-AS1	88287435	88287622	0	188	613	27299	613	27111	0.0	0.022610748404706577
chr5	TMEM161B-AS1	88285743	88285851	0	109	613	27299	613	27190	0.0	0.02254505332842957
chr5	TMEM161B-AS1	88285740	88285851	0	112	613	27299	613	27187	0.0	0.022547541104204216
chr5	TMEM161B-AS1	88281143	88281197	0	55	613	27299	613	27244	0.0	0.02250036705329614
chr5	TMEM161B-AS1	88269467	88269687	0	221	613	27299	613	27078	0.0	0.02263830415835734
chr5	TMEM161B-AS1	88291383	88291476	0	94	613	27299	613	27205	0.0	0.022532622679654474
chr5	TMEM161B-AS1	88287438	88287622	0	185	613	27299	613	27114	0.0	0.02260824666224091
chr5	TMEM161B-AS1	88269467	88269617	0	151	613	27299	613	27148	0.0	0.022579932223368203
chr5	TMEM161B-AS1	88282756	88282866	0	111	613	27299	613	27188	0.0	0.02254671178461086
chr5	TMEM161B-AS1	88424427	88424548	0	122	613	27299	613	27177	0.0	0.022555837656842184
chr5	TMEM161B-AS1	88319649	88319834	0	186	613	27299	613	27113	0.0	0.02260908051488216
chr5	MEF2C-AS1	88903937	88904160	0	224	0	7887	0	7663	0.0	0.0
chr5	MEF2C-AS1	88943015	88943122	0	108	0	7887	0	7779	0.0	0.0
chr5	MEF2C-AS1	88948135	88948215	0	81	0	7887	0	7806	0.0	0.0
chr5	MEF2C-AS1	88965840	88965915	0	76	0	7887	0	7811	0.0	0.0
chr5	MEF2C-AS1	88903937	88904203	0	267	0	7887	0	7620	0.0	0.0
chr5	MEF2C-AS1	88892166	88892277	0	112	0	7887	0	7775	0.0	0.0
chr5	AC113167.1	89963841	89963980	0	140	0	5770	0	5630	0.0	0.0
chr5	ADGRV1	90619085	90619181	0	97	22464	33926	22464	33829	0.0	0.6640456413136658
chr5	ADGRV1	90683585	90684195	0	611	22464	33926	22464	33315	0.0	0.6742908599729851
chr5	ADGRV1	90756453	90756630	0	178	22464	33926	22464	33748	0.0	0.6656394453004623
chr5	ADGRV1	91150029	91150221	0	193	22464	33926	22464	33733	0.0	0.6659354341446062
chr5	ADGRV1	90672802	90672897	694	96	22464	33926	21770	33830	7.229166666666667	0.6435116760271948
chr5	ADGRV1	90825814	90825853	0	40	22464	33926	22464	33886	0.0	0.6629286430974444
chr5	ADGRV1	90850685	90850876	0	192	22464	33926	22464	33734	0.0	0.6659156933657437
chr5	ADGRV1	91153220	91153398	0	179	22464	33926	22464	33747	0.0	0.6656591697039737
chr5	AC114316.1	92400914	92401061	46	148	10597	7357	10551	7209	0.3108108108108108	1.4635871826883062
chr5	AC106818.2	93666125	93666187	0	63	0	1992	0	1929	0.0	0.0
chr5	SLF1	94643272	94643435	0	164	177	6842	177	6678	0.0	0.026504941599281222
chr5	SLF1	94620064	94620171	0	108	177	6842	177	6734	0.0	0.026284526284526284
chr5	FAM81B	95420283	95420402	0	120	0	2488	0	2368	0.0	0.0
chr5	FAM81B	95446561	95446697	0	137	0	2488	0	2351	0.0	0.0
chr5	FAM81B	95424049	95424190	0	142	0	2488	0	2346	0.0	0.0
chr5	FAM81B	95448720	95448796	0	77	0	2488	0	2411	0.0	0.0
chr5	ARSK	95567889	95568049	0	161	1020	4336	1020	4175	0.0	0.24431137724550897
chr5	ARSK	95580891	95580942	0	52	1020	4336	1020	4284	0.0	0.23809523809523808
chr5	ARSK	95600624	95600683	0	60	1020	4336	1020	4276	0.0	0.23854069223573432
chr5	RFESD	95654332	95654367	0	36	51	5072	51	5036	0.0	0.010127084988085783
chr5	RFESD	95653116	95653214	0	99	51	5072	51	4973	0.0	0.010255379046853006
chr5	RHOBTB3	95736888	95737075	0	188	102	7954	102	7766	0.0	0.013134174607262426
chr5	RHOBTB3	95752238	95752350	0	113	102	7954	102	7841	0.0	0.013008544828465756
chr5	LINC01554	95852791	95852926	0	136	0	2265	0	2129	0.0	0.0
chr5	AC104123.1	96308723	96308882	0	160	0	1494	0	1334	0.0	0.0
chr5	CAST	96726793	96726859	0	67	716	12297	716	12230	0.0	0.058544562551103844
chr5	CAST	96729152	96729209	0	58	716	12297	716	12239	0.0	0.05850151156140208
chr5	CAST	96730779	96730860	0	82	716	12297	716	12215	0.0	0.05861645517805976
chr5	CAST	96746341	96746425	0	85	716	12297	716	12212	0.0	0.0586308548968228
chr5	CAST	96770530	96770602	0	73	716	12297	716	12224	0.0	0.058573298429319375
chr5	CAST	96662351	96662497	0	147	716	12297	716	12150	0.0	0.05893004115226337
chr5	CAST	96740744	96740783	0	40	716	12297	716	12257	0.0	0.0584155992494085
chr5	CAST	96736171	96736240	0	70	716	12297	716	12227	0.0	0.058558926964913716
chr5	CAST	96712348	96712473	0	126	716	12297	716	12171	0.0	0.058828362501027034
chr5	CAST	96726753	96726859	0	107	716	12297	716	12190	0.0	0.05873666940114848
chr5	CAST	96747344	96747392	0	49	716	12297	716	12248	0.0	0.05845852384062704
chr5	CAST	96757177	96757336	0	160	716	12297	716	12137	0.0	0.058993161407267035
chr5	AC008906.2	96805531	96805651	0	121	0	1265	0	1144	0.0	0.0
chr5	ERAP2	96886654	96886789	0	136	0	6815	0	6679	0.0	0.0
chr5	ERAP2	96896372	96896504	0	133	0	6815	0	6682	0.0	0.0
chr5	LINC01340	97521228	97521290	0	63	0	3722	0	3659	0.0	0.0
chr5	LINC01340	97528592	97528627	0	36	0	3722	0	3686	0.0	0.0
chr5	LINC02234	97899637	97899799	0	163	0	1845	0	1682	0.0	0.0
chr5	AC113385.1	100401623	100401783	0	161	0	2224	0	2063	0.0	0.0
chr5	AC113385.1	100408946	100409027	0	82	0	2224	0	2142	0.0	0.0
chr5	AC113385.1	100408798	100409027	0	230	0	2224	0	1994	0.0	0.0
chr5	FAM174A	100562053	100562188	0	136	0	1351	0	1215	0.0	0.0
chr5	PAM	102901355	102901413	0	59	2306	8786	2306	8727	0.0	0.26423742408616935
chr5	PAM	102974115	102974436	0	322	2306	8786	2306	8464	0.0	0.27244801512287337
chr5	PAM	103017333	103017433	0	101	2306	8786	2306	8685	0.0	0.2655152561888313
chr5	PAM	103025130	103025334	0	205	2306	8786	2306	8581	0.0	0.26873324787320824
chr5	PAM	103028184	103028238	0	55	2306	8786	2306	8731	0.0	0.26411636696827395
chr5	PAM	103025133	103025334	0	202	2306	8786	2306	8584	0.0	0.26863932898415654
chr5	PAM	103028181	103028238	0	58	2306	8786	2306	8728	0.0	0.2642071494042163
chr5	PPIP5K2	103183233	103183407	0	175	51	17308	51	17133	0.0	0.0029767116091752757
chr5	PPIP5K2	103186319	103186439	0	121	51	17308	51	17187	0.0	0.002967359050445104
chr5	PPIP5K2	103135992	103136114	0	123	51	17308	51	17185	0.0	0.0029677043933663077
chr5	PPIP5K2	103187313	103187376	0	64	51	17308	51	17244	0.0	0.0029575504523312456
chr5	PPIP5K2	103176865	103176910	0	46	51	17308	51	17262	0.0	0.002954466458116093
chr5	PPIP5K2	103189166	103189226	0	61	51	17308	51	17247	0.0	0.0029570360062619585
chr5	FER	108768092	108768238	0	147	33926	13623	33926	13476	0.0	2.5175126150192937
chr5	SLC25A46	110755995	110756121	0	127	2499	8281	2499	8154	0.0	0.30647534952170713
chr5	CAMK4	111376859	111376942	0	84	1529	8858	1529	8774	0.0	0.1742648734898564
chr5	CAMK4	111374849	111374912	0	64	1529	8858	1529	8794	0.0	0.1738685467364112
chr5	EPB41L4A-AS1	112161702	112161775	0	74	9333	3497	9333	3423	0.0	2.726555652936021
chr5	EPB41L4A-AS1	112161685	112161775	0	91	9333	3497	9333	3406	0.0	2.7401644157369347
chr5	APC	112754872	112755025	0	154	201	12460	201	12306	0.0	0.016333495855680155
chr5	APC	112792445	112792529	0	85	201	12460	201	12375	0.0	0.016242424242424242
chr5	APC	112810125	112810311	0	187	201	12460	201	12273	0.0	0.016377413835248107
chr5	APC	112738352	112738460	0	109	201	12460	201	12351	0.0	0.0162739859120719
chr5	APC	112823306	112823360	150	55	201	12460	51	12405	2.727272727272727	0.004111245465538089
chr5	SRP19	112864456	112864528	0	73	19221	10412	19221	10339	0.0	1.85907728020118
chr5	SRP19	112862507	112862583	0	77	19221	10412	19221	10335	0.0	1.8597968069666182
chr5	SRP19	112881956	112882049	0	94	19221	10412	19221	10318	0.0	1.8628610195774375
chr5	SRP19	112864620	112864732	306	113	19221	10412	18915	10299	2.7079646017699117	1.8365860763180892
chr5	DCP2	112993105	112993173	0	69	71	11385	71	11316	0.0	0.006274301873453517
chr5	DCP2	113003941	113004077	0	137	71	11385	71	11248	0.0	0.006312233285917497
chr5	DCP2	113007937	113008042	0	106	71	11385	71	11279	0.0	0.006294884298253391
chr5	DCP2	112981041	112981171	0	131	71	11385	71	11254	0.0	0.006308867958059357
chr5	KCNN2	114404437	114404856	0	420	2142	6097	2142	5677	0.0	0.37731196054254007
chr5	KCNN2	114490690	114490699	0	10	2142	6097	2142	6087	0.0	0.3518974864465254
chr5	KCNN2	114486697	114486803	0	107	2142	6097	2142	5990	0.0	0.35759599332220365
chr5	AC010226.1	115603045	115603156	48	112	918	4460	870	4348	0.42857142857142855	0.20009199632014718
chr5	AC010226.1	115619138	115619199	0	62	918	4460	918	4398	0.0	0.208731241473397
chr5	AP3S1	115870016	115870128	0	113	1239	2941	1239	2828	0.0	0.4381188118811881
chr5	AP3S1	115902884	115902992	561	109	1239	2941	678	2832	5.146788990825688	0.23940677966101695
chr5	LVRN	116021711	116021752	0	42	142	6620	142	6578	0.0	0.021587108543630284
chr5	LVRN	116010740	116010894	0	155	142	6620	142	6465	0.0	0.021964423820572312
chr5	LVRN	116010514	116010894	0	381	142	6620	142	6239	0.0	0.022760057701554735
chr5	COMMD10	116134067	116134178	0	112	66	2453	66	2341	0.0	0.028193079880392994
chr5	LINC02147	118187464	118187591	0	128	0	1755	0	1627	0.0	0.0
chr5	LINC02147	117995607	117995737	0	131	0	1755	0	1624	0.0	0.0
chr5	LINC02147	118187464	118187595	0	132	0	1755	0	1623	0.0	0.0
chr5	DMXL1	119118814	119119004	0	191	117	13391	117	13200	0.0	0.008863636363636363
chr5	DMXL1	119206833	119206896	0	64	117	13391	117	13327	0.0	0.008779170105800255
chr5	DMXL1	119233339	119233467	0	129	117	13391	117	13262	0.0	0.008822198763384106
chr5	DMXL1	119238988	119239080	0	93	117	13391	117	13298	0.0	0.008798315536170854
chr5	TNFAIP8	119316184	119316302	0	119	153	8513	153	8394	0.0	0.018227305218012867
chr5	TNFAIP8	119356022	119356121	0	100	153	8513	153	8413	0.0	0.018186140496850113
chr5	TNFAIP8	119391364	119391483	0	120	153	8513	153	8393	0.0	0.018229476945073275
chr5	HSD17B4	119456314	119456368	0	55	0	10487	0	10432	0.0	0.0
chr5	HSD17B4	119471635	119471700	0	66	0	10487	0	10421	0.0	0.0
chr5	HSD17B4	119509429	119509494	0	66	0	10487	0	10421	0.0	0.0
chr5	HSD17B4	119477797	119477894	0	98	0	10487	0	10389	0.0	0.0
chr5	HSD17B4	119472457	119472576	0	120	0	10487	0	10367	0.0	0.0
chr5	HSD17B4	119464613	119464693	0	81	0	10487	0	10406	0.0	0.0
chr5	HSD17B4	119476449	119476499	0	51	0	10487	0	10436	0.0	0.0
chr5	HSD17B4	119478093	119478141	0	49	0	10487	0	10438	0.0	0.0
chr5	HSD17B4	119487268	119487400	0	133	0	10487	0	10354	0.0	0.0
chr5	HSD17B4	119495715	119495813	0	99	0	10487	0	10388	0.0	0.0
chr5	FAM170A	119632747	119632888	0	142	0	1383	0	1241	0.0	0.0
chr5	PRR16	120481168	120481293	0	126	0	2259	0	2133	0.0	0.0
chr5	AC008568.1	121324040	121324070	0	31	4784	6233	4784	6202	0.0	0.7713640761044824
chr5	AC008568.1	121326585	121326629	0	45	4784	6233	4784	6188	0.0	0.773109243697479
chr5	ZNF474	122147874	122148007	365	134	37276	2086	36911	1952	2.7238805970149254	18.909323770491802
chr5	SNCAIP	122440461	122440516	0	56	3883	7286	3883	7230	0.0	0.5370677731673582
chr5	SNCAIP	122400985	122401126	285	142	3883	7286	3598	7144	2.007042253521127	0.5036394176931691
chr5	SNCAIP	122336787	122336904	769	118	3883	7286	3114	7168	6.516949152542373	0.43443080357142855
chr5	SNCAIP	122422867	122423739	2655	873	3883	7286	1228	6413	3.0412371134020617	0.19148604397317948
chr5	SNCAIP	122431968	122432082	0	115	3883	7286	3883	7171	0.0	0.5414865430204993
chr5	SNCAIP	122452924	122452995	0	72	3883	7286	3883	7214	0.0	0.5382589409481564
chr5	SNCAIP	122388566	122389870	0	1305	3883	7286	3883	5981	0.0	0.6492225380371175
chr5	SNCAIP	122425351	122425531	0	181	3883	7286	3883	7105	0.0	0.5465165376495426
chr5	SNX2	122799691	122799855	0	165	0	8164	0	7999	0.0	0.0
chr5	SNX2	122827378	122827459	0	82	0	8164	0	8082	0.0	0.0
chr5	SNX2	122799694	122799855	0	162	0	8164	0	8002	0.0	0.0
chr5	SNX24	122891026	122891125	0	100	97	3491	97	3391	0.0	0.028605131229725744
chr5	SNX24	122853673	122853767	0	95	97	3491	97	3396	0.0	0.02856301531213192
chr5	SNX24	122965442	122965521	0	80	97	3491	97	3411	0.0	0.028437408384637937
chr5	SNX24	123022306	123022427	0	122	97	3491	97	3369	0.0	0.02879192638765212
chr5	PRDM6	123159513	123159638	0	126	0	9239	0	9113	0.0	0.0
chr5	PRDM6	123155883	123156011	0	129	0	9239	0	9110	0.0	0.0
chr5	CSNK1G3	123545416	123545841	0	426	0	5014	0	4588	0.0	0.0
chr5	CSNK1G3	123605338	123605362	0	25	0	5014	0	4989	0.0	0.0
chr5	CSNK1G3	123595038	123595134	0	97	0	5014	0	4917	0.0	0.0
chr5	LINC02240	124897755	124897813	0	59	51	7498	51	7439	0.0	0.006855760182820272
chr5	LINC02240	125003658	125003761	0	104	51	7498	51	7394	0.0	0.006897484446848796
chr5	GRAMD2B	126469676	126469788	0	113	306	4832	306	4719	0.0	0.06484424666242848
chr5	GRAMD2B	126466293	126466336	0	44	306	4832	306	4788	0.0	0.06390977443609022
chr5	LMNB1	126815169	126815247	0	79	0	2990	0	2911	0.0	0.0
chr5	LMNB1	126777360	126777867	0	508	0	2990	0	2482	0.0	0.0
chr5	MEGF10	127433362	127433509	0	148	8714	9073	8714	8925	0.0	0.9763585434173669
chr5	MEGF10	127299995	127300046	0	52	8714	9073	8714	9021	0.0	0.9659682961977608
chr5	SLC12A2	128177104	128177152	0	49	51	10681	51	10632	0.0	0.004796839729119639
chr5	ADAMTS19	129461101	129461757	0	657	0	5416	0	4759	0.0	0.0
chr5	LYRM7	131187027	131187109	0	83	0	2776	0	2693	0.0	0.0
chr5	LYRM7	131182228	131182299	0	72	0	2776	0	2704	0.0	0.0
chr5	CDC42SE2	131315975	131316144	0	170	0	4667	0	4497	0.0	0.0
chr5	PDLIM4	132271790	132271908	12	119	30404	2643	30392	2524	0.10084033613445378	12.041204437400951
chr5	SLC22A5	132390689	132390904	0	216	11486	12829	11486	12613	0.0	0.910647744390708
chr5	SLC22A5	132378163	132378235	0	73	11486	12829	11486	12756	0.0	0.9004390090937598
chr5	SLC22A5	132390775	132390904	0	130	11486	12829	11486	12699	0.0	0.9044806677691157
chr5	IRF1-AS1	132449649	132449689	0	41	677	9736	677	9695	0.0	0.06982980917998968
chr5	RAD50	132591223	132591406	0	184	51	9711	51	9527	0.0	0.005353206675763619
chr5	RAD50	132591876	132592034	0	159	51	9711	51	9552	0.0	0.005339195979899497
chr5	AC116366.2	132556331	132556473	0	143	321	8990	321	8847	0.0	0.03628348592743303
chr5	AC116366.2	132486191	132486660	204	470	321	8990	117	8520	0.4340425531914894	0.013732394366197184
chr5	RAD50	132594561	132594677	0	117	51	9711	51	9594	0.0	0.005315822388993121
chr5	RAD50	132590640	132590673	0	34	51	9711	51	9677	0.0	0.005270228376562984
chr5	RAD50	132592763	132592965	0	203	51	9711	51	9508	0.0	0.005363904080774085
chr5	AC116366.2	132642177	132642394	0	218	321	8990	321	8772	0.0	0.036593707250342
chr5	IL13	132657065	132657244	0	180	51	2890	51	2710	0.0	0.018819188191881917
chr5	IL13	132658289	132658360	0	72	51	2890	51	2818	0.0	0.01809794180269695
chr5	IL4	132677780	132677881	0	102	0	825	0	723	0.0	0.0
chr5	IL4	132674458	132674506	0	49	0	825	0	776	0.0	0.0
chr5	AC004039.1	132692450	132692634	0	185	0	1795	0	1610	0.0	0.0
chr5	UQCRQ	132866868	132867035	0	168	0	2072	0	1904	0.0	0.0
chr5	TCF7	134144796	134144869	1213	74	64848	7296	63635	7222	16.39189189189189	8.811271116034339
chr5	TCF7	134140795	134140888	0	94	64848	7296	64848	7202	0.0	9.004165509580671
chr5	TCF7	134145259	134145340	0	82	64848	7296	64848	7214	0.0	8.989187690601607
chr5	UBE2B	134388976	134389052	0	77	1962	2766	1962	2689	0.0	0.7296392711044998
chr5	JADE2	134573644	134573762	0	119	0	9892	0	9773	0.0	0.0
chr5	JADE2	134576767	134576896	0	130	0	9892	0	9762	0.0	0.0
chr5	JADE2	134576767	134577038	0	272	0	9892	0	9620	0.0	0.0
chr5	CAMLG	134741065	134741523	0	459	1479	7417	1479	6958	0.0	0.2125610807703363
chr5	CAMLG	134741062	134741523	0	462	1479	7417	1479	6955	0.0	0.21265276779295472
chr5	CAMLG	134743986	134744052	0	67	1479	7417	1479	7350	0.0	0.20122448979591837
chr5	DDX46	134781920	134782086	0	167	204	9230	204	9063	0.0	0.022509102946044357
chr5	DDX46	134782944	134783065	0	122	204	9230	204	9108	0.0	0.022397891963109356
chr5	DDX46	134790105	134790222	0	118	204	9230	204	9112	0.0	0.022388059701492536
chr5	DDX46	134766916	134767060	0	145	204	9230	204	9085	0.0	0.022454595487066593
chr5	C5ORF24	134846662	134846863	0	202	0	3870	0	3668	0.0	0.0
chr5	TXNDC15	134887694	134888182	0	489	0	4783	0	4294	0.0	0.0
chr5	C5ORF66	135074416	135074528	0	113	1734	6660	1734	6547	0.0	0.26485413166335725
chr5	AC114296.1	135824897	135825137	0	241	0	2718	0	2477	0.0	0.0
chr5	AC114296.1	135825724	135825995	0	272	0	2718	0	2446	0.0	0.0
chr5	SLC25A48	135880772	135880910	0	139	332	8390	332	8251	0.0	0.04023754696400436
chr5	FBXL21P	135935622	135935724	0	103	0	3618	0	3515	0.0	0.0
chr5	FBXL21P	135940488	135940660	0	173	0	3618	0	3445	0.0	0.0
chr5	FBXL21P	135950785	135950944	0	160	0	3618	0	3458	0.0	0.0
chr5	TGFBI	136062662	136062687	0	26	51	5453	51	5427	0.0	0.009397457158651189
chr5	TGFBI	136056448	136056530	0	83	51	5453	51	5370	0.0	0.009497206703910615
chr5	TGFBI	136061499	136061579	0	81	51	5453	51	5372	0.0	0.00949367088607595
chr5	SMAD5	136147831	136147906	0	76	9	8791	9	8715	0.0	0.0010327022375215145
chr5	SMAD5	136152674	136152758	0	85	9	8791	9	8706	0.0	0.0010337698139214334
chr5	AC112178.1	136504599	136504693	0	95	0	2762	0	2667	0.0	0.0
chr5	AC112178.1	136509879	136509958	0	80	0	2762	0	2682	0.0	0.0
chr5	AC112178.1	136508655	136508743	0	89	0	2762	0	2673	0.0	0.0
chr5	MYOT	137881972	137882105	484	134	5169	2836	4685	2702	3.611940298507463	1.733900814211695
chr5	MYOT	137870876	137871007	0	132	5169	2836	5169	2704	0.0	1.911612426035503
chr5	MYOT	137883383	137883591	271	209	5169	2836	4898	2627	1.2966507177033493	1.8644842025123716
chr5	PKD2L2	137936319	137936427	0	109	205044	4377	205044	4268	0.0	48.042174320524836
chr5	KIF20A	138185511	138185710	45	200	710	3854	665	3654	0.225	0.18199233716475097
chr5	FAM53C	138335087	138335138	13	52	3276	6668	3263	6616	0.25	0.4931983071342201
chr5	FAM53C	138336788	138336807	0	20	3276	6668	3276	6648	0.0	0.4927797833935018
chr5	FAM53C	138341183	138341413	51	231	3276	6668	3225	6437	0.22077922077922077	0.5010097871679354
chr5	FAM53C	138341808	138341866	30	59	3276	6668	3246	6609	0.5084745762711864	0.4911484339536995
chr5	FAM53C	138341183	138341264	27	82	3276	6668	3249	6586	0.32926829268292684	0.4933191618584877
chr5	KDM3B	138391012	138392261	408	1250	1292	7897	884	6647	0.3264	0.1329923273657289
chr5	REEP2	138441384	138441461	0	78	3219	3145	3219	3067	0.0	1.0495598304532117
chr5	CTNNA1	138653063	138653122	204	60	21341	8697	21137	8637	3.4	2.447261780710895
chr5	CTNNA1	138783176	138783372	0	197	21341	8697	21341	8500	0.0	2.510705882352941
chr5	CTNNA1	138754693	138755163	1207	471	21341	8697	20134	8226	2.5626326963906583	2.447605154388524
chr5	CTNNA1	138917741	138917898	0	158	21341	8697	21341	8539	0.0	2.4992387867431782
chr5	CTNNA1	138932887	138932958	0	72	21341	8697	21341	8625	0.0	2.47431884057971
chr5	CTNNA1	138781922	138782029	0	108	21341	8697	21341	8589	0.0	2.484689719408546
chr5	CTNNA1	138932577	138932712	0	136	21341	8697	21341	8561	0.0	2.4928162597827357
chr5	CTNNA1	138782289	138782403	0	115	21341	8697	21341	8582	0.0	2.486716383127476
chr5	CTNNA1	138881041	138881137	42	97	21341	8697	21299	8600	0.4329896907216495	2.476627906976744
chr5	CTNNA1	138881044	138881137	42	94	21341	8697	21299	8603	0.44680851063829785	2.4757642682785077
chr5	CTNNA1	138880680	138880733	0	54	21341	8697	21341	8643	0.0	2.4691657989124147
chr5	CTNNA1	138880213	138880288	0	76	21341	8697	21341	8621	0.0	2.475466883192205
chr5	CTNNA1	138880194	138880288	0	95	21341	8697	21341	8602	0.0	2.4809346663566614
chr5	CTNNA1	138891182	138891211	6	30	21341	8697	21335	8667	0.2	2.46163609091958
chr5	MATR3	139279050	139279129	0	80	255	12741	255	12661	0.0	0.0201405892109628
chr5	MATR3	139307238	139308327	0	1090	255	12741	255	11651	0.0	0.021886533344777272
chr5	MATR3	139315696	139315738	0	43	255	12741	255	12698	0.0	0.02008190266183651
chr5	MATR3	139326162	139326284	0	123	255	12741	255	12618	0.0	0.020209224916785545
chr5	MATR3	139278326	139278408	0	83	255	12741	255	12658	0.0	0.020145362616527097
chr5	MATR3	139278564	139278740	0	177	255	12741	255	12564	0.0	0.02029608404966571
chr5	MATR3	139279934	139280058	0	125	255	12741	255	12616	0.0	0.020212428662016488
chr5	MATR3	139314674	139314736	0	63	255	12741	255	12678	0.0	0.020113582584003788
chr5	MATR3	139291971	139292074	0	104	255	12741	255	12637	0.0	0.02017883991453668
chr5	MATR3	139293452	139293575	0	124	255	12741	255	12617	0.0	0.020210826662439566
chr5	MATR3	139283530	139283601	0	72	255	12741	255	12669	0.0	0.020127871181624436
chr5	MATR3	139307240	139308327	0	1088	255	12741	255	11653	0.0	0.021882776967304556
chr5	MATR3	139319333	139319501	0	169	255	12741	255	12572	0.0	0.02028316894686605
chr5	PAIP2	139343329	139343406	0	78	51	3154	51	3076	0.0	0.01657997399219766
chr5	PAIP2	139363758	139363922	0	165	51	3154	51	2989	0.0	0.01706256273001004
chr5	PAIP2	139364563	139364743	0	181	51	3154	51	2973	0.0	0.017154389505549948
chr5	UBE2D2	139562243	139562407	0	165	6195	3131	6195	2966	0.0	2.088671611598112
chr5	CXXC5	139679846	139679940	0	95	693	3537	693	3442	0.0	0.20133643230679837
chr5	CXXC5	139665579	139665803	0	225	693	3537	693	3312	0.0	0.20923913043478262
chr5	CYSTM1	140194445	140194652	0	208	1020	1864	1020	1656	0.0	0.6159420289855072
chr5	SLC4A9	140365833	140366022	0	190	3484	3662	3484	3472	0.0	1.0034562211981566
chr5	ANKHD1	140496519	140497278	0	760	4597	11160	4597	10400	0.0	0.4420192307692308
chr5	ANKHD1	140507784	140507998	0	215	4597	11160	4597	10945	0.0	0.4200091365920512
chr5	ANKHD1	140535361	140535538	0	178	4597	11160	4597	10982	0.0	0.4185940630122018
chr5	ANKHD1	140464666	140464776	0	111	4597	11160	4597	11049	0.0	0.4160557516517332
chr5	ANKHD1	140472238	140472295	0	58	4597	11160	4597	11102	0.0	0.4140695370203567
chr5	TMCO6	140641017	140641220	0	204	140	3038	140	2834	0.0	0.04940014114326041
chr5	IK	140648882	140648980	0	99	75	2764	75	2665	0.0	0.028142589118198873
chr5	HARS2	140691606	140691756	0	151	448186	3423	448186	3272	0.0	136.97616136919316
chr5	HARS2	140693490	140693665	0	176	448186	3423	448186	3247	0.0	138.0307976593779
chr5	HARS2	140696102	140696201	0	100	448186	3423	448186	3323	0.0	134.87390911826662
chr5	HARS2	140691791	140692017	0	227	448186	3423	448186	3196	0.0	140.23341677096371
chr5	HARS2	140691794	140691937	0	144	448186	3423	448186	3279	0.0	136.68374504422079
chr5	HARS2	140693490	140693508	0	19	448186	3423	448186	3404	0.0	131.66451233842537
chr5	HARS2	140693590	140693665	0	76	448186	3423	448186	3347	0.0	133.90678219300867
chr5	HARS2	140696028	140696201	0	174	448186	3423	448186	3249	0.0	137.9458294859957
chr5	PCDHA10	140867709	140867831	0	123	1031264	6271	1031264	6148	0.0	167.73975276512687
chr5	PCDHA10	140979673	140979926	28	254	1031264	6271	1031236	6017	0.11023622047244094	171.3870699684228
chr5	PCDHA10	140984065	140984249	136	185	1031264	6271	1031128	6086	0.7351351351351352	169.42622412093328
chr5	PCDHA10	140984065	140984149	0	85	1031264	6271	1031264	6186	0.0	166.70934367927578
chr5	PCDHGC3	141478393	141478546	0	154	161187	5020	161187	4866	0.0	33.12515413070284
chr5	RELL2	141638954	141639021	0	68	408	2590	408	2522	0.0	0.16177636796193498
chr5	RELL2	141640411	141640445	0	35	408	2590	408	2555	0.0	0.15968688845401174
chr5	RELL2	141639463	141639649	0	187	408	2590	408	2403	0.0	0.16978776529338327
chr5	RNF14	141974803	141974955	3730	153	8869	4992	5139	4839	24.37908496732026	1.0619962802231866
chr5	RNF14	141970703	141970877	0	175	8869	4992	8869	4817	0.0	1.841187461075358
chr5	RNF14	141978302	141978830	0	529	8869	4992	8869	4463	0.0	1.987228321756666
chr5	RNF14	141980122	141980351	3354	230	8869	4992	5515	4762	14.582608695652175	1.1581268374632507
chr5	LINC01844	142757826	142757934	0	109	2193	3613	2193	3504	0.0	0.6258561643835616
chr5	LINC01844	142718115	142718266	0	152	2193	3613	2193	3461	0.0	0.6336318982952904
chr5	LINC01844	142745207	142745718	510	512	2193	3613	1683	3101	0.99609375	0.5427281522089649
chr5	LINC01844	142757826	142757903	0	78	2193	3613	2193	3535	0.0	0.6203677510608203
chr5	LINC01844	142753100	142753227	0	128	2193	3613	2193	3485	0.0	0.6292682926829268
chr5	LINC01844	142756467	142756632	0	166	2193	3613	2193	3447	0.0	0.6362053959965187
chr5	LINC01844	142746477	142746585	0	109	2193	3613	2193	3504	0.0	0.6258561643835616
chr5	LINC01844	142750119	142750228	0	110	2193	3613	2193	3503	0.0	0.6260348272908935
chr5	LINC01844	142756507	142756632	0	126	2193	3613	2193	3487	0.0	0.6289073702322914
chr5	ARHGAP26	143207197	143207308	0	112	2330	17199	2330	17087	0.0	0.13636097618072218
chr5	ARHGAP26	143207197	143207473	0	277	2330	17199	2330	16922	0.0	0.13769058030965606
chr5	ARHGAP26	143207443	143207473	0	31	2330	17199	2330	17168	0.0	0.13571761416589004
chr5	ARHGAP26	143207382	143207473	0	92	2330	17199	2330	17107	0.0	0.136201554919039
chr5	AC016598.2	143539840	143539996	55495	157	58197	2440	2702	2283	353.47133757961785	1.1835304424003503
chr5	AC016598.2	143556786	143556927	0	142	58197	2440	58197	2298	0.0	25.325065274151434
chr5	AC008700.1	145436997	145437231	51	235	1479	2327	1428	2092	0.2170212765957447	0.6826003824091779
chr5	SH3RF2	146059865	146060224	0	360	0	7224	0	6864	0.0	0.0
chr5	TCERG1	146468340	146468403	0	64	0	8311	0	8247	0.0	0.0
chr5	TCERG1	146510066	146510160	0	95	0	8311	0	8216	0.0	0.0
chr5	STK32A	147275957	147276031	0	75	11	7512	11	7437	0.0	0.0014790910313298372
chr5	STK32A	147383889	147383954	0	66	11	7512	11	7446	0.0	0.00147730325006715
chr5	JAKMIP2-AS1	147636276	147636405	0	130	14	2112	14	1982	0.0	0.007063572149344097
chr5	SPINK5	148125523	148125613	0	91	0	4513	0	4422	0.0	0.0
chr5	SPINK14	148174233	148174370	0	138	0	298	0	160	0.0	0.0
chr5	SPINK7	148313373	148313399	0	27	0	849	0	822	0.0	0.0
chr5	FBXO38	148427212	148427947	0	736	703	8747	703	8011	0.0	0.08775433778554488
chr5	FBXO38	148427212	148427722	0	511	703	8747	703	8236	0.0	0.08535696940262263
chr5	SH3TC2-DT	149064070	149064174	0	105	153	3002	153	2897	0.0	0.052813255091473936
chr5	SH3TC2-DT	149064066	149064174	0	109	153	3002	153	2893	0.0	0.05288627722087798
chr5	ABLIM3	149242490	149242538	0	49	2470	7250	2470	7201	0.0	0.34300791556728233
chr5	ABLIM3	149240675	149240774	0	100	2470	7250	2470	7150	0.0	0.34545454545454546
chr5	ABLIM3	149199043	149199122	0	80	2470	7250	2470	7170	0.0	0.34449093444909346
chr5	AFAP1L1	149335593	149335722	0	130	24786	6588	24786	6458	0.0	3.838030349953546
chr5	GRPEL2	149349653	149349735	0	83	510	4424	510	4341	0.0	0.11748445058742225
chr5	PCYOX1L	149362966	149363016	311	51	50264	4004	49953	3953	6.098039215686274	12.636731596256007
chr5	CARMN	149420480	149421068	430	589	691350	14357	690920	13768	0.7300509337860781	50.18303312027891
chr5	CARMN	149423185	149423639	51	455	691350	14357	691299	13902	0.11208791208791209	49.72658610271903
chr5	CARMN	149420480	149420544	204	65	691350	14357	691146	14292	3.1384615384615384	48.358942065491185
chr5	CARMN	149423185	149423309	51	125	691350	14357	691299	14232	0.408	48.57356661045531
chr5	CARMN	149415520	149415917	255	398	691350	14357	691095	13959	0.6407035175879398	49.508918977004086
chr5	CARMN	149423433	149423639	0	207	691350	14357	691350	14150	0.0	48.85865724381625
chr5	PPARGC1B	149830766	149830883	0	118	51148	11362	51148	11244	0.0	4.548914976876556
chr5	SLC26A2	149961992	149962272	0	281	204	8585	204	8304	0.0	0.024566473988439308
chr5	TCOF1	150374173	150374386	0	214	3897	10045	3897	9831	0.0	0.39639914555996336
chr5	TCOF1	150372005	150372236	0	232	3897	10045	3897	9813	0.0	0.39712626108223786
chr5	TCOF1	150391543	150391657	0	115	3897	10045	3897	9930	0.0	0.39244712990936553
chr5	TCOF1	150383064	150383172	0	109	3897	10045	3897	9936	0.0	0.39221014492753625
chr5	TCOF1	150383061	150383172	0	112	3897	10045	3897	9933	0.0	0.3923286016309272
chr5	TCOF1	150364906	150365057	0	152	3897	10045	3897	9893	0.0	0.39391488931567775
chr5	TCOF1	150391543	150391795	0	253	3897	10045	3897	9792	0.0	0.39797794117647056
chr5	NDST1	150548217	150548388	0	172	10529	9532	10529	9360	0.0	1.1248931623931624
chr5	SMIM3	150782473	150782590	0	118	92	2452	92	2334	0.0	0.03941730934018852
chr5	GPX3	151027431	151027531	0	101	0	2903	0	2802	0.0	0.0
chr5	GPX3	151025339	151025493	0	155	0	2903	0	2748	0.0	0.0
chr5	GPX3	151020827	151020854	0	28	0	2903	0	2875	0.0	0.0
chr5	GPX3	151020827	151021253	0	427	0	2903	0	2476	0.0	0.0
chr5	SLC36A1	151452342	151452491	0	150	87	6979	87	6829	0.0	0.01273978620588666
chr5	SLC36A1	151476854	151476980	0	127	87	6979	87	6852	0.0	0.012697022767075307
chr5	G3BP1	151790322	151790404	0	83	0	10115	0	10032	0.0	0.0
chr5	G3BP1	151794158	151794249	0	92	0	10115	0	10023	0.0	0.0
chr5	G3BP1	151797226	151797428	0	203	0	10115	0	9912	0.0	0.0
chr5	G3BP1	151799888	151800000	0	113	0	10115	0	10002	0.0	0.0
chr5	G3BP1	151800217	151800346	0	130	0	10115	0	9985	0.0	0.0
chr5	G3BP1	151800759	151800869	0	111	0	10115	0	10004	0.0	0.0
chr5	G3BP1	151786571	151786715	0	145	0	10115	0	9970	0.0	0.0
chr5	G3BP1	151803884	151804141	0	258	0	10115	0	9857	0.0	0.0
chr5	G3BP1	151786602	151786715	0	114	0	10115	0	10001	0.0	0.0
chr5	G3BP1	151803884	151804162	0	279	0	10115	0	9836	0.0	0.0
chr5	G3BP1	151792044	151792201	0	158	0	10115	0	9957	0.0	0.0
chr5	G3BP1	151799898	151800000	0	103	0	10115	0	10012	0.0	0.0
chr5	G3BP1	151786867	151786985	0	119	0	10115	0	9996	0.0	0.0
chr5	G3BP1	151799888	151800043	0	156	0	10115	0	9959	0.0	0.0
chr5	G3BP1	151772534	151772567	0	34	0	10115	0	10081	0.0	0.0
chr5	G3BP1	151787764	151787794	0	31	0	10115	0	10084	0.0	0.0
chr5	G3BP1	151772656	151772668	0	13	0	10115	0	10102	0.0	0.0
chr5	G3BP1	151777614	151777734	0	121	0	10115	0	9994	0.0	0.0
chr5	G3BP1	151774604	151774709	0	106	0	10115	0	10009	0.0	0.0
chr5	G3BP1	151803537	151803636	0	100	0	10115	0	10015	0.0	0.0
chr5	G3BP1	151786863	151786985	0	123	0	10115	0	9992	0.0	0.0
chr5	G3BP1	151794202	151794249	0	48	0	10115	0	10067	0.0	0.0
chr5	G3BP1	151796313	151796545	0	233	0	10115	0	9882	0.0	0.0
chr5	G3BP1	151797288	151797428	0	141	0	10115	0	9974	0.0	0.0
chr5	G3BP1	151803884	151803996	0	113	0	10115	0	10002	0.0	0.0
chr5	LINC01933	152231262	152231299	0	38	306	5425	306	5387	0.0	0.0568034156302209
chr5	GRIA1	153646927	153647167	0	241	21411	7564	21411	7323	0.0	2.923801720606309
chr5	MFAP3	154049556	154050017	0	462	14507	7808	14507	7346	0.0	1.9748162265178328
chr5	MFAP3	154121717	154121897	0	181	14507	7808	14507	7627	0.0	1.9020584764651896
chr5	MFAP3	154134844	154134916	0	73	14507	7808	14507	7735	0.0	1.8755009696186167
chr5	GALNT10	154376276	154376462	0	187	113808	10188	113808	10001	0.0	11.37966203379662
chr5	GALNT10	154356152	154356283	0	132	113808	10188	113808	10056	0.0	11.317422434367542
chr5	GALNT10	154412491	154412735	0	245	113808	10188	113808	9943	0.0	11.446042441918937
chr5	SAP30L	154451090	154451213	0	124	0	6350	0	6226	0.0	0.0
chr5	LARP1	154790644	154790710	0	67	256	8718	256	8651	0.0	0.029591954687319386
chr5	LARP1	154793799	154794000	0	202	256	8718	256	8516	0.0	0.030061061531235323
chr5	LARP1	154791945	154792013	0	69	256	8718	256	8649	0.0	0.029598797548849577
chr5	LARP1	154793799	154793922	0	124	256	8718	256	8594	0.0	0.02978822434256458
chr5	CNOT8	154863206	154863395	0	190	38	3723	38	3533	0.0	0.01075573167279932
chr5	CNOT8	154865191	154865385	0	195	38	3723	38	3528	0.0	0.010770975056689343
chr5	CNOT8	154870660	154870822	0	163	38	3723	38	3560	0.0	0.010674157303370787
chr5	CNOT8	154859694	154859873	0	180	38	3723	38	3543	0.0	0.010725373976855771
chr5	CNOT8	154867691	154867792	0	102	38	3723	38	3621	0.0	0.010494338580502624
chr5	CNOT8	154859352	154859496	0	145	38	3723	38	3578	0.0	0.010620458356623811
chr5	MRPL22	154950820	154950938	86	119	86	4098	0	3979	0.7226890756302521	0.0
chr5	MRPL22	154950802	154950938	86	137	86	4098	0	3961	0.6277372262773723	0.0
chr5	AC010476.2	155116550	155116678	0	129	0	6659	0	6530	0.0	0.0
chr5	SGCD	156329533	156329579	0	47	264	10597	264	10550	0.0	0.025023696682464455
chr5	SGCD	156393752	156393865	0	114	264	10597	264	10483	0.0	0.025183630640083946
chr5	ITK	157245725	157245790	0	66	380146	8492	380146	8426	0.0	45.11583194873012
chr5	ITK	157213566	157213697	58496	132	380146	8492	321650	8360	443.1515151515151	38.47488038277512
chr5	CYFIP2	157294782	157294860	0	79	269	10488	269	10409	0.0	0.025843020463060813
chr5	CYFIP2	157322941	157323016	0	76	269	10488	269	10412	0.0	0.025835574337303113
chr5	CYFIP2	157288611	157288659	0	49	269	10488	269	10439	0.0	0.025768751796149056
chr5	CYFIP2	157324770	157324900	0	131	269	10488	269	10357	0.0	0.02597277203823501
chr5	NIPAL4	157467048	157467105	0	58	0	4215	0	4157	0.0	0.0
chr5	NIPAL4	157460547	157460579	0	33	0	4215	0	4182	0.0	0.0
chr5	THG1L	157738621	157738734	0	114	0	3005	0	2891	0.0	0.0
chr5	AC091939.1	158502690	158502956	0	267	44420	2207	44420	1940	0.0	22.896907216494846
chr5	AC091939.1	158503152	158503382	0	231	44420	2207	44420	1976	0.0	22.479757085020243
chr5	AC008691.1	159392532	159392577	0	46	41874	13464	41874	13418	0.0	3.120733343270234
chr5	FABP6	160228472	160228692	0	221	0	1096	0	875	0.0	0.0
chr5	GABRA1	161853665	161853727	0	63	0	6688	0	6625	0.0	0.0
chr5	GABRA1	161850578	161850667	0	90	0	6688	0	6598	0.0	0.0
chr5	GABRG2	162151729	162151753	0	25	490	19638	490	19613	0.0	0.024983429358078825
chr5	GABRG2	162068062	162068106	0	45	490	19638	490	19593	0.0	0.025008931761343337
chr5	GABRG2	162102553	162102673	0	121	490	19638	490	19517	0.0	0.02510631756929856
chr5	GABRG2	162103888	162104026	0	139	490	19638	490	19499	0.0	0.025129493820195907
chr5	GABRG2	162083500	162083621	0	122	490	19638	490	19516	0.0	0.025107604017216643
chr5	GABRG2	162129222	162129261	0	40	490	19638	490	19598	0.0	0.025002551280742934
chr5	GABRG2	162150994	162151753	0	760	490	19638	490	18878	0.0	0.025956139421548893
chr5	CCNG1	163442373	163442568	0	196	0	2779	0	2583	0.0	0.0
chr5	CCNG1	163439256	163439520	0	265	0	2779	0	2514	0.0	0.0
chr5	HMMR	163467700	163467748	0	49	0	3950	0	3901	0.0	0.0
chr5	HMMR	163467703	163467748	0	46	0	3950	0	3904	0.0	0.0
chr5	MAT2B	163513554	163513669	0	116	0	3962	0	3846	0.0	0.0
chr5	MAT2B	163512001	163512196	0	196	0	3962	0	3766	0.0	0.0
chr5	AC109466.1	164523946	164524004	0	59	153	9904	153	9845	0.0	0.015540883697308279
chr5	AC109466.1	164354140	164354224	0	85	153	9904	153	9819	0.0	0.015582034830430797
chr5	AC109466.1	164910706	164910758	0	53	153	9904	153	9851	0.0	0.015531418130139071
chr5	AC109466.1	164920134	164920195	0	62	153	9904	153	9842	0.0	0.015545620808778703
chr5	AC109466.1	164486673	164486741	0	69	153	9904	153	9835	0.0	0.015556685307574987
chr5	AC109466.1	164486668	164486741	0	74	153	9904	153	9830	0.0	0.015564598168870803
chr5	AC109466.1	164485952	164486097	0	146	153	9904	153	9758	0.0	0.0156794425087108
chr5	AC109466.1	164470058	164470468	0	411	153	9904	153	9493	0.0	0.01611713894448541
chr5	AC109466.1	164604817	164604892	0	76	153	9904	153	9828	0.0	0.015567765567765568
chr5	TENM2	168047426	168047549	0	124	72376	10863	72376	10739	0.0	6.73954744389608
chr5	TENM2	168211733	168211754	8	22	72376	10863	72368	10841	0.36363636363636365	6.6753989484364915
chr5	TENM2	167875985	167876195	201	211	72376	10863	72175	10652	0.95260663507109	6.775722868944799
chr5	WWC1	168406197	168406327	0	131	1911	9685	1911	9554	0.0	0.20002093364036005
chr5	WWC1	168441681	168441834	0	154	1911	9685	1911	9531	0.0	0.20050361976707587
chr5	RARS1	168488152	168488270	306	119	825	3434	519	3315	2.5714285714285716	0.15656108597285068
chr5	RARS1	168493893	168494002	0	110	825	3434	825	3324	0.0	0.24819494584837545
chr5	SLIT3-AS1	169017831	169017941	505	111	50726	3135	50221	3024	4.54954954954955	16.607473544973544
chr5	SLIT3-AS1	169018392	169018641	1646	250	50726	3135	49080	2885	6.584	17.01213171577123
chr5	SLIT3-AS1	169022132	169022228	506	97	50726	3135	50220	3038	5.216494845360825	16.53061224489796
chr5	SPDL1	169587198	169587372	0	175	8623	4769	8623	4594	0.0	1.8770134958641707
chr5	SPDL1	169587260	169587372	0	113	8623	4769	8623	4656	0.0	1.8520189003436427
chr5	SPDL1	169584087	169584166	0	80	8623	4769	8623	4689	0.0	1.838984858178716
chr5	SPDL1	169590755	169590829	154	75	8623	4769	8469	4694	2.0533333333333332	1.804218150830848
chr5	SPDL1	169590752	169590829	154	78	8623	4769	8469	4691	1.9743589743589745	1.8053719889149435
chr5	DOCK2	169708168	169708267	0	100	1836	11986	1836	11886	0.0	0.15446744068652196
chr5	DOCK2	169712119	169712223	0	105	1836	11986	1836	11881	0.0	0.15453244676374042
chr5	DOCK2	170008687	170008746	0	60	1836	11986	1836	11926	0.0	0.15394935435183632
chr5	DOCK2	169997973	169998024	0	52	1836	11986	1836	11934	0.0	0.15384615384615385
chr5	C5ORF58	170234114	170234198	0	85	0	2724	0	2639	0.0	0.0
chr5	C5ORF58	170237270	170237365	0	96	0	2724	0	2628	0.0	0.0
chr5	LINC01366	170332847	170332937	0	91	510	2997	510	2906	0.0	0.17549896765313144
chr5	LINC01366	170332143	170332280	0	138	510	2997	510	2859	0.0	0.1783840503672613
chr5	KCNIP1	170669498	170669660	0	163	32	3382	32	3219	0.0	0.009940975458216837
chr5	KCNIP1	170712853	170712886	0	34	32	3382	32	3348	0.0	0.009557945041816009
chr5	GABRP	170809567	170809755	0	189	816	4637	816	4448	0.0	0.18345323741007194
chr5	RANBP17	170896049	170896115	0	67	35363	9801	35363	9734	0.0	3.632936100267105
chr5	RANBP17	170918712	170918859	0	148	35363	9801	35363	9653	0.0	3.66342069822853
chr5	RANBP17	171028871	171028989	0	119	35363	9801	35363	9682	0.0	3.652447841355092
chr5	RANBP17	171284512	171284678	0	167	35363	9801	35363	9634	0.0	3.6706456300602035
chr5	RANBP17	171158333	171158494	0	162	35363	9801	35363	9639	0.0	3.668741570702355
chr5	RANBP17	171161406	171161466	0	61	35363	9801	35363	9740	0.0	3.630698151950719
chr5	RANBP17	170983064	170983245	0	182	35363	9801	35363	9619	0.0	3.6763696849984404
chr5	RANBP17	171183194	171183230	0	37	35363	9801	35363	9764	0.0	3.621773863170832
chr5	NPM1	171390050	171390130	0	81	7984	6517	7984	6436	0.0	1.240522063393412
chr5	NPM1	171400838	171400925	0	88	7984	6517	7984	6429	0.0	1.241872764037953
chr5	NPM1	171400152	171400210	10	59	7984	6517	7974	6458	0.1694915254237288	1.2347475998761226
chr5	NPM1	171406396	171407161	1836	766	7984	6517	6148	5751	2.3968668407310707	1.0690314727873413
chr5	NPM1	171402813	171402900	0	88	7984	6517	7984	6429	0.0	1.241872764037953
chr5	NPM1	171407128	171407161	0	34	7984	6517	7984	6483	0.0	1.2315286132963135
chr5	NPM1	171390074	171390130	0	57	7984	6517	7984	6460	0.0	1.2359133126934985
chr5	NEURL1B	172669784	172670330	0	547	0	6432	0	5885	0.0	0.0
chr5	NEURL1B	172683418	172684138	0	721	0	6432	0	5711	0.0	0.0
chr5	AC110011.1	172818384	172818493	0	110	0	768	0	658	0.0	0.0
chr5	ERGIC1	172909666	172909761	0	96	2301	12376	2301	12280	0.0	0.18737785016286646
chr5	ERGIC1	172915517	172915690	0	174	2301	12376	2301	12202	0.0	0.18857564333715784
chr5	ATP6V0E1	172994774	172994822	0	49	614774	1613	614774	1564	0.0	393.0780051150895
chr5	ATP6V0E1	173020237	173020367	0	131	614774	1613	614774	1482	0.0	414.8272604588394
chr5	BNIP1	173151565	173151694	0	130	0	2448	0	2318	0.0	0.0
chr5	BNIP1	173158743	173158845	0	103	0	2448	0	2345	0.0	0.0
chr5	AC016573.1	173439427	173439530	0	104	3392	1709	3392	1605	0.0	2.1133956386292834
chr5	AC016573.1	173385043	173385148	2312	106	3392	1709	1080	1603	21.81132075471698	0.6737367436057392
chr5	AC016573.1	173424713	173424904	0	192	3392	1709	3392	1517	0.0	2.2359920896506265
chr5	AC016573.1	173444337	173444443	35	107	3392	1709	3357	1602	0.32710280373831774	2.095505617977528
chr5	AC016573.1	173431676	173431720	0	45	3392	1709	3392	1664	0.0	2.0384615384615383
chr5	CPEB4	173932449	173932500	0	52	0	10457	0	10405	0.0	0.0
chr5	CPEB4	173943025	173943049	0	25	0	10457	0	10432	0.0	0.0
chr5	CPEB4	173942883	173943049	0	167	0	10457	0	10290	0.0	0.0
chr5	NSG2	174066203	174066279	0	77	0	3855	0	3778	0.0	0.0
chr5	SFXN1	175491493	175491651	0	159	102	7421	102	7262	0.0	0.01404571743321399
chr5	HRH2	175691223	175691359	0	137	1377	5684	1377	5547	0.0	0.2482422931314224
chr5	CPLX2	175805443	175805621	11149	179	22789	7033	11640	6854	62.28491620111732	1.6982783775897285
chr5	CPLX2	175809332	175809392	65	61	22789	7033	22724	6972	1.0655737704918034	3.259323006310958
chr5	FAM153B	176074635	176074829	18078	195	35646	5362	17568	5167	92.70769230769231	3.400038707180182
chr5	FAM153B	176090369	176090394	0	26	35646	5362	35646	5336	0.0	6.680284857571214
chr5	AC139491.5	176119814	176120001	0	188	0	4570	0	4382	0.0	0.0
chr5	FAM153B	176087111	176087255	0	145	35646	5362	35646	5217	0.0	6.832662449683727
chr5	FAM153B	176087111	176087205	0	95	35646	5362	35646	5267	0.0	6.767799506360357
chr5	AC139491.5	176123996	176124105	0	110	0	4570	0	4460	0.0	0.0
chr5	AC139491.5	176123996	176124120	0	125	0	4570	0	4445	0.0	0.0
chr5	SIMC1	176289653	176290955	0	1303	765	5551	765	4248	0.0	0.18008474576271186
chr5	CDHR2	176566945	176567114	129	170	7203	5382	7074	5212	0.7588235294117647	1.3572524942440523
chr5	EIF4E1B	176637325	176637471	2726	147	2879	3096	153	2949	18.54421768707483	0.05188199389623601
chr5	TSPAN17	176654894	176655020	0	127	249	4684	249	4557	0.0	0.05464121132323897
chr5	UNC5A	176869613	176869781	8283	169	112604	4335	104321	4166	49.01183431952663	25.041046567450792
chr5	ZNF346	177050702	177050936	255	235	67992	6647	67737	6412	1.0851063829787233	10.564098565190267
chr5	ZNF346	177044388	177044533	0	146	67992	6647	67992	6501	0.0	10.458698661744346
chr5	ZNF346	177050750	177050936	255	187	67992	6647	67737	6460	1.3636363636363635	10.485603715170278
chr5	ZNF346	177023159	177023234	482	76	67992	6647	67510	6571	6.342105263157895	10.273930908537514
chr5	FGFR4	177088238	177088514	0	277	2880	4774	2880	4497	0.0	0.6404269513008672
chr5	FGFR4	177089857	177089940	0	84	2880	4774	2880	4690	0.0	0.6140724946695096
chr5	NSD1	177238236	177238507	51	272	432	15548	381	15276	0.1875	0.024941084053417124
chr5	NSD1	177169393	177169644	0	252	432	15548	432	15296	0.0	0.028242677824267783
chr5	NSD1	177169393	177169428	0	36	432	15548	432	15512	0.0	0.02784940691077875
chr5	NSD1	177229764	177229886	0	123	432	15548	432	15425	0.0	0.028006482982171798
chr5	RGS14	177371474	177371589	0	116	0	3486	0	3370	0.0	0.0
chr5	SLC34A1	177394027	177394195	0	169	43232	4414	43232	4245	0.0	10.184216725559482
chr5	GRK6	177432705	177432806	0	102	125	4375	125	4273	0.0	0.029253451907325066
chr5	PRR7	177453955	177454040	0	86	51	1759	51	1673	0.0	0.030484160191273164
chr5	B4GALT7	177601425	177601503	0	79	255	3050	255	2971	0.0	0.0858296869740828
chr5	AC106795.1	177836660	177836800	0	141	634	3867	634	3726	0.0	0.1701556629092861
chr5	FAM153CP	178052802	178052989	24	188	87124	18718	87100	18530	0.1276595744680851	4.700485698866703
chr5	FAM153CP	178020259	178020453	0	195	87124	18718	87124	18523	0.0	4.703557739027155
chr5	FAM153CP	178016585	178016616	0	32	87124	18718	87124	18686	0.0	4.662528095900674
chr5	FAM153CP	178032742	178032886	561	145	87124	18718	86563	18573	3.8689655172413793	4.660690249286599
chr5	FAM153CP	178054737	178054807	0	71	87124	18718	87124	18647	0.0	4.6722797232798845
chr5	FAM153CP	178057648	178057818	0	171	87124	18718	87124	18547	0.0	4.697471289157276
chr5	FAM153CP	178060874	178060994	0	121	87124	18718	87124	18597	0.0	4.684841641124913
chr5	FAM153CP	178023232	178023332	0	101	87124	18718	87124	18617	0.0	4.679808776924316
chr5	FAM153CP	178052908	178052989	0	82	87124	18718	87124	18636	0.0	4.675037561708521
chr5	FAM153CP	178054715	178054807	0	93	87124	18718	87124	18625	0.0	4.677798657718121
chr5	RMND5B	178135172	178135312	0	141	14189	6205	14189	6064	0.0	2.3398746701846966
chr5	RMND5B	178138107	178138258	0	152	14189	6205	14189	6053	0.0	2.3441268792334378
chr5	RMND5B	178133451	178133569	357	119	14189	6205	13832	6086	3.0	2.2727571475517583
chr5	RMND5B	178131236	178131376	0	141	14189	6205	14189	6064	0.0	2.3398746701846966
chr5	RMND5B	178136028	178136248	0	221	14189	6205	14189	5984	0.0	2.3711564171122994
chr5	HNRNPAB	178210131	178210272	0	142	102	2125	102	1983	0.0	0.05143721633888049
chr5	ZFP2	178915684	178915771	0	88	0	2644	0	2556	0.0	0.0
chr5	RUFY1	179562546	179562664	0	119	0	5465	0	5346	0.0	0.0
chr5	RUFY1	179580946	179581012	0	67	0	5465	0	5398	0.0	0.0
chr5	RUFY1	179589545	179589647	0	103	0	5465	0	5362	0.0	0.0
chr5	RUFY1	179586330	179586475	0	146	0	5465	0	5319	0.0	0.0
chr5	RUFY1	179555649	179555790	0	142	0	5465	0	5323	0.0	0.0
chr5	AC136604.2	179662974	179663103	31692	130	37384	1529	5692	1399	243.7846153846154	4.068620443173695
chr5	CANX	179707131	179707190	266	60	108795	6294	108529	6234	4.433333333333334	17.40920757138274
chr5	CANX	179699574	179699770	495	197	108795	6294	108300	6097	2.512690355329949	17.76283418074463
chr5	CANX	179705678	179705852	102	175	108795	6294	108693	6119	0.5828571428571429	17.76319660075176
chr5	CANX	179704154	179704430	34	277	108795	6294	108761	6017	0.12274368231046931	18.075619079275388
chr5	CANX	179706257	179706331	0	75	108795	6294	108795	6219	0.0	17.493970091654607
chr5	CANX	179715898	179716000	0	103	108795	6294	108795	6191	0.0	17.57308996931029
chr5	SQSTM1	179821550	179821707	0	158	102	6804	102	6646	0.0	0.01534757749021968
chr5	CNOT6	180529274	180529388	56	115	56	6531	0	6416	0.48695652173913045	0.0
chr5	CNOT6	180553385	180553471	0	87	56	6531	56	6444	0.0	0.008690254500310366
chr5	CNOT6	180495420	180495588	0	169	56	6531	56	6362	0.0	0.008802263439170073
chr5	CNOT6	180549930	180550117	0	188	56	6531	56	6343	0.0	0.00882862998581113
chr5	LINC00847	180831758	180831941	0	184	213	5657	213	5473	0.0	0.0389183263292527
chr5	LINC00847	180831735	180831806	0	72	213	5657	213	5585	0.0	0.038137869292748434
chr5	LINC00847	180832672	180832860	60	189	213	5657	153	5468	0.31746031746031744	0.027980980248719825
chr5	LINC00847	180831735	180831941	0	207	213	5657	213	5450	0.0	0.03908256880733945
chr5	LINC00847	180831758	180831806	0	49	213	5657	213	5608	0.0	0.03798145506419401
chr5	LINC00847	180832744	180832860	10	117	213	5657	203	5540	0.08547008547008547	0.03664259927797834
chr5	BTNL8	180908585	180908933	0	349	2178	3933	2178	3584	0.0	0.6077008928571429
chr5	BTNL8	180948354	180948375	0	22	2178	3933	2178	3911	0.0	0.5568908207619535
chr5	BTNL8	180902345	180902396	55	52	2178	3933	2123	3881	1.0576923076923077	0.5470239628961607
chr5	BTNL9	181045466	181045598	0	133	0	5577	0	5444	0.0	0.0
chr5	TRIM41	181233412	181233435	0	24	0	9683	0	9659	0.0	0.0
chr5	SLC9A3	474882	475132	115	251	300106	5771	299991	5520	0.4581673306772908	54.34619565217391
chr5	ZDHHC11B	769954	770117	9	164	4955	5638	4946	5474	0.054878048780487805	0.9035440263061747
chr5	ZDHHC11B	783941	784124	0	184	4955	5638	4955	5454	0.0	0.9085075174184085
chr5	ZDHHC11	823388	823809	3435	422	26627	4756	23192	4334	8.139810426540285	5.351176742039686
chr5	ZDHHC11	823388	824093	6134	706	26627	4756	20493	4050	8.688385269121813	5.06
chr5	BRD9	868606	869119	7478	514	772955	9010	765477	8496	14.54863813229572	90.09851694915254
chr5	BRD9	883350	883450	6003	101	772955	9010	766952	8909	59.43564356435643	86.08732742170838
chr5	BRD9	888234	888407	0	174	772955	9010	772955	8836	0.0	87.47793119058397
chr5	BRD9	881106	881182	1025	77	772955	9010	771930	8933	13.311688311688311	86.41329900369416
chr5	BRD9	869244	869394	1302	151	772955	9010	771653	8859	8.62251655629139	87.10384919291117
chr5	BRD9	869244	869404	1702	161	772955	9010	771253	8849	10.571428571428571	87.15707989603345
chr5	BRD9	869037	869119	429	83	772955	9010	772526	8927	5.168674698795181	86.53814271311751
chr5	BRD9	883937	884070	7056	134	772955	9010	765899	8876	52.656716417910445	86.2887561964849
chr5	SLC12A7	1056581	1056596	9	16	195195	6029	195186	6013	0.5625	32.46066855147181
chr5	TERT	1264403	1264592	1585	190	10089	5782	8504	5592	8.342105263157896	1.5207439198855508
chr5	LINC01511	1368319	1368391	0	73	0	3376	0	3303	0.0	0.0
chr5	AC026412.1	1630408	1630566	143	159	44766	3371	44623	3212	0.89937106918239	13.892590286425904
chr5	AC026412.1	1632643	1632751	51	109	44766	3371	44715	3262	0.46788990825688076	13.707847946045371
chr5	AC026412.4	1640370	1640774	0	405	0	2235	0	1830	0.0	0.0
chr5	IRX4	1880065	1880143	0	79	51	2906	51	2827	0.0	0.01804032543332154
chr5	NSUN2	6605272	6605408	45278	137	1219128	5525	1173850	5388	330.4963503649635	217.8637713437268
chr5	NSUN2	6622015	6622100	1559	86	1219128	5525	1217569	5439	18.127906976744185	223.85898143041
chr5	NSUN2	6631872	6631977	545	106	1219128	5525	1218583	5419	5.1415094339622645	224.87230116257612
chr5	FASTKD3	7866645	7868196	71766	1552	106287	2765	34521	1213	46.240979381443296	28.45919208573784
chr5	TAS2R1	9659420	9659581	0	162	0	1281	0	1119	0.0	0.0
chr5	ATPSCKMT	10235210	10235261	1973	52	131887	3292	129914	3240	37.94230769230769	40.09691358024691
chr5	ATPSCKMT	10244433	10244500	0	68	131887	3292	131887	3224	0.0	40.90787841191067
chr5	ATPSCKMT	10236837	10237040	542	204	131887	3292	131345	3088	2.656862745098039	42.53400259067357
chr5	CMBL	10282196	10282288	0	93	180320	4891	180320	4798	0.0	37.582325969153814
chr5	DAP	10683528	10683571	0	44	1165403	3328	1165403	3284	0.0	354.8730207064555
chr5	CTNND2	10988110	10988242	0	133	114	7298	114	7165	0.0	0.015910676901605025
chr5	CTNND2	11384664	11385229	0	566	114	7298	114	6732	0.0	0.01693404634581105
chr5	CTNND2	10986637	10986741	0	105	114	7298	114	7193	0.0	0.015848741832336994
chr5	CTNND2	11083880	11083955	0	76	114	7298	114	7222	0.0	0.015785101080033233
chr5	CTNND2	11397030	11397203	114	174	114	7298	0	7124	0.6551724137931034	0.0
chr5	DNAH5	13765975	13766179	0	205	13396	16556	13396	16351	0.0	0.8192771084337349
chr5	CTD-2350J17.1	15617179	15617341	0	163	0	1269	0	1106	0.0	0.0
chr5	MARCHF11	16090888	16091081	0	194	0	1882	0	1688	0.0	0.0
chr5	MYO10	16877608	16877707	260	100	707994	13792	707734	13692	2.6	51.68959976628688
chr5	MYO10	16738135	16738398	765	264	707994	13792	707229	13528	2.897727272727273	52.27890301596688
chr5	AC106744.2	19037514	19037714	0	201	0	1160	0	959	0.0	0.0
chr5	CDH18	19981059	19981178	0	120	7295	6506	7295	6386	0.0	1.1423426244910742
chr5	CDH18	19878031	19878090	0	60	7295	6506	7295	6446	0.0	1.1317095873409866
chr5	AC093274.1	21339601	21339652	0	52	1836	6003	1836	5951	0.0	0.3085195765417577
chr5	CDH12	21854670	21854790	0	121	165	5671	165	5550	0.0	0.02972972972972973
chr5	CDH12	22405256	22405351	0	96	165	5671	165	5575	0.0	0.029596412556053813
chr5	CDH10	24505111	24505248	254	138	20996	3673	20742	3535	1.8405797101449275	5.867609618104668
chr5	LINC02228	25167527	25167588	0	62	14112	4908	14112	4846	0.0	2.912092447379282
chr5	CDH9	27028253	27028370	0	118	190	4220	190	4102	0.0	0.046318868844466114
chr5	LINC02064	29381852	29381962	0	111	0	4274	0	4163	0.0	0.0
chr5	LINC02064	29354204	29354391	0	188	0	4274	0	4086	0.0	0.0
chr5	LINC02064	29389810	29389935	0	126	0	4274	0	4148	0.0	0.0
chr5	LINC02064	29363317	29363382	0	66	0	4274	0	4208	0.0	0.0
chr5	LINC02064	29389810	29389939	0	130	0	4274	0	4144	0.0	0.0
chr5	DROSHA	31515453	31515564	722	112	364450	7164	363728	7052	6.446428571428571	51.577992058990354
chr5	DROSHA	31521122	31521215	0	94	364450	7164	364450	7070	0.0	51.54879773691655
chr5	DROSHA	31531449	31531525	0	77	364450	7164	364450	7087	0.0	51.42514463101453
chr5	GOLPH3	32143748	32143880	26450	133	1675897	2746	1649447	2613	198.87218045112783	631.246460007654
chr5	MTMR12	32234961	32235129	13375	169	568388	5541	555013	5372	79.14201183431953	103.31589724497394
chr5	MTMR12	32276681	32276742	0	62	568388	5541	568388	5479	0.0	103.73936849790108
chr5	MTMR12	32233772	32233934	18021	163	568388	5541	550367	5378	110.55828220858896	102.33674228337672
chr5	MTMR12	32296353	32296470	0	118	568388	5541	568388	5423	0.0	104.81062142725429
chr5	ZFR	32380074	32380172	2472	99	528705	5928	526233	5829	24.96969696969697	90.27843540916109
chr5	AC010343.3	33263499	33263666	78	168	486	3258	408	3090	0.4642857142857143	0.13203883495145632
chr5	SLC45A2	33963690	33964016	0	327	0	3230	0	2903	0.0	0.0
chr5	SLC45A2	33982235	33982412	0	178	0	3230	0	3052	0.0	0.0
chr5	AMACR	34004573	34004734	8401	162	91296	2515	82895	2353	51.858024691358025	35.229494262643435
chr5	AMACR	33993947	33994120	0	174	91296	2515	91296	2341	0.0	38.99871849636907
chr5	AMACR	33994077	33994120	0	44	91296	2515	91296	2471	0.0	36.94698502630514
chr5	AC138409.2	34200820	34200921	124	102	17656	6582	17532	6480	1.2156862745098038	2.7055555555555557
chr5	RAD1	34913469	34913578	3051	110	463767	6562	460716	6452	27.736363636363638	71.40669559826411
chr5	RAD1	34913926	34914026	3464	101	463767	6562	460303	6461	34.2970297029703	71.24330598978486
chr5	AGXT2	35040574	35040663	0	90	0	3817	0	3727	0.0	0.0
chr5	PRLR	35065948	35066102	1527	155	9171	3630	7644	3475	9.851612903225806	2.199712230215827
chr5	PRLR	35068778	35068878	0	101	9171	3630	9171	3529	0.0	2.5987531878719183
chr5	PRLR	35086207	35086340	0	134	9171	3630	9171	3496	0.0	2.623283752860412
chr5	PRLR	35084469	35084639	37	171	9171	3630	9134	3459	0.21637426900584794	2.6406475860075167
chr5	PRLR	35072574	35072744	423	171	9171	3630	8748	3459	2.473684210526316	2.529054640069384
chr5	PRLR	35152786	35152973	0	188	9171	3630	9171	3442	0.0	2.6644392794886693
chr5	PRLR	35195550	35195713	62	164	9171	3630	9109	3466	0.3780487804878049	2.6281015579919216
chr5	UGT3A1	35988449	35988551	0	103	0	8317	0	8214	0.0	0.0
chr5	UGT3A1	35961988	35962951	0	964	0	8317	0	7353	0.0	0.0
chr5	UGT3A2	36048888	36049420	0	533	969	2692	969	2159	0.0	0.44881889763779526
chr5	UGT3A2	36064248	36064350	0	103	969	2692	969	2589	0.0	0.3742757821552723
chr5	NADK2	36200226	36200280	126	55	259915	5032	259789	4977	2.290909090909091	52.19791038778381
chr5	NADK2	36207169	36207265	259	97	259915	5032	259656	4935	2.670103092783505	52.61519756838906
chr5	NADK2	36208624	36208690	96	67	259915	5032	259819	4965	1.4328358208955223	52.330110775428
chr5	RANBP3L	36268192	36268267	0	76	51	4900	51	4824	0.0	0.010572139303482588
chr5	CPLANE1	37139339	37139370	0	32	68705	20159	68705	20127	0.0	3.4135738063298056
chr5	CPLANE1	37206196	37206425	765	230	68705	20159	67940	19929	3.3260869565217392	3.409102313211902
chr5	CPLANE1	37243012	37243119	0	108	68705	20159	68705	20051	0.0	3.426512393396838
chr5	CPLANE1	37244374	37244607	3482	234	68705	20159	65223	19925	14.88034188034188	3.273425345043915
chr5	CPLANE1	37157312	37157420	0	109	68705	20159	68705	20050	0.0	3.4266832917705736
chr5	CPLANE1	37206196	37206296	0	101	68705	20159	68705	20058	0.0	3.425316581912454
chr5	CPLANE1	37230661	37230718	0	58	68705	20159	68705	20101	0.0	3.4179891547684194
chr5	NUP155	37310551	37310743	23638	193	551308	9160	527670	8967	122.47668393782384	58.84576781532285
chr5	GDNF	37824009	37824089	0	81	154622	4634	154622	4553	0.0	33.96046562705908
chr5	LIFR	38555004	38555065	0	62	81443	12186	81443	12124	0.0	6.717502474430881
chr5	OSMR-AS1	38715639	38715802	0	164	1435	4879	1435	4715	0.0	0.30434782608695654
chr5	RICTOR	39074110	39074158	56	49	132746	12689	132690	12640	1.1428571428571428	10.497626582278482
chr5	RICTOR	38949355	38949427	0	73	132746	12689	132746	12616	0.0	10.522035510462905
chr5	FYB1	39125997	39126135	0	139	0	7176	0	7037	0.0	0.0
chr5	FYB1	39125971	39126135	0	165	0	7176	0	7011	0.0	0.0
chr5	FYB1	39250670	39250806	0	137	0	7176	0	7039	0.0	0.0
chr5	FYB1	39212677	39213017	0	341	0	7176	0	6835	0.0	0.0
chr5	FYB1	39211057	39211091	0	35	0	7176	0	7141	0.0	0.0
chr5	FYB1	39208863	39208964	0	102	0	7176	0	7074	0.0	0.0
chr5	DAB2	39382617	39383271	80447	655	294632	7579	214185	6924	122.81984732824428	30.93370883882149
chr5	DAB2	39388304	39388367	0	64	294632	7579	294632	7515	0.0	39.20585495675316
chr5	DAB2	39423703	39423897	0	195	294632	7579	294632	7384	0.0	39.901408450704224
chr5	DAB2	39417188	39417284	0	97	294632	7579	294632	7482	0.0	39.378775728414865
chr5	DAB2	39418180	39418345	160	166	294632	7579	294472	7413	0.963855421686747	39.72372858491838
chr5	TTC33	40728344	40728476	1912	133	127014	9717	125102	9584	14.37593984962406	13.05321368948247
chr5	TTC33	40730261	40730343	0	83	127014	9717	127014	9634	0.0	13.183931907826448
chr5	PRKAA1	40769415	40769503	0	89	831376	6430	831376	6341	0.0	131.1111812017032
chr5	PRKAA1	40774927	40774972	928	46	831376	6430	830448	6384	20.17391304347826	130.08270676691728
chr5	RPL37	40834180	40834265	2532	86	295501	1105	292969	1019	29.441860465116278	287.5063788027478
chr5	RPL37	40833960	40834037	2500	78	295501	1105	293001	1027	32.05128205128205	285.2979552093476
chr5	C6	41203577	41203734	0	158	0	4881	0	4723	0.0	0.0
chr5	SELENOP	42804655	42804773	0	119	255	5511	255	5392	0.0	0.047292284866468845
chr5	SELENOP	42806895	42807108	0	214	255	5511	255	5297	0.0	0.04814045686237493
chr5	SELENOP	42808150	42808366	0	217	255	5511	255	5294	0.0	0.04816773706082357
chr5	SELENOP	42809759	42809788	0	30	255	5511	255	5481	0.0	0.046524356869184456
chr5	SELENOP	42810690	42810778	0	89	255	5511	255	5422	0.0	0.04703061600885282
chr5	AC025171.1	43016361	43016477	3597	117	124560	4315	120963	4198	30.743589743589745	28.814435445450215
chr5	HMGCS1	43307765	43307824	80	60	385159	6361	385079	6301	1.3333333333333333	61.113950166640215
chr5	TMEM267	43476113	43476258	549	146	57186	1523	56637	1377	3.76027397260274	41.130718954248366
chr5	TMEM267	43453657	43454043	11309	387	57186	1523	45877	1136	29.22222222222222	40.38468309859155
chr5	TMEM267	43454454	43454605	304	152	57186	1523	56882	1371	2.0	41.48942377826404
chr5	TMEM267	43479889	43479987	1702	99	57186	1523	55484	1424	17.19191919191919	38.96348314606742
chr5	C5ORF34	43502371	43502495	150	125	99192	2821	99042	2696	1.2	36.736646884273
chr5	C5ORF34	43509144	43509375	9662	232	99192	2821	89530	2589	41.64655172413793	34.58091927385091
chr5	C5ORF34	43508576	43508666	0	91	99192	2821	99192	2730	0.0	36.33406593406593
chr5	PAIP1	43529785	43529879	0	95	210208	3400	210208	3305	0.0	63.60302571860817
chr5	PAIP1	43538923	43539035	659	113	210208	3400	209549	3287	5.831858407079646	63.75083662914512
chr5	PAIP1	43555829	43555999	32296	171	210208	3400	177912	3229	188.8654970760234	55.09817280891917
chr5	PAIP1	43529796	43529879	0	84	210208	3400	210208	3316	0.0	63.392038600723765
chr5	NNT-AS1	43583466	43583566	1997	101	154578	6365	152581	6264	19.77227722772277	24.358397190293744
chr5	LINC02224	44504292	44504472	0	181	0	1438	0	1257	0.0	0.0
chr5	MRPS30-DT	44777036	44777101	0	66	1949	1997	1949	1931	0.0	1.0093215950284826
chr5	MRPS30-DT	44747626	44747696	0	71	1949	1997	1949	1926	0.0	1.0119418483904465
chr5	MRPS30-DT	44777908	44777992	0	85	1949	1997	1949	1912	0.0	1.0193514644351465
chr5	HCN1	45266514	45266563	0	50	3672	10283	3672	10233	0.0	0.35883905013192613
chr5	AC025180.1	52978267	52978399	51	133	51	2429	0	2296	0.38345864661654133	0.0
chr5	AC025180.1	52978251	52978399	51	149	51	2429	0	2280	0.3422818791946309	0.0
chr5	MOCS2	53101358	53101509	0	152	83	5555	83	5403	0.0	0.015361836017027578
chr5	MOCS2	53102096	53102224	32	129	83	5555	51	5426	0.24806201550387597	0.009399189089568744
chr5	LINC02105	53778267	53778377	0	111	0	1891	0	1780	0.0	0.0
chr5	LINC02105	53816052	53816192	0	141	0	1891	0	1750	0.0	0.0
chr5	ESM1	54981996	54982146	0	151	8340	2697	8340	2546	0.0	3.2757266300078554
chr5	AC034238.1	55023137	55023337	0	201	0	4159	0	3958	0.0	0.0
chr5	AC034238.1	55024946	55025111	0	166	0	4159	0	3993	0.0	0.0
chr5	AC034238.1	55024946	55025041	0	96	0	4159	0	4063	0.0	0.0
chr5	AC034238.1	55023297	55023337	0	41	0	4159	0	4118	0.0	0.0
chr5	AC034238.1	55023928	55024076	0	149	0	4159	0	4010	0.0	0.0
chr5	AC034238.1	55025675	55025764	0	90	0	4159	0	4069	0.0	0.0
chr5	AC034238.1	55028217	55028306	0	90	0	4159	0	4069	0.0	0.0
chr5	CDC20B	55120424	55120550	0	127	51	4537	51	4410	0.0	0.011564625850340135
chr5	CDC20B	55172587	55172650	0	64	51	4537	51	4473	0.0	0.011401743796109993
chr5	CDC20B	55126353	55126439	0	87	51	4537	51	4450	0.0	0.01146067415730337
chr5	DHX29	55298590	55298664	0	75	19237	4731	19237	4656	0.0	4.131658075601375
chr5	PLPP1	55475298	55475450	0	153	0	1943	0	1790	0.0	0.0
chr5	PLPP1	55490959	55491114	0	156	0	1943	0	1787	0.0	0.0
chr5	SLC38A9	55649206	55649314	0	109	204	8550	204	8441	0.0	0.024167752635943607
chr5	SLC38A9	55672562	55672695	0	134	204	8550	204	8416	0.0	0.02423954372623574
chr5	SLC38A9	55697845	55697992	0	148	204	8550	204	8402	0.0	0.02427993334920257
chr5	SLC38A9	55711451	55711499	0	49	204	8550	204	8501	0.0	0.02399717680272909
chr5	SLC38A9	55691188	55691292	0	105	204	8550	204	8445	0.0	0.024156305506216696
chr5	SLC38A9	55704321	55704434	0	114	204	8550	204	8436	0.0	0.02418207681365576
chr5	SLC38A9	55711351	55711499	0	149	204	8550	204	8401	0.0	0.024282823473396026
chr5	SLC38A9	55702738	55702894	0	157	204	8550	204	8393	0.0	0.0243059692600977
chr5	IL6ST	55954809	55954992	0	184	0	10136	0	9952	0.0	0.0
chr5	IL6ST	55957208	55957291	0	84	0	10136	0	10052	0.0	0.0
chr5	IL6ST	55982723	55982811	0	89	0	10136	0	10047	0.0	0.0
chr5	IL6ST	55948101	55948982	0	882	0	10136	0	9254	0.0	0.0
chr5	IL6ST	55959625	55959671	0	47	0	10136	0	10089	0.0	0.0
chr5	IL6ST	55948897	55948982	0	86	0	10136	0	10050	0.0	0.0
chr5	ANKRD55	56126921	56127106	0	186	962	2963	962	2777	0.0	0.34641699675909254
chr5	ANKRD55	56143800	56143929	0	130	962	2963	962	2833	0.0	0.33956936110130603
chr5	ANKRD55	56232855	56232946	500	92	962	2963	462	2871	5.434782608695652	0.16091954022988506
chr5	LINC01948	56464986	56465067	0	82	2486	4731	2486	4649	0.0	0.5347386534738654
chr5	MIER3	56938295	56938338	0	44	0	5712	0	5668	0.0	0.0
chr5	MIER3	56936893	56936936	0	44	0	5712	0	5668	0.0	0.0
chr5	MIER3	56950627	56950652	0	26	0	5712	0	5686	0.0	0.0
chr5	MIER3	56959385	56959520	0	136	0	5712	0	5576	0.0	0.0
chr5	PDE4D	59038858	59038971	0	114	165531	13868	165531	13754	0.0	12.035117056856187
chr5	PDE4D	59091081	59091125	76	45	165531	13868	165455	13823	1.6888888888888889	11.969543514432468
chr5	PDE4D	60188295	60188418	9398	124	165531	13868	156133	13744	75.79032258064517	11.360084400465658
chr5	PDE4D	60127583	60127681	0	99	165531	13868	165531	13769	0.0	12.022005955407074
chr5	DEPDC1B	60599074	60599260	0	187	1876	3820	1876	3633	0.0	0.5163776493256262
chr5	DEPDC1B	60688984	60689050	0	67	1876	3820	1876	3753	0.0	0.4998667732480682
chr5	DEPDC1B	60687724	60687838	101	115	1876	3820	1775	3705	0.8782608695652174	0.47908232118758437
chr5	ELOVL7	60799179	60799230	0	52	2507	4475	2507	4423	0.0	0.5668098575627403
chr5	ELOVL7	60802626	60802665	0	40	2507	4475	2507	4435	0.0	0.5652762119503946
chr5	ELOVL7	60768645	60768690	1171	46	2507	4475	1336	4429	25.456521739130434	0.3016482275908783
chr5	ERCC8	60924290	60924508	0	219	51	13538	51	13319	0.0	0.003829116300022524
chr5	ERCC8	60890272	60890401	0	130	51	13538	51	13408	0.0	0.0038036992840095466
chr5	ERCC8	60924290	60924356	0	67	51	13538	51	13471	0.0	0.003785910474352312
chr5	ERCC8	60915185	60915286	0	102	51	13538	51	13436	0.0	0.00379577255135457
chr5	ERCC8	60909647	60909957	0	311	51	13538	51	13227	0.0	0.0038557496030845995
chr5	ERCC8	60896458	60896515	0	58	51	13538	51	13480	0.0	0.0037833827893175073
chr5	ERCC8	60900650	60900840	0	191	51	13538	51	13347	0.0	0.003821083389525736
chr5	ERCC8	60932106	60932148	0	43	51	13538	51	13495	0.0	0.0037791774731381995
chr5	ERCC8	60924290	60924367	0	78	51	13538	51	13460	0.0	0.003789004457652303
chr5	LINC02057	61264776	61264852	0	77	0	1494	0	1417	0.0	0.0
chr5	AC026746.1	61667756	61667877	1036	122	73183	3482	72147	3360	8.491803278688524	21.47232142857143
chr5	ADAMTS6	65291328	65291470	561	143	54899	8581	54338	8438	3.923076923076923	6.439677648731927
chr5	ADAMTS6	65297107	65297244	0	138	54899	8581	54899	8443	0.0	6.50230960559043
chr5	CENPK	65528918	65529017	0	100	0	3192	0	3092	0.0	0.0
chr5	CENPK	65551105	65551242	0	138	0	3192	0	3054	0.0	0.0
chr5	CENPK	65541354	65541436	0	83	0	3192	0	3109	0.0	0.0
chr5	TRIM23	65618092	65618255	0	164	8	3039	8	2875	0.0	0.002782608695652174
chr5	TRIM23	65613726	65613855	0	130	8	3039	8	2909	0.0	0.002750085940185631
chr5	AC010280.1	68526813	68526919	0	107	126	792	126	685	0.0	0.18394160583941604
chr5	CCDC125	69292187	69292362	0	176	17679	7594	17679	7418	0.0	2.383256942572122
chr5	CCDC125	69313984	69314046	0	63	17679	7594	17679	7531	0.0	2.3474970123489576
chr5	CCDC125	69294792	69294900	0	109	17679	7594	17679	7485	0.0	2.3619238476953908
chr5	CCDC125	69313984	69314043	0	60	17679	7594	17679	7534	0.0	2.3465622511282187
chr5	TAF9	69366502	69366595	41573	94	120394	2120	78821	2026	442.2659574468085	38.90473840078973
chr5	NAIP	70979868	70980036	0	169	0	9217	0	9048	0.0	0.0
chr5	NAIP	70971448	70971571	0	124	0	9217	0	9093	0.0	0.0
chr5	NAIP	71011711	71011786	0	76	0	9217	0	9141	0.0	0.0
chr5	GTF2H2	71061271	71061308	0	38	0	5742	0	5704	0.0	0.0
chr5	GTF2H2	71065124	71065222	0	99	0	5742	0	5643	0.0	0.0
chr5	GTF2H2	71050216	71050305	0	90	0	5742	0	5652	0.0	0.0
chr5	MRPS27	72314080	72314158	0	79	1049	5031	1049	4952	0.0	0.2118336025848142
chr5	MRPS27	72241646	72241688	25	43	1049	5031	1024	4988	0.5813953488372093	0.20529270248596632
chr5	ZNF366	72494222	72494293	0	72	0	5617	0	5545	0.0	0.0
chr5	ZNF366	72493586	72493660	0	75	0	5617	0	5542	0.0	0.0
chr5	AC063979.1	72693550	72693782	0	233	0	1828	0	1595	0.0	0.0
chr5	AC063979.1	72770627	72770866	0	240	0	1828	0	1588	0.0	0.0
chr5	AC063979.1	72770709	72770866	0	158	0	1828	0	1670	0.0	0.0
chr5	ANKRA2	73561129	73561288	0	160	0	2700	0	2540	0.0	0.0
chr5	LINC01331	74476337	74476452	0	116	1020	3666	1020	3550	0.0	0.28732394366197184
chr5	ENC1	74637564	74637701	598	138	59959	8243	59361	8105	4.333333333333333	7.323997532387415
chr5	ENC1	74637493	74640125	50346	2633	59959	8243	9613	5610	19.121154576528674	1.713547237076649
chr5	ENC1	74637493	74637618	0	126	59959	8243	59959	8117	0.0	7.386842429469016
chr5	GFM2	74725639	74725755	0	117	8186	3867	8186	3750	0.0	2.182933333333333
chr5	GFM2	74730259	74730398	360	140	8186	3867	7826	3727	2.5714285714285716	2.0998121813791255
chr5	GFM2	74738501	74738642	816	142	8186	3867	7370	3725	5.746478873239437	1.9785234899328858
chr5	GFM2	74751367	74751493	0	127	8186	3867	8186	3740	0.0	2.188770053475936
chr5	GFM2	74763679	74763766	0	88	8186	3867	8186	3779	0.0	2.16618152950516
chr5	GFM2	74765034	74765152	0	119	8186	3867	8186	3748	0.0	2.1840981856990394
chr5	FAM169A	74813839	74814019	70	181	1366	6891	1296	6710	0.3867403314917127	0.1931445603576751
chr5	FAM169A	74834425	74834597	0	173	1366	6891	1366	6718	0.0	0.20333432569217028
chr5	ANKRD31	75145986	75147505	0	1520	102	6335	102	4815	0.0	0.02118380062305296
chr5	ANKRD31	75144000	75144171	0	172	102	6335	102	6163	0.0	0.016550381307804642
chr5	CERT1	75379418	75379473	0	56	0	10692	0	10636	0.0	0.0
chr5	CERT1	75399309	75399387	0	79	0	10692	0	10613	0.0	0.0
chr5	CERT1	75411010	75411103	0	94	0	10692	0	10598	0.0	0.0
chr5	CERT1	75389591	75389687	0	97	0	10692	0	10595	0.0	0.0
chr5	CERT1	75379336	75379473	0	138	0	10692	0	10554	0.0	0.0
chr5	CERT1	75402674	75402792	0	119	0	10692	0	10573	0.0	0.0
chr5	POC5	75677773	75677950	0	178	51	3430	51	3252	0.0	0.015682656826568265
chr5	POC5	75705703	75705787	0	85	51	3430	51	3345	0.0	0.015246636771300448
chr5	POC5	75707736	75707875	0	140	51	3430	51	3290	0.0	0.015501519756838906
chr5	POC5	75712853	75712951	0	99	51	3430	51	3331	0.0	0.015310717502251577
chr5	POC5	75712606	75712665	0	60	51	3430	51	3370	0.0	0.015133531157270029
chr5	ZBED3	77078593	77078728	0	136	83378	6480	83378	6344	0.0	13.14281210592686
chr5	WDR41	77437335	77437424	0	90	20263	5048	20263	4958	0.0	4.086930213795886
chr5	WDR41	77453816	77453928	0	113	20263	5048	20263	4935	0.0	4.105977710233029
chr5	WDR41	77464760	77464809	0	50	20263	5048	20263	4998	0.0	4.0542216886754705
chr5	WDR41	77449759	77449860	0	102	20263	5048	20263	4946	0.0	4.096845936109988
chr5	WDR41	77489456	77489572	0	117	20263	5048	20263	4931	0.0	4.109308456702494
chr5	WDR41	77453816	77453910	0	95	20263	5048	20263	4953	0.0	4.091055925701595
chr5	WDR41	77480080	77480189	0	110	20263	5048	20263	4938	0.0	4.1034831915755365
chr5	TBCA	77693265	77693352	0	88	1203	3121	1203	3033	0.0	0.39663699307616224
chr5	TBCA	77708241	77708347	408	107	1203	3121	795	3014	3.8130841121495327	0.26376907763769075
chr5	TBCA	77705565	77705634	0	70	1203	3121	1203	3051	0.0	0.3942969518190757
chr5	LHFPL2	78632263	78632368	0	106	408	7990	408	7884	0.0	0.0517503805175038
chr5	MTX3	79985570	79985659	375	90	2670	7925	2295	7835	4.166666666666667	0.2929164007657945
chr5	MTX3	79990593	79990663	0	71	2670	7925	2670	7854	0.0	0.33995416348357527
chr5	THBS4-AS1	80081767	80081940	0	174	1474	5353	1474	5179	0.0	0.2846109287507241
chr5	SERINC5	80116137	80116323	0	187	2377	7714	2377	7527	0.0	0.3157964660555334
chr5	SERINC5	80114513	80114651	0	139	2377	7714	2377	7575	0.0	0.3137953795379538
chr5	ANKRD34B	80564383	80564469	0	87	2516	3822	2516	3735	0.0	0.6736278447121821
chr5	DHFR	80633876	80633992	0	117	621	2626	621	2509	0.0	0.2475089677162216
chr5	DHFR	80637882	80638009	0	128	621	2626	621	2498	0.0	0.24859887910328263
chr5	DHFR	80654007	80654057	0	51	621	2626	621	2575	0.0	0.2411650485436893
chr5	CKMT2-AS1	81223314	81223475	0	162	0	7683	0	7521	0.0	0.0
chr5	CKMT2-AS1	81246889	81246972	0	84	0	7683	0	7599	0.0	0.0
chr5	CKMT2-AS1	81250702	81250789	0	88	0	7683	0	7595	0.0	0.0
chr5	CKMT2-AS1	81240327	81240380	0	54	0	7683	0	7629	0.0	0.0
chr5	ACOT12	81342671	81342755	0	85	61	2467	61	2382	0.0	0.025608732157850547
chr5	SSBP2	81428584	81428683	0	100	1098	11043	1098	10943	0.0	0.10033811569039569
chr5	SSBP2	81489249	81489309	0	61	1098	11043	1098	10982	0.0	0.09998178838098706
chr5	SSBP2	81513627	81513717	0	91	1098	11043	1098	10952	0.0	0.10025566106647188
chr5	SSBP2	81710677	81710768	0	92	1098	11043	1098	10951	0.0	0.10026481599853895
chr5	LINC01338	82854764	82854912	0	149	6234	3362	6234	3213	0.0	1.9402427637721755
chr5	TMEM167A	83065007	83065117	0	111	0	4871	0	4760	0.0	0.0
chr5	TMEM167A	83061876	83061911	0	36	0	4871	0	4835	0.0	0.0
chr5	HAPLN1	83675287	83675337	0	51	0	5774	0	5723	0.0	0.0
chr5	EDIL3	84229854	84229884	0	31	0	5839	0	5808	0.0	0.0
chr5	CCNH	87404843	87405007	0	165	0	4875	0	4710	0.0	0.0
chr5	CCNH	87394404	87394484	0	81	0	4875	0	4794	0.0	0.0
chr5	TMEM161B	88197668	88197765	0	98	4531	9091	4531	8993	0.0	0.5038363171355499
chr5	TMEM161B	88225768	88225866	0	99	4531	9091	4531	8992	0.0	0.5038923487544484
chr5	TMEM161B	88240812	88240916	0	105	4531	9091	4531	8986	0.0	0.5042288003561095
chr5	TMEM161B	88221673	88221760	0	88	4531	9091	4531	9003	0.0	0.5032766855492613
chr5	TMEM161B	88259231	88259363	0	133	4531	9091	4531	8958	0.0	0.5058048671578478
chr5	LINC00461	88672964	88673028	0	65	0	11943	0	11878	0.0	0.0
chr5	LINC00461	88666790	88667591	0	802	0	11943	0	11141	0.0	0.0
chr5	LINC00461	88656624	88656707	0	84	0	11943	0	11859	0.0	0.0
chr5	LINC00461	88671035	88671085	0	51	0	11943	0	11892	0.0	0.0
chr5	LINC00461	88672964	88673090	0	127	0	11943	0	11816	0.0	0.0
chr5	MEF2C	88730210	88730234	0	25	0	5849	0	5824	0.0	0.0
chr5	MEF2C	88761184	88761328	0	145	0	5849	0	5704	0.0	0.0
chr5	MEF2C	88761268	88761328	0	61	0	5849	0	5788	0.0	0.0
chr5	MEF2C	88760987	88761125	0	139	0	5849	0	5710	0.0	0.0
chr5	MEF2C	88880923	88881022	0	100	0	5849	0	5749	0.0	0.0
chr5	MEF2C	88817804	88817831	0	28	0	5849	0	5821	0.0	0.0
chr5	LINC01339	90200466	90200528	0	63	0	2565	0	2502	0.0	0.0
chr5	LINC01339	90235428	90235535	0	108	0	2565	0	2457	0.0	0.0
chr5	LINC01339	90244610	90244755	0	146	0	2565	0	2419	0.0	0.0
chr5	CETN3	90396492	90396564	0	73	0	3096	0	3023	0.0	0.0
chr5	LYSMD3	90526918	90527002	0	85	423	4464	423	4379	0.0	0.09659739666590546
chr5	LYSMD3	90520363	90520461	153	99	423	4464	270	4365	1.5454545454545454	0.061855670103092786
chr5	LUCAT1	91195495	91195592	0	98	0	15454	0	15356	0.0	0.0
chr5	LUCAT1	91264662	91264713	0	52	0	15454	0	15402	0.0	0.0
chr5	LUCAT1	91303872	91303971	0	100	0	15454	0	15354	0.0	0.0
chr5	LUCAT1	91313637	91313777	0	141	0	15454	0	15313	0.0	0.0
chr5	LUCAT1	91313077	91313229	0	153	0	15454	0	15301	0.0	0.0
chr5	LUCAT1	91305679	91305771	0	93	0	15454	0	15361	0.0	0.0
chr5	LUCAT1	91312294	91312481	0	188	0	15454	0	15266	0.0	0.0
chr5	LUCAT1	91310855	91311032	0	178	0	15454	0	15276	0.0	0.0
chr5	LUCAT1	91312294	91312413	0	120	0	15454	0	15334	0.0	0.0
chr5	LUCAT1	91310737	91311032	0	296	0	15454	0	15158	0.0	0.0
chr5	LUCAT1	91312294	91312495	0	202	0	15454	0	15252	0.0	0.0
chr5	LUCAT1	91311645	91311737	0	93	0	15454	0	15361	0.0	0.0
chr5	LUCAT1	91306031	91306096	0	66	0	15454	0	15388	0.0	0.0
chr5	LUCAT1	91313961	91314052	0	92	0	15454	0	15362	0.0	0.0
chr5	LUCAT1	91313961	91314033	0	73	0	15454	0	15381	0.0	0.0
chr5	LUCAT1	91311645	91312413	0	769	0	15454	0	14685	0.0	0.0
chr5	ARRDC3	91376620	91376768	0	149	0	4954	0	4805	0.0	0.0
chr5	NR2F1-AS1	93544794	93544915	0	122	3564	22614	3564	22492	0.0	0.1584563400320114
chr5	NR2F1-AS1	93432364	93432460	0	97	3564	22614	3564	22517	0.0	0.15828041035661944
chr5	NR2F1-AS1	93497953	93498156	0	204	3564	22614	3564	22410	0.0	0.15903614457831325
chr5	NR2F1-AS1	93438702	93438741	0	40	3564	22614	3564	22574	0.0	0.15788074776291308
chr5	NR2F1-AS1	93569889	93570002	54	114	3564	22614	3510	22500	0.47368421052631576	0.156
chr5	NR2F1-AS1	93496056	93496103	0	48	3564	22614	3564	22566	0.0	0.15793671895772401
chr5	NR2F1-AS1	93423154	93423244	0	91	3564	22614	3564	22523	0.0	0.1582382453491986
chr5	NR2F1-AS1	93569889	93570058	186	170	3564	22614	3378	22444	1.0941176470588236	0.15050793085011585
chr5	NR2F1-AS1	93543981	93544024	0	44	3564	22614	3564	22570	0.0	0.1579087284005317
chr5	NR2F1-AS1	93535184	93535243	0	60	3564	22614	3564	22554	0.0	0.15802075019952114
chr5	NR2F1-AS1	93580466	93580691	0	226	3564	22614	3564	22388	0.0	0.15919242451313204
chr5	NR2F1-AS1	93422309	93422421	0	113	3564	22614	3564	22501	0.0	0.15839296031287498
chr5	NR2F1-AS1	93500956	93501160	0	205	3564	22614	3564	22409	0.0	0.15904324155473248
chr5	NR2F1-AS1	93543688	93544024	0	337	3564	22614	3564	22277	0.0	0.15998563540871752
chr5	NR2F1-AS1	93504591	93506495	51	1905	3564	22614	3513	20709	0.026771653543307086	0.16963638997537303
chr5	FAM172A	93958776	93958968	204	193	516	5269	312	5076	1.0569948186528497	0.061465721040189124
chr5	FAM172A	94050730	94050831	0	102	516	5269	516	5167	0.0	0.09986452486936327
chr5	FAM172A	94074645	94074769	0	125	516	5269	516	5144	0.0	0.10031104199066875
chr5	FAM172A	93737811	93737940	0	130	516	5269	516	5139	0.0	0.10040863981319323
chr5	KIAA0825	94582432	94582583	0	152	10482	6197	10482	6045	0.0	1.7339950372208437
chr5	MCTP1	94799012	94799132	693	121	15326	12122	14633	12001	5.7272727272727275	1.2193150570785767
chr5	MCTP1	94917895	94917973	0	79	15326	12122	15326	12043	0.0	1.2726064933986547
chr5	MCTP1	94931952	94931991	0	40	15326	12122	15326	12082	0.0	1.2684985929481873
chr5	MCTP1	94923961	94924021	0	61	15326	12122	15326	12061	0.0	1.2707072382057873
chr5	MCTP1	95068784	95068829	0	46	15326	12122	15326	12076	0.0	1.2691288506127858
chr5	TTC37	95543183	95543327	0	145	550	10468	550	10323	0.0	0.05327908553715005
chr5	TTC37	95553006	95553228	0	223	550	10468	550	10245	0.0	0.053684724255734506
chr5	SPATA9	95675411	95675639	0	229	39	2937	39	2708	0.0	0.014401772525849335
chr5	SPATA9	95674685	95674788	0	104	39	2937	39	2833	0.0	0.013766325450052947
chr5	AC008840.1	95716916	95717081	0	166	60	2200	60	2034	0.0	0.029498525073746312
chr5	ELL2	95932631	95932713	0	83	204	7037	204	6954	0.0	0.029335634167385678
chr5	PCSK1	96410773	96410986	0	214	11068	5374	11068	5160	0.0	2.1449612403100775
chr5	ERAP1	96800861	96801000	204	140	204	6534	0	6394	1.457142857142857	0.0
chr5	AC009126.1	96822936	96823117	0	182	0	4132	0	3950	0.0	0.0
chr5	AC009126.1	96848770	96848823	0	54	0	4132	0	4078	0.0	0.0
chr5	AC009126.1	96873514	96873672	0	159	0	4132	0	3973	0.0	0.0
chr5	LIX1	97137103	97137192	0	90	51	4003	51	3913	0.0	0.01303347814975722
chr5	RIOK2	97166266	97166371	0	106	0	4454	0	4348	0.0	0.0
chr5	RGMB-AS1	98772621	98772798	0	178	0	963	0	785	0.0	0.0
chr5	RGMB-AS1	98772621	98772715	0	95	0	963	0	868	0.0	0.0
chr5	RGMB-AS1	98771655	98771766	0	112	0	963	0	851	0.0	0.0
chr5	CHD1	98859971	98860068	0	98	340	10309	340	10211	0.0	0.033297424346293215
chr5	CHD1	98863407	98863586	0	180	340	10309	340	10129	0.0	0.03356698588212064
chr5	CHD1	98869013	98869277	0	265	340	10309	340	10044	0.0	0.0338510553564317
chr5	AC021086.1	100526305	100526349	0	45	51	3518	51	3473	0.0	0.01468471062482004
chr5	AC021086.1	100457056	100457124	0	69	51	3518	51	3449	0.0	0.014786894752102058
chr5	AC021086.1	100534079	100534152	0	74	51	3518	51	3444	0.0	0.014808362369337979
chr5	ST8SIA4	100900314	100900463	0	150	0	7819	0	7669	0.0	0.0
chr5	SLCO6A1	102459655	102459777	0	123	51	2803	51	2680	0.0	0.019029850746268655
chr5	SLCO6A1	102477675	102477861	51	187	51	2803	0	2616	0.2727272727272727	0.0
chr5	SLCO6A1	102477675	102477690	0	16	51	2803	51	2787	0.0	0.01829924650161464
chr5	LINC00491	102617857	102617928	0	72	21405	2811	21405	2739	0.0	7.814895947426068
chr5	LINC00491	102611892	102611955	18746	64	21405	2811	2659	2747	292.90625	0.9679650527848562
chr5	LINC00491	102636142	102636291	0	150	21405	2811	21405	2661	0.0	8.043968432919955
chr5	GIN1	103106715	103106909	0	195	51	4178	51	3983	0.0	0.012804418779814211
chr5	AC099520.1	104638447	104638527	0	81	0	4954	0	4873	0.0	0.0
chr5	AC099520.1	104763279	104763383	0	105	0	4954	0	4849	0.0	0.0
chr5	AC099520.1	104754822	104755006	0	185	0	4954	0	4769	0.0	0.0
chr5	AC099520.1	104745362	104745446	0	85	0	4954	0	4869	0.0	0.0
chr5	AC099520.1	104744517	104744609	0	93	0	4954	0	4861	0.0	0.0
chr5	LINC01950	106969883	106969951	220	69	267	877	47	808	3.1884057971014492	0.05816831683168317
chr5	LINC01950	106980763	106980870	0	108	267	877	267	769	0.0	0.3472041612483745
chr5	EFNA5	107387234	107387315	0	82	0	5752	0	5670	0.0	0.0
chr5	TMEM232	110528587	110528835	8181	249	8806	10205	625	9956	32.855421686746986	0.06277621534752913
chr5	TMEM232	110667227	110667364	0	138	8806	10205	8806	10067	0.0	0.8747392470447999
chr5	TMEM232	110610502	110610600	0	99	8806	10205	8806	10106	0.0	0.8713635464080745
chr5	TMEM232	110667694	110667729	0	36	8806	10205	8806	10169	0.0	0.8659651883174353
chr5	TMEM232	110726626	110726798	0	173	8806	10205	8806	10032	0.0	0.8777910685805422
chr5	STARD4	111501961	111502088	0	128	205435	5691	205435	5563	0.0	36.92881538738091
chr5	STARD4	111507328	111507442	0	115	205435	5691	205435	5576	0.0	36.84271879483501
chr5	STARD4	111505014	111505043	0	30	205435	5691	205435	5661	0.0	36.289524818936584
chr5	NREP	111755769	111755830	0	62	153	9126	153	9064	0.0	0.016879964695498677
chr5	NREP	111734669	111734742	0	74	153	9126	153	9052	0.0	0.01690234202386213
chr5	NREP	111755769	111755926	0	158	153	9126	153	8968	0.0	0.017060660124888494
chr5	REEP5	112887014	112887183	0	170	5755	3981	5755	3811	0.0	1.5101023353450538
chr5	REEP5	112902379	112902518	0	140	5755	3981	5755	3841	0.0	1.4983077323613643
chr5	REEP5	112892449	112892817	126	369	5755	3981	5629	3612	0.34146341463414637	1.5584163898117387
chr5	TRIM36	115163517	115163752	0	236	116823	6078	116823	5842	0.0	19.997090037658335
chr5	TRIM36	115159640	115159670	0	31	116823	6078	116823	6047	0.0	19.319166528857284
chr5	PGGT1B	115221823	115222008	0	186	97289	9777	97289	9591	0.0	10.143780627671775
chr5	PGGT1B	115230975	115231021	12	47	97289	9777	97277	9730	0.2553191489361702	9.997636176772867
chr5	CCDC112	115269702	115269798	0	97	0	3161	0	3064	0.0	0.0
chr5	CCDC112	115284786	115284908	0	123	0	3161	0	3038	0.0	0.0
chr5	CCDC112	115280351	115280480	0	130	0	3161	0	3031	0.0	0.0
chr5	ATG12	115837627	115837764	0	138	3202	7572	3202	7434	0.0	0.4307237019101426
chr5	ATG12	115840496	115840612	500	117	3202	7572	2702	7455	4.273504273504273	0.3624413145539906
chr5	ATG12	115840817	115840934	0	118	3202	7572	3202	7454	0.0	0.42956801717198817
chr5	SEMA6A	116467582	116467747	0	166	29	10571	29	10405	0.0	0.002787121576165305
chr5	SEMA6A	116478541	116478718	0	178	29	10571	29	10393	0.0	0.0027903396516886364
chr5	SEMA6A	116472884	116472935	0	52	29	10571	29	10519	0.0	0.0027569160566593785
chr5	LINC02208	118469080	118469148	0	69	1866	5937	1866	5868	0.0	0.3179959100204499
chr5	LINC02208	118472062	118472189	0	128	1866	5937	1866	5809	0.0	0.3212256842830091
chr5	LINC02208	118472848	118472906	0	59	1866	5937	1866	5878	0.0	0.3174549166383124
chr5	LINC02208	118555046	118555139	221	94	1866	5937	1645	5843	2.351063829787234	0.28153345883963715
chr5	LINC02208	118552352	118552549	0	198	1866	5937	1866	5739	0.0	0.3251437532671197
chr5	DTWD2	118928536	118928729	0	194	17671	5874	17671	5680	0.0	3.1110915492957747
chr5	DTWD2	118939195	118939290	0	96	17671	5874	17671	5778	0.0	3.0583246798200068
chr5	AC113418.1	120351751	120351867	0	117	0	944	0	827	0.0	0.0
chr5	LOX	122076892	122077001	0	110	0	5516	0	5406	0.0	0.0
chr5	LOX	122070690	122070768	0	79	0	5516	0	5437	0.0	0.0
chr5	MGC32805	122450546	122450666	0	121	0	2401	0	2280	0.0	0.0
chr5	CEP120	123422466	123422575	0	110	0	13045	0	12935	0.0	0.0
chr5	CEP120	123403255	123403344	0	90	0	13045	0	12955	0.0	0.0
chr5	CEP120	123409831	123409948	0	118	0	13045	0	12927	0.0	0.0
chr5	CEP120	123422949	123423030	0	82	0	13045	0	12963	0.0	0.0
chr5	CEP120	123403693	123403740	0	48	0	13045	0	12997	0.0	0.0
chr5	CEP120	123358251	123358445	0	195	0	13045	0	12850	0.0	0.0
chr5	LINC01170	124313589	124313700	0	112	45	3859	45	3747	0.0	0.01200960768614892
chr5	ZNF608	124638781	124638823	0	43	3	6892	3	6849	0.0	0.0004380201489268506
chr5	ZNF608	124641251	124641405	3	155	3	6892	0	6737	0.01935483870967742	0.0
chr5	ZNF608	124646678	124649133	0	2456	3	6892	3	4436	0.0	0.0006762849413886385
chr5	ZNF608	124644243	124644661	0	419	3	6892	3	6473	0.0	0.0004634636181059787
chr5	ALDH7A1	126552020	126552137	0	118	153	14624	153	14506	0.0	0.010547359713222114
chr5	ALDH7A1	126568258	126568356	0	99	153	14624	153	14525	0.0	0.01053356282271945
chr5	ALDH7A1	126582850	126582974	0	125	153	14624	153	14499	0.0	0.010552451893234015
chr5	ALDH7A1	126583931	126584012	0	82	153	14624	153	14542	0.0	0.010521248796589189
chr5	ALDH7A1	126592663	126592729	0	67	153	14624	153	14557	0.0	0.010510407364154702
chr5	ALDH7A1	126593350	126593404	0	55	153	14624	153	14569	0.0	0.010501750291715286
chr5	ALDH7A1	126594107	126594267	0	161	153	14624	153	14463	0.0	0.010578718108276292
chr5	ALDH7A1	126582104	126582149	0	46	153	14624	153	14578	0.0	0.010495266840444505
chr5	ALDH7A1	126593350	126593447	0	98	153	14624	153	14526	0.0	0.010532837670384139
chr5	ALDH7A1	126584362	126584495	0	134	153	14624	153	14490	0.0	0.010559006211180125
chr5	ALDH7A1	126564457	126564592	28	136	153	14624	125	14488	0.20588235294117646	0.008627829928216455
chr5	C5ORF63	127056396	127056506	0	111	0	6944	0	6833	0.0	0.0
chr5	AC011416.4	127264501	127264718	0	218	1989	7226	1989	7008	0.0	0.2838184931506849
chr5	AC011416.4	127282212	127282309	51	98	1989	7226	1938	7128	0.5204081632653061	0.2718855218855219
chr5	LINC01184	128081972	128082191	0	220	51	12548	51	12328	0.0	0.004136924075275795
chr5	LINC01184	128062373	128062500	0	128	51	12548	51	12420	0.0	0.004106280193236715
chr5	LINC01184	128062369	128062500	0	132	51	12548	51	12416	0.0	0.004107603092783505
chr5	LINC01184	128081972	128082194	0	223	51	12548	51	12325	0.0	0.004137931034482759
chr5	LINC01184	128061143	128061244	0	102	51	12548	51	12446	0.0	0.004097702072955166
chr5	LINC01184	128076946	128077093	0	148	51	12548	51	12400	0.0	0.004112903225806452
chr5	LINC01184	128064736	128064850	0	115	51	12548	51	12433	0.0	0.004101986648435615
chr5	FBN2	128530594	128530693	0	100	2383	13291	2383	13191	0.0	0.18065347585474945
chr5	AC008591.1	129780327	129780481	0	155	255	8398	255	8243	0.0	0.030935339075579278
chr5	HINT1	131160655	131160844	0	190	147	6082	147	5892	0.0	0.02494908350305499
chr5	HINT1	131162063	131162477	0	415	147	6082	147	5667	0.0	0.02593965060878772
chr5	HINT1	131162028	131162503	0	476	147	6082	147	5606	0.0	0.026221905101676775
chr5	HINT1	131162028	131162477	0	450	147	6082	147	5632	0.0	0.026100852272727272
chr5	RAPGEF6	131428901	131429216	0	316	2245	11266	2245	10950	0.0	0.2050228310502283
chr5	RAPGEF6	131561977	131562047	0	71	2245	11266	2245	11195	0.0	0.2005359535506923
chr5	RAPGEF6	131450022	131450046	0	25	2245	11266	2245	11241	0.0	0.1997153278178098
chr5	RAPGEF6	131469800	131469815	0	16	2245	11266	2245	11250	0.0	0.19955555555555557
chr5	RAPGEF6	131440145	131440228	0	84	2245	11266	2245	11182	0.0	0.20076909318547667
chr5	RAPGEF6	131532100	131532194	783	95	2245	11266	1462	11171	8.242105263157894	0.1308745859815594
chr5	FNIP1	131730903	131731038	2303	136	29869	6738	27566	6602	16.933823529411764	4.175401393517116
chr5	FNIP1	131710577	131710661	255	85	29869	6738	29614	6653	3.0	4.4512250112731095
chr5	MEIKIN	131851263	131851383	0	121	20246	1618	20246	1497	0.0	13.52438209752839
chr5	MEIKIN	131878977	131879048	0	72	20246	1618	20246	1546	0.0	13.095730918499353
chr5	ACSL6	131985406	131985458	85	53	64616	15803	64531	15750	1.6037735849056605	4.097206349206349
chr5	ACSL6	131971746	131971759	0	14	64616	15803	64616	15789	0.0	4.092469440749889
chr5	ACSL6	132004314	132004663	0	350	64616	15803	64616	15453	0.0	4.181453439461594
chr5	ACSL6	131991744	131991813	0	70	64616	15803	64616	15733	0.0	4.107036166020467
chr5	ACSL6	131976183	131976240	0	58	64616	15803	64616	15745	0.0	4.103906001905367
chr5	ACSL6	131988555	131988600	0	46	64616	15803	64616	15757	0.0	4.100780605445199
chr5	P4HA2	132226696	132227221	3053	526	35065	9992	32012	9466	5.804182509505703	3.38178744982041
chr5	P4HA2	132227085	132227258	310	174	35065	9992	34755	9818	1.7816091954022988	3.539926665308617
chr5	P4HA2	132227085	132227221	250	137	35065	9992	34815	9855	1.8248175182481752	3.532724505327245
chr5	P4HA2	132226931	132227221	868	291	35065	9992	34197	9701	2.9828178694158076	3.5251005051025666
chr5	MIR3936HG	132352488	132352631	0	144	648	2699	648	2555	0.0	0.25362035225048923
chr5	MIR3936HG	132365858	132366049	0	192	648	2699	648	2507	0.0	0.258476266453929
chr5	IRF1	132486250	132486373	0	124	255	5641	255	5517	0.0	0.046220772158781946
chr5	IRF1	132487925	132488025	51	101	255	5641	204	5540	0.504950495049505	0.0368231046931408
chr5	IRF1	132489391	132489483	0	93	255	5641	255	5548	0.0	0.045962509012256667
chr5	KIF3A	132702086	132702212	0	127	0	6880	0	6753	0.0	0.0
chr5	KIF3A	132708906	132708978	0	73	0	6880	0	6807	0.0	0.0
chr5	KIF3A	132706450	132706459	0	10	0	6880	0	6870	0.0	0.0
chr5	SEPTIN8	132761799	132761896	0	98	0	4865	0	4767	0.0	0.0
chr5	SHROOM1	132824614	132824821	0	208	51	3735	51	3527	0.0	0.014459880918627729
chr5	AFF4	132898229	132898392	0	164	51	11305	51	11141	0.0	0.004577686024593843
chr5	AFF4	132927120	132927207	0	88	51	11305	51	11217	0.0	0.004546670232682536
chr5	ZCCHC10	133000131	133000173	0	43	0	2555	0	2512	0.0	0.0
chr5	ZCCHC10	133022840	133022906	0	67	0	2555	0	2488	0.0	0.0
chr5	ZCCHC10	133000131	133000201	0	71	0	2555	0	2484	0.0	0.0
chr5	FSTL4	133224189	133224216	0	28	297914	6733	297914	6705	0.0	44.431618195376586
chr5	SKP1	134170950	134171038	0	89	122297	12086	122297	11997	0.0	10.193965157956155
chr5	SKP1	134174461	134174514	0	54	122297	12086	122297	12032	0.0	10.164311835106384
chr5	SKP1	134173700	134173766	0	67	122297	12086	122297	12019	0.0	10.175305765870705
chr5	CDKL3	134306608	134306702	25	95	110679	3167	110654	3072	0.2631578947368421	36.020182291666664
chr5	CDKL3	134308573	134308727	0	155	110679	3167	110679	3012	0.0	36.74601593625498
chr5	CDKL3	134312291	134312380	0	90	110679	3167	110679	3077	0.0	35.96977575560611
chr5	CDKL3	134302139	134302210	459	72	110679	3167	110220	3095	6.375	35.61227786752827
chr5	CDKL3	134319357	134319497	0	141	110679	3167	110679	3026	0.0	36.576007931262396
chr5	CDKL3	134299655	134299750	630	96	110679	3167	110049	3071	6.5625	35.83490719635298
chr5	SAR1B	134618191	134618313	0	123	183	10558	183	10435	0.0	0.01753713464302827
chr5	SAR1B	134632076	134632195	0	120	183	10558	183	10438	0.0	0.017532094270933128
chr5	SAR1B	134608975	134609133	0	159	183	10558	183	10399	0.0	0.017597845946725647
chr5	SAR1B	134625776	134625876	0	101	183	10558	183	10457	0.0	0.017500239074304293
chr5	SAR1B	134632076	134632199	0	124	183	10558	183	10434	0.0	0.017538815411155838
chr5	MACROH2A1	135352945	135353045	0	101	1181264	10783	1181264	10682	0.0	110.58453473132373
chr5	MACROH2A1	135388921	135389126	738	206	1181264	10783	1180526	10577	3.5825242718446604	111.61255554505058
chr5	MACROH2A1	135350822	135350913	0	92	1181264	10783	1181264	10691	0.0	110.49144139930783
chr5	TRPC7	136274672	136274837	0	166	51	3780	51	3614	0.0	0.014111787493082457
chr5	TRPC7	136315596	136315779	0	184	51	3780	51	3596	0.0	0.01418242491657397
chr5	TRPC7	136274656	136274837	0	182	51	3780	51	3598	0.0	0.014174541411895497
chr5	TRPC7	136266219	136266436	0	218	51	3780	51	3562	0.0	0.014317798989331837
chr5	SPOCK1	137498372	137498558	0	187	231	6218	231	6031	0.0	0.03830210578676836
chr5	KLHL3	137637293	137637395	95	103	179158	11404	179063	11301	0.9223300970873787	15.844880983983717
chr5	KLHL3	137720464	137720584	0	121	179158	11404	179158	11283	0.0	15.878578392271558
chr5	FAM13B	137946227	137946311	0	85	107	6607	107	6522	0.0	0.016406010426249618
chr5	FAM13B	138018954	138019146	0	193	107	6607	107	6414	0.0	0.016682257561584035
chr5	FAM13B	137956476	137956542	0	67	107	6607	107	6540	0.0	0.01636085626911315
chr5	FAM13B	138033772	138033869	0	98	107	6607	107	6509	0.0	0.01643877707789215
chr5	FAM13B	138019880	138019977	0	98	107	6607	107	6509	0.0	0.01643877707789215
chr5	BRD8	138164713	138165166	0	454	128470	6939	128470	6485	0.0	19.810331534309945
chr5	BRD8	138166517	138166727	51	211	128470	6939	128419	6728	0.24170616113744076	19.087247324613557
chr5	BRD8	138172064	138172134	204	71	128470	6939	128266	6868	2.8732394366197185	18.675888177053
chr5	BRD8	138157641	138157894	51	254	128470	6939	128419	6685	0.20078740157480315	19.21002243829469
chr5	BRD8	138168469	138168688	0	220	128470	6939	128470	6719	0.0	19.120404822146153
chr5	BRD8	138166517	138166610	51	94	128470	6939	128419	6845	0.5425531914893617	18.76099342585829
chr5	BRD8	138159554	138159599	0	46	128470	6939	128470	6893	0.0	18.63774844044683
chr5	BRD8	138163129	138163344	73299	216	128470	6939	55171	6723	339.34722222222223	8.20630670831474
chr5	BRD8	138163586	138163643	782	58	128470	6939	127688	6881	13.482758620689655	18.556605144601075
chr5	BRD8	138164086	138164133	0	48	128470	6939	128470	6891	0.0	18.643157741982296
chr5	BRD8	138172719	138172826	0	108	128470	6939	128470	6831	0.0	18.806909676474895
chr5	BRD8	138172719	138172851	0	133	128470	6939	128470	6806	0.0	18.87599177196591
chr5	CDC23	138202112	138202155	0	44	1607	3956	1607	3912	0.0	0.41078732106339466
chr5	CDC23	138212990	138213063	0	74	1607	3956	1607	3882	0.0	0.41396187532199896
chr5	GFRA3	138259556	138259649	51	94	4535	1996	4484	1902	0.5425531914893617	2.3575184016824395
chr5	CDC25C	138325814	138325904	0	91	689	3355	689	3264	0.0	0.2110906862745098
chr5	CDC25C	138329552	138329647	0	96	689	3355	689	3259	0.0	0.21141454433875423
chr5	CDC25C	138326020	138326054	0	35	689	3355	689	3320	0.0	0.2075301204819277
chr5	ETF1	138517560	138517700	243	141	2775	4549	2532	4408	1.7234042553191489	0.574410163339383
chr5	ETF1	138529554	138529678	302	125	2775	4549	2473	4424	2.416	0.558996383363472
chr5	HSPA9	138557868	138557986	0	119	649	5786	649	5667	0.0	0.11452267513675667
chr5	HSPA9	138559863	138560091	0	229	649	5786	649	5557	0.0	0.1167896346949793
chr5	HSPA9	138566625	138566718	0	94	649	5786	649	5692	0.0	0.1140196767392832
chr5	HSPA9	138567648	138567722	0	75	649	5786	649	5711	0.0	0.11364034319733847
chr5	HSPA9	138574067	138574126	0	60	649	5786	649	5726	0.0	0.11334264757247642
chr5	HSPA9	138574067	138574169	0	103	649	5786	649	5683	0.0	0.11420024634875946
chr5	HSPA9	138574067	138574121	0	55	649	5786	649	5731	0.0	0.11324376199616124
chr5	HSPA9	138560780	138560931	111	152	649	5786	538	5634	0.7302631578947368	0.09549165779197728
chr5	SIL1	139026800	139026992	0	193	2097	3852	2097	3659	0.0	0.57310740639519
chr5	SIL1	139196440	139196528	0	89	2097	3852	2097	3763	0.0	0.5572681371246346
chr5	SIL1	139137328	139137474	0	147	2097	3852	2097	3705	0.0	0.5659919028340081
chr5	SIL1	139133333	139133471	0	139	2097	3852	2097	3713	0.0	0.564772421222731
chr5	SIL1	139127943	139128052	0	110	2097	3852	2097	3742	0.0	0.5603955104222341
chr5	SLC23A1	139379677	139379834	0	158	357	3085	357	2927	0.0	0.12196788520669627
chr5	SLC23A1	139380207	139380389	0	183	357	3085	357	2902	0.0	0.12301860785665059
chr5	MZB1	139388460	139388585	0	126	0	2030	0	1904	0.0	0.0
chr5	MZB1	139388460	139388601	0	142	0	2030	0	1888	0.0	0.0
chr5	MZB1	139388460	139388667	0	208	0	2030	0	1822	0.0	0.0
chr5	MZB1	139389326	139389420	0	95	0	2030	0	1935	0.0	0.0
chr5	SPATA24	139402627	139402693	0	67	204	942	204	875	0.0	0.23314285714285715
chr5	SPATA24	139397040	139397143	0	104	204	942	204	838	0.0	0.24343675417661098
chr5	DNAJC18	139422707	139422817	255	111	255	2652	0	2541	2.2972972972972974	0.0
chr5	DNAJC18	139428537	139428683	0	147	255	2652	255	2505	0.0	0.10179640718562874
chr5	DNAJC18	139437371	139437558	0	188	255	2652	255	2464	0.0	0.10349025974025974
chr5	DNAJC18	139418718	139418833	0	116	255	2652	255	2536	0.0	0.10055205047318612
chr5	DNAJC18	139442286	139442484	0	199	255	2652	255	2453	0.0	0.10395434162250305
chr5	STING1	139477328	139477515	0	188	51	4684	51	4496	0.0	0.011343416370106761
chr5	STING1	139481477	139481704	0	228	51	4684	51	4456	0.0	0.01144524236983842
chr5	STING1	139479151	139479204	0	54	51	4684	51	4630	0.0	0.011015118790496761
chr5	STING1	139481477	139481550	0	74	51	4684	51	4610	0.0	0.01106290672451193
chr5	NRG2	139859888	139859912	16	25	12857	4616	12841	4591	0.64	2.796994118928338
chr5	NRG2	139865114	139865173	0	60	12857	4616	12857	4556	0.0	2.821992976294996
chr5	NRG2	139865548	139865625	192	78	12857	4616	12665	4538	2.4615384615384617	2.7908770383428823
chr5	MALINC1	140106295	140106461	0	167	14558	7192	14558	7025	0.0	2.0723131672597863
chr5	MALINC1	140106295	140106490	0	196	14558	7192	14558	6996	0.0	2.0809033733562035
chr5	PFDN1	140281448	140281533	0	86	44	1745	44	1659	0.0	0.02652200120554551
chr5	PFDN1	140300415	140300582	0	168	44	1745	44	1577	0.0	0.027901077996195307
chr5	AC008438.1	140371412	140371755	0	344	357	988	357	644	0.0	0.5543478260869565
chr5	SRA1	140551981	140552184	0	204	612	3400	612	3196	0.0	0.19148936170212766
chr5	APBB3	140560638	140560754	0	117	418	3183	418	3066	0.0	0.13633398564905413
chr5	APBB3	140561843	140561849	0	7	418	3183	418	3176	0.0	0.13161209068010077
chr5	APBB3	140561843	140561995	0	153	418	3183	418	3030	0.0	0.13795379537953795
chr5	HARS1	140675016	140675133	0	118	6636	12088	6636	11970	0.0	0.5543859649122806
chr5	HARS1	140677326	140677420	0	95	6636	12088	6636	11993	0.0	0.5533227716167765
chr5	HARS1	140677907	140678015	0	109	6636	12088	6636	11979	0.0	0.55396944653143
chr5	HARS1	140683099	140683219	30	121	6636	12088	6606	11967	0.24793388429752067	0.5520180496365004
chr5	HARS1	140677326	140677457	0	132	6636	12088	6636	11956	0.0	0.5550351288056206
chr5	HARS1	140687745	140687933	0	189	6636	12088	6636	11899	0.0	0.5576939238591478
chr5	HARS1	140683545	140683667	0	123	6636	12088	6636	11965	0.0	0.5546176347680736
chr5	HARS1	140683545	140683664	0	120	6636	12088	6636	11968	0.0	0.5544786096256684
chr5	HARS1	140687420	140687542	0	123	6636	12088	6636	11965	0.0	0.5546176347680736
chr5	AC005609.5	140792666	140792770	0	105	7280	5049	7280	4944	0.0	1.4724919093851132
chr5	AC244517.5	141057749	141057850	0	102	51	1905	51	1803	0.0	0.028286189683860232
chr5	AC244517.5	141062410	141062533	0	124	51	1905	51	1781	0.0	0.028635597978663673
chr5	AC244517.11	141241452	141241687	0	236	0	1533	0	1297	0.0	0.0
chr5	DIAPH1	141529602	141529697	51	96	178283	7015	178232	6919	0.53125	25.759791877438936
chr5	DIAPH1	141588223	141588250	0	28	178283	7015	178283	6987	0.0	25.516387576928583
chr5	DIAPH1	141518943	141518996	630	54	178283	7015	177653	6961	11.666666666666666	25.521189484269502
chr5	DIAPH1	141581914	141582056	0	143	178283	7015	178283	6872	0.0	25.943393480791617
chr5	HDAC3	141625684	141625764	0	81	691	3635	691	3554	0.0	0.19442881260551492
chr5	HDAC3	141626012	141626071	0	60	691	3635	691	3575	0.0	0.1932867132867133
chr5	HDAC3	141629172	141629306	0	135	691	3635	691	3500	0.0	0.19742857142857143
chr5	HDAC3	141629683	141629739	0	57	691	3635	691	3578	0.0	0.19312465064281722
chr5	HDAC3	141634810	141634953	0	144	691	3635	691	3491	0.0	0.1979375537095388
chr5	HDAC3	141630043	141630125	0	83	691	3635	691	3552	0.0	0.19453828828828829
chr5	FCHSD1	141642396	141642503	0	108	168	5453	168	5345	0.0	0.0314312441534144
chr5	FCHSD1	141643000	141643088	0	89	168	5453	168	5364	0.0	0.03131991051454139
chr5	ARAP3	141655361	141655400	0	40	3687	6227	3687	6187	0.0	0.5959269435914013
chr5	ARAP3	141662042	141662255	51	214	3687	6227	3636	6013	0.2383177570093458	0.6046898386828539
chr5	PCDH1	141863231	141865427	0	2197	0	5934	0	3737	0.0	0.0
chr5	PCDH1	141856223	141856262	0	40	0	5934	0	5894	0.0	0.0
chr5	PCDH1	141867469	141867614	0	146	0	5934	0	5788	0.0	0.0
chr5	GNPDA1	142012287	142012339	0	53	992	3613	992	3560	0.0	0.2786516853932584
chr5	GNPDA1	142012287	142012377	0	91	992	3613	992	3522	0.0	0.2816581487791028
chr5	SPRY4	142319743	142319794	0	52	709	6560	709	6508	0.0	0.10894283958205286
chr5	SPRY4	142319732	142319794	0	63	709	6560	709	6497	0.0	0.10912728951823919
chr5	FGF1	142600701	142600805	0	105	2898	4780	2898	4675	0.0	0.6198930481283422
chr5	FGF1	142600701	142600800	0	100	2898	4780	2898	4680	0.0	0.6192307692307693
chr5	FGF1	142697621	142697715	0	95	2898	4780	2898	4685	0.0	0.6185699039487726
chr5	ARHGAP26-AS1	142860304	142860563	0	260	0	996	0	736	0.0	0.0
chr5	NR3C1	143433718	143433817	0	100	422	9176	422	9076	0.0	0.046496253856324374
chr5	YIPF5	144169845	144169965	0	121	0	3704	0	3583	0.0	0.0
chr5	PRELID2	145819378	145819414	0	37	24983	2724	24983	2687	0.0	9.297729810197247
chr5	PRELID2	145825997	145826200	0	204	24983	2724	24983	2520	0.0	9.91388888888889
chr5	LARS1	146139615	146139703	0	89	51	16674	51	16585	0.0	0.0030750678323786555
chr5	LARS1	146131018	146131109	0	92	51	16674	51	16582	0.0	0.003075624170787601
chr5	LARS1	146168127	146168265	51	139	51	16674	0	16535	0.3669064748201439	0.0
chr5	LARS1	146171909	146171990	0	82	51	16674	51	16592	0.0	0.0030737704918032786
chr5	LARS1	146181011	146181187	0	177	51	16674	51	16497	0.0	0.0030914711765775596
chr5	LARS1	146177546	146177665	0	120	51	16674	51	16554	0.0	0.0030808263863718738
chr5	LARS1	146119008	146119074	0	67	51	16674	51	16607	0.0	0.0030709941590895407
chr5	PPP2R2B	146878001	146878195	0	195	0	13227	0	13032	0.0	0.0
chr5	PPP2R2B	146856498	146856583	0	86	0	13227	0	13141	0.0	0.0
chr5	PPP2R2B	146592048	146592193	0	146	0	13227	0	13081	0.0	0.0
chr5	PPP2R2B	147054597	147054659	0	63	0	13227	0	13164	0.0	0.0
chr5	PPP2R2B	147040716	147040805	0	90	0	13227	0	13137	0.0	0.0
chr5	PPP2R2B	147035168	147035240	0	73	0	13227	0	13154	0.0	0.0
chr5	DPYSL3	147397665	147397845	0	181	18	7196	18	7015	0.0	0.0025659301496792587
chr5	DPYSL3	147400691	147400833	18	143	18	7196	0	7053	0.1258741258741259	0.0
chr5	JAKMIP2	147601740	147601811	0	72	51	9225	51	9153	0.0	0.005571943625040971
chr5	JAKMIP2	147636221	147636284	0	64	51	9225	51	9161	0.0	0.005567077829931231
chr5	JAKMIP2	147640703	147640823	0	121	51	9225	51	9104	0.0	0.005601933216168717
chr5	JAKMIP2	147650337	147650547	0	211	51	9225	51	9014	0.0	0.005657865542489461
chr5	JAKMIP2	147671677	147671954	0	278	51	9225	51	8947	0.0	0.0057002347155471105
chr5	AC011346.1	148308003	148308165	0	163	765	13969	765	13806	0.0	0.05541069100391134
chr5	AC011346.1	148290920	148290995	0	76	765	13969	765	13893	0.0	0.05506370114446124
chr5	AC011346.1	148377286	148377361	0	76	765	13969	765	13893	0.0	0.05506370114446124
chr5	AC011346.1	148290251	148290995	0	745	765	13969	765	13224	0.0	0.05784936479128856
chr5	HTR4	148461872	148461943	0	72	30	7064	30	6992	0.0	0.004290617848970252
chr5	HTR4	148465849	148465925	0	77	30	7064	30	6987	0.0	0.004293688278231
chr5	HTR4	148484259	148484379	0	121	30	7064	30	6943	0.0	0.004320898746939364
chr5	HTR4	148490599	148490846	0	248	30	7064	30	6816	0.0	0.0044014084507042256
chr5	SH3TC2	149003725	149003842	360	118	2844	12652	2484	12534	3.0508474576271185	0.19818094782192436
chr5	SH3TC2	149034390	149034520	0	131	2844	12652	2844	12521	0.0	0.22713840747544126
chr5	SH3TC2	149035392	149035602	0	211	2844	12652	2844	12441	0.0	0.22859898721967686
chr5	SH3TC2	149006133	149006251	0	119	2844	12652	2844	12533	0.0	0.22692092874810502
chr5	SH3TC2	149026059	149026200	0	142	2844	12652	2844	12510	0.0	0.2273381294964029
chr5	SH3TC2	149045893	149045961	0	69	2844	12652	2844	12583	0.0	0.2260192322975443
chr5	CSNK1A1	149511793	149511872	0	80	3009	8524	3009	8444	0.0	0.35634770251065845
chr5	CSNK1A1	149517793	149517877	0	85	3009	8524	3009	8439	0.0	0.3565588339850693
chr5	CSNK1A1	149525044	149525171	0	128	3009	8524	3009	8396	0.0	0.3583849452120057
chr5	CSNK1A1	149511065	149511158	0	94	3009	8524	3009	8430	0.0	0.35693950177935946
chr5	CSNK1A1	149515668	149515726	0	59	3009	8524	3009	8465	0.0	0.35546367395156525
chr5	CSNK1A1	149531393	149531511	0	119	3009	8524	3009	8405	0.0	0.3580011897679952
chr5	CSNK1A1	149529603	149529719	0	117	3009	8524	3009	8407	0.0	0.3579160223623171
chr5	PDE6A	149898362	149898506	51	145	103050	5965	102999	5820	0.35172413793103446	17.69742268041237
chr5	CSF1R	150073300	150073493	324	194	120502	5174	120178	4980	1.6701030927835052	24.132128514056223
chr5	CSF1R	150059699	150059862	0	164	120502	5174	120502	5010	0.0	24.052295409181635
chr5	CSF1R	150086378	150086607	1267	230	120502	5174	119235	4944	5.508695652173913	24.117111650485437
chr5	CSF1R	150058154	150058271	2272	118	120502	5174	118230	5056	19.25423728813559	23.384098101265824
chr5	PDGFRB	150137007	150137053	0	47	11482	6271	11482	6224	0.0	1.8447943444730077
chr5	CAMK2A	150228191	150228286	0	96	574	6094	574	5998	0.0	0.09569856618872957
chr5	CAMK2A	150231304	150231380	0	77	574	6094	574	6017	0.0	0.09539637693202592
chr5	CAMK2A	150239703	150239736	0	34	574	6094	574	6060	0.0	0.09471947194719472
chr5	CAMK2A	150264955	150265015	42	61	574	6094	532	6033	0.6885245901639344	0.08818166749544173
chr5	CD74	150403120	150403312	969	193	5233	2965	4264	2772	5.020725388601036	1.5382395382395382
chr5	CD74	150406880	150406960	7	81	5233	2965	5226	2884	0.08641975308641975	1.8120665742024966
chr5	CD74	150407151	150407324	0	174	5233	2965	5233	2791	0.0	1.8749552131852383
chr5	RPS14	150444478	150444641	21475	164	51349	2968	29874	2804	130.9451219512195	10.654065620542083
chr5	DCTN4	150742113	150742157	0	45	204	6234	204	6189	0.0	0.03296170625302957
chr5	DCTN4	150731885	150731906	0	22	204	6234	204	6212	0.0	0.032839665164198326
chr5	DCTN4	150755530	150755567	0	38	204	6234	204	6196	0.0	0.0329244673983215
chr5	DCTN4	150757920	150757948	0	29	204	6234	204	6205	0.0	0.03287671232876712
chr5	ZNF300	150903140	150903182	0	43	1382	4410	1382	4367	0.0	0.3164643920311427
chr5	ZNF300	150903328	150903383	168	56	1382	4410	1214	4354	3.0	0.2788240698208544
chr5	TNIP1	151033607	151033799	0	193	860983	5576	860983	5383	0.0	159.94482630503435
chr5	TNIP1	151064959	151065131	193	173	860983	5576	860790	5403	1.115606936416185	159.31704608550805
chr5	TNIP1	151032286	151032383	0	98	860983	5576	860983	5478	0.0	157.17104782767433
chr5	TNIP1	151033479	151033579	0	101	860983	5576	860983	5475	0.0	157.25716894977168
chr5	TNIP1	151080323	151080359	0	37	860983	5576	860983	5539	0.0	155.44015165192272
chr5	ANXA6	151110626	151110644	0	19	45638	5501	45638	5482	0.0	8.32506384531193
chr5	ANXA6	151147883	151147926	150	44	45638	5501	45488	5457	3.409090909090909	8.335715594649075
chr5	ANXA6	151140326	151140555	51	230	45638	5501	45587	5271	0.2217391304347826	8.648643521153481
chr5	CCDC69	151198996	151199084	0	89	826419	4952	826419	4863	0.0	169.940160394818
chr5	CCDC69	151205399	151205475	387	77	826419	4952	826032	4875	5.025974025974026	169.44246153846154
chr5	SLC36A3	151288933	151289056	0	124	0	4990	0	4866	0.0	0.0
chr5	SLC36A2	151339059	151339144	0	86	969	4280	969	4194	0.0	0.23104434907010013
chr5	SLC36A2	151332428	151332525	0	98	969	4280	969	4182	0.0	0.23170731707317074
chr5	SPARC	151679073	151679299	0	227	0	4653	0	4426	0.0	0.0
chr5	GLRA1	151892310	151892438	0	129	0	2453	0	2324	0.0	0.0
chr5	LINC01470	152623230	152623352	0	123	33	4499	33	4376	0.0	0.007541133455210238
chr5	LINC01470	152631411	152631478	0	68	33	4499	33	4431	0.0	0.007447528774542992
chr5	LINC01470	152971713	152971786	0	74	33	4499	33	4425	0.0	0.007457627118644068
chr5	LINC01470	152967092	152967106	0	15	33	4499	33	4484	0.0	0.0073595004460303304
chr5	FAM114A2	154038387	154038434	0	48	102	6540	102	6492	0.0	0.015711645101663587
chr5	FAM114A2	154038292	154038434	0	143	102	6540	102	6397	0.0	0.01594497420665937
chr5	FAM114A2	154036241	154036385	0	145	102	6540	102	6395	0.0	0.015949960906958563
chr5	FAXDC2	154830800	154830922	0	123	0	6073	0	5950	0.0	0.0
chr5	FAXDC2	154834624	154834728	0	105	0	6073	0	5968	0.0	0.0
chr5	FAXDC2	154838130	154838178	0	49	0	6073	0	6024	0.0	0.0
chr5	FAXDC2	154838562	154838939	0	378	0	6073	0	5695	0.0	0.0
chr5	TIMD4	156948415	156948499	0	85	909	1526	909	1441	0.0	0.6308119361554476
chr5	HAVCR1	157032853	157032887	0	35	49	1934	49	1899	0.0	0.025803054239073198
chr5	HAVCR1	157032853	157032870	0	18	49	1934	49	1916	0.0	0.0255741127348643
chr5	HAVCR2	157104665	157104749	0	85	0	3220	0	3135	0.0	0.0
chr5	SOX30	157638229	157638722	0	494	0	3496	0	3002	0.0	0.0
chr5	CLINT1	157794897	157794972	0	76	7752	6158	7752	6082	0.0	1.2745807300230187
chr5	CLINT1	157790599	157790651	0	53	7752	6158	7752	6105	0.0	1.26977886977887
chr5	EBF1	158712153	158712333	29771	181	122992	6353	93221	6172	164.48066298342542	15.103856124432923
chr5	EBF1	159073395	159073464	0	70	122992	6353	122992	6283	0.0	19.57536208817444
chr5	LINC01847	159704325	159704576	0	252	0	8584	0	8332	0.0	0.0
chr5	LINC01847	159748232	159748375	0	144	0	8584	0	8440	0.0	0.0
chr5	LINC01847	159866871	159867035	0	165	0	8584	0	8419	0.0	0.0
chr5	PWWP2A	160080650	160080770	0	121	51	4785	51	4664	0.0	0.010934819897084048
chr5	PWWP2A	160089505	160089610	0	106	51	4785	51	4679	0.0	0.010899764907031416
chr5	PWWP2A	160108544	160108614	0	71	51	4785	51	4714	0.0	0.010818837505303353
chr5	CCNJL	160261080	160261337	0	258	204	9249	204	8991	0.0	0.022689356022689355
chr5	CCNJL	160276268	160276412	0	145	204	9249	204	9104	0.0	0.02240773286467487
chr5	CCNJL	160254128	160254335	0	208	204	9249	204	9041	0.0	0.022563875677469307
chr5	CCNJL	160294727	160294963	0	237	204	9249	204	9012	0.0	0.022636484687083888
chr5	CCNJL	160274821	160274858	0	38	204	9249	204	9211	0.0	0.022147432417761372
chr5	ZBED8	160397441	160397515	0	75	0	2885	0	2810	0.0	0.0
chr5	SLU7	160417111	160417241	0	131	0	4786	0	4655	0.0	0.0
chr5	SLU7	160418595	160418685	0	91	0	4786	0	4695	0.0	0.0
chr5	ATP10B	160688759	160688943	0	185	0	9107	0	8922	0.0	0.0
chr5	ATP10B	160716908	160717034	0	127	0	9107	0	8980	0.0	0.0
chr5	GABRB2	161326367	161326481	0	115	102	17158	102	17043	0.0	0.005984861820102095
chr5	GABRB2	161459623	161459844	0	222	102	17158	102	16936	0.0	0.006022673594709494
chr5	GABRB2	161546321	161546413	0	93	102	17158	102	17065	0.0	0.0059771462056841486
chr5	GABRB2	161394720	161394761	0	42	102	17158	102	17116	0.0	0.005959336293526525
chr5	AC113414.1	162591609	162591685	0	77	255	8813	255	8736	0.0	0.02918956043956044
chr5	AC113414.1	162660101	162660225	51	125	255	8813	204	8688	0.408	0.023480662983425413
chr5	HMMR-AS1	163489250	163489383	0	134	5	960	5	826	0.0	0.006053268765133172
chr5	LINC01938	165241085	165241268	0	184	0	3198	0	3014	0.0	0.0
chr5	PANK3	168563888	168564065	0	178	3315	10356	3315	10178	0.0	0.3257024955786992
chr5	PANK3	168578633	168578707	0	75	3315	10356	3315	10281	0.0	0.322439451415232
chr5	LCP2	170266807	170266891	0	85	104	6844	104	6759	0.0	0.015386891552004735
chr5	FBXW11	171914342	171914405	0	64	2040	5539	2040	5475	0.0	0.3726027397260274
chr5	FBXW11	171957596	171957698	0	103	2040	5539	2040	5436	0.0	0.37527593818984545
chr5	FBXW11	171996889	171997051	0	163	2040	5539	2040	5376	0.0	0.3794642857142857
chr5	STK10	172107779	172107852	0	74	52569	8939	52569	8865	0.0	5.92994923857868
chr5	STK10	172045425	172045480	0	56	52569	8939	52569	8883	0.0	5.9179331306990886
chr5	SH3PXD2B	172356690	172356774	1161	85	94201	7913	93040	7828	13.658823529411764	11.885539090444558
chr5	BOD1	173609237	173609434	0	198	134	2259	134	2061	0.0	0.06501698204754973
chr5	BOD1	173613130	173613255	0	126	134	2259	134	2133	0.0	0.06282231598687295
chr5	LINC01484	173711845	173711948	0	104	0	5287	0	5183	0.0	0.0
chr5	LINC01484	173718840	173719543	0	704	0	5287	0	4583	0.0	0.0
chr5	AC113423.2	174084098	174084158	0	61	0	884	0	823	0.0	0.0
chr5	AC113423.2	174084098	174084290	0	193	0	884	0	691	0.0	0.0
chr5	THOC3	175961050	175961151	177	102	2681	2629	2504	2527	1.7352941176470589	0.9908982983775227
chr5	THOC3	175967110	175967267	468	158	2681	2629	2213	2471	2.962025316455696	0.8955888304330231
chr5	AC139491.6	176146088	176146207	0	120	0	2756	0	2636	0.0	0.0
chr5	AC139493.2	176174973	176175060	0	88	0	3034	0	2946	0.0	0.0
chr5	AC139493.2	176183230	176183301	0	72	0	3034	0	2962	0.0	0.0
chr5	AC139491.6	176146770	176146863	0	94	0	2756	0	2662	0.0	0.0
chr5	AC139493.2	176177647	176177945	0	299	0	3034	0	2735	0.0	0.0
chr5	KIAA1191	176359480	176359567	153	88	5348	3822	5195	3734	1.7386363636363635	1.391269416175683
chr5	KIAA1191	176359810	176359918	153	109	5348	3822	5195	3713	1.4036697247706422	1.3991381632103421
chr5	KIAA1191	176355570	176355749	74	180	5348	3822	5274	3642	0.4111111111111111	1.4481054365733115
chr5	KIAA1191	176359461	176359567	153	107	5348	3822	5195	3715	1.4299065420560748	1.398384925975774
chr5	KIAA1191	176357175	176357273	0	99	5348	3822	5348	3723	0.0	1.4364759602471124
chr5	CLTB	176396478	176396532	1000	55	4759	1831	3759	1776	18.181818181818183	2.116554054054054
chr5	CLTB	176406156	176406708	154	553	4759	1831	4605	1278	0.27848101265822783	3.603286384976526
chr5	SNCB	176626719	176626761	0	43	787	1869	787	1826	0.0	0.43099671412924423
chr5	SNCB	176629808	176629965	0	158	787	1869	787	1711	0.0	0.45996493278784334
chr5	UIMC1	176968554	176969291	2321	738	304354	3988	302033	3250	3.144986449864499	92.93323076923078
chr5	UIMC1	176969052	176969291	1456	240	304354	3988	302898	3748	6.066666666666666	80.81590181430096
chr5	UIMC1	177001416	177001501	0	86	304354	3988	304354	3902	0.0	77.99948744233727
chr5	UIMC1	177001997	177002111	0	115	304354	3988	304354	3873	0.0	78.58352698166796
chr5	RAB24	177302751	177302830	14348	80	84040	1931	69692	1851	179.35	37.65099945975149
chr5	MXD3	177310667	177310697	6411	31	524793	5032	518382	5001	206.80645161290323	103.65566886622675
chr5	F12	177404498	177404664	0	167	513	2581	513	2414	0.0	0.21251035625517814
chr5	DBN1	177472118	177472397	0	280	0	4984	0	4704	0.0	0.0
chr5	DBN1	177459602	177459740	0	139	0	4984	0	4845	0.0	0.0
chr5	PDLIM7	177489770	177489832	0	63	102	4294	102	4231	0.0	0.02410777593949421
chr5	PDLIM7	177491403	177491420	0	18	102	4294	102	4276	0.0	0.023854069223573433
chr5	PDLIM7	177491806	177491925	0	120	102	4294	102	4174	0.0	0.024436990896023
chr5	PDLIM7	177489770	177490031	0	262	102	4294	102	4032	0.0	0.025297619047619048
chr5	PDLIM7	177491806	177491976	0	171	102	4294	102	4123	0.0	0.02473926752364783
chr5	PDLIM7	177491806	177491995	0	190	102	4294	102	4104	0.0	0.024853801169590642
chr5	DOK3	177508236	177508542	0	307	119	4236	119	3929	0.0	0.030287604988546706
chr5	DOK3	177510542	177510581	0	40	119	4236	119	4196	0.0	0.028360343183984747
chr5	DDX41	177515684	177515821	0	138	225	3376	225	3238	0.0	0.06948733786287832
chr5	DDX41	177514172	177514288	0	117	225	3376	225	3259	0.0	0.06903958269407794
chr5	FAM193B	177523162	177523265	0	104	4817	5341	4817	5237	0.0	0.9198014130227229
chr5	FAM193B	177531952	177532200	0	249	4817	5341	4817	5092	0.0	0.9459937156323645
chr5	FAM193B	177552041	177552131	156	91	4817	5341	4661	5250	1.7142857142857142	0.8878095238095238
chr5	FAM193B	177531952	177532131	0	180	4817	5341	4817	5161	0.0	0.9333462507266034
chr5	FAM193B	177531281	177531521	0	241	4817	5341	4817	5100	0.0	0.9445098039215686
chr5	FAM193B	177523158	177523265	0	108	4817	5341	4817	5233	0.0	0.9205044907318938
chr5	FAM193B	177532155	177532200	0	46	4817	5341	4817	5295	0.0	0.9097261567516525
chr5	FAM193B	177547167	177547228	86	62	4817	5341	4731	5279	1.3870967741935485	0.8961924606933132
chr5	FAM153A	177763316	177763510	0	195	7931	8568	7931	8373	0.0	0.9472112743341694
chr5	FAM153A	177750908	177751052	0	145	7931	8568	7931	8423	0.0	0.9415885076576042
chr5	FAM153A	177767149	177767180	0	32	7931	8568	7931	8536	0.0	0.9291237113402062
chr5	FAM153A	177750958	177751052	0	95	7931	8568	7931	8473	0.0	0.9360321019709666
chr5	NHP2	178150887	178150993	0	107	602	1330	602	1223	0.0	0.4922322158626329
chr5	PHYKPL	178212972	178213103	0	132	0	7715	0	7583	0.0	0.0
chr5	PHYKPL	178215275	178215430	0	156	0	7715	0	7559	0.0	0.0
chr5	PHYKPL	178231404	178231523	0	120	0	7715	0	7595	0.0	0.0
chr5	PHYKPL	178229697	178229720	0	24	0	7715	0	7691	0.0	0.0
chr5	PHYKPL	178231668	178231866	0	199	0	7715	0	7516	0.0	0.0
chr5	PHYKPL	178223319	178223451	0	133	0	7715	0	7582	0.0	0.0
chr5	CLK4	178608375	178608458	29	84	27108	7054	27079	6970	0.34523809523809523	3.8850789096126257
chr5	CLK4	178617343	178617434	1020	92	27108	7054	26088	6962	11.08695652173913	3.74719908072393
chr5	CLK4	178619837	178619896	2036	60	27108	7054	25072	6994	33.93333333333333	3.5847869602516442
chr5	CLK4	178605824	178605865	0	42	27108	7054	27108	7012	0.0	3.8659440958357103
chr5	CLK4	178622392	178622459	1	68	27108	7054	27107	6986	0.014705882352941176	3.8801889493272257
chr5	CLK4	178619837	178620673	12271	837	27108	7054	14837	6217	14.660692951015532	2.3865208299823064
chr5	ZNF354A	178726074	178726227	0	154	642	2990	642	2836	0.0	0.22637517630465445
chr5	AACSP1	178768469	178768664	0	196	943	3397	943	3201	0.0	0.29459543892533585
chr5	HNRNPH1	179615545	179615595	0	51	276	5593	276	5542	0.0	0.049801515698303864
chr5	HNRNPH1	179617050	179617110	0	61	276	5593	276	5532	0.0	0.049891540130151846
chr5	HNRNPH1	179619268	179619407	0	140	276	5593	276	5453	0.0	0.05061434072987346
chr5	HNRNPH1	179620891	179621035	0	145	276	5593	276	5448	0.0	0.05066079295154185
chr5	HNRNPH1	179621241	179621397	0	157	276	5593	276	5436	0.0	0.05077262693156733
chr5	HNRNPH1	179617059	179617110	0	52	276	5593	276	5541	0.0	0.04981050351922036
chr5	HNRNPH1	179618144	179618323	0	180	276	5593	276	5413	0.0	0.05098836135230002
chr5	HNRNPH1	179619268	179619360	0	93	276	5593	276	5500	0.0	0.05018181818181818
chr5	HNRNPH1	179621842	179621976	0	135	276	5593	276	5458	0.0	0.050567973616709415
chr5	HNRNPH1	179621370	179621397	0	28	276	5593	276	5565	0.0	0.04959568733153639
chr5	HNRNPH1	179623977	179624115	0	139	276	5593	276	5454	0.0	0.050605060506050605
chr5	HNRNPH1	179624096	179624202	0	107	276	5593	276	5486	0.0	0.05030987969376595
chr5	MGAT4B	179801333	179801467	0	135	24	5408	24	5273	0.0	0.0045514887161008915
chr5	MGAT4B	179799202	179799250	0	49	24	5408	24	5359	0.0	0.004478447471543199
chr5	MRNIP	179844151	179844227	0	77	306	7454	306	7377	0.0	0.0414802765351769
chr5	MRNIP	179853196	179853276	0	81	306	7454	306	7373	0.0	0.04150278041502781
chr5	MRNIP	179847977	179848066	51	90	306	7454	255	7364	0.5666666666666667	0.0346279196089082
chr5	MRNIP	179851242	179851337	0	96	306	7454	306	7358	0.0	0.04158738787714053
chr5	MRNIP	179851242	179851424	153	183	306	7454	153	7271	0.8360655737704918	0.021042497593178378
chr5	TBC1D9B	179867444	179867495	0	52	2239	10501	2239	10449	0.0	0.2142788783615657
chr5	TBC1D9B	179899188	179899307	0	120	2239	10501	2239	10381	0.0	0.21568249686928043
chr5	RNF130	179963470	179963564	16	95	117488	12829	117472	12734	0.16842105263157894	9.225066750431914
chr5	RASGEF1C	180115246	180115284	0	39	6579	3032	6579	2993	0.0	2.1981289675910456
chr5	MAPK9	180279795	180280036	0	242	113356	8972	113356	8730	0.0	12.984650630011455
chr5	MAPK9	180247662	180247728	0	67	113356	8972	113356	8905	0.0	12.729477821448624
chr5	MAPK9	180286974	180287067	0	94	113356	8972	113356	8878	0.0	12.76819103401667
chr5	FLT4	180619020	180619109	322	90	28461	8776	28139	8686	3.577777777777778	3.2395809348376696
chr5	FLT4	180629258	180629427	0	170	28461	8776	28461	8606	0.0	3.3071113176853357
chr5	MGAT1	180808647	180809066	0	420	204	11216	204	10796	0.0	0.018895887365690995
chr5	MGAT1	180795837	180795875	0	39	204	11216	204	11177	0.0	0.018251767021562136
chr5	MGAT1	180795655	180795875	0	221	204	11216	204	10995	0.0	0.018553888130968622
chr5	ZFP62	180851987	180852060	0	74	0	3131	0	3057	0.0	0.0
chr5	OR2V1	181129519	181129575	0	57	0	2789	0	2732	0.0	0.0
chr5	RACK1	181237608	181237719	0	112	0	5102	0	4990	0.0	0.0
chr5	RACK1	181239066	181239177	0	112	0	5102	0	4990	0.0	0.0
chr5	RACK1	181241491	181241639	0	149	0	5102	0	4953	0.0	0.0
chr5	RACK1	181237224	181237319	0	96	0	5102	0	5006	0.0	0.0
chr5	RACK1	181238098	181238239	0	142	0	5102	0	4960	0.0	0.0
chr5	RACK1	181240215	181240327	0	113	0	5102	0	4989	0.0	0.0
chr5	RACK1	181240215	181240345	0	131	0	5102	0	4971	0.0	0.0
chr5	RACK1	181241491	181241563	0	73	0	5102	0	5029	0.0	0.0
chr5	RACK1	181243285	181243405	0	121	0	5102	0	4981	0.0	0.0
chr5	RACK1	181243253	181243405	0	153	0	5102	0	4949	0.0	0.0
chr6	DUSP22	311879	311962	3021	84	143861	4077	140840	3993	35.964285714285715	35.271725519659405
chr6	DUSP22	335113	335163	1291	51	143861	4077	142570	4026	25.313725490196077	35.412319920516644
chr6	DUSP22	304627	304661	1127	35	143861	4077	142734	4042	32.2	35.31271647699159
chr6	IRF4	393097	393368	0	272	1530	5891	1530	5619	0.0	0.27229044313934864
chr6	IRF4	406765	406899	0	135	1530	5891	1530	5756	0.0	0.2658095899930507
chr6	GMDS-DT	2398882	2399037	513	156	13598	21506	13085	21350	3.2884615384615383	0.6128805620608899
chr6	GMDS-DT	2263600	2263684	0	85	13598	21506	13598	21421	0.0	0.6347976284954017
chr6	GMDS-DT	2397220	2397626	357	407	13598	21506	13241	21099	0.8771498771498771	0.6275652874543817
chr6	GMDS-DT	2360543	2360630	51	88	13598	21506	13547	21418	0.5795454545454546	0.632505369315529
chr6	GMDS-DT	2398576	2398778	102	203	13598	21506	13496	21303	0.5024630541871922	0.6335257944890391
chr6	GMDS-DT	2398865	2399037	547	173	13598	21506	13051	21333	3.161849710982659	0.6117751839872498
chr6	GMDS-DT	2269697	2269799	255	103	13598	21506	13343	21403	2.4757281553398056	0.623417277951689
chr6	NQO2	3003668	3003789	0	122	169190	4556	169190	4434	0.0	38.1574199368516
chr6	NQO2	3015529	3015643	1121	115	169190	4556	168069	4441	9.747826086956522	37.84485476244089
chr6	NQO2	3002049	3002286	985	238	169190	4556	168205	4318	4.138655462184874	38.95437702640111
chr6	NQO2	3004494	3004651	255	158	169190	4556	168935	4398	1.6139240506329113	38.411778080945886
chr6	NQO2	3006815	3006935	0	121	169190	4556	169190	4435	0.0	38.14881623449831
chr6	RIPK1	3076763	3076987	108	225	459507	10181	459399	9956	0.48	46.14292888710325
chr6	RIPK1	3082546	3082660	82	115	459507	10181	459425	10066	0.7130434782608696	45.64126763361812
chr6	RIPK1	3064487	3064721	867	235	459507	10181	458640	9946	3.6893617021276595	46.113010255379045
chr6	RIPK1	3083084	3083313	2370	230	459507	10181	457137	9951	10.304347826086957	45.9388001205909
chr6	RIPK1	3080978	3081116	51	139	459507	10181	459456	10042	0.3669064748201439	45.753435570603465
chr6	RIPK1	3089580	3089657	816	78	459507	10181	458691	10103	10.461538461538462	45.401464911412454
chr6	RIPK1	3073638	3073802	194	165	459507	10181	459313	10016	1.1757575757575758	45.85792731629393
chr6	BPHL	3119284	3119512	512	229	135586	5789	135074	5560	2.2358078602620086	24.293884892086332
chr6	PSMG4	3263683	3263759	2241	77	205324	6322	203083	6245	29.103896103896105	32.51929543634908
chr6	PSMG4	3264208	3264325	459	118	205324	6322	204865	6204	3.889830508474576	33.02143778207608
chr6	PSMG4	3264173	3264325	466	153	205324	6322	204858	6169	3.045751633986928	33.20765115902091
chr6	PRPF4B	4062556	4062633	984	78	422403	7279	421419	7201	12.615384615384615	58.5222885710318
chr6	PRPF4B	4062556	4062760	5073	205	422403	7279	417330	7074	24.746341463414634	58.99491094147583
chr6	C6ORF201	4087348	4087726	0	379	212460	3267	212460	2888	0.0	73.56648199445983
chr6	CDYL	4733158	4733248	0	91	383791	4577	383791	4486	0.0	85.55305394560855
chr6	CDYL	4891712	4892379	149518	668	383791	4577	234273	3909	223.82934131736528	59.93169608595549
chr6	LYRM4-AS1	5022428	5022576	220	149	19581	4630	19361	4481	1.476510067114094	4.3206873465744255
chr6	LYRM4-AS1	5030772	5031022	0	251	19581	4630	19581	4379	0.0	4.471568851335921
chr6	LYRM4-AS1	5030748	5031022	0	275	19581	4630	19581	4355	0.0	4.496211251435132
chr6	LYRM4-AS1	5040629	5040687	0	59	19581	4630	19581	4571	0.0	4.283745351126668
chr6	LYRM4-AS1	5030804	5031022	0	219	19581	4630	19581	4411	0.0	4.439129449104511
chr6	FARS2	5272425	5272489	0	65	103889	4850	103889	4785	0.0	21.71138975966562
chr6	RREB1	7240437	7240602	357	166	284743	16690	284386	16524	2.1506024096385543	17.21048172355362
chr6	RREB1	7246423	7247221	18181	799	284743	16690	266562	15891	22.754693366708384	16.774400604115538
chr6	SNRNP48	7599672	7599680	90	9	383802	5846	383712	5837	10.0	65.73787904745589
chr6	AL355499.1	8260566	8260738	0	173	28666	4643	28666	4470	0.0	6.412975391498882
chr6	AL355499.1	8146509	8146599	0	91	28666	4643	28666	4552	0.0	6.297451669595782
chr6	AL355499.1	8302933	8303118	0	186	28666	4643	28666	4457	0.0	6.431680502580211
chr6	AL355499.1	8323530	8323636	0	107	28666	4643	28666	4536	0.0	6.319664902998237
chr6	HULC	8754785	8754892	0	108	13320	47611	13320	47503	0.0	0.2804033429467613
chr6	AL355499.1	8329654	8329923	0	270	28666	4643	28666	4373	0.0	6.555225245826664
chr6	AL355499.1	8328004	8328277	0	274	28666	4643	28666	4369	0.0	6.561226825360494
chr6	HULC	8558584	8558643	0	60	13320	47611	13320	47551	0.0	0.280120291897121
chr6	HULC	8577267	8577449	0	183	13320	47611	13320	47428	0.0	0.28084675718984564
chr6	HULC	8780248	8780367	0	120	13320	47611	13320	47491	0.0	0.2804741951106525
chr6	HULC	8547116	8547214	0	99	13320	47611	13320	47512	0.0	0.2803502273109951
chr6	HULC	8788821	8790434	2295	1614	13320	47611	11025	45997	1.4219330855018588	0.23968954497032416
chr6	HULC	8760376	8760495	0	120	13320	47611	13320	47491	0.0	0.2804741951106525
chr6	HULC	8788821	8788946	0	126	13320	47611	13320	47485	0.0	0.2805096346214594
chr6	HULC	8779886	8780007	0	122	13320	47611	13320	47489	0.0	0.2804860072858978
chr6	HULC	8759798	8759958	0	161	13320	47611	13320	47450	0.0	0.28071654373024235
chr6	HULC	8759837	8759958	0	122	13320	47611	13320	47489	0.0	0.2804860072858978
chr6	HULC	8788821	8788964	0	144	13320	47611	13320	47467	0.0	0.28061600691006383
chr6	HULC	8607007	8607168	0	162	13320	47611	13320	47449	0.0	0.2807224599043183
chr6	HULC	8469990	8470132	51	143	13320	47611	13269	47468	0.35664335664335667	0.27953568719979777
chr6	HULC	8932841	8932885	0	45	13320	47611	13320	47566	0.0	0.2800319555985368
chr6	HULC	8923685	8923832	0	148	13320	47611	13320	47463	0.0	0.28063965615321407
chr6	HULC	8831501	8831621	0	121	13320	47611	13320	47490	0.0	0.2804801010739103
chr6	HULC	9188865	9189035	0	171	13320	47611	13320	47440	0.0	0.28077571669477236
chr6	HULC	8925813	8925931	0	119	13320	47611	13320	47492	0.0	0.2804682893961088
chr6	HULC	8992164	8992294	0	131	13320	47611	13320	47480	0.0	0.2805391743892165
chr6	HULC	8858128	8858355	0	228	13320	47611	13320	47383	0.0	0.28111347951797055
chr6	HULC	8790271	8790434	316	164	13320	47611	13004	47447	1.9268292682926829	0.2740742301936898
chr6	HULC	8985729	8985847	0	119	13320	47611	13320	47492	0.0	0.2804682893961088
chr6	HULC	8789309	8789418	338	110	13320	47611	12982	47501	3.0727272727272728	0.2732995094840109
chr6	HULC	8959635	8959748	0	114	13320	47611	13320	47497	0.0	0.28043876455355077
chr6	HULC	9023270	9023324	0	55	13320	47611	13320	47556	0.0	0.2800908402725208
chr6	HULC	8751004	8751067	0	64	13320	47611	13320	47547	0.0	0.28014385765663447
chr6	HULC	8850838	8850951	0	114	13320	47611	13320	47497	0.0	0.28043876455355077
chr6	HULC	8855977	8856105	0	129	13320	47611	13320	47482	0.0	0.280527357735563
chr6	HULC	8960706	8960815	0	110	13320	47611	13320	47501	0.0	0.28041514915475463
chr6	HULC	8961458	8961564	0	107	13320	47611	13320	47504	0.0	0.2803974402155608
chr6	HULC	9092216	9092308	0	93	13320	47611	13320	47518	0.0	0.28031482806515423
chr6	HULC	8937390	8937480	0	91	13320	47611	13320	47520	0.0	0.2803030303030303
chr6	HULC	9092593	9092752	0	160	13320	47611	13320	47451	0.0	0.2807106278055257
chr6	HULC	9090879	9091071	0	193	13320	47611	13320	47418	0.0	0.28090598506896114
chr6	HULC	9090879	9091080	0	202	13320	47611	13320	47409	0.0	0.28095931152312853
chr6	HULC	9044261	9044392	0	132	13320	47611	13320	47479	0.0	0.2805450830893658
chr6	GCNT2	10509086	10509158	0	73	254611	8968	254611	8895	0.0	28.624058459808882
chr6	GCNT2	10528630	10528841	8939	212	254611	8968	245672	8756	42.16509433962264	28.057560529922338
chr6	GCNT2	10528630	10529836	65987	1207	254611	8968	188624	7761	54.67025683512842	24.304084525190053
chr6	TMEM14C	10724555	10724633	3126	79	1429159	1327	1426033	1248	39.56962025316456	1142.6546474358975
chr6	TMEM14C	10724569	10724633	2587	65	1429159	1327	1426572	1262	39.8	1130.405705229794
chr6	TMEM14C	10724960	10725037	1670	78	1429159	1327	1427489	1249	21.41025641025641	1142.9055244195356
chr6	TMEM14B	10751132	10751234	1600	103	1049659	4830	1048059	4727	15.533980582524272	221.71757986037656
chr6	TMEM14B	10749201	10749268	397	68	1049659	4830	1049262	4762	5.838235294117647	220.34061318773624
chr6	TMEM14B	10827696	10827824	816	129	1049659	4830	1048843	4701	6.325581395348837	223.11061476281643
chr6	SYCP2L	10910823	10910869	0	47	15940	3997	15940	3950	0.0	4.035443037974684
chr6	TMEM14B	10749621	10749698	649	78	1049659	4830	1049010	4752	8.320512820512821	220.75126262626262
chr6	TMEM14B	10755141	10755232	1963	92	1049659	4830	1047696	4738	21.33695652173913	221.126213592233
chr6	TMEM14B	10826563	10826612	348	50	1049659	4830	1049311	4780	6.96	219.52112970711298
chr6	SYCP2L	10922690	10922790	0	101	15940	3997	15940	3896	0.0	4.091375770020534
chr6	ELOVL2-AS1	11049108	11049219	0	112	5072	2521	5072	2409	0.0	2.1054379410543795
chr6	ELOVL2-AS1	11073454	11073545	26	92	5072	2521	5046	2429	0.2826086956521739	2.07739810621655
chr6	AL445430.1	11461284	11461467	0	184	10	1436	10	1252	0.0	0.007987220447284345
chr6	AL445430.1	11466431	11466605	10	175	10	1436	0	1261	0.05714285714285714	0.0
chr6	AL445430.2	11490312	11490464	0	153	0	1661	0	1508	0.0	0.0
chr6	HIVEP1	12129758	12129892	0	135	49160	11019	49160	10884	0.0	4.516721793458287
chr6	HIVEP1	12135790	12135892	0	103	49160	11019	49160	10916	0.0	4.503481128618541
chr6	HIVEP1	12020247	12020418	663	172	49160	11019	48497	10847	3.854651162790698	4.4710058080575275
chr6	PHACTR1	12717508	12717553	0	46	483	11593	483	11547	0.0	0.041829046505585867
chr6	PHACTR1	12717508	12717743	0	236	483	11593	483	11357	0.0	0.04252883684071498
chr6	PHACTR1	13184798	13185005	0	208	483	11593	483	11385	0.0	0.04242424242424243
chr6	SIRT5	13596962	13597016	0	55	109734	6538	109734	6483	0.0	16.926422952336882
chr6	SIRT5	13588330	13588464	120	135	109734	6538	109614	6403	0.8888888888888888	17.11916289239419
chr6	SIRT5	13584986	13585127	0	142	109734	6538	109734	6396	0.0	17.156660412757972
chr6	RNF182	13961479	13961562	0	84	490562	4104	490562	4020	0.0	122.03034825870647
chr6	RNF182	13974209	13974364	478	156	490562	4104	490084	3948	3.0641025641025643	124.13475177304964
chr6	MYLIP	16130556	16130747	0	192	9368	3079	9368	2887	0.0	3.244890890197437
chr6	RBM24	17290848	17290893	76	46	362966	3435	362890	3389	1.6521739130434783	107.07878430215403
chr6	CAP2	17462995	17463073	30	79	422021	3361	421991	3282	0.379746835443038	128.5773918342474
chr6	CAP2	17536237	17536341	180	105	422021	3361	421841	3256	1.7142857142857142	129.55804668304668
chr6	CAP2	17507168	17507312	0	145	422021	3361	422021	3216	0.0	131.2254353233831
chr6	CAP2	17493378	17493595	408	218	422021	3361	421613	3143	1.871559633027523	134.1434934775692
chr6	CDKAL1	20535086	20535199	1939	114	89164	4621	87225	4507	17.00877192982456	19.35322831151542
chr6	CASC15	22056545	22056690	0	146	0	32553	0	32407	0.0	0.0
chr6	CASC15	22110746	22110920	0	175	0	32553	0	32378	0.0	0.0
chr6	CASC15	22191566	22191656	0	91	0	32553	0	32462	0.0	0.0
chr6	CASC15	21978944	21979062	0	119	0	32553	0	32434	0.0	0.0
chr6	CASC15	22020338	22020542	0	205	0	32553	0	32348	0.0	0.0
chr6	CASC15	22110746	22110818	0	73	0	32553	0	32480	0.0	0.0
chr6	CASC15	21802656	21802740	0	85	0	32553	0	32468	0.0	0.0
chr6	CASC15	22173997	22174062	0	66	0	32553	0	32487	0.0	0.0
chr6	CASC15	22113916	22114037	0	122	0	32553	0	32431	0.0	0.0
chr6	CASC15	22063019	22063240	0	222	0	32553	0	32331	0.0	0.0
chr6	CASC15	21999070	21999212	0	143	0	32553	0	32410	0.0	0.0
chr6	CASC15	21909469	21909603	0	135	0	32553	0	32418	0.0	0.0
chr6	CASC15	22083582	22083718	0	137	0	32553	0	32416	0.0	0.0
chr6	CASC15	22043630	22043894	0	265	0	32553	0	32288	0.0	0.0
chr6	CASC15	22051477	22051590	0	114	0	32553	0	32439	0.0	0.0
chr6	CASC15	21977321	21977530	0	210	0	32553	0	32343	0.0	0.0
chr6	CASC15	21977777	21977927	0	151	0	32553	0	32402	0.0	0.0
chr6	CASC15	22181322	22181475	0	154	0	32553	0	32399	0.0	0.0
chr6	CASC15	22036830	22036941	0	112	0	32553	0	32441	0.0	0.0
chr6	CASC15	21915208	21915238	0	31	0	32553	0	32522	0.0	0.0
chr6	CASC15	21977777	21977953	0	177	0	32553	0	32376	0.0	0.0
chr6	CASC15	21905544	21905605	0	62	0	32553	0	32491	0.0	0.0
chr6	CASC15	22142900	22142951	0	52	0	32553	0	32501	0.0	0.0
chr6	CASC15	22088566	22088783	0	218	0	32553	0	32335	0.0	0.0
chr6	CASC15	22043646	22043894	0	249	0	32553	0	32304	0.0	0.0
chr6	CASC15	22029424	22029562	0	139	0	32553	0	32414	0.0	0.0
chr6	CASC15	21900914	21901180	0	267	0	32553	0	32286	0.0	0.0
chr6	CASC15	22181664	22181762	0	99	0	32553	0	32454	0.0	0.0
chr6	CASC15	22194044	22194446	0	403	0	32553	0	32150	0.0	0.0
chr6	CASC15	22214306	22215702	0	1397	0	32553	0	31156	0.0	0.0
chr6	MRS2	24409460	24409573	0	114	216837	5145	216837	5031	0.0	43.10017889087656
chr6	MRS2	24408407	24408444	0	38	216837	5145	216837	5107	0.0	42.45878206383395
chr6	ALDH5A1	24515166	24515310	0	145	36420	7575	36420	7430	0.0	4.901749663526245
chr6	ALDH5A1	24502522	24502606	0	85	36420	7575	36420	7490	0.0	4.862483311081442
chr6	ALDH5A1	24511829	24511868	0	40	36420	7575	36420	7535	0.0	4.8334439283344395
chr6	ALDH5A1	24515124	24515310	0	187	36420	7575	36420	7388	0.0	4.929615592853276
chr6	ALDH5A1	24502522	24502763	66	242	36420	7575	36354	7333	0.2727272727272727	4.957588981317333
chr6	ACOT13	24687404	24687693	0	290	214164	4398	214164	4108	0.0	52.1333982473223
chr6	LINC02828	24748995	24749148	0	154	153	868	153	714	0.0	0.21428571428571427
chr6	CARMIL1	25507478	25507490	0	13	55383	6896	55383	6883	0.0	8.046346070027605
chr6	CARMIL1	25576975	25576993	0	19	55383	6896	55383	6877	0.0	8.053366293441908
chr6	CARMIL1	25612739	25612886	0	148	55383	6896	55383	6748	0.0	8.207320687611144
chr6	SCGN	25681950	25682006	0	57	0	1493	0	1436	0.0	0.0
chr6	SCGN	25653381	25653452	0	72	0	1493	0	1421	0.0	0.0
chr6	SLC17A4	25768335	25768435	0	101	0	4570	0	4469	0.0	0.0
chr6	U91328.1	25993996	25994142	0	147	67482	3639	67482	3492	0.0	19.324742268041238
chr6	U91328.1	25993168	25993236	0	69	67482	3639	67482	3570	0.0	18.90252100840336
chr6	HFE	26092684	26092960	2791	277	156147	5638	153356	5361	10.07581227436823	28.605857116209663
chr6	HFE	26090909	26091104	2083	196	156147	5638	154064	5442	10.627551020408163	28.31018008085263
chr6	HFE	26091313	26091589	3689	277	156147	5638	152458	5361	13.31768953068592	28.43835105390785
chr6	HFE	26090840	26091104	2187	265	156147	5638	153960	5373	8.252830188679246	28.65438302624232
chr6	HFE	26092608	26092641	364	34	156147	5638	155783	5604	10.705882352941176	27.79853675945753
chr6	HFE	26094185	26094218	34	34	156147	5638	156113	5604	1.0	27.857423269093506
chr6	BTN3A2	26367989	26368050	153	62	120376	5358	120223	5296	2.467741935483871	22.70071752265861
chr6	BTN3A2	26370321	26370603	2921	283	120376	5358	117455	5075	10.321554770318022	23.14384236453202
chr6	BTN3A2	26372896	26373097	2912	202	120376	5358	117464	5156	14.415841584158416	22.78200155159038
chr6	BTN3A2	26368177	26368267	1377	91	120376	5358	118999	5267	15.131868131868131	22.593316878678564
chr6	BTN3A2	26368182	26368267	1377	86	120376	5358	118999	5272	16.011627906976745	22.57188922610015
chr6	BTN3A2	26368564	26368608	84	45	120376	5358	120292	5313	1.8666666666666667	22.641069075851686
chr6	BTN2A2	26385014	26385362	5855	349	147022	4365	141167	4016	16.77650429799427	35.15114541832669
chr6	BTN2A2	26388012	26388294	5872	283	147022	4365	141150	4082	20.749116607773853	34.578637922586964
chr6	BTN2A2	26383791	26383915	13	125	147022	4365	147009	4240	0.104	34.67193396226415
chr6	BTN2A2	26385142	26385362	5519	221	147022	4365	141503	4144	24.97285067873303	34.146476833976834
chr6	BTN3A1	26404134	26404227	0	94	101324	4719	101324	4625	0.0	21.907891891891893
chr6	BTN2A3P	26427870	26428107	522	238	79889	4185	79367	3947	2.19327731092437	20.108183430453508
chr6	BTN2A3P	26423398	26423759	7722	362	79889	4185	72167	3823	21.331491712707184	18.877059900601623
chr6	BTN3A3	26443569	26443659	709	91	34789	3974	34080	3883	7.791208791208791	8.776719031676539
chr6	BTN3A3	26443381	26443442	0	62	34789	3974	34789	3912	0.0	8.892893660531698
chr6	BTN3A3	26443640	26443659	314	20	34789	3974	34475	3954	15.7	8.719018715225088
chr6	BTN3A3	26448616	26448637	493	22	34789	3974	34296	3952	22.40909090909091	8.678137651821862
chr6	BTN3A3	26443366	26443442	0	77	34789	3974	34789	3897	0.0	8.927123428278163
chr6	BTN2A1	26458606	26458718	716	113	418419	3758	417703	3645	6.336283185840708	114.59615912208506
chr6	BTN2A1	26462796	26462897	497	102	418419	3758	417922	3656	4.872549019607843	114.31126914660831
chr6	PRSS16	27248846	27248946	0	101	149	3595	149	3494	0.0	0.04264453348597596
chr6	PRSS16	27254692	27254872	0	181	149	3595	149	3414	0.0	0.04364381956649092
chr6	PRSS16	27252807	27252949	47	143	149	3595	102	3452	0.32867132867132864	0.02954808806488992
chr6	PRSS16	27251749	27252040	9	292	149	3595	140	3303	0.030821917808219176	0.04238570996064184
chr6	PRSS16	27249099	27249229	0	131	149	3595	149	3464	0.0	0.04301385681293302
chr6	PRSS16	27251041	27251119	0	79	149	3595	149	3516	0.0	0.042377701934015924
chr6	PRSS16	27250682	27250806	0	125	149	3595	149	3470	0.0	0.042939481268011524
chr6	ZNF391	27395016	27395095	0	80	1734	4840	1734	4760	0.0	0.36428571428571427
chr6	LINC01012	27710123	27710225	0	103	51	3778	51	3675	0.0	0.013877551020408163
chr6	LINC01012	27707338	27707416	0	79	51	3778	51	3699	0.0	0.013787510137875101
chr6	ZKSCAN8	28144330	28144424	0	95	0	7588	0	7493	0.0	0.0
chr6	ZNF192P1	28162942	28163100	0	159	0	2377	0	2218	0.0	0.0
chr6	ZSCAN9	28230335	28230488	0	154	204	3599	204	3445	0.0	0.059216255442670535
chr6	ZSCAN9	28230401	28230488	0	88	204	3599	204	3511	0.0	0.05810310452862432
chr6	ZKSCAN3	28359524	28359988	0	465	4506	4811	4506	4346	0.0	1.0368154624942476
chr6	ZKSCAN3	28350271	28350388	2846	118	4506	4811	1660	4693	24.11864406779661	0.353718303856808
chr6	GPX5	28531777	28531895	0	119	51	2056	51	1937	0.0	0.02632937532266391
chr6	OR2J3	29109455	29109657	0	203	0	3825	0	3622	0.0	0.0
chr6	MOG	29659323	29659666	0	344	0	2643	0	2299	0.0	0.0
chr6	MOG	29670280	29670397	0	118	0	2643	0	2525	0.0	0.0
chr6	MOG	29659318	29659666	0	349	0	2643	0	2294	0.0	0.0
chr6	MOG	29666151	29666265	0	115	0	2643	0	2528	0.0	0.0
chr6	MOG	29670173	29670221	0	49	0	2643	0	2594	0.0	0.0
chr6	MOG	29670700	29670721	0	22	0	2643	0	2621	0.0	0.0
chr6	MOG	29664629	29664767	0	139	0	2643	0	2504	0.0	0.0
chr6	HLA-F	29725030	29725306	0	277	0	3641	0	3364	0.0	0.0
chr6	HLA-G	29828542	29828818	0	277	0	1771	0	1494	0.0	0.0
chr6	HLA-G	29829417	29829693	0	277	0	1771	0	1494	0.0	0.0
chr6	HLA-G	29830552	29830600	0	49	0	1771	0	1722	0.0	0.0
chr6	HLA-A	29944499	29944616	0	118	0	2718	0	2600	0.0	0.0
chr6	HLA-A	29944499	29944634	0	136	0	2718	0	2582	0.0	0.0
chr6	HLA-J	30006799	30007069	0	271	51	1955	51	1684	0.0	0.030285035629453682
chr6	HLA-J	30008584	30008701	0	118	51	1955	51	1837	0.0	0.027762656505171474
chr6	HLA-J	30009319	30009367	0	49	51	1955	51	1906	0.0	0.026757607555089193
chr6	HLA-J	30007317	30007593	0	277	51	1955	51	1678	0.0	0.030393325387365912
chr6	POLR1H	30061916	30062017	0	102	0	1070	0	968	0.0	0.0
chr6	PPP1R11	30068278	30068353	0	76	0	2327	0	2251	0.0	0.0
chr6	TRIM39	30327651	30327696	0	46	51	4237	51	4191	0.0	0.012168933428775949
chr6	TRIM39	30340271	30340361	0	91	51	4237	51	4146	0.0	0.012301013024602027
chr6	TRIM39	30327646	30327696	0	51	51	4237	51	4186	0.0	0.012183468705207836
chr6	RPP21	30345490	30345573	0	84	51	1107	51	1023	0.0	0.04985337243401759
chr6	RPP21	30345466	30345573	0	108	51	1107	51	999	0.0	0.05105105105105105
chr6	RPP21	30345297	30345398	0	102	51	1107	51	1005	0.0	0.050746268656716415
chr6	PRR3	30558149	30558212	2076	64	89124	2594	87048	2530	32.4375	34.40632411067194
chr6	ABCF1	30577408	30577455	0	48	254724	4261	254724	4213	0.0	60.461428910515075
chr6	ABCF1	30582393	30582507	228	115	254724	4261	254496	4146	1.982608695652174	61.383502170767
chr6	ATAT1	30640534	30640603	17458	70	689283	3818	671825	3748	249.4	179.24893276414087
chr6	ATAT1	30642767	30643011	0	245	689283	3818	689283	3573	0.0	192.91435768261965
chr6	C6ORF136	30649750	30649959	9020	210	225863	2035	216843	1825	42.95238095238095	118.81808219178082
chr6	C6ORF136	30652647	30652717	11146	71	225863	2035	214717	1964	156.98591549295776	109.32637474541751
chr6	C6ORF136	30649557	30649959	15073	403	225863	2035	210790	1632	37.40198511166253	129.16053921568627
chr6	C6ORF136	30650993	30651082	1712	90	225863	2035	224151	1945	19.022222222222222	115.24473007712082
chr6	C6ORF136	30647605	30647846	1073	242	225863	2035	224790	1793	4.433884297520661	125.37088678192973
chr6	C6ORF136	30652647	30652728	16684	82	225863	2035	209179	1953	203.46341463414635	107.10650281618024
chr6	HCG20	30790888	30790956	37	69	240	1580	203	1511	0.5362318840579711	0.1343481138318994
chr6	DDR1	30880897	30881125	26525	229	133998	8326	107473	8097	115.82969432314411	13.273187600345807
chr6	DDR1	30891379	30891479	503	101	133998	8326	133495	8225	4.98019801980198	16.230395136778114
chr6	DDR1	30884537	30884710	3509	174	133998	8326	130489	8152	20.166666666666668	16.00699214916585
chr6	DDR1	30885624	30885680	145	57	133998	8326	133853	8269	2.543859649122807	16.187326157939292
chr6	DDR1	30895403	30895514	662	112	133998	8326	133336	8214	5.910714285714286	16.232773313854395
chr6	DDR1	30881926	30881993	0	68	133998	8326	133998	8258	0.0	16.226447081617824
chr6	DDR1	30896620	30896865	0	246	133998	8326	133998	8080	0.0	16.583910891089108
chr6	DDR1	30883263	30883326	350	64	133998	8326	133648	8262	5.46875	16.176228516097797
chr6	DDR1	30884057	30884145	0	89	133998	8326	133998	8237	0.0	16.26781595240986
chr6	VARS2	30921924	30921995	0	72	0	6416	0	6344	0.0	0.0
chr6	VARS2	30914809	30915037	0	229	0	6416	0	6187	0.0	0.0
chr6	VARS2	30914804	30915037	0	234	0	6416	0	6182	0.0	0.0
chr6	PSORS1C1	31138655	31138779	949	125	252421	3835	251472	3710	7.592	67.7822102425876
chr6	PSORS1C1	31125738	31125839	0	102	252421	3835	252421	3733	0.0	67.6188052504688
chr6	MICA	31411243	31411359	0	117	1194	3859	1194	3742	0.0	0.3190807055050775
chr6	MICA	31411071	31411359	0	289	1194	3859	1194	3570	0.0	0.334453781512605
chr6	HCP5	31463370	31463508	255	139	455259	10617	455004	10478	1.8345323741007193	43.4246993701088
chr6	NFKBIL1	31556696	31556783	0	88	537	1758	537	1670	0.0	0.3215568862275449
chr6	LST1	31587943	31587966	24	24	39635	1224	39611	1200	1.0	33.009166666666665
chr6	LST1	31587640	31587733	570	94	39635	1224	39065	1130	6.0638297872340425	34.57079646017699
chr6	LST1	31587948	31587966	19	19	39635	1224	39616	1205	1.0	32.87634854771784
chr6	CSNK2B	31669318	31669508	206	191	52186	2558	51980	2367	1.0785340314136125	21.9602872834812
chr6	AL662899.2	31670972	31671008	2905	37	13215	2533	10310	2496	78.51351351351352	4.1306089743589745
chr6	MPIG6B	31724141	31724232	3471	92	131259	2943	127788	2851	37.72826086956522	44.82216766047001
chr6	MPIG6B	31724586	31724627	1031	42	131259	2943	130228	2901	24.547619047619047	44.890727335401586
chr6	MSH5	31745236	31745319	5129	84	350463	5859	345334	5775	61.05952380952381	59.798095238095236
chr6	MSH5	31758547	31758620	132	74	350463	5859	350331	5785	1.7837837837837838	60.55851339671565
chr6	MSH5	31760689	31760839	39253	151	350463	5859	311210	5708	259.95364238410593	54.52172389628591
chr6	MSH5	31740193	31740220	0	28	350463	5859	350463	5831	0.0	60.1034127936889
chr6	MSH5-SAPCD1	31764265	31764355	0	91	289079	3610	289079	3519	0.0	82.14805342426826
chr6	MSH5	31760787	31760839	19520	53	350463	5859	330943	5806	368.3018867924528	57.00017223561833
chr6	MSH5	31758532	31758620	432	89	350463	5859	350031	5770	4.853932584269663	60.66395147313691
chr6	MSH5-SAPCD1	31762789	31763168	21420	380	289079	3610	267659	3230	56.36842105263158	82.86656346749226
chr6	MSH5	31761749	31761780	0	32	350463	5859	350463	5827	0.0	60.144671357473825
chr6	SNHG32	31835410	31835451	0	42	0	1649	0	1607	0.0	0.0
chr6	SNHG32	31836423	31836517	0	95	0	1649	0	1554	0.0	0.0
chr6	SNHG32	31836298	31836517	0	220	0	1649	0	1429	0.0	0.0
chr6	SNHG32	31835410	31835455	0	46	0	1649	0	1603	0.0	0.0
chr6	SNHG32	31836294	31836517	0	224	0	1649	0	1425	0.0	0.0
chr6	C2	31942958	31943099	0	142	622662	5539	622662	5397	0.0	115.37187326292384
chr6	C2	31944979	31945029	0	51	622662	5539	622662	5488	0.0	113.45881924198251
chr6	C2	31933866	31933965	0	100	622662	5539	622662	5439	0.0	114.48097076668505
chr6	C2	31935922	31936061	645	140	622662	5539	622017	5399	4.607142857142857	115.2096684571217
chr6	C2	31934165	31934299	0	135	622662	5539	622662	5404	0.0	115.22242783123612
chr6	C2	31927954	31928164	80093	211	622662	5539	542569	5328	379.5876777251185	101.83352102102103
chr6	C2	31928731	31928917	19496	187	622662	5539	603166	5352	104.2566844919786	112.699177877429
chr6	C2	31942914	31943099	0	186	622662	5539	622662	5353	0.0	116.3201942835793
chr6	SKIV2L	31961195	31961386	227	192	4370	4787	4143	4595	1.1822916666666667	0.9016322089227421
chr6	STK19	31972620	31972757	54	138	3796	3774	3742	3636	0.391304347826087	1.029152915291529
chr6	STK19	31979413	31979553	0	141	3796	3774	3796	3633	0.0	1.0448665015139003
chr6	C4B	32033789	32033892	0	104	45	6663	45	6559	0.0	0.0068608019515169994
chr6	CYP21A2	32038721	32038811	0	91	0	2688	0	2597	0.0	0.0
chr6	CYP21A2	32040004	32040205	0	202	0	2688	0	2486	0.0	0.0
chr6	PPT2	32154195	32154404	9619	210	158171	2809	148552	2599	45.804761904761904	57.15736821854559
chr6	PPT2	32155029	32155183	66586	155	158171	2809	91585	2654	429.5870967741935	34.508289374529014
chr6	PPT2	32157839	32157924	51	86	158171	2809	158120	2723	0.5930232558139535	58.068307014322436
chr6	PPT2	32153998	32154404	30461	407	158171	2809	127710	2402	74.84275184275184	53.16819317235637
chr6	PPT2-EGFL8	32164578	32164657	0	80	174403	5532	174403	5452	0.0	31.98881144534116
chr6	PPT2-EGFL8	32164578	32164681	0	104	174403	5532	174403	5428	0.0	32.13025055268976
chr6	TSBP1-AS1	32389268	32389421	0	154	153	8215	153	8061	0.0	0.018980275400074433
chr6	TSBP1-AS1	32365779	32365839	0	61	153	8215	153	8154	0.0	0.018763796909492272
chr6	TSBP1-AS1	32262611	32262809	0	199	153	8215	153	8016	0.0	0.01908682634730539
chr6	TSBP1-AS1	32349511	32349997	0	487	153	8215	153	7728	0.0	0.019798136645962732
chr6	HLA-DQA1	32642609	32642784	0	176	51	6330	51	6154	0.0	0.008287292817679558
chr6	HLA-DQA1	32638911	32639905	51	995	51	6330	0	5335	0.05125628140703518	0.0
chr6	AL662789.1	32718405	32718440	0	36	0	1019	0	983	0.0	0.0
chr6	PSMB8-AS1	32844644	32844870	0	227	160	1878	160	1651	0.0	0.09691096305269534
chr6	PSMB8-AS1	32844569	32844870	0	302	160	1878	160	1576	0.0	0.10152284263959391
chr6	PSMB8-AS1	32844809	32844870	0	62	160	1878	160	1816	0.0	0.0881057268722467
chr6	BRD2	32975020	32975112	0	93	0	7303	0	7210	0.0	0.0
chr6	BRD2	32971594	32972927	0	1334	0	7303	0	5969	0.0	0.0
chr6	BRD2	32979089	32979194	0	106	0	7303	0	7197	0.0	0.0
chr6	SLC39A7	33201241	33201656	153	416	153	2852	0	2436	0.36778846153846156	0.0
chr6	KIFC1	33400391	33400514	10314	124	107235	3042	96921	2918	83.1774193548387	33.21487320082248
chr6	PHF1	33415234	33415329	1485	96	141982	3035	140497	2939	15.46875	47.80435522286492
chr6	SYNGAP1	33442452	33442494	0	43	38016	8100	38016	8057	0.0	4.71838153158744
chr6	SYNGAP1	33448788	33448868	0	81	38016	8100	38016	8019	0.0	4.7407407407407405
chr6	HMGA1	34237203	34237317	176	115	2286	2333	2110	2218	1.5304347826086957	0.951307484220018
chr6	AL354740.1	34277907	34278182	50	276	93920	6489	93870	6213	0.18115942028985507	15.108643167551907
chr6	SNRPC	34757911	34757954	0	44	204	1248	204	1204	0.0	0.16943521594684385
chr6	ANKS1A	34972580	34972643	0	64	46898	8524	46898	8460	0.0	5.543498817966903
chr6	ANKS1A	35086269	35086368	0	100	46898	8524	46898	8424	0.0	5.56718898385565
chr6	ZNF76	35293750	35293915	0	166	43099	6025	43099	5859	0.0	7.3560334528076465
chr6	PPARD	35410986	35411217	0	232	50663	4466	50663	4234	0.0	11.965753424657533
chr6	PPARD	35397497	35397593	0	97	50663	4466	50663	4369	0.0	11.596017395284962
chr6	FANCE	35463847	35463980	0	134	1420	2720	1420	2586	0.0	0.5491105955143079
chr6	CLPSL2	35777458	35777581	0	124	0	611	0	487	0.0	0.0
chr6	CLPSL2	35777850	35777929	0	80	0	611	0	531	0.0	0.0
chr6	MAPK14	36102570	36102649	0	80	62677	6770	62677	6690	0.0	9.368759342301944
chr6	BRPF3	36222167	36222265	0	99	42930	6627	42930	6528	0.0	6.576286764705882
chr6	BRPF3	36225266	36225364	0	99	42930	6627	42930	6528	0.0	6.576286764705882
chr6	BRPF3	36225270	36225364	0	95	42930	6627	42930	6532	0.0	6.572259644825475
chr6	KCTD20	36479590	36479711	29	122	80401	6251	80372	6129	0.23770491803278687	13.113395333659652
chr6	KCTD20	36474788	36475062	0	275	80401	6251	80401	5976	0.0	13.453982597054885
chr6	KCTD20	36465600	36465698	16946	99	80401	6251	63455	6152	171.17171717171718	10.314531859557867
chr6	KCTD20	36443417	36443530	98	114	80401	6251	80303	6137	0.8596491228070176	13.085057845853022
chr6	KCTD20	36479120	36479223	0	104	80401	6251	80401	6147	0.0	13.079713681470636
chr6	KCTD20	36470051	36470257	3417	207	80401	6251	76984	6044	16.507246376811594	12.737260092653871
chr6	SRSF3	36598428	36598526	0	99	0	6059	0	5960	0.0	0.0
chr6	SRSF3	36599820	36600276	0	457	0	6059	0	5602	0.0	0.0
chr6	CDKN1A	36677901	36677933	0	33	0	3000	0	2967	0.0	0.0
chr6	CDKN1A	36682639	36682730	0	92	0	3000	0	2908	0.0	0.0
chr6	C6ORF89	36892765	36892856	10034	92	18380	7343	8346	7251	109.06521739130434	1.1510136532892015
chr6	C6ORF89	36894503	36894603	7355	101	18380	7343	11025	7242	72.82178217821782	1.5223695111847555
chr6	RNF8	37359182	37359342	1573	161	6644	6384	5071	6223	9.770186335403727	0.8148802828217901
chr6	RNF8	37374619	37374709	0	91	6644	6384	6644	6293	0.0	1.0557762593357698
chr6	RNF8	37381149	37381354	0	206	6644	6384	6644	6178	0.0	1.0754289414049854
chr6	RNF8	37361337	37361558	0	222	6644	6384	6644	6162	0.0	1.0782213567023693
chr6	ZFAND3	38082391	38082457	0	67	3844	3819	3844	3752	0.0	1.0245202558635393
chr6	ZFAND3	38003690	38003783	0	94	3844	3819	3844	3725	0.0	1.0319463087248322
chr6	DNAH8	38729901	38729986	0	86	518	15442	518	15356	0.0	0.03373274290179734
chr6	DNAH8	38866768	38866876	0	109	518	15442	518	15333	0.0	0.0337833431161547
chr6	DAAM2	39886420	39886447	0	28	5576	11330	5576	11302	0.0	0.4933640063705539
chr6	DAAM2	39861122	39861328	0	207	5576	11330	5576	11123	0.0	0.5013036051424975
chr6	TSPO2	41043556	41043698	0	143	1772	1079	1772	936	0.0	1.893162393162393
chr6	NFYA	41080810	41080897	0	88	460	3821	460	3733	0.0	0.12322528797214037
chr6	ADCY10P1	41105891	41106035	0	145	2867	5583	2867	5438	0.0	0.5272158881941891
chr6	TREML4	41232362	41232504	0	143	0	2699	0	2556	0.0	0.0
chr6	NCR2	41342917	41343024	0	108	152	1274	152	1166	0.0	0.13036020583190394
chr6	LINC01276	41506224	41506371	115	148	3297	2076	3182	1928	0.777027027027027	1.650414937759336
chr6	MDFI	41646125	41646308	0	184	2722	2542	2722	2358	0.0	1.1543681085665818
chr6	MDFI	41638139	41638375	0	237	2722	2542	2722	2305	0.0	1.1809110629067245
chr6	BYSL	41930131	41930270	0	140	102	1944	102	1804	0.0	0.0565410199556541
chr6	TAF8	42071346	42071468	0	123	3852	9297	3852	9174	0.0	0.4198822759973839
chr6	AL096814.2	42162919	42163095	102	177	105783	2281	105681	2104	0.576271186440678	50.22861216730038
chr6	AL096814.2	42162919	42163466	102	548	105783	2281	105681	1733	0.18613138686131386	60.98153491055972
chr6	RPL7L1	42880860	42880966	0	107	204	7235	204	7128	0.0	0.02861952861952862
chr6	PTCRA	42923026	42923347	51	322	573948	1176	573897	854	0.15838509316770186	672.0105386416861
chr6	PPP2R5D	43008692	43008746	3499	55	104526	3567	101027	3512	63.61818181818182	28.76623006833713
chr6	KLHDC3	43017852	43017968	7756	117	76300	1665	68544	1548	66.2905982905983	44.27906976744186
chr6	KLC4	43062885	43063147	0	263	8006	5760	8006	5497	0.0	1.4564307804256866
chr6	KLC4	43071566	43071619	63	54	8006	5760	7943	5706	1.1666666666666667	1.392043463021381
chr6	KLC4	43071851	43071922	0	72	8006	5760	8006	5688	0.0	1.4075246132208157
chr6	KLC4	43061310	43061593	25	284	8006	5760	7981	5476	0.0880281690140845	1.4574506939371805
chr6	KLC4	43062916	43063147	0	232	8006	5760	8006	5528	0.0	1.4482633863965269
chr6	KLC4	43062982	43063147	0	166	8006	5760	8006	5594	0.0	1.4311762602788702
chr6	PTK7	43130229	43130420	0	192	574235	8336	574235	8144	0.0	70.51019155206286
chr6	PTK7	43139405	43139525	1409	121	574235	8336	572826	8215	11.644628099173554	69.72927571515521
chr6	PTK7	43145199	43145432	0	234	574235	8336	574235	8102	0.0	70.87570970130832
chr6	CUL9	43187245	43187439	4119	195	38655	10593	34536	10398	21.123076923076923	3.321407963069821
chr6	CUL9	43206320	43206510	0	191	38655	10593	38655	10402	0.0	3.716112286098827
chr6	SLC22A7	43299091	43299097	14	7	87740	3540	87726	3533	2.0	24.83045570336824
chr6	SLC22A7	43299091	43299274	96	184	87740	3540	87644	3356	0.5217391304347826	26.115613825983313
chr6	TJAP1	43478658	43478718	0	61	236395	6659	236395	6598	0.0	35.828281297362835
chr6	TJAP1	43478086	43478232	0	147	236395	6659	236395	6512	0.0	36.30144348894349
chr6	TJAP1	43502587	43502617	184	31	236395	6659	236211	6628	5.935483870967742	35.63835244417622
chr6	TJAP1	43478136	43478232	0	97	236395	6659	236395	6562	0.0	36.0248399878086
chr6	POLR1C	43520065	43520185	0	121	107381	5100	107381	4979	0.0	21.566780478007633
chr6	POLR1C	43520624	43520774	249	151	107381	5100	107132	4949	1.6490066225165563	21.64720145483936
chr6	POLR1C	43521181	43521317	30343	137	107381	5100	77038	4963	221.4817518248175	15.522466250251863
chr6	POLR1C	43529248	43529359	0	112	107381	5100	107381	4988	0.0	21.527866880513233
chr6	POLR1C	43550967	43551011	0	45	107381	5100	107381	5055	0.0	21.242532146389713
chr6	POLH	43582315	43582456	26749	142	48918	8308	22169	8166	188.3732394366197	2.7147930443301496
chr6	RSPH9	43666423	43666520	0	98	51	2648	51	2550	0.0	0.02
chr6	VEGFA	43781955	43782087	0	133	0	7921	0	7788	0.0	0.0
chr6	VEGFA	43781955	43782052	0	98	0	7921	0	7823	0.0	0.0
chr6	VEGFA	43780731	43780785	0	55	0	7921	0	7866	0.0	0.0
chr6	VEGFA	43780731	43780854	0	124	0	7921	0	7797	0.0	0.0
chr6	VEGFA	43780731	43780803	0	73	0	7921	0	7848	0.0	0.0
chr6	VEGFA	43778888	43778918	0	31	0	7921	0	7890	0.0	0.0
chr6	C6ORF223	44001016	44001143	0	128	2091	5569	2091	5441	0.0	0.38430435581694544
chr6	C6ORF223	44000973	44001143	0	171	2091	5569	2091	5398	0.0	0.38736569099666546
chr6	TMEM63B	44135327	44135366	0	40	102	4452	102	4412	0.0	0.023118766999093383
chr6	TMEM63B	44154072	44154188	0	117	102	4452	102	4335	0.0	0.023529411764705882
chr6	CAPN11	44168941	44169031	0	91	41	3486	41	3395	0.0	0.01207658321060383
chr6	CAPN11	44161789	44161924	0	136	41	3486	41	3350	0.0	0.012238805970149255
chr6	CAPN11	44182940	44183019	0	80	41	3486	41	3406	0.0	0.012037580739870817
chr6	SLC29A1	44226060	44226167	957	108	679626	4176	678669	4068	8.86111111111111	166.8311209439528
chr6	SLC29A1	44227262	44227342	0	81	679626	4176	679626	4095	0.0	165.96483516483516
chr6	SLC29A1	44227259	44227342	0	84	679626	4176	679626	4092	0.0	166.08651026392963
chr6	SLC29A1	44221585	44221685	237916	101	679626	4176	441710	4075	2355.6039603960394	108.39509202453988
chr6	SLC29A1	44225924	44226167	1704	244	679626	4176	677922	3932	6.983606557377049	172.411495422177
chr6	SLC29A1	44225972	44226167	1122	196	679626	4176	678504	3980	5.724489795918367	170.47839195979898
chr6	RUNX2	45491940	45492114	0	175	3805	8204	3805	8029	0.0	0.4739070868103126
chr6	RUNX2	45545216	45545282	0	67	3805	8204	3805	8137	0.0	0.4676170578837409
chr6	RUNX2	45422592	45422957	51	366	3805	8204	3754	7838	0.13934426229508196	0.4789487114059709
chr6	RUNX2	45513449	45513653	997	205	3805	8204	2808	7999	4.863414634146341	0.35104388048506063
chr6	SLC25A27	46664773	46664886	0	114	0	2558	0	2444	0.0	0.0
chr6	TDRD6	46697997	46698087	0	91	0	9046	0	8955	0.0	0.0
chr6	TDRD6	46700998	46701062	0	65	0	9046	0	8981	0.0	0.0
chr6	C6ORF141	49552976	49553207	0	232	0	2362	0	2130	0.0	0.0
chr6	AL121974.1	49802984	49803073	0	90	0	1303	0	1213	0.0	0.0
chr6	AL121974.1	49802984	49803057	0	74	0	1303	0	1229	0.0	0.0
chr6	AL121974.1	49801706	49801760	0	55	0	1303	0	1248	0.0	0.0
chr6	AL121974.1	49811475	49811593	0	119	0	1303	0	1184	0.0	0.0
chr6	AL121974.1	49802984	49803105	0	122	0	1303	0	1181	0.0	0.0
chr6	AL138826.1	50095709	50095909	0	201	0	1720	0	1519	0.0	0.0
chr6	TFAP2B	50822133	50822160	0	28	0	6163	0	6135	0.0	0.0
chr6	EFHC1	52438303	52438591	0	289	15377	16238	15377	15949	0.0	0.9641356824879302
chr6	EFHC1	52464894	52465115	102	222	15377	16238	15275	16016	0.4594594594594595	0.9537337662337663
chr6	EFHC1	52429968	52430131	51	164	15377	16238	15326	16074	0.31097560975609756	0.9534652233420431
chr6	EFHC1	52423686	52423814	62	129	15377	16238	15315	16109	0.4806201550387597	0.950710782792228
chr6	EFHC1	52430227	52430374	51	148	15377	16238	15326	16090	0.34459459459459457	0.9525170913610939
chr6	EFHC1	52423686	52423828	62	143	15377	16238	15315	16095	0.43356643356643354	0.9515377446411929
chr6	EFHC1	52437561	52437678	0	118	15377	16238	15377	16120	0.0	0.9539081885856079
chr6	EFHC1	52438303	52438454	0	152	15377	16238	15377	16086	0.0	0.9559244063160512
chr6	TRAM2-AS1	52578501	52578594	0	94	864	8437	864	8343	0.0	0.10355987055016182
chr6	FBXO9	53067904	53068006	0	103	7476	7972	7476	7869	0.0	0.9500571864277545
chr6	FBXO9	53094691	53094841	0	151	7476	7972	7476	7821	0.0	0.9558879938626774
chr6	MLIP	54121446	54121602	0	157	0	7315	0	7158	0.0	0.0
chr6	MLIP	54136714	54138286	0	1573	0	7315	0	5742	0.0	0.0
chr6	MLIP	54160515	54160599	0	85	0	7315	0	7230	0.0	0.0
chr6	MLIP	54149055	54149127	0	73	0	7315	0	7242	0.0	0.0
chr6	MLIP	54230713	54230917	0	205	0	7315	0	7110	0.0	0.0
chr6	MLIP	54160739	54160799	0	61	0	7315	0	7254	0.0	0.0
chr6	MLIP	54257307	54257361	0	55	0	7315	0	7260	0.0	0.0
chr6	MLIP	54160366	54160432	0	67	0	7315	0	7248	0.0	0.0
chr6	BEND6	57014461	57014525	0	65	4090	5621	4090	5556	0.0	0.7361411087113031
chr6	KIAA1586	57050773	57050854	390	82	254200	3113	253810	3031	4.7560975609756095	83.73804025074233
chr6	ZNF451	57090810	57090894	0	85	2076	14830	2076	14745	0.0	0.140793489318413
chr6	ZNF451	57099468	57099568	0	101	2076	14830	2076	14729	0.0	0.14094643220856812
chr6	ZNF451	57150718	57150862	0	145	2076	14830	2076	14685	0.0	0.14136874361593463
chr6	ZNF451	57090832	57090894	0	63	2076	14830	2076	14767	0.0	0.1405837340014898
chr6	AL445250.1	57965516	57965743	0	228	1020	10037	1020	9809	0.0	0.10398613518197573
chr6	AL445250.1	57962130	57962248	0	119	1020	10037	1020	9918	0.0	0.102843315184513
chr6	AL445250.1	57962180	57962248	0	69	1020	10037	1020	9968	0.0	0.10232744783306581
chr6	AL445250.1	58162609	58162749	0	141	1020	10037	1020	9896	0.0	0.103071948261924
chr6	AL445250.1	57965665	57965743	0	79	1020	10037	1020	9958	0.0	0.10243020686884917
chr6	AL445250.1	58300738	58300811	0	74	1020	10037	1020	9963	0.0	0.10237880156579343
chr6	AL445250.1	58072214	58072267	0	54	1020	10037	1020	9983	0.0	0.10217369528197937
chr6	AC244258.1	60425366	60425439	0	74	0	3028	0	2954	0.0	0.0
chr6	PTP4A1	63532336	63532530	0	195	0	5534	0	5339	0.0	0.0
chr6	PTP4A1	63579256	63579331	0	76	0	5534	0	5458	0.0	0.0
chr6	PTP4A1	63550299	63550493	0	195	0	5534	0	5339	0.0	0.0
chr6	PHF3	63646526	63646795	0	270	102	20948	102	20678	0.0	0.004932778798723281
chr6	PHF3	63684128	63685911	0	1784	102	20948	102	19164	0.0	0.005322479649342517
chr6	PHF3	63679999	63680161	0	163	102	20948	102	20785	0.0	0.0049073851335097425
chr6	PHF3	63646618	63646795	0	178	102	20948	102	20770	0.0	0.0049109292248435245
chr6	PHF3	63678827	63679020	0	194	102	20948	102	20754	0.0	0.004914715235617231
chr6	FAM135A	70415290	70415376	43667	87	43667	9960	0	9873	501.91954022988506	0.0
chr6	FAM135A	70426438	70426532	0	95	43667	9960	43667	9865	0.0	4.426457171819564
chr6	FAM135A	70418374	70418492	0	119	43667	9960	43667	9841	0.0	4.437252311756935
chr6	FAM135A	70426569	70426709	0	141	43667	9960	43667	9819	0.0	4.447194215296873
chr6	FAM135A	70486166	70486244	0	79	43667	9960	43667	9881	0.0	4.419289545592552
chr6	SMAP1	70859328	70859416	0	89	51	4171	51	4082	0.0	0.012493875551200392
chr6	SMAP1	70791688	70791769	0	82	51	4171	51	4089	0.0	0.012472487160674981
chr6	RIMS1	72265959	72266049	0	91	204	12828	204	12737	0.0	0.01601633037606972
chr6	RIMS1	72260704	72260767	0	64	204	12828	204	12764	0.0	0.01598245064243184
chr6	RIMS1	72398248	72398350	0	103	204	12828	204	12725	0.0	0.016031434184675834
chr6	RIMS1	72274348	72274432	0	85	204	12828	204	12743	0.0	0.016008789139135213
chr6	RIMS1	72265389	72265503	0	115	204	12828	204	12713	0.0	0.0160465665067254
chr6	RIMS1	72290678	72290861	0	184	204	12828	204	12644	0.0	0.016134134767478645
chr6	RIMS1	72264974	72265052	0	79	204	12828	204	12749	0.0	0.01600125500039219
chr6	RIMS1	72284046	72284118	0	73	204	12828	204	12755	0.0	0.015993727949823597
chr6	RIMS1	72295936	72295966	0	31	204	12828	204	12797	0.0	0.01594123622724076
chr6	KCNQ5	73124485	73124512	0	28	204	8128	204	8100	0.0	0.025185185185185185
chr6	KCNQ5	73129792	73129849	0	58	204	8128	204	8070	0.0	0.025278810408921933
chr6	AC019205.1	73270397	73270527	0	131	102	10457	102	10326	0.0	0.009877977919814061
chr6	AC019205.1	73284635	73284734	0	100	102	10457	102	10357	0.0	0.009848411702230376
chr6	MTO1	73473364	73473654	0	291	2538	11827	2538	11536	0.0	0.22000693481276007
chr6	MTO1	73480996	73481116	208	121	2538	11827	2330	11706	1.71900826446281	0.19904322569622415
chr6	MTO1	73497735	73497896	0	162	2538	11827	2538	11665	0.0	0.21757393913416204
chr6	MTO1	73482039	73482244	0	206	2538	11827	2538	11621	0.0	0.21839772825058085
chr6	MTO1	73480292	73480367	0	76	2538	11827	2538	11751	0.0	0.2159816185856523
chr6	MTO1	73471459	73471557	0	99	2538	11827	2538	11728	0.0	0.21640518417462484
chr6	MTO1	73481000	73481116	192	117	2538	11827	2346	11710	1.641025641025641	0.2003415883859949
chr6	MTO1	73480317	73480367	0	51	2538	11827	2538	11776	0.0	0.21552309782608695
chr6	MTO1	73486597	73486761	102	165	2538	11827	2436	11662	0.6181818181818182	0.20888355342136855
chr6	AL121972.1	73525885	73526002	0	118	153	809	153	691	0.0	0.22141823444283648
chr6	CD109	73730343	73730574	51	232	4605	9817	4554	9585	0.21982758620689655	0.4751173708920188
chr6	TMEM30A-DT	75293492	75293594	0	103	0	9457	0	9354	0.0	0.0
chr6	AL445465.1	75360666	75360719	0	54	0	2251	0	2197	0.0	0.0
chr6	AL445465.1	75361851	75362013	0	163	0	2251	0	2088	0.0	0.0
chr6	AL445465.1	75360812	75360916	0	105	0	2251	0	2146	0.0	0.0
chr6	AL445465.1	75362765	75362956	0	192	0	2251	0	2059	0.0	0.0
chr6	SENP6	75702644	75703072	0	429	51	11017	51	10588	0.0	0.004816773706082357
chr6	SENP6	75640683	75640704	0	22	51	11017	51	10995	0.0	0.004638472032742156
chr6	SENP6	75622750	75622858	0	109	51	11017	51	10908	0.0	0.004675467546754675
chr6	SENP6	75640686	75640704	0	19	51	11017	51	10998	0.0	0.004637206764866339
chr6	MYO6	75844896	75844977	0	82	6089	9887	6089	9805	0.0	0.6210096889342173
chr6	MYO6	75898372	75898411	0	40	6089	9887	6089	9847	0.0	0.6183609221082563
chr6	MYO6	75911671	75911698	0	28	6089	9887	6089	9859	0.0	0.617608276701491
chr6	MYO6	75871294	75871392	12	99	6089	9887	6077	9788	0.12121212121212122	0.6208622803432775
chr6	MYO6	75867430	75867523	0	94	6089	9887	6089	9793	0.0	0.6217706525068927
chr6	MYO6	75846967	75846976	0	10	6089	9887	6089	9877	0.0	0.6164827376733826
chr6	MYO6	75813598	75813688	0	91	6089	9887	6089	9796	0.0	0.6215802368313598
chr6	MYO6	75894813	75894840	0	28	6089	9887	6089	9859	0.0	0.617608276701491
chr6	MYO6	75777452	75777570	0	119	6089	9887	6089	9768	0.0	0.6233619983619983
chr6	MYO6	75819772	75819872	0	101	6089	9887	6089	9786	0.0	0.6222154097690579
chr6	MYO6	75757998	75758120	0	123	6089	9887	6089	9764	0.0	0.6236173699303564
chr6	MYO6	75834249	75834376	0	128	6089	9887	6089	9759	0.0	0.6239368787785634
chr6	IRAK1BP1	78898063	78898298	0	236	0	2777	0	2541	0.0	0.0
chr6	TTK	80006104	80006175	0	72	0	4604	0	4532	0.0	0.0
chr6	AL359715.1	80454109	80454227	0	119	0	6274	0	6155	0.0	0.0
chr6	DOP1A	83125165	83125195	0	31	1416	9967	1416	9936	0.0	0.14251207729468598
chr6	DOP1A	83164659	83164719	0	61	1416	9967	1416	9906	0.0	0.14294367050272563
chr6	TBX18-AS1	84706558	84706695	0	138	0	2085	0	1947	0.0	0.0
chr6	TBX18-AS1	84699643	84699800	0	158	0	2085	0	1927	0.0	0.0
chr6	NT5E	85490507	85490657	0	151	19400	4543	19400	4392	0.0	4.41712204007286
chr6	ZNF292	87249311	87249466	0	156	51	9852	51	9696	0.0	0.00525990099009901
chr6	SMIM8	87330691	87330950	0	260	153	7986	153	7726	0.0	0.01980326171369402
chr6	SMIM8	87330691	87330712	0	22	153	7986	153	7964	0.0	0.01921145153189352
chr6	SLC35A1	87508419	87508596	0	178	0	2003	0	1825	0.0	0.0
chr6	SLC35A1	87506381	87506448	0	68	0	2003	0	1935	0.0	0.0
chr6	ORC3	87601783	87601881	0	99	78	3712	78	3613	0.0	0.021588707445336287
chr6	ANKRD6	89566833	89567096	0	264	102	8004	102	7740	0.0	0.01317829457364341
chr6	ANKRD6	89595915	89596014	0	100	102	8004	102	7904	0.0	0.012904858299595142
chr6	ANKRD6	89606006	89606105	0	100	102	8004	102	7904	0.0	0.012904858299595142
chr6	ANKRD6	89617953	89618031	0	79	102	8004	102	7925	0.0	0.012870662460567823
chr6	ANKRD6	89621921	89622026	0	106	102	8004	102	7898	0.0	0.012914661939731578
chr6	ANKRD6	89624538	89624691	0	154	102	8004	102	7850	0.0	0.012993630573248408
chr6	ANKRD6	89616873	89616956	51	84	102	8004	51	7920	0.6071428571428571	0.006439393939393939
chr6	AL132996.1	90345220	90345391	26358	172	247916	8959	221558	8787	153.24418604651163	25.214293843177423
chr6	AL132996.1	90345260	90345391	23992	132	247916	8959	223924	8827	181.75757575757575	25.368075223745326
chr6	AL132996.1	90355763	90355818	615	56	247916	8959	247301	8903	10.982142857142858	27.777266090081994
chr6	FHL5	96563124	96563355	0	232	0	2142	0	1910	0.0	0.0
chr6	KLHL32	97064627	97064726	0	100	0	4138	0	4038	0.0	0.0
chr6	KLHL32	97113782	97114509	0	728	0	4138	0	3410	0.0	0.0
chr6	KLHL32	97041491	97041599	0	109	0	4138	0	4029	0.0	0.0
chr6	KLHL32	97062332	97062503	0	172	0	4138	0	3966	0.0	0.0
chr6	KLHL32	97085125	97085341	0	217	0	4138	0	3921	0.0	0.0
chr6	KLHL32	97105442	97105521	0	80	0	4138	0	4058	0.0	0.0
chr6	AL589740.1	97373847	97373914	0	68	16623	12047	16623	11979	0.0	1.3876784372652142
chr6	AL589740.1	97433617	97433662	0	46	16623	12047	16623	12001	0.0	1.38513457211899
chr6	AL589740.1	97309981	97310059	0	79	16623	12047	16623	11968	0.0	1.3889538770053476
chr6	AL589740.1	97423468	97423662	0	195	16623	12047	16623	11852	0.0	1.4025480931488357
chr6	AL589740.1	98099185	98099270	0	86	16623	12047	16623	11961	0.0	1.3897667419112114
chr6	AL589740.1	97423468	97423566	0	99	16623	12047	16623	11948	0.0	1.391278875125544
chr6	AL589740.1	97972525	97972670	0	146	16623	12047	16623	11901	0.0	1.3967733803882028
chr6	AL589740.1	97633487	97633603	0	117	16623	12047	16623	11930	0.0	1.3933780385582566
chr6	AL589740.1	97618125	97618231	451	107	16623	12047	16172	11940	4.214953271028038	1.3544388609715243
chr6	AL589740.1	97972576	97972670	0	95	16623	12047	16623	11952	0.0	1.3908132530120483
chr6	AL589740.1	98076066	98076145	0	80	16623	12047	16623	11967	0.0	1.389069942341439
chr6	AL589740.1	97769541	97769698	0	158	16623	12047	16623	11889	0.0	1.3981831945495837
chr6	AL589740.1	97479170	97479219	0	50	16623	12047	16623	11997	0.0	1.3855963990997748
chr6	AL589740.1	97616835	97616931	455	97	16623	12047	16168	11950	4.690721649484536	1.352970711297071
chr6	AL589740.1	97628900	97628961	0	62	16623	12047	16623	11985	0.0	1.3869837296620775
chr6	AL589740.1	97769541	97769702	0	162	16623	12047	16623	11885	0.0	1.3986537652503155
chr6	AL589740.1	98113798	98113860	0	63	16623	12047	16623	11984	0.0	1.387099465954606
chr6	AL589740.1	98117238	98117321	0	84	16623	12047	16623	11963	0.0	1.3895343977263228
chr6	AL589740.1	97612167	97612339	0	173	16623	12047	16623	11874	0.0	1.3999494694290044
chr6	AL589740.1	97969405	97969466	0	62	16623	12047	16623	11985	0.0	1.3869837296620775
chr6	AL589740.1	97998858	97998907	0	50	16623	12047	16623	11997	0.0	1.3855963990997748
chr6	AL589740.1	98034494	98034562	0	69	16623	12047	16623	11978	0.0	1.3877942895308064
chr6	AL589740.1	98270566	98270656	0	91	16623	12047	16623	11956	0.0	1.3903479424556708
chr6	AL589740.1	98270597	98270656	0	60	16623	12047	16623	11987	0.0	1.3867523150079253
chr6	AL589740.1	98361337	98361412	0	76	16623	12047	16623	11971	0.0	1.3886057973435804
chr6	AL589740.1	98276073	98276189	0	117	16623	12047	16623	11930	0.0	1.3933780385582566
chr6	AL589740.1	98364717	98364772	0	56	16623	12047	16623	11991	0.0	1.386289717287966
chr6	AL589740.1	98133351	98133456	0	106	16623	12047	16623	11941	0.0	1.3920944644502136
chr6	AL589740.1	98041418	98041512	0	95	16623	12047	16623	11952	0.0	1.3908132530120483
chr6	AL589740.1	98279755	98279859	0	105	16623	12047	16623	11942	0.0	1.391977893150226
chr6	TSTD3	99526063	99526109	0	47	153	16121	153	16074	0.0	0.009518477043673012
chr6	TSTD3	99531362	99531536	0	175	153	16121	153	15946	0.0	0.009594882729211088
chr6	MCHR2-AS1	99996161	99996330	1277	170	2162	1443	885	1273	7.511764705882353	0.6952081696779262
chr6	MCHR2-AS1	100007434	100007464	0	31	2162	1443	2162	1412	0.0	1.5311614730878187
chr6	GRIK2	101686179	101686353	0	175	0	7955	0	7780	0.0	0.0
chr6	GRIK2	102065796	102065928	0	133	0	7955	0	7822	0.0	0.0
chr6	GRIK2	102063961	102064048	0	88	0	7955	0	7867	0.0	0.0
chr6	GRIK2	101495966	101496182	0	217	0	7955	0	7738	0.0	0.0
chr6	BVES-AS1	105154393	105154491	0	99	1989	6708	1989	6609	0.0	0.300953245574217
chr6	BVES-AS1	105166543	105166702	0	160	1989	6708	1989	6548	0.0	0.3037568723274282
chr6	BVES-AS1	105166605	105166702	0	98	1989	6708	1989	6610	0.0	0.30090771558245083
chr6	AL096794.1	105456629	105457094	0	466	0	4203	0	3737	0.0	0.0
chr6	MTRES1	107030024	107030107	0	84	15290	2300	15290	2216	0.0	6.899819494584838
chr6	AFG1L	108401995	108402054	0	60	901	5866	901	5806	0.0	0.15518429211160867
chr6	AFG1L	108510211	108510352	0	142	901	5866	901	5724	0.0	0.1574074074074074
chr6	LINC00222	108760301	108760403	0	103	563	2909	563	2806	0.0	0.2006414825374198
chr6	LINC00222	108766995	108767269	51	275	563	2909	512	2634	0.18545454545454546	0.19438116932422173
chr6	ARMC2	108858198	108858271	0	74	618	4275	618	4201	0.0	0.14710783146869794
chr6	CEP57L1	109106034	109106090	0	57	14299	16746	14299	16689	0.0	0.8567918988555336
chr6	CEP57L1	109145218	109145381	0	164	14299	16746	14299	16582	0.0	0.8623205885900374
chr6	CEP57L1	109146757	109146937	0	181	14299	16746	14299	16565	0.0	0.8632055538786598
chr6	CEP57L1	109140420	109140675	0	256	14299	16746	14299	16490	0.0	0.8671315949060037
chr6	CEP57L1	109100191	109100286	0	96	14299	16746	14299	16650	0.0	0.8587987987987988
chr6	CEP57L1	109130735	109130836	0	102	14299	16746	14299	16644	0.0	0.8591083874068733
chr6	CEP57L1	109155790	109155877	0	88	14299	16746	14299	16658	0.0	0.858386360907672
chr6	CEP57L1	109124990	109125031	0	42	14299	16746	14299	16704	0.0	0.8560225095785441
chr6	CEP57L1	109158599	109158718	0	120	14299	16746	14299	16626	0.0	0.8600384939251774
chr6	CEP57L1	109129303	109129492	0	190	14299	16746	14299	16556	0.0	0.8636748006764919
chr6	CCDC162P	109300230	109300369	0	140	16204	10064	16204	9924	0.0	1.6328093510681176
chr6	CCDC162P	109341301	109341433	0	133	16204	10064	16204	9931	0.0	1.6316584432584835
chr6	CCDC162P	109352786	109352914	0	129	16204	10064	16204	9935	0.0	1.6310015098137896
chr6	CCDC162P	109298579	109298631	0	53	16204	10064	16204	10011	0.0	1.6186195185296175
chr6	CCDC162P	109352838	109352914	0	77	16204	10064	16204	9987	0.0	1.622509262040653
chr6	FIG4	109716444	109716568	0	125	394464	19865	394464	19740	0.0	19.982978723404255
chr6	FIG4	109727108	109727265	0	158	394464	19865	394464	19707	0.0	20.01644085857817
chr6	FIG4	109738324	109738453	0	130	394464	19865	394464	19735	0.0	19.988041550544718
chr6	FIG4	109760249	109760383	276	135	394464	19865	394188	19730	2.0444444444444443	19.979118094272682
chr6	FIG4	109776921	109777060	807	140	394464	19865	393657	19725	5.764285714285714	19.95726235741445
chr6	FIG4	109785670	109785769	1698	100	394464	19865	392766	19765	16.98	19.87179357450038
chr6	FIG4	109796764	109796851	220	88	394464	19865	394244	19777	2.5	19.93446933306366
chr6	FIG4	109743109	109743272	0	164	394464	19865	394464	19701	0.0	20.02253692705954
chr6	FIG4	109741443	109741544	122	102	394464	19865	394342	19763	1.196078431372549	19.953549562313412
chr6	FIG4	109788797	109788956	6707	160	394464	19865	387757	19705	41.91875	19.678102004567368
chr6	FIG4	109715077	109715176	0	100	394464	19865	394464	19765	0.0	19.95770301037187
chr6	FIG4	109695398	109695474	248	77	394464	19865	394216	19788	3.220779220779221	19.92197291287649
chr6	FIG4	109695829	109695904	2293	76	394464	19865	392171	19789	30.17105263157895	19.817625953812723
chr6	FIG4	109727157	109727265	0	109	394464	19865	394464	19756	0.0	19.96679489775258
chr6	FIG4	109744666	109744761	0	96	394464	19865	394464	19769	0.0	19.95366482877232
chr6	FIG4	109788797	109788913	4473	117	394464	19865	389991	19748	38.23076923076923	19.748379582742555
chr6	AMD1	110892160	110892203	0	44	408	9630	408	9586	0.0	0.04256206968495723
chr6	AMD1	110887504	110887591	0	88	408	9630	408	9542	0.0	0.04275833158666946
chr6	RPF2	110988987	110989065	0	79	2230	3933	2230	3854	0.0	0.5786196159833938
chr6	RPF2	110989027	110989065	0	39	2230	3933	2230	3894	0.0	0.5726759116589625
chr6	SLC16A10	111193292	111193324	528	33	2330	11246	1802	11213	16.0	0.16070632301792562
chr6	MFSD4B	111263829	111263946	0	118	65496	13087	65496	12969	0.0	5.050196622715707
chr6	MFSD4B	111273329	111273422	0	94	65496	13087	65496	12993	0.0	5.040868159778342
chr6	MFSD4B	111265383	111265437	15	55	65496	13087	65481	13032	0.2727272727272727	5.02463167587477
chr6	MFSD4B	111262256	111262425	0	170	65496	13087	65496	12917	0.0	5.070527212200975
chr6	TRAF3IP2-AS1	111484117	111484145	0	29	20556	4826	20556	4797	0.0	4.285178236397749
chr6	TRAF3IP2-AS1	111484743	111484861	0	119	20556	4826	20556	4707	0.0	4.367112810707457
chr6	TRAF3IP2-AS1	111574620	111574802	0	183	20556	4826	20556	4643	0.0	4.427309928925264
chr6	CCN6	112066968	112067032	0	65	0	1796	0	1731	0.0	0.0
chr6	Z99289.1	112162028	112162239	0	212	0	1518	0	1306	0.0	0.0
chr6	LAMA4-AS1	112277179	112277311	0	133	0	4143	0	4010	0.0	0.0
chr6	LAMA4-AS1	112283297	112283527	0	231	0	4143	0	3912	0.0	0.0
chr6	LAMA4-AS1	112258357	112258552	0	196	0	4143	0	3947	0.0	0.0
chr6	LAMA4-AS1	112283053	112283192	0	140	0	4143	0	4003	0.0	0.0
chr6	LAMA4-AS1	112279120	112279238	0	119	0	4143	0	4024	0.0	0.0
chr6	AL365214.2	112343397	112343778	0	382	153	1443	153	1061	0.0	0.14420358152686144
chr6	AL365214.2	112345112	112345159	0	48	153	1443	153	1395	0.0	0.10967741935483871
chr6	LINC02880	113916942	113917052	0	111	0	2265	0	2154	0.0	0.0
chr6	HDAC2-AS2	114230156	114230323	0	168	54590	8080	54590	7912	0.0	6.8996461071789685
chr6	NT5DC1	116237458	116237639	0	182	561	7321	561	7139	0.0	0.07858243451463791
chr6	DSE	116367008	116367217	0	210	21712	19215	21712	19005	0.0	1.1424362009997369
chr6	DSE	116433342	116433550	0	209	21712	19215	21712	19006	0.0	1.1423760917604966
chr6	DSE	116430953	116431193	64	241	21712	19215	21648	18974	0.26556016597510373	1.1409296932644672
chr6	CALHM6	116461871	116462454	1424	584	1475	1190	51	606	2.4383561643835616	0.08415841584158416
chr6	CALHM4	116554284	116554351	0	68	12606	1903	12606	1835	0.0	6.8697547683923705
chr6	CALHM4	116554190	116554351	0	162	12606	1903	12606	1741	0.0	7.240666283744974
chr6	RWDD1	116572857	116572985	11527	129	76601	5877	65074	5748	89.35658914728683	11.32115518441197
chr6	RWDD1	116574057	116574171	16368	115	76601	5877	60233	5762	142.3304347826087	10.453488372093023
chr6	RWDD1	116572421	116572478	7803	58	76601	5877	68798	5819	134.5344827586207	11.822993641519162
chr6	RSPH4A	116627628	116628369	0	742	0	2846	0	2104	0.0	0.0
chr6	RSPH4A	116629566	116629702	0	137	0	2846	0	2709	0.0	0.0
chr6	KPNA5	116681446	116681552	0	107	731	2297	731	2190	0.0	0.33378995433789954
chr6	VGLL2	117270542	117271064	0	523	0	2235	0	1712	0.0	0.0
chr6	DCBLD1	117464055	117464165	0	111	102	6214	102	6103	0.0	0.016713091922005572
chr6	DCBLD1	117525361	117525434	0	74	102	6214	102	6140	0.0	0.016612377850162865
chr6	DCBLD1	117540667	117540815	0	149	102	6214	102	6065	0.0	0.016817807089859853
chr6	DCBLD1	117543123	117543211	0	89	102	6214	102	6125	0.0	0.016653061224489795
chr6	HSF2	122427902	122427956	0	55	0	2710	0	2655	0.0	0.0
chr6	PKIB	122701439	122701500	0	62	0	3448	0	3386	0.0	0.0
chr6	PKIB	122675077	122675144	0	68	0	3448	0	3380	0.0	0.0
chr6	PKIB	122701061	122701224	0	164	0	3448	0	3284	0.0	0.0
chr6	SMPDL3A	122795676	122795890	0	215	0	2357	0	2142	0.0	0.0
chr6	CLVS2	122997218	122998166	0	949	55	11225	55	10276	0.0	0.005352277150642273
chr6	TRDN-AS1	123462246	123462358	0	113	0	7284	0	7171	0.0	0.0
chr6	TRDN-AS1	123442000	123442147	0	148	0	7284	0	7136	0.0	0.0
chr6	TRDN-AS1	123489504	123489605	0	102	0	7284	0	7182	0.0	0.0
chr6	TRDN-AS1	123469636	123470058	0	423	0	7284	0	6861	0.0	0.0
chr6	AL445259.1	123533299	123533533	0	235	51	2875	51	2640	0.0	0.019318181818181818
chr6	NKAIN2	124121877	124121941	0	65	0	4468	0	4403	0.0	0.0
chr6	NKAIN2	124819085	124819174	0	90	0	4468	0	4378	0.0	0.0
chr6	RNF217	125082448	125082563	0	116	102	12571	102	12455	0.0	0.00818948213568848
chr6	RNF217	124971500	124971598	0	99	102	12571	102	12472	0.0	0.0081783194355356
chr6	RNF217	125006075	125006177	0	103	102	12571	102	12468	0.0	0.008180943214629451
chr6	RNF217	125009173	125009282	0	110	102	12571	102	12461	0.0	0.008185538881309686
chr6	RNF217	125048151	125048259	0	109	102	12571	102	12462	0.0	0.008184882041405874
chr6	TPD52L1	125252021	125252036	0	16	78	4105	78	4089	0.0	0.019075568598679385
chr6	TPD52L1	125257097	125257158	0	62	78	4105	78	4043	0.0	0.01929260450160772
chr6	TPD52L1	125253716	125253755	0	40	78	4105	78	4065	0.0	0.01918819188191882
chr6	TPD52L1	125257097	125257180	0	84	78	4105	78	4021	0.0	0.019398159661775678
chr6	NCOA7	125855019	125855240	0	222	102	7669	102	7447	0.0	0.013696790653954613
chr6	NCOA7	125928173	125928247	0	75	102	7669	102	7594	0.0	0.013431656570977087
chr6	NCOA7	125796679	125796797	0	119	102	7669	102	7550	0.0	0.013509933774834438
chr6	TRMT11	125998052	125998134	0	83	3787	5422	3787	5339	0.0	0.7093088593369545
chr6	TRMT11	126009334	126009434	0	101	3787	5422	3787	5321	0.0	0.711708325502725
chr6	TRMT11	126006841	126006954	0	114	3787	5422	3787	5308	0.0	0.7134513941220799
chr6	TRMT11	126008656	126008745	0	90	3787	5422	3787	5332	0.0	0.7102400600150037
chr6	RNF146	127286049	127286177	0	129	0	3139	0	3010	0.0	0.0
chr6	RNF146	127280515	127280604	0	90	0	3139	0	3049	0.0	0.0
chr6	RNF146	127282286	127282395	0	110	0	3139	0	3029	0.0	0.0
chr6	RNF146	127285207	127285348	0	142	0	3139	0	2997	0.0	0.0
chr6	LAMA2	129475389	129475401	0	13	4107	10427	4107	10414	0.0	0.3943729594776263
chr6	LAMA2	129292802	129293066	0	265	4107	10427	4107	10162	0.0	0.4041527258413698
chr6	L3MBTL3	130049755	130049830	0	76	0	5138	0	5062	0.0	0.0
chr6	L3MBTL3	130049650	130049830	0	181	0	5138	0	4957	0.0	0.0
chr6	L3MBTL3	130022226	130022305	0	80	0	5138	0	5058	0.0	0.0
chr6	TMEM200A	130385172	130385236	0	65	3836	5863	3836	5798	0.0	0.661607450845119
chr6	AKAP7	131169112	131169273	0	162	4839	4154	4839	3992	0.0	1.2121743486973948
chr6	AKAP7	131199460	131199573	1394	114	4839	4154	3445	4040	12.228070175438596	0.8527227722772277
chr6	AKAP7	131253036	131253105	0	70	4839	4154	4839	4084	0.0	1.1848677766895201
chr6	ARG1	131576662	131576735	0	74	0	2170	0	2096	0.0	0.0
chr6	ENPP3	131638450	131638576	0	127	0	3912	0	3785	0.0	0.0
chr6	ENPP3	131652830	131652891	0	62	0	3912	0	3850	0.0	0.0
chr6	ENPP3	131733587	131733723	0	137	0	3912	0	3775	0.0	0.0
chr6	ENPP3	131638446	131638576	0	131	0	3912	0	3781	0.0	0.0
chr6	ENPP1	131852174	131852235	0	62	2846	9693	2846	9631	0.0	0.2955041013394248
chr6	ENPP1	131869357	131869489	0	133	2846	9693	2846	9560	0.0	0.29769874476987446
chr6	ENPP1	131826021	131826115	153	95	2846	9693	2693	9598	1.6105263157894736	0.2805792873515316
chr6	ENPP1	131851141	131851267	0	127	2846	9693	2846	9566	0.0	0.2975120217436755
chr6	LINC01013	132146219	132146412	0	194	177	6796	177	6602	0.0	0.026810057558315663
chr6	LINC01013	132160766	132160914	0	149	177	6796	177	6647	0.0	0.02662855423499323
chr6	LINC01013	132134271	132134483	0	213	177	6796	177	6583	0.0	0.026887437338599423
chr6	LINC01013	132161958	132162131	0	174	177	6796	177	6622	0.0	0.026729084868619753
chr6	LINC01013	132154655	132154777	0	123	177	6796	177	6673	0.0	0.026524801438633297
chr6	LINC01013	132160766	132161006	0	241	177	6796	177	6555	0.0	0.02700228832951945
chr6	LINC01013	132163896	132164193	0	298	177	6796	177	6498	0.0	0.02723915050784857
chr6	LINC01013	132162000	132162131	0	132	177	6796	177	6664	0.0	0.02656062424969988
chr6	LINC01013	132166193	132166291	51	99	177	6796	126	6697	0.5151515151515151	0.01881439450500224
chr6	LINC01013	132162015	132162131	0	117	177	6796	177	6679	0.0	0.026500973199580776
chr6	LINC00326	133087779	133088577	0	799	1416	6021	1416	5222	0.0	0.2711604749138261
chr6	LINC00326	133100006	133100184	204	179	1416	6021	1212	5842	1.1396648044692737	0.2074631975350907
chr6	LINC00326	133096509	133096563	0	55	1416	6021	1416	5966	0.0	0.23734495474354678
chr6	LINC00326	133088817	133090069	0	1253	1416	6021	1416	4768	0.0	0.29697986577181207
chr6	LINC00326	133098269	133098318	0	50	1416	6021	1416	5971	0.0	0.23714620666555017
chr6	LINC00326	133098269	133098369	0	101	1416	6021	1416	5920	0.0	0.2391891891891892
chr6	LINC00326	133098269	133098520	0	252	1416	6021	1416	5769	0.0	0.2454498179927197
chr6	LINC00326	133088817	133088931	0	115	1416	6021	1416	5906	0.0	0.2397561801557738
chr6	LINC00326	133089893	133090069	0	177	1416	6021	1416	5844	0.0	0.24229979466119098
chr6	LINC00326	133100047	133100184	140	138	1416	6021	1276	5883	1.0144927536231885	0.2168961414244433
chr6	LINC00326	133098269	133098382	0	114	1416	6021	1416	5907	0.0	0.23971559167089893
chr6	LINC00326	133098269	133098374	0	106	1416	6021	1416	5915	0.0	0.2393913778529163
chr6	EYA4	133448110	133448179	0	70	0	7266	0	7196	0.0	0.0
chr6	EYA4	133456555	133456648	0	94	0	7266	0	7172	0.0	0.0
chr6	TBPL1	133984576	133984671	0	96	694	5049	694	4953	0.0	0.140117100747022
chr6	TBPL1	133953184	133953425	0	242	694	5049	694	4807	0.0	0.14437278968171416
chr6	TBPL1	133968854	133968957	0	104	694	5049	694	4945	0.0	0.1403437815975733
chr6	LINC01010	134470908	134471026	0	119	2339	4158	2339	4039	0.0	0.5791037385491459
chr6	LINC01010	134467813	134467944	0	132	2339	4158	2339	4026	0.0	0.5809736711376056
chr6	LINC01010	134476747	134476930	0	184	2339	4158	2339	3974	0.0	0.5885757423251132
chr6	LINC01010	134476898	134476930	0	33	2339	4158	2339	4125	0.0	0.567030303030303
chr6	LINC01010	134500433	134500574	0	142	2339	4158	2339	4016	0.0	0.5824203187250996
chr6	LINC01010	134497410	134497471	0	62	2339	4158	2339	4096	0.0	0.571044921875
chr6	MYB	135187833	135187905	0	73	1466	5517	1466	5444	0.0	0.26928728875826596
chr6	MYB	135190126	135190347	0	222	1466	5517	1466	5295	0.0	0.2768649669499528
chr6	MYB	135194355	135194460	0	106	1466	5517	1466	5411	0.0	0.27092958787654775
chr6	MYB	135196960	135197323	0	364	1466	5517	1466	5153	0.0	0.2844944692412187
chr6	MYB	135201638	135201749	0	112	1466	5517	1466	5405	0.0	0.27123034227567067
chr6	MYB	135194355	135194451	0	97	1466	5517	1466	5420	0.0	0.27047970479704797
chr6	MYB	135195747	135196002	0	256	1466	5517	1466	5261	0.0	0.27865424824177915
chr6	MYB	135199525	135199581	0	57	1466	5517	1466	5460	0.0	0.2684981684981685
chr6	MYB	135202413	135202669	408	257	1466	5517	1058	5260	1.5875486381322956	0.2011406844106464
chr6	MYB	135194959	135195081	0	123	1466	5517	1466	5394	0.0	0.2717834631071561
chr6	MYB	135196725	135196908	0	184	1466	5517	1466	5333	0.0	0.27489218076129757
chr6	MYB	135202947	135202949	0	3	1466	5517	1466	5514	0.0	0.26586869785999273
chr6	MYB	135202413	135202673	408	261	1466	5517	1058	5256	1.5632183908045978	0.2012937595129376
chr6	MYB	135195747	135195917	0	171	1466	5517	1466	5346	0.0	0.2742237186681631
chr6	MYB	135196725	135197323	0	599	1466	5517	1466	4918	0.0	0.2980886539243595
chr6	LINC00271	135518592	135518830	0	239	23374	13702	23374	13463	0.0	1.7361657877144767
chr6	LINC00271	135499351	135499441	0	91	23374	13702	23374	13611	0.0	1.717287488061127
chr6	LINC00271	135518592	135518642	0	51	23374	13702	23374	13651	0.0	1.7122555124166727
chr6	LINC00271	135498403	135498517	0	115	23374	13702	23374	13587	0.0	1.7203208949731361
chr6	PEX7	136870731	136870839	38	109	854	3423	816	3314	0.3486238532110092	0.24622812311406156
chr6	HEBP2	138412082	138412256	26340	175	234574	10358	208234	10183	150.5142857142857	20.449180005892174
chr6	ECT2L	138812837	138812977	0	141	0	4663	0	4522	0.0	0.0
chr6	FILNC1	139771072	139771123	0	52	0	1857	0	1805	0.0	0.0
chr6	FILNC1	139745385	139745439	0	55	0	1857	0	1802	0.0	0.0
chr6	AL357146.1	140087763	140087989	0	227	0	2548	0	2321	0.0	0.0
chr6	AL357146.1	140083096	140083228	0	133	0	2548	0	2415	0.0	0.0
chr6	AL357146.1	140083096	140083257	0	162	0	2548	0	2386	0.0	0.0
chr6	AL357146.1	140087763	140088007	0	245	0	2548	0	2303	0.0	0.0
chr6	AL357146.1	140086681	140086761	0	81	0	2548	0	2467	0.0	0.0
chr6	VTA1	142166227	142166322	0	96	0	7266	0	7170	0.0	0.0
chr6	VTA1	142203984	142204065	0	82	0	7266	0	7184	0.0	0.0
chr6	ADGRG6	142383759	142383843	0	85	102	8466	102	8381	0.0	0.012170385395537525
chr6	ADGRG6	142440907	142440953	0	47	102	8466	102	8419	0.0	0.01211545314170329
chr6	ADGRG6	142405342	142405391	0	50	102	8466	102	8416	0.0	0.01211977186311787
chr6	AL355304.1	142955252	142955397	0	146	0	3273	0	3127	0.0	0.0
chr6	AIG1	143136834	143136990	102	157	102	8203	0	8046	0.6496815286624203	0.0
chr6	PEX3	143459084	143459216	0	133	107	2842	107	2709	0.0	0.03949796973052787
chr6	VDAC1P8	143505339	143505457	0	119	1868	4338	1868	4219	0.0	0.44275894761791895
chr6	VDAC1P8	143494519	143494705	0	187	1868	4338	1868	4151	0.0	0.4500120452902915
chr6	VDAC1P8	143503393	143504142	561	750	1868	4338	1307	3588	0.748	0.3642697881828317
chr6	VDAC1P8	143504522	143504597	0	76	1868	4338	1868	4262	0.0	0.4382918817456593
chr6	PHACTR2	143753753	143753912	969	160	1539308	11240	1538339	11080	6.05625	138.83925992779783
chr6	PHACTR2	143760400	143760640	0	241	1539308	11240	1539308	10999	0.0	139.94981361941996
chr6	PHACTR2	143712015	143712183	0	169	1539308	11240	1539308	11071	0.0	139.0396531478638
chr6	UTRN	144827347	144827386	0	40	367579	14685	367579	14645	0.0	25.09928303175145
chr6	FBXO30-DT	145828360	145828420	0	61	0	8517	0	8456	0.0	0.0
chr6	FBXO30-DT	145881578	145881648	0	71	0	8517	0	8446	0.0	0.0
chr6	FBXO30-DT	145828360	145828456	0	97	0	8517	0	8420	0.0	0.0
chr6	FBXO30-DT	145862634	145862721	0	88	0	8517	0	8429	0.0	0.0
chr6	GRM1	146426558	146426643	0	86	0	7383	0	7297	0.0	0.0
chr6	ADGB	146600332	146600363	0	32	0	7809	0	7777	0.0	0.0
chr6	ADGB	146715381	146715415	0	35	0	7809	0	7774	0.0	0.0
chr6	ADGB	146784617	146784794	0	178	0	7809	0	7631	0.0	0.0
chr6	ADGB	146784617	146784673	0	57	0	7809	0	7752	0.0	0.0
chr6	AL138916.1	146861960	146862041	0	82	0	1320	0	1238	0.0	0.0
chr6	STXBP5	147353322	147353373	0	52	189	6303	189	6251	0.0	0.030235162374020158
chr6	STXBP5	147339336	147339384	0	49	189	6303	189	6254	0.0	0.030220658778381836
chr6	STXBP5	147339178	147339238	0	61	189	6303	189	6242	0.0	0.030278756808715154
chr6	STXBP5	147328698	147328782	0	85	189	6303	189	6218	0.0	0.030395625603087808
chr6	SASH1	148531525	148531661	0	137	0	10733	0	10596	0.0	0.0
chr6	AL031056.1	149229931	149229995	0	65	51	2858	51	2793	0.0	0.018259935553168637
chr6	TAB2	149379933	149380143	182	211	52770	5937	52588	5726	0.8625592417061612	9.184072651065316
chr6	PCMT1	149771161	149771266	0	106	426	2845	426	2739	0.0	0.15553121577217963
chr6	PCMT1	149789953	149790058	0	106	426	2845	426	2739	0.0	0.15553121577217963
chr6	PCMT1	149772047	149772247	0	201	426	2845	426	2644	0.0	0.16111951588502268
chr6	PCMT1	149772013	149772247	0	235	426	2845	426	2610	0.0	0.1632183908045977
chr6	PCMT1	149772554	149772684	18	131	426	2845	408	2714	0.13740458015267176	0.1503316138540899
chr6	PCMT1	149765690	149765753	0	64	426	2845	426	2781	0.0	0.15318230852211434
chr6	IYD	150395454	150395566	0	113	153	9466	153	9353	0.0	0.01635838768309633
chr6	IYD	150395393	150395566	0	174	153	9466	153	9292	0.0	0.01646577701248386
chr6	IYD	150395393	150395454	0	62	153	9466	153	9404	0.0	0.01626967247979583
chr6	PLEKHG1	150638079	150638125	0	47	0	8413	0	8366	0.0	0.0
chr6	MTHFD1L	150887841	150887981	0	141	0	4923	0	4782	0.0	0.0
chr6	MTHFD1L	150887844	150887981	0	138	0	4923	0	4785	0.0	0.0
chr6	ARMT1	151454547	151454653	0	107	0	2824	0	2717	0.0	0.0
chr6	ESR1	151842596	151842787	0	192	100	13546	100	13354	0.0	0.007488392990864161
chr6	ESR1	151944172	151944508	0	337	100	13546	100	13209	0.0	0.007570595805889924
chr6	ESR1	151880654	151880771	0	118	100	13546	100	13428	0.0	0.0074471254095918975
chr6	ESR1	152011655	152011794	0	140	100	13546	100	13406	0.0	0.007459346561241235
chr6	MYCT1	152721741	152722253	0	513	0	2524	0	2011	0.0	0.0
chr6	OPRM1	154039410	154039834	0	425	408	20919	408	20494	0.0	0.019908265833902605
chr6	OPRM1	154039160	154039305	0	146	408	20919	408	20773	0.0	0.01964087998844654
chr6	OPRM1	154089825	154090178	0	354	408	20919	408	20565	0.0	0.019839533187454413
chr6	OPRM1	154094209	154094318	0	110	408	20919	408	20809	0.0	0.01960690086020472
chr6	SCAF8	154741955	154742018	0	64	12292	5450	12292	5386	0.0	2.2822131451912364
chr6	TIAM2	155211203	155211307	0	105	42590	11505	42590	11400	0.0	3.7359649122807017
chr6	TIAM2	155016240	155016361	0	122	42590	11505	42590	11383	0.0	3.741544408328209
chr6	TIAM2	155168844	155168916	442	73	42590	11505	42148	11432	6.054794520547945	3.686843946815955
chr6	TIAM2	155250537	155250624	0	88	42590	11505	42590	11417	0.0	3.7304020320574582
chr6	ARID1B	156871613	156871652	0	40	8976	37651	8976	37611	0.0	0.23865358538725373
chr6	ARID1B	157110471	157110561	0	91	8976	37651	8976	37560	0.0	0.2389776357827476
chr6	ARID1B	157133027	157133207	0	181	8976	37651	8976	37470	0.0	0.23955164131305043
chr6	ARID1B	157174846	157175005	0	160	8976	37651	8976	37491	0.0	0.2394174601904457
chr6	ARID1B	157036834	157036876	0	43	8976	37651	8976	37608	0.0	0.23867262284620294
chr6	ARID1B	157150724	157150853	0	130	8976	37651	8976	37521	0.0	0.23922603342128407
chr6	ARID1B	157164638	157164748	0	111	8976	37651	8976	37540	0.0	0.2391049547149707
chr6	GTF2H5	158187039	158187121	0	83	357	7569	357	7486	0.0	0.0476890195030724
chr6	TULP4	158489587	158489732	6209	146	88557	12302	82348	12156	42.52739726027397	6.774267851266864
chr6	TULP4	158501677	158504178	37923	2502	88557	12302	50634	9800	15.157074340527577	5.166734693877551
chr6	C6ORF99	158908733	158908895	0	163	10605	1833	10605	1670	0.0	6.350299401197605
chr6	C6ORF99	158873527	158873621	0	95	10605	1833	10605	1738	0.0	6.101841196777905
chr6	C6ORF99	158873529	158873621	0	93	10605	1833	10605	1740	0.0	6.094827586206897
chr6	AL035530.2	159040918	159041055	2483	138	81731	11394	79248	11256	17.992753623188406	7.040511727078891
chr6	AL035530.2	159042522	159042676	7190	155	81731	11394	74541	11239	46.38709677419355	6.632351632707536
chr6	FNDC1	159229814	159230003	408	190	271894	6874	271486	6684	2.1473684210526316	40.61729503291442
chr6	LINC02529	159393516	159393609	254	94	2438	1353	2184	1259	2.702127659574468	1.7347100873709294
chr6	LINC02529	159396060	159396174	0	115	2438	1353	2438	1238	0.0	1.9693053311793214
chr6	PNLDC1	159801112	159801186	0	75	0	2094	0	2019	0.0	0.0
chr6	PNLDC1	159811700	159811786	0	87	0	2094	0	2007	0.0	0.0
chr6	IGF2R	160046891	160047057	816	167	2571794	22665	2570978	22498	4.88622754491018	114.27584674193261
chr6	IGF2R	160068844	160069014	190	171	2571794	22665	2571604	22494	1.1111111111111112	114.32399751044723
chr6	SLC22A1	160130103	160130207	589	105	5435	2297	4846	2192	5.609523809523809	2.210766423357664
chr6	SLC22A1	160139652	160139867	463	216	5435	2297	4972	2081	2.1435185185185186	2.3892359442575684
chr6	SLC22A1	160154797	160154910	763	114	5435	2297	4672	2183	6.692982456140351	2.1401740723774623
chr6	SLC22A1	160155974	160156074	210	101	5435	2297	5225	2196	2.0792079207920793	2.3793260473588345
chr6	MAP3K4	161098277	161098427	0	151	25	7415	25	7264	0.0	0.0034416299559471364
chr6	MAP3K4	161067198	161067296	0	99	25	7415	25	7316	0.0	0.003417167851284855
chr6	MAP3K4	161108950	161109041	0	92	25	7415	25	7323	0.0	0.0034139014065273795
chr6	PACRG	163312778	163312895	0	118	102	2627	102	2509	0.0	0.04065364687126345
chr6	PACRG	162997405	162997544	0	140	102	2627	102	2487	0.0	0.04101326899879373
chr6	QKI	163455278	163455421	0	144	97	12507	97	12363	0.0	0.007845992073121411
chr6	QKI	163478779	163478896	0	118	97	12507	97	12389	0.0	0.0078295261925902
chr6	QKI	163457380	163457551	0	172	97	12507	97	12335	0.0	0.007863802188893394
chr6	AL078602.1	163709359	163709501	0	143	102	6195	102	6052	0.0	0.016853932584269662
chr6	CEP43	167013507	167013567	0	61	200365	9903	200365	9842	0.0	20.35815891079049
chr6	CEP43	167010812	167010893	0	82	200365	9903	200365	9821	0.0	20.40169025557479
chr6	TCP10L2	167149956	167150073	0	118	0	4322	0	4204	0.0	0.0
chr6	HPAT5	167232478	167232560	0	83	0	990	0	907	0.0	0.0
chr6	UNC93A	167297944	167298070	0	127	51	2703	51	2576	0.0	0.019798136645962732
chr6	TTLL2	167338646	167338803	0	158	2199	3838	2199	3680	0.0	0.597554347826087
chr6	TTLL2	167328003	167328384	0	382	2199	3838	2199	3456	0.0	0.6362847222222222
chr6	AFDN	167893861	167893906	0	46	51	13403	51	13357	0.0	0.003818222654787752
chr6	AFDN	167954457	167954493	0	37	51	13403	51	13366	0.0	0.00381565165344905
chr6	AFDN	167913402	167913423	0	22	51	13403	51	13381	0.0	0.0038113743367461325
chr6	AFDN	167954460	167954493	0	34	51	13403	51	13369	0.0	0.0038147954222454935
chr6	KIF25	168042560	168042716	0	157	0	4641	0	4484	0.0	0.0
chr6	SMOC2	168655395	168655490	0	96	93	4047	93	3951	0.0	0.023538344722854973
chr6	AL109924.2	169068282	169068299	0	18	0	772	0	754	0.0	0.0
chr6	ERMARD	169753286	169753372	0	87	600	4289	600	4202	0.0	0.14278914802475012
chr6	ERMARD	169755287	169755422	0	136	600	4289	600	4153	0.0	0.14447387430772934
chr6	ERMARD	169756337	169756439	0	103	600	4289	600	4186	0.0	0.1433349259436216
chr6	ERMARD	169753943	169754032	0	90	600	4289	600	4199	0.0	0.1428911645629912
chr6	ERMARD	169755282	169755422	0	141	600	4289	600	4148	0.0	0.1446480231436837
chr6	ERMARD	169753863	169754032	0	170	600	4289	600	4119	0.0	0.14566642388929352
chr6	ERMARD	169766637	169766667	34	31	600	4289	566	4258	1.096774193548387	0.13292625645843117
chr6	ERMARD	169776333	169776411	0	79	600	4289	600	4210	0.0	0.14251781472684086
chr6	ERMARD	169776454	169776673	0	220	600	4289	600	4069	0.0	0.14745637748832638
chr6	ERMARD	169753316	169753372	0	57	600	4289	600	4232	0.0	0.14177693761814744
chr6	ERMARD	169753037	169753181	0	145	600	4289	600	4144	0.0	0.14478764478764478
chr6	TBP	170556881	170557083	0	203	153	2328	153	2125	0.0	0.072
chr6	TBP	170556878	170557083	0	206	153	2328	153	2122	0.0	0.07210179076343072
chr6	TBP	170567225	170567505	0	281	153	2328	153	2047	0.0	0.07474352711284807
chr6	LINC01622	998365	998472	0	108	0	5705	0	5597	0.0	0.0
chr6	LINC01600	2631276	2631417	0	142	2551	3082	2551	2940	0.0	0.867687074829932
chr6	SERPINB9P1	2857910	2857995	510	86	714	4429	204	4343	5.930232558139535	0.04697213907437255
chr6	SERPINB9P1	2872816	2873086	0	271	714	4429	714	4158	0.0	0.1717171717171717
chr6	SERPINB9P1	2857910	2857991	510	82	714	4429	204	4347	6.219512195121951	0.04692891649413389
chr6	SERPINB6	2960260	2960378	522	119	416205	6054	415683	5935	4.38655462184874	70.03925863521482
chr6	SERPINB6	2959167	2959342	0	176	416205	6054	416205	5878	0.0	70.80724736304866
chr6	SERPINB6	2968778	2968913	4917	136	416205	6054	411288	5918	36.154411764705884	69.4978033119297
chr6	SERPINB6	2961893	2962029	4185	137	416205	6054	412020	5917	30.547445255474454	69.63326009802265
chr6	SERPINB6	2968778	2969102	17431	325	416205	6054	398774	5729	53.63384615384616	69.6062139989527
chr6	SERPINB6	2956695	2956814	1025	120	416205	6054	415180	5934	8.541666666666666	69.96629592180653
chr6	SERPINB6	2960969	2961096	3691	128	416205	6054	412514	5926	28.8359375	69.61086736415795
chr6	SERPINB6	2970695	2970824	2121	130	416205	6054	414084	5924	16.315384615384616	69.89939230249831
chr6	SERPINB6	2966399	2966590	4165	192	416205	6054	412040	5862	21.692708333333332	70.29000341180485
chr6	NQO2-AS1	2998616	2998669	0	54	2193	1462	2193	1408	0.0	1.5575284090909092
chr6	LINC02525	3190826	3191257	0	432	0	1654	0	1222	0.0	0.0
chr6	LINC02525	3190826	3191230	0	405	0	1654	0	1249	0.0	0.0
chr6	SLC22A23	3284935	3284959	0	25	77444	6133	77444	6108	0.0	12.679109364767518
chr6	SLC22A23	3323265	3323318	0	54	77444	6133	77444	6079	0.0	12.739595328178977
chr6	SLC22A23	3432093	3432338	254	246	77444	6133	77190	5887	1.032520325203252	13.11194156616273
chr6	AL033523.1	3663659	3663905	604	247	4735	14663	4131	14416	2.445344129554656	0.2865566037735849
chr6	AL033523.1	3595566	3595661	0	96	4735	14663	4735	14567	0.0	0.32504977002814583
chr6	AL033523.1	3632028	3632189	0	162	4735	14663	4735	14501	0.0	0.3265292048824219
chr6	AL033523.1	3653220	3654795	306	1576	4735	14663	4429	13087	0.19416243654822335	0.3384274470848934
chr6	AL033523.1	3634018	3634059	81	42	4735	14663	4654	14621	1.9285714285714286	0.31830928117091856
chr6	AL033523.1	3623647	3623943	0	297	4735	14663	4735	14366	0.0	0.32959766114436867
chr6	AL033523.1	3609379	3609549	0	171	4735	14663	4735	14492	0.0	0.3267319900634833
chr6	AL033523.1	3631925	3632189	0	265	4735	14663	4735	14398	0.0	0.3288651201555772
chr6	AL033523.1	3607104	3607594	0	491	4735	14663	4735	14172	0.0	0.3341095117132374
chr6	AL033523.1	3609026	3609109	0	84	4735	14663	4735	14579	0.0	0.3247822210028123
chr6	AL033523.1	3611056	3611152	0	97	4735	14663	4735	14566	0.0	0.32507208567897844
chr6	AL033523.1	3653600	3654795	306	1196	4735	14663	4429	13467	0.25585284280936454	0.3288779980693547
chr6	FAM217A	4074442	4074456	0	15	3988	3144	3988	3129	0.0	1.2745286033876637
chr6	FAM217A	4077354	4077448	0	95	3988	3144	3988	3049	0.0	1.3079698261725157
chr6	FAM217A	4074576	4074661	0	86	3988	3144	3988	3058	0.0	1.304120340091563
chr6	ECI2	4130178	4130249	865	72	209016	4584	208151	4512	12.01388888888889	46.13275709219858
chr6	RPP40	4998715	4998841	194	127	60773	1987	60579	1860	1.5275590551181102	32.56935483870968
chr6	RPP40	5000562	5000631	0	70	60773	1987	60773	1917	0.0	31.702138758476785
chr6	RPP40	5001093	5001130	0	38	60773	1987	60773	1949	0.0	31.18163160595177
chr6	LYRM4	5216617	5216738	561	122	190011	3829	189450	3707	4.598360655737705	51.106015646074994
chr6	LYRM4	5144137	5144262	0	126	190011	3829	190011	3703	0.0	51.31271941668917
chr6	LYRM4	5113070	5113417	276	348	190011	3829	189735	3481	0.7931034482758621	54.50588911232404
chr6	AL021328.1	5456952	5457028	0	77	0	1336	0	1259	0.0	0.0
chr6	LY86-AS1	6569417	6569489	0	73	0	9672	0	9599	0.0	0.0
chr6	LY86-AS1	6492892	6493138	0	247	0	9672	0	9425	0.0	0.0
chr6	LY86-AS1	6591155	6591479	0	325	0	9672	0	9347	0.0	0.0
chr6	LY86-AS1	6620754	6621383	0	630	0	9672	0	9042	0.0	0.0
chr6	SSR1	7295087	7295102	0	16	250941	2851	250941	2835	0.0	88.51534391534392
chr6	SSR1	7287861	7287922	26825	62	250941	2851	224116	2789	432.66129032258067	80.35711724632485
chr6	CAGE1	7356024	7356129	0	106	112	3526	112	3420	0.0	0.03274853801169591
chr6	CAGE1	7378616	7379020	0	405	112	3526	112	3121	0.0	0.035885933995514256
chr6	CAGE1	7386978	7387196	0	219	112	3526	112	3307	0.0	0.033867553674024796
chr6	CAGE1	7365803	7365884	0	82	112	3526	112	3444	0.0	0.032520325203252036
chr6	CAGE1	7378621	7379020	0	400	112	3526	112	3126	0.0	0.03582853486884197
chr6	CAGE1	7386978	7387175	0	198	112	3526	112	3328	0.0	0.03365384615384615
chr6	BLOC1S5	8041138	8041268	0	131	99377	3306	99377	3175	0.0	31.29984251968504
chr6	BLOC1S5	8027206	8027399	0	194	99377	3306	99377	3112	0.0	31.933483290488432
chr6	BLOC1S5	8054269	8054372	0	104	99377	3306	99377	3202	0.0	31.035915053091816
chr6	EEF1E1	8095377	8095495	0	119	79422	2096	79422	1977	0.0	40.17298937784522
chr6	AL359378.1	8378738	8378844	0	107	32	1434	32	1327	0.0	0.024114544084400905
chr6	AL359378.1	8362719	8362832	0	114	32	1434	32	1320	0.0	0.024242424242424242
chr6	SLC35B3	8434384	8434430	46	47	70179	3823	70133	3776	0.9787234042553191	18.573358050847457
chr6	SLC35B3	8418743	8418885	611	143	70179	3823	69568	3680	4.2727272727272725	18.904347826086955
chr6	OFCC1	9900325	9900489	0	165	0	4816	0	4651	0.0	0.0
chr6	OFCC1	9809576	9809714	0	139	0	4816	0	4677	0.0	0.0
chr6	OFCC1	9819403	9819424	0	22	0	4816	0	4794	0.0	0.0
chr6	OFCC1	9850397	9850469	0	73	0	4816	0	4743	0.0	0.0
chr6	OFCC1	9896870	9897003	0	134	0	4816	0	4682	0.0	0.0
chr6	OFCC1	9903372	9903441	0	70	0	4816	0	4746	0.0	0.0
chr6	OFCC1	9841931	9842023	0	93	0	4816	0	4723	0.0	0.0
chr6	OFCC1	9903372	9903406	0	35	0	4816	0	4781	0.0	0.0
chr6	OFCC1	9921908	9921920	0	13	0	4816	0	4803	0.0	0.0
chr6	TFAP2A	10400447	10400589	6303	143	1054151	7421	1047848	7278	44.07692307692308	143.97471832921133
chr6	TFAP2A	10409900	10410335	77574	436	1054151	7421	976577	6985	177.92201834862385	139.81059413027916
chr6	LINC00518	10434247	10434363	0	117	510	2040	510	1923	0.0	0.26521060842433697
chr6	LINC00518	10433027	10433253	0	227	510	2040	510	1813	0.0	0.28130170987313846
chr6	C6ORF52	10684848	10684923	0	76	1879	892	1879	816	0.0	2.3026960784313726
chr6	C6ORF52	10686965	10687164	0	200	1879	892	1879	692	0.0	2.7153179190751446
chr6	C6ORF52	10687479	10687561	0	83	1879	892	1879	809	0.0	2.322620519159456
chr6	C6ORF52	10672546	10672636	0	91	1879	892	1879	801	0.0	2.3458177278402
chr6	MAK	10770110	10770230	663	121	24054	4411	23391	4290	5.479338842975206	5.452447552447553
chr6	MAK	10830547	10830877	102	331	24054	4411	23952	4080	0.3081570996978852	5.870588235294117
chr6	MAK	10773033	10773108	0	76	24054	4411	24054	4335	0.0	5.54878892733564
chr6	MAK	10779325	10779497	3401	173	24054	4411	20653	4238	19.658959537572255	4.873289287399717
chr6	MAK	10784819	10784924	2211	106	24054	4411	21843	4305	20.858490566037737	5.0738675958188155
chr6	NEDD9	11213280	11213727	1581	448	5480	8413	3899	7965	3.529017857142857	0.48951663527934713
chr6	NEDD9	11200270	11200421	0	152	5480	8413	5480	8261	0.0	0.6633579469797846
chr6	NEDD9	11305065	11305159	0	95	5480	8413	5480	8318	0.0	0.6588122144746333
chr6	NEDD9	11251563	11251726	0	164	5480	8413	5480	8249	0.0	0.6643229482361498
chr6	NEDD9	11334500	11334561	0	62	5480	8413	5480	8351	0.0	0.6562088372649982
chr6	NEDD9	11249138	11249214	0	77	5480	8413	5480	8336	0.0	0.6573896353166987
chr6	ADTRP	11717308	11717414	0	107	14497	3963	14497	3856	0.0	3.7595954356846475
chr6	ADTRP	11770030	11770084	0	55	14497	3963	14497	3908	0.0	3.7095701125895597
chr6	ADTRP	11770030	11770089	0	60	14497	3963	14497	3903	0.0	3.714322316167051
chr6	TBC1D7	13316570	13316708	1089	139	20248	6125	19159	5986	7.83453237410072	3.200634814567324
chr6	TBC1D7	13325093	13325174	47	82	20248	6125	20201	6043	0.573170731707317	3.3428760549395995
chr6	MCUR1	13803729	13804315	1210	587	303280	4201	302070	3614	2.061328790459966	83.58328721638074
chr6	LINC01108	14283944	14284180	0	237	0	3700	0	3463	0.0	0.0
chr6	AL138720.1	15053030	15053186	0	157	0	3665	0	3508	0.0	0.0
chr6	AL138720.1	14997415	14997475	0	61	0	3665	0	3604	0.0	0.0
chr6	DTNBP1	15651312	15651363	0	52	86756	2096	86756	2044	0.0	42.44422700587084
chr6	DTNBP1	15651312	15651408	0	97	86756	2096	86756	1999	0.0	43.399699849924964
chr6	DTNBP1	15652086	15652140	0	55	86756	2096	86756	2041	0.0	42.506614404703576
chr6	DTNBP1	15660382	15660521	245	140	86756	2096	86511	1956	1.75	44.22852760736196
chr6	ATXN1	16754042	16754091	0	50	159353	17696	159353	17646	0.0	9.030545166043296
chr6	ATXN1	16753232	16753347	0	116	159353	17696	159353	17580	0.0	9.064448236632536
chr6	NUP153	17639938	17640064	0	127	444330	6144	444330	6017	0.0	73.84577031743393
chr6	NUP153	17651833	17651926	588	94	444330	6144	443742	6050	6.25531914893617	73.34578512396695
chr6	KIF13A	17794248	17794395	102	148	261419	10432	261317	10284	0.6891891891891891	25.410054453520033
chr6	KIF13A	17898167	17898180	0	14	261419	10432	261419	10418	0.0	25.09301209445191
chr6	KIF13A	17771113	17771218	359	106	261419	10432	261060	10326	3.3867924528301887	25.28181289947705
chr6	KIF13A	17789871	17789910	194	40	261419	10432	261225	10392	4.85	25.137124711316396
chr6	KIF13A	17821785	17821905	255	121	261419	10432	261164	10311	2.1074380165289255	25.328678110755504
chr6	DEK	18258303	18258405	0	103	695559	4668	695559	4565	0.0	152.36779846659365
chr6	DEK	18263842	18263996	381	155	695559	4668	695178	4513	2.458064516129032	154.03899844892533
chr6	DEK	18244507	18244603	483	97	695559	4668	695076	4571	4.979381443298969	152.06213082476484
chr6	LNC-LBCS	19785392	19785440	0	49	11739	12676	11739	12627	0.0	0.9296745070087907
chr6	LNC-LBCS	19600835	19600948	0	114	11739	12676	11739	12562	0.0	0.9344849546250596
chr6	LNC-LBCS	19639262	19639454	0	193	11739	12676	11739	12483	0.0	0.9403989425618842
chr6	LNC-LBCS	19675358	19675425	0	68	11739	12676	11739	12608	0.0	0.9310755076142132
chr6	LNC-LBCS	19784467	19784589	0	123	11739	12676	11739	12553	0.0	0.935154943041504
chr6	LNC-LBCS	19802086	19802156	0	71	11739	12676	11739	12605	0.0	0.9312971043236811
chr6	LNC-LBCS	19749647	19749758	0	112	11739	12676	11739	12564	0.0	0.9343361986628462
chr6	LNC-LBCS	19690923	19691023	0	101	11739	12676	11739	12575	0.0	0.9335188866799204
chr6	LNC-LBCS	19803507	19803910	5359	404	11739	12676	6380	12272	13.264851485148515	0.5198826597131682
chr6	LNC-LBCS	19744030	19744134	0	105	11739	12676	11739	12571	0.0	0.9338159255429163
chr6	LNC-LBCS	19804170	19804277	0	108	11739	12676	11739	12568	0.0	0.9340388287714831
chr6	AL132775.2	20332380	20332489	0	110	0	1994	0	1884	0.0	0.0
chr6	PRL	22290173	22290353	0	181	0	1437	0	1256	0.0	0.0
chr6	GPLD1	24486074	24486130	0	57	33099	7249	33099	7192	0.0	4.602196885428254
chr6	KIAA0319	24600618	24600709	0	92	13752	7093	13752	7001	0.0	1.9642908155977719
chr6	RIPOR2	24847541	24847691	0	151	0	9468	0	9317	0.0	0.0
chr6	RIPOR2	24898400	24898566	0	167	0	9468	0	9301	0.0	0.0
chr6	CMAHP	25091895	25092012	0	118	317	7466	317	7348	0.0	0.04314099074578116
chr6	CMAHP	25084652	25084832	0	181	317	7466	317	7285	0.0	0.043514070006863415
chr6	CMAHP	25119133	25119230	0	98	317	7466	317	7368	0.0	0.04302388707926167
chr6	SLC17A1	25812830	25812992	0	163	0	2032	0	1869	0.0	0.0
chr6	SLC17A1	25813094	25813213	0	120	0	2032	0	1912	0.0	0.0
chr6	SLC17A3	25861795	25862029	0	235	0	3608	0	3373	0.0	0.0
chr6	SLC17A3	25861623	25861711	0	89	0	3608	0	3519	0.0	0.0
chr6	SLC17A2	25915498	25915646	0	149	0	2580	0	2431	0.0	0.0
chr6	ZNF322	26643658	26643728	0	71	95513	5066	95513	4995	0.0	19.121721721721723
chr6	ZNF322	26658557	26658646	150	90	95513	5066	95363	4976	1.6666666666666667	19.16459003215434
chr6	ZNF322	26658776	26658851	352	76	95513	5066	95161	4990	4.631578947368421	19.070340681362726
chr6	GUSBP2	26887963	26888051	35	89	35	2081	0	1992	0.39325842696629215	0.0
chr6	ZSCAN16-AS1	28125622	28125819	7132	198	89781	5751	82649	5553	36.02020202020202	14.883666486583829
chr6	ZSCAN31	28329302	28329778	0	477	12071	3678	12071	3201	0.0	3.7710090596688537
chr6	ZSCAN31	28337755	28337893	51	139	12071	3678	12020	3539	0.3669064748201439	3.396439672223792
chr6	ZSCAN31	28341745	28341792	172	48	12071	3678	11899	3630	3.5833333333333335	3.277961432506887
chr6	ZSCAN31	28332284	28332393	864	110	12071	3678	11207	3568	7.8545454545454545	3.14097533632287
chr6	ZSCAN31	28341745	28341795	184	51	12071	3678	11887	3627	3.607843137254902	3.277364212848084
chr6	ZSCAN31	28329302	28329714	0	413	12071	3678	12071	3265	0.0	3.6970903522205205
chr6	ZSCAN31	28337798	28337893	51	96	12071	3678	12020	3582	0.53125	3.3556672250139585
chr6	ZSCAN23	28435459	28435607	0	149	0	3288	0	3139	0.0	0.0
chr6	ZSCAN23	28435858	28436343	0	486	0	3288	0	2802	0.0	0.0
chr6	GPX6	28505702	28505802	0	101	0	2026	0	1925	0.0	0.0
chr6	TRIM27	28907491	28907563	146	73	1345	5195	1199	5122	2.0	0.2340882467786021
chr6	GABBR1	29609228	29609379	0	152	191017	8494	191017	8342	0.0	22.898225845121075
chr6	GABBR1	29630521	29630643	0	123	191017	8494	191017	8371	0.0	22.818898578425518
chr6	GABBR1	29630457	29630643	0	187	191017	8494	191017	8307	0.0	22.994703262308896
chr6	ZFP57	29676880	29677366	0	487	0	2090	0	1603	0.0	0.0
chr6	ZNRD1ASP	30021666	30021761	0	96	38940	9881	38940	9785	0.0	3.9795605518650996
chr6	ZNRD1ASP	30060740	30060995	0	256	38940	9881	38940	9625	0.0	4.045714285714285
chr6	ZNRD1ASP	30057090	30057717	0	628	38940	9881	38940	9253	0.0	4.208364854641737
chr6	TRIM26	30204655	30204765	0	111	3450	3810	3450	3699	0.0	0.9326845093268451
chr6	TRIM26	30201034	30201138	0	105	3450	3810	3450	3705	0.0	0.9311740890688259
chr6	HCG18	30294470	30294964	3298	495	134925	15541	131627	15046	6.6626262626262625	8.748305197394656
chr6	HCG18	30314268	30314482	26664	215	134925	15541	108261	15326	124.01860465116279	7.063878376614903
chr6	HCG18	30291536	30292599	890	1064	134925	15541	134035	14477	0.8364661654135338	9.258478966636734
chr6	HCG18	30291536	30291982	350	447	134925	15541	134575	15094	0.7829977628635347	8.915794355372995
chr6	HCG18	30291536	30294964	32028	3429	134925	15541	102897	12112	9.340332458442695	8.495459048877146
chr6	HCG18	30326150	30326263	0	114	134925	15541	134925	15427	0.0	8.746029688208985
chr6	HCG18	30296131	30296237	412	107	134925	15541	134513	15434	3.850467289719626	8.715368666580277
chr6	HCG18	30294852	30294964	351	113	134925	15541	134574	15428	3.106194690265487	8.72271195229453
chr6	PPP1R18	30684407	30684544	0	138	30258	4135	30258	3997	0.0	7.570177633224919
chr6	PPP1R18	30684407	30686046	8411	1640	30258	4135	21847	2495	5.128658536585366	8.756312625250501
chr6	NRM	30689275	30689452	1271	178	7539171	2051	7537900	1873	7.140449438202247	4024.5061398825414
chr6	NRM	30690046	30690243	6828	198	7539171	2051	7532343	1853	34.484848484848484	4064.9449541284403
chr6	MDC1	30707565	30708357	240775	793	598719	7574	357944	6781	303.62547288776796	52.78631470284619
chr6	FLOT1	30741613	30741704	0	92	151	3108	151	3016	0.0	0.05006631299734748
chr6	FLOT1	30741791	30741867	0	77	151	3108	151	3031	0.0	0.04981854173540086
chr6	FLOT1	30741661	30741704	0	44	151	3108	151	3064	0.0	0.04928198433420366
chr6	CCHCR1	31143261	31143413	3841	153	13501	4266	9660	4113	25.104575163398692	2.348650619985412
chr6	CCHCR1	31154495	31154799	0	305	13501	4266	13501	3961	0.0	3.408482706387276
chr6	CCHCR1	31157022	31157089	0	68	13501	4266	13501	4198	0.0	3.2160552644116245
chr6	CCHCR1	31157022	31157155	0	134	13501	4266	13501	4132	0.0	3.2674249757986447
chr6	CCHCR1	31148891	31148984	234	94	13501	4266	13267	4172	2.4893617021276597	3.1800095877277084
chr6	CCHCR1	31148891	31148987	240	97	13501	4266	13261	4169	2.4742268041237114	3.1808587191172943
chr6	CCHCR1	31157384	31157500	0	117	13501	4266	13501	4149	0.0	3.254037117377681
chr6	CCHCR1	31157357	31157500	0	144	13501	4266	13501	4122	0.0	3.2753517709849587
chr6	HLA-B	31355106	31355223	0	118	176	2543	176	2425	0.0	0.07257731958762886
chr6	DDX39B	31541152	31541327	0	176	559	3454	559	3278	0.0	0.1705308114704088
chr6	LTB	31581813	31581859	16	47	67	1356	51	1309	0.3404255319148936	0.03896103896103896
chr6	BAG6	31639499	31639646	3027	148	87466	5364	84439	5216	20.4527027027027	16.188458588957054
chr6	BAG6	31640384	31640528	401	145	87466	5364	87065	5219	2.7655172413793103	16.68231461965894
chr6	BAG6	31644524	31644602	2623	79	87466	5364	84843	5285	33.20253164556962	16.053547776726585
chr6	BAG6	31647590	31647826	51	237	87466	5364	87415	5127	0.21518987341772153	17.04993173395748
chr6	BAG6	31648910	31648964	133	55	87466	5364	87333	5309	2.418181818181818	16.449990582030516
chr6	BAG6	31644081	31644194	0	114	87466	5364	87466	5250	0.0	16.660190476190476
chr6	BAG6	31644306	31644414	0	109	87466	5364	87466	5255	0.0	16.644338725023786
chr6	BAG6	31644524	31644629	2854	106	87466	5364	84612	5258	26.92452830188679	16.09205020920502
chr6	ABHD16A	31696947	31697033	1153	87	9287	3670	8134	3583	13.25287356321839	2.270164666480603
chr6	ABHD16A	31701273	31701340	0	68	9287	3670	9287	3602	0.0	2.5782898389783453
chr6	ABHD16A	31702073	31702130	265	58	9287	3670	9022	3612	4.568965517241379	2.4977851605758583
chr6	LY6G6C	31720952	31721063	8276	112	30014	1008	21738	896	73.89285714285714	24.261160714285715
chr6	DDAH2	31728450	31728524	9090	75	146051	2151	136961	2076	121.2	65.97350674373796
chr6	DDAH2	31728864	31729221	6569	358	146051	2151	139482	1793	18.349162011173185	77.792526491913
chr6	DDAH2	31728864	31729225	6569	362	146051	2151	139482	1789	18.146408839779006	77.96646171045276
chr6	LSM2	31798476	31798507	0	32	492649	1066	492649	1034	0.0	476.4497098646035
chr6	LSM2	31797989	31798049	245	61	492649	1066	492404	1005	4.016393442622951	489.9542288557214
chr6	LSM2	31806074	31806142	4015	69	492649	1066	488634	997	58.18840579710145	490.10431293881646
chr6	SLC44A4	31870602	31870702	966	101	22450	3391	21484	3290	9.564356435643564	6.530091185410335
chr6	SLC44A4	31874720	31874846	0	127	22450	3391	22450	3264	0.0	6.878063725490196
chr6	EHMT2	31888968	31889070	0	103	153	6358	153	6255	0.0	0.02446043165467626
chr6	NELFE	31957317	31957435	0	119	1512	2493	1512	2374	0.0	0.636899747262005
chr6	DXO	31971319	31971725	0	407	1082	1879	1082	1472	0.0	0.7350543478260869
chr6	DXO	31971319	31971681	0	363	1082	1879	1082	1516	0.0	0.7137203166226913
chr6	TNXB	32087250	32087991	51830	742	320292	15410	268462	14668	69.85175202156334	18.30256340332697
chr6	PRRT1	32150367	32150583	7099	217	208140	2230	201041	2013	32.714285714285715	99.87133631395926
chr6	PRRT1	32150367	32150906	14482	540	208140	2230	193658	1690	26.81851851851852	114.5905325443787
chr6	AL662884.3	32152971	32153172	60161	202	230672	1064	170511	862	297.8267326732673	197.80858468677494
chr6	AGER	32181605	32181632	0	28	0	1715	0	1687	0.0	0.0
chr6	NOTCH4	32212823	32212911	0	89	181	9201	181	9112	0.0	0.019863915715539946
chr6	TSBP1	32315771	32315792	0	22	34062	2235	34062	2213	0.0	15.391775869859918
chr6	TSBP1	32343237	32343258	0	22	34062	2235	34062	2213	0.0	15.391775869859918
chr6	TSBP1	32366166	32366187	0	22	34062	2235	34062	2213	0.0	15.391775869859918
chr6	TSBP1	32316393	32316414	0	22	34062	2235	34062	2213	0.0	15.391775869859918
chr6	TSBP1	32324655	32324679	0	25	34062	2235	34062	2210	0.0	15.412669683257919
chr6	TSBP1	32366386	32366419	0	34	34062	2235	34062	2201	0.0	15.475692866878692
chr6	HLA-DQB1	32664797	32665067	0	271	0	3879	0	3608	0.0	0.0
chr6	HLA-DQB1	32660858	32660882	0	25	0	3879	0	3854	0.0	0.0
chr6	HLA-DQB1	32661346	32661457	0	112	0	3879	0	3767	0.0	0.0
chr6	HLA-DQB2	32757280	32757304	0	25	0	2031	0	2006	0.0	0.0
chr6	HLA-DQB2	32757772	32757883	0	112	0	2031	0	1919	0.0	0.0
chr6	HLA-DMB	32935341	32935377	185	37	6381	2610	6196	2573	5.0	2.408083948698018
chr6	HLA-DMB	32935535	32935652	0	118	6381	2610	6381	2492	0.0	2.560593900481541
chr6	HLA-DMA	32950518	32950803	432	286	60930	2526	60498	2240	1.5104895104895104	27.008035714285715
chr6	HLA-DMA	32952283	32952461	0	179	60930	2526	60930	2347	0.0	25.960801022582018
chr6	HLA-DPA1	33073470	33073669	0	200	0	3195	0	2995	0.0	0.0
chr6	HLA-DPA1	33073470	33073772	0	303	0	3195	0	2892	0.0	0.0
chr6	COL11A2	33184991	33185054	0	64	1189981	6807	1189981	6743	0.0	176.47649414207325
chr6	COL11A2	33184144	33184324	0	181	1189981	6807	1189981	6626	0.0	179.59266525807425
chr6	COL11A2	33185700	33185778	0	79	1189981	6807	1189981	6728	0.0	176.8699464922711
chr6	RXRB	33199168	33199416	0	249	51	3784	51	3535	0.0	0.014427157001414427
chr6	VPS52	33269998	33270051	579	54	1362698	3958	1362119	3904	10.722222222222221	348.90343237704917
chr6	RGL2	33296027	33296325	0	299	1564	4078	1564	3779	0.0	0.4138661021434242
chr6	RGL2	33298454	33298651	0	198	1564	4078	1564	3880	0.0	0.40309278350515465
chr6	TAPBP	33313216	33313477	0	262	0	4844	0	4582	0.0	0.0
chr6	TAPBP	33313693	33313864	0	172	0	4844	0	4672	0.0	0.0
chr6	TAPBP	33308104	33308158	0	55	0	4844	0	4789	0.0	0.0
chr6	DAXX	33320735	33321567	0	833	102	2984	102	2151	0.0	0.04741980474198047
chr6	DAXX	33321718	33321977	0	260	102	2984	102	2724	0.0	0.037444933920704845
chr6	DAXX	33321718	33321974	0	257	102	2984	102	2727	0.0	0.0374037403740374
chr6	DAXX	33321718	33322008	0	291	102	2984	102	2693	0.0	0.037875974749350165
chr6	CUTA	33416919	33416969	2282	51	88350	1281	86068	1230	44.745098039215684	69.9739837398374
chr6	BAK1	33574505	33574525	0	21	51	2219	51	2198	0.0	0.023202911737943584
chr6	UQCC2	33701345	33701420	0	76	51	2323	51	2247	0.0	0.022696929238985315
chr6	IP6K3	33739132	33739261	29476	130	30795	2801	1319	2671	226.73846153846154	0.4938225383751404
chr6	IP6K3	33746587	33746633	44	47	30795	2801	30751	2754	0.9361702127659575	11.165940450254176
chr6	LINC01016	33892316	33892451	0	136	0	1879	0	1743	0.0	0.0
chr6	GRM4	34056543	34056684	0	142	102	14402	102	14260	0.0	0.007152875175315568
chr6	GRM4	34091882	34092099	0	218	102	14402	102	14184	0.0	0.0071912013536379014
chr6	SMIM29	34247466	34247492	3102	27	173291	1694	170189	1667	114.88888888888889	102.09298140371925
chr6	RPS10-NUDT3	34341861	34341972	0	112	6011	5240	6011	5128	0.0	1.172191887675507
chr6	RPS10	34417797	34417897	0	101	0	2123	0	2022	0.0	0.0
chr6	SPDEF	34539514	34539562	0	49	118914	1920	118914	1871	0.0	63.556386958845536
chr6	ILRUN	34646600	34646798	0	199	2397	4557	2397	4358	0.0	0.5500229463056447
chr6	TAF11	34879625	34879736	102	112	897	1995	795	1883	0.9107142857142857	0.4221986192246415
chr6	TAF11	34879966	34880063	0	98	897	1995	897	1897	0.0	0.4728518713758566
chr6	TCP11	35136106	35136203	0	98	0	3084	0	2986	0.0	0.0
chr6	TCP11	35129061	35129182	0	122	0	3084	0	2962	0.0	0.0
chr6	TCP11	35140814	35140884	0	71	0	3084	0	3013	0.0	0.0
chr6	TCP11	35136106	35136218	0	113	0	3084	0	2971	0.0	0.0
chr6	TCP11	35140019	35140225	0	207	0	3084	0	2877	0.0	0.0
chr6	TCP11	35140746	35140884	0	139	0	3084	0	2945	0.0	0.0
chr6	TCP11	35128282	35128419	0	138	0	3084	0	2946	0.0	0.0
chr6	TCP11	35140505	35140597	0	93	0	3084	0	2991	0.0	0.0
chr6	TCP11	35128579	35128791	0	213	0	3084	0	2871	0.0	0.0
chr6	TCP11	35137690	35137852	0	163	0	3084	0	2921	0.0	0.0
chr6	TULP1	35506273	35506279	0	7	0	2931	0	2924	0.0	0.0
chr6	TULP1	35511647	35511806	0	160	0	2931	0	2771	0.0	0.0
chr6	FKBP5	35591129	35591220	0	92	204	10641	204	10549	0.0	0.019338325907668975
chr6	CLPS	35795730	35795853	0	124	0	605	0	481	0.0	0.0
chr6	SRPK1	35870280	35870494	162	215	20384	6252	20222	6037	0.7534883720930232	3.3496769918833857
chr6	SRPK1	35904878	35904974	0	97	20384	6252	20384	6155	0.0	3.311779041429732
chr6	ETV7	36371329	36371560	0	232	35	2383	35	2151	0.0	0.016271501627150162
chr6	ETV7	36375870	36376035	0	166	35	2383	35	2217	0.0	0.015787099684258007
chr6	ETV7	36385533	36385669	0	137	35	2383	35	2246	0.0	0.015583259127337488
chr6	ETV7	36375829	36376035	35	207	35	2383	0	2176	0.16908212560386474	0.0
chr6	CPNE5	36753033	36753095	0	63	39194	5796	39194	5733	0.0	6.836560265131694
chr6	CPNE5	36792395	36792446	0	52	39194	5796	39194	5744	0.0	6.8234679665738165
chr6	CPNE5	36792395	36792443	0	49	39194	5796	39194	5747	0.0	6.819906037932834
chr6	MTCH1	36976497	36976598	0	102	0	3138	0	3036	0.0	0.0
chr6	TMEM217	37218425	37219041	0	617	727	2617	727	2000	0.0	0.3635
chr6	TMEM217	37213210	37213319	0	110	727	2617	727	2507	0.0	0.2899880335061827
chr6	TMEM217	37215197	37215282	42	86	727	2617	685	2531	0.4883720930232558	0.27064401422362705
chr6	TMEM217	37218474	37219041	0	568	727	2617	727	2049	0.0	0.3548072230356271
chr6	TMEM217	37215940	37215966	0	27	727	2617	727	2590	0.0	0.2806949806949807
chr6	MDGA1	37645932	37645956	0	25	2144	12747	2144	12722	0.0	0.16852696116962743
chr6	BTBD9	38612833	38613033	152	201	185	9553	33	9352	0.7562189054726368	0.0035286569717707444
chr6	BTBD9	38504493	38504562	0	70	185	9553	185	9483	0.0	0.019508594326689867
chr6	BTBD9	38402816	38402903	29	88	185	9553	156	9465	0.32954545454545453	0.01648177496038035
chr6	KCNK17	39300372	39300523	0	152	0	2085	0	1933	0.0	0.0
chr6	KCNK16	39316301	39316442	0	142	23	1981	23	1839	0.0	0.012506797172376292
chr6	KIF6	39346475	39346526	0	52	102	11899	102	11847	0.0	0.008609774626487718
chr6	DAAM2-AS1	39891622	39891763	108	142	8192	6427	8084	6285	0.7605633802816901	1.2862370723945904
chr6	DAAM2-AS1	39891305	39891379	0	75	8192	6427	8192	6352	0.0	1.2896725440806045
chr6	MOCS1	39909039	39909102	0	64	0	5101	0	5037	0.0	0.0
chr6	MOCS1	39909054	39909102	0	49	0	5101	0	5052	0.0	0.0
chr6	MOCS1	39927328	39927455	0	128	0	5101	0	4973	0.0	0.0
chr6	MOCS1	39927183	39927455	0	273	0	5101	0	4828	0.0	0.0
chr6	UNC5CL	41031680	41031748	0	69	54224	3165	54224	3096	0.0	17.51421188630491
chr6	OARD1	41068840	41068953	3666	114	556209	6234	552543	6120	32.1578947368421	90.28480392156862
chr6	OARD1	41071595	41071675	0	81	556209	6234	556209	6153	0.0	90.39639200390053
chr6	OARD1	41070075	41070134	1139	60	556209	6234	555070	6174	18.983333333333334	89.90443796566245
chr6	TREML1	41153757	41154090	0	334	0	1489	0	1155	0.0	0.0
chr6	TREML1	41150260	41150313	0	54	0	1489	0	1435	0.0	0.0
chr6	TREM2	41158872	41159106	0	235	0	1100	0	865	0.0	0.0
chr6	TREM2	41158872	41159066	0	195	0	1100	0	905	0.0	0.0
chr6	TREM1	41280960	41281153	0	194	0	5896	0	5702	0.0	0.0
chr6	TFEB	41690662	41690917	0	256	512	5743	512	5487	0.0	0.09331146345908511
chr6	TFEB	41732648	41732739	0	92	512	5743	512	5651	0.0	0.0906034330207043
chr6	TFEB	41732648	41732767	0	120	512	5743	512	5623	0.0	0.09105459719011204
chr6	USP49	41803805	41804010	0	206	33673	10934	33673	10728	0.0	3.1387956748695003
chr6	USP49	41891793	41891875	4	83	33673	10934	33669	10851	0.04819277108433735	3.1028476638097873
chr6	MED20	41916784	41916939	0	156	97447	3286	97447	3130	0.0	31.133226837060704
chr6	MED20	41917794	41917916	0	123	97447	3286	97447	3163	0.0	30.808409737590896
chr6	CCND3	41936558	41936695	0	138	42639	5772	42639	5634	0.0	7.568157614483493
chr6	CCND3	42030008	42030190	279	183	42639	5772	42360	5589	1.5245901639344261	7.5791733762748255
chr6	CCND3	41940369	41940585	0	217	42639	5772	42639	5555	0.0	7.675787578757876
chr6	CCND3	41940951	41941161	0	211	42639	5772	42639	5561	0.0	7.667505844272613
chr6	TRERF1	42263259	42263568	0	310	56006	7750	56006	7440	0.0	7.52768817204301
chr6	TRERF1	42263319	42263568	0	250	56006	7750	56006	7500	0.0	7.467466666666667
chr6	MRPL2	43055544	43055618	42	75	1088	1897	1046	1822	0.56	0.5740944017563118
chr6	CRIP3	43306066	43306124	6838	59	98635	2357	91797	2298	115.89830508474576	39.94647519582245
chr6	CRIP3	43306445	43306517	3762	73	98635	2357	94873	2284	51.534246575342465	41.53809106830123
chr6	YIPF3	43515594	43515701	0	108	97145	2603	97145	2495	0.0	38.93587174348698
chr6	YIPF3	43515605	43515701	0	97	97145	2603	97145	2506	0.0	38.76496408619314
chr6	YIPF3	43515192	43515306	234	115	97145	2603	96911	2488	2.034782608695652	38.95136655948553
chr6	XPO5	43558500	43558591	0	92	125777	7753	125777	7661	0.0	16.417830570421614
chr6	XPO5	43547315	43547453	0	139	125777	7753	125777	7614	0.0	16.519175203572367
chr6	MRPS18A	43675201	43675271	0	71	0	1390	0	1319	0.0	0.0
chr6	LINC02537	43851588	43851886	0	299	0	2071	0	1772	0.0	0.0
chr6	AL109615.3	44000590	44000715	0	126	1900	2900	1900	2774	0.0	0.684931506849315
chr6	SLC35B2	44256684	44256878	0	195	102	2369	102	2174	0.0	0.046918123275068994
chr6	SLC35B2	44256341	44256496	0	156	102	2369	102	2213	0.0	0.04609127880704925
chr6	NFKBIE	44262559	44262662	0	104	184	2060	184	1956	0.0	0.09406952965235174
chr6	TCTE1	44282109	44282559	0	451	55573	3091	55573	2640	0.0	21.05037878787879
chr6	CLIC5	45883752	45883828	0	77	51	6919	51	6842	0.0	0.007453960830166618
chr6	CLIC5	45913777	45913812	0	36	51	6919	51	6883	0.0	0.007409559784977481
chr6	AL035701.1	46122947	46123109	0	163	646	1897	646	1734	0.0	0.37254901960784315
chr6	ENPP5	46170052	46170114	0	63	51	4280	51	4217	0.0	0.012093905620109082
chr6	CYP39A1	46630962	46631070	0	109	277	3125	277	3016	0.0	0.09184350132625994
chr6	CYP39A1	46639493	46639668	0	176	277	3125	277	2949	0.0	0.09393014581213971
chr6	ADGRF1	47016616	47016768	0	153	204	10686	204	10533	0.0	0.01936770150954144
chr6	ADGRF1	47027703	47027761	0	59	204	10686	204	10627	0.0	0.019196386562529408
chr6	ADGRF1	47028992	47029104	0	113	204	10686	204	10573	0.0	0.01929442920646931
chr6	ADGRF1	47018479	47018582	0	104	204	10686	204	10582	0.0	0.019278019278019278
chr6	RHAG	49606847	49606921	0	75	0	2083	0	2008	0.0	0.0
chr6	RHAG	49611023	49611145	0	123	0	2083	0	1960	0.0	0.0
chr6	RHAG	49606728	49606921	0	194	0	2083	0	1889	0.0	0.0
chr6	CRISP2	49697675	49697780	0	106	51	1529	51	1423	0.0	0.035839775122979624
chr6	CRISP2	49711284	49711321	0	38	51	1529	51	1491	0.0	0.03420523138832998
chr6	CRISP1	49838436	49838525	0	90	0	2016	0	1926	0.0	0.0
chr6	AL135908.1	50599464	50599517	26	54	26	833	0	779	0.48148148148148145	0.0
chr6	MCM3	52283293	52283406	0	114	9120	3663	9120	3549	0.0	2.569737954353339
chr6	MCM3	52265234	52265385	0	152	9120	3663	9120	3511	0.0	2.597550555397323
chr6	GSTA1	52796181	52796314	0	134	51	1269	51	1135	0.0	0.044933920704845816
chr6	GSTA1	52797585	52797637	0	53	51	1269	51	1216	0.0	0.04194078947368421
chr6	GSTA5	52836235	52836368	0	134	0	898	0	764	0.0	0.0
chr6	GSTA3	52903675	52903727	13	53	362	905	349	852	0.24528301886792453	0.4096244131455399
chr6	GSTA3	52905747	52905855	0	109	362	905	362	796	0.0	0.4547738693467337
chr6	GSTA9P	52945006	52945104	0	99	5128	896	5128	797	0.0	6.4341279799247175
chr6	GSTA4	52985450	52985583	0	134	51	2109	51	1975	0.0	0.025822784810126582
chr6	GSTA4	52987356	52987408	0	53	51	2109	51	2056	0.0	0.02480544747081712
chr6	CILK1	53060935	53061046	0	112	0	6317	0	6205	0.0	0.0
chr6	ELOVL5	53273219	53273344	0	126	0	3826	0	3700	0.0	0.0
chr6	ELOVL5	53287861	53287942	0	82	0	3826	0	3744	0.0	0.0
chr6	GCLC	53516108	53516222	0	115	227	8525	227	8410	0.0	0.02699167657550535
chr6	GCLC	53516108	53516240	0	133	227	8525	227	8392	0.0	0.027049571020019064
chr6	GCLC	53516108	53516217	0	110	227	8525	227	8415	0.0	0.026975638740344622
chr6	AL033397.1	53573199	53573275	0	77	0	3858	0	3781	0.0	0.0
chr6	AL033397.1	53569422	53569605	0	184	0	3858	0	3674	0.0	0.0
chr6	AL033397.1	53569479	53569605	0	127	0	3858	0	3731	0.0	0.0
chr6	AL033397.1	53569422	53569584	0	163	0	3858	0	3695	0.0	0.0
chr6	AL590652.1	53746515	53746603	0	89	46	4495	46	4406	0.0	0.01044030866999546
chr6	MLIP-AS1	54032376	54032436	0	61	0	4048	0	3987	0.0	0.0
chr6	MLIP-AS1	54030618	54030659	0	42	0	4048	0	4006	0.0	0.0
chr6	MLIP-AS1	54045537	54045825	0	289	0	4048	0	3759	0.0	0.0
chr6	MLIP-AS1	54043351	54043427	0	77	0	4048	0	3971	0.0	0.0
chr6	MLIP-AS1	54057946	54058000	0	55	0	4048	0	3993	0.0	0.0
chr6	HMGCLL1	55516507	55516603	0	97	51	4792	51	4695	0.0	0.010862619808306708
chr6	HMGCLL1	55577077	55577167	0	91	51	4792	51	4701	0.0	0.010848755583918315
chr6	HMGCLL1	55563818	55563914	0	97	51	4792	51	4695	0.0	0.010862619808306708
chr6	HMGCLL1	55566503	55566628	0	126	51	4792	51	4666	0.0	0.01093013287612516
chr6	HMGCLL1	55495418	55495607	0	190	51	4792	51	4602	0.0	0.01108213820078227
chr6	COL21A1	56078092	56078188	0	97	70	6096	70	5999	0.0	0.011668611435239206
chr6	COL21A1	56156886	56156949	0	64	70	6096	70	6032	0.0	0.011604774535809019
chr6	COL21A1	56164813	56164822	0	10	70	6096	70	6086	0.0	0.011501807426881366
chr6	COL21A1	56231060	56231134	0	75	70	6096	70	6021	0.0	0.01162597575153629
chr6	COL21A1	56225859	56225911	0	53	70	6096	70	6043	0.0	0.0115836505047162
chr6	DST	56463045	56463156	52	112	32143	43263	32091	43151	0.4642857142857143	0.7436907603531784
chr6	DST	56468981	56468999	19	19	32143	43263	32124	43244	1.0	0.7428545000462492
chr6	DST	56529447	56529774	0	328	32143	43263	32143	42935	0.0	0.7486432980086177
chr6	DST	56464684	56464756	0	73	32143	43263	32143	43190	0.0	0.7442231998147719
chr6	DST	56617985	56620715	612	2731	32143	43263	31531	40532	0.22409373855730502	0.7779285502812593
chr6	ZNF451-AS1	57134146	57134215	0	70	204	4544	204	4474	0.0	0.045596781403665625
chr6	ZNF451-AS1	57116037	57116127	51	91	204	4544	153	4453	0.5604395604395604	0.03435885919604761
chr6	ZNF451-AS1	57116425	57116547	0	123	204	4544	204	4421	0.0	0.04614340646912463
chr6	ZNF451-AS1	57115455	57115563	0	109	204	4544	204	4435	0.0	0.045997745208568204
chr6	ZNF451-AS1	57151822	57151906	0	85	204	4544	204	4459	0.0	0.04575016819914779
chr6	ZNF451-AS1	57151027	57151195	0	169	204	4544	204	4375	0.0	0.04662857142857143
chr6	ZNF451-AS1	57150902	57150946	0	45	204	4544	204	4499	0.0	0.04534340964658813
chr6	AL021368.4	57929044	57929132	0	89	0	682	0	593	0.0	0.0
chr6	LINC00680	57961151	57961224	0	74	0	2185	0	2111	0.0	0.0
chr6	LINC00680	57949858	57950011	0	154	0	2185	0	2031	0.0	0.0
chr6	KHDRBS2	61707329	61707403	0	75	0	2413	0	2338	0.0	0.0
chr6	EYS	63741912	63741975	0	64	102	17124	102	17060	0.0	0.005978898007033997
chr6	EYS	65491356	65491589	0	234	102	17124	102	16890	0.0	0.006039076376554174
chr6	AL713998.1	67886967	67887398	0	432	51	5335	51	4903	0.0	0.010401794819498267
chr6	AL713998.1	67883603	67883876	0	274	51	5335	51	5061	0.0	0.01007705986959099
chr6	AL713998.1	67886967	67888821	51	1855	51	5335	0	3480	0.027493261455525605	0.0
chr6	AL713998.1	67886967	67887069	0	103	51	5335	51	5232	0.0	0.00974770642201835
chr6	AL713998.1	67886986	67887398	0	413	51	5335	51	4922	0.0	0.01036164160910199
chr6	AL713998.1	67883705	67883876	0	172	51	5335	51	5163	0.0	0.009877977919814061
chr6	AL606923.2	68512788	68512876	0	89	0	2614	0	2525	0.0	0.0
chr6	AL606923.2	68467166	68467249	0	84	0	2614	0	2530	0.0	0.0
chr6	LMBRD1	69749340	69749408	0	69	0	8302	0	8233	0.0	0.0
chr6	LMBRD1	69752258	69752356	0	99	0	8302	0	8203	0.0	0.0
chr6	LMBRD1	69708849	69709231	0	383	0	8302	0	7919	0.0	0.0
chr6	LMBRD1	69743987	69744047	0	61	0	8302	0	8241	0.0	0.0
chr6	LMBRD1	69824488	69824552	0	65	0	8302	0	8237	0.0	0.0
chr6	LMBRD1	69835856	69836035	0	180	0	8302	0	8122	0.0	0.0
chr6	LMBRD1	69755557	69755585	0	29	0	8302	0	8273	0.0	0.0
chr6	LMBRD1	69755472	69755585	0	114	0	8302	0	8188	0.0	0.0
chr6	LMBRD1	69705500	69705619	0	120	0	8302	0	8182	0.0	0.0
chr6	LMBRD1	69748223	69748289	0	67	0	8302	0	8235	0.0	0.0
chr6	LMBRD1	69743783	69743881	0	99	0	8302	0	8203	0.0	0.0
chr6	LMBRD1	69709156	69709231	0	76	0	8302	0	8226	0.0	0.0
chr6	LMBRD1	69798114	69798289	0	176	0	8302	0	8126	0.0	0.0
chr6	LMBRD1	69710424	69710444	0	21	0	8302	0	8281	0.0	0.0
chr6	LMBRD1	69796153	69796229	0	77	0	8302	0	8225	0.0	0.0
chr6	COL9A1	70241963	70242035	0	73	98	6308	98	6235	0.0	0.015717722534081796
chr6	COL9A1	70270313	70270367	0	55	98	6308	98	6253	0.0	0.01567247721093875
chr6	COL9A1	70279515	70279620	0	106	98	6308	98	6202	0.0	0.01580135440180587
chr6	AL589935.1	71302969	71303045	64	77	7201	5018	7137	4941	0.8311688311688312	1.4444444444444444
chr6	AL589935.1	71304347	71304390	0	44	7201	5018	7201	4974	0.0	1.4477281865701648
chr6	AL589935.1	71295710	71295813	0	104	7201	5018	7201	4914	0.0	1.4654049654049655
chr6	AL589935.1	71313053	71313146	0	94	7201	5018	7201	4924	0.0	1.4624289195775793
chr6	AL589935.1	71313844	71314164	0	321	7201	5018	7201	4697	0.0	1.5331062380242708
chr6	AL589935.1	71326329	71326620	0	292	7201	5018	7201	4726	0.0	1.5236986881083368
chr6	AL589935.1	71314706	71314785	0	80	7201	5018	7201	4938	0.0	1.4582827055488052
chr6	AL589935.1	71313844	71314189	0	346	7201	5018	7201	4672	0.0	1.5413099315068493
chr6	LINC00472	71346173	71346400	0	228	23316	11340	23316	11112	0.0	2.0982721382289418
chr6	LINC00472	71348526	71348610	0	85	23316	11340	23316	11255	0.0	2.071612616614838
chr6	LINC00472	71418688	71418754	0	67	23316	11340	23316	11273	0.0	2.0683047990774415
chr6	KCNQ5-AS1	73136093	73136159	0	67	0	4669	0	4602	0.0	0.0
chr6	AL356277.3	74602278	74602453	0	176	6790	1486	6790	1310	0.0	5.183206106870229
chr6	COL12A1	75138319	75138340	0	22	408	12551	408	12529	0.0	0.032564450474898234
chr6	COX7A2	75240300	75240385	0	86	0	1928	0	1842	0.0	0.0
chr6	COX7A2	75241175	75241265	0	91	0	1928	0	1837	0.0	0.0
chr6	COX7A2	75241122	75241265	0	144	0	1928	0	1784	0.0	0.0
chr6	COX7A2	75240276	75240385	0	110	0	1928	0	1818	0.0	0.0
chr6	COX7A2	75241821	75241938	0	118	0	1928	0	1810	0.0	0.0
chr6	TMEM30A	75265230	75265338	0	109	101	5513	101	5404	0.0	0.018689859363434494
chr6	TMEM30A	75267640	75267748	0	109	101	5513	101	5404	0.0	0.018689859363434494
chr6	TMEM30A	75260121	75260402	0	282	101	5513	101	5231	0.0	0.019307971707130566
chr6	IMPG1	76041892	76042126	0	235	268083	3821	268083	3586	0.0	74.75822643614055
chr6	HMGN3	79202062	79202155	0	94	0	1021	0	927	0.0	0.0
chr6	LINC02542	82059590	82059679	0	90	333	2815	333	2725	0.0	0.12220183486238533
chr6	IBTK	82214226	82214829	0	604	2552	7325	2552	6721	0.0	0.37970540098199673
chr6	IBTK	82174897	82175002	0	106	2552	7325	2552	7219	0.0	0.35351156669898876
chr6	UBE3D	83049708	83049772	0	65	6514	6416	6514	6351	0.0	1.0256652495669973
chr6	UBE3D	83032241	83032310	0	70	6514	6416	6514	6346	0.0	1.026473369051371
chr6	UBE3D	83063152	83063245	0	94	6514	6416	6514	6322	0.0	1.030370136032901
chr6	PGM3	83171936	83172059	0	124	153	5939	153	5815	0.0	0.02631126397248495
chr6	PGM3	83175961	83176060	0	100	153	5939	153	5839	0.0	0.026203116972084262
chr6	PGM3	83179809	83179967	0	159	153	5939	153	5780	0.0	0.026470588235294117
chr6	PGM3	83190808	83191014	0	207	153	5939	153	5732	0.0	0.026692254012561062
chr6	PGM3	83178672	83178756	0	85	153	5939	153	5854	0.0	0.026135975401434915
chr6	PGM3	83191186	83191323	0	138	153	5939	153	5801	0.0	0.026374762971901396
chr6	SNAP91	83556142	83556245	0	104	4795	6360	4795	6256	0.0	0.7664641943734015
chr6	SNAP91	83592454	83592538	0	85	4795	6360	4795	6275	0.0	0.7641434262948207
chr6	SNAP91	83593181	83593259	0	79	4795	6360	4795	6281	0.0	0.7634134691928037
chr6	SNAP91	83614856	83614862	0	7	4795	6360	4795	6353	0.0	0.7547615299858335
chr6	SNAP91	83623300	83623342	0	43	4795	6360	4795	6317	0.0	0.7590628462877949
chr6	SNAP91	83661501	83661604	0	104	4795	6360	4795	6256	0.0	0.7664641943734015
chr6	SNAP91	83665438	83665581	528	144	4795	6360	4267	6216	3.6666666666666665	0.6864543114543115
chr6	SNAP91	83591210	83591294	0	85	4795	6360	4795	6275	0.0	0.7641434262948207
chr6	CEP162	84217798	84217860	0	63	0	5511	0	5448	0.0	0.0
chr6	CEP162	84226336	84226452	0	117	0	5511	0	5394	0.0	0.0
chr6	CEP162	84219102	84219214	0	113	0	5511	0	5398	0.0	0.0
chr6	LINC01611	84463677	84463787	0	111	0	747	0	636	0.0	0.0
chr6	SNX14	85514069	85514234	0	166	100	7137	100	6971	0.0	0.014345144168698896
chr6	SNX14	85538837	85538864	0	28	100	7137	100	7109	0.0	0.014066676044450697
chr6	SNX14	85557975	85558060	0	86	100	7137	100	7051	0.0	0.014182385477237271
chr6	SNX14	85567533	85567577	0	45	100	7137	100	7092	0.0	0.01410039481105471
chr6	SNX14	85565331	85565419	0	89	100	7137	100	7048	0.0	0.014188422247446084
chr6	SYNCRIP	85637242	85637356	0	115	0	9811	0	9696	0.0	0.0
chr6	SYNCRIP	85641291	85641451	0	161	0	9811	0	9650	0.0	0.0
chr6	SYNCRIP	85642796	85642890	0	95	0	9811	0	9716	0.0	0.0
chr6	SYNCRIP	85637268	85637356	0	89	0	9811	0	9722	0.0	0.0
chr6	SYNCRIP	85636966	85637143	0	178	0	9811	0	9633	0.0	0.0
chr6	SNHG5	85677423	85677492	0	70	0	7815	0	7745	0.0	0.0
chr6	SNHG5	85677953	85678032	0	80	0	7815	0	7735	0.0	0.0
chr6	SNHG5	85677794	85677875	0	82	0	7815	0	7733	0.0	0.0
chr6	SNHG5	85666003	85666147	0	145	0	7815	0	7670	0.0	0.0
chr6	SNHG5	85677092	85677191	0	100	0	7815	0	7715	0.0	0.0
chr6	SNHG5	85677794	85677868	0	75	0	7815	0	7740	0.0	0.0
chr6	SNHG5	85676984	85677191	0	208	0	7815	0	7607	0.0	0.0
chr6	SNHG5	85668112	85668274	0	163	0	7815	0	7652	0.0	0.0
chr6	SNHG5	85677423	85678032	0	610	0	7815	0	7205	0.0	0.0
chr6	SNHG5	85677794	85678032	0	239	0	7815	0	7576	0.0	0.0
chr6	SNHG5	85677790	85677875	0	86	0	7815	0	7729	0.0	0.0
chr6	SNHG5	85677423	85677875	0	453	0	7815	0	7362	0.0	0.0
chr6	SNHG5	85677794	85677899	0	106	0	7815	0	7709	0.0	0.0
chr6	SNHG5	85677790	85678032	0	243	0	7815	0	7572	0.0	0.0
chr6	CGA	87094828	87094880	0	53	0	1990	0	1937	0.0	0.0
chr6	CGA	87086516	87086609	0	94	0	1990	0	1896	0.0	0.0
chr6	CGA	87088868	87089167	0	300	0	1990	0	1690	0.0	0.0
chr6	RARS2	87564543	87564662	0	120	118	2991	118	2871	0.0	0.04110066179031696
chr6	CNR1	88147663	88147806	0	144	0	2313	0	2169	0.0	0.0
chr6	RNGTT	88801563	88801632	0	70	0	5204	0	5134	0.0	0.0
chr6	AL353135.2	89132335	89132478	0	144	15	1763	15	1619	0.0	0.00926497838171711
chr6	GABRR1	89203434	89203485	0	52	51	3789	51	3737	0.0	0.013647310677013648
chr6	GABRR1	89204595	89204694	0	100	51	3789	51	3689	0.0	0.013824884792626729
chr6	RRAGD	89387294	89387590	0	297	0	5103	0	4806	0.0	0.0
chr6	BACH2	90252512	90252590	0	79	298	9799	298	9720	0.0	0.03065843621399177
chr6	BACH2	90271848	90271941	0	94	298	9799	298	9705	0.0	0.030705821741370428
chr6	MAP3K7	90544551	90544632	65	82	8564	7270	8499	7188	0.7926829268292683	1.1823873121869783
chr6	MAP3K7	90518446	90518562	210	117	8564	7270	8354	7153	1.794871794871795	1.1679015797567454
chr6	UFL1-AS1	96460485	96460612	0	128	0	6546	0	6418	0.0	0.0
chr6	UFL1-AS1	96519294	96519375	0	82	0	6546	0	6464	0.0	0.0
chr6	MMS22L	97233860	97233980	0	121	1305	18577	1305	18456	0.0	0.07070871261378414
chr6	MMS22L	97263334	97263448	0	115	1305	18577	1305	18462	0.0	0.07068573285667858
chr6	MMS22L	97270106	97270283	0	178	1305	18577	1305	18399	0.0	0.07092776781346813
chr6	FBXL4	98934761	98934879	0	119	51	8128	51	8009	0.0	0.0063678361842926705
chr6	COQ3	99375939	99376182	0	244	1628	1456	1628	1212	0.0	1.3432343234323432
chr6	PNISR	99403828	99403882	0	55	0	5565	0	5510	0.0	0.0
chr6	PNISR	99416348	99416428	0	81	0	5565	0	5484	0.0	0.0
chr6	USP45	99464603	99464747	0	145	0	7638	0	7493	0.0	0.0
chr6	USP45	99466671	99466763	0	93	0	7638	0	7545	0.0	0.0
chr6	USP45	99482752	99482883	0	132	0	7638	0	7506	0.0	0.0
chr6	USP45	99468099	99468170	0	72	0	7638	0	7566	0.0	0.0
chr6	USP45	99468536	99468618	0	83	0	7638	0	7555	0.0	0.0
chr6	CCNC	99561596	99561681	0	86	0	5627	0	5541	0.0	0.0
chr6	CCNC	99562841	99562948	0	108	0	5627	0	5519	0.0	0.0
chr6	CCNC	99549311	99549399	0	89	0	5627	0	5538	0.0	0.0
chr6	CCNC	99544178	99544273	0	96	0	5627	0	5531	0.0	0.0
chr6	CCNC	99544205	99544273	0	69	0	5627	0	5558	0.0	0.0
chr6	CCNC	99566897	99567038	0	142	0	5627	0	5485	0.0	0.0
chr6	ASCC3	100864063	100864214	0	152	1428	11774	1428	11622	0.0	0.12287041817243159
chr6	HACE1	104750340	104750472	0	133	645	9266	645	9133	0.0	0.07062301543851965
chr6	HACE1	104833041	104833173	0	133	645	9266	645	9133	0.0	0.07062301543851965
chr6	HACE1	104780352	104780457	0	106	645	9266	645	9160	0.0	0.07041484716157205
chr6	HACE1	104824813	104824907	0	95	645	9266	645	9171	0.0	0.07033038927052666
chr6	HACE1	104858393	104858532	33	140	645	9266	612	9126	0.2357142857142857	0.0670611439842209
chr6	LIN28B-AS1	104939327	104939536	0	210	51	5056	51	4846	0.0	0.010524143623607098
chr6	LINC02836	105619333	105619462	0	130	0	740	0	610	0.0	0.0
chr6	ATG5	106248149	106248244	0	96	51	5668	51	5572	0.0	0.009152907394113424
chr6	ATG5	106308363	106308491	0	129	51	5668	51	5539	0.0	0.009207438165733887
chr6	ATG5	106217463	106217601	0	139	51	5668	51	5529	0.0	0.009224091155724362
chr6	LINC02532	106733575	106733663	0	89	14827	11311	14827	11222	0.0	1.3212439850294064
chr6	LINC02532	106739700	106739770	0	71	14827	11311	14827	11240	0.0	1.3191281138790036
chr6	LINC02532	106725341	106725389	0	49	14827	11311	14827	11262	0.0	1.316551234239034
chr6	LINC02532	106726361	106726501	51	141	14827	11311	14776	11170	0.3617021276595745	1.322829006266786
chr6	LINC02532	106749633	106749788	0	156	14827	11311	14827	11155	0.0	1.3291797400268939
chr6	LINC02532	106747213	106747288	0	76	14827	11311	14827	11235	0.0	1.3197151757899421
chr6	LINC02532	106772237	106772361	0	125	14827	11311	14827	11186	0.0	1.3254961559091722
chr6	LINC02532	106756104	106756261	1393	158	14827	11311	13434	11153	8.816455696202532	1.2045189635075764
chr6	LINC02532	106774776	106775000	0	225	14827	11311	14827	11086	0.0	1.3374526429731193
chr6	LINC02532	106765017	106765219	0	203	14827	11311	14827	11108	0.0	1.3348037450486137
chr6	LINC02532	106765017	106765196	0	180	14827	11311	14827	11131	0.0	1.3320456383074297
chr6	LINC02532	106754293	106754422	0	130	14827	11311	14827	11181	0.0	1.3260889008138808
chr6	LINC02532	106755869	106755990	0	122	14827	11311	14827	11189	0.0	1.3251407632496202
chr6	LINC02532	106756416	106756457	0	42	14827	11311	14827	11269	0.0	1.3157334279882864
chr6	LINC02532	106774776	106774921	0	146	14827	11311	14827	11165	0.0	1.3279892521271832
chr6	CD24	106974577	106974754	61	178	1596	1798	1535	1620	0.34269662921348315	0.9475308641975309
chr6	SCML4	107772171	107772386	0	216	153	8568	153	8352	0.0	0.018318965517241378
chr6	SCML4	107755570	107755664	0	95	153	8568	153	8473	0.0	0.01805735866871238
chr6	SEC63	107955964	107956106	0	143	877	8629	877	8486	0.0	0.10334668866368135
chr6	SNX3	108222949	108223045	0	97	11556	1833	11556	1736	0.0	6.65668202764977
chr6	SNX3	108222233	108222320	1280	88	11556	1833	10276	1745	14.545454545454545	5.888825214899714
chr6	CD164	109370410	109370467	0	58	667	6868	667	6810	0.0	0.09794419970631424
chr6	CD164	109376073	109376112	0	40	667	6868	667	6828	0.0	0.09768599882835384
chr6	CD164	109368921	109369017	312	97	667	6868	355	6771	3.216494845360825	0.05242947865898685
chr6	PPIL6	109400034	109400170	0	137	845	4492	845	4355	0.0	0.19402985074626866
chr6	PPIL6	109436103	109436199	0	97	845	4492	845	4395	0.0	0.19226393629124006
chr6	PPIL6	109404928	109405048	0	121	845	4492	845	4371	0.0	0.193319606497369
chr6	PPIL6	109403030	109403108	0	79	845	4492	845	4413	0.0	0.19147971901200997
chr6	MICAL1	109450299	109450557	196	259	13100	5222	12904	4963	0.7567567567567568	2.60004029820673
chr6	AK9	109641517	109641616	0	100	9165	10140	9165	10040	0.0	0.9128486055776892
chr6	AK9	109675628	109675756	0	129	9165	10140	9165	10011	0.0	0.9154929577464789
chr6	WASF1	110160634	110160732	0	99	51	3135	51	3036	0.0	0.016798418972332016
chr6	WASF1	110178597	110178742	0	146	51	3135	51	2989	0.0	0.01706256273001004
chr6	WASF1	110177146	110177186	0	41	51	3135	51	3094	0.0	0.016483516483516484
chr6	DDO	110404773	110404950	0	178	0	2148	0	1970	0.0	0.0
chr6	DDO	110408333	110408442	0	110	0	2148	0	2038	0.0	0.0
chr6	SLC22A16	110456537	110456803	195	267	16922	2809	16727	2542	0.7303370786516854	6.580251770259638
chr6	CDK19	110746125	110746201	0	77	0	7662	0	7585	0.0	0.0
chr6	CDK19	110632029	110632161	0	133	0	7662	0	7529	0.0	0.0
chr6	CDK19	110638648	110638706	0	59	0	7662	0	7603	0.0	0.0
chr6	CDK19	110773875	110773937	0	63	0	7662	0	7599	0.0	0.0
chr6	REV3L	111308013	111308245	0	233	20259	12462	20259	12229	0.0	1.6566358655654592
chr6	REV3L	111358821	111359014	0	194	20259	12462	20259	12268	0.0	1.6513694163677861
chr6	REV3L	111460299	111460406	0	108	20259	12462	20259	12354	0.0	1.6398737251092763
chr6	REV3L	111472012	111472140	0	129	20259	12462	20259	12333	0.0	1.6426660180004864
chr6	TRAF3IP2	111562964	111563039	0	76	21938	7884	21938	7808	0.0	2.8096823770491803
chr6	TRAF3IP2	111601195	111601306	3	112	21938	7884	21935	7772	0.026785714285714284	2.822310859495625
chr6	TRAF3IP2	111601195	111601318	3	124	21938	7884	21935	7760	0.024193548387096774	2.8266752577319587
chr6	TRAF3IP2	111595702	111595820	2006	119	21938	7884	19932	7765	16.857142857142858	2.5669027688345136
chr6	FYN	111699514	111699670	0	157	11800	6971	11800	6814	0.0	1.7317287936601116
chr6	FYN	111780565	111780635	0	71	11800	6971	11800	6900	0.0	1.710144927536232
chr6	FYN	111846588	111846629	0	42	11800	6971	11800	6929	0.0	1.702987444075624
chr6	FYN	111700103	111700268	0	166	11800	6971	11800	6805	0.0	1.7340191036002939
chr6	FYN	111740980	111741093	0	114	11800	6971	11800	6857	0.0	1.7208691847746829
chr6	FYN	111740980	111741097	0	118	11800	6971	11800	6853	0.0	1.7218736319859915
chr6	FYN	111754433	111754677	0	245	11800	6971	11800	6726	0.0	1.7543859649122806
chr6	FYN	111813891	111814107	0	217	11800	6971	11800	6754	0.0	1.7471128220313887
chr6	TUBE1	112084188	112084246	0	59	0	6165	0	6106	0.0	0.0
chr6	LAMA4	112122013	112122201	0	189	476	11935	476	11746	0.0	0.04052443384982122
chr6	LINC02541	113623739	113623822	0	84	0	2418	0	2334	0.0	0.0
chr6	LINC02541	113649403	113649821	0	419	0	2418	0	1999	0.0	0.0
chr6	HDAC2	113962366	113962394	0	29	357	12521	357	12492	0.0	0.028578290105667627
chr6	HDAC2	113968633	113968696	0	64	357	12521	357	12457	0.0	0.02865858553423778
chr6	AL138830.1	114535715	114536066	0	352	0	826	0	474	0.0	0.0
chr6	LINC02534	115634139	115634347	0	209	0	634	0	425	0.0	0.0
chr6	LINC02534	115643109	115643142	0	34	0	634	0	600	0.0	0.0
chr6	ZUP1	116656683	116656852	0	170	527	2667	527	2497	0.0	0.21105326391670004
chr6	GPRC6A	116800583	116800796	0	214	0	2914	0	2700	0.0	0.0
chr6	ROS1	117414518	117414545	0	28	147	8935	147	8907	0.0	0.016503873358033008
chr6	GOPC	117569571	117569736	21	166	72	4637	51	4471	0.12650602409638553	0.011406844106463879
chr6	GOPC	117577447	117577471	0	25	72	4637	72	4612	0.0	0.015611448395490026
chr6	CEP85L	118664410	118664521	0	112	0	9448	0	9336	0.0	0.0
chr6	MCM9	118827926	118828130	44	205	2186	12510	2142	12305	0.2146341463414634	0.17407557903291346
chr6	MCM9	118856370	118856545	0	176	2186	12510	2186	12334	0.0	0.1772336630452408
chr6	MCM9	118932606	118932740	0	135	2186	12510	2186	12375	0.0	0.17664646464646463
chr6	FAM184A	118974427	118974574	0	148	2462	7735	2462	7587	0.0	0.32450243838144194
chr6	FAM184A	118964666	118964771	0	106	2462	7735	2462	7629	0.0	0.3227159522873247
chr6	FAM184A	118960768	118960863	0	96	2462	7735	2462	7639	0.0	0.3222934939128158
chr6	FAM184A	118961760	118961963	0	204	2462	7735	2462	7531	0.0	0.3269154162793786
chr6	TBC1D32	121205074	121205163	0	90	255	6953	255	6863	0.0	0.037155762785953665
chr6	TBC1D32	121170404	121170527	0	124	255	6953	255	6829	0.0	0.03734075267242642
chr6	TBC1D32	121139773	121139836	0	64	255	6953	255	6889	0.0	0.037015532007548264
chr6	TBC1D32	121192374	121192542	0	169	255	6953	255	6784	0.0	0.03758844339622641
chr6	TBC1D32	121224362	121224451	0	90	255	6953	255	6863	0.0	0.037155762785953665
chr6	TBC1D32	121129868	121129924	0	57	255	6953	255	6896	0.0	0.036977958236658934
chr6	TRDN	123497192	123497252	0	61	0	9810	0	9749	0.0	0.0
chr6	RNF217-AS1	124682870	124683022	0	153	0	11186	0	11033	0.0	0.0
chr6	RNF217-AS1	124931695	124931738	0	44	0	11186	0	11142	0.0	0.0
chr6	RNF217-AS1	124947930	124948098	0	169	0	11186	0	11017	0.0	0.0
chr6	RNF217-AS1	124941389	124941524	0	136	0	11186	0	11050	0.0	0.0
chr6	RNF217-AS1	124744395	124744472	0	78	0	11186	0	11108	0.0	0.0
chr6	RNF217-AS1	124945298	124945439	0	142	0	11186	0	11044	0.0	0.0
chr6	RNF217-AS1	124826227	124826547	0	321	0	11186	0	10865	0.0	0.0
chr6	RNF217-AS1	124941389	124941604	0	216	0	11186	0	10970	0.0	0.0
chr6	HDDC2	125298713	125298816	0	104	918	4375	918	4271	0.0	0.21493795364083354
chr6	AL450332.1	125438079	125438236	0	158	60880	4796	60880	4638	0.0	13.126347563605002
chr6	AL450332.1	125408493	125408622	1857	130	60880	4796	59023	4666	14.284615384615385	12.649592798971282
chr6	AL450332.1	125404857	125404938	2428	82	60880	4796	58452	4714	29.609756097560975	12.39966058549003
chr6	AL365259.1	125657428	125657466	0	39	862	4118	862	4079	0.0	0.21132630546702624
chr6	AL356534.1	126717332	126717474	0	143	1763	36890	1763	36747	0.0	0.047976705581408007
chr6	AL356534.1	126888215	126888338	0	124	1763	36890	1763	36766	0.0	0.04795191209269434
chr6	AL356534.1	126943385	126943608	0	224	1763	36890	1763	36666	0.0	0.04808269241258932
chr6	AL356534.1	127004184	127004398	130	215	1763	36890	1633	36675	0.6046511627906976	0.04452624403544649
chr6	AL356534.1	126894281	126894385	0	105	1763	36890	1763	36785	0.0	0.047927144216392555
chr6	AL356534.1	126910950	126911018	0	69	1763	36890	1763	36821	0.0	0.047880285706526166
chr6	AL356534.1	126701943	126702106	561	164	1763	36890	1202	36726	3.4207317073170733	0.03272885694058705
chr6	AL356534.1	127000282	127000383	0	102	1763	36890	1763	36788	0.0	0.047923235837773186
chr6	AL356534.1	126873151	126873270	0	120	1763	36890	1763	36770	0.0	0.04794669567582268
chr6	AL356534.1	127071011	127071086	0	76	1763	36890	1763	36814	0.0	0.04788938990601402
chr6	AL356534.1	127022010	127022081	0	72	1763	36890	1763	36818	0.0	0.04788418708240535
chr6	AL356534.1	127072001	127072119	0	119	1763	36890	1763	36771	0.0	0.04794539174893258
chr6	AL356534.1	126819391	126819514	0	124	1763	36890	1763	36766	0.0	0.04795191209269434
chr6	AL356534.1	127029088	127029121	0	34	1763	36890	1763	36856	0.0	0.04783481658345995
chr6	ECHDC1	127316449	127316502	0	54	0	5138	0	5084	0.0	0.0
chr6	ECHDC1	127330808	127331030	0	223	0	5138	0	4915	0.0	0.0
chr6	ECHDC1	127315134	127315138	0	5	0	5138	0	5133	0.0	0.0
chr6	ECHDC1	127331829	127331867	0	39	0	5138	0	5099	0.0	0.0
chr6	ECHDC1	127315933	127316081	0	149	0	5138	0	4989	0.0	0.0
chr6	ECHDC1	127315933	127315974	0	42	0	5138	0	5096	0.0	0.0
chr6	ECHDC1	127326495	127326574	0	80	0	5138	0	5058	0.0	0.0
chr6	ECHDC1	127341568	127341638	0	71	0	5138	0	5067	0.0	0.0
chr6	ECHDC1	127329821	127329882	0	62	0	5138	0	5076	0.0	0.0
chr6	KIAA0408	127451281	127451317	0	37	1376	8707	1376	8670	0.0	0.15870818915801616
chr6	SOGA3	127517518	127517766	210	249	1842	4333	1632	4084	0.8433734939759037	0.39960822722820766
chr6	THEMIS	127829475	127829934	297	460	2082	4317	1785	3857	0.6456521739130435	0.4627949183303085
chr6	THEMIS	127900841	127901081	0	241	2082	4317	2082	4076	0.0	0.5107948969578018
chr6	THEMIS	127807215	127807332	0	118	2082	4317	2082	4199	0.0	0.4958323410335794
chr6	PTPRK	128322038	128322310	1509	273	6303	7983	4794	7710	5.527472527472527	0.6217898832684825
chr6	PTPRK	127995248	127995266	0	19	6303	7983	6303	7964	0.0	0.7914364640883977
chr6	PTPRK	128001195	128001207	0	13	6303	7983	6303	7970	0.0	0.790840652446675
chr6	PTPRK	128003196	128003232	0	37	6303	7983	6303	7946	0.0	0.7932292977598792
chr6	PTPRK	128006025	128006055	0	31	6303	7983	6303	7952	0.0	0.7926307847082495
chr6	PTPRK	128008045	128008087	0	43	6303	7983	6303	7940	0.0	0.7938287153652392
chr6	PTPRK	128491731	128491849	539	119	6303	7983	5764	7864	4.529411764705882	0.7329603255340793
chr6	PTPRK	128409293	128409332	0	40	6303	7983	6303	7943	0.0	0.7935288933652273
chr6	AL356124.1	129532915	129532971	0	57	234	6842	234	6785	0.0	0.03448784082535004
chr6	AL356124.1	129546394	129546628	0	235	234	6842	234	6607	0.0	0.03541698198879976
chr6	AL356124.1	129532915	129532969	0	55	234	6842	234	6787	0.0	0.03447767791365847
chr6	AL356124.1	129546394	129546492	0	99	234	6842	234	6743	0.0	0.03470265460477532
chr6	AL355581.1	130143009	130143116	0	108	0	3172	0	3064	0.0	0.0
chr6	AL355581.1	130143749	130144051	0	303	0	3172	0	2869	0.0	0.0
chr6	SAMD3	130145339	130145422	0	84	16	6681	16	6597	0.0	0.0024253448537213886
chr6	SAMD3	130221636	130221775	0	140	16	6681	16	6541	0.0	0.002446109157621159
chr6	EPB41L2	130865535	130865634	0	100	0	10058	0	9958	0.0	0.0
chr6	EPB41L2	130867458	130867581	0	124	0	10058	0	9934	0.0	0.0
chr6	EPB41L2	130869811	130870126	0	316	0	10058	0	9742	0.0	0.0
chr6	EPB41L2	130869562	130870126	0	565	0	10058	0	9493	0.0	0.0
chr6	EPB41L2	130880143	130880206	0	64	0	10058	0	9994	0.0	0.0
chr6	EPB41L2	130872370	130872538	0	169	0	10058	0	9889	0.0	0.0
chr6	EPB41L2	130876673	130876775	0	103	0	10058	0	9955	0.0	0.0
chr6	MED23	131615323	131615341	0	19	2423	7132	2423	7113	0.0	0.34064389146632923
chr6	VNN3	132726721	132727012	0	292	1467	5404	1467	5112	0.0	0.2869718309859155
chr6	VNN3	132728740	132728933	0	194	1467	5404	1467	5210	0.0	0.281573896353167
chr6	VNN3	132728740	132728979	0	240	1467	5404	1467	5164	0.0	0.2840821068938807
chr6	VNN3	132726721	132726838	0	118	1467	5404	1467	5286	0.0	0.2775255391600454
chr6	VNN3	132731374	132731527	0	154	1467	5404	1467	5250	0.0	0.2794285714285714
chr6	VNN2	132752672	132752749	0	78	0	2606	0	2528	0.0	0.0
chr6	VNN2	132752460	132752749	0	290	0	2606	0	2316	0.0	0.0
chr6	VNN2	132752460	132752577	0	118	0	2606	0	2488	0.0	0.0
chr6	VNN2	132755842	132756035	0	194	0	2606	0	2412	0.0	0.0
chr6	VNN2	132751144	132751518	0	375	0	2606	0	2231	0.0	0.0
chr6	VNN2	132751144	132751278	0	135	0	2606	0	2471	0.0	0.0
chr6	VNN2	132753417	132753491	0	75	0	2606	0	2531	0.0	0.0
chr6	VNN2	132760631	132760803	0	173	0	2606	0	2433	0.0	0.0
chr6	SLC18B1	132790784	132790865	0	82	13889	2862	13889	2780	0.0	4.996043165467626
chr6	SLC18B1	132807043	132807168	96	126	13889	2862	13793	2736	0.7619047619047619	5.041301169590644
chr6	AL591115.1	133092597	133092682	588	86	3286	2024	2698	1938	6.837209302325581	1.392156862745098
chr6	TARID	133760184	133760260	0	77	300	8097	300	8020	0.0	0.03740648379052369
chr6	TARID	133538071	133538192	0	122	300	8097	300	7975	0.0	0.03761755485893417
chr6	TARID	133888603	133889212	0	610	300	8097	300	7487	0.0	0.040069453719780955
chr6	TARID	133888603	133888743	0	141	300	8097	300	7956	0.0	0.03770739064856712
chr6	TARID	133889125	133889212	0	88	300	8097	300	8009	0.0	0.037457859907603946
chr6	TARID	133888603	133889430	0	828	300	8097	300	7269	0.0	0.041271151465125874
chr6	SGK1	134173022	134173154	0	133	0	6257	0	6124	0.0	0.0
chr6	SGK1	134317391	134317542	0	152	0	6257	0	6105	0.0	0.0
chr6	CT69	134447933	134448001	0	69	51	3481	51	3412	0.0	0.014947245017584994
chr6	CT69	134447935	134448001	0	67	51	3481	51	3414	0.0	0.014938488576449912
chr6	CT69	134439059	134439175	0	117	51	3481	51	3364	0.0	0.01516052318668252
chr6	AL078590.2	134540574	134540623	0	50	213	3122	213	3072	0.0	0.0693359375
chr6	AL078590.2	134532033	134532090	0	58	213	3122	213	3064	0.0	0.06951697127937337
chr6	AL078590.2	134532033	134532095	0	63	213	3122	213	3059	0.0	0.06963059823471723
chr6	AL078590.2	134629872	134629958	0	87	213	3122	213	3035	0.0	0.07018121911037892
chr6	ALDH8A1	134929053	134929215	0	163	0	2824	0	2661	0.0	0.0
chr6	ALDH8A1	134939265	134939415	0	151	0	2824	0	2673	0.0	0.0
chr6	ALDH8A1	134940180	134940221	0	42	0	2824	0	2782	0.0	0.0
chr6	HBS1L	135039572	135039767	0	196	30	10065	30	9869	0.0	0.003039821663795724
chr6	HBS1L	135042000	135042126	0	127	30	10065	30	9938	0.0	0.0030187160394445564
chr6	HBS1L	135050581	135050647	0	67	30	10065	30	9998	0.0	0.0030006001200240046
chr6	HBS1L	135026853	135026863	0	11	30	10065	30	10054	0.0	0.002983887010145216
chr6	HBS1L	135037810	135038026	0	217	30	10065	30	9848	0.0	0.0030463038180341185
chr6	AHI1	135290422	135290525	17522	104	42520	8731	24998	8627	168.48076923076923	2.897646922452765
chr6	AHI1	135323161	135323324	0	164	42520	8731	42520	8567	0.0	4.96323100268472
chr6	AHI1	135467580	135467634	0	55	42520	8731	42520	8676	0.0	4.900875979714154
chr6	AHI1	135495813	135495898	0	86	42520	8731	42520	8645	0.0	4.91844997108155
chr6	AHI1	135497187	135497249	0	63	42520	8731	42520	8668	0.0	4.90539916935856
chr6	AHI1	135286398	135286548	4254	151	42520	8731	38266	8580	28.172185430463575	4.45990675990676
chr6	AHI1	135297431	135297492	0	62	42520	8731	42520	8669	0.0	4.90483331410774
chr6	AHI1	135435156	135435232	0	77	42520	8731	42520	8654	0.0	4.913334874046684
chr6	AL138828.1	136117069	136117172	0	104	612	7340	612	7236	0.0	0.0845771144278607
chr6	AL138828.1	136162017	136162144	0	128	612	7340	612	7212	0.0	0.08485856905158069
chr6	AL138828.1	136110995	136111101	0	107	612	7340	612	7233	0.0	0.08461219411032767
chr6	AL138828.1	136097997	136098072	0	76	612	7340	612	7264	0.0	0.0842511013215859
chr6	AL138828.1	136165511	136165665	0	155	612	7340	612	7185	0.0	0.08517745302713987
chr6	AL138828.1	136166319	136166400	0	82	612	7340	612	7258	0.0	0.08432074951777349
chr6	MTFR2	136249036	136249153	0	118	0	2171	0	2053	0.0	0.0
chr6	MTFR2	136247460	136247560	0	101	0	2171	0	2070	0.0	0.0
chr6	BCLAF1	136267028	136267175	0	148	3804	7393	3804	7245	0.0	0.5250517598343686
chr6	BCLAF1	136269140	136269303	0	164	3804	7393	3804	7229	0.0	0.5262138608382902
chr6	BCLAF1	136270322	136270383	0	62	3804	7393	3804	7331	0.0	0.518892374846542
chr6	BCLAF1	136273962	136274189	510	228	3804	7393	3294	7165	2.236842105263158	0.4597348220516399
chr6	BCLAF1	136276467	136276508	6	42	3804	7393	3798	7351	0.14285714285714285	0.5166643994014419
chr6	MAP7	136383670	136383781	0	112	1493	5468	1493	5356	0.0	0.27875280059746077
chr6	MAP7	136525831	136525971	0	141	1493	5468	1493	5327	0.0	0.28027032100619487
chr6	IL20RA	137011273	137011452	0	180	195	4311	195	4131	0.0	0.04720406681190995
chr6	IL22RA2	137147721	137147891	867	171	4931	2904	4064	2733	5.0701754385964914	1.487010611050128
chr6	IL22RA2	137156758	137156854	49	97	4931	2904	4882	2807	0.5051546391752577	1.7392233701460633
chr6	IFNGR1	137209849	137209984	0	136	6407	2945	6407	2809	0.0	2.2808828764684943
chr6	IFNGR1	137209849	137209972	0	124	6407	2945	6407	2821	0.0	2.271180432470755
chr6	IFNGR1	137215266	137215377	0	112	6407	2945	6407	2833	0.0	2.261560183551006
chr6	LINC02539	137731211	137731245	0	35	0	1059	0	1024	0.0	0.0
chr6	NHSL1	138441982	138442114	0	133	510	8431	510	8298	0.0	0.06146059291395517
chr6	REPS1	138907494	138907600	0	107	1767	6039	1767	5932	0.0	0.297875927174646
chr6	REPS1	138911275	138911371	0	97	1767	6039	1767	5942	0.0	0.2973746213396163
chr6	REPS1	138926400	138926481	0	82	1767	6039	1767	5957	0.0	0.2966258183649488
chr6	REPS1	138943512	138943576	0	65	1767	6039	1767	5974	0.0	0.2957817207900904
chr6	REPS1	138926400	138926478	0	79	1767	6039	1767	5960	0.0	0.2964765100671141
chr6	REPS1	138934224	138934326	0	103	1767	6039	1767	5936	0.0	0.29767520215633425
chr6	AL031772.1	139151080	139151275	0	196	4393	5167	4393	4971	0.0	0.8837256085294709
chr6	AL031772.1	139201674	139201783	0	110	4393	5167	4393	5057	0.0	0.8686968558433854
chr6	AL031772.1	139237379	139237505	166	127	4393	5167	4227	5040	1.3070866141732282	0.8386904761904762
chr6	AL031772.1	139203574	139203635	0	62	4393	5167	4393	5105	0.0	0.8605288932419197
chr6	AL158850.1	139268975	139269170	19813	196	29787	1908	9974	1712	101.08673469387755	5.825934579439252
chr6	AL158850.1	139244594	139244690	0	97	29787	1908	29787	1811	0.0	16.447818884594145
chr6	AL158850.1	139251451	139251622	0	172	29787	1908	29787	1736	0.0	17.158410138248847
chr6	LINC01625	139443482	139443589	0	108	0	7136	0	7028	0.0	0.0
chr6	LINC01625	139470349	139470460	0	112	0	7136	0	7024	0.0	0.0
chr6	AL359313.1	142596299	142596536	0	238	1632	2561	1632	2323	0.0	0.7025398191993112
chr6	HIVEP2	142783520	142783615	0	96	14616	10566	14616	10470	0.0	1.3959885386819484
chr6	LINC01277	142986044	142986130	0	87	44	4191	44	4104	0.0	0.010721247563352826
chr6	LINC01277	142985468	142985581	0	114	44	4191	44	4077	0.0	0.010792249202845229
chr6	LINC01277	142970987	142971041	44	55	44	4191	0	4136	0.8	0.0
chr6	LINC01277	143022823	143023115	0	293	44	4191	44	3898	0.0	0.011287839917906618
chr6	PHACTR2-AS1	143557530	143557741	0	212	0	2119	0	1907	0.0	0.0
chr6	PLAGL1	143947984	143948460	0	477	0	8363	0	7886	0.0	0.0
chr6	PLAGL1	143964786	143966230	0	1445	0	8363	0	6918	0.0	0.0
chr6	PLAGL1	143964786	143964818	0	33	0	8363	0	8330	0.0	0.0
chr6	PLAGL1	143966157	143966198	0	42	0	8363	0	8321	0.0	0.0
chr6	PLAGL1	143985134	143985174	0	41	0	8363	0	8322	0.0	0.0
chr6	PLAGL1	143965179	143965303	0	125	0	8363	0	8238	0.0	0.0
chr6	PLAGL1	143965179	143965279	0	101	0	8363	0	8262	0.0	0.0
chr6	PLAGL1	143960468	143960556	0	89	0	8363	0	8274	0.0	0.0
chr6	PLAGL1	143965849	143966198	0	350	0	8363	0	8013	0.0	0.0
chr6	PLAGL1	143965107	143965313	0	207	0	8363	0	8156	0.0	0.0
chr6	PLAGL1	143960468	143960542	0	75	0	8363	0	8288	0.0	0.0
chr6	PLAGL1	143966157	143966212	0	56	0	8363	0	8307	0.0	0.0
chr6	PLAGL1	143966157	143966285	0	129	0	8363	0	8234	0.0	0.0
chr6	PLAGL1	143966157	143966230	0	74	0	8363	0	8289	0.0	0.0
chr6	EPM2A	145686121	145686296	0	176	0	17587	0	17411	0.0	0.0
chr6	EPM2A	145635244	145635486	0	243	0	17587	0	17344	0.0	0.0
chr6	EPM2A	145720900	145721155	0	256	0	17587	0	17331	0.0	0.0
chr6	EPM2A	145671238	145671399	0	162	0	17587	0	17425	0.0	0.0
chr6	SHPRH	145951790	145951923	0	134	1607	17722	1607	17588	0.0	0.09136911530589038
chr6	STXBP5-AS1	146860617	146860743	0	127	1218	11664	1218	11537	0.0	0.10557337262719944
chr6	STXBP5-AS1	146911551	146911665	0	115	1218	11664	1218	11549	0.0	0.10546367650878864
chr6	STXBP5-AS1	146911551	146911663	0	113	1218	11664	1218	11551	0.0	0.10544541598130032
chr6	STXBP5-AS1	146858222	146858416	0	195	1218	11664	1218	11469	0.0	0.10619931990583312
chr6	STXBP5-AS1	147001440	147001543	0	104	1218	11664	1218	11560	0.0	0.10536332179930796
chr6	STXBP5-AS1	146850824	146851331	0	508	1218	11664	1218	11156	0.0	0.10917891717461456
chr6	STXBP5-AS1	146972044	146972070	0	27	1218	11664	1218	11637	0.0	0.10466615106986336
chr6	STXBP5-AS1	146864383	146864602	72	220	1218	11664	1146	11444	0.32727272727272727	0.10013981125480602
chr6	STXBP5-AS1	147074804	147074847	0	44	1218	11664	1218	11620	0.0	0.10481927710843374
chr6	STXBP5-AS1	147108471	147108610	0	140	1218	11664	1218	11524	0.0	0.10569246789309268
chr6	STXBP5-AS1	147170012	147170083	0	72	1218	11664	1218	11592	0.0	0.10507246376811594
chr6	STXBP5-AS1	146857115	146857235	0	121	1218	11664	1218	11543	0.0	0.1055184960582171
chr6	STXBP5-AS1	146962390	146962566	0	177	1218	11664	1218	11487	0.0	0.10603290676416818
chr6	KATNA1	149597062	149597189	0	128	637	2267	637	2139	0.0	0.2978027115474521
chr6	KATNA1	149604660	149604782	0	123	637	2267	637	2144	0.0	0.2971082089552239
chr6	KATNA1	149603267	149603373	0	107	637	2267	637	2160	0.0	0.2949074074074074
chr6	LATS1	149701778	149702266	0	489	3057	8502	3057	8013	0.0	0.381505054286784
chr6	LATS1	149697091	149697186	0	96	3057	8502	3057	8406	0.0	0.3636688079942898
chr6	NUP43	149738642	149738778	0	137	24204	4429	24204	4292	0.0	5.63932898415657
chr6	NUP43	149742389	149742570	0	182	24204	4429	24204	4247	0.0	5.699081704732753
chr6	NUP43	149736470	149736622	0	153	24204	4429	24204	4276	0.0	5.660430308699719
chr6	RMND1	151422540	151422605	18	66	1059757	4190	1059739	4124	0.2727272727272727	256.9687196896217
chr6	RMND1	151427481	151427582	0	102	1059757	4190	1059757	4088	0.0	259.2360567514677
chr6	RMND1	151445307	151445825	39	519	1059757	4190	1059718	3671	0.07514450867052024	288.67284118768725
chr6	RMND1	151408642	151408900	108	259	1059757	4190	1059649	3931	0.416988416988417	269.5621979140168
chr6	SYNE1	152130719	152130778	0	60	780	42788	780	42728	0.0	0.018255008425388505
chr6	SYNE1	152300640	152300781	0	142	780	42788	780	42646	0.0	0.01829010927167847
chr6	SYNE1	152368971	152369127	0	157	780	42788	780	42631	0.0	0.01829654476789191
chr6	SYNE1	152456667	152456802	0	136	780	42788	780	42652	0.0	0.018287536340617087
chr6	SYNE1	152498741	152498792	0	52	780	42788	780	42736	0.0	0.018251591164357917
chr6	SYNE1	152145486	152145555	25	70	780	42788	755	42718	0.35714285714285715	0.01767404841050611
chr6	SYNE1	152318080	152318263	0	184	780	42788	780	42604	0.0	0.018308140080743593
chr6	SYNE1	152359314	152359458	0	145	780	42788	780	42643	0.0	0.01829139600872359
chr6	SYNE1	152455885	152456044	0	160	780	42788	780	42628	0.0	0.018297832410622127
chr6	SYNE1	152511570	152511591	0	22	780	42788	780	42766	0.0	0.01823878782210167
chr6	SYNE1	152347058	152347235	0	178	780	42788	780	42610	0.0	0.01830556207463037
chr6	SYNE1	152350167	152350335	0	169	780	42788	780	42619	0.0	0.018301696426476454
chr6	SYNE1	152136272	152136314	0	43	780	42788	780	42745	0.0	0.018247748274652007
chr6	SYNE1	152319898	152320216	0	319	780	42788	780	42469	0.0	0.018366337799335986
chr6	SYNE1	152542159	152542240	0	82	780	42788	780	42706	0.0	0.01826441249473142
chr6	LINC02840	152831052	152831268	0	217	0	8955	0	8738	0.0	0.0
chr6	LINC02840	152765987	152766062	0	76	0	8955	0	8879	0.0	0.0
chr6	MTRF1L	152991184	152991321	0	138	0	4304	0	4166	0.0	0.0
chr6	CNKSR3	154422914	154422983	0	70	102	21595	102	21525	0.0	0.004738675958188153
chr6	IPCEF1	154306694	154306762	0	69	153	3968	153	3899	0.0	0.03924083098230315
chr6	SERAC1	158117726	158117821	0	96	0	9775	0	9679	0.0	0.0
chr6	SERAC1	158128107	158128270	0	164	0	9775	0	9611	0.0	0.0
chr6	SERAC1	158130372	158130486	0	115	0	9775	0	9660	0.0	0.0
chr6	SERAC1	158146781	158146913	0	133	0	9775	0	9642	0.0	0.0
chr6	SERAC1	158148864	158148954	0	91	0	9775	0	9684	0.0	0.0
chr6	SERAC1	158155314	158155351	0	38	0	9775	0	9737	0.0	0.0
chr6	SERAC1	158117531	158117575	0	45	0	9775	0	9730	0.0	0.0
chr6	SERAC1	158162147	158162152	0	6	0	9775	0	9769	0.0	0.0
chr6	SERAC1	158150452	158150587	0	136	0	9775	0	9639	0.0	0.0
chr6	TAGAP	159042077	159042244	3258	168	89638	4099	86380	3931	19.392857142857142	21.974052403968457
chr6	SOD2	159684853	159685033	102	181	8459	6793	8357	6612	0.56353591160221	1.263914095583787
chr6	SOD2	159688125	159688242	0	118	8459	6793	8459	6675	0.0	1.2672659176029963
chr6	TCP1	159779626	159779790	0	165	51	4725	51	4560	0.0	0.01118421052631579
chr6	TCP1	159785899	159785997	0	99	51	4725	51	4626	0.0	0.011024643320363165
chr6	TCP1	159788057	159788143	0	87	51	4725	51	4638	0.0	0.010996119016817595
chr6	TCP1	159787742	159787871	51	130	51	4725	0	4595	0.3923076923076923	0.0
chr6	TCP1	159785899	159786020	0	122	51	4725	51	4603	0.0	0.011079730610471432
chr6	TCP1	159788609	159788696	0	88	51	4725	51	4637	0.0	0.010998490403277982
chr6	SLC22A2	160256613	160256717	0	105	21936	4746	21936	4641	0.0	4.726567550096962
chr6	LPAL2	160467540	160467719	61205	180	492398	4767	431193	4587	340.02777777777777	94.00327011118378
chr6	LPAL2	160491362	160491520	0	159	492398	4767	492398	4608	0.0	106.85720486111111
chr6	AL391361.2	160900223	160900399	0	177	37	897	37	720	0.0	0.05138888888888889
chr6	AGPAT4	161166247	161166417	0	171	408	14246	408	14075	0.0	0.028987566607460036
chr6	AGPAT4	161165576	161165713	0	138	408	14246	408	14108	0.0	0.028919761837255458
chr6	PRKN	161360087	161360205	0	119	1776	12056	1776	11937	0.0	0.14878110077909024
chr6	PRKN	162054090	162054174	0	85	1776	12056	1776	11971	0.0	0.1483585331217108
chr6	PRKN	162201130	162201252	0	123	1776	12056	1776	11933	0.0	0.14883097293220482
chr6	PRKN	162262524	162262765	0	242	1776	12056	1776	11814	0.0	0.15033011681056374
chr6	PRKN	162443309	162443473	0	165	1776	12056	1776	11891	0.0	0.14935665629467665
chr6	PRKN	161442893	161442979	765	87	1776	12056	1011	11969	8.793103448275861	0.08446820954131506
chr6	PRKN	162695037	162695066	0	30	1776	12056	1776	12026	0.0	0.1476800266090138
chr6	PACRG-AS2	163044648	163044746	0	99	0	1548	0	1449	0.0	0.0
chr6	PACRG-AS3	163187672	163187850	0	179	51	8368	51	8189	0.0	0.006227866650384662
chr6	PACRG-AS3	163183974	163184142	0	169	51	8368	51	8199	0.0	0.0062202707647274055
chr6	PACRG-AS3	163187672	163187933	0	262	51	8368	51	8106	0.0	0.006291635825314582
chr6	PACRG-AS3	163187672	163187962	0	291	51	8368	51	8077	0.0	0.006314225578804011
chr6	PACRG-AS3	163188463	163188595	0	133	51	8368	51	8235	0.0	0.006193078324225865
chr6	AL450345.2	164815159	164815236	0	78	0	3937	0	3859	0.0	0.0
chr6	AL450345.2	164813831	164814042	0	212	0	3937	0	3725	0.0	0.0
chr6	AL450345.2	164806065	164806198	0	134	0	3937	0	3803	0.0	0.0
chr6	PDE10A	165454577	165454695	0	119	17	23062	17	22943	0.0	0.000740966743669093
chr6	PDE10A	165482314	165482343	0	30	17	23062	17	23032	0.0	0.0007381035081625565
chr6	PDE10A	165576411	165576449	0	39	17	23062	17	23023	0.0	0.0007383920427398689
chr6	PDE10A	165466419	165466532	0	114	17	23062	17	22948	0.0	0.0007408052989367265
chr6	PDE10A	165418352	165418507	0	156	17	23062	17	22906	0.0	0.000742163625251026
chr6	PDE10A	165418352	165418551	0	200	17	23062	17	22862	0.0	0.0007435919867028256
chr6	PDE10A	165828529	165828701	0	173	17	23062	17	22889	0.0	0.0007427148411900913
chr6	PDE10A	165711018	165711153	0	136	17	23062	17	22926	0.0	0.0007415161825002181
chr6	TBXT	166162446	166162623	0	178	0	2612	0	2434	0.0	0.0
chr6	TBXT	166162446	166162620	0	175	0	2612	0	2437	0.0	0.0
chr6	MPC1	166366968	166367184	0	217	0	1554	0	1337	0.0	0.0
chr6	RPS6KA2	166770862	166770913	0	52	357	8285	357	8233	0.0	0.04336207943641443
chr6	RNASET2	166955494	166955627	0	134	714	14460	714	14326	0.0	0.049839452743264
chr6	TCP10L3	167376545	167376704	553	160	26551	8397	25998	8237	3.45625	3.156246206143013
chr6	TCP10L3	167384165	167384215	0	51	26551	8397	26551	8346	0.0	3.181284447639588
chr6	FRMD1	168062670	168062739	0	70	0	7718	0	7648	0.0	0.0
chr6	FRMD1	168057504	168057723	0	220	0	7718	0	7498	0.0	0.0
chr6	FRMD1	168067068	168067129	0	62	0	7718	0	7656	0.0	0.0
chr6	LINC01615	169161067	169161214	0	148	0	2249	0	2101	0.0	0.0
chr6	LINC01615	169159044	169159136	0	93	0	2249	0	2156	0.0	0.0
chr6	THBS2	169234733	169234907	0	175	51	5550	51	5375	0.0	0.009488372093023256
chr6	THBS2	169237624	169237795	0	172	51	5550	51	5378	0.0	0.009483079211602826
chr6	THBS2	169237609	169237795	0	187	51	5550	51	5363	0.0	0.009509602834234571
chr6	WDR27	169458220	169458464	0	245	4199	10533	4199	10288	0.0	0.40814541213063765
chr6	WDR27	169613558	169613656	29	99	4199	10533	4170	10434	0.29292929292929293	0.3996549741230592
chr6	WDR27	169572418	169572540	408	123	4199	10533	3791	10410	3.317073170731707	0.36416906820365036
chr6	WDR27	169636370	169636504	173	135	4199	10533	4026	10398	1.2814814814814814	0.3871898442008078
chr6	WDR27	169659085	169659207	0	123	4199	10533	4199	10410	0.0	0.40336215177713736
chr6	WDR27	169659450	169659518	0	69	4199	10533	4199	10464	0.0	0.40128058103975534
chr6	WDR27	169667981	169668185	0	205	4199	10533	4199	10328	0.0	0.40656467854376455
chr6	WDR27	169689126	169689308	0	183	4199	10533	4199	10350	0.0	0.40570048309178747
chr6	WDR27	169665485	169665556	0	72	4199	10533	4199	10461	0.0	0.40139566007073896
chr6	WDR27	169638538	169638660	0	123	4199	10533	4199	10410	0.0	0.40336215177713736
chr6	WDR27	169667135	169668776	0	1642	4199	10533	4199	8891	0.0	0.4722753346080306
chr6	WDR27	169663562	169663649	0	88	4199	10533	4199	10445	0.0	0.40201053135471515
chr6	WDR27	169667135	169667187	0	53	4199	10533	4199	10480	0.0	0.4006679389312977
chr6	WDR27	169663562	169663878	0	317	4199	10533	4199	10216	0.0	0.41102192638997653
chr6	WDR27	169663562	169663706	0	145	4199	10533	4199	10388	0.0	0.4042164035425491
chr6	WDR27	169670568	169670693	0	126	4199	10533	4199	10407	0.0	0.4034784279811665
chr6	WDR27	169667981	169668095	0	115	4199	10533	4199	10418	0.0	0.4030524092916107
chr6	PHF10	169714732	169714842	0	111	153	5914	153	5803	0.0	0.026365672927795968
chr6	PDCD2	170580001	170580105	0	105	0	5759	0	5654	0.0	0.0
chr7	AC093627.4	152440	152547	551	108	40697	3520	40146	3412	5.101851851851852	11.76611957796014
chr7	AC093627.4	151810	151995	325	186	40697	3520	40372	3334	1.7473118279569892	12.109178164367126
chr7	DNAAF5	729662	729847	0	186	57881	7106	57881	6920	0.0	8.364306358381503
chr7	DNAAF5	729724	729847	0	124	57881	7106	57881	6982	0.0	8.290031509596105
chr7	SUN1	832504	832601	51	98	181809	10878	181758	10780	0.5204081632653061	16.860667903525048
chr7	SUN1	817279	817499	478	221	181809	10878	181331	10657	2.16289592760181	17.015201276156517
chr7	SUN1	854919	855006	0	88	181809	10878	181809	10790	0.0	16.849768303985172
chr7	SUN1	832019	832101	174	83	181809	10878	181635	10795	2.0963855421686746	16.82584529874942
chr7	SUN1	851383	851482	0	100	181809	10878	181809	10778	0.0	16.868528483948783
chr7	SUN1	848417	848615	51	199	181809	10878	181758	10679	0.2562814070351759	17.02013297125199
chr7	SUN1	849922	850033	0	112	181809	10878	181809	10766	0.0	16.887330484859742
chr7	SUN1	849519	849603	1	85	181809	10878	181808	10793	0.011764705882352941	16.844992124525156
chr7	GPER1	1088197	1088321	2262	125	14820	2840	12558	2715	18.096	4.625414364640884
chr7	ZFAND2A-DT	1163451	1163495	0	45	1551	2348	1551	2303	0.0	0.673469387755102
chr7	ZFAND2A-DT	1162961	1163217	0	257	1551	2348	1551	2091	0.0	0.7417503586800573
chr7	ZFAND2A-DT	1162961	1163495	0	535	1551	2348	1551	1813	0.0	0.8554881412024269
chr7	ZFAND2A-DT	1162961	1163207	0	247	1551	2348	1551	2101	0.0	0.7382198952879581
chr7	PSMG3-AS1	1583161	1583269	0	109	6661	5168	6661	5059	0.0	1.3166633722079462
chr7	PSMG3-AS1	1579286	1579404	246	119	6661	5168	6415	5049	2.0672268907563027	1.2705486234898
chr7	EIF3B	2366524	2366591	0	68	7907	6692	7907	6624	0.0	1.19368961352657
chr7	IQCE	2567115	2567163	135	49	112604	9142	112469	9093	2.7551020408163267	12.36874518860662
chr7	IQCE	2568953	2568999	0	47	112604	9142	112604	9095	0.0	12.380868609125894
chr7	IQCE	2572713	2572821	0	109	112604	9142	112604	9033	0.0	12.465847448245322
chr7	TTYH3	2647958	2648054	150	97	29620	6110	29470	6013	1.5463917525773196	4.90104772991851
chr7	TTYH3	2659939	2660040	0	102	29620	6110	29620	6008	0.0	4.9300932090545935
chr7	AMZ1	2709074	2709244	0	171	167851	6968	167851	6797	0.0	24.694865381786084
chr7	SDK1	4175774	4175834	0	61	51	12307	51	12246	0.0	0.004164625183733464
chr7	AP5Z1	4781174	4781312	0	139	45148	8341	45148	8202	0.0	5.504511094854913
chr7	AP5Z1	4781567	4781754	675	188	45148	8341	44473	8153	3.5904255319148937	5.454801913406108
chr7	AP5Z1	4790458	4790591	0	134	45148	8341	45148	8207	0.0	5.501157548434263
chr7	RNF216P1	4986566	4986631	0	66	2505	3552	2505	3486	0.0	0.7185886402753873
chr7	RNF216P1	4989062	4989177	0	116	2505	3552	2505	3436	0.0	0.7290454016298021
chr7	RNF216P1	4981640	4981857	0	218	2505	3552	2505	3334	0.0	0.7513497300539892
chr7	RNF216P1	4995474	4995582	0	109	2505	3552	2505	3443	0.0	0.7275631716526285
chr7	RNF216P1	4989033	4989177	0	145	2505	3552	2505	3407	0.0	0.7352509539184033
chr7	RBAK	5063694	5063755	259	62	29145	6964	28886	6902	4.17741935483871	4.185163720660678
chr7	WIPI2	5193117	5193171	0	55	14338	7716	14338	7661	0.0	1.871557237958491
chr7	ZNF815P	5831180	5831283	0	104	51	2310	51	2206	0.0	0.023118766999093383
chr7	ZNF815P	5839069	5839204	0	136	51	2310	51	2174	0.0	0.023459061637534497
chr7	CCZ1	5900472	5900566	0	95	1380	4269	1380	4174	0.0	0.3306181121226641
chr7	AIMP2	6015145	6015352	996	208	76294	1834	75298	1626	4.788461538461538	46.30873308733087
chr7	AIMP2	6012678	6013140	74539	463	76294	1834	1755	1371	160.9913606911447	1.2800875273522976
chr7	USP42	6115322	6115523	0	202	17432	7092	17432	6890	0.0	2.530043541364296
chr7	USP42	6128137	6128230	0	94	17432	7092	17432	6998	0.0	2.4909974278365246
chr7	USP42	6111796	6111951	0	156	17432	7092	17432	6936	0.0	2.513264129181084
chr7	RAC1	6398661	6398718	0	58	147	3109	147	3051	0.0	0.048180924287118974
chr7	ZDHHC4	6577589	6577720	0	132	102	3565	102	3433	0.0	0.029711622487620156
chr7	C7ORF26	6602663	6602752	36	90	36	2732	0	2642	0.4	0.0
chr7	PMS2CL	6730633	6730727	1807	95	31103	3894	29296	3799	19.021052631578947	7.711503027112398
chr7	PMS2CL	6740173	6740324	817	152	31103	3894	30286	3742	5.375	8.093532870122928
chr7	RSPH10B2	6765705	6765791	0	87	34372	4899	34372	4812	0.0	7.142975893599335
chr7	RSPH10B2	6780808	6780888	0	81	34372	4899	34372	4818	0.0	7.134080531340805
chr7	RSPH10B2	6786877	6787021	181	145	34372	4899	34191	4754	1.2482758620689656	7.192048801009676
chr7	RSPH10B2	6791903	6791997	6466	95	34372	4899	27906	4804	68.06315789473685	5.808909242298085
chr7	RSPH10B2	6779609	6779724	0	116	34372	4899	34372	4783	0.0	7.186284758519758
chr7	MIOS	7568025	7568123	0	99	23603	6728	23603	6629	0.0	3.5605672047065924
chr7	MIOS	7567606	7567688	0	83	23603	6728	23603	6645	0.0	3.5519939804364182
chr7	UMAD1	7676101	7676208	1447	108	1877	3764	430	3656	13.398148148148149	0.11761487964989059
chr7	UMAD1	7868329	7868608	0	280	1877	3764	1877	3484	0.0	0.5387485648679678
chr7	UMAD1	7868329	7868533	0	205	1877	3764	1877	3559	0.0	0.5273953357684743
chr7	UMAD1	7738710	7738891	0	182	1877	3764	1877	3582	0.0	0.5240089335566722
chr7	GLCCI1	8084896	8085017	0	122	459	6051	459	5929	0.0	0.07741609040310339
chr7	GLCCI1	8022482	8022569	0	88	459	6051	459	5963	0.0	0.07697467717591816
chr7	AC060834.2	9757673	9757898	0	226	204	1505	204	1279	0.0	0.1594996090695856
chr7	AC010991.1	9984404	9984439	0	36	0	1562	0	1526	0.0	0.0
chr7	PHF14	10982371	10983159	51	789	23540	9108	23489	8319	0.06463878326996197	2.8235364827503306
chr7	AC004160.1	11240536	11240731	0	196	510	5088	510	4892	0.0	0.10425183973834833
chr7	TMEM106B	12215603	12215804	0	202	51	13848	51	13646	0.0	0.0037373589330206656
chr7	TMEM106B	12214200	12214394	0	195	51	13848	51	13653	0.0	0.0037354427598330037
chr7	AC013470.2	12522970	12523426	0	457	94	3214	94	2757	0.0	0.034095030830612987
chr7	AC013470.2	12525819	12525904	0	86	94	3214	94	3128	0.0	0.030051150895140665
chr7	SCIN	12571544	12571625	0	82	0	11649	0	11567	0.0	0.0
chr7	SCIN	12644137	12644315	0	179	0	11649	0	11470	0.0	0.0
chr7	SCIN	12577541	12577759	0	219	0	11649	0	11430	0.0	0.0
chr7	SCIN	12596269	12596426	0	158	0	11649	0	11491	0.0	0.0
chr7	ARL4A	12687634	12687728	0	95	2244	3588	2244	3493	0.0	0.6424277125679931
chr7	AC011287.1	13636645	13636732	0	88	98	12535	98	12447	0.0	0.00787338314453282
chr7	AC011287.1	13702315	13702376	0	62	98	12535	98	12473	0.0	0.007856971057484166
chr7	AC011287.1	13172678	13172743	0	66	98	12535	98	12469	0.0	0.007859491539016761
chr7	CRPPA-AS1	16237308	16237410	99	103	105	2784	6	2681	0.9611650485436893	0.002237970906378217
chr7	CRPPA-AS1	16216332	16216569	0	238	105	2784	105	2546	0.0	0.04124116260801257
chr7	CRPPA-AS1	16216383	16216569	0	187	105	2784	105	2597	0.0	0.04043126684636118
chr7	CRPPA-AS1	16235901	16235979	0	79	105	2784	105	2705	0.0	0.038817005545286505
chr7	LRRC72	16532670	16532821	0	152	35	1452	35	1300	0.0	0.026923076923076925
chr7	BZW2	16685904	16686040	5263	137	6580	3675	1317	3538	38.416058394160586	0.37224420576596945
chr7	BZW2	16694833	16695004	0	172	6580	3675	6580	3503	0.0	1.8783899514701685
chr7	BZW2	16665436	16665501	0	66	6580	3675	6580	3609	0.0	1.8232197284566363
chr7	BZW2	16685923	16686040	598	118	6580	3675	5982	3557	5.067796610169491	1.681754287320776
chr7	HDAC9	18395114	18395183	0	70	3825	16740	3825	16670	0.0	0.22945410917816436
chr7	HDAC9	18502580	18502639	0	60	3825	16740	3825	16680	0.0	0.22931654676258992
chr7	HDAC9	18629349	18629481	0	133	3825	16740	3825	16607	0.0	0.23032456193171555
chr7	AC005083.1	20217787	20217858	0	72	0	906	0	834	0.0	0.0
chr7	AC099342.1	20300058	20300226	0	169	5	2149	5	1980	0.0	0.0025252525252525255
chr7	SP4	21428676	21428792	0	117	0	6231	0	6114	0.0	0.0
chr7	SP4	21429288	21430843	0	1556	0	6231	0	4675	0.0	0.0
chr7	DNAH11	21564185	21564397	0	213	273	16261	273	16048	0.0	0.017011465603190428
chr7	DNAH11	21681678	21681684	0	7	273	16261	273	16254	0.0	0.016795865633074936
chr7	DNAH11	21681721	21681727	0	7	273	16261	273	16254	0.0	0.016795865633074936
chr7	IL6	22727443	22727634	41	192	51	2074	10	1882	0.21354166666666666	0.005313496280552604
chr7	IL6	22727512	22727634	0	123	51	2074	51	1951	0.0	0.026140440799589954
chr7	SNHG26	22856972	22857016	0	45	131681	5723	131681	5678	0.0	23.191440648115535
chr7	SNHG26	22858570	22858830	3287	261	131681	5723	128394	5462	12.593869731800766	23.506774075430247
chr7	SNHG26	22858570	22858795	2659	226	131681	5723	129022	5497	11.765486725663717	23.471348008004366
chr7	KLHL7	23117833	23117964	0	132	9437	7081	9437	6949	0.0	1.3580371276442653
chr7	KLHL7	23123776	23123879	0	104	9437	7081	9437	6977	0.0	1.3525870718073671
chr7	NUP42	23185069	23185298	0	230	7818	3660	7818	3430	0.0	2.2793002915451894
chr7	NUP42	23197172	23197230	0	59	7818	3660	7818	3601	0.0	2.1710635934462648
chr7	NUP42	23197172	23197247	0	76	7818	3660	7818	3584	0.0	2.181361607142857
chr7	GPNMB	23261481	23261565	0	85	7250	5924	7250	5839	0.0	1.2416509676314438
chr7	CCDC126	23597966	23598051	0	86	1871	3555	1871	3469	0.0	0.5393485154223119
chr7	CCDC126	23604085	23604279	0	195	1871	3555	1871	3360	0.0	0.5568452380952381
chr7	FAM221A	23684498	23684672	0	175	1663	5529	1663	5354	0.0	0.31060889054912216
chr7	FAM221A	23686288	23688987	51	2700	1663	5529	1612	2829	0.01888888888888889	0.5698126546482856
chr7	FAM221A	23692182	23692253	0	72	1663	5529	1663	5457	0.0	0.3047461975444383
chr7	FAM221A	23688227	23688323	0	97	1663	5529	1663	5432	0.0	0.30614874815905746
chr7	FAM221A	23698191	23698299	0	109	1663	5529	1663	5420	0.0	0.30682656826568266
chr7	STK31	23815143	23815212	0	70	10875	5113	10875	5043	0.0	2.156454491374182
chr7	NPY	24284874	24285076	0	203	0	898	0	695	0.0	0.0
chr7	MPP6	24623662	24623784	0	123	63382	9386	63382	9263	0.0	6.8424916333801145
chr7	MPP6	24623665	24623784	0	120	63382	9386	63382	9266	0.0	6.840276278868983
chr7	MPP6	24620051	24620220	0	170	63382	9386	63382	9216	0.0	6.877387152777778
chr7	MPP6	24624061	24624156	0	96	63382	9386	63382	9290	0.0	6.822604951560818
chr7	MPP6	24666864	24666982	0	119	63382	9386	63382	9267	0.0	6.839538146109852
chr7	SNX10	26357006	26357127	0	122	0	3619	0	3497	0.0	0.0
chr7	SNX10	26354056	26354184	0	129	0	3619	0	3490	0.0	0.0
chr7	AC004540.1	26440369	26440505	0	137	46	6357	46	6220	0.0	0.007395498392282958
chr7	AC004540.1	26412184	26412239	46	56	46	6357	0	6301	0.8214285714285714	0.0
chr7	AC004540.1	26403395	26403517	0	123	46	6357	46	6234	0.0	0.007378889958293231
chr7	AC004540.1	26440312	26440505	0	194	46	6357	46	6163	0.0	0.007463897452539348
chr7	AC004540.1	26495808	26495881	0	74	46	6357	46	6283	0.0	0.007321343307337259
chr7	AC004540.1	26492832	26493023	0	192	46	6357	46	6165	0.0	0.00746147607461476
chr7	AC004947.1	26554808	26554919	0	112	66	2731	66	2619	0.0	0.025200458190148912
chr7	HOTAIRM1	27099097	27099366	0	270	0	1243	0	973	0.0	0.0
chr7	HOTAIRM1	27099073	27099366	0	294	0	1243	0	949	0.0	0.0
chr7	HOXA-AS2	27109194	27109263	0	70	102	4914	102	4844	0.0	0.021056977704376548
chr7	HOXA10-AS	27169306	27169764	45	459	4089	1657	4044	1198	0.09803921568627451	3.375626043405676
chr7	HOXA11-AS	27186108	27186263	0	156	1991	3018	1991	2862	0.0	0.6956673654786862
chr7	HOXA11-AS	27186071	27186263	0	193	1991	3018	1991	2825	0.0	0.7047787610619469
chr7	HOXA11-AS	27186682	27186891	0	210	1991	3018	1991	2808	0.0	0.709045584045584
chr7	EVX1	27244466	27244518	0	53	0	3173	0	3120	0.0	0.0
chr7	AC004009.1	27384402	27384636	0	235	153	1330	153	1095	0.0	0.13972602739726028
chr7	TAX1BP1	27765833	27766021	0	189	25225	9188	25225	8999	0.0	2.8030892321369043
chr7	TAX1BP1	27803108	27803180	0	73	25225	9188	25225	9115	0.0	2.7674163466812947
chr7	JAZF1-AS1	28217242	28217349	0	108	0	4249	0	4141	0.0	0.0
chr7	JAZF1-AS1	28239731	28240106	0	376	0	4249	0	3873	0.0	0.0
chr7	JAZF1-AS1	28217242	28217344	0	103	0	4249	0	4146	0.0	0.0
chr7	CREB5	28818760	28818789	50	30	1761	11466	1711	11436	1.6666666666666667	0.14961525008744317
chr7	CHN2	29146848	29146960	0	113	0	6384	0	6271	0.0	0.0
chr7	CHN2	29480278	29480356	0	79	0	6384	0	6305	0.0	0.0
chr7	CHN2	29499866	29500040	0	175	0	6384	0	6209	0.0	0.0
chr7	CHN2	29507227	29507365	0	139	0	6384	0	6245	0.0	0.0
chr7	AC005232.1	29126855	29126939	0	85	0	1148	0	1063	0.0	0.0
chr7	AC005232.1	29127453	29127579	0	127	0	1148	0	1021	0.0	0.0
chr7	CHN2	29292924	29292963	0	40	0	6384	0	6344	0.0	0.0
chr7	CHN2	29509300	29509406	0	107	0	6384	0	6277	0.0	0.0
chr7	FKBP14-AS1	29988889	29989224	0	336	5345	2840	5345	2504	0.0	2.134584664536741
chr7	PLEKHA8	30074070	30074132	0	63	98830	10896	98830	10833	0.0	9.123049939998154
chr7	MTURN	30146176	30146299	0	124	19508	6361	19508	6237	0.0	3.127785794452461
chr7	GARS1	30626233	30626319	0	87	76999	11228	76999	11141	0.0	6.911318553092182
chr7	GARS1	30631447	30631541	78	95	76999	11228	76921	11133	0.8210526315789474	6.909278720919788
chr7	GARS1	30598795	30598897	92	103	76999	11228	76907	11125	0.8932038834951457	6.912988764044944
chr7	GARS1	30595823	30595933	920	111	76999	11228	76079	11117	8.288288288288289	6.843482954034362
chr7	GARS1	30613444	30613597	3583	154	76999	11228	73416	11074	23.266233766233768	6.629582806573957
chr7	GARS1	30606325	30606397	1156	73	76999	11228	75843	11155	15.835616438356164	6.799013895114299
chr7	GARS1	30599423	30599545	3042	123	76999	11228	73957	11105	24.73170731707317	6.659792886087348
chr7	GARS1	30608407	30608483	2234	77	76999	11228	74765	11151	29.01298701298701	6.70477984037306
chr7	GARS1	30631447	30631559	186	113	76999	11228	76813	11115	1.6460176991150441	6.910751237067027
chr7	GARS1	30627056	30627190	207	135	76999	11228	76792	11093	1.5333333333333334	6.922563778959704
chr7	GARS1	30595107	30595143	693	37	76999	11228	76306	11191	18.72972972972973	6.818514878026986
chr7	INMT-MINDY4	30766344	30766561	0	218	136	2900	136	2682	0.0	0.05070842654735272
chr7	GHRHR	30973984	30974138	0	155	1395	3152	1395	2997	0.0	0.46546546546546547
chr7	GHRHR	30977280	30977322	0	43	1395	3152	1395	3109	0.0	0.4486973303312962
chr7	ADCYAP1R1	31100126	31100210	0	85	28	7004	28	6919	0.0	0.004046827576239341
chr7	ADCYAP1R1	31095666	31095750	0	85	28	7004	28	6919	0.0	0.004046827576239341
chr7	ITPRID1	31549425	31549499	0	75	421	7265	421	7190	0.0	0.05855354659248957
chr7	ITPRID1	31553001	31553187	0	187	421	7265	421	7078	0.0	0.05948007911839503
chr7	PPP1R17	31695468	31695621	0	154	0	1797	0	1643	0.0	0.0
chr7	AVL9	32580218	32580272	20	55	56576	13146	56556	13091	0.36363636363636365	4.320219998472233
chr7	AVL9	32575954	32576072	0	119	56576	13146	56576	13027	0.0	4.342979964688723
chr7	FKBP9	32963543	32963702	717	160	5657	5161	4940	5001	4.48125	0.9878024395120976
chr7	FKBP9	32974616	32974762	200	147	5657	5161	5457	5014	1.3605442176870748	1.0883526126844834
chr7	BBS9	33352858	33352873	0	16	717	8800	717	8784	0.0	0.08162568306010928
chr7	BBS9	33351026	33351323	0	298	717	8800	717	8502	0.0	0.08433309809456599
chr7	BBS9	33351218	33351323	0	106	717	8800	717	8694	0.0	0.08247066942719117
chr7	BBS9	33146241	33146364	0	124	717	8800	717	8676	0.0	0.0826417704011065
chr7	BBS9	33154485	33154608	0	124	717	8800	717	8676	0.0	0.0826417704011065
chr7	BBS9	33146268	33146364	0	97	717	8800	717	8703	0.0	0.08238538435022406
chr7	BBS9	33568170	33568286	0	117	717	8800	717	8683	0.0	0.08257514683865023
chr7	BBS9	33346226	33346370	0	145	717	8800	717	8655	0.0	0.08284228769497401
chr7	BBS9	33604864	33604975	0	112	717	8800	717	8688	0.0	0.08252762430939227
chr7	BMPER	33937288	33937388	0	101	20571	8014	20571	7913	0.0	2.5996461519019336
chr7	BMPER	34046305	34046405	0	101	20571	8014	20571	7913	0.0	2.5996461519019336
chr7	BMPER	34058058	34058163	0	106	20571	8014	20571	7908	0.0	2.601289833080425
chr7	BMPER	34078856	34079186	0	331	20571	8014	20571	7683	0.0	2.677469738383444
chr7	BMPER	34143229	34143360	0	132	20571	8014	20571	7882	0.0	2.6098705912205022
chr7	BMPER	34051860	34051970	0	111	20571	8014	20571	7903	0.0	2.602935594078198
chr7	BMPER	34062001	34062047	0	47	20571	8014	20571	7967	0.0	2.582025856658717
chr7	BMPER	34078984	34079186	0	203	20571	8014	20571	7811	0.0	2.633593649980796
chr7	BMPER	33939951	33940021	0	71	20571	8014	20571	7943	0.0	2.5898275210877504
chr7	BMPER	33976997	33977115	999	119	20571	8014	19572	7895	8.394957983193278	2.479037365421153
chr7	BMPER	33944191	33944308	0	118	20571	8014	20571	7896	0.0	2.605243161094225
chr7	NPSR1	34778461	34778565	0	105	0	2708	0	2603	0.0	0.0
chr7	NPSR1	34811769	34811863	0	95	0	2708	0	2613	0.0	0.0
chr7	NPSR1	34778494	34778565	0	72	0	2708	0	2636	0.0	0.0
chr7	NPSR1	34849322	34849422	0	101	0	2708	0	2607	0.0	0.0
chr7	AC018647.1	35717030	35717128	0	99	13228	6731	13228	6632	0.0	1.994571773220748
chr7	AC018647.1	35717006	35717128	0	123	13228	6731	13228	6608	0.0	2.00181598062954
chr7	AC018647.1	35717027	35717128	0	102	13228	6731	13228	6629	0.0	1.9954744305325087
chr7	SEPTIN7	35831491	35831496	0	6	30313	11676	30313	11670	0.0	2.59751499571551
chr7	SEPTIN7	35832797	35832900	0	104	30313	11676	30313	11572	0.0	2.6195126166609057
chr7	SEPTIN7	35832792	35832900	0	109	30313	11676	30313	11567	0.0	2.6206449381862194
chr7	SEPTIN7	35832803	35832900	0	98	30313	11676	30313	11578	0.0	2.6181551217826913
chr7	SEPTIN7	35831352	35831496	0	145	30313	11676	30313	11531	0.0	2.628826641227994
chr7	SEPTIN7	35832797	35832893	0	97	30313	11676	30313	11579	0.0	2.6179290094135936
chr7	SEPTIN7	35831424	35831496	0	73	30313	11676	30313	11603	0.0	2.6125140049987072
chr7	ANLN	36411058	36411166	0	109	15960	5237	15960	5128	0.0	3.1123244929797194
chr7	ANLN	36415757	36415884	0	128	15960	5237	15960	5109	0.0	3.1238990017615973
chr7	ANLN	36417079	36417190	0	112	15960	5237	15960	5125	0.0	3.1141463414634147
chr7	ANLN	36428306	36428360	0	55	15960	5237	15960	5182	0.0	3.079891933616364
chr7	GPR141	37685178	37685298	0	121	0	2321	0	2200	0.0	0.0
chr7	NME8	37848823	37849056	5	234	85	2400	80	2166	0.021367521367521368	0.03693444136657433
chr7	EPDR1	37948839	37949048	0	210	0	2786	0	2576	0.0	0.0
chr7	STARD3NL	38217024	38217078	0	55	279	2309	279	2254	0.0	0.12377994676131322
chr7	STARD3NL	38179089	38179145	0	57	279	2309	279	2252	0.0	0.1238898756660746
chr7	STARD3NL	38202069	38202197	0	129	279	2309	279	2180	0.0	0.12798165137614678
chr7	STARD3NL	38201713	38201966	0	254	279	2309	279	2055	0.0	0.13576642335766423
chr7	STARD3NL	38198210	38198365	0	156	279	2309	279	2153	0.0	0.12958662331630283
chr7	POU6F2	39406599	39406740	0	142	0	8328	0	8186	0.0	0.0
chr7	POU6F2	39451532	39451701	0	170	0	8328	0	8158	0.0	0.0
chr7	POU6F2	39006756	39006867	0	112	0	8328	0	8216	0.0	0.0
chr7	RALA	39697407	39697510	0	104	891	3587	891	3483	0.0	0.2558139534883721
chr7	LINC00265	39763547	39763671	0	125	4475	6805	4475	6680	0.0	0.6699101796407185
chr7	LINC00265	39779270	39779385	306	116	4475	6805	4169	6689	2.6379310344827585	0.6232620720586036
chr7	LINC00265	39742049	39742177	651	129	4475	6805	3824	6676	5.046511627906977	0.572798082684242
chr7	LINC00265	39744291	39744384	0	94	4475	6805	4475	6711	0.0	0.6668156757562211
chr7	CDK13	40085698	40085746	160	49	64285	22505	64125	22456	3.2653061224489797	2.8555842536515854
chr7	CDK13	40073617	40073692	153	76	64285	22505	64132	22429	2.013157894736842	2.8593338980783805
chr7	SUGCT	40180946	40180998	0	53	10013	2849	10013	2796	0.0	3.581187410586552
chr7	SUGCT	40274512	40274656	0	145	10013	2849	10013	2704	0.0	3.7030325443786984
chr7	SUGCT	40684055	40684133	0	79	10013	2849	10013	2770	0.0	3.614801444043321
chr7	SUGCT	40141823	40141873	0	51	10013	2849	10013	2798	0.0	3.578627591136526
chr7	INHBA-AS1	41772895	41772994	0	100	1122	4865	1122	4765	0.0	0.2354669464847849
chr7	MRPL32	42937163	42937241	0	79	20781	3362	20781	3283	0.0	6.3298812062138285
chr7	HECW1	43243874	43243932	0	59	19861	13972	19861	13913	0.0	1.4275138359807373
chr7	HECW1	43114156	43114391	0	236	19861	13972	19861	13736	0.0	1.4459085614443796
chr7	HECW1	43450827	43450929	0	103	19861	13972	19861	13869	0.0	1.4320426851250991
chr7	BLVRA	43760016	43760110	0	95	2167	1831	2167	1736	0.0	1.2482718894009217
chr7	UBE2D4	43942825	43942857	650	33	21405	4694	20755	4661	19.696969696969695	4.452907101480369
chr7	UBE2D4	43950598	43950692	62	95	21405	4694	21343	4599	0.6526315789473685	4.640791476407915
chr7	UBE2D4	43928013	43928111	0	99	21405	4694	21405	4595	0.0	4.658324265505985
chr7	UBE2D4	43947158	43947229	51	72	21405	4694	21354	4622	0.7083333333333334	4.620077888360017
chr7	UBE2D4	43942953	43943031	1381	79	21405	4694	20024	4615	17.481012658227847	4.338894907908992
chr7	DBNL	44050224	44050280	0	57	31858	12166	31858	12109	0.0	2.630935667685193
chr7	DBNL	44059353	44059449	0	97	31858	12166	31858	12069	0.0	2.6396553152705278
chr7	DBNL	44051829	44051942	3089	114	31858	12166	28769	12052	27.096491228070175	2.38707268503153
chr7	DBNL	44052866	44052941	1438	76	31858	12166	30420	12090	18.92105263157895	2.5161290322580645
chr7	DBNL	44056756	44056903	0	148	31858	12166	31858	12018	0.0	2.650857047761691
chr7	DBNL	44052866	44052951	1496	86	31858	12166	30362	12080	17.3953488372093	2.51341059602649
chr7	DBNL	44057972	44057992	0	21	31858	12166	31858	12145	0.0	2.6231370934540963
chr7	YKT6	44211022	44211124	0	103	0	4921	0	4818	0.0	0.0
chr7	YKT6	44208794	44211124	51	2331	0	4921	-51	2590	0.021879021879021878	-0.019691119691119693
chr7	YKT6	44208406	44211124	51	2719	0	4921	-51	2202	0.01875689591761677	-0.02316076294277929
chr7	YKT6	44205582	44205631	0	50	0	4921	0	4871	0.0	0.0
chr7	YKT6	44211553	44211604	0	52	0	4921	0	4869	0.0	0.0
chr7	YKT6	44210841	44210931	0	91	0	4921	0	4830	0.0	0.0
chr7	OGDH	44673786	44673941	10	156	11949	5234	11939	5078	0.0641025641025641	2.351122489168964
chr7	OGDH	44656317	44656362	0	46	11949	5234	11949	5188	0.0	2.303199691595991
chr7	OGDH	44622805	44622875	44	71	11949	5234	11905	5163	0.6197183098591549	2.305829943831106
chr7	ZMIZ2	44760150	44760228	0	79	7424	6855	7424	6776	0.0	1.0956316410861866
chr7	PPIA	44799391	44799480	4588	90	572968	5460	568380	5370	50.977777777777774	105.84357541899442
chr7	PPIA	44798747	44798904	5090	158	572968	5460	567878	5302	32.21518987341772	107.10637495284799
chr7	PPIA	44798747	44798814	537	68	572968	5460	572431	5392	7.897058823529412	106.16301928783383
chr7	PPIA	44797519	44797621	13989	103	572968	5460	558979	5357	135.81553398058253	104.34552921411237
chr7	PPIA	44800423	44800543	764	121	572968	5460	572204	5339	6.31404958677686	107.17437722419929
chr7	CCM2	45063917	45064001	280	85	5771	7220	5491	7135	3.2941176470588234	0.7695865451997197
chr7	CCM2	45068442	45068579	0	138	5771	7220	5771	7082	0.0	0.8148828014685118
chr7	CCM2	45072725	45072783	450	59	5771	7220	5321	7161	7.627118644067797	0.7430526462784527
chr7	CCM2	45038252	45038426	0	175	5771	7220	5771	7045	0.0	0.8191625266146203
chr7	CCM2	45069825	45069961	61	137	5771	7220	5710	7083	0.44525547445255476	0.8061555837921784
chr7	CCM2	45070093	45070168	56	76	5771	7220	5715	7144	0.7368421052631579	0.7999720044792833
chr7	CCM2	45071749	45071872	36	124	5771	7220	5735	7096	0.2903225806451613	0.8082018038331454
chr7	IGFBP1	45891931	45892060	0	130	102	1640	102	1510	0.0	0.06754966887417219
chr7	AC073115.2	45977518	45977678	0	161	0	1652	0	1491	0.0	0.0
chr7	C7ORF69	47813425	47813569	0	145	0	812	0	667	0.0	0.0
chr7	C7ORF57	48036292	48036363	0	72	306	2284	306	2212	0.0	0.1383363471971067
chr7	C7ORF57	48054594	48054606	0	13	306	2284	306	2271	0.0	0.13474240422721268
chr7	C7ORF57	48036207	48036363	0	157	306	2284	306	2127	0.0	0.14386459802538787
chr7	UPP1	48099669	48099787	0	119	254	4559	254	4440	0.0	0.057207207207207206
chr7	UPP1	48089211	48089418	0	208	254	4559	254	4351	0.0	0.058377384509308204
chr7	UPP1	48089508	48089636	0	129	254	4559	254	4430	0.0	0.05733634311512415
chr7	UPP1	48103296	48103411	0	116	254	4559	254	4443	0.0	0.05716857978843124
chr7	UPP1	48101823	48101870	0	48	254	4559	254	4511	0.0	0.05630680558634449
chr7	ABCA13	48242987	48243084	0	98	51	19141	51	19043	0.0	0.002678149451241926
chr7	ABCA13	48466955	48467045	0	91	51	19141	51	19050	0.0	0.0026771653543307085
chr7	ABCA13	48466952	48467045	0	94	51	19141	51	19047	0.0	0.0026775870215782014
chr7	IKZF1	50391728	50391863	0	136	0	10578	0	10442	0.0	0.0
chr7	IKZF1	50376532	50376793	0	262	0	10578	0	10316	0.0	0.0
chr7	IKZF1	50387344	50387470	0	127	0	10578	0	10451	0.0	0.0
chr7	IKZF1	50368005	50368065	0	61	0	10578	0	10517	0.0	0.0
chr7	IKZF1	50382539	50382707	0	169	0	10578	0	10409	0.0	0.0
chr7	AC004830.2	51018356	51018411	0	56	0	916	0	860	0.0	0.0
chr7	LINC01445	54339129	54339220	0	92	51	8479	51	8387	0.0	0.006080839394300703
chr7	LINC01445	54334227	54334296	0	70	51	8479	51	8409	0.0	0.006064930431680342
chr7	LINC01445	54343640	54344342	0	703	51	8479	51	7776	0.0	0.006558641975308642
chr7	VSTM2A	54553866	54554073	0	208	102	5394	102	5186	0.0	0.019668337832626302
chr7	EGFR	55146605	55146740	306	136	138070	12548	137764	12412	2.25	11.099258781824041
chr7	LANCL2	55379646	55379833	0	188	3292	5248	3292	5060	0.0	0.6505928853754941
chr7	ZNF713	55918041	55918297	0	257	153	5679	153	5422	0.0	0.028218369605311693
chr7	NIPSNAP2	55978349	55978395	0	47	4762	3190	4762	3143	0.0	1.5151129494113904
chr7	NIPSNAP2	55982209	55982280	0	72	4762	3190	4762	3118	0.0	1.5272610647851186
chr7	NIPSNAP2	55979759	55979886	124	128	4762	3190	4638	3062	0.96875	1.5146962769431744
chr7	NIPSNAP2	55979762	55979886	19	125	4762	3190	4743	3065	0.152	1.5474714518760195
chr7	NIPSNAP2	55991827	55991884	252	58	4762	3190	4510	3132	4.344827586206897	1.4399744572158366
chr7	CCT6A	56054368	56054503	2758	136	69978	3861	67220	3725	20.279411764705884	18.045637583892617
chr7	SUMF2	56068481	56068638	0	158	73001	3936	73001	3778	0.0	19.32265749073584
chr7	SUMF2	56074585	56074736	0	152	73001	3936	73001	3784	0.0	19.292019027484145
chr7	SUMF2	56078363	56078508	4617	146	73001	3936	68384	3790	31.623287671232877	18.043271767810026
chr7	SUMF2	56074173	56074218	0	46	73001	3936	73001	3890	0.0	18.766323907455014
chr7	SUMF2	56068481	56068647	0	167	73001	3936	73001	3769	0.0	19.36879808967896
chr7	SUMF2	56078921	56079039	45701	119	73001	3936	27300	3817	384.0420168067227	7.152213780455855
chr7	SUMF2	56076833	56076889	0	57	73001	3936	73001	3879	0.0	18.819541118845063
chr7	SUMF2	56072996	56073111	0	116	73001	3936	73001	3820	0.0	19.11020942408377
chr7	SUMF2	56074585	56074639	0	55	73001	3936	73001	3881	0.0	18.809842824014428
chr7	SUMF2	56074113	56074218	0	106	73001	3936	73001	3830	0.0	19.060313315926894
chr7	AC237221.1	57407073	57407170	0	98	0	4007	0	3909	0.0	0.0
chr7	AC237221.1	57407482	57407550	0	69	0	4007	0	3938	0.0	0.0
chr7	AC237221.1	57407482	57407558	0	77	0	4007	0	3930	0.0	0.0
chr7	AC237221.1	57406038	57406221	0	184	0	4007	0	3823	0.0	0.0
chr7	AC006455.5	63350918	63351014	0	97	0	2294	0	2197	0.0	0.0
chr7	LINC02848	63903521	63903590	0	70	51	5075	51	5005	0.0	0.01018981018981019
chr7	LINC02848	63917518	63917567	0	50	51	5075	51	5025	0.0	0.010149253731343283
chr7	ZNF107	64691864	64691960	44	97	1778	7169	1734	7072	0.4536082474226804	0.24519230769230768
chr7	ZNF107	64669036	64669178	102	143	1778	7169	1676	7026	0.7132867132867133	0.2385425562197552
chr7	ZNF107	64690398	64690525	0	128	1778	7169	1778	7041	0.0	0.25252094872887376
chr7	ZNF107	64679176	64679336	0	161	1778	7169	1778	7008	0.0	0.2537100456621005
chr7	ZNF138	64830939	64831076	153	138	2377	2856	2224	2718	1.108695652173913	0.8182487122884474
chr7	ZNF138	64815575	64815653	140	79	2377	2856	2237	2777	1.7721518987341771	0.8055455527547714
chr7	ZNF138	64814917	64815044	1110	128	2377	2856	1267	2728	8.671875	0.46444281524926684
chr7	ZNF138	64815571	64815653	140	83	2377	2856	2237	2773	1.6867469879518073	0.8067075369635773
chr7	ZNF138	64814058	64814147	0	90	2377	2856	2377	2766	0.0	0.8593637020968908
chr7	ZNF273	64917029	64917118	0	90	159	8661	159	8571	0.0	0.01855092754637732
chr7	CCT6P3	65072144	65072247	0	104	0	3062	0	2958	0.0	0.0
chr7	INTS4P1	65192158	65192248	1254	91	14895	3924	13641	3833	13.780219780219781	3.5588312027132796
chr7	INTS4P1	65150252	65150341	0	90	14895	3924	14895	3834	0.0	3.884976525821596
chr7	INTS4P1	65202516	65202637	883	122	14895	3924	14012	3802	7.237704918032787	3.685428721725408
chr7	ZNF92	65387901	65388028	285	128	6169	3517	5884	3389	2.2265625	1.7362053703157274
chr7	ZNF92	65388805	65388901	102	97	6169	3517	6067	3420	1.0515463917525774	1.7739766081871344
chr7	INTS4P2	65656934	65657023	0	90	433	2034	433	1944	0.0	0.2227366255144033
chr7	INTS4P2	65708413	65708544	189	132	433	2034	244	1902	1.4318181818181819	0.12828601472134596
chr7	CCT6P1	65757602	65757717	0	116	156	1684	156	1568	0.0	0.09948979591836735
chr7	CCT6P1	65761645	65761748	0	104	156	1684	156	1580	0.0	0.09873417721518987
chr7	CCT6P1	65752163	65752310	51	148	156	1684	105	1536	0.34459459459459457	0.068359375
chr7	VKORC1L1	65948670	65948780	0	111	31052	6095	31052	5984	0.0	5.189171122994653
chr7	ASL	66089275	66089335	0	61	8623	5629	8623	5568	0.0	1.5486709770114941
chr7	ASL	66081802	66081997	0	196	8623	5629	8623	5433	0.0	1.5871525860482238
chr7	ASL	66086743	66086821	0	79	8623	5629	8623	5550	0.0	1.5536936936936936
chr7	CRCP	66130743	66130842	308	100	25620	3326	25312	3226	3.08	7.846249225046497
chr7	CRCP	66130126	66130248	0	123	25620	3326	25620	3203	0.0	7.998751170777396
chr7	TPST1	66205793	66205921	94	129	116056	2816	115962	2687	0.7286821705426356	43.1566803126163
chr7	TPST1	66240324	66241270	9729	947	116056	2816	106327	1869	10.27349524815206	56.889780631353666
chr7	TPST1	66209852	66209904	0	53	116056	2816	116056	2763	0.0	42.00361925443359
chr7	KCTD7	66633274	66633444	0	171	6560	3297	6560	3126	0.0	2.0985284708893155
chr7	RABGEF1	66773690	66773810	4579	121	30669	5517	26090	5396	37.84297520661157	4.835063009636768
chr7	RABGEF1	66783674	66783841	0	168	30669	5517	30669	5349	0.0	5.733595064498037
chr7	KCTD7	66639127	66639228	0	102	6560	3297	6560	3195	0.0	2.05320813771518
chr7	AC006001.2	66665169	66665287	0	119	1491	2686	1491	2567	0.0	0.5808336579664979
chr7	AC006001.2	66667397	66667610	0	214	1491	2686	1491	2472	0.0	0.6031553398058253
chr7	AC006001.2	66666113	66666202	51	90	1491	2686	1440	2596	0.5666666666666667	0.5546995377503852
chr7	RABGEF1	66770322	66770467	0	146	30669	5517	30669	5371	0.0	5.710109849190095
chr7	RABGEF1	66768830	66769025	483	196	30669	5517	30186	5321	2.4642857142857144	5.672993798158241
chr7	TMEM248	66950951	66951135	0	185	0	5095	0	4910	0.0	0.0
chr7	TMEM248	66922148	66922246	0	99	0	5095	0	4996	0.0	0.0
chr7	TYW1	66998816	66998954	0	139	204	3755	204	3616	0.0	0.05641592920353982
chr7	TYW1	67014366	67014561	0	196	204	3755	204	3559	0.0	0.05731947176173082
chr7	TYW1	67055834	67055887	0	54	204	3755	204	3701	0.0	0.05512023777357471
chr7	STAG3L4	67308576	67308652	0	77	0	3202	0	3125	0.0	0.0
chr7	AC092637.1	68028880	68028994	0	115	0	849	0	734	0.0	0.0
chr7	AUTS2	70768023	70768068	0	46	2998	24173	2998	24127	0.0	0.12425912877688897
chr7	AUTS2	70774027	70774099	0	73	2998	24173	2998	24100	0.0	0.12439834024896265
chr7	AUTS2	70775356	70775386	0	31	2998	24173	2998	24142	0.0	0.12418192361859001
chr7	AUTS2	70093231	70093303	0	73	2998	24173	2998	24100	0.0	0.12439834024896265
chr7	AUTS2	70145305	70145444	0	140	2998	24173	2998	24033	0.0	0.12474514209628428
chr7	SBDSP1	72833763	72833928	72	166	15117	1244	15045	1078	0.43373493975903615	13.956400742115028
chr7	SBDSP1	72830691	72830813	0	123	15117	1244	15117	1121	0.0	13.485280999107939
chr7	POM121	72913764	72913828	0	65	514073	9840	514073	9775	0.0	52.59058823529412
chr7	FKBP6	73329359	73329449	0	91	34	4736	34	4645	0.0	0.0073196986006458555
chr7	FKBP6	73331656	73331776	34	121	34	4736	0	4615	0.2809917355371901	0.0
chr7	FKBP6	73329359	73329834	0	476	34	4736	34	4260	0.0	0.007981220657276996
chr7	BUD23	73690915	73691012	0	98	1476	5292	1476	5194	0.0	0.2841740469772815
chr7	BUD23	73686998	73687095	0	98	1476	5292	1476	5194	0.0	0.2841740469772815
chr7	BUD23	73693991	73694050	0	60	1476	5292	1476	5232	0.0	0.28211009174311924
chr7	BUD23	73697465	73697516	0	52	1476	5292	1476	5240	0.0	0.2816793893129771
chr7	TMEM270	73861468	73861591	0	124	0	978	0	854	0.0	0.0
chr7	ELN	74036554	74036584	0	31	293	6338	293	6307	0.0	0.046456318376407166
chr7	ELN	74041215	74041251	0	37	293	6338	293	6301	0.0	0.04650055546738613
chr7	ELN	74046187	74046217	0	31	293	6338	293	6307	0.0	0.046456318376407166
chr7	ELN	74047674	74047716	0	43	293	6338	293	6295	0.0	0.04654487688641779
chr7	ELN	74057639	74057696	0	58	293	6338	293	6280	0.0	0.04665605095541401
chr7	ELN	74060139	74060184	0	46	293	6338	293	6292	0.0	0.04656706929434202
chr7	ELN	74045221	74045293	0	73	293	6338	293	6265	0.0	0.046767757382282525
chr7	ELN	74065943	74065997	0	55	293	6338	293	6283	0.0	0.04663377367499602
chr7	ELN	74043544	74043778	0	235	293	6338	293	6103	0.0	0.04800917581517287
chr7	EIF4H	74187610	74187798	0	189	57550	4839	57550	4650	0.0	12.376344086021506
chr7	EIF4H	74190246	74190306	0	61	57550	4839	57550	4778	0.0	12.044788614483048
chr7	EIF4H	74179337	74179418	0	82	57550	4839	57550	4757	0.0	12.097960899726719
chr7	EIF4H	74178655	74178826	0	172	57550	4839	57550	4667	0.0	12.331262052710521
chr7	LAT2	74214821	74215010	49	190	922	4561	873	4371	0.2578947368421053	0.1997254632807138
chr7	LAT2	74221636	74221692	0	57	922	4561	922	4504	0.0	0.20470692717584368
chr7	LAT2	74214821	74214917	19	97	922	4561	903	4464	0.1958762886597938	0.20228494623655913
chr7	LAT2	74214821	74215099	332	279	922	4561	590	4282	1.189964157706093	0.13778608127043437
chr7	LAT2	74214821	74214940	19	120	922	4561	903	4441	0.15833333333333333	0.20333258275163252
chr7	CLIP2	74372931	74373036	0	106	1808	6823	1808	6717	0.0	0.26916778323656393
chr7	CLIP2	74401504	74401567	0	64	1808	6823	1808	6759	0.0	0.26749519159639
chr7	CLIP2	74381581	74381630	0	50	1808	6823	1808	6773	0.0	0.2669422707810424
chr7	GTF2IRD1	74547102	74547286	0	185	54237	5259	54237	5074	0.0	10.689199842333466
chr7	GTF2IRD1	74555392	74555494	0	103	54237	5259	54237	5156	0.0	10.519200930954229
chr7	GTF2IRD1	74555437	74555494	0	58	54237	5259	54237	5201	0.0	10.42818688713709
chr7	GTF2I	74714856	74714916	34	61	1677	11341	1643	11280	0.5573770491803278	0.14565602836879432
chr7	GTF2I	74718878	74718941	0	64	1677	11341	1677	11277	0.0	0.1487097632349029
chr7	GTF2I	74689123	74689227	0	105	1677	11341	1677	11236	0.0	0.14925240299038803
chr7	GTF2I	74744138	74744250	0	113	1677	11341	1677	11228	0.0	0.14935874599216245
chr7	NCF1	74779081	74779157	0	77	53877	3153	53877	3076	0.0	17.515279583875163
chr7	NCF1	74778306	74778399	111	94	53877	3153	53766	3059	1.1808510638297873	17.576332134684538
chr7	NCF1	74780156	74780226	595	71	53877	3153	53282	3082	8.380281690140846	17.28812459441921
chr7	NCF1	74779256	74779422	621	167	53877	3153	53256	2986	3.718562874251497	17.835231078365705
chr7	GTF2IRD2B	75093850	75095029	600	1180	27018	6408	26418	5228	0.5084745762711864	5.0531752104055085
chr7	GTF2IRD2B	75126341	75126385	786	45	27018	6408	26232	6363	17.466666666666665	4.122583686940122
chr7	NSUN5P1	75410605	75410726	0	122	0	2136	0	2014	0.0	0.0
chr7	NSUN5P1	75415591	75415778	0	188	0	2136	0	1948	0.0	0.0
chr7	NSUN5P1	75411407	75411574	0	168	0	2136	0	1968	0.0	0.0
chr7	NSUN5P1	75414639	75414798	0	160	0	2136	0	1976	0.0	0.0
chr7	NSUN5P1	75415591	75415770	0	180	0	2136	0	1956	0.0	0.0
chr7	RHBDD2	75881364	75881486	0	123	133	2398	133	2275	0.0	0.05846153846153846
chr7	POR	75981047	75981172	0	126	43524	5746	43524	5620	0.0	7.744483985765124
chr7	POR	75915660	75915767	1267	108	43524	5746	42257	5638	11.731481481481481	7.495033699893579
chr7	MDH2	76060372	76060498	0	127	7272	3651	7272	3524	0.0	2.0635641316685587
chr7	MDH2	76054829	76054998	0	170	7272	3651	7272	3481	0.0	2.089054869290434
chr7	HSPB1	76303801	76303865	0	65	0	1152	0	1087	0.0	0.0
chr7	HSPB1	76303801	76303888	0	88	0	1152	0	1064	0.0	0.0
chr7	HSPB1	76303806	76303865	0	60	0	1152	0	1092	0.0	0.0
chr7	HSPB1	76303776	76303865	0	90	0	1152	0	1062	0.0	0.0
chr7	HSPB1	76303801	76303844	0	44	0	1152	0	1108	0.0	0.0
chr7	HSPB1	76303801	76303882	0	82	0	1152	0	1070	0.0	0.0
chr7	HSPB1	76303697	76303727	0	31	0	1152	0	1121	0.0	0.0
chr7	DTX2	76463653	76463709	0	57	0	5061	0	5004	0.0	0.0
chr7	DTX2	76477113	76477178	0	66	0	5061	0	4995	0.0	0.0
chr7	DTX2	76463444	76463709	0	266	0	5061	0	4795	0.0	0.0
chr7	DTX2	76476942	76477178	0	237	0	5061	0	4824	0.0	0.0
chr7	DTX2	76470299	76470419	0	121	0	5061	0	4940	0.0	0.0
chr7	DTX2	76497336	76497477	0	142	0	5061	0	4919	0.0	0.0
chr7	DTX2	76463544	76463709	0	166	0	5061	0	4895	0.0	0.0
chr7	DTX2	76480420	76480777	0	358	0	5061	0	4703	0.0	0.0
chr7	DTX2	76501266	76501292	0	27	0	5061	0	5034	0.0	0.0
chr7	UPK3B	76513083	76513163	0	81	0	2542	0	2461	0.0	0.0
chr7	AC007003.1	76916590	76916843	540	254	540	1239	0	985	2.125984251968504	0.0
chr7	DTX2P1-UPK3BP1-PMS2P11	77006978	77007059	0	82	102	5347	102	5265	0.0	0.019373219373219373
chr7	DTX2P1-UPK3BP1-PMS2P11	76968398	76968518	0	121	102	5347	102	5226	0.0	0.01951779563719862
chr7	DTX2P1-UPK3BP1-PMS2P11	76995454	76995595	0	142	102	5347	102	5205	0.0	0.019596541786743516
chr7	DTX2P1-UPK3BP1-PMS2P11	77003288	77003449	0	162	102	5347	102	5185	0.0	0.019672131147540985
chr7	CCDC146	77273693	77273789	0	97	36252	4481	36252	4384	0.0	8.269160583941606
chr7	PTPN12	77581426	77581503	0	78	6385	5154	6385	5076	0.0	1.257880220646178
chr7	PTPN12	77583554	77583650	0	97	6385	5154	6385	5057	0.0	1.2626062883132292
chr7	PTPN12	77592184	77592256	0	73	6385	5154	6385	5081	0.0	1.2566423932296793
chr7	PTPN12	77632347	77632425	0	79	6385	5154	6385	5075	0.0	1.258128078817734
chr7	PTPN12	77563935	77564195	0	261	6385	5154	6385	4893	0.0	1.30492540363785
chr7	PTPN12	77538764	77538845	0	82	6385	5154	6385	5072	0.0	1.258872239747634
chr7	PTPN12	77604878	77604935	0	58	6385	5154	6385	5096	0.0	1.2529434850863421
chr7	PHTF2	77854732	77854834	0	103	51	8667	51	8564	0.0	0.0059551611396543675
chr7	PHTF2	77893981	77893993	0	13	51	8667	51	8654	0.0	0.005893228564825514
chr7	PHTF2	77937709	77937838	0	130	51	8667	51	8537	0.0	0.00597399554878763
chr7	PHTF2	77940527	77940659	0	133	51	8667	51	8534	0.0	0.00597609561752988
chr7	PHTF2	77949677	77949833	0	157	51	8667	51	8510	0.0	0.005992949471210341
chr7	AC004990.1	77990983	77991182	0	200	155	2237	155	2037	0.0	0.07609229258713794
chr7	RPL13AP17	78348376	78348425	0	50	0	2160	0	2110	0.0	0.0
chr7	MAGI2-AS3	79454865	79455007	0	143	153	16832	153	16689	0.0	0.009167715261549523
chr7	MAGI2-AS3	79470593	79470679	0	87	153	16832	153	16745	0.0	0.009137055837563452
chr7	MAGI2-AS3	79453586	79453655	0	70	153	16832	153	16762	0.0	0.009127789046653144
chr7	MAGI2-AS3	79454885	79455007	0	123	153	16832	153	16709	0.0	0.009156741875635884
chr7	MAGI2-AS3	79459406	79459453	0	48	153	16832	153	16784	0.0	0.00911582459485224
chr7	MAGI2-AS3	79458658	79458730	0	73	153	16832	153	16759	0.0	0.009129422996598843
chr7	MAGI2-AS3	79455889	79456180	0	292	153	16832	153	16540	0.0	0.009250302297460702
chr7	MAGI2-AS3	79454885	79458730	0	3846	153	16832	153	12986	0.0	0.011781918989681195
chr7	MAGI2-AS3	79456089	79456180	0	92	153	16832	153	16740	0.0	0.00913978494623656
chr7	GNAI1	80134417	80134568	0	152	714	23932	714	23780	0.0	0.030025231286795625
chr7	GNAI1	80134417	80134588	0	172	714	23932	714	23760	0.0	0.03005050505050505
chr7	GNAI1	80134399	80134568	0	170	714	23932	714	23762	0.0	0.030047975759616194
chr7	GNAI1	80180594	80180754	51	161	714	23932	663	23771	0.3167701863354037	0.02789112784485297
chr7	CD36	80662989	80663169	0	181	5886	9692	5886	9511	0.0	0.6188623698874987
chr7	CD36	80670976	80671164	0	189	5886	9692	5886	9503	0.0	0.6193833526254867
chr7	CD36	80639843	80639929	0	87	5886	9692	5886	9605	0.0	0.6128058302967204
chr7	CACNA2D1-AS1	82021121	82021205	0	85	102	2656	102	2571	0.0	0.039673278879813305
chr7	GRM3	86765005	86765613	0	609	7171	4481	7171	3872	0.0	1.8520144628099173
chr7	GRM3	86838838	86839905	153	1068	7171	4481	7018	3413	0.14325842696629212	2.0562554937005566
chr7	DMTF1	87163494	87163617	0	124	0	7275	0	7151	0.0	0.0
chr7	DMTF1	87164933	87165050	0	118	0	7275	0	7157	0.0	0.0
chr7	DMTF1	87166482	87166605	0	124	0	7275	0	7151	0.0	0.0
chr7	DMTF1	87184396	87184625	0	230	0	7275	0	7045	0.0	0.0
chr7	DMTF1	87194683	87194828	0	146	0	7275	0	7129	0.0	0.0
chr7	DMTF1	87188091	87188301	0	211	0	7275	0	7064	0.0	0.0
chr7	DMTF1	87163238	87163332	0	95	0	7275	0	7180	0.0	0.0
chr7	DMTF1	87188038	87188301	0	264	0	7275	0	7011	0.0	0.0
chr7	DMTF1	87154389	87154528	0	140	0	7275	0	7135	0.0	0.0
chr7	DMTF1	87184819	87184892	0	74	0	7275	0	7201	0.0	0.0
chr7	DMTF1	87188197	87188301	0	105	0	7275	0	7170	0.0	0.0
chr7	DMTF1	87164253	87164331	0	79	0	7275	0	7196	0.0	0.0
chr7	DMTF1	87154227	87154278	0	52	0	7275	0	7223	0.0	0.0
chr7	DMTF1	87155454	87155497	0	44	0	7275	0	7231	0.0	0.0
chr7	CROT	87357506	87357590	0	85	7	5015	7	4930	0.0	0.0014198782961460446
chr7	RUNDC3B	87693907	87693958	0	52	19116	4721	19116	4669	0.0	4.09423859498822
chr7	RUNDC3B	87807372	87807519	0	148	19116	4721	19116	4573	0.0	4.180188060354253
chr7	DBF4	87897293	87897339	0	47	153	4607	153	4560	0.0	0.03355263157894737
chr7	ADAM22	87964633	87964684	0	52	51	12235	51	12183	0.0	0.004186161044077813
chr7	ADAM22	88178934	88179042	0	109	51	12235	51	12126	0.0	0.004205838693715982
chr7	ADAM22	88186614	88186701	0	88	51	12235	51	12147	0.0	0.0041985675475426035
chr7	ADAM22	88184291	88184402	0	112	51	12235	51	12123	0.0	0.004206879485275922
chr7	ADAM22	88178934	88179129	0	196	51	12235	51	12039	0.0	0.00423623224520309
chr7	AC003991.1	88283831	88283909	0	79	0	4852	0	4773	0.0	0.0
chr7	AC003991.1	88276955	88277169	0	215	0	4852	0	4637	0.0	0.0
chr7	AC003991.1	88282595	88282866	0	272	0	4852	0	4580	0.0	0.0
chr7	AC003991.1	88290291	88290423	0	133	0	4852	0	4719	0.0	0.0
chr7	AC002383.1	89474894	89475043	0	150	0	2016	0	1866	0.0	0.0
chr7	AC002383.1	89492392	89492488	0	97	0	2016	0	1919	0.0	0.0
chr7	AC002383.1	89490119	89490274	0	156	0	2016	0	1860	0.0	0.0
chr7	STEAP1	90162973	90163110	0	138	0	1550	0	1412	0.0	0.0
chr7	STEAP2	90216490	90216603	0	114	23	8556	23	8442	0.0	0.002724472873726605
chr7	STEAP2	90232336	90232484	0	149	23	8556	23	8407	0.0	0.002735815391935292
chr7	STEAP2	90216494	90216603	0	110	23	8556	23	8446	0.0	0.0027231825716315414
chr7	CFAP69	90261946	90262056	0	111	35	4519	35	4408	0.0	0.00794010889292196
chr7	CFAP69	90265300	90265377	0	78	35	4519	35	4441	0.0	0.007881107858590407
chr7	CFAP69	90271780	90271958	0	179	35	4519	35	4340	0.0	0.008064516129032258
chr7	CFAP69	90273986	90274110	0	125	35	4519	35	4394	0.0	0.007965407373691398
chr7	CFAP69	90303968	90304106	0	139	35	4519	35	4380	0.0	0.007990867579908675
chr7	CFAP69	90306900	90307098	0	199	35	4519	35	4320	0.0	0.008101851851851851
chr7	CFAP69	90309262	90309367	0	106	35	4519	35	4413	0.0	0.007931112621799229
chr7	CFAP69	90276020	90276152	0	133	35	4519	35	4386	0.0	0.007979936160510716
chr7	CFAP69	90287501	90287749	0	249	35	4519	35	4270	0.0	0.00819672131147541
chr7	CFAP69	90261946	90262050	0	105	35	4519	35	4414	0.0	0.00792931581332125
chr7	GTPBP10	90355085	90355230	0	146	0	10450	0	10304	0.0	0.0
chr7	GTPBP10	90372154	90372228	0	75	0	10450	0	10375	0.0	0.0
chr7	GTPBP10	90354457	90354549	0	93	0	10450	0	10357	0.0	0.0
chr7	GTPBP10	90342244	90342322	0	79	0	10450	0	10371	0.0	0.0
chr7	CLDN12	90411962	90412061	0	100	51	6484	51	6384	0.0	0.007988721804511278
chr7	CLDN12	90412006	90412061	0	56	51	6484	51	6428	0.0	0.007934038581207219
chr7	CLDN12	90412006	90412049	0	44	51	6484	51	6440	0.0	0.007919254658385094
chr7	CLDN12	90469890	90469953	0	64	51	6484	51	6420	0.0	0.00794392523364486
chr7	CLDN12	90494366	90494430	0	65	51	6484	51	6419	0.0	0.007945162797943606
chr7	CDK14	90747680	90747775	0	96	206	6964	206	6868	0.0	0.029994175888177054
chr7	CDK14	90666339	90666411	0	73	206	6964	206	6891	0.0	0.02989406472210129
chr7	CDK14	90608529	90608575	0	47	206	6964	206	6917	0.0	0.029781697267601562
chr7	CDK14	90716339	90716394	0	56	206	6964	206	6908	0.0	0.029820497973364217
chr7	CDK14	90709815	90709957	0	143	206	6964	206	6821	0.0	0.03020085031520305
chr7	AC079760.2	91320801	91320987	0	187	1468	2663	1468	2476	0.0	0.592891760904685
chr7	AC079760.2	91335196	91335369	0	174	1468	2663	1468	2489	0.0	0.5897950984331056
chr7	AC079760.2	91493394	91493535	0	142	1468	2663	1468	2521	0.0	0.582308607695359
chr7	AC079760.2	91496502	91496646	0	145	1468	2663	1468	2518	0.0	0.5830023828435266
chr7	AKAP9	91992157	91992211	0	55	102767	18331	102767	18276	0.0	5.623057561829722
chr7	AKAP9	92042045	92042186	0	142	102767	18331	102767	18189	0.0	5.649953268458959
chr7	AKAP9	92043281	92043377	0	97	102767	18331	102767	18234	0.0	5.636009652297905
chr7	AKAP9	92063461	92063500	0	40	102767	18331	102767	18291	0.0	5.618446230386529
chr7	ANKIB1	92392240	92392292	0	53	2153	7413	2153	7360	0.0	0.2925271739130435
chr7	ANKIB1	92325927	92326008	0	82	2153	7413	2153	7331	0.0	0.29368435411267224
chr7	ANKIB1	92347946	92348016	0	71	2153	7413	2153	7342	0.0	0.29324434758921275
chr7	GATAD1	92449091	92449213	0	123	10302	6342	10302	6219	0.0	1.6565364206464062
chr7	CDK6-AS1	92854908	92854953	0	46	0	671	0	625	0.0	0.0
chr7	CDK6-AS1	92855683	92855827	0	145	0	671	0	526	0.0	0.0
chr7	VPS50	93246101	93246129	0	29	2191	9328	2191	9299	0.0	0.23561673298204108
chr7	VPS50	93240715	93240818	0	104	2191	9328	2191	9224	0.0	0.23753252385082393
chr7	VPS50	93252652	93252775	0	124	2191	9328	2191	9204	0.0	0.23804867448935246
chr7	CASD1	94518202	94518323	0	122	102	5279	102	5157	0.0	0.01977894124490983
chr7	CASD1	94517559	94517656	0	98	102	5279	102	5181	0.0	0.019687319050376375
chr7	PEG10	94661037	94661097	0	61	561	3432	561	3371	0.0	0.16641946010086028
chr7	PPP1R9A	95203664	95203730	0	67	102	11218	102	11151	0.0	0.009147161689534571
chr7	PPP1R9A	95288535	95288718	0	184	102	11218	102	11034	0.0	0.009244154431756389
chr7	PPP1R9A	95287109	95287133	0	25	102	11218	102	11193	0.0	0.009112838381131064
chr7	AC002451.1	95609587	95609862	0	276	0	6751	0	6475	0.0	0.0
chr7	DYNC1I1	95828056	95828116	0	61	21777	4540	21777	4479	0.0	4.862022772940389
chr7	DYNC1I1	95802679	95802794	0	116	21777	4540	21777	4424	0.0	4.9224683544303796
chr7	SDHAF3	97136387	97136467	0	81	0	1191	0	1110	0.0	0.0
chr7	TAC1	97734247	97734292	0	46	525	1719	525	1673	0.0	0.3138075313807531
chr7	TAC1	97736298	97736352	474	55	525	1719	51	1664	8.618181818181819	0.03064903846153846
chr7	TRRAP	98945746	98945800	0	55	1139865	20054	1139865	19999	0.0	56.99609980499025
chr7	TRRAP	98945929	98945950	0	22	1139865	20054	1139865	20032	0.0	56.90220646964856
chr7	TRRAP	99030594	99030757	1929	164	1139865	20054	1137936	19890	11.762195121951219	57.21146304675717
chr7	TRRAP	99045541	99045792	13033	252	1139865	20054	1126832	19802	51.71825396825397	56.90495909504091
chr7	MYH16	99252812	99252876	0	65	916	6350	916	6285	0.0	0.14574383452665077
chr7	AC004922.1	99335452	99335484	0	33	286	2725	286	2692	0.0	0.1062407132243685
chr7	AC004922.1	99339857	99340009	0	153	286	2725	286	2572	0.0	0.11119751166407466
chr7	ARPC1A	99363542	99363633	0	92	286	2077	286	1985	0.0	0.14408060453400504
chr7	ARPC1B	99377337	99377455	0	119	0	3642	0	3523	0.0	0.0
chr7	ARPC1B	99377333	99377439	0	107	0	3642	0	3535	0.0	0.0
chr7	ARPC1B	99376443	99376574	0	132	0	3642	0	3510	0.0	0.0
chr7	ARPC1B	99384050	99384171	0	122	0	3642	0	3520	0.0	0.0
chr7	ARPC1B	99377337	99377439	0	103	0	3642	0	3539	0.0	0.0
chr7	ARPC1B	99377357	99377455	0	99	0	3642	0	3543	0.0	0.0
chr7	ARPC1B	99376432	99376574	0	143	0	3642	0	3499	0.0	0.0
chr7	ARPC1B	99377357	99377439	0	83	0	3642	0	3559	0.0	0.0
chr7	ARPC1B	99386492	99386590	0	99	0	3642	0	3543	0.0	0.0
chr7	ARPC1B	99388654	99388843	0	190	0	3642	0	3452	0.0	0.0
chr7	BUD31	99416137	99416260	0	124	1	2378	1	2254	0.0	0.00044365572315882877
chr7	BUD31	99411749	99411983	0	235	1	2378	1	2143	0.0	0.0004666355576294914
chr7	CPSF4	99450275	99450371	0	97	51	3985	51	3888	0.0	0.013117283950617283
chr7	CPSF4	99450701	99450795	0	95	51	3985	51	3890	0.0	0.013110539845758355
chr7	CPSF4	99447772	99448040	0	269	51	3985	51	3716	0.0	0.01372443487621098
chr7	CPSF4	99442996	99443175	0	180	51	3985	51	3805	0.0	0.013403416557161629
chr7	ZNF789	99478273	99478356	0	84	20449	4406	20449	4322	0.0	4.7313743637205
chr7	ZNF789	99485207	99485368	51	162	20449	4406	20398	4244	0.3148148148148148	4.80631479736098
chr7	ZNF789	99476402	99476480	0	79	20449	4406	20449	4327	0.0	4.725907094984978
chr7	ZNF789	99483738	99483853	0	116	20449	4406	20449	4290	0.0	4.766666666666667
chr7	ZKSCAN5	99520168	99520304	0	137	40868	6053	40868	5916	0.0	6.908045977011494
chr7	ZNF655	99561887	99561973	0	87	1091	7216	1091	7129	0.0	0.15303689156964512
chr7	ZNF655	99563187	99563266	0	80	1091	7216	1091	7136	0.0	0.15288677130044842
chr7	ZNF655	99571259	99571379	51	121	1091	7216	1040	7095	0.4214876033057851	0.14658210007047218
chr7	ZNF655	99562348	99562494	0	147	1091	7216	1091	7069	0.0	0.1543358325081341
chr7	ZNF655	99571687	99571792	0	106	1091	7216	1091	7110	0.0	0.15344585091420535
chr7	ZNF655	99563193	99563266	0	74	1091	7216	1091	7142	0.0	0.15275833099971997
chr7	ZSCAN25	99618134	99618209	0	76	156354	5715	156354	5639	0.0	27.727256605781168
chr7	CYP3A43	99836452	99836546	0	95	62	2652	62	2557	0.0	0.024247164646069613
chr7	CYP3A43	99844142	99844242	0	101	62	2652	62	2551	0.0	0.024304194433555467
chr7	CYP3A43	99849545	99849694	51	150	62	2652	11	2502	0.34	0.004396482813749001
chr7	CYP3A43	99855590	99855718	0	129	62	2652	62	2523	0.0	0.024573919936583432
chr7	CYP3A43	99863536	99863699	11	164	62	2652	51	2488	0.06707317073170732	0.0204983922829582
chr7	CYP3A43	99838676	99838798	0	123	62	2652	62	2529	0.0	0.024515618821668642
chr7	CYP3A43	99839119	99839172	0	54	62	2652	62	2598	0.0	0.02386451116243264
chr7	CYP3A43	99849978	99850099	0	122	62	2652	62	2530	0.0	0.02450592885375494
chr7	CYP3A43	99861612	99861839	0	228	62	2652	62	2424	0.0	0.02557755775577558
chr7	CYP3A43	99856832	99856899	0	68	62	2652	62	2584	0.0	0.023993808049535603
chr7	CYP3A43	99863533	99863699	11	167	62	2652	51	2485	0.0658682634730539	0.020523138832997986
chr7	ZKSCAN1	100019230	100019349	0	120	127291	10327	127291	10207	0.0	12.470951307925933
chr7	ZSCAN21	100063787	100063979	0	193	93608	2045	93608	1852	0.0	50.54427645788337
chr7	ZSCAN21	100051477	100051610	0	134	93608	2045	93608	1911	0.0	48.98377812663527
chr7	COPS6	100090398	100090487	0	90	704	2424	704	2334	0.0	0.30162810625535563
chr7	AP4M1	100102245	100102393	0	149	51	4601	51	4452	0.0	0.011455525606469003
chr7	AP4M1	100102863	100102960	0	98	51	4601	51	4503	0.0	0.011325782811459028
chr7	AP4M1	100104873	100104940	0	68	51	4601	51	4533	0.0	0.011250827266710787
chr7	AP4M1	100102674	100102781	0	108	51	4601	51	4493	0.0	0.01135099042955709
chr7	AP4M1	100102674	100102746	0	73	51	4601	51	4528	0.0	0.011263250883392226
chr7	AP4M1	100106657	100106912	0	256	51	4601	51	4345	0.0	0.011737629459148446
chr7	AP4M1	100105044	100105098	0	55	51	4601	51	4546	0.0	0.011218653761548614
chr7	LAMTOR4	100149498	100149579	0	82	626	1452	626	1370	0.0	0.4569343065693431
chr7	LAMTOR4	100149498	100149565	0	68	626	1452	626	1384	0.0	0.4523121387283237
chr7	LAMTOR4	100152715	100152757	0	43	626	1452	626	1409	0.0	0.44428672817601134
chr7	STAG3	100188811	100189016	80	206	40472	8611	40392	8405	0.3883495145631068	4.805710886377156
chr7	PILRB	100353372	100354012	0	641	0	3977	0	3336	0.0	0.0
chr7	PILRB	100353372	100353483	0	112	0	3977	0	3865	0.0	0.0
chr7	PILRB	100353209	100353270	0	62	0	3977	0	3915	0.0	0.0
chr7	PILRB	100353894	100354012	0	119	0	3977	0	3858	0.0	0.0
chr7	PILRA	100397878	100397912	0	35	141	1999	141	1964	0.0	0.07179226069246436
chr7	PILRA	100389887	100390106	0	220	141	1999	141	1779	0.0	0.07925801011804384
chr7	AC069281.1	100519375	100519498	0	124	51	1003	51	879	0.0	0.05802047781569966
chr7	AGFG2	100556593	100556626	0	34	0	5500	0	5466	0.0	0.0
chr7	FBXO24	100595101	100595223	0	123	0	3344	0	3221	0.0	0.0
chr7	FBXO24	100600030	100600201	0	172	0	3344	0	3172	0.0	0.0
chr7	MOSPD3	100613193	100613269	0	77	0	1702	0	1625	0.0	0.0
chr7	GNB2	100676176	100676322	0	147	0	2613	0	2466	0.0	0.0
chr7	GNB2	100677351	100677415	0	65	0	2613	0	2548	0.0	0.0
chr7	ZAN	100793819	100794018	51	200	204236	8919	204185	8719	0.255	23.418396605115266
chr7	ZAN	100794119	100794258	102	140	204236	8919	204134	8779	0.7285714285714285	23.252534457227476
chr7	SLC12A9	100859049	100859161	0	113	1183977	7409	1183977	7296	0.0	162.27754934210526
chr7	SLC12A9	100856867	100857176	888	310	1183977	7409	1183089	7099	2.8645161290322583	166.6557261586139
chr7	SLC12A9	100854155	100854378	19696	224	1183977	7409	1164281	7185	87.92857142857143	162.04328462073764
chr7	TRIP6	100867910	100867988	51	79	16105	2453	16054	2374	0.6455696202531646	6.7624262847514744
chr7	TRIP6	100867860	100867988	51	129	16105	2453	16054	2324	0.3953488372093023	6.907917383820998
chr7	TRIP6	100871060	100871177	0	118	16105	2453	16105	2335	0.0	6.897216274089936
chr7	SRRT	100888256	100888383	122507	128	432881	4638	310374	4510	957.0859375	68.8190687361419
chr7	SRRT	100880695	100880769	4640	75	432881	4638	428241	4563	61.86666666666667	93.85075608152532
chr7	SRRT	100882764	100883090	77803	327	432881	4638	355078	4311	237.9296636085627	82.36557643238228
chr7	SRRT	100882457	100883090	82761	634	432881	4638	350120	4004	130.5378548895899	87.44255744255744
chr7	SRRT	100888277	100888383	92225	107	432881	4638	340656	4531	861.9158878504672	75.18340322224674
chr7	MUC3A	100963150	100963266	0	117	483578	11408	483578	11291	0.0	42.828624568240194
chr7	MUC3A	100966385	100966559	0	175	483578	11408	483578	11233	0.0	43.04976408795513
chr7	MUC12	101015614	101015691	0	78	1479	17146	1479	17068	0.0	0.08665338645418327
chr7	MUC17	101050483	101050635	0	153	1038	14706	1038	14553	0.0	0.07132549989692846
chr7	AP1S1	101157376	101157485	0	110	0	1707	0	1597	0.0	0.0
chr7	EMSLR	101309613	101309694	0	82	51	4680	51	4598	0.0	0.011091779034362766
chr7	CUX1	101916114	101916225	0	112	138872	17804	138872	17692	0.0	7.84942346823423
chr7	CUX1	102028097	102028145	0	49	138872	17804	138872	17755	0.0	7.8215713883413125
chr7	CUX1	102097363	102097501	19478	139	138872	17804	119394	17665	140.1294964028777	6.758788564958959
chr7	CUX1	102198801	102198867	0	67	138872	17804	138872	17737	0.0	7.82950893612223
chr7	CUX1	102200070	102200172	3901	103	138872	17804	134971	17701	37.87378640776699	7.625049432235467
chr7	SH2B2	102300521	102301279	26400	759	33646	2394	7246	1635	34.78260869565217	4.431804281345566
chr7	PRKRIP1	102397619	102397698	0	80	8005	3465	8005	3385	0.0	2.364844903988183
chr7	PRKRIP1	102365954	102366076	0	123	8005	3465	8005	3342	0.0	2.395272292040694
chr7	PRKRIP1	102365973	102366076	0	104	8005	3465	8005	3361	0.0	2.381731627491818
chr7	PRKRIP1	102395976	102396537	7803	562	8005	3465	202	2903	13.884341637010676	0.0695831898036514
chr7	PRKRIP1	102366017	102366076	0	60	8005	3465	8005	3405	0.0	2.3509544787077825
chr7	ORAI2	102436201	102436333	375	133	10508	11112	10133	10979	2.819548872180451	0.9229438018034429
chr7	ORAI2	102438943	102439181	0	239	10508	11112	10508	10873	0.0	0.9664306079278948
chr7	ORAI2	102436229	102436333	375	105	10508	11112	10133	11007	3.5714285714285716	0.9205959843735805
chr7	ORAI2	102436224	102436333	375	110	10508	11112	10133	11002	3.409090909090909	0.9210143610252681
chr7	LRWD1	102465531	102465627	0	97	2318	2902	2318	2805	0.0	0.8263814616755794
chr7	FAM185A	102751691	102751801	0	111	2101	2732	2101	2621	0.0	0.8016024418161007
chr7	LRRC17	102942289	102942342	54	54	147096	2834	147042	2780	1.0	52.892805755395685
chr7	ARMC10	103092476	103092653	0	178	0	4585	0	4407	0.0	0.0
chr7	ARMC10	103075776	103075881	0	106	0	4585	0	4479	0.0	0.0
chr7	ARMC10	103097276	103097348	0	73	0	4585	0	4512	0.0	0.0
chr7	ARMC10	103086868	103086937	0	70	0	4585	0	4515	0.0	0.0
chr7	ARMC10	103084029	103084062	0	34	0	4585	0	4551	0.0	0.0
chr7	PMPCB	103307595	103307708	0	114	0	5146	0	5032	0.0	0.0
chr7	PSMC2	103356169	103356209	0	41	0	7122	0	7081	0.0	0.0
chr7	AC005064.1	103504403	103504524	0	122	204	2729	204	2607	0.0	0.07825086306098965
chr7	LHFPL3	104845381	104845429	0	49	0	1860	0	1811	0.0	0.0
chr7	AC007384.1	104962284	104962357	0	74	6094	2440	6094	2366	0.0	2.5756551141166524
chr7	KMT2E	105110476	105110602	0	127	17175	9981	17175	9854	0.0	1.7429470265881875
chr7	KMT2E	105038125	105038199	0	75	17175	9981	17175	9906	0.0	1.7337976983646275
chr7	KMT2E	105068474	105068545	0	72	17175	9981	17175	9909	0.0	1.7332727823191039
chr7	KMT2E	105038384	105038525	0	142	17175	9981	17175	9839	0.0	1.7456042280719586
chr7	KMT2E	105064027	105064116	0	90	17175	9981	17175	9891	0.0	1.7364270548983924
chr7	KMT2E	105108543	105108658	0	116	17175	9981	17175	9865	0.0	1.7410035478966042
chr7	RINT1	105535571	105535691	465	121	7433	3420	6968	3299	3.84297520661157	2.1121551985450138
chr7	CDHR3	105974843	105975046	0	204	86249	9741	86249	9537	0.0	9.043619586872182
chr7	LINC02577	106777541	106777732	0	192	4705	4128	4705	3936	0.0	1.1953760162601625
chr7	LINC02577	106775958	106776022	0	65	4705	4128	4705	4063	0.0	1.158011321683485
chr7	PIK3CG	106867549	106869556	612	2008	2574	7778	1962	5770	0.3047808764940239	0.34003466204506066
chr7	HBP1	107174447	107174745	0	299	153	6030	153	5731	0.0	0.026696911533763742
chr7	HBP1	107196289	107196369	0	81	153	6030	153	5949	0.0	0.025718608169440244
chr7	DUS4L-BCAP29	107564587	107564676	1014	90	272938	7282	271924	7192	11.266666666666667	37.80923248053393
chr7	DUS4L-BCAP29	107571144	107571266	0	123	272938	7282	272938	7159	0.0	38.125157144852636
chr7	DUS4L-BCAP29	107573703	107573821	77	119	272938	7282	272861	7163	0.6470588235294118	38.093117408906885
chr7	BCAP29	107580758	107580864	9839	107	352856	5519	343017	5412	91.95327102803738	63.380820399113084
chr7	DUS4L-BCAP29	107593954	107594105	50855	152	272938	7282	222083	7130	334.57236842105266	31.147685834502102
chr7	DUS4L-BCAP29	107613653	107613732	0	80	272938	7282	272938	7202	0.0	37.89752846431547
chr7	DUS4L-BCAP29	107573703	107573883	561	181	272938	7282	272377	7101	3.0994475138121547	38.357555273905085
chr7	BCAP29	107580645	107580864	35148	220	352856	5519	317708	5299	159.76363636363635	59.95621815436875
chr7	SLC26A4	107701100	107701196	0	97	102	5632	102	5535	0.0	0.01842818428184282
chr7	SLC26A4	107704330	107704385	0	56	102	5632	102	5576	0.0	0.018292682926829267
chr7	CBLL1	107752544	107752617	0	74	0	5237	0	5163	0.0	0.0
chr7	CBLL1	107755417	107755491	0	75	0	5237	0	5162	0.0	0.0
chr7	DLD	107905360	107905504	0	145	34	4987	34	4842	0.0	0.007021891780256092
chr7	DLD	107902324	107902393	0	70	34	4987	34	4917	0.0	0.006914785438275371
chr7	DLD	107901737	107901817	0	81	34	4987	34	4906	0.0	0.006930289441500204
chr7	DLD	107904662	107904746	0	85	34	4987	34	4902	0.0	0.0069359445124439
chr7	LRRN3	111097026	111097133	0	108	1785	3880	1785	3772	0.0	0.4732237539766702
chr7	LRRN3	111099880	111099962	0	83	1785	3880	1785	3797	0.0	0.47010797998419807
chr7	ZNF277	112295868	112295957	0	90	0	4755	0	4665	0.0	0.0
chr7	IFRD1	112450577	112450782	0	206	16528	6697	16528	6491	0.0	2.5462948698197505
chr7	IFRD1	112462269	112462378	1084	110	16528	6697	15444	6587	9.854545454545455	2.3446181873386975
chr7	IFRD1	112450507	112450782	0	276	16528	6697	16528	6421	0.0	2.5740538856875874
chr7	IFRD1	112465638	112465838	0	201	16528	6697	16528	6496	0.0	2.544334975369458
chr7	IFRD1	112465614	112465838	0	225	16528	6697	16528	6472	0.0	2.553770086526576
chr7	IFRD1	112470898	112471033	0	136	16528	6697	16528	6561	0.0	2.519128181679622
chr7	IFRD1	112475429	112475676	0	248	16528	6697	16528	6449	0.0	2.5628779655760585
chr7	LSMEM1	112483413	112483606	0	194	0	2599	0	2405	0.0	0.0
chr7	LSMEM1	112486351	112486439	0	89	0	2599	0	2510	0.0	0.0
chr7	AC002463.1	112618819	112619021	0	203	104220	5157	104220	4954	0.0	21.037545417844168
chr7	AC002463.1	112640161	112640218	0	58	104220	5157	104220	5099	0.0	20.439301823887035
chr7	AC002463.1	112701366	112701437	0	72	104220	5157	104220	5085	0.0	20.495575221238937
chr7	AC002463.1	112707736	112707861	0	126	104220	5157	104220	5031	0.0	20.71556350626118
chr7	AC002463.1	112757086	112757316	98960	231	104220	5157	5260	4926	428.3982683982684	1.0678034916768169
chr7	AC002463.1	112640079	112640218	0	140	104220	5157	104220	5017	0.0	20.773370540163445
chr7	AC002463.1	112626157	112626410	5171	254	104220	5157	99049	4903	20.358267716535433	20.2017132367938
chr7	AC002463.1	112699329	112699522	0	194	104220	5157	104220	4963	0.0	20.999395526899054
chr7	AC002463.1	112648055	112648144	0	90	104220	5157	104220	5067	0.0	20.568383658969804
chr7	AC002463.1	112707741	112707861	0	121	104220	5157	104220	5036	0.0	20.694996028594122
chr7	AC002463.1	112638094	112638284	0	191	104220	5157	104220	4966	0.0	20.98670962545308
chr7	FOXP2	114538325	114538383	0	59	35018	16292	35018	16233	0.0	2.15721062034128
chr7	FOXP2	114570806	114570881	0	76	35018	16292	35018	16216	0.0	2.159472126295017
chr7	FOXP2	114629591	114629642	0	52	35018	16292	35018	16240	0.0	2.15628078817734
chr7	FOXP2	114659355	114659432	406	78	35018	16292	34612	16214	5.205128205128205	2.134698408782534
chr7	FOXP2	114162943	114163088	0	146	35018	16292	35018	16146	0.0	2.1688343862256905
chr7	FOXP2	114463073	114463171	0	99	35018	16292	35018	16193	0.0	2.162539368863089
chr7	FOXP2	114285404	114285456	0	53	35018	16292	35018	16239	0.0	2.156413572264302
chr7	FOXP2	114366504	114366640	0	137	35018	16292	35018	16155	0.0	2.1676261219436705
chr7	FOXP2	114656439	114656594	7624	156	35018	16292	27394	16136	48.87179487179487	1.6976945959345562
chr7	FOXP2	114630610	114630613	4	4	35018	16292	35014	16288	1.0	2.149680746561886
chr7	FOXP2	114658065	114658267	20813	203	35018	16292	14205	16089	102.52709359605912	0.8829013611784449
chr7	MDFIC	115014462	115014533	0	72	0	5056	0	4984	0.0	0.0
chr7	LINC01393	115118934	115119056	0	123	0	2309	0	2186	0.0	0.0
chr7	LINC01393	115122177	115122247	0	71	0	2309	0	2238	0.0	0.0
chr7	TES	116234533	116234619	0	87	0	4275	0	4188	0.0	0.0
chr7	TES	116251759	116251975	0	217	0	4275	0	4058	0.0	0.0
chr7	CAV2	116316431	116316510	0	80	19364	6517	19364	6437	0.0	3.008233649215473
chr7	CAV2	116432958	116433119	0	162	19364	6517	19364	6355	0.0	3.047049567269866
chr7	CAV2	116427321	116427486	272	166	19364	6517	19092	6351	1.6385542168674698	3.0061407652338215
chr7	CAV2	116500259	116500447	0	189	19364	6517	19364	6328	0.0	3.0600505689001265
chr7	CAV2	116323089	116323179	0	91	19364	6517	19364	6426	0.0	3.01338313103019
chr7	CAV2	116500533	116500658	0	126	19364	6517	19364	6391	0.0	3.0298857768737286
chr7	CAV1	116525627	116525805	0	179	79752	3435	79752	3256	0.0	24.493857493857494
chr7	MET	116759336	116759490	0	155	35770	7248	35770	7093	0.0	5.043000140984069
chr7	MET	116771848	116771989	19997	142	35770	7248	15773	7106	140.82394366197184	2.21967351533915
chr7	MET	116759390	116759490	0	101	35770	7248	35770	7147	0.0	5.004897159647404
chr7	MET	116695749	116695799	0	51	35770	7248	35770	7197	0.0	4.970126441572877
chr7	CAPZA2	116861190	116861350	493	161	1971	7326	1478	7165	3.062111801242236	0.20628053035589672
chr7	CAPZA2	116880066	116880147	0	82	1971	7326	1971	7244	0.0	0.2720872446162341
chr7	CAPZA2	116906262	116906342	0	81	1971	7326	1971	7245	0.0	0.2720496894409938
chr7	ST7	117099761	117099844	0	84	0	6497	0	6413	0.0	0.0
chr7	ST7	117119560	117119720	0	161	0	6497	0	6336	0.0	0.0
chr7	ST7	117221922	117222062	0	141	0	6497	0	6356	0.0	0.0
chr7	ST7	117134123	117134192	0	70	0	6497	0	6427	0.0	0.0
chr7	ST7	117219083	117219176	0	94	0	6497	0	6403	0.0	0.0
chr7	ST7	117098612	117098815	0	204	0	6497	0	6293	0.0	0.0
chr7	ST7	117090748	117090837	0	90	0	6497	0	6407	0.0	0.0
chr7	ST7	117022902	117022999	0	98	0	6497	0	6399	0.0	0.0
chr7	CFTR	117534275	117534365	0	91	703	9870	703	9779	0.0	0.07188874118007976
chr7	CFTR	117505154	117505228	0	75	703	9870	703	9795	0.0	0.07177131189382338
chr7	CFTR	117548640	117548823	0	184	703	9870	703	9686	0.0	0.07257897997109229
chr7	ANKRD7	118280192	118280289	0	98	0	2975	0	2877	0.0	0.0
chr7	ANKRD7	118227931	118227991	0	61	0	2975	0	2914	0.0	0.0
chr7	ING3	120964741	120964838	0	98	1073	5212	1073	5114	0.0	0.20981619084865077
chr7	PTPRZ1	122034094	122034115	0	22	0	8512	0	8490	0.0	0.0
chr7	PTPRZ1	122038754	122038889	0	136	0	8512	0	8376	0.0	0.0
chr7	PTPRZ1	122047673	122047790	0	118	0	8512	0	8394	0.0	0.0
chr7	PTPRZ1	122058799	122058942	0	144	0	8512	0	8368	0.0	0.0
chr7	PTPRZ1	122012647	122012821	0	175	0	8512	0	8337	0.0	0.0
chr7	PTPRZ1	121893523	121893626	0	104	0	8512	0	8408	0.0	0.0
chr7	PTPRZ1	122012647	122013889	0	1243	0	8512	0	7269	0.0	0.0
chr7	PTPRZ1	122012077	122013889	0	1813	0	8512	0	6699	0.0	0.0
chr7	AC015983.2	122201253	122201396	0	144	0	1896	0	1752	0.0	0.0
chr7	AC015983.2	122216347	122216462	0	116	0	1896	0	1780	0.0	0.0
chr7	AC015983.2	122145987	122146058	0	72	0	1896	0	1824	0.0	0.0
chr7	AC015983.2	122214095	122214189	0	95	0	1896	0	1801	0.0	0.0
chr7	AC004594.1	122366781	122366878	0	98	0	3479	0	3381	0.0	0.0
chr7	AC004594.1	122368069	122368204	0	136	0	3479	0	3343	0.0	0.0
chr7	AC004594.1	122357355	122357409	0	55	0	3479	0	3424	0.0	0.0
chr7	AC004594.1	122412809	122413082	0	274	0	3479	0	3205	0.0	0.0
chr7	AC004594.1	122420966	122421120	0	155	0	3479	0	3324	0.0	0.0
chr7	AC004594.1	122338949	122338996	0	48	0	3479	0	3431	0.0	0.0
chr7	AC004594.1	122331900	122332053	0	154	0	3479	0	3325	0.0	0.0
chr7	AC004594.1	122395469	122395522	0	54	0	3479	0	3425	0.0	0.0
chr7	ASB15	123612275	123612400	0	126	153	4927	153	4801	0.0	0.03186836075817538
chr7	ASB15	123608593	123608654	0	62	153	4927	153	4865	0.0	0.03144912641315519
chr7	HYAL4	123876025	123876082	0	58	0	2750	0	2692	0.0	0.0
chr7	SPAM1	123947703	123947788	0	86	33	3041	33	2955	0.0	0.01116751269035533
chr7	AC006148.1	124334246	124334390	0	145	225	17199	225	17054	0.0	0.013193385715961065
chr7	AC006148.1	124077246	124077372	0	127	225	17199	225	17072	0.0	0.013179475164011247
chr7	AC006148.1	124353150	124353855	0	706	225	17199	225	16493	0.0	0.013642151215667253
chr7	POT1-AS1	125116873	125117028	0	156	0	16759	0	16603	0.0	0.0
chr7	POT1-AS1	125125824	125125977	0	154	0	16759	0	16605	0.0	0.0
chr7	POT1-AS1	125403503	125403664	0	162	0	16759	0	16597	0.0	0.0
chr7	POT1-AS1	125438091	125438297	0	207	0	16759	0	16552	0.0	0.0
chr7	POT1-AS1	125138572	125138659	0	88	0	16759	0	16671	0.0	0.0
chr7	POT1-AS1	125089689	125089776	0	88	0	16759	0	16671	0.0	0.0
chr7	POT1-AS1	125000681	125001012	0	332	0	16759	0	16427	0.0	0.0
chr7	POT1-AS1	125080711	125080813	0	103	0	16759	0	16656	0.0	0.0
chr7	POT1-AS1	125347124	125347207	0	84	0	16759	0	16675	0.0	0.0
chr7	POT1-AS1	125438144	125438297	0	154	0	16759	0	16605	0.0	0.0
chr7	GRM8-AS1	127219466	127219702	2	237	290734	1921	290732	1684	0.008438818565400843	172.6437054631829
chr7	SND1	127990946	127991056	0	111	7185	6520	7185	6409	0.0	1.121079731627399
chr7	SND1	128074501	128074690	0	190	7185	6520	7185	6330	0.0	1.1350710900473933
chr7	METTL2B	128477081	128477173	0	93	582287	6255	582287	6162	0.0	94.49642973060695
chr7	METTL2B	128477948	128477992	0	45	582287	6255	582287	6210	0.0	93.76602254428342
chr7	AC090114.3	128577963	128578033	36	71	39457	838	39421	767	0.5070422535211268	51.396349413298566
chr7	FAM71F2	128677563	128677813	408	251	2651	3056	2243	2805	1.6254980079681276	0.7996434937611409
chr7	FAM71F1	128724768	128725072	0	305	10	2436	10	2131	0.0	0.004692632566870014
chr7	CALU	128747552	128748367	0	816	32594	6140	32594	5324	0.0	6.122088655146507
chr7	CALU	128767455	128767655	32594	201	32594	6140	0	5939	162.1592039800995	0.0
chr7	CCDC136	128792099	128792183	0	85	28934	6127	28934	6042	0.0	4.788811651770937
chr7	CCDC136	128806236	128806395	51	160	28934	6127	28883	5967	0.31875	4.84045584045584
chr7	CCDC136	128817757	128817864	85	108	28934	6127	28849	6019	0.7870370370370371	4.792988868582821
chr7	FLNC	128849975	128850074	819	100	146549	9298	145730	9198	8.19	15.843661665579473
chr7	ATP6V1F	128865119	128865203	1256	85	3245	765	1989	680	14.776470588235295	2.925
chr7	IRF5	128947022	128947056	0	35	1446	4365	1446	4330	0.0	0.33394919168591225
chr7	IRF5	128947229	128947535	0	307	1446	4365	1446	4058	0.0	0.35633316904879253
chr7	IRF5	128941278	128941391	0	114	1446	4365	1446	4251	0.0	0.34015525758645027
chr7	IRF5	128941278	128941424	0	147	1446	4365	1446	4218	0.0	0.34281650071123754
chr7	IRF5	128947277	128947535	0	259	1446	4365	1446	4106	0.0	0.3521675596687774
chr7	IRF5	128943058	128943134	0	77	1446	4365	1446	4288	0.0	0.33722014925373134
chr7	SMO	129209288	129209397	0	110	51	4764	51	4654	0.0	0.01095831542758917
chr7	SMO	129191897	129192097	0	201	51	4764	51	4563	0.0	0.011176857330703484
chr7	SMO	129211382	129211510	0	129	51	4764	51	4635	0.0	0.011003236245954692
chr7	NRF1	129641724	129641822	0	99	26287	4134	26287	4035	0.0	6.514745972738538
chr7	NRF1	129744172	129744229	172	58	26287	4134	26115	4076	2.9655172413793105	6.407016683022571
chr7	AC073320.1	130023012	130023070	0	59	0	1538	0	1479	0.0	0.0
chr7	KLHDC10	130096920	130097007	0	88	12134	6595	12134	6507	0.0	1.8647610265867527
chr7	KLHDC10	130094894	130094931	0	38	12134	6595	12134	6557	0.0	1.8505414061308525
chr7	CPA2	130273705	130273811	18	107	459	1805	441	1698	0.16822429906542055	0.2597173144876325
chr7	CPA4	130305815	130305920	0	106	204	3971	204	3865	0.0	0.05278137128072445
chr7	CPA4	130300815	130300914	0	100	204	3971	204	3871	0.0	0.05269956083699302
chr7	CPA5	130345838	130345896	0	59	4759	2962	4759	2903	0.0	1.6393386152256286
chr7	CPA5	130367905	130367990	0	86	4759	2962	4759	2876	0.0	1.6547287899860919
chr7	CPA5	130367371	130367571	0	201	4759	2962	4759	2761	0.0	1.723650851140891
chr7	MEST	130500788	130500890	0	103	559	4491	559	4388	0.0	0.12739288969917958
chr7	MEST	130493202	130493263	0	62	559	4491	559	4429	0.0	0.1262135922330097
chr7	LINC00513	130928030	130928199	0	170	202648	2162	202648	1992	0.0	101.73092369477912
chr7	MKLN1	131478622	131478677	0	56	679	12894	679	12838	0.0	0.05288985823336968
chr7	MKLN1	131202856	131202974	0	119	679	12894	679	12775	0.0	0.05315068493150685
chr7	MKLN1	131375423	131375493	0	71	679	12894	679	12823	0.0	0.05295172736489121
chr7	BPGM	134647134	134647259	159	126	1941	2545	1782	2419	1.2619047619047619	0.7366680446465481
chr7	BPGM	134658347	134658668	0	322	1941	2545	1941	2223	0.0	0.873144399460189
chr7	CALD1	134935687	134935765	0	79	1660	9452	1660	9373	0.0	0.17710444894910915
chr7	CALD1	134844250	134844336	0	87	1660	9452	1660	9365	0.0	0.17725573945541911
chr7	CALD1	134928048	134928090	0	43	1660	9452	1660	9409	0.0	0.17642682537995535
chr7	CALD1	134962819	134962934	0	116	1660	9452	1660	9336	0.0	0.1778063410454156
chr7	AGBL3	134993492	134993678	0	187	1309	7328	1309	7141	0.0	0.18330765999159782
chr7	AGBL3	135051021	135051154	1224	134	1309	7328	85	7194	9.134328358208956	0.011815401723658605
chr7	AC009542.1	135201473	135201547	0	75	102	2508	102	2433	0.0	0.04192355117139334
chr7	NUP205	135613720	135613808	85565	89	279137	7667	193572	7578	961.4044943820224	25.543942992874108
chr7	STMP1	135672752	135672806	0	55	0	4939	0	4884	0.0	0.0
chr7	AC024084.1	136027163	136027309	0	147	0	1484	0	1337	0.0	0.0
chr7	AC078845.1	136177251	136177413	0	163	0	3283	0	3120	0.0	0.0
chr7	AC078845.1	136242149	136242371	0	223	0	3283	0	3060	0.0	0.0
chr7	AC078845.1	136117070	136117188	0	119	0	3283	0	3164	0.0	0.0
chr7	AC078845.1	136405269	136405316	0	48	0	3283	0	3235	0.0	0.0
chr7	AKR1D1	138105306	138105429	0	124	407	3424	407	3300	0.0	0.12333333333333334
chr7	AKR1D1	138113689	138113772	0	84	407	3424	407	3340	0.0	0.1218562874251497
chr7	AKR1D1	138088600	138088768	407	169	407	3424	0	3255	2.408284023668639	0.0
chr7	TMEM213	138801329	138801398	0	70	0	4817	0	4747	0.0	0.0
chr7	TMEM213	138801326	138801398	0	73	0	4817	0	4744	0.0	0.0
chr7	TTC26	139137846	139137939	530	94	683	5017	153	4923	5.638297872340425	0.031078610603290677
chr7	TTC26	139187405	139187539	0	135	683	5017	683	4882	0.0	0.13990167963949202
chr7	TTC26	139160947	139161022	0	76	683	5017	683	4941	0.0	0.13823112730216555
chr7	LUC7L2	139375508	139375583	144	76	98102	5494	97958	5418	1.894736842105263	18.080103359173126
chr7	LUC7L2	139374400	139374471	0	72	98102	5494	98102	5422	0.0	18.093323496864624
chr7	CLEC2L	139536273	139536348	0	76	51	2704	51	2628	0.0	0.019406392694063926
chr7	TBXAS1	139782665	139782729	0	65	1504	6297	1504	6232	0.0	0.24133504492939667
chr7	TBXAS1	139911224	139911321	0	98	1504	6297	1504	6199	0.0	0.24261977738344895
chr7	TBXAS1	140017670	140017833	0	164	1504	6297	1504	6133	0.0	0.24523071906081853
chr7	TBXAS1	139780739	139780824	0	86	1504	6297	1504	6211	0.0	0.242151022379649
chr7	TBXAS1	139829311	139829479	51	169	1504	6297	1453	6128	0.30177514792899407	0.2371083550913838
chr7	TBXAS1	139952550	139952688	0	139	1504	6297	1504	6158	0.0	0.24423514127963625
chr7	TBXAS1	139906100	139906198	0	99	1504	6297	1504	6198	0.0	0.24265892223297839
chr7	ADCK2	140689596	140689725	0	130	150	3120	150	2990	0.0	0.05016722408026756
chr7	NDUFB2	140700873	140700959	0	87	239222	4289	239222	4202	0.0	56.93050928129462
chr7	NDUFB2	140698074	140698268	0	195	239222	4289	239222	4094	0.0	58.43234000977039
chr7	NDUFB2	140700869	140700959	0	91	239222	4289	239222	4198	0.0	56.98475464506908
chr7	AGK	141555452	141555567	0	116	369	9243	369	9127	0.0	0.04042949490522625
chr7	AGK	141593145	141593185	0	41	369	9243	369	9202	0.0	0.04009997826559444
chr7	AGK	141633900	141633980	0	81	369	9243	369	9162	0.0	0.04027504911591356
chr7	AGK	141562106	141562110	0	5	369	9243	369	9238	0.0	0.039943710759904744
chr7	AGK	141641247	141641398	0	152	369	9243	369	9091	0.0	0.04058959410405896
chr7	AGK	141594674	141594928	0	255	369	9243	369	8988	0.0	0.041054739652870494
chr7	AGK	141555463	141555567	0	105	369	9243	369	9138	0.0	0.040380827314510835
chr7	AGK	141600491	141600557	0	67	369	9243	369	9176	0.0	0.040213600697471666
chr7	AGK	141624179	141624296	12	118	369	9243	357	9125	0.1016949152542373	0.039123287671232874
chr7	WEE2	141725025	141725196	0	172	0	3073	0	2901	0.0	0.0
chr7	MGAM	142004389	142004488	0	100	0	10843	0	10743	0.0	0.0
chr7	PRSS1	142751068	142751110	0	43	0	1218	0	1175	0.0	0.0
chr7	PRSS2	142772561	142772603	0	43	0	1266	0	1223	0.0	0.0
chr7	EPHB6	142863630	142863695	0	66	102	4742	102	4676	0.0	0.021813515825491875
chr7	EPHB6	142870529	142870685	0	157	102	4742	102	4585	0.0	0.022246455834242094
chr7	EPHB6	142870590	142870685	0	96	102	4742	102	4646	0.0	0.021954369349978475
chr7	GSTK1	143264547	143264676	0	130	1667	3842	1667	3712	0.0	0.44908405172413796
chr7	GSTK1	143268090	143268184	0	95	1667	3842	1667	3747	0.0	0.4448892447291166
chr7	GSTK1	143265260	143265296	0	37	1667	3842	1667	3805	0.0	0.438107752956636
chr7	TMEM139	143285344	143285445	0	102	0	2569	0	2467	0.0	0.0
chr7	TMEM139	143285347	143285445	0	99	0	2569	0	2470	0.0	0.0
chr7	TMEM139	143285940	143286202	0	263	0	2569	0	2306	0.0	0.0
chr7	TMEM139	143285553	143285640	0	88	0	2569	0	2481	0.0	0.0
chr7	CLCN1	143324413	143324492	0	80	594	3346	594	3266	0.0	0.18187385180649113
chr7	CLCN1	143323308	143323386	0	79	594	3346	594	3267	0.0	0.18181818181818182
chr7	CLCN1	143323572	143323627	0	56	594	3346	594	3290	0.0	0.18054711246200608
chr7	ZYX	143382592	143382685	0	94	0	3134	0	3040	0.0	0.0
chr7	ZYX	143381556	143381779	0	224	0	3134	0	2910	0.0	0.0
chr7	ZYX	143387761	143387787	0	27	0	3134	0	3107	0.0	0.0
chr7	ZYX	143384089	143384245	0	157	0	3134	0	2977	0.0	0.0
chr7	AC073264.3	143623761	143624398	0	638	0	2583	0	1945	0.0	0.0
chr7	TCAF2	143720805	143720985	0	181	0	6420	0	6239	0.0	0.0
chr7	ARHGEF35-AS1	144200170	144200277	0	108	0	7882	0	7774	0.0	0.0
chr7	ARHGEF35-AS1	144201551	144201891	0	341	0	7882	0	7541	0.0	0.0
chr7	ARHGEF35-AS1	144215858	144215912	0	55	0	7882	0	7827	0.0	0.0
chr7	OR2A9P	144298483	144298680	0	198	0	2184	0	1986	0.0	0.0
chr7	ARHGEF5	144375513	144375675	0	163	380	5833	380	5670	0.0	0.06701940035273368
chr7	CUL1	148759303	148759354	0	52	14536	4022	14536	3970	0.0	3.6614609571788415
chr7	CUL1	148760332	148760496	1264	165	14536	4022	13272	3857	7.66060606060606	3.441016333938294
chr7	CUL1	148786988	148787120	0	133	14536	4022	14536	3889	0.0	3.737721779377732
chr7	CUL1	148790309	148790441	0	133	14536	4022	14536	3889	0.0	3.737721779377732
chr7	CUL1	148797936	148798019	161	84	14536	4022	14375	3938	1.9166666666666667	3.6503301168105637
chr7	ZNF212	149251279	149251327	80	49	29836	3185	29756	3136	1.6326530612244898	9.488520408163266
chr7	ZNF212	149251209	149251327	102	119	29836	3185	29734	3066	0.8571428571428571	9.697977821265493
chr7	AC004890.2	149291555	149291745	561	191	4906	4299	4345	4108	2.93717277486911	1.0576923076923077
chr7	AC004890.2	149289937	149290038	0	102	4906	4299	4906	4197	0.0	1.1689301882296879
chr7	AC004890.2	149288620	149288691	0	72	4906	4299	4906	4227	0.0	1.160634019399101
chr7	KRBA1	149715238	149715349	0	112	0	5309	0	5197	0.0	0.0
chr7	KRBA1	149729187	149729370	0	184	0	5309	0	5125	0.0	0.0
chr7	SSPOP	149782846	149783022	0	177	46	19328	46	19151	0.0	0.0024019633439507073
chr7	SSPOP	149811910	149812121	0	212	46	19328	46	19116	0.0	0.00240636116342331
chr7	SSPOP	149822511	149822679	0	169	46	19328	46	19159	0.0	0.0024009603841536613
chr7	SSPOP	149825799	149825938	0	140	46	19328	46	19188	0.0	0.0023973316656243485
chr7	SSPOP	149826678	149826821	0	144	46	19328	46	19184	0.0	0.0023978315262718933
chr7	SSPOP	149823723	149823848	0	126	46	19328	46	19202	0.0	0.002395583793354859
chr7	SSPOP	149826074	149826277	0	204	46	19328	46	19124	0.0	0.0024053545283413513
chr7	SSPOP	149823351	149823482	0	132	46	19328	46	19196	0.0	0.002396332569285268
chr7	SSPOP	149826449	149826577	0	129	46	19328	46	19199	0.0	0.0023959581228188967
chr7	ATP6V0E2	149878677	149878790	0	114	0	6761	0	6647	0.0	0.0
chr7	ATP6V0E2	149875972	149876089	0	118	0	6761	0	6643	0.0	0.0
chr7	ATP6V0E2	149878677	149878746	0	70	0	6761	0	6691	0.0	0.0
chr7	ATP6V0E2	149879165	149879225	0	61	0	6761	0	6700	0.0	0.0
chr7	AC092666.1	150035605	150035666	0	62	2485	5281	2485	5219	0.0	0.4761448553362713
chr7	AC092666.1	150041951	150042012	0	62	2485	5281	2485	5219	0.0	0.4761448553362713
chr7	AC092666.1	150043178	150043239	0	62	2485	5281	2485	5219	0.0	0.4761448553362713
chr7	AC092666.1	150037614	150037675	0	62	2485	5281	2485	5219	0.0	0.4761448553362713
chr7	AC092666.1	150040571	150040654	0	84	2485	5281	2485	5197	0.0	0.47816047719838367
chr7	AC092666.1	150063269	150063412	204	144	2485	5281	2281	5137	1.4166666666666667	0.4440334825773798
chr7	AC092666.1	150043588	150043660	0	73	2485	5281	2485	5208	0.0	0.4771505376344086
chr7	AC092666.1	150062054	150062259	0	206	2485	5281	2485	5075	0.0	0.4896551724137931
chr7	AC092666.1	150043138	150043239	0	102	2485	5281	2485	5179	0.0	0.4798223595288666
chr7	AC092666.1	150041968	150042012	0	45	2485	5281	2485	5236	0.0	0.47459893048128343
chr7	LRRC61	150324357	150324418	0	62	0	1972	0	1910	0.0	0.0
chr7	LRRC61	150325840	150326010	0	171	0	1972	0	1801	0.0	0.0
chr7	REPIN1	150370759	150370884	0	126	0	4590	0	4464	0.0	0.0
chr7	REPIN1	150369670	150369868	0	199	0	4590	0	4391	0.0	0.0
chr7	REPIN1	150369741	150369868	0	128	0	4590	0	4462	0.0	0.0
chr7	REPIN1	150370713	150370884	0	172	0	4590	0	4418	0.0	0.0
chr7	AC073111.3	150407583	150408488	51	906	186	4340	135	3434	0.056291390728476824	0.039312754804892255
chr7	LINC00996	150435029	150435157	0	129	0	2176	0	2047	0.0	0.0
chr7	GIMAP4	150569887	150570001	0	115	0	2102	0	1987	0.0	0.0
chr7	GIMAP4	150569887	150569959	0	73	0	2102	0	2029	0.0	0.0
chr7	TMEM176A	150804361	150804472	0	112	11310	2191	11310	2079	0.0	5.44011544011544
chr7	TMEM176A	150804361	150804485	0	125	11310	2191	11310	2066	0.0	5.4743465634075505
chr7	AOC1	150853917	150854163	0	247	1274	3797	1274	3550	0.0	0.3588732394366197
chr7	NOS3	150993752	150993961	0	210	204	5947	204	5737	0.0	0.035558654348962875
chr7	ABCB8	151040267	151040301	420	35	177864	9139	177444	9104	12.0	19.490773286467487
chr7	ABCB8	151028800	151028911	86	112	177864	9139	177778	9027	0.7678571428571429	19.694029024038993
chr7	ABCB8	151028779	151028852	79	74	177864	9139	177785	9065	1.0675675675675675	19.612244897959183
chr7	ABCB8	151028779	151028911	102	133	177864	9139	177762	9006	0.7669172932330827	19.7381745502998
chr7	ABCB8	151031240	151031291	0	52	177864	9139	177864	9087	0.0	19.573456586332124
chr7	ABCB8	151033604	151033917	0	314	177864	9139	177864	8825	0.0	20.15456090651558
chr7	ABCB8	151032843	151033061	0	219	177864	9139	177864	8920	0.0	19.939910313901347
chr7	ABCB8	151034272	151034428	0	157	177864	9139	177864	8982	0.0	19.802271209084836
chr7	ASIC3	151051171	151051319	36	149	37959	2756	37923	2607	0.24161073825503357	14.546605293440736
chr7	ASIC3	151052415	151052474	57	60	37959	2756	37902	2696	0.95	14.058605341246292
chr7	AGAP3	151138142	151138313	0	172	306	10457	306	10285	0.0	0.02975206611570248
chr7	AGAP3	151119986	151120145	0	160	306	10457	306	10297	0.0	0.02971739341555793
chr7	AGAP3	151120519	151120745	0	227	306	10457	306	10230	0.0	0.029912023460410556
chr7	AGAP3	151120519	151120567	0	49	306	10457	306	10408	0.0	0.029400461183704842
chr7	AGAP3	151139978	151140116	0	139	306	10457	306	10318	0.0	0.029656910253925178
chr7	CHPF2	151234085	151234274	0	190	102	4210	102	4020	0.0	0.025373134328358207
chr7	CHPF2	151236955	151237172	0	218	102	4210	102	3992	0.0	0.02555110220440882
chr7	NUB1	151374096	151374201	0	106	2460	5427	2460	5321	0.0	0.4623191129486939
chr7	NUB1	151374096	151374243	0	148	2460	5427	2460	5279	0.0	0.4659973479825725
chr7	NUB1	151352092	151352193	0	102	2460	5427	2460	5325	0.0	0.4619718309859155
chr7	WDR86-AS1	151411227	151411312	0	86	433	1187	433	1101	0.0	0.3932788374205268
chr7	GALNTL5	151957782	151957886	0	105	1066	3335	1066	3230	0.0	0.330030959752322
chr7	GALNT11	152100797	152100921	0	125	976	7002	976	6877	0.0	0.14192234986185837
chr7	GALNT11	152027596	152027718	409	123	976	7002	567	6879	3.3252032520325203	0.08242477104230266
chr7	GALNT11	152100824	152100921	0	98	976	7002	976	6904	0.0	0.1413673232908459
chr7	GALNT11	152116903	152117038	0	136	976	7002	976	6866	0.0	0.14214972327410427
chr7	ACTR3B	152783186	152783242	0	57	102	5081	102	5024	0.0	0.020302547770700636
chr7	PAXIP1-AS2	154928955	154929024	0	70	0	6944	0	6874	0.0	0.0
chr7	HTR5A	155072192	155072441	0	250	357	4905	357	4655	0.0	0.07669172932330827
chr7	INSIG1	155303824	155303895	0	72	0	3328	0	3256	0.0	0.0
chr7	RBM33	155684932	155685052	0	121	306	13047	306	12926	0.0	0.02367321677239672
chr7	RBM33	155707293	155707380	0	88	306	13047	306	12959	0.0	0.02361293309668956
chr7	RNF32	156642976	156643087	0	112	4899	4235	4899	4123	0.0	1.1882124666504972
chr7	RNF32	156646453	156646560	0	108	4899	4235	4899	4127	0.0	1.1870608189968501
chr7	UBE3C	157164418	157164530	972	113	184924	9218	183952	9105	8.601769911504425	20.203404722679846
chr7	DNAJB6	157369359	157369475	0	117	0	10917	0	10800	0.0	0.0
chr7	DNAJB6	157337560	157337811	0	252	0	10917	0	10665	0.0	0.0
chr7	PTPRN2-AS1	157855926	157856130	0	205	0	1585	0	1380	0.0	0.0
chr7	DYNC2I1	158922376	158922549	0	174	0	6714	0	6540	0.0	0.0
chr7	AC215522.2	26288	26402	0	115	102	1563	102	1448	0.0	0.07044198895027624
chr7	AC215522.2	33680	33792	0	113	102	1563	102	1450	0.0	0.0703448275862069
chr7	AC093627.5	145293	145415	2033	123	76251	4819	74218	4696	16.528455284552845	15.804514480408859
chr7	PDGFA	500430	500499	0	70	0	4160	0	4090	0.0	0.0
chr7	PDGFA	518938	519068	0	131	0	4160	0	4029	0.0	0.0
chr7	ADAP1	900935	901031	13868	97	213241	4762	199373	4665	142.96907216494844	42.73804930332262
chr7	MICALL2	1437889	1437980	0	92	153	7681	153	7589	0.0	0.020160758993279747
chr7	MICALL2	1435100	1435147	0	48	153	7681	153	7633	0.0	0.0200445434298441
chr7	TMEM184A	1550122	1550198	0	77	6520	4053	6520	3976	0.0	1.6398390342052314
chr7	TMEM184A	1549546	1549604	36	59	6520	4053	6484	3994	0.6101694915254238	1.6234351527290936
chr7	MAD1L1	2225409	2225550	561	142	4993	7267	4432	7125	3.9507042253521125	0.6220350877192983
chr7	MAD1L1	2220883	2221022	0	140	4993	7267	4993	7127	0.0	0.7005752771151957
chr7	MAD1L1	2230548	2230764	445	217	4993	7267	4548	7050	2.0506912442396312	0.6451063829787234
chr7	MAD1L1	2230548	2230724	76	177	4993	7267	4917	7090	0.4293785310734463	0.6935119887165021
chr7	MAD1L1	2230548	2230727	92	180	4993	7267	4901	7087	0.5111111111111111	0.6915479046140821
chr7	MRM2	2238014	2238937	1772	924	2841	2892	1069	1968	1.9177489177489178	0.5431910569105691
chr7	SNX8	2337115	2337281	0	167	162822	5766	162822	5599	0.0	29.08055009823183
chr7	BRAT1	2539178	2539351	0	174	51	4242	51	4068	0.0	0.012536873156342183
chr7	BRAT1	2544908	2545056	0	149	51	4242	51	4093	0.0	0.012460298069875397
chr7	GNA12	2814311	2814389	204	79	16060	5912	15856	5833	2.5822784810126582	2.71832676152923
chr7	CARD11	2980519	2980580	0	62	132	4654	132	4592	0.0	0.028745644599303136
chr7	AC073316.1	3148980	3149068	0	89	0	1732	0	1643	0.0	0.0
chr7	MMD2	4909728	4909778	0	51	306	2474	306	2423	0.0	0.12628972348328518
chr7	TNRC18	5361593	5361722	0	130	21154	12605	21154	12475	0.0	1.6957114228456913
chr7	TNRC18	5329936	5329969	0	34	21154	12605	21154	12571	0.0	1.6827619123379207
chr7	ACTB	5529534	5529663	3945	130	57655	3559	53710	3429	30.346153846153847	15.663458734324877
chr7	ACTB	5529160	5529400	4761	241	57655	3559	52894	3318	19.755186721991702	15.941531042796866
chr7	ACTB	5529018	5529059	3849	42	57655	3559	53806	3517	91.64285714285714	15.298834233721923
chr7	ACTB	5529534	5529733	6889	200	57655	3559	50766	3359	34.445	15.113426615064007
chr7	ACTB	5540675	5540771	8533	97	57655	3559	49122	3462	87.96907216494846	14.188908145580589
chr7	RNF216	5760390	5760511	51	122	7597	7601	7546	7479	0.4180327868852459	1.0089584169006551
chr7	RNF216	5775004	5775179	593	176	7597	7601	7004	7425	3.3693181818181817	0.9432996632996633
chr7	RSPH10B	5932781	5932875	0	95	29702	5015	29702	4920	0.0	6.036991869918699
chr7	RSPH10B	5937757	5937901	0	145	29702	5015	29702	4870	0.0	6.098973305954826
chr7	RSPH10B	5945063	5945178	0	116	29702	5015	29702	4899	0.0	6.062869973463973
chr7	RSPH10B	5943910	5943990	0	81	29702	5015	29702	4934	0.0	6.01986218078638
chr7	RSPH10B	5958992	5959078	388	87	29702	5015	29314	4928	4.459770114942529	5.948457792207792
chr7	RSPH10B	5967317	5967437	0	121	29702	5015	29702	4894	0.0	6.069064160196159
chr7	PMS2	6003689	6003792	0	104	3468	5550	3468	5446	0.0	0.6367976496511201
chr7	PMS2	6005891	6006031	0	141	3468	5550	3468	5409	0.0	0.6411536328341653
chr7	PMS2	6005891	6006026	0	136	3468	5550	3468	5414	0.0	0.6405615072035463
chr7	EIF2AK1	6046070	6046151	0	82	74175	4527	74175	4445	0.0	16.687289088863892
chr7	EIF2AK1	6058147	6058242	0	96	74175	4527	74175	4431	0.0	16.740013540961407
chr7	DAGLB	6430479	6430607	14	129	14599	5365	14585	5236	0.10852713178294573	2.7855233002291824
chr7	DAGLB	6434761	6435020	1836	260	14599	5365	12763	5105	7.061538461538461	2.500097943192948
chr7	DAGLB	6432836	6432959	4306	124	14599	5365	10293	5241	34.725806451612904	1.9639381797366915
chr7	DAGLB	6436361	6436533	447	173	14599	5365	14152	5192	2.5838150289017343	2.725731895223421
chr7	KDELR2	6466070	6466323	2421	254	140167	3937	137746	3683	9.531496062992126	37.400488732011944
chr7	KDELR2	6482391	6482589	153	199	140167	3937	140014	3738	0.7688442211055276	37.45692883895131
chr7	CCZ1B	6796632	6796678	0	47	48	5850	48	5803	0.0	0.008271583663622264
chr7	CCZ1B	6812975	6813037	6	63	48	5850	42	5787	0.09523809523809523	0.007257646448937273
chr7	CCZ1B	6819765	6819941	0	177	48	5850	48	5673	0.0	0.008461131676361713
chr7	CCZ1B	6824454	6824548	0	95	48	5850	48	5755	0.0	0.008340573414422242
chr7	COL28A1	7511651	7511844	0	194	232	6312	232	6118	0.0	0.03792088917947042
chr7	RPA3	7640319	7640581	51	263	2306	3101	2255	2838	0.19391634980988592	0.7945736434108527
chr7	AC007161.1	7740685	7740842	0	158	2040	1452	2040	1294	0.0	1.5765069551777435
chr7	ICA1	8227637	8227851	0	215	9846	4842	9846	4627	0.0	2.127944672574022
chr7	ICA1	8141968	8142055	42	88	9846	4842	9804	4754	0.4772727272727273	2.062263357172907
chr7	ICA1	8223487	8223559	0	73	9846	4842	9846	4769	0.0	2.0645837701824283
chr7	VWDE	12353814	12354487	0	674	0	6744	0	6070	0.0	0.0
chr7	VWDE	12345738	12345960	0	223	0	6744	0	6521	0.0	0.0
chr7	VWDE	12354349	12354487	0	139	0	6744	0	6605	0.0	0.0
chr7	VWDE	12388807	12388957	0	151	0	6744	0	6593	0.0	0.0
chr7	ETV1	13911238	13911307	0	70	888	9310	888	9240	0.0	0.09610389610389611
chr7	ETV1	13935707	13935896	174	190	888	9310	714	9120	0.9157894736842105	0.07828947368421052
chr7	ETV1	13977426	13977480	0	55	888	9310	888	9255	0.0	0.09594813614262561
chr7	ETV1	13989267	13989464	0	198	888	9310	888	9112	0.0	0.09745390693590869
chr7	ETV1	13990552	13990702	0	151	888	9310	888	9159	0.0	0.09695381591876842
chr7	ETV1	13907792	13907856	0	65	888	9310	888	9245	0.0	0.09605191995673337
chr7	DGKB	14753927	14753948	0	22	13	9521	13	9499	0.0	0.001368565112117065
chr7	DGKB	14841193	14841450	0	258	13	9521	13	9263	0.0	0.0014034330130627227
chr7	CRPPA	16308522	16308627	45	106	318	7208	273	7102	0.42452830188679247	0.0384398760912419
chr7	CRPPA	16376091	16376241	0	151	318	7208	318	7057	0.0	0.04506164092390534
chr7	ANKMY2	16603548	16603660	0	113	2345	2863	2345	2750	0.0	0.8527272727272728
chr7	ANKMY2	16644625	16644812	0	188	2345	2863	2345	2675	0.0	0.8766355140186916
chr7	ANKMY2	16644684	16644812	0	129	2345	2863	2345	2734	0.0	0.8577176298463789
chr7	AGR3	16878509	16878645	0	137	0	1161	0	1024	0.0	0.0
chr7	AC073332.1	17295165	17295260	0	96	51	10260	51	10164	0.0	0.005017709563164109
chr7	AC073332.1	17291229	17291371	0	143	51	10260	51	10117	0.0	0.00504102006523673
chr7	AC073332.1	17292370	17292440	0	71	51	10260	51	10189	0.0	0.005005397978211797
chr7	AC073332.1	17287751	17287814	0	64	51	10260	51	10196	0.0	0.005001961553550412
chr7	AC073332.1	17295165	17295273	0	109	51	10260	51	10151	0.0	0.005024135553147473
chr7	AC019117.1	17459724	17459919	0	196	121	3525	121	3329	0.0	0.03634725142685491
chr7	AC019117.1	17482526	17482782	0	257	121	3525	121	3268	0.0	0.03702570379436965
chr7	AC019117.1	17482526	17482733	0	208	121	3525	121	3317	0.0	0.03647874585468797
chr7	AC019117.1	17481794	17481897	0	104	121	3525	121	3421	0.0	0.03536977491961415
chr7	SNX13	17893331	17893434	0	104	29006	16045	29006	15941	0.0	1.819584718650022
chr7	SNX13	17888559	17888722	0	164	29006	16045	29006	15881	0.0	1.8264592909766388
chr7	TMEM196	19724279	19724353	38	75	38	3555	0	3480	0.5066666666666667	0.0
chr7	TMEM196	19724279	19724351	36	73	38	3555	2	3482	0.4931506849315068	0.0005743825387708214
chr7	AC005062.1	19919865	19919977	0	113	0	3126	0	3013	0.0	0.0
chr7	AC004130.2	20329689	20329782	0	94	0	900	0	806	0.0	0.0
chr7	SP8	20785947	20786043	0	97	51	3721	51	3624	0.0	0.014072847682119206
chr7	CDCA7L	21911616	21911754	255	139	1657	3906	1402	3767	1.8345323741007193	0.3721794531457393
chr7	CDCA7L	21916753	21916894	0	142	1657	3906	1657	3764	0.0	0.4402231668437832
chr7	CDCA7L	21940261	21940315	120	55	1657	3906	1537	3851	2.1818181818181817	0.3991171124383277
chr7	CDCA7L	21911616	21911751	255	136	1657	3906	1402	3770	1.875	0.37188328912466845
chr7	RAPGEF5	22191528	22191642	0	115	78	9098	78	8983	0.0	0.008683068017366137
chr7	STEAP1B	22495361	22495480	0	120	161	6324	161	6204	0.0	0.025950999355254675
chr7	STEAP1B	22655201	22655349	0	149	161	6324	161	6175	0.0	0.026072874493927124
chr7	TOMM7	22817411	22817548	0	138	0	1757	0	1619	0.0	0.0
chr7	TOMM7	22817999	22818048	0	50	0	1757	0	1707	0.0	0.0
chr7	FAM126A	22983943	22984045	4373	103	78537	7672	74164	7569	42.45631067961165	9.798388162240718
chr7	FAM126A	22991060	22991139	408	80	78537	7672	78129	7592	5.1	10.290964172813489
chr7	FAM126A	22946951	22947247	0	297	78537	7672	78537	7375	0.0	10.649084745762712
chr7	FAM126A	22947032	22947247	0	216	78537	7672	78537	7456	0.0	10.53339592274678
chr7	IGF2BP3	23319137	23319254	0	118	97474	8233	97474	8115	0.0	12.01158348736907
chr7	IGF2BP3	23343717	23343853	3027	137	97474	8233	94447	8096	22.094890510948904	11.66588438735178
chr7	IGF2BP3	23361689	23361741	0	53	97474	8233	97474	8180	0.0	11.916136919315404
chr7	TRA2A	23522131	23522432	51	302	14758	3350	14707	3048	0.16887417218543047	4.8251312335958
chr7	TRA2A	23531180	23531270	153	91	14758	3350	14605	3259	1.6813186813186813	4.481436023320037
chr7	TRA2A	23522353	23522432	0	80	14758	3350	14758	3270	0.0	4.513149847094801
chr7	GSDME	24749563	24749793	102	231	73525	7275	73423	7044	0.44155844155844154	10.423480976717775
chr7	OSBPL3	24806775	24806902	0	128	6074	8114	6074	7986	0.0	0.7605810167793638
chr7	OSBPL3	24849068	24849176	0	109	6074	8114	6074	8005	0.0	0.7587757651467832
chr7	OSBPL3	24863199	24863292	0	94	6074	8114	6074	8020	0.0	0.757356608478803
chr7	CYCS	25124689	25124844	0	156	510	5795	510	5639	0.0	0.09044156765383933
chr7	CYCS	25124689	25124815	0	127	510	5795	510	5668	0.0	0.08997882851093861
chr7	C7ORF31	25179661	25179800	0	140	3845	3683	3845	3543	0.0	1.0852384984476433
chr7	AC005165.1	25596313	25596364	0	52	0	5486	0	5434	0.0	0.0
chr7	AC005165.1	25656087	25656231	0	145	0	5486	0	5341	0.0	0.0
chr7	AC005165.1	25656087	25656286	0	200	0	5486	0	5286	0.0	0.0
chr7	AC005165.1	25656087	25656229	0	143	0	5486	0	5343	0.0	0.0
chr7	AC005165.1	25656087	25656261	0	175	0	5486	0	5311	0.0	0.0
chr7	HNRNPA2B1	26193574	26193694	0	121	2234	8930	2234	8809	0.0	0.2536042683619026
chr7	HNRNPA2B1	26190992	26192338	709	1347	2234	8930	1525	7583	0.526354862657758	0.20110774099960438
chr7	HNRNPA2B1	26192494	26192577	516	84	2234	8930	1718	8846	6.142857142857143	0.1942120732534479
chr7	HNRNPA2B1	26171679	26171847	0	169	2234	8930	2234	8761	0.0	0.25499372217783356
chr7	HNRNPA2B1	26190992	26191128	97	137	2234	8930	2137	8793	0.708029197080292	0.24303423177527578
chr7	HNRNPA2B1	26185198	26185279	0	82	2234	8930	2234	8848	0.0	0.25248643761301987
chr7	HNRNPA2B1	26197830	26197866	12	37	2234	8930	2222	8893	0.32432432432432434	0.24985944000899585
chr7	HNRNPA2B1	26193250	26193373	0	124	2234	8930	2234	8806	0.0	0.25369066545537133
chr7	HNRNPA2B1	26193574	26193598	0	25	2234	8930	2234	8905	0.0	0.25087029758562607
chr7	HNRNPA2B1	26193598	26193694	0	97	2234	8930	2234	8833	0.0	0.2529152043473339
chr7	HNRNPA2B1	26192300	26192338	0	39	2234	8930	2234	8891	0.0	0.2512653244854347
chr7	HNRNPA2B1	26191421	26191650	0	230	2234	8930	2234	8700	0.0	0.25678160919540227
chr7	HNRNPA2B1	26191421	26192338	612	918	2234	8930	1622	8012	0.6666666666666666	0.20244633050424363
chr7	HOXA3	27126885	27127070	19	186	274	4315	255	4129	0.10215053763440861	0.061758294986679584
chr7	HIBADH	27649472	27649633	0	162	312	2220	312	2058	0.0	0.15160349854227406
chr7	JAZF1	28101618	28101804	102	187	70098	4271	69996	4084	0.5454545454545454	17.139079333986288
chr7	JAZF1	27914729	27914808	0	80	70098	4271	70098	4191	0.0	16.72584108804581
chr7	JAZF1	27913391	27913453	0	63	70098	4271	70098	4208	0.0	16.658269961977187
chr7	CPVL	29066022	29066121	0	100	0	3356	0	3256	0.0	0.0
chr7	CPVL	29064060	29064234	0	175	0	3356	0	3181	0.0	0.0
chr7	CPVL	29184420	29184548	0	129	0	3356	0	3227	0.0	0.0
chr7	AC007255.1	29561858	29561922	0	65	0	1444	0	1379	0.0	0.0
chr7	SCRN1	29968908	29969068	0	161	1815	6059	1815	5898	0.0	0.30773143438453715
chr7	FKBP14	30022664	30022816	34	153	7272	5349	7238	5196	0.2222222222222222	1.392994611239415
chr7	FKBP14	30020212	30020304	702	93	7272	5349	6570	5256	7.548387096774194	1.25
chr7	NOD1	30459151	30459240	0	90	8437	6096	8437	6006	0.0	1.4047619047619047
chr7	NOD1	30428503	30428609	23	107	8437	6096	8414	5989	0.21495327102803738	1.4049089998330273
chr7	NOD1	30463985	30464061	153	77	8437	6096	8284	6019	1.9870129870129871	1.376308356869912
chr7	NOD1	30475847	30475988	663	142	8437	6096	7774	5954	4.669014084507042	1.3056768558951966
chr7	NOD1	30463608	30463698	867	91	8437	6096	7570	6005	9.527472527472527	1.260616153205662
chr7	GGCT	30498802	30498938	1463	137	5896	1599	4433	1462	10.678832116788321	3.0321477428180574
chr7	GGCT	30500535	30500681	357	147	5896	1599	5539	1452	2.4285714285714284	3.814738292011019
chr7	GGCT	30497740	30497896	0	157	5896	1599	5896	1442	0.0	4.08876560332871
chr7	GARS1-DT	30551317	30551395	0	79	32726	12139	32726	12060	0.0	2.713598673300166
chr7	GARS1-DT	30552099	30552179	0	81	32726	12139	32726	12058	0.0	2.714048764305855
chr7	GARS1-DT	30551317	30551479	0	163	32726	12139	32726	11976	0.0	2.732631930527722
chr7	GARS1-DT	30584710	30584808	0	99	32726	12139	32726	12040	0.0	2.7181063122923588
chr7	GARS1-DT	30576563	30576710	723	148	32726	12139	32003	11991	4.885135135135135	2.6689183554332416
chr7	GARS1-DT	30584422	30584453	136	32	32726	12139	32590	12107	4.25	2.691831172049228
chr7	GARS1-DT	30579005	30579128	51	124	32726	12139	32675	12015	0.4112903225806452	2.7195172700790677
chr7	GARS1-DT	30577648	30578091	2076	444	32726	12139	30650	11695	4.675675675675675	2.6207781103035486
chr7	CRHR2	30654697	30654808	0	112	96296	3787	96296	3675	0.0	26.20299319727891
chr7	CRHR2	30686388	30686615	0	228	96296	3787	96296	3559	0.0	27.057038493958977
chr7	LSM5	32489463	32489600	0	138	0	4281	0	4143	0.0	0.0
chr7	RP9P	32928561	32928691	1885	131	6583	1440	4698	1309	14.389312977099237	3.5889992360580596
chr7	RP9P	32933813	32933896	0	84	6583	1440	6583	1356	0.0	4.8547197640118
chr7	NT5C3A	33029628	33029714	2078	87	189030	3108	186952	3021	23.885057471264368	61.88414432307183
chr7	NT5C3A	33035933	33035988	25368	56	189030	3108	163662	3052	453.0	53.62450851900393
chr7	NT5C3A	33029628	33029709	2073	82	189030	3108	186957	3026	25.28048780487805	61.78354263053536
chr7	AC008080.4	33796701	33796809	0	109	0	2834	0	2725	0.0	0.0
chr7	AC008080.4	33795904	33796129	0	226	0	2834	0	2608	0.0	0.0
chr7	NPSR1-AS1	34704079	34704199	0	121	0	7122	0	7001	0.0	0.0
chr7	DPY19L1	34937993	34938119	0	127	20431	6265	20431	6138	0.0	3.3286086673183446
chr7	DPY19L1	34957983	34958070	0	88	20431	6265	20431	6177	0.0	3.3075926825319732
chr7	DPY19L2P1	35102916	35103030	0	115	14536	7663	14536	7548	0.0	1.9258081611022788
chr7	HERPUD2	35673200	35673278	11142	79	13278	3420	2136	3341	141.0379746835443	0.6393295420532774
chr7	HERPUD2	35670214	35670328	1830	115	13278	3420	11448	3305	15.91304347826087	3.4638426626323753
chr7	SEPTIN7-DT	35755732	35755817	0	86	204	4118	204	4032	0.0	0.050595238095238096
chr7	SEPTIN7-DT	35763764	35763909	0	146	204	4118	204	3972	0.0	0.0513595166163142
chr7	KIAA0895	36336153	36336297	0	145	7697	4862	7697	4717	0.0	1.631757472970108
chr7	KIAA0895	36356901	36357590	0	690	7697	4862	7697	4172	0.0	1.8449185043144776
chr7	AOAH	36686698	36686794	0	97	0	3544	0	3447	0.0	0.0
chr7	AOAH	36514471	36514590	0	120	0	3544	0	3424	0.0	0.0
chr7	AOAH	36690096	36690180	0	85	0	3544	0	3459	0.0	0.0
chr7	ELMO1	36887559	36887672	0	114	51	9599	51	9485	0.0	0.005376910911966262
chr7	ELMO1	37244355	37244391	0	37	51	9599	51	9562	0.0	0.0053336122150177785
chr7	ELMO1	37033346	37033412	0	67	51	9599	51	9532	0.0	0.005350398657154847
chr7	ELMO1	37217711	37217756	0	46	51	9599	51	9553	0.0	0.005338637077357898
chr7	ELMO1	37393821	37393917	0	97	51	9599	51	9502	0.0	0.00536729109661124
chr7	AMPH	38417824	38417950	0	127	4317	5513	4317	5386	0.0	0.8015224656516896
chr7	AMPH	38429055	38429577	4317	523	4317	5513	0	4990	8.254302103250478	0.0
chr7	AMPH	38420911	38421016	0	106	4317	5513	4317	5407	0.0	0.7984094692065841
chr7	VPS41	38830253	38830328	0	76	37263	7789	37263	7713	0.0	4.8311940879035395
chr7	VPS41	38898090	38898129	0	40	37263	7789	37263	7749	0.0	4.808749516066589
chr7	VPS41	38728340	38728434	0	95	37263	7789	37263	7694	0.0	4.843124512607226
chr7	VPS41	38796414	38796526	14315	113	37263	7789	22948	7676	126.68141592920354	2.989577905158937
chr7	GLI3	42150019	42150183	0	165	2933	13825	2933	13660	0.0	0.21471449487554906
chr7	GLI3	42145437	42145606	0	170	2933	13825	2933	13655	0.0	0.21479311607469792
chr7	GLI3	42150019	42150102	0	84	2933	13825	2933	13741	0.0	0.21344880285277637
chr7	PSMA2	42926535	42926668	351	134	6087	8384	5736	8250	2.6194029850746268	0.6952727272727273
chr7	PSMA2	42927382	42927459	255	78	6087	8384	5832	8306	3.269230769230769	0.7021430291355647
chr7	AC010132.3	42911039	42911193	165	155	1497	3926	1332	3771	1.064516129032258	0.3532219570405728
chr7	AC010132.3	42912058	42912552	408	495	1497	3926	1089	3431	0.8242424242424242	0.3174001748761294
chr7	AC005537.1	43028337	43028395	0	59	397914	5165	397914	5106	0.0	77.93066980023502
chr7	AC005537.1	43044546	43044620	0	75	397914	5165	397914	5090	0.0	78.17563850687623
chr7	AC005537.1	43037484	43037598	0	115	397914	5165	397914	5050	0.0	78.79485148514851
chr7	AC005537.1	43075021	43075063	0	43	397914	5165	397914	5122	0.0	77.68723155017571
chr7	COA1	43650611	43650712	66	102	140225	11833	140159	11731	0.6470588235294118	11.947745290256584
chr7	COA1	43665657	43665722	5650	66	140225	11833	134575	11767	85.60606060606061	11.436644854253421
chr7	COA1	43650492	43650712	204	221	140225	11833	140021	11612	0.9230769230769231	12.058301756803306
chr7	COA1	43711399	43711449	0	51	140225	11833	140225	11782	0.0	11.901629604481412
chr7	URGCP	43887414	43887485	0	72	499387	7095	499387	7023	0.0	71.10736152641321
chr7	URGCP	43887789	43887816	0	28	499387	7095	499387	7067	0.0	70.66463846044998
chr7	URGCP	43887789	43887811	0	23	499387	7095	499387	7072	0.0	70.61467760180996
chr7	POLR2J4	43969731	43969861	51	131	92316	7433	92265	7302	0.3893129770992366	12.63557929334429
chr7	POLR2J4	44014605	44014783	74	179	92316	7433	92242	7254	0.4134078212290503	12.716018748276813
chr7	RASA4CP	44036671	44036809	1974	139	56544	4067	54570	3928	14.201438848920864	13.89256619144603
chr7	POLM	44074130	44074233	0	104	5301	4453	5301	4349	0.0	1.2189008967578754
chr7	POLM	44076508	44076629	0	122	5301	4453	5301	4331	0.0	1.223966751327638
chr7	POLM	44079860	44079959	612	100	5301	4453	4689	4353	6.12	1.0771881461061337
chr7	POLM	44078321	44078438	40	118	5301	4453	5261	4335	0.3389830508474576	1.21361014994233
chr7	POLM	44074130	44074220	0	91	5301	4453	5301	4362	0.0	1.2152682255845941
chr7	POLM	44079570	44079741	905	172	5301	4453	4396	4281	5.261627906976744	1.0268628825040877
chr7	POLM	44080364	44080471	204	108	5301	4453	5097	4345	1.8888888888888888	1.17307249712313
chr7	POLD2	44122281	44122459	0	179	57714	3708	57714	3529	0.0	16.354207990932274
chr7	MYL7	44140711	44140787	0	77	0	1463	0	1386	0.0	0.0
chr7	MYL7	44140711	44140856	0	146	0	1463	0	1317	0.0	0.0
chr7	MYL7	44140711	44140827	0	117	0	1463	0	1346	0.0	0.0
chr7	GCK	44158072	44158196	2940	125	35768	5074	32828	4949	23.52	6.633259244291776
chr7	CAMK2B	44232821	44232866	0	46	14180	7658	14180	7612	0.0	1.8628481345244352
chr7	CAMK2B	44234389	44234461	0	73	14180	7658	14180	7585	0.0	1.869479235332894
chr7	CAMK2B	44239588	44239663	0	76	14180	7658	14180	7582	0.0	1.8702189395937747
chr7	CAMK2B	44240706	44240749	13260	44	14180	7658	920	7614	301.3636363636364	0.12083004990806409
chr7	NPC1L1	44518585	44518666	0	82	4034	5287	4034	5205	0.0	0.7750240153698367
chr7	NPC1L1	44533738	44533853	0	116	4034	5287	4034	5171	0.0	0.78011989943918
chr7	DDX56	44570757	44570877	0	121	0	3948	0	3827	0.0	0.0
chr7	DDX56	44572889	44573050	0	162	0	3948	0	3786	0.0	0.0
chr7	DDX56	44572889	44573046	0	158	0	3948	0	3790	0.0	0.0
chr7	TMED4	44581092	44581239	0	148	1428	3773	1428	3625	0.0	0.3939310344827586
chr7	H2AZ2	44840898	44841012	957123	115	962345	7009	5222	6894	8322.808695652175	0.7574702639976791
chr7	H2AZ2	44843276	44843354	0	79	962345	7009	962345	6930	0.0	138.86652236652236
chr7	H2AZ2	44835528	44835658	1132	131	962345	7009	961213	6878	8.641221374045802	139.7518173887758
chr7	MYO1G	44976862	44977071	0	210	250	8668	250	8458	0.0	0.02955781508630882
chr7	SNHG15	44984356	44984426	0	71	102	3016	102	2945	0.0	0.03463497453310696
chr7	SNHG15	44986020	44986097	0	78	102	3016	102	2938	0.0	0.03471749489448604
chr7	SNHG15	44985881	44986097	0	217	102	3016	102	2799	0.0	0.03644158628081458
chr7	SNHG15	44984356	44986097	0	1742	102	3016	102	1274	0.0	0.08006279434850863
chr7	TBRG4	45110744	45110877	5072	134	72036	5038	66964	4904	37.850746268656714	13.654975530179446
chr7	SEPTIN7P2	45746826	45746948	0	123	7023	4161	7023	4038	0.0	1.7392273402674592
chr7	SEPTIN7P2	45756908	45756992	0	85	7023	4161	7023	4076	0.0	1.7230127576054957
chr7	SEPTIN7P2	45726183	45726236	0	54	7023	4161	7023	4107	0.0	1.710007304601899
chr7	SEPTIN7P2	45728831	45729026	61	196	7023	4161	6962	3965	0.3112244897959184	1.7558638083228246
chr7	SEPTIN7P2	45765705	45765812	4310	108	7023	4161	2713	4053	39.907407407407405	0.6693807056501357
chr7	TNS3	47405497	47405559	0	63	19328	11804	19328	11741	0.0	1.646197087130568
chr7	HUS1	47971259	47971516	0	258	0	2928	0	2670	0.0	0.0
chr7	HUS1	47976214	47976421	0	208	0	2928	0	2720	0.0	0.0
chr7	SUN3	47991009	47991045	0	37	7450	1742	7450	1705	0.0	4.3695014662756595
chr7	SUN3	48018498	48018596	306	99	7450	1742	7144	1643	3.090909090909091	4.348143639683506
chr7	FIGNL1	50449555	50449723	0	169	0	1093	0	924	0.0	0.0
chr7	FIGNL1	50448180	50448289	0	110	0	1093	0	983	0.0	0.0
chr7	FIGNL1	50449562	50449723	0	162	0	1093	0	931	0.0	0.0
chr7	FIGNL1	50449117	50449723	0	607	0	1093	0	486	0.0	0.0
chr7	FIGNL1	50447967	50448055	0	89	0	1093	0	1004	0.0	0.0
chr7	FIGNL1	50449544	50449723	0	180	0	1093	0	913	0.0	0.0
chr7	FIGNL1	50449499	50449723	0	225	0	1093	0	868	0.0	0.0
chr7	DDC	50499147	50499242	32	96	980	3104	948	3008	0.3333333333333333	0.3151595744680851
chr7	DDC	50528136	50528280	42	145	980	3104	938	2959	0.2896551724137931	0.31699898614396754
chr7	DDC	50539914	50540028	0	115	980	3104	980	2989	0.0	0.32786885245901637
chr7	DDC	50529207	50529342	0	136	980	3104	980	2968	0.0	0.330188679245283
chr7	DDC	50537859	50537979	0	121	980	3104	980	2983	0.0	0.3285283271873952
chr7	GRB10	50616209	50616347	0	139	693	9680	693	9541	0.0	0.07263389581804842
chr7	GRB10	50703820	50703908	17	89	693	9680	676	9591	0.19101123595505617	0.07048274423939109
chr7	GRB10	50755886	50756056	0	171	693	9680	693	9509	0.0	0.07287832579661374
chr7	GRB10	50732271	50732368	0	98	693	9680	693	9582	0.0	0.07232310582341892
chr7	GRB10	50780626	50780736	0	111	693	9680	693	9569	0.0	0.07242136064374542
chr7	GRB10	50710874	50710990	0	117	693	9680	693	9563	0.0	0.07246679912161455
chr7	GRB10	50705139	50705323	0	185	693	9680	693	9495	0.0	0.07298578199052133
chr7	COBL	51083057	51083228	0	172	255	14368	255	14196	0.0	0.017962806424344887
chr7	COBL	51172455	51172530	0	76	255	14368	255	14292	0.0	0.017842149454240133
chr7	COBL	51187913	51187958	0	46	255	14368	255	14322	0.0	0.017804775869291998
chr7	LINC01446	53691926	53692089	0	164	0	7300	0	7136	0.0	0.0
chr7	LINC01446	53776487	53776628	0	142	0	7300	0	7158	0.0	0.0
chr7	LINC01446	53771433	53771607	0	175	0	7300	0	7125	0.0	0.0
chr7	LINC01446	53811507	53811574	0	68	0	7300	0	7232	0.0	0.0
chr7	LINC01446	53811507	53811571	0	65	0	7300	0	7235	0.0	0.0
chr7	LINC01446	53710831	53710894	0	64	0	7300	0	7236	0.0	0.0
chr7	LINC01446	53780156	53780230	0	75	0	7300	0	7225	0.0	0.0
chr7	LINC01446	53692330	53692473	0	144	0	7300	0	7156	0.0	0.0
chr7	LINC01446	53780777	53780868	0	92	0	7300	0	7208	0.0	0.0
chr7	LINC01446	53769915	53770065	0	151	0	7300	0	7149	0.0	0.0
chr7	LINC02854	53934921	53935007	0	87	2167	775	2167	688	0.0	3.1497093023255816
chr7	SEC61G	54757494	54757594	0	101	0	1847	0	1746	0.0	0.0
chr7	VOPP1	55497612	55497690	0	79	120273	5361	120273	5282	0.0	22.77035213934116
chr7	VOPP1	55561979	55562051	714	73	120273	5361	119559	5288	9.780821917808218	22.609493192133133
chr7	VOPP1	55530828	55530911	1018	84	120273	5361	119255	5277	12.119047619047619	22.59901459162403
chr7	PSPH	56033380	56033494	51	115	146029	2748	145978	2633	0.4434782608695652	55.441701481200155
chr7	PSPH	56043147	56043261	240	115	146029	2748	145789	2633	2.0869565217391304	55.36992024306874
chr7	PHKG1	56084148	56084244	0	97	106306	2773	106306	2676	0.0	39.72571001494768
chr7	PHKG1	56086969	56087024	105	56	106306	2773	106201	2717	1.875	39.0875966139124
chr7	PHKG1	56087597	56087776	765	180	106306	2773	105541	2593	4.25	40.70227535672966
chr7	AC092447.7	56428384	56428441	0	58	208	1842	208	1784	0.0	0.11659192825112108
chr7	AC092634.4	63891751	63891805	0	55	70	1871	70	1816	0.0	0.03854625550660793
chr7	AC092634.4	63891073	63891220	70	148	70	1871	0	1723	0.47297297297297297	0.0
chr7	ZNF680	64544305	64544432	0	128	27939	5567	27939	5439	0.0	5.136789851075565
chr7	GUSB	65970281	65970366	0	86	3632	3830	3632	3744	0.0	0.9700854700854701
chr7	GUSB	65974918	65975071	0	154	3632	3830	3632	3676	0.0	0.9880304678998912
chr7	GUSB	65979726	65979911	0	186	3632	3830	3632	3644	0.0	0.9967069154774972
chr7	GUSB	65979398	65979541	345	144	3632	3830	3287	3686	2.3958333333333335	0.8917525773195877
chr7	GUSB	65980223	65980409	0	187	3632	3830	3632	3643	0.0	0.996980510568213
chr7	GUSB	65979833	65979911	0	79	3632	3830	3632	3751	0.0	0.9682751266328979
chr7	GUSB	65979385	65979541	357	157	3632	3830	3275	3673	2.2738853503184715	0.8916417097740267
chr7	LINC00174	66395878	66395956	0	79	211762	11077	211762	10998	0.0	19.254591743953448
chr7	LINC00174	66429678	66429757	0	80	211762	11077	211762	10997	0.0	19.25634263890152
chr7	LINC00174	66439134	66439304	0	171	211762	11077	211762	10906	0.0	19.417018155143957
chr7	LINC00174	66480393	66480448	0	56	211762	11077	211762	11021	0.0	19.214408855820707
chr7	LINC00174	66487948	66488038	124	91	211762	11077	211638	10986	1.3626373626373627	19.264336428181323
chr7	LINC00174	66401194	66401394	364	201	211762	11077	211398	10876	1.8109452736318408	19.43710923133505
chr7	LINC00174	66455658	66455853	78	196	211762	11077	211684	10881	0.3979591836734694	19.45446190607481
chr7	LINC00174	66432739	66432851	0	113	211762	11077	211762	10964	0.0	19.31430134987231
chr7	LINC00174	66492273	66492339	236	67	211762	11077	211526	11010	3.5223880597014925	19.21217075386013
chr7	AC006001.3	66560578	66560675	0	98	14349	5901	14349	5803	0.0	2.4726865414440806
chr7	AC006001.3	66576754	66576932	0	179	14349	5901	14349	5722	0.0	2.5076896190143305
chr7	PMS2P4	67296936	67297049	0	114	51	851	51	737	0.0	0.06919945725915876
chr7	CALN1	72403250	72403442	31	193	1309	10007	1278	9814	0.16062176165803108	0.13022213164866517
chr7	CALN1	72412057	72412275	1068	219	1309	10007	241	9788	4.876712328767123	0.02462198610543523
chr7	TYW1B	72810470	72810665	0	196	4566	3277	4566	3081	0.0	1.4819863680623175
chr7	TYW1B	72807065	72807356	51	292	4566	3277	4515	2985	0.17465753424657535	1.5125628140703518
chr7	NSUN5P2	72949312	72949491	0	180	17481	1874	17481	1694	0.0	10.319362455726091
chr7	NSUN5P2	72952151	72952295	7492	145	17481	1874	9989	1729	51.66896551724138	5.777327935222672
chr7	STAG3L3	73000357	73000481	0	125	783	3267	783	3142	0.0	0.24920432845321452
chr7	STAG3L3	72999054	72999162	0	109	783	3267	783	3158	0.0	0.24794173527549082
chr7	BCL7B	73537933	73538013	0	81	66754	3073	66754	2992	0.0	22.31082887700535
chr7	BCL7B	73539881	73540052	51	172	66754	3073	66703	2901	0.29651162790697677	22.993105825577388
chr7	BCL7B	73543547	73543644	0	98	66754	3073	66754	2975	0.0	22.438319327731094
chr7	BCL7B	73552166	73552242	0	77	66754	3073	66754	2996	0.0	22.281041388518023
chr7	BCL7B	73542829	73542907	0	79	66754	3073	66754	2994	0.0	22.295925183700735
chr7	BCL7B	73553547	73553669	0	123	66754	3073	66754	2950	0.0	22.628474576271188
chr7	TBL2	73574382	73574513	0	132	51	4171	51	4039	0.0	0.012626887843525626
chr7	TBL2	73574382	73574571	0	190	51	4171	51	3981	0.0	0.01281085154483798
chr7	TBL2	73576540	73576701	0	162	51	4171	51	4009	0.0	0.012721376901970565
chr7	TBL2	73574382	73574804	0	423	51	4171	51	3748	0.0	0.013607257203842048
chr7	TBL2	73577972	73578267	0	296	51	4171	51	3875	0.0	0.013161290322580645
chr7	MLXIPL	73596638	73596789	302	152	73577	4671	73275	4519	1.986842105263158	16.214870546581103
chr7	MLXIPL	73596638	73596786	302	149	73577	4671	73275	4522	2.0268456375838926	16.204113224237062
chr7	ABHD11	73737220	73737391	0	172	102	2293	102	2121	0.0	0.04809052333804809
chr7	ABHD11	73736928	73737220	0	293	102	2293	102	2000	0.0	0.051
chr7	ABHD11	73736928	73737110	0	183	102	2293	102	2110	0.0	0.04834123222748815
chr7	ABHD11	73737220	73737360	0	141	102	2293	102	2152	0.0	0.047397769516728624
chr7	ABHD11	73737875	73738072	4	198	102	2293	98	2095	0.020202020202020204	0.04677804295942721
chr7	METTL27	73840413	73840549	0	137	0	1456	0	1319	0.0	0.0
chr7	RFC2	74249011	74249118	0	108	2195	2224	2195	2116	0.0	1.037334593572779
chr7	RFC2	74252428	74252498	0	71	2195	2224	2195	2153	0.0	1.0195076637250349
chr7	RFC2	74246661	74246763	404	103	2195	2224	1791	2121	3.9223300970873787	0.8444130127298444
chr7	RFC2	74233774	74233894	401	121	2195	2224	1794	2103	3.3140495867768593	0.8530670470756063
chr7	RFC2	74249011	74249220	23	210	2195	2224	2172	2014	0.10952380952380952	1.0784508440913605
chr7	RFC2	74253598	74253717	112	120	2195	2224	2083	2104	0.9333333333333333	0.9900190114068441
chr7	AC211433.1	74722734	74722788	0	55	1057	2928	1057	2873	0.0	0.367908109989558
chr7	GTF2IRD2	74849111	74850290	51	1180	12984	7923	12933	6743	0.043220338983050846	1.9179890256562362
chr7	STAG3L2	74882851	74883041	0	191	570	2335	570	2144	0.0	0.2658582089552239
chr7	STAG3L2	74883727	74883835	0	109	570	2335	570	2226	0.0	0.2560646900269542
chr7	STAG3L2	74885022	74885146	0	125	570	2335	570	2210	0.0	0.2579185520361991
chr7	STAG3L2	74888561	74888700	117	140	570	2335	453	2195	0.8357142857142857	0.20637813211845102
chr7	POM121C	75426361	75426453	0	93	204	8814	204	8721	0.0	0.023391812865497075
chr7	POM121C	75484197	75484256	0	60	204	8814	204	8754	0.0	0.023303632625085675
chr7	PMS2P3	75512308	75512421	2443	114	7889	1455	5446	1341	21.42982456140351	4.061148396718867
chr7	TMEM120A	75987537	75987602	35	66	151235	1694	151200	1628	0.5303030303030303	92.87469287469287
chr7	TMEM120A	75987922	75987984	0	63	151235	1694	151235	1631	0.0	92.72532188841201
chr7	TMEM120A	75989164	75989224	20	61	151235	1694	151215	1633	0.32786885245901637	92.59951010410288
chr7	STYXL1	76000889	76001002	0	114	1105	1888	1105	1774	0.0	0.6228861330326945
chr7	STYXL1	76013741	76013887	0	147	1105	1888	1105	1741	0.0	0.6346927053417576
chr7	STYXL1	76021850	76021992	0	143	1105	1888	1105	1745	0.0	0.6332378223495702
chr7	POMZP3	76618496	76618615	51	120	6843	1868	6792	1748	0.425	3.88558352402746
chr7	FAM185BP	77109544	77109662	0	119	9	1292	9	1173	0.0	0.0076726342710997444
chr7	GSAP	77321332	77321403	42	72	47355	8592	47313	8520	0.5833333333333334	5.553169014084507
chr7	GSAP	77323646	77323742	0	97	47355	8592	47355	8495	0.0	5.57445556209535
chr7	APTR	77661197	77661333	0	137	153	5920	153	5783	0.0	0.02645685630295694
chr7	APTR	77685201	77685328	0	128	153	5920	153	5792	0.0	0.02641574585635359
chr7	APTR	77684089	77684251	0	163	153	5920	153	5757	0.0	0.026576341844710787
chr7	MAGI2	78135020	78135206	0	187	204	25254	204	25067	0.0	0.008138189651733355
chr7	MAGI2	78185628	78185670	0	43	204	25254	204	25211	0.0	0.008091706001348618
chr7	MAGI2	78065573	78065662	0	90	204	25254	204	25164	0.0	0.008106819265617548
chr7	MAGI2	78026067	78026104	0	38	204	25254	204	25216	0.0	0.00809010152284264
chr7	MAGI2	78583420	78583494	0	75	204	25254	204	25179	0.0	0.0081019897533659
chr7	MAGI2	78554566	78554671	0	106	204	25254	204	25148	0.0	0.008111977095594082
chr7	MAGI2	78345443	78345572	0	130	204	25254	204	25124	0.0	0.008119726158255056
chr7	AC004862.1	80362114	80362224	0	111	72847	3489	72847	3378	0.0	21.565127294256957
chr7	AC004862.1	80360523	80360645	0	123	72847	3489	72847	3366	0.0	21.642008318478908
chr7	AC004862.1	80374340	80374460	19262	121	72847	3489	53585	3368	159.1900826446281	15.91003562945368
chr7	AC004862.1	80381850	80382060	808	211	72847	3489	72039	3278	3.829383886255924	21.976510067114095
chr7	AC004862.1	80384848	80384979	1188	132	72847	3489	71659	3357	9.0	21.34614238903783
chr7	AC004862.1	80389914	80390011	1365	98	72847	3489	71482	3391	13.928571428571429	21.07991742848717
chr7	SEMA3C	80905828	80905916	0	89	0	6126	0	6037	0.0	0.0
chr7	AC008163.1	81528428	81528576	0	149	22090	5496	22090	5347	0.0	4.131288573031607
chr7	AC008163.1	81567908	81568065	0	158	22090	5496	22090	5338	0.0	4.13825402772574
chr7	AC008163.1	81586879	81586983	0	105	22090	5496	22090	5391	0.0	4.0975700241142645
chr7	AC008163.1	81586946	81586983	0	38	22090	5496	22090	5458	0.0	4.04727006229388
chr7	AC008163.1	81583119	81583270	261	152	22090	5496	21829	5344	1.7171052631578947	4.084767964071856
chr7	AC008163.1	81624372	81624443	0	72	22090	5496	22090	5424	0.0	4.0726401179941005
chr7	AC008163.1	81625151	81625226	0	76	22090	5496	22090	5420	0.0	4.075645756457565
chr7	CACNA2D1	81983313	81983334	0	22	1	9032	1	9010	0.0	0.00011098779134295228
chr7	CACNA2D1	82001658	82001715	0	58	1	9032	1	8974	0.0	0.00011143302874972142
chr7	PCLO	82835666	82835693	0	28	459	21068	459	21040	0.0	0.021815589353612167
chr7	PCLO	82821111	82821294	0	184	459	21068	459	20884	0.0	0.021978548170848496
chr7	PCLO	82848867	82848921	0	55	459	21068	459	21013	0.0	0.021843620615809262
chr7	PCLO	82868106	82868195	0	90	459	21068	459	20978	0.0	0.02188006482982172
chr7	SEMA3E	83616611	83616712	0	102	0	8472	0	8370	0.0	0.0
chr7	SEMA3A	84489095	84489182	0	88	0	9086	0	8998	0.0	0.0
chr7	ELAPOR2	86947726	86947922	0	197	69	7850	69	7653	0.0	0.00901607212857703
chr7	ELAPOR2	86964903	86965024	0	122	69	7850	69	7728	0.0	0.008928571428571428
chr7	ELAPOR2	86941351	86941385	0	35	69	7850	69	7815	0.0	0.008829174664107486
chr7	ELAPOR2	86911621	86911695	0	75	69	7850	69	7775	0.0	0.00887459807073955
chr7	TP53TG1	87345042	87345233	0	192	0	5876	0	5684	0.0	0.0
chr7	TP53TG1	87329934	87330094	0	161	0	5876	0	5715	0.0	0.0
chr7	ABCB4	87411892	87412033	0	142	23607	7393	23607	7251	0.0	3.2556888705006206
chr7	ABCB4	87448633	87448706	0	74	23607	7393	23607	7319	0.0	3.225440633966389
chr7	ABCB1	87566784	87566976	0	193	48135	6455	48135	6262	0.0	7.686841264771639
chr7	SLC25A40	87836729	87836810	2591	82	473487	4907	470896	4825	31.597560975609756	97.59502590673576
chr7	SLC25A40	87843753	87843863	102	111	473487	4907	473385	4796	0.918918918918919	98.70412844036697
chr7	SLC25A40	87841931	87842041	393	111	473487	4907	473094	4796	3.5405405405405403	98.64345287739783
chr7	SLC25A40	87860071	87860169	0	99	473487	4907	473487	4808	0.0	98.47899334442596
chr7	SRI	88218858	88218942	0	85	0	3757	0	3672	0.0	0.0
chr7	SRI	88214794	88214936	0	143	0	3757	0	3614	0.0	0.0
chr7	STEAP4	88282640	88283168	0	529	0	11254	0	10725	0.0	0.0
chr7	STEAP4	88290915	88291014	0	100	0	11254	0	11154	0.0	0.0
chr7	MTERF1	91880054	91880113	43	60	64911	4878	64868	4818	0.7166666666666667	13.46367787463678
chr7	MTERF1	91876877	91876978	0	102	64911	4878	64911	4776	0.0	13.59108040201005
chr7	MTERF1	91876877	91876926	0	50	64911	4878	64911	4828	0.0	13.4446975973488
chr7	KRIT1	92225719	92225827	0	109	269252	5947	269252	5838	0.0	46.1205892428914
chr7	KRIT1	92234448	92234592	27439	145	269252	5947	241813	5802	189.2344827586207	41.677524991382285
chr7	KRIT1	92244001	92244149	17610	149	269252	5947	251642	5798	118.18791946308725	43.401517764746465
chr7	LRRD1	92159004	92159203	0	200	96886	4457	96886	4257	0.0	22.759220108057317
chr7	LRRD1	92163285	92165276	96633	1992	96886	4457	253	2465	48.5105421686747	0.1026369168356998
chr7	KRIT1	92245426	92245595	0	170	269252	5947	269252	5777	0.0	46.607581789856326
chr7	TMBIM7P	92428012	92428066	0	55	0	2049	0	1994	0.0	0.0
chr7	TMBIM7P	92429369	92429448	0	80	0	2049	0	1969	0.0	0.0
chr7	PEX1	92504731	92504902	0	172	255	7210	255	7038	0.0	0.036231884057971016
chr7	PEX1	92509328	92509411	0	84	255	7210	255	7126	0.0	0.03578445130507999
chr7	FAM133B	92566013	92566061	0	49	0	4492	0	4443	0.0	0.0
chr7	FAM133B	92585297	92585396	0	100	0	4492	0	4392	0.0	0.0
chr7	FAM133B	92566009	92566061	0	53	0	4492	0	4439	0.0	0.0
chr7	SAMD9	93114794	93114895	0	102	51	6858	51	6756	0.0	0.007548845470692718
chr7	SAMD9L	93146882	93147146	0	265	0	2461	0	2196	0.0	0.0
chr7	SAMD9L	93147087	93147146	0	60	0	2461	0	2401	0.0	0.0
chr7	SAMD9L	93145908	93146040	0	133	0	2461	0	2328	0.0	0.0
chr7	HEPACAM2	93197372	93197397	0	26	153	2492	153	2466	0.0	0.06204379562043796
chr7	HEPACAM2	93225882	93225951	0	70	153	2492	153	2422	0.0	0.06317093311312964
chr7	CALCR	93462062	93462110	0	49	2394	4055	2394	4006	0.0	0.5976035946080879
chr7	CALCR	93495903	93495974	0	72	2394	4055	2394	3983	0.0	0.6010544815465729
chr7	CALCR	93441499	93441549	0	51	2394	4055	2394	4004	0.0	0.5979020979020979
chr7	BET1	93994351	93994385	0	35	0	5238	0	5203	0.0	0.0
chr7	SGCE	94618757	94618956	0	200	162	11980	162	11780	0.0	0.013752122241086587
chr7	SGCE	94587777	94587812	0	36	162	11980	162	11944	0.0	0.013563295378432686
chr7	SGCE	94598774	94598963	0	190	162	11980	162	11790	0.0	0.013740458015267175
chr7	SGCE	94599696	94599723	0	28	162	11980	162	11952	0.0	0.01355421686746988
chr7	SGCE	94600645	94600857	0	213	162	11980	162	11767	0.0	0.013767315373502167
chr7	SGCE	94622545	94622626	0	82	162	11980	162	11898	0.0	0.01361573373676248
chr7	SGCE	94628201	94628359	0	159	162	11980	162	11821	0.0	0.013704424329582946
chr7	SGCE	94629718	94629841	0	124	162	11980	162	11856	0.0	0.013663967611336033
chr7	SGCE	94588688	94588732	0	45	162	11980	162	11935	0.0	0.013573523250942606
chr7	SGCE	94587777	94587884	0	108	162	11980	162	11872	0.0	0.0136455525606469
chr7	SGCE	94639340	94639448	0	109	162	11980	162	11871	0.0	0.013646702047005308
chr7	SGCE	94597929	94598004	0	76	162	11980	162	11904	0.0	0.013608870967741936
chr7	SGCE	94587777	94588732	0	956	162	11980	162	11024	0.0	0.01469521044992743
chr7	SGCE	94644605	94644667	0	63	162	11980	162	11917	0.0	0.013594025341948477
chr7	SGCE	94640896	94640964	0	69	162	11980	162	11911	0.0	0.013600873142473343
chr7	SGCE	94587777	94587849	0	73	162	11980	162	11907	0.0	0.013605442176870748
chr7	SGCE	94597748	94598004	78	257	162	11980	84	11723	0.3035019455252918	0.0071654013477778725
chr7	SGCE	94618757	94618932	0	176	162	11980	162	11804	0.0	0.013724161301253812
chr7	SGCE	94597748	94597839	78	92	162	11980	84	11888	0.8478260869565217	0.0070659488559892325
chr7	SGCE	94594431	94594546	0	116	162	11980	162	11864	0.0	0.013654753877275792
chr7	SGCE	94621848	94621995	0	148	162	11980	162	11832	0.0	0.013691683569979716
chr7	SGCE	94622515	94622626	0	112	162	11980	162	11868	0.0	0.013650151668351871
chr7	SGCE	94587777	94587809	0	33	162	11980	162	11947	0.0	0.013559889512011383
chr7	SGCE	94599326	94599400	0	75	162	11980	162	11905	0.0	0.01360772784544309
chr7	SGCE	94597923	94598004	0	82	162	11980	162	11898	0.0	0.01361573373676248
chr7	SGCE	94618757	94618935	0	179	162	11980	162	11801	0.0	0.013727650199135667
chr7	SGCE	94629718	94629821	0	104	162	11980	162	11876	0.0	0.013640956551027282
chr7	PON3	95367361	95367488	0	128	0	4129	0	4001	0.0	0.0
chr7	PON3	95390153	95390209	0	57	0	4129	0	4072	0.0	0.0
chr7	PON2	95424514	95424585	0	72	51	3559	51	3487	0.0	0.0146257527960998
chr7	PON2	95434258	95434333	0	76	51	3559	51	3483	0.0	0.014642549526270457
chr7	PON2	95415147	95415272	0	126	51	3559	51	3433	0.0	0.014855811243810078
chr7	SLC25A13	96234801	96234917	0	117	510	3638	510	3521	0.0	0.1448452144277194
chr7	SEM1	96484824	96484854	0	31	51	11514	51	11483	0.0	0.0044413480797700945
chr7	SEM1	96496283	96496341	0	59	51	11514	51	11455	0.0	0.004452204277608032
chr7	SEM1	96656456	96656585	0	130	51	11514	51	11384	0.0	0.004479971890372453
chr7	SEM1	96558116	96558256	0	141	51	11514	51	11373	0.0	0.004484304932735426
chr7	SEM1	96637239	96637306	0	68	51	11514	51	11446	0.0	0.004455705049799056
chr7	SEM1	96694797	96694891	0	95	51	11514	51	11419	0.0	0.004466240476398984
chr7	DLX6-AS1	96978346	96979591	0	1246	306	16178	306	14932	0.0	0.02049290115188856
chr7	DLX6-AS1	97011824	97012303	0	480	306	16178	306	15698	0.0	0.01949292903554593
chr7	DLX6-AS1	96979489	96979587	0	99	306	16178	306	16079	0.0	0.019031034268300266
chr7	DLX6-AS1	96979083	96979587	0	505	306	16178	306	15673	0.0	0.019524022203789956
chr7	DLX6-AS1	97012180	97012303	0	124	306	16178	306	16054	0.0	0.019060670237946928
chr7	DLX6-AS1	96979083	96979591	0	509	306	16178	306	15669	0.0	0.019529006318207927
chr7	AC079781.5	97908794	97909011	0	218	41885	5190	41885	4972	0.0	8.424175382139984
chr7	AC079781.5	97945507	97945615	51	109	41885	5190	41834	5081	0.46788990825688076	8.233418618382208
chr7	ASNS	97871718	97871996	0	279	12062	4867	12062	4588	0.0	2.629032258064516
chr7	ASNS	97868907	97869105	0	199	12062	4867	12062	4668	0.0	2.5839760068551842
chr7	ASNS	97869777	97869813	10	37	12062	4867	12052	4830	0.2702702702702703	2.4952380952380953
chr7	TECPR1	98245921	98246165	0	245	102	8184	102	7939	0.0	0.01284796573875803
chr7	TMEM130	98863094	98863400	612	307	2545	4279	1933	3972	1.993485342019544	0.4866565961732125
chr7	TMEM130	98860178	98860338	0	161	2545	4279	2545	4118	0.0	0.6180184555609519
chr7	SMURF1	99050914	99050992	2408	79	126793	6304	124385	6225	30.481012658227847	19.98152610441767
chr7	AC004834.1	99299463	99299666	0	204	1989	4618	1989	4414	0.0	0.4506116900770276
chr7	AC004834.1	99305588	99305769	0	182	1989	4618	1989	4436	0.0	0.44837691614066727
chr7	ATP5MF-PTCD1	99441389	99441487	0	99	0	2870	0	2771	0.0	0.0
chr7	ATP5MF	99459146	99459263	0	118	204	2117	204	1999	0.0	0.10205102551275638
chr7	ATP5MF	99460085	99460193	0	109	204	2117	204	2008	0.0	0.10159362549800798
chr7	ZNF394	99498715	99498842	2674	128	17009	7765	14335	7637	20.890625	1.8770459604556764
chr7	CYP3A5	99672783	99672915	18833	133	375655	8312	356822	8179	141.6015037593985	43.62660471940335
chr7	CYP3A5	99671770	99671878	0	109	375655	8312	375655	8203	0.0	45.79483115933195
chr7	CYP3A5	99676316	99676576	4446	261	375655	8312	371209	8051	17.03448275862069	46.10719165321078
chr7	CYP3A4	99761775	99761868	0	94	18549	3400	18549	3306	0.0	5.6107078039927405
chr7	TRIM4	99916701	99916779	2625	79	9651	4841	7026	4762	33.22784810126582	1.4754304913901721
chr7	ZNF3	100077302	100077433	0	132	184638	5432	184638	5300	0.0	34.83735849056604
chr7	ZNF3	100079535	100079656	0	122	184638	5432	184638	5310	0.0	34.77175141242938
chr7	ZNF3	100077228	100077433	0	206	184638	5432	184638	5226	0.0	35.330654420206656
chr7	ZNF3	100079535	100079572	0	38	184638	5432	184638	5394	0.0	34.23025583982202
chr7	TAF6	100113348	100113405	0	58	133	3852	133	3794	0.0	0.03505535055350553
chr7	TAF6	100118517	100118649	0	133	133	3852	133	3719	0.0	0.03576230169400377
chr7	TAF6	100116513	100116633	0	121	133	3852	133	3731	0.0	0.03564727954971857
chr7	TAF6	100116513	100116612	0	100	133	3852	133	3752	0.0	0.03544776119402985
chr7	MAP11	100156385	100156549	0	165	2699	2975	2699	2810	0.0	0.9604982206405694
chr7	MAP11	100157632	100157762	357	131	2699	2975	2342	2844	2.7251908396946565	0.8234880450070323
chr7	GAL3ST4	100166501	100166805	0	305	8970	2633	8970	2328	0.0	3.8530927835051547
chr7	GPC2	100175571	100175894	26444	324	74214	3469	47770	3145	81.61728395061728	15.18918918918919
chr7	CASTOR3	100213046	100213133	0	88	27956	4870	27956	4782	0.0	5.846089502300293
chr7	CASTOR3	100223569	100223698	1739	130	27956	4870	26217	4740	13.376923076923077	5.531012658227848
chr7	CASTOR3	100222596	100222720	242	125	27956	4870	27714	4745	1.936	5.840674394099052
chr7	PMS2P1	100332441	100332581	0	141	153	5373	153	5232	0.0	0.029243119266055047
chr7	PMS2P1	100325690	100325868	0	179	153	5373	153	5194	0.0	0.029457065845206007
chr7	PMS2P1	100330181	100330284	0	104	153	5373	153	5269	0.0	0.029037768077434047
chr7	PMS2P1	100330908	100331040	25	133	153	5373	128	5240	0.18796992481203006	0.024427480916030534
chr7	PMS2P1	100325690	100325779	0	90	153	5373	153	5283	0.0	0.028960817717206135
chr7	PMS2P1	100330908	100331043	28	136	153	5373	125	5237	0.20588235294117646	0.023868627076570555
chr7	PMS2P1	100332441	100332576	0	136	153	5373	153	5237	0.0	0.02921519954172236
chr7	PMS2P1	100328835	100329019	51	185	153	5373	102	5188	0.2756756756756757	0.01966075558982267
chr7	PMS2P1	100330908	100330961	0	54	153	5373	153	5319	0.0	0.028764805414551606
chr7	PMS2P1	100335205	100335428	0	224	153	5373	153	5149	0.0	0.029714507671392502
chr7	PMS2P1	100330908	100331204	51	297	153	5373	102	5076	0.1717171717171717	0.02009456264775414
chr7	PMS2P1	100334971	100335428	0	458	153	5373	153	4915	0.0	0.031129196337741607
chr7	ZCWPW1	100401888	100402041	0	154	204280	3336	204280	3182	0.0	64.19861722187304
chr7	ZCWPW1	100405012	100405093	47308	82	204280	3336	156972	3254	576.9268292682926	48.239704978488014
chr7	ZCWPW1	100402515	100402576	72	62	204280	3336	204208	3274	1.1612903225806452	62.372632864996945
chr7	PPP1R35	100435630	100435767	0	138	1479	1121	1479	983	0.0	1.5045778229908444
chr7	LRCH4	100577085	100577154	0	70	0	5999	0	5929	0.0	0.0
chr7	TFR2	100629252	100629372	0	121	51	4851	51	4730	0.0	0.010782241014799155
chr7	TFR2	100631498	100631596	51	99	51	4851	0	4752	0.5151515151515151	0.0
chr7	ACTL6B	100655802	100655879	0	78	0	2389	0	2311	0.0	0.0
chr7	GIGYF1	100689301	100689555	0	255	51	6865	51	6610	0.0	0.0077155824508320725
chr7	EPHB4	100805165	100805321	1252	157	457036	6454	455784	6297	7.974522292993631	72.38113387327299
chr7	ACHE	100892333	100892554	140	222	15872	3736	15732	3514	0.6306306306306306	4.476949345475242
chr7	ACHE	100892333	100892818	1211	486	15872	3736	14661	3250	2.4917695473251027	4.511076923076923
chr7	ACHE	100892707	100892818	933	112	15872	3736	14939	3624	8.330357142857142	4.122240618101546
chr7	ACHE	100891168	100891338	0	171	15872	3736	15872	3565	0.0	4.452173913043478
chr7	ACHE	100892333	100892643	140	311	15872	3736	15732	3425	0.45016077170418006	4.593284671532847
chr7	ACHE	100892686	100892818	1071	133	15872	3736	14801	3603	8.052631578947368	4.10796558423536
chr7	ACHE	100896139	100896281	0	143	15872	3736	15872	3593	0.0	4.417478430281102
chr7	NAT16	101179096	101179136	0	41	0	3890	0	3849	0.0	0.0
chr7	MOGAT3	101196186	101196389	0	204	91	2258	91	2054	0.0	0.04430379746835443
chr7	PLOD3	101207577	101207724	0	148	0	5401	0	5253	0.0	0.0
chr7	PLOD3	101212529	101212655	0	127	0	5401	0	5274	0.0	0.0
chr7	PLOD3	101217165	101217418	0	254	0	5401	0	5147	0.0	0.0
chr7	CLDN15	101234277	101234442	0	166	51	2635	51	2469	0.0	0.020656136087484813
chr7	CLDN15	101236746	101236886	0	141	51	2635	51	2494	0.0	0.02044907778668805
chr7	CLDN15	101233872	101234116	0	245	51	2635	51	2390	0.0	0.021338912133891212
chr7	CLDN15	101234277	101234373	0	97	51	2635	51	2538	0.0	0.02009456264775414
chr7	FIS1	101240141	101240247	0	107	0	1800	0	1693	0.0	0.0
chr7	FIS1	101244006	101244139	0	134	0	1800	0	1666	0.0	0.0
chr7	IFT22	101318123	101318213	0	91	51	3810	51	3719	0.0	0.013713363807475128
chr7	IFT22	101318955	101319032	0	78	51	3810	51	3732	0.0	0.013665594855305467
chr7	IFT22	101321426	101321499	0	74	51	3810	51	3736	0.0	0.013650963597430408
chr7	IFT22	101318955	101319063	0	109	51	3810	51	3701	0.0	0.013780059443393677
chr7	MYL10	101623919	101624021	0	103	975	1059	975	956	0.0	1.0198744769874477
chr7	RASA4B	102483824	102483889	0	66	2687	7327	2687	7261	0.0	0.370059220493045
chr7	RASA4B	102490985	102491123	0	139	2687	7327	2687	7188	0.0	0.3738174735670562
chr7	POLR2J3	102569834	102569924	0	91	0	3918	0	3827	0.0	0.0
chr7	POLR2J3	102568009	102568184	0	176	0	3918	0	3742	0.0	0.0
chr7	POLR2J3	102566581	102566736	0	156	0	3918	0	3762	0.0	0.0
chr7	RASA4	102583003	102583068	0	66	547	8099	547	8033	0.0	0.06809411178887091
chr7	RASA4	102590158	102590296	0	139	547	8099	547	7960	0.0	0.06871859296482412
chr7	RASA4	102602323	102602405	0	83	547	8099	547	8016	0.0	0.06823852295409182
chr7	RASA4	102605857	102605987	0	131	547	8099	547	7968	0.0	0.06864959839357429
chr7	RASA4	102611085	102611142	0	58	547	8099	547	8041	0.0	0.06802636487999004
chr7	FBXL13	102931880	102931933	0	54	9642	4038	9642	3984	0.0	2.4201807228915664
chr7	FBXL13	103028599	103028748	0	150	9642	4038	9642	3888	0.0	2.4799382716049383
chr7	FBXL13	102822382	102822440	0	59	9642	4038	9642	3979	0.0	2.4232219150540337
chr7	FBXL13	103055087	103055178	0	92	9642	4038	9642	3946	0.0	2.4434870755195135
chr7	FBXL13	102832839	102832974	0	136	9642	4038	9642	3902	0.0	2.4710404920553564
chr7	FBXL13	102854776	102854860	0	85	9642	4038	9642	3953	0.0	2.4391601315456617
chr7	FBXL13	103046808	103047020	0	213	9642	4038	9642	3825	0.0	2.5207843137254904
chr7	DPY19L2P2	103184001	103184127	0	127	0	5606	0	5479	0.0	0.0
chr7	DPY19L2P2	103238802	103238871	0	70	0	5606	0	5536	0.0	0.0
chr7	DPY19L2P2	103226213	103226379	0	167	0	5606	0	5439	0.0	0.0
chr7	DPY19L2P2	103258443	103258592	0	150	0	5606	0	5456	0.0	0.0
chr7	DPY19L2P2	103278244	103278346	0	103	0	5606	0	5503	0.0	0.0
chr7	DPY19L2P2	103279832	103279894	0	63	0	5606	0	5543	0.0	0.0
chr7	DNAJC2	103324481	103324562	0	82	0	5991	0	5909	0.0	0.0
chr7	DNAJC2	103327331	103327378	0	48	0	5991	0	5943	0.0	0.0
chr7	SLC26A5	103378445	103378553	0	109	31	3428	31	3319	0.0	0.009340162699608317
chr7	SLC26A5	103380479	103380549	0	71	31	3428	31	3357	0.0	0.009234435507893953
chr7	SLC26A5	103389328	103389424	0	97	31	3428	31	3331	0.0	0.009306514560192134
chr7	SLC26A5	103392918	103393066	0	149	31	3428	31	3279	0.0	0.009454101860323269
chr7	SLC26A5	103413001	103413112	0	112	31	3428	31	3316	0.0	0.009348612786489748
chr7	SLC26A5	103390428	103390506	0	79	31	3428	31	3349	0.0	0.009256494475962974
chr7	RELN	103478388	103478394	0	7	854	12852	854	12845	0.0	0.0664850136239782
chr7	RELN	103478388	103478524	0	137	854	12852	854	12715	0.0	0.06716476602438065
chr7	ORC5	104202410	104202544	0	135	126	3741	126	3606	0.0	0.03494176372712146
chr7	ORC5	104202376	104202544	0	169	126	3741	126	3572	0.0	0.03527435610302351
chr7	LHFPL3-AS1	104798336	104798407	0	72	20876	3053	20876	2981	0.0	7.003019121100302
chr7	SRPK2	105125781	105125874	0	94	35636	5398	35636	5304	0.0	6.718702865761689
chr7	SRPK2	105126247	105126340	161	94	35636	5398	35475	5304	1.7127659574468086	6.6883484162895925
chr7	SRPK2	105268805	105268869	0	65	35636	5398	35636	5333	0.0	6.682167635477217
chr7	PUS7	105462213	105462427	0	215	1610	4451	1610	4236	0.0	0.38007554296506135
chr7	PUS7	105505954	105506056	5	103	1610	4451	1605	4348	0.04854368932038835	0.36913523459061637
chr7	EFCAB10	105567466	105567490	0	25	2672	2585	2672	2560	0.0	1.04375
chr7	EFCAB10	105569406	105569571	562	166	2672	2585	2110	2419	3.3855421686746987	0.8722612649855312
chr7	ATXN7L1	105624074	105624267	0	194	2380	8314	2380	8120	0.0	0.29310344827586204
chr7	ATXN7L1	105639486	105639569	0	84	2380	8314	2380	8230	0.0	0.2891859052247874
chr7	ATXN7L1	105875811	105875880	0	70	2380	8314	2380	8244	0.0	0.28869480834546335
chr7	ATXN7L1	105617791	105618097	0	307	2380	8314	2380	8007	0.0	0.29723991507430997
chr7	ATXN7L1	105649406	105649560	0	155	2380	8314	2380	8159	0.0	0.2917024145115823
chr7	SYPL1	106092547	106092669	0	123	0	2483	0	2360	0.0	0.0
chr7	SYPL1	106092563	106092669	0	107	0	2483	0	2376	0.0	0.0
chr7	SYPL1	106096292	106096302	0	11	0	2483	0	2472	0.0	0.0
chr7	AC004917.1	106520728	106520819	0	92	217	2096	217	2004	0.0	0.10828343313373254
chr7	AC004917.1	106591549	106591682	0	134	217	2096	217	1962	0.0	0.11060142711518858
chr7	COG5	107256731	107256794	587	64	16219	8422	15632	8358	9.171875	1.8703039004546542
chr7	SLC26A4-AS1	107654610	107654816	0	207	51	8534	51	8327	0.0	0.006124654737600576
chr7	SLC26A4-AS1	107654643	107654816	0	174	51	8534	51	8360	0.0	0.006100478468899521
chr7	SLC26A3	107773919	107774153	0	235	0	3403	0	3168	0.0	0.0
chr7	LAMB1	107929411	107929619	0	209	0	15924	0	15715	0.0	0.0
chr7	LAMB1	107936278	107936373	0	96	0	15924	0	15828	0.0	0.0
chr7	LAMB1	107939988	107940358	0	371	0	15924	0	15553	0.0	0.0
chr7	LAMB1	107959248	107959480	0	233	0	15924	0	15691	0.0	0.0
chr7	LAMB1	107998356	107998492	0	137	0	15924	0	15787	0.0	0.0
chr7	LAMB1	108002126	108002384	0	259	0	15924	0	15665	0.0	0.0
chr7	LAMB4	108030805	108030979	0	175	1807	7058	1807	6883	0.0	0.26253087316577073
chr7	NRCAM	108175321	108175357	0	37	2650	8273	2650	8236	0.0	0.32175813501699857
chr7	NRCAM	108191253	108191283	0	31	2650	8273	2650	8242	0.0	0.32152390196554237
chr7	NRCAM	108225644	108225701	0	58	2650	8273	2650	8215	0.0	0.3225806451612903
chr7	NRCAM	108237751	108237769	0	19	2650	8273	2650	8254	0.0	0.32105645747516354
chr7	NRCAM	108166920	108167073	0	154	2650	8273	2650	8119	0.0	0.32639487621628277
chr7	NRCAM	108168276	108168402	0	127	2650	8273	2650	8146	0.0	0.32531303707341025
chr7	PNPLA8	108521475	108521521	0	47	0	5688	0	5641	0.0	0.0
chr7	PNPLA8	108514435	108515574	0	1140	0	5688	0	4548	0.0	0.0
chr7	PNPLA8	108518189	108518301	0	113	0	5688	0	5575	0.0	0.0
chr7	PNPLA8	108514435	108515447	0	1013	0	5688	0	4675	0.0	0.0
chr7	PNPLA8	108514143	108514293	0	151	0	5688	0	5537	0.0	0.0
chr7	THAP5	108565829	108566022	0	194	0	5062	0	4868	0.0	0.0
chr7	THAP5	108565951	108566022	0	72	0	5062	0	4990	0.0	0.0
chr7	AC073114.1	110432810	110432906	0	97	0	3082	0	2985	0.0	0.0
chr7	IMMP2L	110886592	110886695	0	104	612	3465	612	3361	0.0	0.18208866408806904
chr7	IMMP2L	111532517	111532585	0	69	612	3465	612	3396	0.0	0.18021201413427562
chr7	DOCK4	111732225	111732287	0	63	429	11836	429	11773	0.0	0.036439310286248194
chr7	DOCK4	111742012	111742132	0	121	429	11836	429	11715	0.0	0.036619718309859155
chr7	DOCK4	111782863	111782924	0	62	429	11836	429	11774	0.0	0.03643621538984203
chr7	DOCK4	111784096	111784123	0	28	429	11836	429	11808	0.0	0.03633130081300813
chr7	DOCK4	111735053	111735167	0	115	429	11836	429	11721	0.0	0.03660097261325825
chr7	DOCK4	111840762	111840870	0	109	429	11836	429	11727	0.0	0.03658224609874648
chr7	TMEM168	112783697	112784953	0	1257	153	7838	153	6581	0.0	0.02324874639112597
chr7	TMEM168	112788453	112788544	0	92	153	7838	153	7746	0.0	0.019752130131680867
chr7	TMEM168	112783697	112783783	0	87	153	7838	153	7751	0.0	0.019739388466004388
chr7	BMT2	112935186	112935264	0	79	0	4104	0	4025	0.0	0.0
chr7	HRAT17	112986535	112986664	0	130	0	3836	0	3706	0.0	0.0
chr7	HRAT17	112977143	112977199	0	57	0	3836	0	3779	0.0	0.0
chr7	HRAT17	112980045	112980164	0	120	0	3836	0	3716	0.0	0.0
chr7	HRAT17	112973604	112973672	0	69	0	3836	0	3767	0.0	0.0
chr7	HRAT17	112982986	112983141	0	156	0	3836	0	3680	0.0	0.0
chr7	HRAT17	112980903	112981161	0	259	0	3836	0	3577	0.0	0.0
chr7	GPR85	113085991	113086109	0	119	0	7246	0	7127	0.0	0.0
chr7	GPR85	113085991	113086106	0	116	0	7246	0	7130	0.0	0.0
chr7	TFEC	115974169	115974256	0	88	1701	3858	1701	3770	0.0	0.45119363395225465
chr7	AC073130.1	116284367	116284406	0	40	0	2565	0	2525	0.0	0.0
chr7	COMETT	116600790	116600934	561	145	575	1698	14	1553	3.8689655172413793	0.00901481004507405
chr7	WNT2	117315070	117315348	0	279	51	4366	51	4087	0.0	0.012478590653290923
chr7	WNT2	117300844	117301156	0	313	51	4366	51	4053	0.0	0.012583271650629163
chr7	WNT2	117315070	117315284	0	215	51	4366	51	4151	0.0	0.012286196097325945
chr7	ASZ1	117385697	117385809	0	113	0	3062	0	2949	0.0	0.0
chr7	ASZ1	117422236	117422359	0	124	0	3062	0	2938	0.0	0.0
chr7	CTTNBP2	117725051	117725257	0	207	0	6668	0	6461	0.0	0.0
chr7	CTTNBP2	117746012	117746099	0	88	0	6668	0	6580	0.0	0.0
chr7	CTTNBP2	117786385	117786425	0	41	0	6668	0	6627	0.0	0.0
chr7	TSPAN12	120814004	120814247	0	244	38	3274	38	3030	0.0	0.012541254125412541
chr7	FAM3C	121380208	121380264	0	57	102	3406	102	3349	0.0	0.030456852791878174
chr7	AASS	122081499	122081595	0	97	0	6223	0	6126	0.0	0.0
chr7	AASS	122098744	122098866	0	123	0	6223	0	6100	0.0	0.0
chr7	AASS	122082787	122082891	0	105	0	6223	0	6118	0.0	0.0
chr7	AASS	122098748	122098866	0	119	0	6223	0	6104	0.0	0.0
chr7	AASS	122079148	122079327	0	180	0	6223	0	6043	0.0	0.0
chr7	CADPS2	122393195	122393315	0	121	306	6398	306	6277	0.0	0.048749402580850726
chr7	CADPS2	122414067	122414076	0	10	306	6398	306	6388	0.0	0.04790231684408266
chr7	CADPS2	122480851	122480860	0	10	306	6398	306	6388	0.0	0.04790231684408266
chr7	CADPS2	122436359	122436380	0	22	306	6398	306	6376	0.0	0.04799247176913425
chr7	CADPS2	122386294	122386309	0	16	306	6398	306	6382	0.0	0.04794735192729552
chr7	SLC13A1	123186695	123186749	374	55	20924	4420	20550	4365	6.8	4.707903780068729
chr7	SLC13A1	123190457	123190613	8575	157	20924	4420	12349	4263	54.617834394904456	2.8967863007271872
chr7	IQUB	123479794	123479970	0	177	0	4300	0	4123	0.0	0.0
chr7	NDUFA5	123550469	123550586	0	118	663	7705	663	7587	0.0	0.08738631870304468
chr7	NDUFA5	123557403	123557448	0	46	663	7705	663	7659	0.0	0.08656482569526047
chr7	NDUFA5	123550469	123550584	0	116	663	7705	663	7589	0.0	0.0873632889708789
chr7	NDUFA5	123551367	123551576	0	210	663	7705	663	7495	0.0	0.08845897264843229
chr7	NDUFA5	123557403	123557507	0	105	663	7705	663	7600	0.0	0.08723684210526315
chr7	NDUFA5	123553669	123553756	0	88	663	7705	663	7617	0.0	0.08704214257581724
chr7	NDUFA5	123546657	123546817	0	161	663	7705	663	7544	0.0	0.08788441145281017
chr7	NDUFA5	123546582	123546817	0	236	663	7705	663	7469	0.0	0.08876690319989289
chr7	NDUFA5	123544734	123544761	0	28	663	7705	663	7677	0.0	0.08636186010160218
chr7	NDUFA5	123544729	123544761	0	33	663	7705	663	7672	0.0	0.08641814389989573
chr7	ASB15-AS1	123622973	123623160	0	188	0	1738	0	1550	0.0	0.0
chr7	POT1	124829253	124829342	0	90	0	8237	0	8147	0.0	0.0
chr7	POT1	124870910	124871041	0	132	0	8237	0	8105	0.0	0.0
chr7	POT1	124915573	124915646	0	74	0	8237	0	8163	0.0	0.0
chr7	POT1	124835278	124835414	0	137	0	8237	0	8100	0.0	0.0
chr7	POT1	124848539	124848659	0	121	0	8237	0	8116	0.0	0.0
chr7	POT1	124865128	124865299	0	172	0	8237	0	8065	0.0	0.0
chr7	POT1	124882442	124882466	0	25	0	8237	0	8212	0.0	0.0
chr7	POT1	124897459	124897595	0	137	0	8237	0	8100	0.0	0.0
chr7	GRM8	126701756	126701827	0	72	0	6186	0	6114	0.0	0.0
chr7	GRM8	126445235	126445453	0	219	0	6186	0	5967	0.0	0.0
chr7	RBM28	128325817	128325891	440	75	431642	15885	431202	15810	5.866666666666666	27.274003795066413
chr7	RBM28	128338249	128338342	153	94	431642	15885	431489	15791	1.627659574468085	27.32499525045912
chr7	RBM28	128341117	128341219	0	103	431642	15885	431642	15782	0.0	27.350272462298822
chr7	PRRT4	128361305	128361422	0	118	153	3551	153	3433	0.0	0.04456743373143024
chr7	IMPDH1	128393721	128393738	162	18	1729486	3677	1729324	3659	9.0	472.62202787646896
chr7	IMPDH1	128405766	128405865	668	100	1729486	3677	1728818	3577	6.68	483.3150684931507
chr7	IMPDH1	128400816	128400891	0	76	1729486	3677	1729486	3601	0.0	480.27936684254377
chr7	IMPDH1	128409440	128409484	76866	45	1729486	3677	1652620	3632	1708.1333333333334	455.01651982378854
chr7	IMPDH1	128409288	128409366	138644	79	1729486	3677	1590842	3598	1754.987341772152	442.1461923290717
chr7	IMPDH1	128400831	128400891	0	61	1729486	3677	1729486	3616	0.0	478.2870575221239
chr7	IMPDH1	128409288	128409352	111648	65	1729486	3677	1617838	3612	1717.6615384615384	447.90642303433003
chr7	KCP	128864901	128865010	827	110	5806	12575	4979	12465	7.5181818181818185	0.3994384275972724
chr7	KCP	128879717	128879829	0	113	5806	12575	5806	12462	0.0	0.4658963248274755
chr7	TNPO3	128986728	128986920	561	193	3378	4700	2817	4507	2.906735751295337	0.6250277346350122
chr7	TNPO3	129041556	129041717	0	162	3378	4700	3378	4538	0.0	0.744380784486558
chr7	UBE2H	129865014	129865065	0	52	54072	6527	54072	6475	0.0	8.350888030888031
chr7	UBE2H	129948958	129949102	0	145	54072	6527	54072	6382	0.0	8.47257912879975
chr7	ZC3HC1	130023510	130023723	0	214	30236	3026	30236	2812	0.0	10.7524893314367
chr7	ZC3HC1	130050442	130050488	0	47	30236	3026	30236	2979	0.0	10.149714669352132
chr7	ZC3HC1	130036649	130036966	29123	318	30236	3026	1113	2708	91.58176100628931	0.41100443131462333
chr7	TMEM209	130178401	130178527	0	127	0	4570	0	4443	0.0	0.0
chr7	CEP41	130400038	130400254	0	217	1002	12794	1002	12577	0.0	0.07966923749701836
chr7	CEP41	130416918	130416966	0	49	1002	12794	1002	12745	0.0	0.07861906630051001
chr7	CEP41	130427954	130428018	0	65	1002	12794	1002	12729	0.0	0.07871788828658968
chr7	CEP41	130426645	130426759	0	115	1002	12794	1002	12679	0.0	0.07902831453584667
chr7	CEP41	130426628	130426759	0	132	1002	12794	1002	12662	0.0	0.07913441794345286
chr7	CEP41	130427395	130427482	0	88	1002	12794	1002	12706	0.0	0.07886038092239887
chr7	CEP41	130413455	130413569	0	115	1002	12794	1002	12679	0.0	0.07902831453584667
chr7	CEP41	130433868	130434041	0	174	1002	12794	1002	12620	0.0	0.07939778129952456
chr7	CEP41	130403030	130403091	0	62	1002	12794	1002	12732	0.0	0.07869934024505183
chr7	TSGA13	130686261	130686308	0	48	1793	2204	1793	2156	0.0	0.8316326530612245
chr7	TSGA13	130686261	130686373	0	113	1793	2204	1793	2091	0.0	0.8574844571975132
chr7	LINC-PINT	131052424	131052555	0	132	6987	8484	6987	8352	0.0	0.836566091954023
chr7	AC016831.6	130872459	130872639	0	181	3886	10992	3886	10811	0.0	0.3594487096475812
chr7	AC016831.6	130912109	130912152	0	44	3886	10992	3886	10948	0.0	0.3549506759225429
chr7	LINC-PINT	130978507	130978528	0	22	6987	8484	6987	8462	0.0	0.8256913259276767
chr7	LINC-PINT	131002196	131002320	480	125	6987	8484	6507	8359	3.84	0.7784423974159589
chr7	LINC-PINT	130959868	130959970	0	103	6987	8484	6987	8381	0.0	0.8336713995943205
chr7	LINC-PINT	131009708	131009778	0	71	6987	8484	6987	8413	0.0	0.8305004160228219
chr7	LINC-PINT	131106544	131106617	138	74	6987	8484	6849	8410	1.864864864864865	0.8143876337693222
chr7	LINC-PINT	131076524	131076587	0	64	6987	8484	6987	8420	0.0	0.8298099762470309
chr7	LINC-PINT	130993981	130994093	0	113	6987	8484	6987	8371	0.0	0.8346673037868833
chr7	LINC-PINT	130967388	130967517	0	130	6987	8484	6987	8354	0.0	0.8363658127842949
chr7	MKLN1-AS	131321878	131321931	0	54	0	7684	0	7630	0.0	0.0
chr7	MKLN1-AS	131311129	131311223	0	95	0	7684	0	7589	0.0	0.0
chr7	PODXL	131510235	131510331	0	97	51	6903	51	6806	0.0	0.007493388186893917
chr7	CHCHD3	132886973	132886988	0	16	43585	3443	43585	3427	0.0	12.718120805369127
chr7	CHCHD3	133022405	133022495	0	91	43585	3443	43585	3352	0.0	13.002684964200478
chr7	SLC35B4	134304804	134304854	0	51	0	1724	0	1673	0.0	0.0
chr7	AC009275.1	134373061	134373140	0	80	102	5023	102	4943	0.0	0.02063524175601861
chr7	AC009275.1	134371344	134371520	0	177	102	5023	102	4846	0.0	0.021048287247214196
chr7	AC009275.1	134416320	134416412	0	93	102	5023	102	4930	0.0	0.020689655172413793
chr7	AC009275.1	134417710	134417836	0	127	102	5023	102	4896	0.0	0.020833333333333332
chr7	AC009275.1	134418626	134418974	0	349	102	5023	102	4674	0.0	0.021822849807445442
chr7	AC009275.1	134430274	134430392	0	119	102	5023	102	4904	0.0	0.020799347471451877
chr7	CNOT4	135363853	135364066	0	214	8494	5584	8494	5370	0.0	1.5817504655493482
chr7	SLC13A4	135684123	135684261	0	139	0	4236	0	4097	0.0	0.0
chr7	AC009264.1	137032793	137032913	0	121	0	6929	0	6808	0.0	0.0
chr7	AC009264.1	137031904	137031963	0	60	0	6929	0	6869	0.0	0.0
chr7	PTN	137236143	137236242	0	100	0	1628	0	1528	0.0	0.0
chr7	DGKI	137485373	137485418	0	46	0	15589	0	15543	0.0	0.0
chr7	DGKI	137493782	137493836	0	55	0	15589	0	15534	0.0	0.0
chr7	DGKI	137463488	137463611	0	124	0	15589	0	15465	0.0	0.0
chr7	DGKI	137545899	137545962	0	64	0	15589	0	15525	0.0	0.0
chr7	CREB3L2	137922589	137922767	0	179	0	4960	0	4781	0.0	0.0
chr7	SVOPL	138621045	138621135	0	91	7359	3244	7359	3153	0.0	2.333967649857279
chr7	SVOPL	138659863	138659988	0	126	7359	3244	7359	3118	0.0	2.360166773572803
chr7	ATP6V0A4	138715763	138715881	2137	119	93058	4149	90921	4030	17.95798319327731	22.561042183622828
chr7	ATP6V0A4	138786157	138786260	11	104	93058	4149	93047	4045	0.10576923076923077	23.002966625463536
chr7	ATP6V0A4	138780033	138780122	0	90	93058	4149	93058	4059	0.0	22.926336536092634
chr7	ATP6V0A4	138709623	138709795	42175	173	93058	4149	50883	3976	243.78612716763007	12.797535211267606
chr7	PARP12	140027275	140027406	0	132	229289	5260	229289	5128	0.0	44.71314352574103
chr7	PARP12	140037714	140037856	0	143	229289	5260	229289	5117	0.0	44.809263240179796
chr7	KDM7A	140095617	140095711	0	95	5791	9399	5791	9304	0.0	0.6224204643164231
chr7	SLC37A3	140345215	140345263	60	49	567987	8904	567927	8855	1.2244897959183674	64.13630717108978
chr7	SLC37A3	140351272	140351451	0	180	567987	8904	567987	8724	0.0	65.10625859697386
chr7	SLC37A3	140358639	140358785	0	147	567987	8904	567987	8757	0.0	64.86091127098321
chr7	SLC37A3	140364407	140364491	43	85	567987	8904	567944	8819	0.5058823529411764	64.4000453566164
chr7	SLC37A3	140380281	140380390	0	110	567987	8904	567987	8794	0.0	64.58801455537866
chr7	SLC37A3	140348625	140348767	0	143	567987	8904	567987	8761	0.0	64.83129779705513
chr7	SLC37A3	140352061	140352146	0	86	567987	8904	567987	8818	0.0	64.41222499432978
chr7	SLC37A3	140337283	140337349	1517	67	567987	8904	566470	8837	22.64179104477612	64.10207083851986
chr7	SLC37A3	140343411	140343563	629	153	567987	8904	567358	8751	4.111111111111111	64.83350474231517
chr7	SLC37A3	140355667	140355764	0	98	567987	8904	567987	8806	0.0	64.5
chr7	SLC37A3	140345868	140345970	0	103	567987	8904	567987	8801	0.0	64.53664356323145
chr7	SLC37A3	140352061	140352181	0	121	567987	8904	567987	8783	0.0	64.66890584082887
chr7	SLC37A3	140379213	140379307	0	95	567987	8904	567987	8809	0.0	64.47803382903848
chr7	MKRN1	140473774	140473827	0	54	4876	5678	4876	5624	0.0	0.8669985775248933
chr7	MKRN1	140474380	140474489	0	110	4876	5678	4876	5568	0.0	0.8757183908045977
chr7	MKRN1	140475217	140475335	36	119	4876	5678	4840	5559	0.3025210084033613	0.8706601906817772
chr7	MKRN1	140473243	140473332	0	90	4876	5678	4876	5588	0.0	0.8725841088045813
chr7	MKRN1	140472202	140472405	0	204	4876	5678	4876	5474	0.0	0.8907563025210085
chr7	DENND2A	140601402	140602542	0	1141	973	5198	973	4057	0.0	0.23983238846438254
chr7	DENND2A	140605704	140605806	0	103	973	5198	973	5095	0.0	0.19097154072620215
chr7	BRAF	140734616	140734770	0	155	889	20294	889	20139	0.0	0.044143204727146335
chr7	BRAF	140785688	140785808	0	121	889	20294	889	20173	0.0	0.044068804838150004
chr7	BRAF	140808236	140808316	0	81	889	20294	889	20213	0.0	0.0439815960025726
chr7	BRAF	140747365	140747447	0	83	889	20294	889	20211	0.0	0.04398594824600465
chr7	BRAF	140748931	140749052	0	122	889	20294	889	20172	0.0	0.04407098949038271
chr7	MRPS33	141010418	141010660	0	243	204	4992	204	4749	0.0	0.04295641187618446
chr7	AC073878.1	141547331	141547400	0	70	0	2122	0	2052	0.0	0.0
chr7	WEE2-AS1	141727496	141727642	0	147	0	5092	0	4945	0.0	0.0
chr7	WEE2-AS1	141714188	141714374	0	187	0	5092	0	4905	0.0	0.0
chr7	WEE2-AS1	141727203	141727378	0	176	0	5092	0	4916	0.0	0.0
chr7	WEE2-AS1	141737382	141737567	0	186	0	5092	0	4906	0.0	0.0
chr7	WEE2-AS1	141727991	141728145	0	155	0	5092	0	4937	0.0	0.0
chr7	WEE2-AS1	141727553	141727642	0	90	0	5092	0	5002	0.0	0.0
chr7	WEE2-AS1	141727203	141727642	0	440	0	5092	0	4652	0.0	0.0
chr7	WEE2-AS1	141711757	141711800	0	44	0	5092	0	5048	0.0	0.0
chr7	WEE2-AS1	141724999	141725256	0	258	0	5092	0	4834	0.0	0.0
chr7	PRSS37	141837560	141837650	0	91	0	2228	0	2137	0.0	0.0
chr7	CLEC5A	141943895	141943964	0	70	0	4136	0	4066	0.0	0.0
chr7	CLEC5A	141946213	141946312	0	100	0	4136	0	4036	0.0	0.0
chr7	CLEC5A	141935813	141935950	0	138	0	4136	0	3998	0.0	0.0
chr7	CLEC5A	141945340	141945400	0	61	0	4136	0	4075	0.0	0.0
chr7	TRPV5	142928087	142928234	0	148	102	3639	102	3491	0.0	0.0292179891148668
chr7	FAM131B	143359325	143359419	0	95	0	6306	0	6211	0.0	0.0
chr7	FAM131B	143359731	143359767	0	37	0	6306	0	6269	0.0	0.0
chr7	FAM131B	143359549	143359629	0	81	0	6306	0	6225	0.0	0.0
chr7	FAM131B	143359325	143359518	0	194	0	6306	0	6112	0.0	0.0
chr7	EPHA1	143394807	143395014	0	208	261	4564	261	4356	0.0	0.05991735537190083
chr7	AC099548.2	143833246	143833883	0	638	0	3634	0	2996	0.0	0.0
chr7	AC099548.2	143836156	143836269	0	114	0	3634	0	3520	0.0	0.0
chr7	AC099548.2	143833728	143833883	0	156	0	3634	0	3478	0.0	0.0
chr7	TCAF1	143881922	143882099	194	178	398	6256	204	6078	1.0898876404494382	0.03356367226061204
chr7	AC074386.1	144253532	144253588	0	57	0	2197	0	2140	0.0	0.0
chr7	AC074386.1	144311883	144311936	0	54	0	2197	0	2143	0.0	0.0
chr7	OR2A1-AS1	144350717	144350824	0	108	0	2545	0	2437	0.0	0.0
chr7	AC074386.1	144311883	144311939	0	57	0	2197	0	2140	0.0	0.0
chr7	OR2A1-AS1	144335078	144335132	0	55	0	2545	0	2490	0.0	0.0
chr7	OR2A1-AS1	144349103	144349443	0	341	0	2545	0	2204	0.0	0.0
chr7	NOBOX	144401045	144401597	0	553	8	2124	8	1571	0.0	0.005092297899427116
chr7	TPK1	144531063	144531169	0	107	51	8466	51	8359	0.0	0.006101208278502213
chr7	TPK1	144606928	144607050	0	123	51	8466	51	8343	0.0	0.006112909025530385
chr7	TPK1	144681806	144681864	0	59	51	8466	51	8407	0.0	0.006066373260378256
chr7	TPK1	144591422	144591569	0	148	51	8466	51	8318	0.0	0.006131281558066843
chr7	TPK1	144667725	144667846	0	122	51	8466	51	8344	0.0	0.006112176414189837
chr7	AC006007.1	145677865	145677980	0	116	0	993	0	877	0.0	0.0
chr7	EZH2	148814913	148815039	0	127	5922	4102	5922	3975	0.0	1.489811320754717
chr7	EZH2	148818977	148819059	0	83	5922	4102	5922	4019	0.0	1.4735008708633988
chr7	EZH2	148832633	148832750	0	118	5922	4102	5922	3984	0.0	1.4864457831325302
chr7	EZH2	148836821	148837000	51	180	5922	4102	5871	3922	0.2833333333333333	1.496940336562978
chr7	PDIA4	149027848	149027992	0	145	18871	3309	18871	3164	0.0	5.964285714285714
chr7	ZNF786	149080590	149080717	0	128	0	3277	0	3149	0.0	0.0
chr7	ZNF767P	149558607	149558839	759	233	43621	4017	42862	3784	3.257510729613734	11.327167019027485
chr7	ZNF767P	149621045	149621172	0	128	43621	4017	43621	3889	0.0	11.216508099768578
chr7	ZNF767P	149563519	149563603	671	85	43621	4017	42950	3932	7.894117647058824	10.923194303153611
chr7	ATP6V0E2-AS1	149870241	149870351	0	111	0	3296	0	3185	0.0	0.0
chr7	RARRES2	150338614	150338741	0	128	0	736	0	608	0.0	0.0
chr7	TMEM176B	150793960	150794071	0	112	15915	1981	15915	1869	0.0	8.515248796147672
chr7	TMEM176B	150800021	150800167	1808	147	15915	1981	14107	1834	12.299319727891156	7.691930207197383
chr7	ATG9B	151018619	151019374	0	756	55	5653	55	4897	0.0	0.011231366142536246
chr7	ATG9B	151015359	151015713	0	355	55	5653	55	5298	0.0	0.010381275953189883
chr7	CDK5	151055752	151055848	0	97	84132	2201	84132	2104	0.0	39.98669201520912
chr7	FASTK	151079499	151079922	0	424	0	3292	0	2868	0.0	0.0
chr7	ASB10	151176562	151176676	0	115	3496	2381	3496	2266	0.0	1.5428067078552516
chr7	IQCA1L	151195849	151195975	0	127	17237	2846	17237	2719	0.0	6.339463037881574
chr7	SMARCD3	151245459	151245671	0	213	14119	4505	14119	4292	0.0	3.2896085740913326
chr7	WDR86	151385087	151385223	0	137	408	3982	408	3845	0.0	0.10611183355006502
chr7	WDR86	151385087	151385287	0	201	408	3982	408	3781	0.0	0.10790796085691616
chr7	CRYGN	151436179	151436325	0	147	102	3188	102	3041	0.0	0.033541598158500496
chr7	CRYGN	151432167	151432285	51	119	102	3188	51	3069	0.42857142857142855	0.016617790811339198
chr7	RHEB	151498088	151498180	0	93	0	3438	0	3345	0.0	0.0
chr7	PRKAG2	151568715	151568842	0	128	21836	14143	21836	14015	0.0	1.5580449518373172
chr7	PRKAG2	151574890	151574949	0	60	21836	14143	21836	14083	0.0	1.5505219058439252
chr7	PRKAG2	151632068	151632138	0	71	21836	14143	21836	14072	0.0	1.5517339397384877
chr7	PRKAG2	151606093	151606183	0	91	21836	14143	21836	14052	0.0	1.5539424992883575
chr7	PRKAG2	151790880	151791000	1212	121	21836	14143	20624	14022	10.016528925619834	1.4708315504207674
chr7	PRKAG2	151566613	151566699	0	87	21836	14143	21836	14056	0.0	1.5535002845759818
chr7	PRKAG2	151566572	151566613	0	42	21836	14143	21836	14101	0.0	1.5485426565491809
chr7	PRKAG2	151631637	151631768	0	132	21836	14143	21836	14011	0.0	1.5584897580472485
chr7	KMT2C	152157760	152157925	0	166	21420	18723	21420	18557	0.0	1.154281403244059
chr7	KMT2C	152158862	152159072	255	211	21420	18723	21165	18512	1.2085308056872037	1.1433124459809854
chr7	KMT2C	152238706	152238826	0	121	21420	18723	21420	18602	0.0	1.1514890871949253
chr7	LINC01287	153405491	153405598	0	108	0	9603	0	9495	0.0	0.0
chr7	LINC01287	153400178	153400546	0	369	0	9603	0	9234	0.0	0.0
chr7	LINC01287	153404056	153404233	0	178	0	9603	0	9425	0.0	0.0
chr7	LINC01287	153406955	153407084	0	130	0	9603	0	9473	0.0	0.0
chr7	LINC01287	153412090	153413482	0	1393	0	9603	0	8210	0.0	0.0
chr7	LINC01287	153412090	153413220	0	1131	0	9603	0	8472	0.0	0.0
chr7	LINC01287	153401340	153401691	0	352	0	9603	0	9251	0.0	0.0
chr7	LINC01287	153412090	153412731	0	642	0	9603	0	8961	0.0	0.0
chr7	LINC01287	153403362	153403492	0	131	0	9603	0	9472	0.0	0.0
chr7	LINC01287	153404056	153404326	0	271	0	9603	0	9332	0.0	0.0
chr7	LINC01287	153411581	153411724	0	144	0	9603	0	9459	0.0	0.0
chr7	LINC01287	153411585	153411724	0	140	0	9603	0	9463	0.0	0.0
chr7	LINC01287	153404056	153404602	0	547	0	9603	0	9056	0.0	0.0
chr7	PAXIP1	154986016	154986179	0	164	51	9703	51	9539	0.0	0.0053464723765593875
chr7	HTR5A-AS1	155070275	155070453	0	179	0	3810	0	3631	0.0	0.0
chr7	SHH	155800457	155800667	0	211	0	4970	0	4759	0.0	0.0
chr7	SHH	155800457	155800597	0	141	0	4970	0	4829	0.0	0.0
chr7	LINC01006	156471154	156472711	13181	1558	85089	11122	71908	9564	8.4602053915276	7.518611459640318
chr7	LINC01006	156605187	156605380	0	194	85089	11122	85089	10928	0.0	7.786328696925329
chr7	LINC01006	156605657	156605764	0	108	85089	11122	85089	11014	0.0	7.7255311421826764
chr7	LINC01006	156584200	156584520	102	321	85089	11122	84987	10801	0.3177570093457944	7.868438107582631
chr7	LINC01006	156480664	156481620	67751	957	85089	11122	17338	10165	70.79519331243469	1.7056566650270537
chr7	LINC01006	156481376	156481617	0	242	85089	11122	85089	10880	0.0	7.820680147058823
chr7	LINC01006	156603784	156603911	0	128	85089	11122	85089	10994	0.0	7.739585228306349
chr7	LMBR1	156688029	156688191	51	163	34687	8530	34636	8367	0.3128834355828221	4.139596032030596
chr7	LMBR1	156836812	156836885	0	74	34687	8530	34687	8456	0.0	4.102057710501419
chr7	LMBR1	156779654	156779732	512	79	34687	8530	34175	8451	6.481012658227848	4.043900130162111
chr7	LMBR1	156736492	156736615	0	124	34687	8530	34687	8406	0.0	4.126457292410183
chr7	LMBR1	156834477	156834595	0	119	34687	8530	34687	8411	0.0	4.12400428010938
chr7	LMBR1	156833752	156833792	0	41	34687	8530	34687	8489	0.0	4.086111438331959
chr7	LMBR1	156836808	156836885	0	78	34687	8530	34687	8452	0.0	4.103999053478467
chr7	LMBR1	156834477	156834575	0	99	34687	8530	34687	8431	0.0	4.114221326058593
chr7	MNX1	157006478	157006639	546	162	28313	2760	27767	2598	3.3703703703703702	10.687836797536567
chr7	PTPRN2	158316818	158316932	0	115	15	3610	15	3495	0.0	0.004291845493562232
chr7	PTPRN2	158489734	158489785	15	52	15	3610	0	3558	0.28846153846153844	0.0
chr7	PTPRN2	158110828	158110915	0	88	15	3610	15	3522	0.0	0.004258943781942078
chr7	NCAPG2	158650831	158650972	41	142	5036	7141	4995	6999	0.2887323943661972	0.7136733819117017
chr7	NCAPG2	158662193	158662367	0	175	5036	7141	5036	6966	0.0	0.7229399942578237
chr7	NCAPG2	158668395	158668492	0	98	5036	7141	5036	7043	0.0	0.7150362061621468
chr7	NCAPG2	158702247	158702348	531	102	5036	7141	4505	7039	5.205882352941177	0.6400056826253729
chr7	NCAPG2	158703649	158703702	144	54	5036	7141	4892	7087	2.6666666666666665	0.6902779737547622
chr7	ESYT2	158752780	158752843	0	64	16133	7041	16133	6977	0.0	2.3123118818976636
chr8	AC019257.1	1972914	1973036	0	123	0	2174	0	2051	0.0	0.0
chr8	AC246817.2	2705214	2705286	0	73	151	10364	151	10291	0.0	0.014673015256048975
chr8	AC246817.2	2671716	2671853	0	138	151	10364	151	10226	0.0	0.014766282026207707
chr8	AC246817.2	2721489	2721592	0	104	151	10364	151	10260	0.0	0.014717348927875244
chr8	AC246817.2	2678856	2678939	0	84	151	10364	151	10280	0.0	0.014688715953307393
chr8	CSMD1	3018476	3018650	0	175	153	18788	153	18613	0.0	0.008220061247515177
chr8	CSMD1	2954223	2954268	0	46	153	18788	153	18742	0.0	0.008163483086116743
chr8	CSMD1	3096848	3097037	0	190	153	18788	153	18598	0.0	0.008226691042047532
chr8	CSMD1	3613275	3613278	0	4	153	18788	153	18784	0.0	0.008145229982964224
chr8	CSMD1	3598303	3598306	0	4	153	18788	153	18784	0.0	0.008145229982964224
chr8	ANGPT2	6532331	6532487	556	157	62803	6803	62247	6646	3.5414012738853504	9.366084863075534
chr8	MCPH1-AS1	6621344	6621635	0	292	43200	9929	43200	9637	0.0	4.482722839057798
chr8	MCPH1-AS1	6634594	6635419	0	826	43200	9929	43200	9103	0.0	4.745688234647918
chr8	MCPH1-AS1	6620991	6621635	0	645	43200	9929	43200	9284	0.0	4.653166738474796
chr8	MCPH1-AS1	6621422	6621635	0	214	43200	9929	43200	9715	0.0	4.4467318579516215
chr8	MCPH1-AS1	6669988	6670240	0	253	43200	9929	43200	9676	0.0	4.464654816039686
chr8	XKR5	6829168	6829306	0	139	0	4919	0	4780	0.0	0.0
chr8	FAM66B	7323768	7323833	0	66	0	6754	0	6688	0.0	0.0
chr8	SPAG11B	7449132	7449236	0	105	0	1983	0	1878	0.0	0.0
chr8	SPAG11B	7450822	7450900	0	79	0	1983	0	1904	0.0	0.0
chr8	SPAG11B	7451123	7451199	0	77	0	1983	0	1906	0.0	0.0
chr8	ALG1L13P	8243992	8244040	0	49	51	1403	51	1354	0.0	0.03766617429837518
chr8	AC103957.1	8422396	8423013	0	618	0	1679	0	1061	0.0	0.0
chr8	AC021242.2	9374352	9374405	0	54	49	2683	49	2629	0.0	0.018638265500190185
chr8	AC104964.1	10478487	10478555	0	69	51	1531	51	1462	0.0	0.03488372093023256
chr8	PINX1	10820192	10820269	51	78	51	2814	0	2736	0.6538461538461539	0.0
chr8	PINX1	10787623	10787825	0	203	51	2814	51	2611	0.0	0.019532746074301034
chr8	PINX1	10820192	10820310	51	119	51	2814	0	2695	0.42857142857142855	0.0
chr8	CTSB	11847678	11847822	0	145	0	8249	0	8104	0.0	0.0
chr8	CTSB	11849997	11850047	0	51	0	8249	0	8198	0.0	0.0
chr8	CTSB	11848411	11848507	0	97	0	8249	0	8152	0.0	0.0
chr8	CTSB	11849045	11849164	0	120	0	8249	0	8129	0.0	0.0
chr8	CTSB	11845081	11845222	0	142	0	8249	0	8107	0.0	0.0
chr8	CTSB	11861299	11861479	0	181	0	8249	0	8068	0.0	0.0
chr8	CTSB	11864375	11864463	0	89	0	8249	0	8160	0.0	0.0
chr8	CTSB	11865463	11865584	0	122	0	8249	0	8127	0.0	0.0
chr8	CTSB	11867253	11867526	0	274	0	8249	0	7975	0.0	0.0
chr8	CTSB	11849045	11849215	0	171	0	8249	0	8078	0.0	0.0
chr8	CTSB	11865463	11865560	0	98	0	8249	0	8151	0.0	0.0
chr8	CTSB	11867253	11867391	0	139	0	8249	0	8110	0.0	0.0
chr8	CTSB	11861405	11861479	0	75	0	8249	0	8174	0.0	0.0
chr8	CTSB	11864375	11864483	0	109	0	8249	0	8140	0.0	0.0
chr8	CTSB	11857857	11857940	0	84	0	8249	0	8165	0.0	0.0
chr8	CTSB	11862344	11862478	0	135	0	8249	0	8114	0.0	0.0
chr8	CTSB	11866156	11866201	0	46	0	8249	0	8203	0.0	0.0
chr8	CTSB	11854679	11854914	0	236	0	8249	0	8013	0.0	0.0
chr8	CTSB	11850865	11850980	0	116	0	8249	0	8133	0.0	0.0
chr8	CTSB	11856395	11856585	0	191	0	8249	0	8058	0.0	0.0
chr8	CTSB	11847678	11847815	0	138	0	8249	0	8111	0.0	0.0
chr8	CTSB	11849045	11849228	0	184	0	8249	0	8065	0.0	0.0
chr8	CTSB	11861360	11861479	0	120	0	8249	0	8129	0.0	0.0
chr8	CTSB	11846561	11846616	0	56	0	8249	0	8193	0.0	0.0
chr8	CTSB	11864696	11864903	0	208	0	8249	0	8041	0.0	0.0
chr8	FAM86B1	12188310	12188424	0	115	0	4142	0	4027	0.0	0.0
chr8	FAM86B1	12186699	12186833	0	135	0	4142	0	4007	0.0	0.0
chr8	FAM86B1	12189807	12189888	0	82	0	4142	0	4060	0.0	0.0
chr8	FAM86B1	12186351	12186617	0	267	0	4142	0	3875	0.0	0.0
chr8	FAM86B1	12188071	12188173	0	103	0	4142	0	4039	0.0	0.0
chr8	FAM86B1	12193610	12193684	0	75	0	4142	0	4067	0.0	0.0
chr8	FAM86B1	12191778	12191841	0	64	0	4142	0	4078	0.0	0.0
chr8	FAM86B2	12428632	12428898	0	267	23	1374	23	1107	0.0	0.02077687443541102
chr8	FAM86B2	12430349	12430451	0	103	23	1374	23	1271	0.0	0.01809598741148702
chr8	AC068587.4	12596017	12596214	0	198	5717	16955	5717	16757	0.0	0.3411708539714746
chr8	LONRF1	12737271	12737360	0	90	0	5725	0	5635	0.0	0.0
chr8	AC123777.1	12767729	12767914	0	186	0	1264	0	1078	0.0	0.0
chr8	DLC1	13102789	13102853	0	65	0	12281	0	12216	0.0	0.0
chr8	SGCZ	14324102	14324204	0	103	51	7353	51	7250	0.0	0.00703448275862069
chr8	MSR1	16120417	16120606	0	190	51	7839	51	7649	0.0	0.006667538240292849
chr8	FGF20	16995654	16995758	0	105	204	1843	204	1738	0.0	0.11737629459148446
chr8	CNOT7	17232426	17232537	21	112	663	10657	642	10545	0.1875	0.060881934566145095
chr8	CNOT7	17243441	17243545	0	105	663	10657	663	10552	0.0	0.0628316906747536
chr8	CNOT7	17245856	17245931	0	76	663	10657	663	10581	0.0	0.06265948398072016
chr8	CNOT7	17243441	17243622	0	182	663	10657	663	10475	0.0	0.06329355608591886
chr8	MTMR7	17309276	17309326	0	51	51	6948	51	6897	0.0	0.007394519356241845
chr8	MTMR7	17361116	17361274	0	159	51	6948	51	6789	0.0	0.007512152010605391
chr8	MTUS1	17724101	17724162	0	62	187	12042	187	11980	0.0	0.015609348914858098
chr8	MTUS1	17723671	17723833	0	163	187	12042	187	11879	0.0	0.01574206583045711
chr8	FGL1	17891680	17891807	0	128	7220	3313	7220	3185	0.0	2.2668759811616956
chr8	ASAH1	18059340	18059464	0	125	2982	9281	2982	9156	0.0	0.3256880733944954
chr8	ASAH1	18064456	18064531	0	76	2982	9281	2982	9205	0.0	0.3239543726235741
chr8	ASAH1	18069791	18069878	88	88	2982	9281	2894	9193	1.0	0.3148047427390406
chr8	ASAH1	18071299	18071390	0	92	2982	9281	2982	9189	0.0	0.3245184459680052
chr8	ASAH1	18063184	18063230	0	47	2982	9281	2982	9234	0.0	0.32293697205977906
chr8	ASAH1	18064456	18064468	0	13	2982	9281	2982	9268	0.0	0.3217522658610272
chr8	ASAH1	18064456	18064474	0	19	2982	9281	2982	9262	0.0	0.3219606996329087
chr8	ASAH1	18071299	18071411	0	113	2982	9281	2982	9168	0.0	0.325261780104712
chr8	ASAH1	18064456	18064471	0	16	2982	9281	2982	9265	0.0	0.32185644900161897
chr8	ASAH1	18071330	18071390	0	61	2982	9281	2982	9220	0.0	0.32342733188720174
chr8	ASAH1	18069791	18069872	88	82	2982	9281	2894	9199	1.0731707317073171	0.3145994129796717
chr8	ASAH1	18064122	18064278	0	157	2982	9281	2982	9124	0.0	0.3268303375712407
chr8	ASAH1	18073255	18073276	0	22	2982	9281	2982	9259	0.0	0.32206501782049896
chr8	ASAH1	18083980	18084286	0	307	2982	9281	2982	8974	0.0	0.33229329173166927
chr8	ASAH1	18076176	18076413	368	238	2982	9281	2614	9043	1.546218487394958	0.28906336392790005
chr8	PSD3	18774826	18774938	0	113	1277	15239	1277	15126	0.0	0.0844241703027899
chr8	PSD3	18802330	18802352	0	23	1277	15239	1277	15216	0.0	0.08392481598317561
chr8	PSD3	18803161	18803279	0	119	1277	15239	1277	15120	0.0	0.08445767195767195
chr8	CSGALNACT1	19591159	19591278	0	120	12205	6602	12205	6482	0.0	1.8829065103363158
chr8	CSGALNACT1	19585165	19585317	0	153	12205	6602	12205	6449	0.0	1.8925414792991162
chr8	CSGALNACT1	19457529	19457816	0	288	12205	6602	12205	6314	0.0	1.933006018371872
chr8	CSGALNACT1	19601770	19601865	0	96	12205	6602	12205	6506	0.0	1.8759606517061174
chr8	SLC18A1	20147257	20147391	0	135	144	3929	144	3794	0.0	0.037954665260938325
chr8	SLC18A1	20174360	20174444	0	85	144	3929	144	3844	0.0	0.037460978147762745
chr8	SLC18A1	20181748	20181952	0	205	144	3929	144	3724	0.0	0.03866809881847476
chr8	SLC18A1	20164868	20164964	0	97	144	3929	144	3832	0.0	0.037578288100208766
chr8	SLC18A1	20148414	20148516	0	103	144	3929	144	3826	0.0	0.03763721902770518
chr8	AC021613.1	20954654	20954744	0	91	0	13152	0	13061	0.0	0.0
chr8	GFRA2	21782584	21782899	0	316	201	5482	201	5166	0.0	0.038908246225319396
chr8	GFRA2	21782584	21783142	0	559	201	5482	201	4923	0.0	0.04082876294942109
chr8	GFRA2	21774971	21775055	0	85	201	5482	201	5397	0.0	0.03724291272929405
chr8	DOK2	21911900	21911988	0	89	1176	1090	1176	1001	0.0	1.1748251748251748
chr8	DOK2	21912228	21912510	0	283	1176	1090	1176	807	0.0	1.4572490706319703
chr8	HR	22116874	22117039	1882	166	33622	7984	31740	7818	11.337349397590362	4.0598618572524945
chr8	HR	22122492	22122608	864	117	33622	7984	32758	7867	7.384615384615385	4.163976102707513
chr8	REEP4	22138638	22138793	0	156	0	2273	0	2117	0.0	0.0
chr8	REEP4	22138925	22139061	0	137	0	2273	0	2136	0.0	0.0
chr8	LGI3	22154141	22154213	0	73	1	3412	1	3339	0.0	0.0002994908655286014
chr8	PHYHIP	22228787	22228909	0	123	881	3938	881	3815	0.0	0.2309305373525557
chr8	BIN3	22636524	22636586	0	63	51	4410	51	4347	0.0	0.011732229123533472
chr8	BIN3	22644754	22644803	0	50	51	4410	51	4360	0.0	0.011697247706422019
chr8	BIN3	22636921	22636962	0	42	51	4410	51	4368	0.0	0.011675824175824176
chr8	BIN3	22634412	22634525	0	114	51	4410	51	4296	0.0	0.011871508379888268
chr8	EGR3	22692301	22692354	0	54	0	5038	0	4984	0.0	0.0
chr8	TNFRSF10B	23043137	23043243	0	107	5916	4954	5916	4847	0.0	1.2205487930678771
chr8	LOXL2	23333400	23333623	0	224	217530	5755	217530	5531	0.0	39.32923521967095
chr8	LOXL2	23403953	23404073	0	121	217530	5755	217530	5634	0.0	38.61022364217252
chr8	LOXL2	23382390	23382513	0	124	217530	5755	217530	5631	0.0	38.630793819925415
chr8	LOXL2	23370642	23370762	0	121	217530	5755	217530	5634	0.0	38.61022364217252
chr8	ENTPD4	23449892	23449997	0	106	2184763	7070	2184763	6964	0.0	313.722429638139
chr8	AC041005.1	25180816	25180985	318	170	11212	3575	10894	3405	1.8705882352941177	3.199412628487518
chr8	KCTD9	25444291	25444335	0	45	0	4398	0	4353	0.0	0.0
chr8	KCTD9	25446079	25446250	0	172	0	4398	0	4226	0.0	0.0
chr8	KCTD9	25446128	25446250	0	123	0	4398	0	4275	0.0	0.0
chr8	EBF2	25858058	25858154	0	97	22	7116	22	7019	0.0	0.003134349622453341
chr8	STMN4	27241676	27241757	0	82	0	3302	0	3220	0.0	0.0
chr8	STMN4	27243710	27243801	0	92	0	3302	0	3210	0.0	0.0
chr8	STMN4	27239225	27239279	0	55	0	3302	0	3247	0.0	0.0
chr8	TRIM35	27290155	27290178	0	24	1714	3266	1714	3242	0.0	0.5286859962985812
chr8	TRIM35	27298463	27298559	0	97	1714	3266	1714	3169	0.0	0.5408646260650047
chr8	CHRNA2	27462978	27463993	322372	1016	332217	5067	9845	4051	317.29527559055117	2.430264132313009
chr8	CHRNA2	27462978	27463860	2754	883	332217	5067	329463	4184	3.118912797281993	78.74354684512429
chr8	CHRNA2	27477167	27477228	0	62	332217	5067	332217	5005	0.0	66.37702297702297
chr8	CHRNA2	27475212	27475272	0	61	332217	5067	332217	5006	0.0	66.36376348381941
chr8	CLU	27614172	27614370	13637	199	28475	5788	14838	5589	68.52763819095478	2.6548577563070315
chr8	CLU	27613577	27613683	0	107	28475	5788	28475	5681	0.0	5.012321774335504
chr8	CCDC25	27740471	27740517	0	47	272	4420	272	4373	0.0	0.06219986279442031
chr8	CCDC25	27748494	27748598	0	105	272	4420	272	4315	0.0	0.06303592120509849
chr8	CCDC25	27756718	27756770	0	53	272	4420	272	4367	0.0	0.06228532173116556
chr8	CCDC25	27765203	27765251	272	49	272	4420	0	4371	5.551020408163265	0.0
chr8	CCDC25	27748076	27748279	0	204	272	4420	272	4216	0.0	0.06451612903225806
chr8	CCDC25	27764285	27764533	0	249	272	4420	272	4171	0.0	0.06521217933349317
chr8	SCARA5	27921570	27922245	0	676	102	4389	102	3713	0.0	0.02747104767034743
chr8	SCARA5	27966413	27966542	0	130	102	4389	102	4259	0.0	0.023949283869452925
chr8	FBXO16	28456765	28456930	6	166	1773	3825	1767	3659	0.03614457831325301	0.4829188302814977
chr8	FBXO16	28473771	28473807	0	37	1773	3825	1773	3788	0.0	0.4680570221752904
chr8	FBXO16	28483347	28483483	0	137	1773	3825	1773	3688	0.0	0.4807483731019523
chr8	ZNF395	28375261	28375382	0	122	25206	5747	25206	5625	0.0	4.481066666666667
chr8	ZNF395	28368448	28368565	0	118	25206	5747	25206	5629	0.0	4.477882394741517
chr8	FBXO16	28429377	28429403	53	27	1773	3825	1720	3798	1.962962962962963	0.4528699315429173
chr8	FBXO16	28483347	28483462	0	116	1773	3825	1773	3709	0.0	0.4780264222162308
chr8	FBXO16	28447170	28447273	0	104	1773	3825	1773	3721	0.0	0.4764848159097017
chr8	INTS9	28812326	28812461	0	136	1928	4789	1928	4653	0.0	0.41435632924994625
chr8	INTS9	28813491	28813612	0	122	1928	4789	1928	4667	0.0	0.41311334904649666
chr8	INTS9	28835291	28835378	0	88	1928	4789	1928	4701	0.0	0.4101255052116571
chr8	INTS9	28846746	28846809	0	64	1928	4789	1928	4725	0.0	0.40804232804232804
chr8	INTS9	28859435	28859563	0	129	1928	4789	1928	4660	0.0	0.41373390557939915
chr8	INTS9	28850212	28850273	0	62	1928	4789	1928	4727	0.0	0.4078696847895071
chr8	INTS9	28862039	28862212	0	174	1928	4789	1928	4615	0.0	0.41776814734561213
chr8	KIF13B	29075280	29075343	0	64	52950	11154	52950	11090	0.0	4.774571686203787
chr8	KIF13B	29196186	29196199	68	14	52950	11154	52882	11140	4.857142857142857	4.7470377019748655
chr8	KIF13B	29249984	29250084	0	101	52950	11154	52950	11053	0.0	4.790554600560934
chr8	SARAF	30073876	30074055	0	180	1122	1698	1122	1518	0.0	0.7391304347826086
chr8	SARAF	30073876	30074051	0	176	1122	1698	1122	1522	0.0	0.7371879106438897
chr8	SARAF	30073876	30074028	0	153	1122	1698	1122	1545	0.0	0.7262135922330097
chr8	RBPMS-AS1	30383127	30383362	102	236	102	1527	0	1291	0.4322033898305085	0.0
chr8	RBPMS-AS1	30383543	30383697	0	155	102	1527	102	1372	0.0	0.07434402332361516
chr8	GSR	30689160	30689319	0	160	255	3619	255	3459	0.0	0.07372072853425846
chr8	GSR	30692968	30693055	0	88	255	3619	255	3531	0.0	0.07221750212404418
chr8	GSR	30704646	30704864	0	219	255	3619	255	3400	0.0	0.075
chr8	TTI2	33507228	33507321	0	94	0	3568	0	3474	0.0	0.0
chr8	TTI2	33512959	33513004	0	46	0	3568	0	3522	0.0	0.0
chr8	AF279873.4	34005239	34005336	0	98	0	515	0	417	0.0	0.0
chr8	AC124290.2	36034866	36034948	0	83	0	446	0	363	0.0	0.0
chr8	LINC01605	37531311	37531398	0	88	105	1532	105	1444	0.0	0.07271468144044321
chr8	BRF2	37845685	37845774	0	90	102	2723	102	2633	0.0	0.03873908089631599
chr8	BRF2	37847302	37847341	0	40	102	2723	102	2683	0.0	0.0380171449869549
chr8	BRF2	37847273	37847341	0	69	102	2723	102	2654	0.0	0.03843255463451394
chr8	RAB11FIP1	37871277	37873179	0	1903	153	8656	153	6753	0.0	0.02265659706796979
chr8	STAR	38145221	38145315	0	95	9752	3614	9752	3519	0.0	2.7712418300653594
chr8	LSM1	38169801	38169917	0	117	4766	1222	4766	1105	0.0	4.313122171945701
chr8	LSM1	38170942	38171012	5	71	4766	1222	4761	1151	0.07042253521126761	4.13640312771503
chr8	PLPP5	38268370	38268461	905	92	84980	3045	84075	2953	9.83695652173913	28.47104639349814
chr8	PLPP5	38268370	38268407	198	38	84980	3045	84782	3007	5.2105263157894735	28.194878616561358
chr8	NSD3	38299443	38299590	1364	148	1338735	15273	1337371	15125	9.216216216216216	88.42122314049587
chr8	NSD3	38363872	38363900	0	29	1338735	15273	1338735	15244	0.0	87.82045394909473
chr8	FGFR1	38421796	38421941	0	146	323	11651	323	11505	0.0	0.028074750108648412
chr8	FGFR1	38426121	38426245	0	125	323	11651	323	11526	0.0	0.028023598820058997
chr8	FGFR1	38429681	38429948	0	268	323	11651	323	11383	0.0	0.02837564789598524
chr8	FGFR1	38458846	38458894	0	49	323	11651	323	11602	0.0	0.027840027581451474
chr8	FGFR1	38461095	38461255	0	161	323	11651	323	11490	0.0	0.028111401218450828
chr8	FGFR1	38423024	38423175	0	152	323	11651	323	11499	0.0	0.028089399078180713
chr8	FGFR1	38443396	38443492	0	97	323	11651	323	11554	0.0	0.027955686342392243
chr8	FGFR1	38440305	38440373	0	69	323	11651	323	11582	0.0	0.027888102227594542
chr8	FGFR1	38429246	38429390	0	145	323	11651	323	11506	0.0	0.02807231009907874
chr8	FGFR1	38457355	38457534	0	180	323	11651	323	11471	0.0	0.02815796356028245
chr8	FGFR1	38458846	38458969	0	124	323	11651	323	11527	0.0	0.028021167693241953
chr8	FGFR1	38458846	38458984	0	139	323	11651	323	11512	0.0	0.02805767894371091
chr8	AC069120.1	38544083	38544179	0	97	51	2688	51	2591	0.0	0.01968351987649556
chr8	AC069120.1	38552958	38553091	0	134	51	2688	51	2554	0.0	0.019968676585747847
chr8	ADAM3A	39477695	39477846	0	152	0	3023	0	2871	0.0	0.0
chr8	ADAM3A	39512577	39512656	0	80	0	3023	0	2943	0.0	0.0
chr8	ADAM3A	39490262	39490357	0	96	0	3023	0	2927	0.0	0.0
chr8	ADAM3A	39477695	39477943	0	249	0	3023	0	2774	0.0	0.0
chr8	ADAM3A	39522259	39522342	0	84	0	3023	0	2939	0.0	0.0
chr8	ADAM2	39809409	39809466	0	58	0	2928	0	2870	0.0	0.0
chr8	ZMAT4	40674703	40674931	0	229	0	3453	0	3224	0.0	0.0
chr8	ZMAT4	40786688	40786782	0	95	0	3453	0	3358	0.0	0.0
chr8	ZMAT4	40808508	40808571	0	64	0	3453	0	3389	0.0	0.0
chr8	ANK1	41661800	41661941	0	142	52607	10404	52607	10262	0.0	5.126388618203079
chr8	ANK1	41661429	41661564	0	136	52607	10404	52607	10268	0.0	5.1233930658356055
chr8	ANK1	41661875	41661941	0	67	52607	10404	52607	10337	0.0	5.089194156912064
chr8	ANK1	41700430	41700454	0	25	52607	10404	52607	10379	0.0	5.0686000578090376
chr8	ANK1	41672515	41672912	0	398	52607	10404	52607	10006	0.0	5.25754547271637
chr8	KAT6A	42049619	42049707	0	89	600	16866	600	16777	0.0	0.0357632473028551
chr8	KAT6A	42049575	42049707	0	133	600	16866	600	16733	0.0	0.03585728799378474
chr8	KAT6A	41957048	41957180	0	133	600	16866	600	16733	0.0	0.03585728799378474
chr8	PLAT	42185080	42185172	51	93	285245	6705	285194	6612	0.5483870967741935	43.13278886872353
chr8	PLAT	42188933	42189071	73143	139	285245	6705	212102	6566	526.2086330935252	32.303076454462385
chr8	PLAT	42206646	42206698	0	53	285245	6705	285245	6652	0.0	42.88108839446783
chr8	PLAT	42187397	42187572	4603	176	285245	6705	280642	6529	26.15340909090909	42.98391790473273
chr8	PLAT	42177374	42177437	9116	64	285245	6705	276129	6641	142.4375	41.57943080861316
chr8	PLAT	42185080	42185158	51	79	285245	6705	285194	6626	0.6455696202531646	43.041654089948686
chr8	PLAT	42187905	42188016	3427	112	285245	6705	281818	6593	30.598214285714285	42.7450326103443
chr8	AC083973.1	42265614	42266396	2296	783	136232	2277	133936	1494	2.9323116219667944	89.64926372155288
chr8	SLC20A2	42471066	42471201	0	136	313	6168	313	6032	0.0	0.051889920424403185
chr8	CHRNA6	42759068	42759113	0	46	4323	2604	4323	2558	0.0	1.6899921813917123
chr8	THAP1	42839185	42839381	0	197	749	995	749	798	0.0	0.9385964912280702
chr8	RNF170	42865415	42865489	6274	75	32700	5835	26426	5760	83.65333333333334	4.587847222222222
chr8	RNF170	42889302	42889414	74	113	32700	5835	32626	5722	0.6548672566371682	5.70185249912618
chr8	ASNSP1	46590069	46590151	0	83	0	2850	0	2767	0.0	0.0
chr8	ASNSP1	46592102	46592267	0	166	0	2850	0	2684	0.0	0.0
chr8	ASNSP1	46595686	46595780	0	95	0	2850	0	2755	0.0	0.0
chr8	ASNSP1	46600435	46600674	0	240	0	2850	0	2610	0.0	0.0
chr8	ASNSP1	46593463	46593631	0	169	0	2850	0	2681	0.0	0.0
chr8	PRKDC	47776843	47776983	0	141	430	15496	430	15355	0.0	0.02800390752197981
chr8	PRKDC	47782161	47782254	0	94	430	15496	430	15402	0.0	0.02791845214907155
chr8	EFCAB1	48731347	48731503	748	157	166027	4814	165279	4657	4.764331210191083	35.49044449216234
chr8	PXDNL	51374596	51374731	0	136	0	5262	0	5126	0.0	0.0
chr8	PCMTD1	51870247	51870390	0	144	0	6122	0	5978	0.0	0.0
chr8	PCMTD1	51860844	51861246	0	403	0	6122	0	5719	0.0	0.0
chr8	ST18	52210029	52210117	0	89	256	12096	256	12007	0.0	0.021320896143916048
chr8	ST18	52171568	52171623	0	56	256	12096	256	12040	0.0	0.0212624584717608
chr8	ST18	52217741	52217901	0	161	256	12096	256	11935	0.0	0.021449518223711772
chr8	ST18	52217812	52217901	0	90	256	12096	256	12006	0.0	0.021322671997334668
chr8	ST18	52217745	52217901	0	157	256	12096	256	11939	0.0	0.021442331853589076
chr8	ST18	52246585	52246664	0	80	256	12096	256	12016	0.0	0.02130492676431425
chr8	ALKAL1	52538430	52538507	0	78	0	1145	0	1067	0.0	0.0
chr8	RB1CC1	52660595	52660657	0	63	0	6657	0	6594	0.0	0.0
chr8	RB1CC1	52685398	52685520	0	123	0	6657	0	6534	0.0	0.0
chr8	RB1CC1	52686852	52686967	0	116	0	6657	0	6541	0.0	0.0
chr8	RB1CC1	52685936	52686156	0	221	0	6657	0	6436	0.0	0.0
chr8	OPRK1	53242738	53242912	0	175	0	5676	0	5501	0.0	0.0
chr8	AC022034.3	53408698	53408788	0	91	47	3228	47	3137	0.0	0.014982467325470195
chr8	AC022034.3	53401479	53401569	0	91	47	3228	47	3137	0.0	0.014982467325470195
chr8	AC022034.3	53422696	53422835	47	140	47	3228	0	3088	0.3357142857142857	0.0
chr8	AC022034.3	53399569	53399837	0	269	47	3228	47	2959	0.0	0.015883744508279823
chr8	AC022034.3	53422222	53422294	0	73	47	3228	47	3155	0.0	0.014896988906497623
chr8	AC022034.3	53430310	53430462	0	153	47	3228	47	3075	0.0	0.015284552845528456
chr8	AC022034.1	53521018	53521379	0	362	0	7532	0	7170	0.0	0.0
chr8	ATP6V1H	53756554	53756656	0	103	0	3871	0	3768	0.0	0.0
chr8	ATP6V1H	53811163	53811217	0	55	0	3871	0	3816	0.0	0.0
chr8	ATP6V1H	53806741	53806858	0	118	0	3871	0	3753	0.0	0.0
chr8	TCEA1	54010429	54010492	0	64	51	4334	51	4270	0.0	0.011943793911007026
chr8	TCEA1	54002891	54002940	0	50	51	4334	51	4284	0.0	0.011904761904761904
chr8	TCEA1	54002891	54003086	0	196	51	4334	51	4138	0.0	0.012324794586756888
chr8	LYPLA1	54052654	54052756	0	103	0	4705	0	4602	0.0	0.0
chr8	LYPLA1	54062253	54062324	0	72	0	4705	0	4633	0.0	0.0
chr8	LYPLA1	54063327	54063375	0	49	0	4705	0	4656	0.0	0.0
chr8	LYPLA1	54065747	54065813	0	67	0	4705	0	4638	0.0	0.0
chr8	LYPLA1	54100907	54100939	0	33	0	4705	0	4672	0.0	0.0
chr8	TMEM68	55743480	55743620	0	141	0	6607	0	6466	0.0	0.0
chr8	TMEM68	55745060	55745121	0	62	0	6607	0	6545	0.0	0.0
chr8	TMEM68	55756243	55756411	0	169	0	6607	0	6438	0.0	0.0
chr8	TMEM68	55762634	55763028	0	395	0	6607	0	6212	0.0	0.0
chr8	TMEM68	55763935	55763980	0	46	0	6607	0	6561	0.0	0.0
chr8	TMEM68	55751420	55751546	0	127	0	6607	0	6480	0.0	0.0
chr8	TMEM68	55763636	55763701	0	66	0	6607	0	6541	0.0	0.0
chr8	TMEM68	55763421	55763701	0	281	0	6607	0	6326	0.0	0.0
chr8	RPS20	56073694	56073768	0	75	0	6105	0	6030	0.0	0.0
chr8	RPS20	56074059	56074159	0	101	0	6105	0	6004	0.0	0.0
chr8	PLAG1	56168027	56168386	0	360	0	7834	0	7474	0.0	0.0
chr8	PLAG1	56179408	56179513	0	106	0	7834	0	7728	0.0	0.0
chr8	SDR16C5	56312156	56312288	0	133	0	3287	0	3154	0.0	0.0
chr8	SDR16C5	56303937	56304084	0	148	0	3287	0	3139	0.0	0.0
chr8	SDR16C6P	56382522	56382622	0	101	0	1094	0	993	0.0	0.0
chr8	LINC00968	56534945	56535009	0	65	0	3316	0	3251	0.0	0.0
chr8	LINC00968	56544078	56544178	0	101	0	3316	0	3215	0.0	0.0
chr8	LINC00968	56538588	56538894	0	307	0	3316	0	3009	0.0	0.0
chr8	AC009597.1	56645631	56645847	51	217	419	2974	368	2757	0.2350230414746544	0.13347841857091042
chr8	AC009597.1	56654907	56655009	0	103	419	2974	419	2871	0.0	0.14594218042493903
chr8	BPNT2	56967109	56967218	0	110	255578	7626	255578	7516	0.0	34.00452368281
chr8	AC092819.1	58260524	58260753	0	230	0	2277	0	2047	0.0	0.0
chr8	AC092819.1	58271280	58271547	0	268	0	2277	0	2009	0.0	0.0
chr8	AC092819.1	58271280	58271596	0	317	0	2277	0	1960	0.0	0.0
chr8	NSMAF	58637233	58637389	0	157	0	6094	0	5937	0.0	0.0
chr8	NSMAF	58639967	58640102	0	136	0	6094	0	5958	0.0	0.0
chr8	LINC01301	60408354	60408497	0	144	102	9536	102	9392	0.0	0.0108603066439523
chr8	LINC01301	60468071	60468192	0	122	102	9536	102	9414	0.0	0.010834926704907584
chr8	ASPH	61618977	61619019	0	43	9508	19640	9508	19597	0.0	0.4851763024952799
chr8	ASPH	61638321	61638363	0	43	9508	19640	9508	19597	0.0	0.4851763024952799
chr8	ASPH	61643944	61644001	0	58	9508	19640	9508	19582	0.0	0.48554795220100094
chr8	ASPH	61646749	61646878	232	130	9508	19640	9276	19510	1.7846153846153847	0.4754484879548949
chr8	ASPH	61633682	61633727	9	46	9508	19640	9499	19594	0.1956521739130435	0.4847912626314178
chr8	ASPH	61638321	61638360	0	40	9508	19640	9508	19600	0.0	0.4851020408163265
chr8	ASPH	61682438	61682483	0	46	9508	19640	9508	19594	0.0	0.4852505869143615
chr8	GGH	63023906	63023997	0	92	0	6476	0	6384	0.0	0.0
chr8	GGH	63023906	63023939	0	34	0	6476	0	6442	0.0	0.0
chr8	GGH	63017065	63017183	0	119	0	6476	0	6357	0.0	0.0
chr8	AC011124.1	63413383	63413717	0	335	204	3217	204	2882	0.0	0.07078417765440666
chr8	LINC01414	64151092	64151164	0	73	0	4070	0	3997	0.0	0.0
chr8	LINC01414	64230555	64230619	0	65	0	4070	0	4005	0.0	0.0
chr8	LINC01414	63895497	63895549	0	53	0	4070	0	4017	0.0	0.0
chr8	LINC01414	64166974	64167027	0	54	0	4070	0	4016	0.0	0.0
chr8	AC104232.1	64804172	64804278	0	107	0	882	0	775	0.0	0.0
chr8	ARMC1	65613243	65613433	0	191	0	3427	0	3236	0.0	0.0
chr8	ARMC1	65622262	65622354	0	93	0	3427	0	3334	0.0	0.0
chr8	ARMC1	65632897	65632997	0	101	0	3427	0	3326	0.0	0.0
chr8	MYBL1	66566063	66566243	0	181	12613	6691	12613	6510	0.0	1.9374807987711213
chr8	SNHG6	66922323	66922392	0	70	0	1198	0	1128	0.0	0.0
chr8	SNHG6	66922613	66922725	0	113	0	1198	0	1085	0.0	0.0
chr8	PPP1R42	66971093	66971140	0	48	0	2092	0	2044	0.0	0.0
chr8	PPP1R42	66988399	66988517	0	119	0	2092	0	1973	0.0	0.0
chr8	PPP1R42	66982048	66982180	0	133	0	2092	0	1959	0.0	0.0
chr8	PPP1R42	67014425	67014592	0	168	0	2092	0	1924	0.0	0.0
chr8	PPP1R42	67021244	67021344	0	101	0	2092	0	1991	0.0	0.0
chr8	COPS5	67047767	67047859	0	93	0	6172	0	6079	0.0	0.0
chr8	COPS5	67060496	67060545	0	50	0	6172	0	6122	0.0	0.0
chr8	COPS5	67061291	67061422	0	132	0	6172	0	6040	0.0	0.0
chr8	COPS5	67060320	67060545	0	226	0	6172	0	5946	0.0	0.0
chr8	COPS5	67080881	67081096	0	216	0	6172	0	5956	0.0	0.0
chr8	CPA6	67517922	67518047	0	126	61980	2900	61980	2774	0.0	22.343186733958184
chr8	C8ORF34-AS1	68312143	68312217	0	75	0	4657	0	4582	0.0	0.0
chr8	C8ORF34-AS1	68308859	68308963	0	105	0	4657	0	4552	0.0	0.0
chr8	C8ORF34-AS1	68312143	68312281	0	139	0	4657	0	4518	0.0	0.0
chr8	C8ORF34-AS1	68312143	68312252	0	110	0	4657	0	4547	0.0	0.0
chr8	C8ORF34-AS1	68316714	68317012	0	299	0	4657	0	4358	0.0	0.0
chr8	C8ORF34-AS1	68312143	68312220	0	78	0	4657	0	4579	0.0	0.0
chr8	LINC01592	68998303	68998342	0	40	51	3717	51	3677	0.0	0.013870002719608376
chr8	LINC01592	68954057	68954162	0	106	51	3717	51	3611	0.0	0.014123511492661313
chr8	LINC01592	68954057	68954113	0	57	51	3717	51	3660	0.0	0.013934426229508197
chr8	LINC01592	69000058	69000122	0	65	51	3717	51	3652	0.0	0.013964950711938665
chr8	LINC01592	68948494	68948589	0	96	51	3717	51	3621	0.0	0.014084507042253521
chr8	LINC01603	69447586	69447731	0	146	0	1560	0	1414	0.0	0.0
chr8	LINC01603	69447586	69447698	0	113	0	1560	0	1447	0.0	0.0
chr8	SLCO5A1	69676608	69676673	0	66	204	9921	204	9855	0.0	0.020700152207001523
chr8	SLCO5A1	69738039	69738204	0	166	204	9921	204	9755	0.0	0.020912352639671963
chr8	NCOA2	70144641	70144848	0	208	51	9572	51	9364	0.0	0.005446390431439556
chr8	TRAM1	70598133	70598255	0	123	0	4144	0	4021	0.0	0.0
chr8	LACTB2	70640901	70641050	0	150	0	1940	0	1790	0.0	0.0
chr8	EYA1	71244602	71244692	0	91	27566	8802	27566	8711	0.0	3.164504649293996
chr8	EYA1	71354781	71354909	0	129	27566	8802	27566	8673	0.0	3.178369652945924
chr8	EYA1	71323955	71323986	0	32	27566	8802	27566	8770	0.0	3.1432155074116306
chr8	EYA1	71470857	71470931	0	75	27566	8802	27566	8727	0.0	3.158702876131546
chr8	EYA1	71225151	71225305	0	155	27566	8802	27566	8647	0.0	3.1879264484792413
chr8	C8ORF89	73250267	73250323	0	57	0	662	0	605	0.0	0.0
chr8	RDH10-AS1	73321739	73322087	0	349	68	3809	68	3460	0.0	0.019653179190751446
chr8	STAU2	73673106	73673242	0	137	0	8989	0	8852	0.0	0.0
chr8	STAU2	73688653	73688813	0	161	0	8989	0	8828	0.0	0.0
chr8	STAU2	73709031	73709162	0	132	0	8989	0	8857	0.0	0.0
chr8	STAU2	73739755	73739868	0	114	0	8989	0	8875	0.0	0.0
chr8	STAU2	73527690	73527804	0	115	0	8989	0	8874	0.0	0.0
chr8	STAU2	73738283	73738349	0	67	0	8989	0	8922	0.0	0.0
chr8	STAU2	73561410	73561539	0	130	0	8989	0	8859	0.0	0.0
chr8	STAU2	73668980	73669110	0	131	0	8989	0	8858	0.0	0.0
chr8	STAU2	73697307	73697442	0	136	0	8989	0	8853	0.0	0.0
chr8	STAU2	73742223	73742363	0	141	0	8989	0	8848	0.0	0.0
chr8	UBE2W	73825146	73825249	0	104	816	9101	816	8997	0.0	0.0906968989663221
chr8	UBE2W	73870268	73870301	0	34	816	9101	816	9067	0.0	0.08999669129811404
chr8	UBE2W	73796606	73796690	0	85	816	9101	816	9016	0.0	0.09050576752440107
chr8	UBE2W	73795790	73795914	0	125	816	9101	816	8976	0.0	0.09090909090909091
chr8	ELOC	73959764	73959818	561	55	42046	4943	41485	4888	10.2	8.487111292962357
chr8	ELOC	73969559	73969673	768	115	42046	4943	41278	4828	6.678260869565217	8.549710024855013
chr8	ELOC	73964486	73964625	1120	140	42046	4943	40926	4803	8.0	8.520924422236103
chr8	CASC9	75276986	75277090	1845	105	10073	3373	8228	3268	17.571428571428573	2.517747858017136
chr8	CASC9	75271313	75271433	0	121	10073	3373	10073	3252	0.0	3.0974784747847477
chr8	CASC9	75324220	75324333	0	114	10073	3373	10073	3259	0.0	3.0908254065664313
chr8	CASC9	75278356	75278481	2622	126	10073	3373	7451	3247	20.80952380952381	2.2947336002463814
chr8	ZFHX4-AS1	76672826	76673033	0	208	153	5260	153	5052	0.0	0.030285035629453682
chr8	ZFHX4-AS1	76615152	76615319	0	168	153	5260	153	5092	0.0	0.0300471327572663
chr8	ZFHX4-AS1	76614792	76615319	0	528	153	5260	153	4732	0.0	0.0323330515638208
chr8	PEX2	76988306	76988338	0	33	0	4975	0	4942	0.0	0.0
chr8	PEX2	76986186	76986296	0	111	0	4975	0	4864	0.0	0.0
chr8	PKIA-AS1	78535849	78535973	0	125	0	7213	0	7088	0.0	0.0
chr8	IL7	78738503	78738635	0	133	0	3129	0	2996	0.0	0.0
chr8	IL7	78736473	78736527	0	55	0	3129	0	3074	0.0	0.0
chr8	IL7	78746893	78747096	0	204	0	3129	0	2925	0.0	0.0
chr8	HEY1	79766650	79766732	0	83	306	4811	306	4728	0.0	0.06472081218274112
chr8	MRPS28	80002998	80003180	0	183	60	1805	60	1622	0.0	0.036991368680641186
chr8	MRPS28	79958256	79958435	0	180	60	1805	60	1625	0.0	0.036923076923076927
chr8	TPD52	80064477	80064593	0	117	51	7967	51	7850	0.0	0.006496815286624204
chr8	TPD52	80044166	80044208	0	43	51	7967	51	7924	0.0	0.006436143361938415
chr8	TPD52	80050444	80050471	0	28	51	7967	51	7939	0.0	0.006423982869379015
chr8	TPD52	80052605	80052675	0	71	51	7967	51	7896	0.0	0.006458966565349544
chr8	TPD52	80119814	80119884	0	71	51	7967	51	7896	0.0	0.006458966565349544
chr8	PMP2	81444816	81444989	297	174	6970	3528	6673	3354	1.706896551724138	1.9895646988670244
chr8	IMPA1	81670938	81671047	0	110	0	4417	0	4307	0.0	0.0
chr8	IMPA1	81676233	81676279	0	47	0	4417	0	4370	0.0	0.0
chr8	IMPA1	81679125	81679230	0	106	0	4417	0	4311	0.0	0.0
chr8	IMPA1	81685762	81685963	0	202	0	4417	0	4215	0.0	0.0
chr8	IMPA1	81676233	81676265	0	33	0	4417	0	4384	0.0	0.0
chr8	IMPA1	81678582	81678689	0	108	0	4417	0	4309	0.0	0.0
chr8	IMPA1	81674671	81674831	0	161	0	4417	0	4256	0.0	0.0
chr8	ZFAND1	81717248	81717288	0	41	0	2569	0	2528	0.0	0.0
chr8	ZFAND1	81708787	81708829	0	43	0	2569	0	2526	0.0	0.0
chr8	SNX16	81829429	81829516	0	88	0	4619	0	4531	0.0	0.0
chr8	SNX16	81840197	81840443	0	247	0	4619	0	4372	0.0	0.0
chr8	AC060765.1	82536235	82536405	0	171	790	1669	790	1498	0.0	0.527369826435247
chr8	RBIS	85214920	85215037	0	118	0	2119	0	2001	0.0	0.0
chr8	RBIS	85219235	85219363	0	129	0	2119	0	1990	0.0	0.0
chr8	RBIS	85219322	85219363	0	42	0	2119	0	2077	0.0	0.0
chr8	RBIS	85219235	85219360	0	126	0	2119	0	1993	0.0	0.0
chr8	CA1	85332489	85332552	0	64	241	3056	241	2992	0.0	0.08054812834224599
chr8	CA1	85338251	85338449	0	199	241	3056	241	2857	0.0	0.08435421771088554
chr8	CA1	85351730	85351784	0	55	241	3056	241	3001	0.0	0.08030656447850716
chr8	CA1	85336944	85337063	0	120	241	3056	241	2936	0.0	0.08208446866485014
chr8	CA1	85341598	85341659	0	62	241	3056	241	2994	0.0	0.08049432197728791
chr8	CA1	85342748	85342825	0	78	241	3056	241	2978	0.0	0.0809267965077233
chr8	CA1	85338088	85338139	0	52	241	3056	241	3004	0.0	0.08022636484687085
chr8	CA1	85349810	85349885	0	76	241	3056	241	2980	0.0	0.08087248322147651
chr8	CA1	85341753	85341834	0	82	241	3056	241	2974	0.0	0.08103564223268325
chr8	CA1	85341753	85341808	0	56	241	3056	241	3000	0.0	0.08033333333333334
chr8	CA3-AS1	85444006	85444120	0	115	0	3418	0	3303	0.0	0.0
chr8	SLC7A13	86215560	86215688	0	129	0	2215	0	2086	0.0	0.0
chr8	RMDN1	86484871	86484961	0	91	118	5558	118	5467	0.0	0.021584049753063838
chr8	RMDN1	86474819	86474953	0	135	118	5558	118	5423	0.0	0.02175917388899133
chr8	RMDN1	86474819	86474914	0	96	118	5558	118	5462	0.0	0.021603808128890515
chr8	RMDN1	86505299	86505379	0	81	118	5558	118	5477	0.0	0.02154464122694906
chr8	RMDN1	86494828	86494966	0	139	118	5558	118	5419	0.0	0.021775235283262594
chr8	AF121898.1	87636600	87636650	0	51	95168	2929	95168	2878	0.0	33.06740792216817
chr8	AF121898.1	87646916	87647029	0	114	95168	2929	95168	2815	0.0	33.80746003552398
chr8	AF117829.1	89725517	89725641	0	125	2449	13611	2449	13486	0.0	0.18159572890404865
chr8	NBN	89946139	89946295	0	157	306	6181	306	6024	0.0	0.05079681274900399
chr8	NBN	89981952	89982002	0	51	306	6181	306	6130	0.0	0.049918433931484506
chr8	CALB1	90093397	90093484	0	88	0	7066	0	6978	0.0	0.0
chr8	CALB1	90093397	90093675	0	279	0	7066	0	6787	0.0	0.0
chr8	AC004083.1	90562228	90562340	0	113	32	4799	32	4686	0.0	0.006828851899274435
chr8	TMEM64	90631551	90631707	0	157	12632	5879	12632	5722	0.0	2.2076197133869275
chr8	TMEM64	90727498	90727579	255	82	12632	5879	12377	5797	3.1097560975609757	2.1350698637226153
chr8	PIP4P2	91008742	91008795	0	54	31102	2876	31102	2822	0.0	11.021261516654855
chr8	PIP4P2	91024288	91024366	112	79	31102	2876	30990	2797	1.4177215189873418	11.079728280300321
chr8	RUNX1T1	92062545	92062709	0	165	102019	12864	102019	12699	0.0	8.033624694857863
chr8	RUNX1T1	92095027	92095171	120	145	102019	12864	101899	12719	0.8275862068965517	8.01155751238305
chr8	RUNX1T1	92081233	92081293	5935	61	102019	12864	96084	12803	97.29508196721312	7.504803561665235
chr8	RUNX1T1	92075964	92076137	3542	174	102019	12864	98477	12690	20.35632183908046	7.7602048857368
chr8	RUNX1T1	92062545	92062627	0	83	102019	12864	102019	12781	0.0	7.982082779125264
chr8	RUNX1T1	91979776	91979931	0	156	102019	12864	102019	12708	0.0	8.027935158954989
chr8	RUNX1T1	91994486	91994623	0	138	102019	12864	102019	12726	0.0	8.016580229451517
chr8	RUNX1T1	92003301	92003380	749	80	102019	12864	101270	12784	9.3625	7.921620775969963
chr8	RUNX1T1	92075964	92076132	3542	169	102019	12864	98477	12695	20.958579881656803	7.757148483654983
chr8	RUNX1T1	92062545	92062622	0	78	102019	12864	102019	12786	0.0	7.978961363991866
chr8	TRIQK	92916928	92917010	0	83	622	4946	622	4863	0.0	0.12790458564672014
chr8	TRIQK	92954405	92954564	0	160	622	4946	622	4786	0.0	0.1299623903050564
chr8	TRIQK	92916928	92917007	0	80	622	4946	622	4866	0.0	0.12782572955199342
chr8	TRIQK	92921502	92921660	112	159	622	4946	510	4787	0.7044025157232704	0.1065385418842699
chr8	TRIQK	92960500	92960719	0	220	622	4946	622	4726	0.0	0.13161235717308506
chr8	RBM12B	93737306	93737355	0	50	0	5969	0	5919	0.0	0.0
chr8	RBM12B	93740628	93740696	0	69	0	5969	0	5900	0.0	0.0
chr8	CDH17	94130625	94130739	0	115	0	3898	0	3783	0.0	0.0
chr8	CDH17	94151867	94152112	0	246	0	3898	0	3652	0.0	0.0
chr8	CDH17	94197229	94197331	0	103	0	3898	0	3795	0.0	0.0
chr8	RAD54B	94458267	94458436	0	170	51	5337	51	5167	0.0	0.009870330946390556
chr8	RAD54B	94432610	94432656	0	47	51	5337	51	5290	0.0	0.009640831758034027
chr8	VIRMA	94491577	94491909	0	333	102	9910	102	9577	0.0	0.010650516863318367
chr8	VIRMA	94494859	94494956	0	98	102	9910	102	9812	0.0	0.010395434162250305
chr8	VIRMA	94499373	94499506	0	134	102	9910	102	9776	0.0	0.010433715220949264
chr8	VIRMA	94510416	94510652	0	237	102	9910	102	9673	0.0	0.01054481546572935
chr8	VIRMA	94534838	94535007	0	170	102	9910	102	9740	0.0	0.010472279260780287
chr8	CCNE2	94892817	94892969	0	153	0	4412	0	4259	0.0	0.0
chr8	TP53INP1	94932069	94932107	315	39	53816	5648	53501	5609	8.076923076923077	9.538420395792476
chr8	UQCRB	96234422	96234536	0	115	102	9892	102	9777	0.0	0.010432648051549556
chr8	UQCRB	96231225	96231515	0	291	102	9892	102	9601	0.0	0.010623893344443287
chr8	UQCRB	96231531	96231621	0	91	102	9892	102	9801	0.0	0.010407101316192225
chr8	UQCRB	96231378	96231515	0	138	102	9892	102	9754	0.0	0.010457248308386303
chr8	MTERF3	96239793	96239855	0	63	5008	1811	5008	1748	0.0	2.864988558352403
chr8	MTERF3	96243918	96244080	0	163	5008	1811	5008	1648	0.0	3.0388349514563107
chr8	MTERF3	96260136	96260247	204	112	5008	1811	4804	1699	1.8214285714285714	2.8275456150676868
chr8	RPL30	98044942	98045088	0	147	656	3856	656	3709	0.0	0.17686708007549204
chr8	RPL30	98044826	98045088	0	263	656	3856	656	3593	0.0	0.182577233509602
chr8	RIDA	98108645	98108751	0	107	0	1504	0	1397	0.0	0.0
chr8	RIDA	98108645	98108713	0	69	0	1504	0	1435	0.0	0.0
chr8	RIDA	98108645	98108768	0	124	0	1504	0	1380	0.0	0.0
chr8	NIPAL2	98193384	98193412	0	29	5615	5352	5615	5323	0.0	1.0548562840503475
chr8	STK3	98749275	98749390	0	116	123	7884	123	7768	0.0	0.015834191555097837
chr8	STK3	98889774	98889902	0	129	123	7884	123	7755	0.0	0.01586073500967118
chr8	STK3	98638459	98638560	0	102	123	7884	123	7782	0.0	0.015805705474171164
chr8	VPS13B-DT	98961946	98962041	168	96	4554	3622	4386	3526	1.75	1.2439024390243902
chr8	RGS22	100080133	100080355	0	223	19329	6401	19329	6178	0.0	3.1286824214956295
chr8	RGS22	100091877	100091987	0	111	19329	6401	19329	6290	0.0	3.072972972972973
chr8	RGS22	100054333	100054423	192	91	19329	6401	19137	6310	2.10989010989011	3.0328050713153725
chr8	RNF19A	100261541	100261755	0	215	1055	5281	1055	5066	0.0	0.208251085669167
chr8	RNF19A	100264033	100264195	0	163	1055	5281	1055	5118	0.0	0.20613520906604144
chr8	RNF19A	100300527	100300651	0	125	1055	5281	1055	5156	0.0	0.20461598138091544
chr8	RNF19A	100312343	100312410	0	68	1055	5281	1055	5213	0.0	0.2023786687128333
chr8	AP003472.1	100410734	100410771	0	38	1071	1822	1071	1784	0.0	0.6003363228699552
chr8	AP003472.1	100395380	100395457	0	78	1071	1822	1071	1744	0.0	0.614105504587156
chr8	ANKRD46	100527844	100528003	0	160	16	5482	16	5322	0.0	0.003006388575723412
chr8	ANKRD46	100533208	100533311	16	104	16	5482	0	5378	0.15384615384615385	0.0
chr8	ANKRD46	100532355	100532460	0	106	16	5482	16	5376	0.0	0.002976190476190476
chr8	ANKRD46	100554578	100554717	0	140	16	5482	16	5342	0.0	0.002995132909022838
chr8	SNX31	100577018	100577075	0	58	255	3160	255	3102	0.0	0.08220502901353965
chr8	SNX31	100657723	100657867	0	145	255	3160	255	3015	0.0	0.0845771144278607
chr8	SNX31	100649273	100649348	0	76	255	3160	255	3084	0.0	0.08268482490272373
chr8	PABPC1	100706886	100706997	1	112	1532	8827	1531	8715	0.008928571428571428	0.17567412507171543
chr8	PABPC1	100712361	100712457	0	97	1532	8827	1532	8730	0.0	0.17548682703321877
chr8	PABPC1	100712651	100712789	0	139	1532	8827	1532	8688	0.0	0.17633517495395948
chr8	PABPC1	100721390	100721619	0	230	1532	8827	1532	8597	0.0	0.17820169826683727
chr8	PABPC1	100706650	100706805	0	156	1532	8827	1532	8671	0.0	0.17668089032406872
chr8	PABPC1	100721390	100721452	0	63	1532	8827	1532	8764	0.0	0.17480602464628023
chr8	YWHAZ	100948595	100948900	0	306	51	5869	51	5563	0.0	0.009167715261549523
chr8	YWHAZ	100951928	100952125	0	198	51	5869	51	5671	0.0	0.008993122906013049
chr8	YWHAZ	100951928	100952308	0	381	51	5869	51	5488	0.0	0.009293002915451895
chr8	ZNF706	101199194	101199239	0	46	11580	4818	11580	4772	0.0	2.426655490360436
chr8	ZNF706	101199989	101200097	0	109	11580	4818	11580	4709	0.0	2.459120832448503
chr8	ZNF706	101199989	101200123	0	135	11580	4818	11580	4683	0.0	2.472773862908392
chr8	ZNF706	101202332	101202447	130	116	11580	4818	11450	4702	1.1206896551724137	2.435133985538069
chr8	ZNF706	101204649	101204693	0	45	11580	4818	11580	4773	0.0	2.426147077309868
chr8	ZNF706	101200767	101201004	0	238	11580	4818	11580	4580	0.0	2.5283842794759823
chr8	ZNF706	101202332	101202452	130	121	11580	4818	11450	4697	1.0743801652892562	2.4377262082180113
chr8	NCALD	101887140	101887227	0	88	22282	5763	22282	5675	0.0	3.9263436123348017
chr8	NCALD	102029009	102029096	0	88	22282	5763	22282	5675	0.0	3.9263436123348017
chr8	NCALD	101950257	101950360	0	104	22282	5763	22282	5659	0.0	3.937444778229369
chr8	NCALD	101750597	101750687	0	91	22282	5763	22282	5672	0.0	3.928420310296192
chr8	NCALD	101852571	101852670	0	100	22282	5763	22282	5663	0.0	3.934663605862617
chr8	NCALD	101779923	101779979	0	57	22282	5763	22282	5706	0.0	3.905012267788293
chr8	NCALD	101721212	101721351	3216	140	22282	5763	19066	5623	22.97142857142857	3.3907166992708517
chr8	NCALD	101750042	101750162	0	121	22282	5763	22282	5642	0.0	3.9493087557603688
chr8	NCALD	101745830	101745993	0	164	22282	5763	22282	5599	0.0	3.979639221289516
chr8	RRM2B	102232148	102232304	0	157	9092	4052	9092	3895	0.0	2.334274711168164
chr8	RRM2B	102234724	102234845	0	122	9092	4052	9092	3930	0.0	2.3134860050890587
chr8	AZIN1	102839649	102839823	0	175	2652	5939	2652	5764	0.0	0.4600971547536433
chr8	AZIN1	102849998	102850144	0	147	2652	5939	2652	5792	0.0	0.4578729281767956
chr8	AZIN1	102859069	102859188	0	120	2652	5939	2652	5819	0.0	0.45574841037979036
chr8	BAALC-AS1	103277977	103278021	22	45	129133	14006	129111	13961	0.4888888888888889	9.247976505980947
chr8	BAALC-AS1	103268390	103268472	122	83	129133	14006	129011	13923	1.4698795180722892	9.266034618975796
chr8	BAALC-AS1	103268691	103268843	747	153	129133	14006	128386	13853	4.882352941176471	9.267739839745904
chr8	SLC25A32	103404775	103404861	41	87	2182	3661	2141	3574	0.47126436781609193	0.5990486849468383
chr8	SLC25A32	103403163	103403324	200	162	2182	3661	1982	3499	1.2345679012345678	0.5664475564446985
chr8	DPYS	104381183	104381314	0	132	32049	3828	32049	3696	0.0	8.671266233766234
chr8	DPYS	104451245	104451404	132	160	32049	3828	31917	3668	0.825	8.701472191930208
chr8	DPYS	104392783	104392991	3	209	32049	3828	32046	3619	0.014354066985645933	8.854932301740812
chr8	LRP12	104531906	104531963	0	58	6936	9784	6936	9726	0.0	0.7131400370141888
chr8	ZFPM2-AS1	105787066	105787221	0	156	255	2451	255	2295	0.0	0.1111111111111111
chr8	ZFPM2-AS1	106060134	106060234	0	101	255	2451	255	2350	0.0	0.10851063829787234
chr8	ANGPT1	107284681	107284848	14902	168	55530	7136	40628	6968	88.70238095238095	5.830654420206659
chr8	ANGPT1	107303239	107303367	0	129	55530	7136	55530	7007	0.0	7.924932210646497
chr8	RSPO2	107989055	107989244	0	190	0	4366	0	4176	0.0	0.0
chr8	RSPO2	108060042	108060238	0	197	0	4366	0	4169	0.0	0.0
chr8	EIF3E	108239957	108240075	0	119	102	27596	102	27477	0.0	0.00371219565454744
chr8	EIF3E	108241798	108241913	0	116	102	27596	102	27480	0.0	0.0037117903930131003
chr8	EIF3E	108239957	108240098	0	142	102	27596	102	27454	0.0	0.003715305602098055
chr8	EIF3E	108243292	108243463	0	172	102	27596	102	27424	0.0	0.003719369894982497
chr8	EIF3E	108219749	108219830	0	82	102	27596	102	27514	0.0	0.003707203605437232
chr8	EIF3E	108242111	108242346	0	236	102	27596	102	27360	0.0	0.0037280701754385964
chr8	EIF3E	108268245	108268422	0	178	102	27596	102	27418	0.0	0.0037201838208476183
chr8	EIF3E	108434372	108434493	0	122	102	27596	102	27474	0.0	0.003712601004586154
chr8	EIF3E	108434372	108434487	0	116	102	27596	102	27480	0.0	0.0037117903930131003
chr8	EIF3E	108241885	108241913	0	29	102	27596	102	27567	0.0	0.0037000761780389595
chr8	EIF3E	108242111	108242256	0	146	102	27596	102	27450	0.0	0.003715846994535519
chr8	AC104248.1	108916046	108916091	0	46	0	1972	0	1926	0.0	0.0
chr8	NUDCD1	109322308	109322463	102	156	215409	9547	215307	9391	0.6538461538461539	22.9269513363859
chr8	NUDCD1	109313796	109313888	0	93	215409	9547	215409	9454	0.0	22.784958747620056
chr8	SYBU	109586059	109586162	0	104	51	6757	51	6653	0.0	0.00766571471516609
chr8	SYBU	109642727	109642932	0	206	51	6757	51	6551	0.0	0.007785070981529537
chr8	SYBU	109642727	109642929	0	203	51	6757	51	6554	0.0	0.00778150747635032
chr8	SYBU	109645883	109646004	0	122	51	6757	51	6635	0.0	0.007686510926902789
chr8	SYBU	109642727	109642947	0	221	51	6757	51	6536	0.0	0.007802937576499388
chr8	SYBU	109644635	109644716	0	82	51	6757	51	6675	0.0	0.007640449438202248
chr8	LINC01608	111014903	111015032	0	130	0	12963	0	12833	0.0	0.0
chr8	LINC01608	111005529	111005649	0	121	0	12963	0	12842	0.0	0.0
chr8	LINC01608	111004660	111004769	0	110	0	12963	0	12853	0.0	0.0
chr8	LINC01608	110931442	110933251	0	1810	0	12963	0	11153	0.0	0.0
chr8	LINC01608	110947259	110947418	0	160	0	12963	0	12803	0.0	0.0
chr8	LINC01609	111113431	111113520	0	90	0	3404	0	3314	0.0	0.0
chr8	LINC01609	111121265	111121332	0	68	0	3404	0	3336	0.0	0.0
chr8	LINC01609	111116534	111116600	0	67	0	3404	0	3337	0.0	0.0
chr8	LINC01609	111184572	111184668	0	97	0	3404	0	3307	0.0	0.0
chr8	LINC01609	111228414	111228572	0	159	0	3404	0	3245	0.0	0.0
chr8	LINC01609	111186393	111186479	0	87	0	3404	0	3317	0.0	0.0
chr8	CSMD3	112304720	112304915	0	196	51	20481	51	20285	0.0	0.00251417303426177
chr8	CSMD3	112975836	112976148	0	313	51	20481	51	20168	0.0	0.002528758429194764
chr8	TRPS1	115623600	115623758	0	159	51	11061	51	10902	0.0	0.004678040726472207
chr8	LINC00536	116261411	116261641	0	231	15	3491	15	3260	0.0	0.004601226993865031
chr8	EIF3H	116726015	116726172	0	158	41	6450	41	6292	0.0	0.006516211061665607
chr8	EIF3H	116697052	116697237	0	186	41	6450	41	6264	0.0	0.006545338441890166
chr8	EIF3H	116734276	116734324	0	49	41	6450	41	6401	0.0	0.006405249179815654
chr8	EIF3H	116737236	116737287	0	52	41	6450	41	6398	0.0	0.006408252578930916
chr8	EIF3H	116689068	116689140	0	73	41	6450	41	6377	0.0	0.006429355496314882
chr8	EIF3H	116734276	116734354	0	79	41	6450	41	6371	0.0	0.0064354104536179565
chr8	EXT1	117831598	117831653	0	56	5364	7752	5364	7696	0.0	0.696985446985447
chr8	SAMD12	118439861	118439961	56	101	413	15396	357	15295	0.5544554455445545	0.02334096109839817
chr8	SAMD12	118439831	118439961	56	131	413	15396	357	15265	0.42748091603053434	0.02338683262364887
chr8	TNFRSF11B	118930487	118930768	474	282	2247	2518	1773	2236	1.6808510638297873	0.7929338103756708
chr8	MAL2-AS1	119244809	119244842	0	34	0	2009	0	1975	0.0	0.0
chr8	MAL2-AS1	119224249	119224312	0	64	0	2009	0	1945	0.0	0.0
chr8	MAL2-AS1	119244809	119244975	0	167	0	2009	0	1842	0.0	0.0
chr8	ENPP2	119595846	119596002	0	157	98	6760	98	6603	0.0	0.014841738603665
chr8	ENPP2	119572175	119572250	0	76	98	6760	98	6684	0.0	0.014661879114302813
chr8	ENPP2	119618149	119618323	0	175	98	6760	98	6585	0.0	0.014882308276385725
chr8	TAF2	119796989	119797103	0	115	102	6411	102	6296	0.0	0.016200762388818297
chr8	TAF2	119819345	119819506	0	162	102	6411	102	6249	0.0	0.01632261161785886
chr8	TAF2	119744880	119745036	0	157	102	6411	102	6254	0.0	0.016309561880396548
chr8	TAF2	119761607	119761772	0	166	102	6411	102	6245	0.0	0.01633306645316253
chr8	MRPL13	120432029	120432123	0	95	0	4217	0	4122	0.0	0.0
chr8	SNTB1	120551130	120551251	0	122	4730	6806	4730	6684	0.0	0.7076600837821664
chr8	LINC01151	122693372	122693481	0	110	2142	10472	2142	10362	0.0	0.20671685002895193
chr8	LINC01151	122693372	122693436	0	65	2142	10472	2142	10407	0.0	0.20582300374747767
chr8	FAM83A-AS1	123201643	123201982	0	340	0	2531	0	2191	0.0	0.0
chr8	ZHX1	123253321	123256171	0	2851	51	6740	51	3889	0.0	0.013113911031113397
chr8	ATAD2	123328189	123328579	0	391	102	7131	102	6740	0.0	0.015133531157270029
chr8	ATAD2	123380528	123380677	0	150	102	7131	102	6981	0.0	0.01461108723678556
chr8	ANXA13	123735754	123735877	0	124	0	3815	0	3691	0.0	0.0
chr8	TATDN1	124522150	124522200	341	51	91964	4793	91623	4742	6.686274509803922	19.32159426402362
chr8	TATDN1	124522936	124523002	314	67	91964	4793	91650	4726	4.686567164179104	19.392721117223868
chr8	TATDN1	124503839	124503951	294	113	91964	4793	91670	4680	2.601769911504425	19.587606837606838
chr8	TATDN1	124518817	124518881	796	65	91964	4793	91168	4728	12.246153846153845	19.282571912013537
chr8	TATDN1	124518741	124518881	24139	141	91964	4793	67825	4652	171.19858156028369	14.579750644883921
chr8	TATDN1	124526664	124526824	153	161	91964	4793	91811	4632	0.9503105590062112	19.821027633851468
chr8	MTSS1	124557680	124557875	24	196	169201	7472	169177	7276	0.12244897959183673	23.25137438152831
chr8	MTSS1	124558712	124558832	0	121	169201	7472	169201	7351	0.0	23.01741259692559
chr8	MTSS1	124580550	124580562	0	13	169201	7472	169201	7459	0.0	22.68413996514278
chr8	WASHC5	125083712	125084022	0	311	0	4792	0	4481	0.0	0.0
chr8	WASHC5	125083112	125083258	0	147	0	4792	0	4645	0.0	0.0
chr8	WASHC5	125083712	125083776	0	65	0	4792	0	4727	0.0	0.0
chr8	WASHC5	125083834	125084022	0	189	0	4792	0	4603	0.0	0.0
chr8	LINC00861	125945932	125946182	63	251	384	8777	321	8526	0.250996015936255	0.03764954257565095
chr8	CASC19	127188044	127188115	0	72	180	18096	180	18024	0.0	0.009986684420772303
chr8	CASC19	127189909	127189982	0	74	180	18096	180	18022	0.0	0.009987792697813783
chr8	CASC19	127197474	127197564	0	91	180	18096	180	18005	0.0	0.009997222993612885
chr8	CASC19	127202041	127202152	0	112	180	18096	180	17984	0.0	0.010008896797153026
chr8	CASC19	127168897	127169117	0	221	180	18096	180	17875	0.0	0.01006993006993007
chr8	CASC19	127164437	127164526	0	90	180	18096	180	18006	0.0	0.009996667777407531
chr8	CASC19	127203162	127203220	0	59	180	18096	180	18037	0.0	0.009979486610855464
chr8	CASC19	127201017	127201123	0	107	180	18096	180	17989	0.0	0.010006114847962645
chr8	CASC19	127205346	127205612	0	267	180	18096	180	17829	0.0	0.010095911155981827
chr8	CASC19	127174189	127174364	0	176	180	18096	180	17920	0.0	0.010044642857142858
chr8	CASC19	127184826	127185770	0	945	180	18096	180	17151	0.0	0.010495014867937729
chr8	CASC19	127191665	127191847	0	183	180	18096	180	17913	0.0	0.010048568079048735
chr8	CASC19	127201017	127201173	0	157	180	18096	180	17939	0.0	0.010034004125090585
chr8	CASC19	127205346	127205445	0	100	180	18096	180	17996	0.0	0.010002222716159146
chr8	CASC19	127191661	127191847	0	187	180	18096	180	17909	0.0	0.010050812440672288
chr8	CASC8	127323014	127323154	0	141	0	2350	0	2209	0.0	0.0
chr8	LINC00824	128422912	128423026	0	115	51	4572	51	4457	0.0	0.01144267444469374
chr8	CCDC26	129480642	129480690	0	49	28720	49644	28720	49595	0.0	0.5790906341365057
chr8	CCDC26	129370306	129370377	0	72	28720	49644	28720	49572	0.0	0.579359315742758
chr8	CCDC26	129399530	129399684	0	155	28720	49644	28720	49489	0.0	0.5803309826426074
chr8	CCDC26	129223220	129223369	0	150	28720	49644	28720	49494	0.0	0.5802723562452015
chr8	CCDC26	129352803	129352980	0	178	28720	49644	28720	49466	0.0	0.5806008167225973
chr8	CCDC26	129388044	129388118	0	75	28720	49644	28720	49569	0.0	0.579394379551736
chr8	CCDC26	129399513	129399684	0	172	28720	49644	28720	49472	0.0	0.5805304010349288
chr8	CCDC26	129254421	129254495	0	75	28720	49644	28720	49569	0.0	0.579394379551736
chr8	CCDC26	129266059	129266266	0	208	28720	49644	28720	49436	0.0	0.5809531515494781
chr8	CCDC26	129344628	129344774	0	147	28720	49644	28720	49497	0.0	0.5802371860920864
chr8	CCDC26	129267779	129267863	0	85	28720	49644	28720	49559	0.0	0.5795112895740431
chr8	CCDC26	129230768	129230861	0	94	28720	49644	28720	49550	0.0	0.5796165489404642
chr8	CCDC26	129270161	129270300	0	140	28720	49644	28720	49504	0.0	0.5801551389786684
chr8	CCDC26	129303204	129303301	0	98	28720	49644	28720	49546	0.0	0.5796633431558552
chr8	CCDC26	129276784	129276919	0	136	28720	49644	28720	49508	0.0	0.5801082653308556
chr8	CCDC26	129554803	129554941	0	139	28720	49644	28720	49505	0.0	0.5801434198565801
chr8	CCDC26	129284657	129284772	0	116	28720	49644	28720	49528	0.0	0.5798740106606364
chr8	CCDC26	129402215	129402251	0	37	28720	49644	28720	49607	0.0	0.5789505513334812
chr8	CCDC26	129443601	129443752	0	152	28720	49644	28720	49492	0.0	0.5802958053826881
chr8	CCDC26	129550814	129550926	0	113	28720	49644	28720	49531	0.0	0.5798388887767257
chr8	CCDC26	129360662	129360832	0	171	28720	49644	28720	49473	0.0	0.5805186667475188
chr8	CCDC26	129402166	129402251	0	86	28720	49644	28720	49558	0.0	0.5795229831712337
chr8	CCDC26	129554909	129554941	0	33	28720	49644	28720	49611	0.0	0.5789038721251335
chr8	CCDC26	129571402	129571433	0	32	28720	49644	28720	49612	0.0	0.5788922034991534
chr8	CCDC26	129360173	129360832	0	660	28720	49644	28720	48984	0.0	0.5863138984158093
chr8	CCDC26	129494543	129494766	0	224	28720	49644	28720	49420	0.0	0.5811412383650344
chr8	CCDC26	129491672	129491748	0	77	28720	49644	28720	49567	0.0	0.5794177577823956
chr8	CCDC26	129552681	129552810	0	130	28720	49644	28720	49514	0.0	0.580037969059256
chr8	CCDC26	129509649	129509721	0	73	28720	49644	28720	49571	0.0	0.5793710032075206
chr8	CCDC26	129441180	129441310	0	131	28720	49644	28720	49513	0.0	0.5800496839213943
chr8	CCDC26	129554667	129554941	0	275	28720	49644	28720	49369	0.0	0.5817415787234904
chr8	CCDC26	129509649	129510198	0	550	28720	49644	28720	49094	0.0	0.5850002036908787
chr8	CCDC26	129573117	129573214	0	98	28720	49644	28720	49546	0.0	0.5796633431558552
chr8	CCDC26	129389855	129389927	0	73	28720	49644	28720	49571	0.0	0.5793710032075206
chr8	CYRIB	129862228	129862334	0	107	102	7461	102	7354	0.0	0.013870002719608376
chr8	CYRIB	129879388	129879471	0	84	102	7461	102	7377	0.0	0.013826758845058967
chr8	CYRIB	129880375	129880458	0	84	102	7461	102	7377	0.0	0.013826758845058967
chr8	CYRIB	129896671	129896854	0	184	102	7461	102	7277	0.0	0.014016765150474097
chr8	CYRIB	129904498	129904585	0	88	102	7461	102	7373	0.0	0.0138342601383426
chr8	CYRIB	129970942	129970995	0	54	102	7461	102	7407	0.0	0.01377075739165654
chr8	CYRIB	129896748	129896854	0	107	102	7461	102	7354	0.0	0.013870002719608376
chr8	CYRIB	129912469	129912515	0	47	102	7461	102	7414	0.0	0.013757755597518209
chr8	CYRIB	129871374	129871496	0	123	102	7461	102	7338	0.0	0.013900245298446443
chr8	CYRIB	129879596	129879789	0	194	102	7461	102	7267	0.0	0.014036053392046237
chr8	CYRIB	129912359	129912417	0	59	102	7461	102	7402	0.0	0.013780059443393677
chr8	CYRIB	129894486	129894564	0	79	102	7461	102	7382	0.0	0.013817393660254673
chr8	ASAP1	130091972	130092143	0	172	100	8333	100	8161	0.0	0.012253400318588408
chr8	ASAP1	130160784	130160793	0	10	100	8333	100	8323	0.0	0.012014898474107893
chr8	ASAP1	130361669	130361771	0	103	100	8333	100	8230	0.0	0.012150668286755772
chr8	KCNQ3	132184240	132184367	0	128	153	11790	153	11662	0.0	0.013119533527696793
chr8	LRRC6	132615037	132615097	0	61	236	4306	236	4245	0.0	0.055594817432273264
chr8	LRRC6	132632739	132632963	0	225	236	4306	236	4081	0.0	0.05782896348934085
chr8	LRRC6	132578407	132578516	0	110	236	4306	236	4196	0.0	0.05624404194470925
chr8	TMEM71	132713994	132714052	0	59	249	3352	249	3293	0.0	0.0756149407834801
chr8	TMEM71	132727797	132727986	0	190	249	3352	249	3162	0.0	0.07874762808349146
chr8	TMEM71	132757233	132757294	102	62	249	3352	147	3290	1.6451612903225807	0.04468085106382979
chr8	TMEM71	132758839	132758915	0	77	249	3352	249	3275	0.0	0.07603053435114504
chr8	TMEM71	132759297	132759447	0	151	249	3352	249	3201	0.0	0.07778819119025304
chr8	TMEM71	132760291	132760369	0	79	249	3352	249	3273	0.0	0.076076993583868
chr8	SLA	133044983	133045115	0	133	0	7510	0	7377	0.0	0.0
chr8	SLA	133060099	133060200	0	102	0	7510	0	7408	0.0	0.0
chr8	SLA	133074852	133075130	0	279	0	7510	0	7231	0.0	0.0
chr8	SLA	133087717	133087840	0	124	0	7510	0	7386	0.0	0.0
chr8	SLA	133059061	133059192	0	132	0	7510	0	7378	0.0	0.0
chr8	SLA	133064110	133064179	0	70	0	7510	0	7440	0.0	0.0
chr8	SLA	133076655	133076755	0	101	0	7510	0	7409	0.0	0.0
chr8	SLA	133063579	133063728	0	150	0	7510	0	7360	0.0	0.0
chr8	NDRG1	133247874	133247926	0	53	51	10313	51	10260	0.0	0.004970760233918129
chr8	NDRG1	133250439	133250543	0	105	51	10313	51	10208	0.0	0.004996081504702194
chr8	NDRG1	133256776	133256863	0	88	51	10313	51	10225	0.0	0.0049877750611246946
chr8	NDRG1	133258365	133258426	0	62	51	10313	51	10251	0.0	0.004975124378109453
chr8	NDRG1	133264546	133264652	0	107	51	10313	51	10206	0.0	0.0049970605526161085
chr8	NDRG1	133280231	133280267	0	37	51	10313	51	10276	0.0	0.004963020630595562
chr8	NDRG1	133284248	133284329	0	82	51	10313	51	10231	0.0	0.004984849965790245
chr8	NDRG1	133246978	133247120	0	143	51	10313	51	10170	0.0	0.005014749262536873
chr8	NDRG1	133255269	133255400	0	132	51	10313	51	10181	0.0	0.005009331106963952
chr8	NDRG1	133250439	133250676	0	238	51	10313	51	10075	0.0	0.005062034739454094
chr8	NDRG1	133288259	133288431	0	173	51	10313	51	10140	0.0	0.005029585798816568
chr8	NDRG1	133280960	133281055	0	96	51	10313	51	10217	0.0	0.004991680532445923
chr8	NDRG1	133267077	133267122	0	46	51	10313	51	10267	0.0	0.004967371189247102
chr8	NDRG1	133284756	133284896	51	141	51	10313	0	10172	0.3617021276595745	0.0
chr8	ST3GAL1	133499134	133499189	0	56	510	8868	510	8812	0.0	0.05787562414888788
chr8	ST3GAL1	133475718	133476600	0	883	510	8868	510	7985	0.0	0.06386975579211021
chr8	ST3GAL1	133507198	133507321	0	124	510	8868	510	8744	0.0	0.05832570905763952
chr8	ST3GAL1	133539636	133539729	0	94	510	8868	510	8774	0.0	0.058126282197401416
chr8	ZFAT	134608728	134608879	0	152	17312	6733	17312	6581	0.0	2.630603251785443
chr8	ZFAT	134610469	134610655	0	187	17312	6733	17312	6546	0.0	2.644668499847235
chr8	ZFAT	134674729	134674888	0	160	17312	6733	17312	6573	0.0	2.633804959683554
chr8	ZFAT	134564986	134565152	0	167	17312	6733	17312	6566	0.0	2.6366128540968625
chr8	ZFAT	134599729	134599862	0	134	17312	6733	17312	6599	0.0	2.6234277920897107
chr8	FAM135B	138367332	138367410	0	79	513	14093	513	14014	0.0	0.036606250891965175
chr8	COL22A1	138679616	138679676	0	61	0	7936	0	7875	0.0	0.0
chr8	COL22A1	138883081	138883244	0	164	0	7936	0	7772	0.0	0.0
chr8	KCNK9	139611336	139612674	0	1339	0	6793	0	5454	0.0	0.0
chr8	KCNK9	139638022	139638053	0	32	0	6793	0	6761	0.0	0.0
chr8	TRAPPC9	140426614	140426641	0	28	204	9689	204	9661	0.0	0.021115826518993894
chr8	AGO2	140535467	140535569	0	103	0	15869	0	15766	0.0	0.0
chr8	AGO2	140585118	140585311	0	194	0	15869	0	15675	0.0	0.0
chr8	PTK2	140686631	140686694	0	64	4068	12062	4068	11998	0.0	0.3390565094182364
chr8	PTK2	140702569	140702707	0	139	4068	12062	4068	11923	0.0	0.34118929799547093
chr8	PTK2	140746759	140746860	0	102	4068	12062	4068	11960	0.0	0.34013377926421406
chr8	PTK2	140752231	140752316	0	86	4068	12062	4068	11976	0.0	0.3396793587174349
chr8	PTK2	140846259	140846322	0	64	4068	12062	4068	11998	0.0	0.3390565094182364
chr8	PTK2	140879470	140879637	0	168	4068	12062	4068	11894	0.0	0.34202118715318647
chr8	PTK2	140925660	140925749	0	90	4068	12062	4068	11972	0.0	0.33979284998329434
chr8	PTK2	140984077	140984155	0	79	4068	12062	4068	11983	0.0	0.33948093131936913
chr8	PTK2	140762367	140762388	0	22	4068	12062	4068	12040	0.0	0.33787375415282395
chr8	PTK2	140669726	140669735	0	10	4068	12062	4068	12052	0.0	0.33753733820112847
chr8	PTK2	140769574	140769592	0	19	4068	12062	4068	12043	0.0	0.33778958731213155
chr8	PTK2	140864311	140864399	0	89	4068	12062	4068	11973	0.0	0.33976447005762966
chr8	PTK2	140751902	140751987	0	86	4068	12062	4068	11976	0.0	0.3396793587174349
chr8	PTK2	140770715	140770799	0	85	4068	12062	4068	11977	0.0	0.3396509977456792
chr8	PTK2	140660600	140660648	0	49	4068	12062	4068	12013	0.0	0.3386331474236244
chr8	PTK2	140718008	140718211	0	204	4068	12062	4068	11858	0.0	0.34305953786473264
chr8	PTK2	140948665	140948723	0	59	4068	12062	4068	12003	0.0	0.33891527118220444
chr8	PTK2	140927345	140927414	0	70	4068	12062	4068	11992	0.0	0.3392261507671781
chr8	SLC45A4	141253988	141254629	0	642	1332	8610	1332	7968	0.0	0.16716867469879518
chr8	MROH5	141434823	141434926	0	104	1061	4795	1061	4691	0.0	0.22617778725218504
chr8	MROH5	141436685	141436862	190	178	1061	4795	871	4617	1.0674157303370786	0.1886506389430366
chr8	MROH5	141489696	141489837	0	142	1061	4795	1061	4653	0.0	0.22802493015258973
chr8	MROH5	141475924	141476147	0	224	1061	4795	1061	4571	0.0	0.23211551082914023
chr8	MROH5	141496319	141496501	0	183	1061	4795	1061	4612	0.0	0.2300520381613183
chr8	TSNARE1	142279859	142280324	0	466	461	4358	461	3892	0.0	0.118448098663926
chr8	TSNARE1	142365910	142366017	0	108	461	4358	461	4250	0.0	0.10847058823529412
chr8	LNCOC1	142723633	142723722	0	90	51	6398	51	6308	0.0	0.008084971464806594
chr8	LNCOC1	142724657	142724738	0	82	51	6398	51	6316	0.0	0.008074730842305257
chr8	LYNX1	142775340	142775363	0	24	0	5029	0	5005	0.0	0.0
chr8	LYNX1	142775905	142776121	0	217	0	5029	0	4812	0.0	0.0
chr8	CYP11B1	142874956	142875154	0	199	0	4216	0	4017	0.0	0.0
chr8	CYP11B1	142877756	142877834	0	79	0	4216	0	4137	0.0	0.0
chr8	CYP11B1	142879345	142879480	0	136	0	4216	0	4080	0.0	0.0
chr8	LY6E-DT	143009048	143009207	0	160	51	3859	51	3699	0.0	0.013787510137875101
chr8	LY6E-DT	143012484	143012572	0	89	51	3859	51	3770	0.0	0.013527851458885942
chr8	TOP1MT	143359263	143359404	136	142	1210	6431	1074	6289	0.9577464788732394	0.17077436794402925
chr8	TOP1MT	143334107	143334285	0	179	1210	6431	1210	6252	0.0	0.19353806781829813
chr8	TOP1MT	143332486	143332601	0	116	1210	6431	1210	6315	0.0	0.1916072842438638
chr8	TOP1MT	143327302	143327790	0	489	1210	6431	1210	5942	0.0	0.20363513968360822
chr8	TOP1MT	143328192	143328315	0	124	1210	6431	1210	6307	0.0	0.19185032503567465
chr8	TOP1MT	143343219	143343286	0	68	1210	6431	1210	6363	0.0	0.19016187333019016
chr8	TOP1MT	143332486	143332657	0	172	1210	6431	1210	6259	0.0	0.19332161687170474
chr8	TOP1MT	143344915	143344981	0	67	1210	6431	1210	6364	0.0	0.19013199245757384
chr8	TOP1MT	143333795	143333927	0	133	1210	6431	1210	6298	0.0	0.1921244839631629
chr8	MROH6	143567610	143567676	0	67	0	3546	0	3479	0.0	0.0
chr8	MROH6	143568141	143568261	0	121	0	3546	0	3425	0.0	0.0
chr8	NAPRT	143577061	143577177	0	117	0	2597	0	2480	0.0	0.0
chr8	EEF1D	143586218	143586290	0	73	0	8812	0	8739	0.0	0.0
chr8	EEF1D	143593892	143594071	0	180	0	8812	0	8632	0.0	0.0
chr8	EEF1D	143588990	143590092	0	1103	0	8812	0	7709	0.0	0.0
chr8	EEF1D	143590607	143590738	0	132	0	8812	0	8680	0.0	0.0
chr8	EEF1D	143592714	143592893	0	180	0	8812	0	8632	0.0	0.0
chr8	EEF1D	143588990	143590081	0	1092	0	8812	0	7720	0.0	0.0
chr8	EEF1D	143592646	143592660	0	15	0	8812	0	8797	0.0	0.0
chr8	EEF1D	143593874	143594071	0	198	0	8812	0	8614	0.0	0.0
chr8	EEF1D	143592646	143592797	0	152	0	8812	0	8660	0.0	0.0
chr8	EEF1D	143592714	143592942	0	229	0	8812	0	8583	0.0	0.0
chr8	EEF1D	143594415	143594518	0	104	0	8812	0	8708	0.0	0.0
chr8	EEF1D	143590607	143590729	0	123	0	8812	0	8689	0.0	0.0
chr8	EEF1D	143590644	143590738	0	95	0	8812	0	8717	0.0	0.0
chr8	EEF1D	143590607	143590735	0	129	0	8812	0	8683	0.0	0.0
chr8	EEF1D	143592646	143592942	0	297	0	8812	0	8515	0.0	0.0
chr8	EEF1D	143592646	143592893	0	248	0	8812	0	8564	0.0	0.0
chr8	EEF1D	143590644	143590735	0	92	0	8812	0	8720	0.0	0.0
chr8	PYCR3	143608763	143608876	0	114	0	3955	0	3841	0.0	0.0
chr8	SCRIB	143791875	143791913	0	39	119039	6452	119039	6413	0.0	18.562139404334946
chr8	SCRIB	143807551	143807614	441	64	119039	6452	118598	6388	6.890625	18.56574827802129
chr8	SCRIB	143793256	143793340	40	85	119039	6452	118999	6367	0.47058823529411764	18.689963876236845
chr8	SCRIB	143791665	143791740	102	76	119039	6452	118937	6376	1.3421052631578947	18.653858218318696
chr8	PUF60	143820665	143820716	0	52	356049	4846	356049	4794	0.0	74.26971214017522
chr8	PUF60	143824312	143824399	0	88	356049	4846	356049	4758	0.0	74.83165195460278
chr8	PUF60	143824312	143824396	0	85	356049	4846	356049	4761	0.0	74.78449905482042
chr8	PUF60	143827384	143827536	0	153	356049	4846	356049	4693	0.0	75.86810142765822
chr8	NRBP2	143835819	143835875	0	57	714	4948	714	4891	0.0	0.14598241668370476
chr8	PLEC	143922503	143925884	0	3382	0	17036	0	13654	0.0	0.0
chr8	PLEC	143937748	143937784	0	37	0	17036	0	16999	0.0	0.0
chr8	PLEC	143938400	143938415	0	16	0	17036	0	17020	0.0	0.0
chr8	PARP10	143985720	143985975	0	256	0	5815	0	5559	0.0	0.0
chr8	PARP10	143986054	143986233	0	180	0	5815	0	5635	0.0	0.0
chr8	SHARPIN	144099080	144099205	0	126	530591	2512	530591	2386	0.0	222.37678122380552
chr8	BOP1	144289094	144289304	0	211	102	3779	102	3568	0.0	0.02858744394618834
chr8	DGAT1	144319027	144319068	0	42	51	3847	51	3805	0.0	0.013403416557161629
chr8	TMEM249	144354236	144354331	182	96	10991	1229	10809	1133	1.8958333333333333	9.540158870255958
chr8	FBXL6	144355967	144356214	2006	248	89659	3250	87653	3002	8.088709677419354	29.198201199200533
chr8	SLC39A4	144413236	144413389	361	154	3348	2852	2987	2698	2.344155844155844	1.1071163825055597
chr8	SLC39A4	144415809	144416091	0	283	3348	2852	3348	2569	0.0	1.3032308291163877
chr8	CYHR1	144464459	144464612	72	154	53352	9265	53280	9111	0.4675324675324675	5.847876193612117
chr8	RECQL4	144512391	144512561	0	171	183	4192	183	4021	0.0	0.0455110668987814
chr8	ARHGAP39	144537720	144537813	111	94	33940	4900	33829	4806	1.1808510638297873	7.038909696213067
chr8	ZNF251	144754695	144754803	0	109	51450	4075	51450	3966	0.0	12.972768532526475
chr8	ZNF34	144777457	144777577	9488	121	44707	3115	35219	2994	78.41322314049587	11.76319305277221
chr8	RPL8	144790677	144790763	0	87	408	1672	408	1585	0.0	0.25741324921135644
chr8	ZNF250	144886839	144886902	23507	64	57585	3889	34078	3825	367.296875	8.909281045751634
chr8	ZNF250	144895142	144895232	9964	91	57585	3889	47621	3798	109.49450549450549	12.538441284886783
chr8	ZNF16	144947939	144948025	0	87	1281	5242	1281	5155	0.0	0.24849660523763337
chr8	ZNF252P	144996506	144996607	43444	102	977712	7532	934268	7430	425.921568627451	125.74266487213997
chr8	ZNF252P	144994478	144994592	34710	115	977712	7532	943002	7417	301.82608695652175	127.14062289335311
chr8	ZNF252P	145000351	145000538	1107	188	977712	7532	976605	7344	5.888297872340425	132.97998366013073
chr8	ZNF596	240301	240496	0	196	0	4549	0	4353	0.0	0.0
chr8	FBXO25	432885	432935	0	51	44969	10390	44969	10339	0.0	4.349453525486024
chr8	FBXO25	467719	467746	0	28	44969	10390	44969	10362	0.0	4.339799266550859
chr8	DLGAP2	1669742	1669784	22	43	8496	15158	8474	15115	0.5116279069767442	0.5606351306649024
chr8	CLN8	1765067	1765223	0	157	14265	8418	14265	8261	0.0	1.72678852439172
chr8	CLN8	1772923	1772985	0	63	14265	8418	14265	8355	0.0	1.7073608617594256
chr8	ARHGEF10	1843352	1843436	549	85	111103	10602	110554	10517	6.458823529411765	10.511933060758771
chr8	ARHGEF10	1880047	1880164	0	118	111103	10602	111103	10484	0.0	10.597386493704693
chr8	ARHGEF10	1926376	1926463	0	88	111103	10602	111103	10514	0.0	10.56714856381967
chr8	MYOM2	2141140	2141177	0	38	0	7102	0	7064	0.0	0.0
chr8	MYOM2	2142374	2142397	0	24	0	7102	0	7078	0.0	0.0
chr8	AC246817.1	2808366	2808434	0	69	0	6094	0	6025	0.0	0.0
chr8	MCPH1	6438952	6439096	0	145	2207	9791	2207	9646	0.0	0.22879950238440805
chr8	AGPAT5	6724869	6724939	0	71	51	6247	51	6176	0.0	0.008257772020725388
chr8	AGPAT5	6755050	6755174	0	125	51	6247	51	6122	0.0	0.008330610911466842
chr8	AF228730.5	7154741	7154790	0	50	0	2047	0	1997	0.0	0.0
chr8	SPAG11A	7860346	7860422	0	77	0	1983	0	1906	0.0	0.0
chr8	SPAG11A	7860645	7860723	0	79	0	1983	0	1904	0.0	0.0
chr8	SPAG11A	7862308	7862412	0	105	0	1983	0	1878	0.0	0.0
chr8	FAM66E	7960492	7960986	0	495	486	2852	486	2357	0.0	0.206194314806958
chr8	FAM86B3P	8234482	8234584	4580	103	7276	3972	2696	3869	44.46601941747573	0.6968208839493409
chr8	FAM86B3P	8236031	8236299	0	269	7276	3972	7276	3703	0.0	1.9648933297326492
chr8	FAM86B3P	8241540	8241680	0	141	7276	3972	7276	3831	0.0	1.8992430174889063
chr8	ERI1	9004073	9004296	0	224	2647	6398	2647	6174	0.0	0.42873339812115324
chr8	ERI1	9009031	9009138	0	108	2647	6398	2647	6290	0.0	0.4208267090620032
chr8	ERI1	9096742	9096860	0	119	2647	6398	2647	6279	0.0	0.42156394330307373
chr8	AC022784.5	9142282	9142373	0	92	0	722	0	630	0.0	0.0
chr8	AC022784.1	9154205	9154343	0	139	9095	16960	9095	16821	0.0	0.5406931811426193
chr8	AC022784.1	9168110	9169177	0	1068	9095	16960	9095	15892	0.0	0.5723005285678329
chr8	AC022784.1	9193409	9194032	0	624	9095	16960	9095	16336	0.0	0.5567458374142997
chr8	AC022784.1	9189347	9189597	0	251	9095	16960	9095	16709	0.0	0.5443174337183554
chr8	AC022784.1	9198923	9198991	0	69	9095	16960	9095	16891	0.0	0.5384524302883192
chr8	AC022784.1	9154965	9155149	0	185	9095	16960	9095	16775	0.0	0.5421758569299553
chr8	AC022784.1	9154965	9155076	0	112	9095	16960	9095	16848	0.0	0.539826685660019
chr8	AC022784.1	9189347	9189586	0	240	9095	16960	9095	16720	0.0	0.5439593301435407
chr8	AC022784.1	9193059	9193089	0	31	9095	16960	9095	16929	0.0	0.5372437828578179
chr8	AC022784.1	9193957	9194032	0	76	9095	16960	9095	16884	0.0	0.5386756692726842
chr8	AC022784.1	9319873	9320071	0	199	9095	16960	9095	16761	0.0	0.5426287214366684
chr8	AC022784.1	9332838	9332995	0	158	9095	16960	9095	16802	0.0	0.541304606594453
chr8	AC022784.1	9332922	9332995	0	74	9095	16960	9095	16886	0.0	0.5386118678194954
chr8	AC022784.1	9332403	9332513	0	111	9095	16960	9095	16849	0.0	0.5397946465665618
chr8	AC022784.1	9363261	9363382	0	122	9095	16960	9095	16838	0.0	0.5401472859009383
chr8	AC022784.1	9391505	9391565	0	61	9095	16960	9095	16899	0.0	0.5381975264808568
chr8	AC022784.1	9407605	9407867	0	263	9095	16960	9095	16697	0.0	0.544708630292867
chr8	AC022784.1	9389704	9389827	0	124	9095	16960	9095	16836	0.0	0.5402114516512235
chr8	TNKS	9743463	9743572	0	110	1836	14227	1836	14117	0.0	0.13005596089820784
chr8	TNKS	9772368	9772423	0	56	1836	14227	1836	14171	0.0	0.12956036976924706
chr8	MSRA	10245103	10245223	0	121	590	4152	590	4031	0.0	0.1463656660878194
chr8	MSRA	10096243	10096318	0	76	590	4152	590	4076	0.0	0.14474975466143278
chr8	C8ORF74	10687079	10687271	0	193	67052	5362	67052	5169	0.0	12.971948152447283
chr8	MTMR9	11297899	11297951	0	53	102	8416	102	8363	0.0	0.012196580174578501
chr8	TDH	11361385	11361535	0	151	0	2248	0	2097	0.0	0.0
chr8	TDH	11362907	11362973	0	67	0	2248	0	2181	0.0	0.0
chr8	TDH	11362882	11362973	0	92	0	2248	0	2156	0.0	0.0
chr8	FAM167A-AS1	11404540	11404702	0	163	0	2238	0	2075	0.0	0.0
chr8	BLK	11543223	11543347	0	125	0	4919	0	4794	0.0	0.0
chr8	LINC00208	11582503	11582580	0	78	0	2834	0	2756	0.0	0.0
chr8	GATA4	11707855	11708928	1083428	1074	1335593	3555	252165	2481	1008.7783985102421	101.6384522370012
chr8	GATA4	11705913	11706033	2861	121	1335593	3555	1332732	3434	23.644628099173552	388.0990099009901
chr8	NEIL2	11771445	11771585	0	141	0	3371	0	3230	0.0	0.0
chr8	NEIL2	11779597	11779950	0	354	0	3371	0	3017	0.0	0.0
chr8	NEIL2	11770173	11770335	0	163	0	3371	0	3208	0.0	0.0
chr8	FDFT1	11821749	11821878	0	130	0	4998	0	4868	0.0	0.0
chr8	FDFT1	11802758	11802931	0	174	0	4998	0	4824	0.0	0.0
chr8	FDFT1	11808793	11808891	0	99	0	4998	0	4899	0.0	0.0
chr8	FDFT1	11802257	11802455	0	199	0	4998	0	4799	0.0	0.0
chr8	FDFT1	11803321	11803518	0	198	0	4998	0	4800	0.0	0.0
chr8	FDFT1	11803090	11803225	0	136	0	4998	0	4862	0.0	0.0
chr8	FAM66D	12121986	12122050	0	65	24	7125	24	7060	0.0	0.0033994334277620396
chr8	FAM66D	12145931	12146015	0	85	24	7125	24	7040	0.0	0.003409090909090909
chr8	FAM66D	12121644	12121740	0	97	24	7125	24	7028	0.0	0.003414911781445646
chr8	FAM66D	12145947	12146015	0	69	24	7125	24	7056	0.0	0.003401360544217687
chr8	FAM66D	12145422	12145546	0	125	24	7125	24	7000	0.0	0.0034285714285714284
chr8	FAM66D	12121986	12122160	0	175	24	7125	24	6950	0.0	0.0034532374100719426
chr8	TUSC3	15650696	15650814	0	119	2897	5206	2897	5087	0.0	0.5694908590524868
chr8	TUSC3	15730665	15730729	0	65	2897	5206	2897	5141	0.0	0.5635090449328924
chr8	TUSC3	15748374	15748465	0	92	2897	5206	2897	5114	0.0	0.5664841611263199
chr8	TUSC3	15757790	15757855	0	66	2897	5206	2897	5140	0.0	0.5636186770428016
chr8	MICU3	17069687	17069719	0	33	229536	4620	229536	4587	0.0	50.040549378678875
chr8	MICU3	17090545	17090584	0	40	229536	4620	229536	4580	0.0	50.11703056768559
chr8	VPS37A	17265770	17265815	0	46	102	5710	102	5664	0.0	0.018008474576271187
chr8	VPS37A	17265906	17265981	0	76	102	5710	102	5634	0.0	0.01810436634717785
chr8	VPS37A	17248309	17248417	0	109	102	5710	102	5601	0.0	0.01821103374397429
chr8	SLC7A2	17502256	17502302	0	47	0	7920	0	7873	0.0	0.0
chr8	SLC7A2	17538776	17538922	0	147	0	7920	0	7773	0.0	0.0
chr8	PCM1	17924712	17924780	65672	69	198695	12520	133023	12451	951.768115942029	10.683720183117822
chr8	PCM1	17963100	17963291	0	192	198695	12520	198695	12328	0.0	16.11737508111616
chr8	PCM1	17980590	17980755	0	166	198695	12520	198695	12354	0.0	16.08345475149749
chr8	PCM1	18014583	18014840	0	258	198695	12520	198695	12262	0.0	16.204126569890718
chr8	PCM1	17940041	17940158	848	118	198695	12520	197847	12402	7.186440677966102	15.952830188679245
chr8	PCM1	17983232	17983289	0	58	198695	12520	198695	12462	0.0	15.94406997271706
chr8	AC124242.1	18085241	18085485	0	245	0	3569	0	3324	0.0	0.0
chr8	AC124242.1	18087024	18087137	0	114	0	3569	0	3455	0.0	0.0
chr8	NAT1	18212390	18212774	0	385	0	2896	0	2511	0.0	0.0
chr8	NAT1	18216876	18216994	0	119	0	2896	0	2777	0.0	0.0
chr8	AC100849.2	19136677	19136846	0	170	0	2568	0	2398	0.0	0.0
chr8	SH2D4A	19319343	19319728	0	386	204	3405	204	3019	0.0	0.06757204372308712
chr8	SH2D4A	19357202	19357283	204	82	204	3405	0	3323	2.4878048780487805	0.0
chr8	INTS10	19819572	19819676	0	105	0	6356	0	6251	0.0	0.0
chr8	INTS10	19820378	19820518	0	141	0	6356	0	6215	0.0	0.0
chr8	INTS10	19824802	19824972	0	171	0	6356	0	6185	0.0	0.0
chr8	INTS10	19826425	19826559	0	135	0	6356	0	6221	0.0	0.0
chr8	INTS10	19841826	19841955	0	130	0	6356	0	6226	0.0	0.0
chr8	INTS10	19849161	19849239	0	79	0	6356	0	6277	0.0	0.0
chr8	LPL	19959259	19959380	0	122	40	4144	40	4022	0.0	0.009945300845350571
chr8	LPL	19946541	19946698	0	158	40	4144	40	3986	0.0	0.010035122930255895
chr8	ATP6V1B2	20203958	20204083	0	126	0	4458	0	4332	0.0	0.0
chr8	AC023403.1	20358257	20358435	0	179	0	989	0	810	0.0	0.0
chr8	AC023403.1	20363603	20363830	0	228	0	989	0	761	0.0	0.0
chr8	NPM2	22024723	22024830	0	108	14242	1896	14242	1788	0.0	7.965324384787472
chr8	NPM2	22025215	22025306	0	92	14242	1896	14242	1804	0.0	7.894678492239468
chr8	NPM2	22034108	22034275	11472	168	14242	1896	2770	1728	68.28571428571429	1.6030092592592593
chr8	FGF17	22046526	22046633	915	108	1635	3292	720	3184	8.472222222222221	0.22613065326633167
chr8	DMTN	22069015	22069060	0	46	59512	4133	59512	4087	0.0	14.561291901149987
chr8	DMTN	22067084	22067159	3659	76	59512	4133	55853	4057	48.14473684210526	13.767069263002218
chr8	DMTN	22080804	22080870	0	67	59512	4133	59512	4066	0.0	14.63649778652238
chr8	DMTN	22059372	22059496	4644	125	59512	4133	54868	4008	37.152	13.689620758483034
chr8	FAM160B2	22089760	22089854	0	95	47703	6498	47703	6403	0.0	7.450101514914883
chr8	SFTPC	22162573	22162732	0	160	18	2654	18	2494	0.0	0.007217321571772253
chr8	SFTPC	22163882	22164059	0	178	18	2654	18	2476	0.0	0.007269789983844911
chr8	SFTPC	22163882	22164051	0	170	18	2654	18	2484	0.0	0.007246376811594203
chr8	BMP1	22177566	22177732	0	167	255	6861	255	6694	0.0	0.038093815357036154
chr8	BMP1	22206853	22206981	0	129	255	6861	255	6732	0.0	0.03787878787878788
chr8	BMP1	22199263	22199387	0	125	255	6861	255	6736	0.0	0.0378562945368171
chr8	POLR3D	22248153	22248278	366	126	11649	5592	11283	5466	2.9047619047619047	2.0642151481888034
chr8	POLR3D	22249043	22249309	102	267	11649	5592	11547	5325	0.38202247191011235	2.1684507042253522
chr8	PIWIL2	22354270	22354378	0	109	256210	5761	256210	5652	0.0	45.330856334041044
chr8	SLC39A14	22379426	22379514	0	89	15725	6745	15725	6656	0.0	2.362530048076923
chr8	PPP3CC	22498000	22498112	954	113	116644	2915	115690	2802	8.442477876106194	41.28836545324768
chr8	PPP3CC	22539468	22539498	0	31	116644	2915	116644	2884	0.0	40.44521497919556
chr8	PPP3CC	22531301	22531328	0	28	116644	2915	116644	2887	0.0	40.4031866989955
chr8	SORBS3	22565825	22565872	0	48	1122	5808	1122	5760	0.0	0.19479166666666667
chr8	SORBS3	22566344	22566484	0	141	1122	5808	1122	5667	0.0	0.19798835362625727
chr8	PDLIM2	22589297	22589374	0	78	102	7319	102	7241	0.0	0.01408645214749344
chr8	PDLIM2	22591550	22591668	0	119	102	7319	102	7200	0.0	0.014166666666666666
chr8	PDLIM2	22580961	22581078	0	118	102	7319	102	7201	0.0	0.014164699347312874
chr8	PDLIM2	22593732	22593832	0	101	102	7319	102	7218	0.0	0.014131338320864505
chr8	C8ORF58	22602536	22602643	0	108	0	3102	0	2994	0.0	0.0
chr8	C8ORF58	22602560	22602643	0	84	0	3102	0	3018	0.0	0.0
chr8	CCAR2	22605735	22605831	0	97	102	6444	102	6347	0.0	0.016070584528123523
chr8	AC037441.1	22879290	22879407	38207	118	408987	4016	370780	3898	323.7881355932203	95.12057465366854
chr8	TNFRSF10C	23111719	23111825	233	107	27443	1550	27210	1443	2.177570093457944	18.856548856548855
chr8	CHMP7	23249209	23249381	600	173	236340	3469	235740	3296	3.468208092485549	71.52305825242719
chr8	CHMP7	23259065	23259126	141	62	236340	3469	236199	3407	2.274193548387097	69.32756090402113
chr8	CHMP7	23252367	23252461	0	95	236340	3469	236340	3374	0.0	70.04742145820984
chr8	CHMP7	23247986	23248197	1152	212	236340	3469	235188	3257	5.433962264150943	72.21000921093031
chr8	ADAM28	24308640	24308768	0	129	0	9346	0	9217	0.0	0.0
chr8	ADAM28	24353769	24353832	0	64	0	9346	0	9282	0.0	0.0
chr8	ADAM28	24349863	24349972	0	110	0	9346	0	9236	0.0	0.0
chr8	ADAMDEC1	24392261	24392380	0	120	0	2453	0	2333	0.0	0.0
chr8	ADAMDEC1	24390128	24390218	0	91	0	2453	0	2362	0.0	0.0
chr8	ADAM7	24506090	24506156	0	67	26	4508	26	4441	0.0	0.0058545372663814455
chr8	DOCK5	25300575	25300657	49	83	193218	16044	193169	15961	0.5903614457831325	12.102562496084206
chr8	DOCK5	25388808	25388941	0	134	193218	16044	193218	15910	0.0	12.14443746071653
chr8	CDCA2	25460239	25460300	0	62	53	3713	53	3651	0.0	0.014516570802519857
chr8	AC009623.1	25671295	25671686	0	392	0	3660	0	3268	0.0	0.0
chr8	PPP2R2A	26363720	26363890	10950	171	119842	7726	108892	7555	64.03508771929825	14.413236267372602
chr8	PPP2R2A	26333485	26333570	0	86	119842	7726	119842	7640	0.0	15.686125654450262
chr8	PPP2R2A	26358906	26359032	0	127	119842	7726	119842	7599	0.0	15.770759310435583
chr8	PPP2R2A	26339902	26339973	0	72	119842	7726	119842	7654	0.0	15.657434021426704
chr8	PPP2R2A	26358911	26359032	0	122	119842	7726	119842	7604	0.0	15.760389268805891
chr8	PTK2B	27323266	27323426	0	161	7384	7538	7384	7377	0.0	1.000948895214857
chr8	PTK2B	27445793	27445919	0	127	7384	7538	7384	7411	0.0	0.9963567669680206
chr8	EPHX2	27500925	27501010	0	86	52232	4206	52232	4120	0.0	12.677669902912621
chr8	EPHX2	27506871	27506994	0	124	52232	4206	52232	4082	0.0	12.795688388045075
chr8	EPHX2	27515717	27515813	0	97	52232	4206	52232	4109	0.0	12.711608663908494
chr8	EPHX2	27500963	27501010	0	48	52232	4206	52232	4158	0.0	12.561808561808562
chr8	EPHX2	27500927	27501010	0	84	52232	4206	52232	4122	0.0	12.671518680252305
chr8	ESCO2	27792667	27792811	0	145	306	7821	306	7676	0.0	0.03986451276706618
chr8	ELP3	28099827	28099966	0	140	51	5184	51	5044	0.0	0.010111022997620936
chr8	ELP3	28107912	28107976	0	65	51	5184	51	5119	0.0	0.009962883375659308
chr8	ELP3	28097218	28097318	0	101	51	5184	51	5083	0.0	0.010033444816053512
chr8	ELP3	28183193	28183264	0	72	51	5184	51	5112	0.0	0.009976525821596244
chr8	FZD3	28499932	28499978	0	47	200369	12856	200369	12809	0.0	15.642829260676088
chr8	EXTL3	28743085	28743214	918	130	50627	7671	49709	7541	7.061538461538461	6.591831322105821
chr8	HMBOX1	28924639	28924755	0	117	1248	6053	1248	5936	0.0	0.21024258760107817
chr8	HMBOX1	29047357	29047453	7	97	1248	6053	1241	5956	0.07216494845360824	0.20836131631967764
chr8	HMBOX1	28891759	28891790	0	32	1248	6053	1248	6021	0.0	0.20727453911310414
chr8	HMBOX1	29042638	29042718	0	81	1248	6053	1248	5972	0.0	0.20897521768251842
chr8	HMBOX1	29049289	29049361	0	73	1248	6053	1248	5980	0.0	0.20869565217391303
chr8	LEPROTL1	30101897	30101973	0	77	6711	5423	6711	5346	0.0	1.255331088664422
chr8	LEPROTL1	30104733	30104991	29	259	6711	5423	6682	5164	0.11196911196911197	1.293958171959721
chr8	LEPROTL1	30132374	30132489	0	116	6711	5423	6711	5307	0.0	1.2645562464669304
chr8	DCTN6	30175084	30175190	0	107	102	1969	102	1862	0.0	0.05477980665950591
chr8	DCTN6	30177125	30177214	0	90	102	1969	102	1879	0.0	0.054284193720063864
chr8	DCTN6	30165715	30165901	0	187	102	1969	102	1782	0.0	0.05723905723905724
chr8	RBPMS	30561943	30562149	1377	207	105963	8416	104586	8209	6.6521739130434785	12.740406870507979
chr8	RBPMS	30549499	30549585	0	87	105963	8416	105963	8329	0.0	12.722175531276264
chr8	RBPMS	30537577	30537723	0	147	105963	8416	105963	8269	0.0	12.814487846172451
chr8	RBPMS	30545163	30545220	0	58	105963	8416	105963	8358	0.0	12.678033022254128
chr8	UBXN8	30754664	30754787	0	124	0	4037	0	3913	0.0	0.0
chr8	UBXN8	30754664	30754749	0	86	0	4037	0	3951	0.0	0.0
chr8	WRN	31083698	31083779	0	82	378	8258	378	8176	0.0	0.046232876712328765
chr8	WRN	31090464	31090532	0	69	378	8258	378	8189	0.0	0.046159482232262794
chr8	WRN	31064288	31064434	0	147	378	8258	378	8111	0.0	0.046603378128467515
chr8	NRG1	32749560	32749584	0	25	27390	19683	27390	19658	0.0	1.393325872418354
chr8	NRG1	32756402	32756529	0	128	27390	19683	27390	19555	0.0	1.400664791613398
chr8	NRG1	32614513	32614564	0	52	27390	19683	27390	19631	0.0	1.3952422189394325
chr8	NRG1	32616834	32616885	24926	52	27390	19683	2464	19631	479.34615384615387	0.12551576588049512
chr8	NRG1	32742674	32742733	0	60	27390	19683	27390	19623	0.0	1.3958110380675737
chr8	NRG1	32554943	32555057	0	115	27390	19683	27390	19568	0.0	1.3997342600163531
chr8	NRG1	32742007	32742075	0	69	27390	19683	27390	19614	0.0	1.3964515142245335
chr8	NRG1	32763217	32763359	0	143	27390	19683	27390	19540	0.0	1.401740020470829
chr8	NRG1	32727948	32728078	0	131	27390	19683	27390	19552	0.0	1.400879705400982
chr8	AC090204.1	33041634	33041771	0	138	0	1787	0	1649	0.0	0.0
chr8	AC090204.1	32996200	32996316	0	117	0	1787	0	1670	0.0	0.0
chr8	AC090204.1	33041634	33041743	0	110	0	1787	0	1677	0.0	0.0
chr8	AC090204.1	32996200	32996355	0	156	0	1787	0	1631	0.0	0.0
chr8	AC090204.1	32951027	32951119	0	93	0	1787	0	1694	0.0	0.0
chr8	MAK16	33490284	33490339	0	56	0	4321	0	4265	0.0	0.0
chr8	AF279873.3	34034885	34034924	0	40	0	2728	0	2688	0.0	0.0
chr8	UNC5D	35684581	35684749	0	169	51	10818	51	10649	0.0	0.004789182082824678
chr8	UNC5D	35705928	35705961	0	34	51	10818	51	10784	0.0	0.0047292284866468845
chr8	UNC5D	35721454	35721469	0	16	51	10818	51	10802	0.0	0.004721347898537308
chr8	AC124290.1	36146651	36146686	0	36	51	10323	51	10287	0.0	0.004957713619130942
chr8	AC124290.1	36186152	36186203	0	52	51	10323	51	10271	0.0	0.004965436666342128
chr8	KCNU1	36804026	36804088	0	63	51	3995	51	3932	0.0	0.012970498474059003
chr8	KCNU1	36922982	36923044	0	63	51	3995	51	3932	0.0	0.012970498474059003
chr8	AC124067.3	37562362	37562868	0	507	72	3546	72	3039	0.0	0.023692003948667325
chr8	AC124067.3	37564680	37564772	0	93	72	3546	72	3453	0.0	0.020851433536055605
chr8	AC124067.3	37561838	37561938	72	101	72	3546	0	3445	0.7128712871287128	0.0
chr8	ERLIN2	37737907	37738029	22	123	6958	8103	6936	7980	0.17886178861788618	0.869172932330827
chr8	ERLIN2	37741771	37741818	0	48	6958	8103	6958	8055	0.0	0.8638112973308504
chr8	ERLIN2	37740364	37740446	0	83	6958	8103	6958	8020	0.0	0.8675810473815462
chr8	ASH2L	38135667	38135766	228	100	136188	5501	135960	5401	2.28	25.173116089613035
chr8	ASH2L	38107020	38107166	264	147	136188	5501	135924	5354	1.7959183673469388	25.38737392603661
chr8	ASH2L	38106377	38106444	31	68	136188	5501	136157	5433	0.45588235294117646	25.06110804343825
chr8	BAG4	38192687	38192795	0	109	4348	4814	4348	4705	0.0	0.9241232731137088
chr8	DDHD2	38234393	38234584	0	192	284229	7507	284229	7315	0.0	38.85563909774436
chr8	DDHD2	38238088	38238209	0	122	284229	7507	284229	7385	0.0	38.48733920108328
chr8	DDHD2	38240274	38240364	54	91	284229	7507	284175	7416	0.5934065934065934	38.31917475728155
chr8	DDHD2	38234393	38234510	0	118	284229	7507	284229	7389	0.0	38.46650426309379
chr8	DDHD2	38234399	38234584	0	186	284229	7507	284229	7321	0.0	38.82379456358421
chr8	LETM2	38406945	38407038	0	94	0	5024	0	4930	0.0	0.0
chr8	LETM2	38394097	38394241	0	145	0	5024	0	4879	0.0	0.0
chr8	LETM2	38394182	38394241	0	60	0	5024	0	4964	0.0	0.0
chr8	TACC1	38825310	38825368	0	59	1380521	12557	1380521	12498	0.0	110.45935349655944
chr8	TACC1	38825307	38825368	0	62	1380521	12557	1380521	12495	0.0	110.4858743497399
chr8	TACC1	38742350	38742451	0	102	1380521	12557	1380521	12455	0.0	110.8407065435568
chr8	TACC1	38744894	38745493	0	600	1380521	12557	1380521	11957	0.0	115.45713807811325
chr8	TACC1	38823989	38824025	0	37	1380521	12557	1380521	12520	0.0	110.26525559105431
chr8	TACC1	38787556	38787743	88	188	1380521	12557	1380433	12369	0.46808510638297873	111.60425256690112
chr8	PLEKHA2	38917906	38918070	0	165	9292	5592	9292	5427	0.0	1.7121798415330753
chr8	PLEKHA2	38901797	38901892	578	96	9292	5592	8714	5496	6.020833333333333	1.5855167394468705
chr8	ADAM9	39011657	39011716	0	60	19580	17281	19580	17221	0.0	1.1369839149875152
chr8	ADAM9	39041945	39042117	0	173	19580	17281	19580	17108	0.0	1.1444938040682722
chr8	ADAM9	39076146	39076275	0	130	19580	17281	19580	17151	0.0	1.1416243950790042
chr8	ADAM9	39082967	39083073	0	107	19580	17281	19580	17174	0.0	1.1400954931873764
chr8	ADAM9	39090046	39090188	0	143	19580	17281	19580	17138	0.0	1.1424903722721438
chr8	ADAM9	39071297	39071403	807	107	19580	17281	18773	17174	7.542056074766355	1.0931058576918598
chr8	ADAM9	39082640	39082721	0	82	19580	17281	19580	17199	0.0	1.1384382812954241
chr8	ADAM9	39046001	39046058	0	58	19580	17281	19580	17223	0.0	1.1368518841084596
chr8	ADAM9	39091671	39091764	50	94	19580	17281	19530	17187	0.5319148936170213	1.1363239657880957
chr8	ADAM9	39046953	39047046	0	94	19580	17281	19580	17187	0.0	1.1392331413277477
chr8	ADAM9	39071297	39071413	816	117	19580	17281	18764	17164	6.9743589743589745	1.0932183640177116
chr8	ADAM32	39118085	39118165	0	81	186	10077	186	9996	0.0	0.018607442977190875
chr8	ADAM32	39160896	39160965	0	70	186	10077	186	10007	0.0	0.018586989107624664
chr8	ADAM32	39281135	39281174	0	40	186	10077	186	10037	0.0	0.01853143369532729
chr8	ADAM5	39319451	39319505	0	55	0	2870	0	2815	0.0	0.0
chr8	ADAM5	39325212	39325278	0	67	0	2870	0	2803	0.0	0.0
chr8	ADAM5	39345860	39346044	0	185	0	2870	0	2685	0.0	0.0
chr8	ADAM5	39392573	39392660	0	88	0	2870	0	2782	0.0	0.0
chr8	ADAM5	39315454	39315534	0	81	0	2870	0	2789	0.0	0.0
chr8	ADAM5	39344063	39344186	0	124	0	2870	0	2746	0.0	0.0
chr8	AC123767.1	39536513	39536680	0	168	33	2038	33	1870	0.0	0.01764705882352941
chr8	AC123767.1	39578413	39578471	0	59	33	2038	33	1979	0.0	0.01667508842849924
chr8	ADAM18	39605727	39605761	0	35	0	3849	0	3814	0.0	0.0
chr8	ADAM18	39610528	39610706	0	179	0	3849	0	3670	0.0	0.0
chr8	ADAM18	39637263	39637335	0	73	0	3849	0	3776	0.0	0.0
chr8	ADAM18	39648343	39648527	0	185	0	3849	0	3664	0.0	0.0
chr8	IDO1	39908988	39909030	0	43	0	3502	0	3459	0.0	0.0
chr8	IDO2	40005326	40005378	0	53	0	3899	0	3846	0.0	0.0
chr8	AC105999.1	40370755	40370920	0	166	0	1467	0	1301	0.0	0.0
chr8	GPAT4	41610598	41610621	0	24	22337	7612	22337	7588	0.0	2.9437269372693726
chr8	AP3M2	42154477	42154536	867	60	20939	4420	20072	4360	14.45	4.603669724770643
chr8	AP3M2	42162280	42162418	900	139	20939	4420	20039	4281	6.474820143884892	4.680915673907966
chr8	AP3M2	42167163	42167371	357	209	20939	4420	20582	4211	1.708133971291866	4.887675136547139
chr8	AP3M2	42154565	42154960	5476	396	20939	4420	15463	4024	13.828282828282829	3.8426938369781314
chr8	AP3M2	42155978	42156039	331	62	20939	4420	20608	4358	5.338709677419355	4.728774667278568
chr8	AP3M2	42154615	42154960	5395	346	20939	4420	15544	4074	15.592485549132949	3.8154148257241043
chr8	AP3M2	42168196	42168249	811	54	20939	4420	20128	4366	15.018518518518519	4.610169491525424
chr8	IKBKB	42272082	42272205	0	124	43858	8552	43858	8428	0.0	5.203844328429046
chr8	IKBKB	42288633	42288728	306	96	43858	8552	43552	8456	3.1875	5.15042573320719
chr8	IKBKB	42308900	42309025	204	126	43858	8552	43654	8426	1.619047619047619	5.180868739615476
chr8	IKBKB	42319584	42319646	583	63	43858	8552	43275	8489	9.253968253968255	5.097773589350925
chr8	IKBKB	42329123	42329214	393	92	43858	8552	43465	8460	4.271739130434782	5.137706855791962
chr8	POLB	42354416	42354521	1	106	10312	3749	10311	3643	0.009433962264150943	2.830359593741422
chr8	POLB	42339011	42339069	204	59	10312	3749	10108	3690	3.457627118644068	2.7392953929539297
chr8	POLB	42344952	42345019	6	68	10312	3749	10306	3681	0.08823529411764706	2.7997826677533277
chr8	POLB	42362611	42362698	0	88	10312	3749	10312	3661	0.0	2.816716744059
chr8	POLB	42361095	42361202	294	108	10312	3749	10018	3641	2.7222222222222223	2.7514419115627575
chr8	POLB	42370113	42370181	120	69	10312	3749	10192	3680	1.7391304347826086	2.7695652173913046
chr8	VDAC3	42393844	42393884	325	41	65721	2913	65396	2872	7.926829268292683	22.770194986072422
chr8	VDAC3	42399650	42399703	1141	54	65721	2913	64580	2859	21.12962962962963	22.588317593564184
chr8	VDAC3	42395083	42395133	542	51	65721	2913	65179	2862	10.627450980392156	22.77393431167016
chr8	VDAC3	42393810	42393884	325	75	65721	2913	65396	2838	4.333333333333333	23.042988019732206
chr8	VDAC3	42396677	42396680	0	4	65721	2913	65721	2909	0.0	22.59229975936748
chr8	VDAC3	42396655	42396680	0	26	65721	2913	65721	2887	0.0	22.764461378593698
chr8	SMIM19	42546468	42546606	0	139	103	3977	103	3838	0.0	0.026836894215737362
chr8	CHRNB3	42704348	42704481	0	134	10872	2605	10872	2471	0.0	4.399838122217726
chr8	HOOK3	42994433	42994492	584	60	69239	6313	68655	6253	9.733333333333333	10.979529825683672
chr8	HOOK3	43000270	43000276	42	7	69239	6313	69197	6306	6.0	10.973200126863304
chr8	FNTA	43072180	43072307	0	128	139504	8702	139504	8574	0.0	16.27058549101936
chr8	FNTA	43064100	43064215	0	116	139504	8702	139504	8586	0.0	16.247845329606335
chr8	FNTA	43059091	43059177	0	87	139504	8702	139504	8615	0.0	16.193151479976784
chr8	POMK	43097523	43097615	0	93	31920	8233	31920	8140	0.0	3.921375921375921
chr8	POMK	43102504	43102600	0	97	31920	8233	31920	8136	0.0	3.9233038348082596
chr8	POMK	43102221	43102451	0	231	31920	8233	31920	8002	0.0	3.9890027493126716
chr8	POMK	43117432	43117513	0	82	31920	8233	31920	8151	0.0	3.9160839160839163
chr8	POMK	43109563	43109849	0	287	31920	8233	31920	7946	0.0	4.017115529826328
chr8	POMK	43120230	43120498	0	269	31920	8233	31920	7964	0.0	4.008036162732295
chr8	HGSNAT	43158574	43158711	0	138	153	8341	153	8203	0.0	0.01865171278800439
chr8	HGSNAT	43167943	43168061	0	119	153	8341	153	8222	0.0	0.018608611043541716
chr8	HGSNAT	43182348	43182415	0	68	153	8341	153	8273	0.0	0.018493895805632782
chr8	HGSNAT	43196429	43196540	0	112	153	8341	153	8229	0.0	0.01859278162595698
chr8	POTEA	43301972	43302110	0	139	0	2282	0	2143	0.0	0.0
chr8	LINC00293	46842276	46842352	0	77	0	8452	0	8375	0.0	0.0
chr8	LINC00293	46846028	46846081	0	54	0	8452	0	8398	0.0	0.0
chr8	LINC00293	46849448	46849530	0	83	0	8452	0	8369	0.0	0.0
chr8	LINC00293	46836741	46836798	0	58	0	8452	0	8394	0.0	0.0
chr8	LINC00293	46843349	46843426	0	78	0	8452	0	8374	0.0	0.0
chr8	LINC00293	46849733	46850560	0	828	0	8452	0	7624	0.0	0.0
chr8	LINC00293	46836741	46836819	0	79	0	8452	0	8373	0.0	0.0
chr8	LINC00293	46848783	46848901	0	119	0	8452	0	8333	0.0	0.0
chr8	LINC00293	46848783	46848968	0	186	0	8452	0	8266	0.0	0.0
chr8	LINC00293	46842967	46843128	0	162	0	8452	0	8290	0.0	0.0
chr8	LINC00293	46844188	46844296	0	109	0	8452	0	8343	0.0	0.0
chr8	LINC00293	46848783	46849530	0	748	0	8452	0	7704	0.0	0.0
chr8	LINC00293	46849360	46849530	0	171	0	8452	0	8281	0.0	0.0
chr8	LINC00293	46847975	46848100	0	126	0	8452	0	8326	0.0	0.0
chr8	LINC00293	46846403	46846679	0	277	0	8452	0	8175	0.0	0.0
chr8	LINC00293	46853008	46853104	0	97	0	8452	0	8355	0.0	0.0
chr8	LINC00293	46842081	46842134	0	54	0	8452	0	8398	0.0	0.0
chr8	LINC00293	46849375	46849530	0	156	0	8452	0	8296	0.0	0.0
chr8	LINC00293	46842992	46843128	0	137	0	8452	0	8315	0.0	0.0
chr8	LINC00293	46853008	46853161	0	154	0	8452	0	8298	0.0	0.0
chr8	SPIDR	47279861	47280017	0	157	117	7208	117	7051	0.0	0.016593391008367608
chr8	SPIDR	47293866	47294030	0	165	117	7208	117	7043	0.0	0.016612239102655118
chr8	SPIDR	47396375	47396626	0	252	117	7208	117	6956	0.0	0.016820011500862566
chr8	SPIDR	47407860	47407961	0	102	117	7208	117	7106	0.0	0.016464959189417393
chr8	SPIDR	47598945	47599196	0	252	117	7208	117	6956	0.0	0.016820011500862566
chr8	SPIDR	47284027	47284094	0	68	117	7208	117	7140	0.0	0.01638655462184874
chr8	SPIDR	47728932	47729102	0	171	117	7208	117	7037	0.0	0.01662640329685946
chr8	SPIDR	47732128	47732193	0	66	117	7208	117	7142	0.0	0.01638196583590031
chr8	MCM4	47961130	47961214	0	85	0	6523	0	6438	0.0	0.0
chr8	MCM4	47966186	47966407	0	222	0	6523	0	6301	0.0	0.0
chr8	MCM4	47969278	47969401	0	124	0	6523	0	6399	0.0	0.0
chr8	MCM4	47961130	47961426	0	297	0	6523	0	6226	0.0	0.0
chr8	MCM4	47966186	47966275	0	90	0	6523	0	6433	0.0	0.0
chr8	MCM4	47971040	47971189	0	150	0	6523	0	6373	0.0	0.0
chr8	UBE2V2	48034865	48035061	0	197	21	6598	21	6401	0.0	0.0032807373847836274
chr8	UBE2V2	48043032	48043181	0	150	21	6598	21	6448	0.0	0.0032568238213399503
chr8	UBE2V2	48050259	48050508	4	250	21	6598	17	6348	0.016	0.0026780088216761186
chr8	UBE2V2	48043498	48043626	0	129	21	6598	21	6469	0.0	0.00324625135260473
chr8	AC022915.2	48695985	48696209	296	225	111132	2762	110836	2537	1.3155555555555556	43.687820260149785
chr8	AC044893.1	49228139	49228220	0	82	51	2165	51	2083	0.0	0.024483917426788286
chr8	AC044893.1	49214708	49214874	0	167	51	2165	51	1998	0.0	0.025525525525525526
chr8	AC044893.1	49193106	49193195	0	90	51	2165	51	2075	0.0	0.02457831325301205
chr8	SNTG1	50402209	50402344	0	136	17	9266	17	9130	0.0	0.0018619934282584885
chr8	SNTG1	50438542	50438599	0	58	17	9266	17	9208	0.0	0.0018462206776715898
chr8	SNTG1	50530176	50530259	0	84	17	9266	17	9182	0.0	0.0018514484861685907
chr8	SNTG1	50553049	50553179	0	131	17	9266	17	9135	0.0	0.0018609742747673782
chr8	SNTG1	50752000	50752111	0	112	17	9266	17	9154	0.0	0.001857111645182434
chr8	SNTG1	50172560	50172635	0	76	17	9266	17	9190	0.0	0.0018498367791077257
chr8	SNTG1	50568881	50569019	0	139	17	9266	17	9127	0.0	0.0018626054563383367
chr8	SNTG1	50402209	50402324	0	116	17	9266	17	9150	0.0	0.0018579234972677596
chr8	SNTG1	50575667	50575724	0	58	17	9266	17	9208	0.0	0.0018462206776715898
chr8	SNTG1	50747773	50747835	0	63	17	9266	17	9203	0.0	0.0018472237313919375
chr8	SNTG1	50011775	50011857	0	83	17	9266	17	9183	0.0	0.0018512468692148535
chr8	AC064807.1	51913056	51913180	0	125	102	4817	102	4692	0.0	0.021739130434782608
chr8	AC103831.1	52294817	52294921	0	105	510	3042	510	2937	0.0	0.17364657814096016
chr8	RGS20	53879257	53879602	0	346	408	3215	408	2869	0.0	0.14220982920878356
chr8	RGS20	53939575	53939724	0	150	408	3215	408	3065	0.0	0.133115823817292
chr8	RGS20	53946664	53946748	0	85	408	3215	408	3130	0.0	0.13035143769968052
chr8	TGS1	55782747	55782812	0	66	0	4575	0	4509	0.0	0.0
chr8	CHCHD7	56212761	56212909	0	149	187	3872	187	3723	0.0	0.0502283105022831
chr8	CHCHD7	56216679	56216754	34	76	187	3872	153	3796	0.4473684210526316	0.04030558482613277
chr8	CHCHD7	56212761	56212889	0	129	187	3872	187	3743	0.0	0.049959925193694896
chr8	AC012349.1	56526980	56527134	51	155	102	7735	51	7580	0.32903225806451614	0.006728232189973615
chr8	AC012349.1	56493000	56493098	0	99	102	7735	102	7636	0.0	0.013357778941854375
chr8	AC012349.1	56524623	56524749	0	127	102	7735	102	7608	0.0	0.013406940063091483
chr8	LINC01606	57154692	57155645	0	954	2	8839	2	7885	0.0	0.0002536461636017755
chr8	LINC01606	57226490	57226625	2	136	2	8839	0	8703	0.014705882352941176	0.0
chr8	LINC01606	57149100	57149199	0	100	2	8839	2	8739	0.0	0.00022885913720105275
chr8	LINC01606	57226490	57226607	0	118	2	8839	2	8721	0.0	0.00022933149868134388
chr8	LINC01606	57219055	57219138	0	84	2	8839	2	8755	0.0	0.0002284408909194746
chr8	AC068075.1	57344930	57345140	0	211	0	3224	0	3013	0.0	0.0
chr8	AC068075.1	57346693	57347063	0	371	0	3224	0	2853	0.0	0.0
chr8	AC068075.1	57348368	57348586	0	219	0	3224	0	3005	0.0	0.0
chr8	AC068075.1	57351042	57351158	0	117	0	3224	0	3107	0.0	0.0
chr8	AC068075.1	57344963	57345140	0	178	0	3224	0	3046	0.0	0.0
chr8	AC068075.1	57348415	57348586	0	172	0	3224	0	3052	0.0	0.0
chr8	FAM110B	58043183	58043299	0	117	17765	4933	17765	4816	0.0	3.68874584717608
chr8	FAM110B	58189317	58189416	0	100	17765	4933	17765	4833	0.0	3.675770742809849
chr8	UBXN2B	58430518	58430669	0	152	0	5305	0	5153	0.0	0.0
chr8	UBXN2B	58434857	58434948	0	92	0	5305	0	5213	0.0	0.0
chr8	SDCBP	58565018	58565084	0	67	51	4744	51	4677	0.0	0.010904425914047467
chr8	SDCBP	58575902	58576061	51	160	51	4744	0	4584	0.31875	0.0
chr8	SDCBP	58565021	58565084	0	64	51	4744	51	4680	0.0	0.010897435897435897
chr8	SDCBP	58575899	58576061	51	163	51	4744	0	4581	0.3128834355828221	0.0
chr8	SDCBP	58565018	58565066	0	49	51	4744	51	4695	0.0	0.010862619808306708
chr8	SDCBP	58560283	58561795	0	1513	51	4744	51	3231	0.0	0.015784586815227482
chr8	AC087664.2	59612818	59612889	0	72	0	1743	0	1671	0.0	0.0
chr8	AC087664.2	59619603	59619738	0	136	0	1743	0	1607	0.0	0.0
chr8	AC087664.2	59619603	59619829	0	227	0	1743	0	1516	0.0	0.0
chr8	AC087664.2	59613261	59613607	0	347	0	1743	0	1396	0.0	0.0
chr8	AC087664.2	59613380	59613607	0	228	0	1743	0	1515	0.0	0.0
chr8	AC021393.1	60058250	60058528	0	279	0	3900	0	3621	0.0	0.0
chr8	AC021393.1	60059604	60059705	0	102	0	3900	0	3798	0.0	0.0
chr8	RAB2A	60591857	60591969	0	113	51	5435	51	5322	0.0	0.009582863585118376
chr8	RAB2A	60558851	60558923	0	73	51	5435	51	5362	0.0	0.009511376352107423
chr8	RAB2A	60576233	60576297	0	65	51	5435	51	5370	0.0	0.009497206703910615
chr8	RAB2A	60569954	60570057	0	104	51	5435	51	5331	0.0	0.009566685424873381
chr8	CLVS1	61292317	61292454	0	138	4641	7405	4641	7267	0.0	0.6386404293381037
chr8	CLVS1	61299676	61300282	0	607	4641	7405	4641	6798	0.0	0.6827007943512798
chr8	CLVS1	61299676	61300278	0	603	4641	7405	4641	6802	0.0	0.6822993237283153
chr8	CLVS1	61391127	61391229	0	103	4641	7405	4641	7302	0.0	0.6355792933442892
chr8	LINC02842	61827818	61827977	0	160	39	3164	39	3004	0.0	0.012982689747003996
chr8	NKAIN3	62589713	62589794	0	82	153	28741	153	28659	0.0	0.005338637077357898
chr8	NKAIN3	62750339	62750849	0	511	153	28741	153	28230	0.0	0.005419766206163656
chr8	NKAIN3	62918452	62918513	0	62	153	28741	153	28679	0.0	0.005334914048606995
chr8	NKAIN3	62953901	62953972	0	72	153	28741	153	28669	0.0	0.005336774913669818
chr8	NKAIN3	62990167	62991069	0	903	153	28741	153	27838	0.0	0.00549608448882822
chr8	YTHDF3	63173650	63173681	0	32	321	6172	321	6140	0.0	0.05228013029315961
chr8	YTHDF3	63186146	63187745	15	1600	321	6172	306	4572	0.009375	0.06692913385826772
chr8	YTHDF3	63175330	63175416	0	87	321	6172	321	6085	0.0	0.052752670501232536
chr8	YTHDF3	63175336	63175416	0	81	321	6172	321	6091	0.0	0.05270070595961254
chr8	YTHDF3	63172652	63172798	0	147	321	6172	321	6025	0.0	0.05327800829875519
chr8	LINC01289	63778448	63780922	153	2475	44022	4462	43869	1987	0.06181818181818182	22.078007045797683
chr8	MIR124-2HG	64380020	64380187	0	168	0	3786	0	3618	0.0	0.0
chr8	MTFR1	65689565	65689599	0	35	0	4610	0	4575	0.0	0.0
chr8	MTFR1	65682352	65682451	0	100	0	4610	0	4510	0.0	0.0
chr8	MTFR1	65719379	65719481	0	103	0	4610	0	4507	0.0	0.0
chr8	DNAJC5B	66051530	66051666	0	137	0	3670	0	3533	0.0	0.0
chr8	TRIM55	66155622	66155710	0	89	0	3090	0	3001	0.0	0.0
chr8	TRIM55	66154046	66154334	0	289	0	3090	0	2801	0.0	0.0
chr8	ADHFE1	66444366	66444420	0	55	3	3221	3	3166	0.0	0.0009475679090334807
chr8	ADHFE1	66445217	66445414	3	198	3	3221	0	3023	0.015151515151515152	0.0
chr8	ADHFE1	66453709	66453840	0	132	3	3221	3	3089	0.0	0.0009711880867594691
chr8	AC009879.3	66474792	66474952	0	161	336381	5020	336381	4859	0.0	69.22844206626878
chr8	VXN	66510095	66510157	2837	63	350168	4772	347331	4709	45.03174603174603	73.75897218093013
chr8	VXN	66513539	66513637	863	99	350168	4772	349305	4673	8.717171717171718	74.74962550823882
chr8	ADHFE1	66439235	66439305	0	71	3	3221	3	3150	0.0	0.0009523809523809524
chr8	ADHFE1	66442797	66442844	0	48	3	3221	3	3173	0.0	0.0009454774661203908
chr8	ADHFE1	66440161	66440199	0	39	3	3221	3	3182	0.0	0.0009428032683846638
chr8	ADHFE1	66447263	66447341	0	79	3	3221	3	3142	0.0	0.0009548058561425843
chr8	VXN	66498824	66498918	0	95	350168	4772	350168	4677	0.0	74.87021595039555
chr8	C8ORF44-SGK3	66690704	66690760	451	57	1360	2989	909	2932	7.912280701754386	0.31002728512960437
chr8	SGK3	66813852	66813928	0	77	47	5510	47	5433	0.0	0.008650837474691699
chr8	SGK3	66843451	66843547	0	97	47	5510	47	5413	0.0	0.008682800665065583
chr8	C8ORF44	66677641	66677954	0	314	1477	2145	1477	1831	0.0	0.8066630256690334
chr8	C8ORF44	66676744	66676902	0	159	1477	2145	1477	1986	0.0	0.743705941591138
chr8	C8ORF44	66680392	66680458	7	67	1477	2145	1470	2078	0.1044776119402985	0.7074109720885466
chr8	SGK3	66793615	66793832	0	218	47	5510	47	5292	0.0	0.008881330309901738
chr8	SGK3	66777956	66778089	0	134	47	5510	47	5376	0.0	0.008742559523809524
chr8	MCMDC2	66877348	66877544	0	197	51	6364	51	6167	0.0	0.008269823252797147
chr8	CSPP1	67076481	67076581	0	101	204	22998	204	22897	0.0	0.008909464121937372
chr8	CSPP1	67091802	67091883	0	82	204	22998	204	22916	0.0	0.008902077151335312
chr8	CSPP1	67103036	67103135	0	100	204	22998	204	22898	0.0	0.008909075028386759
chr8	CSPP1	67137455	67137603	0	149	204	22998	204	22849	0.0	0.00892818066436168
chr8	CSPP1	67149782	67149935	0	154	204	22998	204	22844	0.0	0.008930134827525827
chr8	CSPP1	67193463	67193602	0	140	204	22998	204	22858	0.0	0.008924665325050311
chr8	CSPP1	67093542	67093641	0	100	204	22998	204	22898	0.0	0.008909075028386759
chr8	CSPP1	67154023	67154136	0	114	204	22998	204	22884	0.0	0.008914525432616675
chr8	CSPP1	67079350	67079462	0	113	204	22998	204	22885	0.0	0.008914135896875683
chr8	CSPP1	67114328	67114370	0	43	204	22998	204	22955	0.0	0.008886952733609236
chr8	CSPP1	67076487	67076581	0	95	204	22998	204	22903	0.0	0.008907130070296468
chr8	CSPP1	67078366	67078487	0	122	204	22998	204	22876	0.0	0.008917642944570729
chr8	CSPP1	67069679	67069802	0	124	204	22998	204	22874	0.0	0.008918422663285826
chr8	CSPP1	67086822	67086846	0	25	204	22998	204	22973	0.0	0.008879989552953467
chr8	CSPP1	67074242	67074351	0	110	204	22998	204	22888	0.0	0.008912967493883258
chr8	CSPP1	67074805	67074923	0	119	204	22998	204	22879	0.0	0.008916473622098868
chr8	CSPP1	67123087	67123159	0	73	204	22998	204	22925	0.0	0.008898582333696838
chr8	CSPP1	67105568	67105661	0	94	204	22998	204	22904	0.0	0.00890674118057981
chr8	CSPP1	67152612	67152712	0	101	204	22998	204	22897	0.0	0.008909464121937372
chr8	CSPP1	67093547	67093641	0	95	204	22998	204	22903	0.0	0.008907130070296468
chr8	CSPP1	67115196	67115264	0	69	204	22998	204	22929	0.0	0.008897029962056784
chr8	CSPP1	67120878	67121130	0	253	204	22998	204	22745	0.0	0.008969004176742141
chr8	CSPP1	67134023	67134165	0	143	204	22998	204	22855	0.0	0.008925836797199738
chr8	CSPP1	67172768	67172973	0	206	204	22998	204	22792	0.0	0.00895050895050895
chr8	CSPP1	67172777	67172973	0	197	204	22998	204	22801	0.0	0.00894697600982413
chr8	CSPP1	67192097	67192217	0	121	204	22998	204	22877	0.0	0.008917253136337807
chr8	CSPP1	67192688	67192803	0	116	204	22998	204	22882	0.0	0.008915304606240713
chr8	CSPP1	67189839	67190014	0	176	204	22998	204	22822	0.0	0.008938743317851196
chr8	CSPP1	67162637	67162762	0	126	204	22998	204	22872	0.0	0.008919202518363064
chr8	CSPP1	67194626	67194718	0	93	204	22998	204	22905	0.0	0.008906352324819908
chr8	C8ORF34	68468691	68468820	0	130	50	10285	50	10155	0.0	0.004923682914820286
chr8	C8ORF34	68640375	68640511	0	137	50	10285	50	10148	0.0	0.004927079227433977
chr8	C8ORF34	68776398	68776449	0	52	50	10285	50	10233	0.0	0.00488615264340858
chr8	C8ORF34	68530592	68530679	0	88	50	10285	50	10197	0.0	0.004903402961655388
chr8	SULF1	69495764	69495926	0	163	510	9293	510	9130	0.0	0.05585980284775466
chr8	SULF1	69638501	69638644	0	144	510	9293	510	9149	0.0	0.055743797136299046
chr8	SULF1	69640807	69640841	0	35	510	9293	510	9258	0.0	0.05508749189889825
chr8	XKR9	70683512	70683630	0	119	463	3941	463	3822	0.0	0.12114076399790685
chr8	XKR9	70678029	70678139	0	111	463	3941	463	3830	0.0	0.12088772845953002
chr8	AC009446.1	71695940	71696033	0	94	0	904	0	810	0.0	0.0
chr8	MSC-AS1	71844228	71844422	0	195	0	7084	0	6889	0.0	0.0
chr8	MSC-AS1	71965408	71965534	0	127	0	7084	0	6957	0.0	0.0
chr8	MSC-AS1	72025361	72025434	0	74	0	7084	0	7010	0.0	0.0
chr8	MSC-AS1	71973537	71973659	0	123	0	7084	0	6961	0.0	0.0
chr8	MSC-AS1	71954137	71954383	0	247	0	7084	0	6837	0.0	0.0
chr8	TERF1	73013894	73013990	0	97	2193	11467	2193	11370	0.0	0.19287598944591028
chr8	TERF1	73024821	73024971	0	151	2193	11467	2193	11316	0.0	0.19379639448568398
chr8	TERF1	73030335	73030395	0	61	2193	11467	2193	11406	0.0	0.19226722777485533
chr8	TERF1	73039544	73039619	0	76	2193	11467	2193	11391	0.0	0.1925204108506716
chr8	TERF1	73038705	73038795	0	91	2193	11467	2193	11376	0.0	0.19277426160337552
chr8	TERF1	73012855	73012931	0	77	2193	11467	2193	11390	0.0	0.1925373134328358
chr8	TERF1	73039115	73039219	0	105	2193	11467	2193	11362	0.0	0.19301179369829255
chr8	TERF1	73030794	73030955	17	162	2193	11467	2176	11305	0.10493827160493827	0.1924812030075188
chr8	AC111149.2	73359105	73359227	0	123	0	2366	0	2243	0.0	0.0
chr8	TMEM70	73979078	73979171	10028	94	79567	2988	69539	2894	106.68085106382979	24.0286800276434
chr8	LY96	74004795	74004885	114	91	155	564	41	473	1.2527472527472527	0.08668076109936575
chr8	GDAP1	74360136	74360310	50	175	31532	20769	31482	20594	0.2857142857142857	1.5286976789356124
chr8	GDAP1	74351273	74351466	0	194	31532	20769	31532	20575	0.0	1.532539489671932
chr8	GDAP1	74351273	74351321	0	49	31532	20769	31532	20720	0.0	1.521814671814672
chr8	GDAP1	74351273	74351418	0	146	31532	20769	31532	20623	0.0	1.5289725064248654
chr8	GDAP1	74363383	74363449	0	67	31532	20769	31532	20702	0.0	1.5231378610762245
chr8	GDAP1	74360140	74360310	50	171	31532	20769	31482	20598	0.29239766081871343	1.5284008156131663
chr8	GDAP1	74351453	74351466	0	14	31532	20769	31532	20755	0.0	1.5192483738858107
chr8	GDAP1	74361883	74361978	0	96	31532	20769	31532	20673	0.0	1.5252745126493494
chr8	GDAP1	74362263	74362351	24	89	31532	20769	31508	20680	0.2696629213483146	1.523597678916828
chr8	GDAP1	74360136	74360149	0	14	31532	20769	31532	20755	0.0	1.5192483738858107
chr8	GDAP1	74362938	74363053	0	116	31532	20769	31532	20653	0.0	1.5267515615164866
chr8	GDAP1	74363371	74363449	0	79	31532	20769	31532	20690	0.0	1.5240212663122281
chr8	GDAP1	74363984	74364163	0	180	31532	20769	31532	20589	0.0	1.5314974015250862
chr8	GDAP1	74351251	74351466	0	216	31532	20769	31532	20553	0.0	1.5341799250717656
chr8	CRISPLD1	75013986	75014102	0	117	0	4446	0	4329	0.0	0.0
chr8	HNF4G	75543810	75543979	0	170	0	4813	0	4643	0.0	0.0
chr8	ZFHX4	76842654	76842771	0	118	60	15869	60	15751	0.0	0.0038092819503523587
chr8	ZFHX4	76703597	76703618	0	22	60	15869	60	15847	0.0	0.003786205590963589
chr8	ZFHX4	76834120	76834434	0	315	60	15869	60	15554	0.0	0.0038575286100038576
chr8	ZFHX4	76782142	76782218	0	77	60	15869	60	15792	0.0	0.003799392097264438
chr8	PKIA	78572810	78572939	0	130	51	4020	51	3890	0.0	0.013110539845758355
chr8	ZC2HC1A	78675786	78675863	0	78	0	4148	0	4070	0.0	0.0
chr8	ZC2HC1A	78711989	78712106	0	118	0	4148	0	4030	0.0	0.0
chr8	AC138646.1	79307229	79307281	0	53	0	2051	0	1998	0.0	0.0
chr8	AC138646.1	79307226	79307281	0	56	0	2051	0	1995	0.0	0.0
chr8	STMN2	79663579	79663661	0	83	571	2049	571	1966	0.0	0.2904374364191251
chr8	AC036214.4	79926333	79926448	0	116	51	2698	51	2582	0.0	0.019752130131680867
chr8	AC034114.2	80285682	80285804	0	123	217007	4283	217007	4160	0.0	52.16514423076923
chr8	AC034114.2	80327144	80327207	0	64	217007	4283	217007	4219	0.0	51.43564825788101
chr8	AC034114.2	80448696	80448980	0	285	217007	4283	217007	3998	0.0	54.27888944472236
chr8	AC034114.2	80274104	80274243	0	140	217007	4283	217007	4143	0.0	52.37919382090273
chr8	AC034114.2	80334799	80335052	0	254	217007	4283	217007	4029	0.0	53.86125589476297
chr8	AC034114.2	80285686	80285804	0	119	217007	4283	217007	4164	0.0	52.115033621517775
chr8	AC034114.2	80303423	80303526	0	104	217007	4283	217007	4179	0.0	51.92797319932998
chr8	AC079209.1	81157613	81157803	0	191	28	2771	28	2580	0.0	0.010852713178294573
chr8	AC079209.1	81162624	81162666	0	43	28	2771	28	2728	0.0	0.010263929618768328
chr8	AC079209.1	81162592	81162666	0	75	28	2771	28	2696	0.0	0.010385756676557863
chr8	LINC02235	81848990	81849107	0	118	6561	4148	6561	4030	0.0	1.6280397022332507
chr8	LINC02235	81874266	81874376	0	111	6561	4148	6561	4037	0.0	1.6252167451077533
chr8	AC060765.2	82435224	82435430	0	207	31	4917	31	4710	0.0	0.0065817409766454355
chr8	RALYL	84346118	84346150	0	33	153	4551	153	4518	0.0	0.03386454183266932
chr8	RALYL	84804769	84804802	0	34	153	4551	153	4517	0.0	0.0338720389639141
chr8	RALYL	84849979	84850027	0	49	153	4551	153	4502	0.0	0.03398489560195469
chr8	RALYL	84887603	84887776	0	174	153	4551	153	4377	0.0	0.03495544893762851
chr8	LRRCC1	85123412	85123606	0	195	0	5020	0	4825	0.0	0.0
chr8	LRRCC1	85129174	85129379	0	206	0	5020	0	4814	0.0	0.0
chr8	LRRCC1	85109594	85109800	0	207	0	5020	0	4813	0.0	0.0
chr8	CA13	85237718	85237870	0	153	0	5610	0	5457	0.0	0.0
chr8	CA13	85224954	85225295	0	342	0	5610	0	5268	0.0	0.0
chr8	CA2	85473692	85473811	0	120	231	2015	231	1895	0.0	0.12189973614775726
chr8	CA2	85473388	85473468	0	81	231	2015	231	1934	0.0	0.11944157187176836
chr8	WWP1	86402018	86402203	0	186	0	6466	0	6280	0.0	0.0
chr8	WWP1	86440625	86440733	0	109	0	6466	0	6357	0.0	0.0
chr8	CPNE3	86515461	86515499	0	39	50	6676	50	6637	0.0	0.007533524182612626
chr8	CPNE3	86537562	86537646	0	85	50	6676	50	6591	0.0	0.007586102260658474
chr8	CPNE3	86524876	86524997	0	122	50	6676	50	6554	0.0	0.007628928898382667
chr8	CPNE3	86524708	86524814	0	107	50	6676	50	6569	0.0	0.007611508601004719
chr8	CPNE3	86521603	86521714	0	112	50	6676	50	6564	0.0	0.007617306520414382
chr8	AC090578.1	88693626	88693665	0	40	561	9713	561	9673	0.0	0.05799648506151142
chr8	AC090578.1	88799848	88799879	0	32	561	9713	561	9681	0.0	0.05794855903315773
chr8	RIPK2	89762828	89762982	0	155	0	3072	0	2917	0.0	0.0
chr8	RIPK2	89759321	89759446	0	126	0	3072	0	2946	0.0	0.0
chr8	DECR1	90017202	90017326	0	125	0	4418	0	4293	0.0	0.0
chr8	DECR1	90036840	90036940	0	101	0	4418	0	4317	0.0	0.0
chr8	DECR1	90017301	90017326	0	26	0	4418	0	4392	0.0	0.0
chr8	DECR1	90005291	90005369	0	79	0	4418	0	4339	0.0	0.0
chr8	DECR1	90017123	90017326	0	204	0	4418	0	4214	0.0	0.0
chr8	DECR1	90015540	90015666	0	127	0	4418	0	4291	0.0	0.0
chr8	DECR1	90005447	90005731	0	285	0	4418	0	4133	0.0	0.0
chr8	LINC00534	90454408	90454523	0	116	1774	14863	1774	14747	0.0	0.12029565335322438
chr8	LINC00534	90566488	90566549	0	62	1774	14863	1774	14801	0.0	0.11985676643470036
chr8	LINC00534	90351540	90351666	0	127	1774	14863	1774	14736	0.0	0.12038545059717698
chr8	LINC00534	90236024	90236219	51	196	1774	14863	1723	14667	0.2602040816326531	0.11747460284993523
chr8	LINC00534	90387566	90387684	0	119	1774	14863	1774	14744	0.0	0.12032013022246338
chr8	OTUD6B	91076591	91076731	0	141	0	3985	0	3844	0.0	0.0
chr8	LRRC69	91206692	91206831	0	140	339	3030	339	2890	0.0	0.11730103806228373
chr8	SLC26A7	91338149	91338232	0	84	51	6281	51	6197	0.0	0.008229788607390673
chr8	AC104211.1	92678808	92679110	0	303	0	2798	0	2495	0.0	0.0
chr8	AC104211.1	92677588	92677775	0	188	0	2798	0	2610	0.0	0.0
chr8	AC104211.1	92677627	92677775	0	149	0	2798	0	2649	0.0	0.0
chr8	AC117834.1	92886893	92886943	0	51	0	955	0	904	0.0	0.0
chr8	AC117834.1	92926289	92926370	0	82	0	955	0	873	0.0	0.0
chr8	CIBAR1	93718674	93718788	0	115	0	6800	0	6685	0.0	0.0
chr8	CIBAR1	93727130	93727244	0	115	0	6800	0	6685	0.0	0.0
chr8	CIBAR1	93702519	93702543	0	25	0	6800	0	6775	0.0	0.0
chr8	CIBAR1	93702164	93702383	0	220	0	6800	0	6580	0.0	0.0
chr8	CIBAR1	93724509	93724595	0	87	0	6800	0	6713	0.0	0.0
chr8	TMEM67	93755777	93755866	0	90	0	7387	0	7297	0.0	0.0
chr8	TMEM67	93765405	93765475	0	71	0	7387	0	7316	0.0	0.0
chr8	TMEM67	93755777	93755908	0	132	0	7387	0	7255	0.0	0.0
chr8	TMEM67	93761984	93762023	0	40	0	7387	0	7347	0.0	0.0
chr8	TMEM67	93759859	93759993	0	135	0	7387	0	7252	0.0	0.0
chr8	TMEM67	93762949	93763065	0	117	0	7387	0	7270	0.0	0.0
chr8	TMEM67	93791881	93792004	0	124	0	7387	0	7263	0.0	0.0
chr8	PDP1	93917910	93917945	0	36	757	5612	757	5576	0.0	0.1357604017216643
chr8	ESRP1	94692676	94692827	612	152	672	4621	60	4469	4.026315789473684	0.013425822331617812
chr8	ESRP1	94696851	94696961	0	111	672	4621	672	4510	0.0	0.14900221729490024
chr8	DPY19L4	94738368	94738459	136	92	75609	7156	75473	7064	1.4782608695652173	10.684173272933183
chr8	DPY19L4	94734629	94734754	20	126	75609	7156	75589	7030	0.15873015873015872	10.752347083926031
chr8	DPY19L4	94765182	94765314	0	133	75609	7156	75609	7023	0.0	10.765912003417343
chr8	DPY19L4	94781083	94781166	0	84	75609	7156	75609	7072	0.0	10.691317873303168
chr8	INTS8	94827262	94827403	629	142	7002	7694	6373	7552	4.429577464788732	0.8438824152542372
chr8	INTS8	94824892	94825067	0	176	7002	7694	7002	7518	0.0	0.931364724660814
chr8	INTS8	94874551	94874602	0	52	7002	7694	7002	7642	0.0	0.9162522899764459
chr8	INTS8	94866311	94866353	0	43	7002	7694	7002	7651	0.0	0.915174486995164
chr8	INTS8	94868691	94868813	0	123	7002	7694	7002	7571	0.0	0.9248448025359925
chr8	INTS8	94866311	94866351	0	41	7002	7694	7002	7653	0.0	0.9149353194825559
chr8	NDUFAF6	94980854	94980973	0	120	2914	6433	2914	6313	0.0	0.4615872010137811
chr8	NDUFAF6	94945482	94945619	0	138	2914	6433	2914	6295	0.0	0.46290706910246227
chr8	NDUFAF6	95023169	95023319	350	151	2914	6433	2564	6282	2.3178807947019866	0.40815027061445397
chr8	NDUFAF6	95034007	95034122	0	116	2914	6433	2914	6317	0.0	0.46129491847395915
chr8	NDUFAF6	94980858	94980973	0	116	2914	6433	2914	6317	0.0	0.46129491847395915
chr8	NDUFAF6	95031994	95032094	0	101	2914	6433	2914	6332	0.0	0.4602021478205938
chr8	NDUFAF6	95040705	95040927	917	223	2914	6433	1997	6210	4.112107623318385	0.3215780998389694
chr8	NDUFAF6	95031994	95032098	0	105	2914	6433	2914	6328	0.0	0.4604930467762326
chr8	NDUFAF6	95036301	95036494	0	194	2914	6433	2914	6239	0.0	0.46706202917134154
chr8	NDUFAF6	95036370	95036494	0	125	2914	6433	2914	6308	0.0	0.4619530754597337
chr8	NDUFAF6	95044476	95044595	0	120	2914	6433	2914	6313	0.0	0.4615872010137811
chr8	NDUFAF6	95052173	95052230	0	58	2914	6433	2914	6375	0.0	0.45709803921568626
chr8	C8ORF37-AS1	95486409	95486494	0	86	94278	4839	94278	4753	0.0	19.8354723332632
chr8	C8ORF37-AS1	95301121	95301192	0	72	94278	4839	94278	4767	0.0	19.77721837633732
chr8	CPQ	96680442	96680547	0	106	0	3459	0	3353	0.0	0.0
chr8	CPQ	96659283	96659323	0	41	0	3459	0	3418	0.0	0.0
chr8	MTDH	97689037	97689103	0	67	102	7888	102	7821	0.0	0.01304181051016494
chr8	MTDH	97699753	97699852	0	100	102	7888	102	7788	0.0	0.013097072419106317
chr8	MTDH	97719048	97719189	0	142	102	7888	102	7746	0.0	0.013168086754453912
chr8	MTDH	97706625	97706750	0	126	102	7888	102	7762	0.0	0.013140943055913424
chr8	MATN2	97941776	97941899	0	124	1847	6549	1847	6425	0.0	0.28747081712062256
chr8	MATN2	97961407	97961530	0	124	1847	6549	1847	6425	0.0	0.28747081712062256
chr8	MATN2	97994479	97994602	0	124	1847	6549	1847	6425	0.0	0.28747081712062256
chr8	MATN2	98021204	98021327	0	124	1847	6549	1847	6425	0.0	0.28747081712062256
chr8	MATN2	98027415	98027829	0	415	1847	6549	1847	6134	0.0	0.3011085751548745
chr8	ERICH5	98089075	98090029	0	955	0	1553	0	598	0.0	0.0
chr8	OSR2	98948172	98948421	0	250	105	2479	105	2229	0.0	0.047106325706594884
chr8	VPS13B	99507136	99507203	0	68	92053	16783	92053	16715	0.0	5.507209093628477
chr8	VPS13B	99507769	99507911	0	143	92053	16783	92053	16640	0.0	5.53203125
chr8	VPS13B	99556449	99556653	0	205	92053	16783	92053	16578	0.0	5.5527204729159125
chr8	VPS13B	99776774	99776956	0	183	92053	16783	92053	16600	0.0	5.545361445783133
chr8	FLJ42969	101054497	101054579	0	83	0	3136	0	3053	0.0	0.0
chr8	FLJ42969	101072334	101072435	0	102	0	3136	0	3034	0.0	0.0
chr8	FLJ42969	101064909	101065134	0	226	0	3136	0	2910	0.0	0.0
chr8	FLJ42969	101071293	101071481	0	189	0	3136	0	2947	0.0	0.0
chr8	GRHL2	101649413	101649499	0	87	1020	6069	1020	5982	0.0	0.17051153460381144
chr8	MAILR	102995624	102995682	0	59	282	7456	282	7397	0.0	0.038123563606867646
chr8	MAILR	102864910	102864994	0	85	282	7456	282	7371	0.0	0.03825803825803826
chr8	MAILR	102992249	102992407	0	159	282	7456	282	7297	0.0	0.038646018911881595
chr8	ATP6V1C1	103040797	103040968	0	172	0	5864	0	5692	0.0	0.0
chr8	BAALC	103212918	103213085	0	168	4174	4005	4174	3837	0.0	1.087829033098775
chr8	BAALC	103200657	103200762	0	106	4174	4005	4174	3899	0.0	1.070530905360349
chr8	FZD6	103328267	103328416	0	150	5953	4072	5953	3922	0.0	1.5178480367159612
chr8	FZD6	103307750	103307880	114	131	5953	4072	5839	3941	0.8702290076335878	1.4816036538949504
chr8	DCAF13	103420974	103421082	28	109	6110	7371	6082	7262	0.25688073394495414	0.8375103277334067
chr8	DCAF13	103420263	103420463	693	201	6110	7371	5417	7170	3.4477611940298507	0.7555090655509066
chr8	RIMS2	103998184	103998250	0	67	4228	14005	4228	13938	0.0	0.3033433778160425
chr8	RIMS2	104013441	104013621	0	181	4228	14005	4228	13824	0.0	0.3058449074074074
chr8	RIMS2	103809279	103809321	0	43	4228	14005	4228	13962	0.0	0.30282194528004586
chr8	RIMS2	103927841	103927889	401	49	4228	14005	3827	13956	8.183673469387756	0.2742189739180281
chr8	RIMS2	103716308	103716320	0	13	4228	14005	4228	13992	0.0	0.3021726700971984
chr8	RIMS2	104094477	104094729	0	253	4228	14005	4228	13752	0.0	0.30744618964514253
chr8	DCSTAMP	104354876	104355185	0	310	3365	2784	3365	2474	0.0	1.3601455133387228
chr8	OXR1	106739457	106739583	0	127	0	6705	0	6578	0.0	0.0
chr8	OXR1	106737519	106737600	0	82	0	6705	0	6623	0.0	0.0
chr8	EMC2	108446161	108446301	0	141	102	6073	102	5932	0.0	0.017194875252865813
chr8	ENY2	109336127	109336204	0	78	0	6789	0	6711	0.0	0.0
chr8	ENY2	109342689	109342809	0	121	0	6789	0	6668	0.0	0.0
chr8	EBAG9	109550809	109550907	0	99	0	3692	0	3593	0.0	0.0
chr8	EBAG9	109557730	109557919	0	190	0	3692	0	3502	0.0	0.0
chr8	LINC02237	111756305	111756400	0	96	0	3366	0	3270	0.0	0.0
chr8	LINC02237	111754396	111754545	0	150	0	3366	0	3216	0.0	0.0
chr8	AC024996.1	112452007	112452095	0	89	0	1458	0	1369	0.0	0.0
chr8	UTP23	116786502	116786649	0	148	255	5250	255	5102	0.0	0.04998039984319875
chr8	UTP23	116770191	116770366	0	176	255	5250	255	5074	0.0	0.05025620811982657
chr8	UTP23	116779482	116779586	0	105	255	5250	255	5145	0.0	0.04956268221574344
chr8	SLC30A8	117146818	117146848	0	31	51	6294	51	6263	0.0	0.008143062430145297
chr8	MED30	117530722	117530827	0	106	0	1444	0	1338	0.0	0.0
chr8	AC023590.1	118284513	118284586	0	74	0	2885	0	2811	0.0	0.0
chr8	SAMD12-AS1	118673421	118673549	0	129	2366	3793	2366	3664	0.0	0.6457423580786026
chr8	SAMD12-AS1	118744226	118744331	4	106	2366	3793	2362	3687	0.03773584905660377	0.640629237862761
chr8	COL14A1	120213934	120214061	0	128	101	10245	101	10117	0.0	0.009983196599782545
chr8	HAS2-AS1	121643372	121643517	0	146	0	5667	0	5521	0.0	0.0
chr8	HAS2-AS1	121879629	121879765	0	137	0	5667	0	5530	0.0	0.0
chr8	HAS2-AS1	121888824	121888977	0	154	0	5667	0	5513	0.0	0.0
chr8	HAS2-AS1	121903438	121903540	0	103	0	5667	0	5564	0.0	0.0
chr8	HAS2-AS1	121913758	121913893	0	136	0	5667	0	5531	0.0	0.0
chr8	HAS2-AS1	121891725	121891754	0	30	0	5667	0	5637	0.0	0.0
chr8	HAS2-AS1	121862925	121863009	0	85	0	5667	0	5582	0.0	0.0
chr8	HAS2-AS1	121884777	121884884	0	108	0	5667	0	5559	0.0	0.0
chr8	HAS2-AS1	121907643	121907710	0	68	0	5667	0	5599	0.0	0.0
chr8	AC016405.1	122810452	122810573	0	122	0	1025	0	903	0.0	0.0
chr8	TBC1D31	123082701	123082817	0	117	252	7097	252	6980	0.0	0.03610315186246418
chr8	TBC1D31	123120054	123120188	0	135	252	7097	252	6962	0.0	0.03619649525998277
chr8	TBC1D31	123134113	123134206	0	94	252	7097	252	7003	0.0	0.035984578037983724
chr8	TBC1D31	123142261	123142456	0	196	252	7097	252	6901	0.0	0.03651644689175482
chr8	TBC1D31	123128280	123128513	0	234	252	7097	252	6863	0.0	0.03671863616494245
chr8	FAM83A	123179763	123179871	0	109	0	5483	0	5374	0.0	0.0
chr8	FAM83A	123191802	123191970	0	169	0	5483	0	5314	0.0	0.0
chr8	FAM83A	123179653	123179871	0	219	0	5483	0	5264	0.0	0.0
chr8	NTAQ1	123436452	123436601	0	150	0	4939	0	4789	0.0	0.0
chr8	NTAQ1	123435441	123435542	0	102	0	4939	0	4837	0.0	0.0
chr8	NTAQ1	123448046	123448224	0	179	0	4939	0	4760	0.0	0.0
chr8	NTAQ1	123438133	123438238	0	106	0	4939	0	4833	0.0	0.0
chr8	FAM91A1	123786003	123786151	0	149	630	7289	630	7140	0.0	0.08823529411764706
chr8	FAM91A1	123812055	123812177	0	123	630	7289	630	7166	0.0	0.08791515489813005
chr8	AC090192.2	124275730	124275834	0	105	4121	2469	4121	2364	0.0	1.7432318104906936
chr8	NDUFB9	124549760	124550501	75	742	450568	14277	450493	13535	0.10107816711590296	33.28356113779091
chr8	NDUFB9	124549760	124549833	0	74	450568	14277	450568	14203	0.0	31.723438710131663
chr8	NDUFB9	124567646	124568914	663	1269	450568	14277	449905	13008	0.5224586288416075	34.58679274292743
chr8	LINC00964	124945637	124945746	0	110	1897	10517	1897	10407	0.0	0.18228115691361582
chr8	LINC00964	124946054	124946159	0	106	1897	10517	1897	10411	0.0	0.18221112285083085
chr8	LINC00964	124944486	124944797	0	312	1897	10517	1897	10205	0.0	0.1858892699657031
chr8	LINC00964	124947542	124947792	0	251	1897	10517	1897	10266	0.0	0.18478472628092732
chr8	LINC00964	124944486	124945051	0	566	1897	10517	1897	9951	0.0	0.19063410712491208
chr8	LINC00964	124945634	124945746	0	113	1897	10517	1897	10404	0.0	0.18233371780084584
chr8	LINC00964	124943269	124943501	0	233	1897	10517	1897	10284	0.0	0.18446129910540646
chr8	LINC00964	124943269	124943383	0	115	1897	10517	1897	10402	0.0	0.18236877523553163
chr8	LINC00964	124943269	124945051	0	1783	1897	10517	1897	8734	0.0	0.21719716052209756
chr8	LINC00964	124944566	124945051	0	486	1897	10517	1897	10031	0.0	0.18911374738311235
chr8	LINC00964	124945952	124946159	0	208	1897	10517	1897	10309	0.0	0.18401396837714618
chr8	LINC00964	124943269	124945746	0	2478	1897	10517	1897	8039	0.0	0.2359746237094166
chr8	LINC00964	124943188	124943269	0	82	1897	10517	1897	10435	0.0	0.1817920459990417
chr8	LINC00964	124944566	124944797	0	232	1897	10517	1897	10285	0.0	0.1844433641225085
chr8	LINC00964	124944486	124945281	0	796	1897	10517	1897	9721	0.0	0.1951445324555087
chr8	LINC00964	124944566	124945281	0	716	1897	10517	1897	9801	0.0	0.19355167840016324
chr8	NSMCE2	125102050	125102146	0	97	79	3005	79	2908	0.0	0.027166437414030263
chr8	NSMCE2	125102013	125102146	0	134	79	3005	79	2871	0.0	0.027516544757924068
chr8	NSMCE2	125094467	125094533	0	67	79	3005	79	2938	0.0	0.026889040163376447
chr8	NSMCE2	125130212	125130354	0	143	79	3005	79	2862	0.0	0.027603074772886094
chr8	NSMCE2	125155999	125156098	0	100	79	3005	79	2905	0.0	0.027194492254733218
chr8	AC084116.1	126499014	126499137	0	124	0	1516	0	1392	0.0	0.0
chr8	PCAT1	127013302	127013774	0	473	0	16754	0	16281	0.0	0.0
chr8	PCAT1	126848519	126848662	0	144	0	16754	0	16610	0.0	0.0
chr8	PCAT1	126878374	126878480	0	107	0	16754	0	16647	0.0	0.0
chr8	PCAT1	126926317	126926399	0	83	0	16754	0	16671	0.0	0.0
chr8	PCAT1	126938255	126938310	0	56	0	16754	0	16698	0.0	0.0
chr8	PVT1	127890588	127890998	0	411	55393	23370	55393	22959	0.0	2.4126921904264123
chr8	PVT1	127939507	127939676	0	170	55393	23370	55393	23200	0.0	2.3876293103448276
chr8	PVT1	128070159	128070272	0	114	55393	23370	55393	23256	0.0	2.38187994496044
chr8	PVT1	127795893	127796071	0	179	55393	23370	55393	23191	0.0	2.3885559053080936
chr8	PVT1	128010317	128010444	0	128	55393	23370	55393	23242	0.0	2.3833146889252217
chr8	PVT1	127855154	127855319	0	166	55393	23370	55393	23204	0.0	2.387217721082572
chr8	PVT1	127932052	127932198	0	147	55393	23370	55393	23223	0.0	2.3852646083623994
chr8	PVT1	127969415	127969537	0	123	55393	23370	55393	23247	0.0	2.382802081989074
chr8	PVT1	128070159	128070361	0	203	55393	23370	55393	23167	0.0	2.391030344887124
chr8	PVT1	127989161	127989291	0	131	55393	23370	55393	23239	0.0	2.383622358965532
chr8	PVT1	128070161	128070272	0	112	55393	23370	55393	23258	0.0	2.3816751225384816
chr8	PVT1	127795893	127796008	0	116	55393	23370	55393	23254	0.0	2.382084802614604
chr8	PVT1	127816827	127816884	0	58	55393	23370	55393	23312	0.0	2.376158201784489
chr8	PVT1	128091246	128091353	0	108	55393	23370	55393	23262	0.0	2.3812655833548275
chr8	PVT1	127994882	127995093	32	212	55393	23370	55361	23158	0.1509433962264151	2.390577770101045
chr8	PVT1	127902455	127902539	0	85	55393	23370	55393	23285	0.0	2.378913463603178
chr8	PVT1	128099369	128099573	13550	205	55393	23370	41843	23165	66.09756097560975	1.8063026116986833
chr8	PVT1	127983903	127984204	0	302	55393	23370	55393	23068	0.0	2.4012918328420323
chr8	PVT1	127851933	127852347	0	415	55393	23370	55393	22955	0.0	2.413112611631453
chr8	PVT1	128038916	128038980	0	65	55393	23370	55393	23305	0.0	2.376871915897876
chr8	PVT1	127932464	127932474	0	11	55393	23370	55393	23359	0.0	2.3713771993664112
chr8	PVT1	128082752	128082848	0	97	55393	23370	55393	23273	0.0	2.3801400764834786
chr8	PVT1	128009589	128009718	0	130	55393	23370	55393	23240	0.0	2.3835197934595524
chr8	PVT1	127881800	127881884	0	85	55393	23370	55393	23285	0.0	2.378913463603178
chr8	PVT1	127803149	127803559	0	411	55393	23370	55393	22959	0.0	2.4126921904264123
chr8	PVT1	128095691	128095817	0	127	55393	23370	55393	23243	0.0	2.3832121498945917
chr8	PVT1	127882061	127882185	0	125	55393	23370	55393	23245	0.0	2.38300709830071
chr8	PVT1	127855162	127855319	0	158	55393	23370	55393	23212	0.0	2.386394968119938
chr8	PVT1	127932027	127932198	0	172	55393	23370	55393	23198	0.0	2.3878351582032935
chr8	PVT1	128048447	128048609	0	163	55393	23370	55393	23207	0.0	2.3869091222475975
chr8	PVT1	127982359	127982479	0	121	55393	23370	55393	23249	0.0	2.3825971009505786
chr8	PVT1	128074072	128074291	0	220	55393	23370	55393	23150	0.0	2.3927861771058314
chr8	PVT1	128080302	128080430	0	129	55393	23370	55393	23241	0.0	2.3834172367798288
chr8	PVT1	128031958	128032272	0	315	55393	23370	55393	23055	0.0	2.402645846887877
chr8	PVT1	128074069	128074291	0	223	55393	23370	55393	23147	0.0	2.39309629757636
chr8	PVT1	128049584	128049748	0	165	55393	23370	55393	23205	0.0	2.3871148459383753
chr8	PVT1	128069068	128069147	0	80	55393	23370	55393	23290	0.0	2.378402747960498
chr8	PVT1	128049587	128049748	0	162	55393	23370	55393	23208	0.0	2.3868062736987246
chr8	PVT1	128084542	128084621	0	80	55393	23370	55393	23290	0.0	2.378402747960498
chr8	AC022973.3	129946387	129946602	0	216	0	2443	0	2227	0.0	0.0
chr8	PHF20L1	132816887	132817076	0	190	3624	12899	3624	12709	0.0	0.28515225430797075
chr8	PHF20L1	132799094	132799172	0	79	3624	12899	3624	12820	0.0	0.2826833073322933
chr8	PHF20L1	132799082	132799172	0	91	3624	12899	3624	12808	0.0	0.282948157401624
chr8	PHF20L1	132788803	132788999	2	197	3624	12899	3622	12702	0.01015228426395939	0.2851519445756574
chr8	PHF20L1	132807722	132807783	0	62	3624	12899	3624	12837	0.0	0.2823089506894134
chr8	PHF20L1	132825034	132825157	0	124	3624	12899	3624	12775	0.0	0.283679060665362
chr8	TG	132941350	132941542	510	193	7853	11185	7343	10992	2.6424870466321244	0.6680312954876274
chr8	TG	132966559	132966697	0	139	7853	11185	7853	11046	0.0	0.7109360854608003
chr8	TG	132983349	132983412	0	64	7853	11185	7853	11121	0.0	0.7061415340347091
chr8	TG	133131811	133131946	0	136	7853	11185	7853	11049	0.0	0.7107430536700153
chr8	TG	132994715	132994804	153	90	7853	11185	7700	11095	1.7	0.694006309148265
chr8	CCN4	133225389	133225583	0	195	0	5195	0	5000	0.0	0.0
chr8	CCN4	133220580	133220841	0	262	0	5195	0	4933	0.0	0.0
chr8	CCN4	133212863	133213143	0	281	0	5195	0	4914	0.0	0.0
chr8	LINC01591	135288095	135288112	0	18	0	1348	0	1330	0.0	0.0
chr8	LINC01591	135293757	135293870	0	114	0	1348	0	1234	0.0	0.0
chr8	LINC01591	135293793	135293870	0	78	0	1348	0	1270	0.0	0.0
chr8	KHDRBS3	135606954	135607037	0	84	153	8661	153	8577	0.0	0.017838405036726127
chr8	KHDRBS3	135645058	135645117	0	60	153	8661	153	8601	0.0	0.0177886292291594
chr8	LINC02055	136089035	136089206	0	172	198	24423	198	24251	0.0	0.008164611768586863
chr8	LINC02055	136153759	136153826	0	68	198	24423	198	24355	0.0	0.008129747485115992
chr8	LINC02055	136519147	136519239	0	93	198	24423	198	24330	0.0	0.00813810110974106
chr8	LINC02055	136529794	136529941	0	148	198	24423	198	24275	0.0	0.00815653964984552
chr8	LINC02055	136563076	136563240	0	165	198	24423	198	24258	0.0	0.008162255750680188
chr8	LINC02055	136790460	136790494	0	35	198	24423	198	24388	0.0	0.008118746924717073
chr8	LINC02055	136645939	136646047	0	109	198	24423	198	24314	0.0	0.00814345644484659
chr8	LINC02055	136888279	136888350	0	72	198	24423	198	24351	0.0	0.008131082912406062
chr8	CHRAC1	140514368	140514495	0	128	0	3308	0	3180	0.0	0.0
chr8	DENND3	141160631	141160787	0	157	1170	13106	1170	12949	0.0	0.09035446752644992
chr8	DENND3	141163332	141163429	0	98	1170	13106	1170	13008	0.0	0.08994464944649447
chr8	DENND3	141150285	141150348	0	64	1170	13106	1170	13042	0.0	0.08971016715227725
chr8	PTP4A3	141427749	141427824	0	76	2040	2881	2040	2805	0.0	0.7272727272727273
chr8	ADGRB1	142524237	142524304	0	68	24	7183	24	7115	0.0	0.0033731553056921995
chr8	ADGRB1	142526541	142526627	0	87	24	7183	24	7096	0.0	0.0033821871476888386
chr8	LY6E	143020261	143020377	0	117	0	2646	0	2529	0.0	0.0
chr8	LY6E	143018832	143019119	0	288	0	2646	0	2358	0.0	0.0
chr8	C8ORF31	143047678	143047814	0	137	0	4098	0	3961	0.0	0.0
chr8	C8ORF31	143042957	143043087	0	131	0	4098	0	3967	0.0	0.0
chr8	C8ORF31	143044173	143044234	0	62	0	4098	0	4036	0.0	0.0
chr8	GLI4	143269359	143269520	0	162	0	2527	0	2365	0.0	0.0
chr8	ZNF696	143292142	143292284	0	143	0	5403	0	5260	0.0	0.0
chr8	ZNF696	143295378	143295470	0	93	0	5403	0	5310	0.0	0.0
chr8	GSDMD	143558681	143558914	0	234	0	3503	0	3269	0.0	0.0
chr8	ZNF707	143690056	143690123	0	68	204	6052	204	5984	0.0	0.03409090909090909
chr8	ZNF707	143692244	143692330	0	87	204	6052	204	5965	0.0	0.034199497066219615
chr8	ZNF707	143684623	143684755	0	133	204	6052	204	5919	0.0	0.03446528129751647
chr8	ZNF707	143689203	143689301	0	99	204	6052	204	5953	0.0	0.0342684360826474
chr8	ZNF707	143687380	143687478	0	99	204	6052	204	5953	0.0	0.0342684360826474
chr8	ZNF707	143687993	143688067	0	75	204	6052	204	5977	0.0	0.03413083486699013
chr8	ZNF707	143684755	143685067	0	313	204	6052	204	5739	0.0	0.03554626241505489
chr8	ZNF707	143692000	143692107	0	108	204	6052	204	5944	0.0	0.034320323014804845
chr8	ZNF707	143686916	143687014	0	99	204	6052	204	5953	0.0	0.0342684360826474
chr8	MAPK15	143717693	143717792	0	100	0	2567	0	2467	0.0	0.0
chr8	MAPK15	143720999	143721105	0	107	0	2567	0	2460	0.0	0.0
chr8	GRINA	143991877	143992078	0	202	0	2462	0	2260	0.0	0.0
chr8	GRINA	143991877	143991949	0	73	0	2462	0	2389	0.0	0.0
chr8	SPATC1	144041231	144041371	0	141	0	2175	0	2034	0.0	0.0
chr8	GPAA1	144083123	144083303	0	181	155	2761	155	2580	0.0	0.060077519379844964
chr8	WDR97	144112223	144112349	0	127	553	7698	553	7571	0.0	0.07304187029454498
chr8	WDR97	144113439	144113517	0	79	553	7698	553	7619	0.0	0.07258170363564773
chr8	HGH1	144138506	144138607	2340	102	11265	2449	8925	2347	22.941176470588236	3.8027268853855984
chr8	MROH1	144247566	144247679	0	114	204	10950	204	10836	0.0	0.018826135105204873
chr8	MROH1	144242601	144242628	0	28	204	10950	204	10922	0.0	0.01867789782091192
chr8	HSF1	144311173	144311249	0	77	51	5162	51	5085	0.0	0.010029498525073746
chr8	HSF1	144312627	144312711	0	85	51	5162	51	5077	0.0	0.01004530234390388
chr8	HSF1	144313845	144313911	0	67	51	5162	51	5095	0.0	0.01000981354268891
chr8	SLC52A2	144359622	144359747	0	126	61401	3711	61401	3585	0.0	17.127196652719665
chr8	SLC52A2	144359622	144359726	0	105	61401	3711	61401	3606	0.0	17.027454242928453
chr8	ADCK5	144377392	144377490	109	99	95853	2760	95744	2661	1.101010101010101	35.980458474257794
chr8	ADCK5	144389262	144389336	50	75	95853	2760	95803	2685	0.6666666666666666	35.68081936685289
chr8	PPP1R16A	144478585	144478682	0	98	881	5425	881	5327	0.0	0.16538389337338089
chr8	MFSD3	144510359	144510507	0	149	853	1627	853	1478	0.0	0.5771312584573748
chr8	LRRC14	144518748	144518815	0	68	38726	4663	38726	4595	0.0	8.4278563656148
chr8	LRRC14	144523635	144524105	0	471	38726	4663	38726	4192	0.0	9.23807251908397
chr8	AF186192.2	144705952	144706042	0	91	38	1686	38	1595	0.0	0.023824451410658306
chr8	ZNF517	144803640	144803767	837	128	70075	4098	69238	3970	6.5390625	17.44030226700252
chr8	ZNF7	144829477	144829604	0	128	6025	10298	6025	10170	0.0	0.5924287118977385
chr8	ZNF7	144829444	144829604	0	161	6025	10298	6025	10137	0.0	0.5943573049225609
chr8	ZNF7	144829522	144829604	0	83	6025	10298	6025	10215	0.0	0.5898188937836515
chr8	ZNF7	144830930	144831029	0	100	6025	10298	6025	10198	0.0	0.5908021180623652
chr8	ZNF7	144828007	144828053	425	47	6025	10298	5600	10251	9.042553191489361	0.5462881670080968
chr8	C8ORF33	145053061	145053146	0	86	1305527	3783	1305527	3697	0.0	353.13145793886935
chr8	C8ORF33	145061257	145061311	0	55	1305527	3783	1305527	3728	0.0	350.1950107296137
chr8	C8ORF33	145061227	145061311	0	85	1305527	3783	1305527	3698	0.0	353.0359653866955
chr9	PGM5P3-AS1	74148	74205	15	58	765	3123	750	3065	0.25862068965517243	0.24469820554649266
chr9	PGM5P3-AS1	80650	80807	0	158	765	3123	765	2965	0.0	0.2580101180438449
chr9	DOCK8	220747	220863	0	117	102	12921	102	12804	0.0	0.007966260543580132
chr9	DOCK8	371427	371566	0	140	102	12921	102	12781	0.0	0.007980596197480636
chr9	DOCK8	386330	386426	0	97	102	12921	102	12824	0.0	0.007953836556456644
chr9	DOCK8	280790	280905	0	116	102	12921	102	12805	0.0	0.007965638422491214
chr9	DOCK8	365590	366552	0	963	102	12921	102	11958	0.0	0.008529854490717512
chr9	DOCK8	369221	369447	0	227	102	12921	102	12694	0.0	0.008035292264061761
chr9	KANK1	549106	549721	0	616	461523	9291	461523	8675	0.0	53.20149855907781
chr9	KANK1	735711	735780	0	70	461523	9291	461523	9221	0.0	50.05129595488559
chr9	DMRT2	1055721	1055799	0	79	0	3147	0	3068	0.0	0.0
chr9	DMRT2	1050619	1050775	0	157	0	3147	0	2990	0.0	0.0
chr9	SMARCA2	2028986	2029247	13932	262	516675	15566	502743	15304	53.17557251908397	32.85043125980136
chr9	SMARCA2	2086828	2087071	27001	244	516675	15566	489674	15322	110.65983606557377	31.95888265239525
chr9	SMARCA2	2115821	2116049	13331	229	516675	15566	503344	15337	58.213973799126634	32.81893460259503
chr9	SMARCA2	2086828	2086897	6617	70	516675	15566	510058	15496	94.52857142857142	32.9154620547238
chr9	SMARCA2	2170418	2170472	0	55	516675	15566	516675	15511	0.0	33.31023144864935
chr9	SMARCA2	2181570	2181676	16436	107	516675	15566	500239	15459	153.60747663551402	32.359078853742155
chr9	SMARCA2	2072031	2072067	0	37	516675	15566	516675	15529	0.0	33.271620838431325
chr9	SMARCA2	2159813	2159909	534	97	516675	15566	516141	15469	5.505154639175258	33.36615165815502
chr9	SMARCA2	2161000	2161035	45	36	516675	15566	516630	15530	1.25	33.2665808113329
chr9	SMARCA2	2159428	2159466	0	39	516675	15566	516675	15527	0.0	33.27590648547691
chr9	SMARCA2	2160975	2161035	45	61	516675	15566	516630	15505	0.7377049180327869	33.3202192841019
chr9	VLDLR	2641376	2641499	5288	124	210432	9408	205144	9284	42.645161290322584	22.096510124946143
chr9	VLDLR	2651414	2651498	1710	85	210432	9408	208722	9323	20.11764705882353	22.387857985626944
chr9	LINC01231	3186917	3187035	0	119	0	5272	0	5153	0.0	0.0
chr9	SLC1A1	4583037	4583172	0	136	1122	3987	1122	3851	0.0	0.29135289535185666
chr9	RCL1	4826857	4827033	42029	177	408525	4153	366496	3976	237.45197740112994	92.17706237424547
chr9	CD274	5457078	5457420	8824	343	49657	4115	40833	3772	25.72594752186589	10.825291622481442
chr9	RIC1	5753535	5753646	4710	112	313998	8618	309288	8506	42.05357142857143	36.36115683047261
chr9	MLANA	5891054	5891199	0	146	962	2885	962	2739	0.0	0.3512230741146404
chr9	IL33	6251139	6251265	0	127	0	3262	0	3135	0.0	0.0
chr9	IL33	6252865	6252991	0	127	0	3262	0	3135	0.0	0.0
chr9	UHRF2	6433913	6434173	24916	261	591186	9898	566270	9637	95.46360153256705	58.75998754799211
chr9	UHRF2	6492302	6492401	519	100	591186	9898	590667	9798	5.19	60.28444580526638
chr9	AL354707.1	6721096	6721174	0	79	0	3185	0	3106	0.0	0.0
chr9	KDM4C	6981841	6982765	4029	925	240826	10355	236797	9430	4.355675675675676	25.11102863202545
chr9	KDM4C	7105401	7105500	0	100	240826	10355	240826	10255	0.0	23.483764017552414
chr9	TYRP1	12698450	12698655	0	206	663	3746	663	3540	0.0	0.18728813559322033
chr9	TYRP1	12707996	12708143	0	148	663	3746	663	3598	0.0	0.18426903835464148
chr9	SNAPC3	15447094	15447244	14984	151	322213	4975	307229	4824	99.23178807947019	63.68760364842454
chr9	ADAMTSL1	18675856	18675907	50	52	394067	11952	394017	11900	0.9615384615384616	33.110672268907564
chr9	ADAMTSL1	18892388	18892596	5918	209	394067	11952	388149	11743	28.31578947368421	33.05364898237248
chr9	ADAMTSL1	18889567	18889748	4767	182	394067	11952	389300	11770	26.192307692307693	33.07561597281224
chr9	DENND4C	19324361	19324507	4554	147	151001	8778	146447	8631	30.979591836734695	16.967558799675587
chr9	DENND4C	19331977	19332184	2814	208	151001	8778	148187	8570	13.528846153846153	17.291365227537923
chr9	DENND4C	19336685	19336832	805	148	151001	8778	150196	8630	5.4391891891891895	17.40393974507532
chr9	DENND4C	19371755	19371820	650	66	151001	8778	150351	8712	9.848484848484848	17.25792011019284
chr9	DENND4C	19337600	19337672	0	73	151001	8778	151001	8705	0.0	17.34646754738656
chr9	FOCAD	20819795	20819900	4211	106	195785	9254	191574	9148	39.72641509433962	20.941626585045913
chr9	FOCAD	20863420	20863550	0	131	195785	9254	195785	9123	0.0	21.460594102817055
chr9	FOCAD	20929357	20929596	6955	240	195785	9254	188830	9014	28.979166666666668	20.94852451741735
chr9	MTAP	21859302	21859425	49660	124	942425	13923	892765	13799	400.48387096774195	64.69780418870933
chr9	CDKN2B-AS1	22061952	22062026	0	75	426848	18594	426848	18519	0.0	23.049192720989254
chr9	CDKN2B-AS1	22066234	22066353	969	120	426848	18594	425879	18474	8.075	23.052885135866624
chr9	CDKN2B-AS1	22032673	22032986	2703	314	426848	18594	424145	18280	8.60828025477707	23.202680525164112
chr9	CDKN2B-AS1	22058358	22059054	1224	697	426848	18594	425624	17897	1.7560975609756098	23.78186288204727
chr9	CDKN2B-AS1	22065661	22065757	0	97	426848	18594	426848	18497	0.0	23.076607017354167
chr9	CDKN2B-AS1	22097257	22097364	1251	108	426848	18594	425597	18486	11.583333333333334	23.022665801146815
chr9	CDKN2B-AS1	22113665	22113799	749	135	426848	18594	426099	18459	5.548148148148148	23.083536486266862
chr9	CDKN2B-AS1	22118643	22118767	3009	125	426848	18594	423839	18469	24.072	22.948670745573665
chr9	CDKN2B-AS1	22046316	22046449	2196	134	426848	18594	424652	18460	16.388059701492537	23.003900325027086
chr9	CDKN2B-AS1	22092307	22092469	204	163	426848	18594	426644	18431	1.2515337423312884	23.14817427160762
chr9	CDKN2B-AS1	22056251	22056387	2319	137	426848	18594	424529	18457	16.927007299270073	23.000975239746438
chr9	CDKN2B-AS1	22063943	22064018	504	76	426848	18594	426344	18518	6.631578947368421	23.023220650178207
chr9	CDKN2B-AS1	22120199	22120410	4538	212	426848	18594	422310	18382	21.40566037735849	22.974105102817973
chr9	CDKN2B-AS1	22029432	22029594	7777	163	426848	18594	419071	18431	47.71165644171779	22.73729043459389
chr9	CDKN2B-AS1	22023943	22024011	51	69	426848	18594	426797	18525	0.7391304347826086	23.038974358974357
chr9	CDKN2B-AS1	22112319	22112395	633	77	426848	18594	426215	18517	8.220779220779221	23.017497434789654
chr9	LINC01241	25802428	25802519	0	92	0	3087	0	2995	0.0	0.0
chr9	IFT74	26992382	26992677	102	296	132016	6878	131914	6582	0.34459459459459457	20.04162868429049
chr9	IFT74	26982285	26982399	0	115	132016	6878	132016	6763	0.0	19.520331213958304
chr9	TEK	27157830	27158142	51	313	4396	4828	4345	4515	0.16293929712460065	0.9623477297895903
chr9	TEK	27191928	27191965	0	38	4396	4828	4396	4790	0.0	0.9177453027139875
chr9	TEK	27180239	27180368	0	130	4396	4828	4396	4698	0.0	0.9357173265219242
chr9	ACO1	32386370	32386442	1117	73	748796	7577	747679	7504	15.301369863013699	99.6373933901919
chr9	ACO1	32386370	32386438	1094	69	748796	7577	747702	7508	15.855072463768115	99.58737346830048
chr9	SMIM27	32565396	32565628	2740	233	70033	3621	67293	3388	11.759656652360515	19.86216056670602
chr9	B4GALT1-AS1	33178895	33178957	1220	63	31045	3840	29825	3777	19.365079365079364	7.896478686788456
chr9	CHMP5	33278112	33278225	71118	114	668693	2399	597575	2285	623.8421052631579	261.5207877461707
chr9	AL356218.2	33409881	33409962	0	82	918	1471	918	1389	0.0	0.6609071274298056
chr9	AL356218.2	33402421	33402577	0	157	918	1471	918	1314	0.0	0.6986301369863014
chr9	ANKRD18B	33528999	33529173	2771	175	14615	4805	11844	4630	15.834285714285715	2.558099352051836
chr9	CYP4F26P	33602811	33602919	255	109	612	3903	357	3794	2.3394495412844036	0.0940959409594096
chr9	CYP4F26P	33604479	33604570	0	92	612	3903	612	3811	0.0	0.16058777223825768
chr9	CYP4F26P	33604296	33604403	0	108	612	3903	612	3795	0.0	0.16126482213438736
chr9	PRSS3	33794745	33794873	0	129	51	1434	51	1305	0.0	0.03908045977011494
chr9	PRSS3	33796642	33796802	0	161	51	1434	51	1273	0.0	0.04006284367635507
chr9	UBAP1	34249778	34249961	86379	184	803760	2780	717381	2596	469.45108695652175	276.34090909090907
chr9	UBAP1	34220907	34220948	5719	42	803760	2780	798041	2738	136.16666666666666	291.46859021183343
chr9	UBAP1	34234215	34234340	29235	126	803760	2780	774525	2654	232.02380952380952	291.8330821401658
chr9	NUDT2	34338712	34338847	26119	136	198380	1078	172261	942	192.0514705882353	182.86730360934183
chr9	NUDT2	34336299	34336341	1021	43	198380	1078	197359	1035	23.74418604651163	190.68502415458937
chr9	NUDT2	34336228	34336341	2910	114	198380	1078	195470	964	25.526315789473685	202.76970954356847
chr9	DNAI1	34483447	34483480	0	34	2561	3636	2561	3602	0.0	0.7109938922820656
chr9	DNAI1	34514393	34514542	686	150	2561	3636	1875	3486	4.573333333333333	0.5378657487091222
chr9	DNAI1	34517284	34517467	0	184	2561	3636	2561	3452	0.0	0.7418887601390498
chr9	CNTFR-AS1	34580099	34580201	0	103	0	2607	0	2504	0.0	0.0
chr9	CNTFR-AS1	34569511	34569616	0	106	0	2607	0	2501	0.0	0.0
chr9	GALT	34647831	34647961	16572	131	223772	4322	207200	4191	126.50381679389314	49.43927463612503
chr9	IL11RA	34655604	34655665	4258	62	212587	4224	208329	4162	68.6774193548387	50.05502162421912
chr9	IL11RA	34656738	34656908	13191	171	212587	4224	199396	4053	77.14035087719299	49.19713792252652
chr9	DNAJB5	34990667	34990812	204	146	144946	3656	144742	3510	1.3972602739726028	41.237037037037034
chr9	DNAJB5	34990347	34990611	62	265	144946	3656	144884	3391	0.2339622641509434	42.72603951636685
chr9	DNAJB5	34990498	34990611	62	114	144946	3656	144884	3542	0.543859649122807	40.904573687182385
chr9	C9ORF131	35042410	35042485	660	76	10341	3828	9681	3752	8.68421052631579	2.580223880597015
chr9	UNC13B	35371933	35371939	0	7	501126	17963	501126	17956	0.0	27.90855424370684
chr9	UNC13B	35397166	35397310	14935	145	501126	17963	486191	17818	103.0	27.2865080255921
chr9	UNC13B	35401950	35402007	0	58	501126	17963	501126	17905	0.0	27.98804803127618
chr9	UNC13B	35291068	35291104	0	37	501126	17963	501126	17926	0.0	27.955260515452416
chr9	UNC13B	35300165	35308412	2040	8248	501126	17963	499086	9715	0.24733268671193018	51.372722593926916
chr9	UNC13B	35364544	35364567	0	24	501126	17963	501126	17939	0.0	27.935001951056357
chr9	ATP8B5P	35480459	35480598	0	140	33642	6309	33642	6169	0.0	5.453396012319663
chr9	TESK1	35607326	35607409	4663	84	123634	3305	118971	3221	55.51190476190476	36.936044706612854
chr9	CA9	35676296	35676389	586	94	6290	1619	5704	1525	6.23404255319149	3.740327868852459
chr9	AL133410.1	35787864	35788036	9	173	12200	3404	12191	3231	0.05202312138728324	3.7731352522438875
chr9	NPR2	35808508	35808683	21532	176	260529	4126	238997	3950	122.3409090909091	60.50556962025316
chr9	TMEM8B	35841525	35841794	4114	270	70552	16232	66438	15962	15.237037037037037	4.16226036837489
chr9	GLIPR2	36150871	36150949	351	79	15647	3062	15296	2983	4.443037974683544	5.127723768018773
chr9	GLIPR2	36148546	36148650	856	105	15647	3062	14791	2957	8.152380952380952	5.002029083530605
chr9	CLTA	36198978	36199096	597093	119	3043915	2526	2446822	2407	5017.588235294118	1016.5442459493145
chr9	CLTA	36209266	36209320	396	55	3043915	2526	3043519	2471	7.2	1231.6952650748685
chr9	CLTA	36210624	36210660	1270	37	3043915	2526	3042645	2489	34.32432432432432	1222.4367215749296
chr9	CLTA	36197550	36197588	105943	39	3043915	2526	2937972	2487	2716.4871794871797	1181.3317249698432
chr9	MELK	36657240	36657363	85302	124	1687362	3106	1602060	2982	687.9193548387096	537.2434607645876
chr9	MELK	36583626	36583712	53587	87	1687362	3106	1633775	3019	615.9425287356322	541.1642928121895
chr9	MELK	36597221	36597290	38885	70	1687362	3106	1648477	3036	555.5	542.9766139657444
chr9	MELK	36594627	36594771	84319	145	1687362	3106	1603043	2961	581.5103448275862	541.38568051334
chr9	MELK	36581643	36581739	50107	97	1687362	3106	1637255	3009	516.5670103092783	544.1193087404454
chr9	MELK	36589535	36589652	79060	118	1687362	3106	1608302	2988	670.0	538.2536813922356
chr9	MELK	36606805	36606923	0	119	1687362	3106	1687362	2987	0.0	564.9019082691664
chr9	MELK	36606829	36606923	0	95	1687362	3106	1687362	3011	0.0	560.3992029226171
chr9	EBLN3P	37084198	37084292	914	95	617447	7939	616533	7844	9.621052631578948	78.59931157572667
chr9	EBLN3P	37080341	37080536	23413	196	617447	7939	594034	7743	119.45408163265306	76.71884282577813
chr9	POLR1E	37492281	37492375	1334	95	1900535	2512	1899201	2417	14.042105263157895	785.7678940835747
chr9	TRMT10B	37762576	37762685	23197	110	224466	2875	201269	2765	210.88181818181818	72.79168173598553
chr9	TRMT10B	37768075	37768228	18447	154	224466	2875	206019	2721	119.78571428571429	75.71444321940463
chr9	TRMT10B	37762542	37762685	23618	144	224466	2875	200848	2731	164.01388888888889	73.54375686561698
chr9	TRMT10B	37763628	37763865	21241	238	224466	2875	203225	2637	89.24789915966386	77.06674251042851
chr9	TRMT10B	37763628	37763753	18205	126	224466	2875	206261	2749	144.484126984127	75.0312841033103
chr9	DCAF10	37842088	37842286	24944	199	571280	8300	546336	8101	125.34673366834171	67.44056289346995
chr9	DCAF10	37857240	37857351	13942	112	571280	8300	557338	8188	124.48214285714286	68.0676599902296
chr9	ALDH1B1	38394476	38394565	0	90	1115147	3120	1115147	3030	0.0	368.03531353135315
chr9	ANKRD20A2P	40226906	40227021	0	116	0	4425	0	4309	0.0	0.0
chr9	BX664727.3	40281393	40281675	0	283	35	5288	35	5005	0.0	0.006993006993006993
chr9	BX664727.3	40266950	40267100	0	151	35	5288	35	5137	0.0	0.0068133151644928945
chr9	BX664727.3	40291748	40291919	0	172	35	5288	35	5116	0.0	0.006841282251759187
chr9	BX664727.3	40271886	40271999	0	114	35	5288	35	5174	0.0	0.00676459219172787
chr9	FAM95B1	40326283	40326445	0	163	949	2302	949	2139	0.0	0.4436652641421225
chr9	FAM95B1	40324888	40325092	0	205	949	2302	949	2097	0.0	0.452551263710062
chr9	FAM95B1	40324984	40325092	0	109	949	2302	949	2193	0.0	0.4327405380756954
chr9	FAM95B1	40326317	40326445	0	129	949	2302	949	2173	0.0	0.436723423838012
chr9	FAM95B1	40327942	40328105	0	164	949	2302	949	2138	0.0	0.4438727782974743
chr9	AMYH02020865.1	40507903	40508011	153	109	376	3624	223	3515	1.4036697247706422	0.06344238975817923
chr9	AL353626.1	40799010	40799083	0	74	1020	512	1020	438	0.0	2.328767123287671
chr9	FRG1HP	40993252	40993434	0	183	0	1712	0	1529	0.0	0.0
chr9	FRG1HP	41009793	41009843	0	51	0	1712	0	1661	0.0	0.0
chr9	ANKRD20A7P	42838214	42838275	0	62	68	7916	68	7854	0.0	0.008658008658008658
chr9	ANKRD20A7P	42856951	42857107	0	157	68	7916	68	7759	0.0	0.008764015981440908
chr9	ANKRD20A7P	42910731	42911013	0	283	68	7916	68	7633	0.0	0.008908685968819599
chr9	ANKRD20A7P	42901237	42901355	0	119	68	7916	68	7797	0.0	0.008721303065281518
chr9	FAM74A6	60935238	60935322	0	85	0	1817	0	1732	0.0	0.0
chr9	FAM74A4	61210861	61210945	0	85	0	1959	0	1874	0.0	0.0
chr9	FAM27C	61920892	61921356	0	465	0	12969	0	12504	0.0	0.0
chr9	FAM27C	62003322	62003478	0	157	0	12969	0	12812	0.0	0.0
chr9	FAM27C	62072999	62073117	0	119	0	12969	0	12850	0.0	0.0
chr9	FAM27C	61920281	61920435	0	155	0	12969	0	12814	0.0	0.0
chr9	FAM27C	61972189	61972670	0	482	0	12969	0	12487	0.0	0.0
chr9	FAM27C	61920302	61920435	0	134	0	12969	0	12835	0.0	0.0
chr9	FAM27C	62072996	62073117	0	122	0	12969	0	12847	0.0	0.0
chr9	FAM27C	61975790	61975912	0	123	0	12969	0	12846	0.0	0.0
chr9	FAM27C	61952972	61954499	0	1528	0	12969	0	11441	0.0	0.0
chr9	FAM27C	62072999	62073110	0	112	0	12969	0	12857	0.0	0.0
chr9	LINC01410	62811938	62812075	0	138	0	4130	0	3992	0.0	0.0
chr9	ANKRD20A4P	64373186	64373301	0	116	0	4526	0	4410	0.0	0.0
chr9	CBWD5	65690966	65691026	0	61	435	10606	435	10545	0.0	0.041251778093883355
chr9	CBWD5	65700250	65700337	0	88	435	10606	435	10518	0.0	0.041357672561323444
chr9	CBWD5	65702969	65703014	0	46	435	10606	435	10560	0.0	0.041193181818181816
chr9	CBWD5	65708901	65708958	0	58	435	10606	435	10548	0.0	0.04124004550625711
chr9	CBWD5	65731629	65731698	0	70	435	10606	435	10536	0.0	0.041287015945330297
chr9	CBWD5	65693385	65693473	0	89	435	10606	435	10517	0.0	0.041361605020443094
chr9	CBWD5	65677127	65677225	0	99	435	10606	435	10507	0.0	0.04140097078138384
chr9	CBWD5	65707012	65707152	0	141	435	10606	435	10465	0.0	0.041567128523650264
chr9	CBWD5	65694904	65695049	0	146	435	10606	435	10460	0.0	0.04158699808795411
chr9	CBWD5	65694904	65695044	0	141	435	10606	435	10465	0.0	0.041567128523650264
chr9	CBWD5	65704330	65704547	0	218	435	10606	435	10388	0.0	0.04187524066230266
chr9	CBWD5	65704330	65704414	0	85	435	10606	435	10521	0.0	0.04134587966923296
chr9	ZNF658	66902908	66903057	0	150	0	4852	0	4702	0.0	0.0
chr9	ANKRD20A1	67862940	67863055	0	116	168	6539	168	6423	0.0	0.026156001868285848
chr9	ANKRD20A1	67860470	67860696	168	227	168	6539	0	6312	0.7400881057268722	0.0
chr9	CBWD3	68256920	68256980	0	61	15465	10070	15465	10009	0.0	1.5451094015386153
chr9	CBWD3	68259346	68259434	0	89	15465	10070	15465	9981	0.0	1.549443943492636
chr9	CBWD3	68266219	68266306	0	88	15465	10070	15465	9982	0.0	1.549288719695452
chr9	CBWD3	68243182	68243280	0	99	15465	10070	15465	9971	0.0	1.5509978938922877
chr9	CBWD3	68274881	68274938	0	58	15465	10070	15465	10012	0.0	1.544646424290851
chr9	CBWD3	68260856	68261001	0	146	15465	10070	15465	9924	0.0	1.5583434099153568
chr9	CBWD3	68260856	68260996	0	141	15465	10070	15465	9929	0.0	1.55755866653238
chr9	CBWD3	68269599	68269722	0	124	15465	10070	15465	9946	0.0	1.554896440780213
chr9	CBWD3	68270301	68270518	0	218	15465	10070	15465	9852	0.0	1.5697320341047503
chr9	AL353608.3	68328888	68328957	0	70	0	5290	0	5220	0.0	0.0
chr9	PGM5	68384397	68384544	0	148	801	5335	801	5187	0.0	0.15442452284557548
chr9	PIP5K1B	68742500	68742657	50	158	4625	5121	4575	4963	0.31645569620253167	0.921821478944187
chr9	PIP5K1B	68991139	68991257	4	119	4625	5121	4621	5002	0.03361344537815126	0.9238304678128748
chr9	PIP5K1B	68824095	68824215	0	121	4625	5121	4625	5000	0.0	0.925
chr9	AL358113.1	69046384	69046482	0	99	9999	8743	9999	8644	0.0	1.1567561314206385
chr9	AL358113.1	69053139	69053260	841	122	9999	8743	9158	8621	6.89344262295082	1.0622897575687276
chr9	AL358113.1	69064937	69065035	303	99	9999	8743	9696	8644	3.0606060606060606	1.1217029153169829
chr9	TJP2	69248011	69248224	51	214	21732	10925	21681	10711	0.2383177570093458	2.024180748762954
chr9	TJP2	69251034	69251364	255	331	21732	10925	21477	10594	0.770392749244713	2.0272795922220124
chr9	TJP2	69249374	69249485	0	112	21732	10925	21732	10813	0.0	2.009803014889485
chr9	TJP2	69185086	69185204	0	119	21732	10925	21732	10806	0.0	2.011104941699056
chr9	FAM189A2	69388157	69388450	0	294	0	5150	0	4856	0.0	0.0
chr9	C9ORF135	69844516	69844625	0	110	0	1258	0	1148	0.0	0.0
chr9	C9ORF135	69886837	69886895	0	59	0	1258	0	1199	0.0	0.0
chr9	C9ORF135	69902254	69902388	0	135	0	1258	0	1123	0.0	0.0
chr9	C9ORF85	71947005	71947112	0	108	51	4980	51	4872	0.0	0.010467980295566502
chr9	C9ORF85	71941804	71941934	0	131	51	4980	51	4849	0.0	0.010517632501546711
chr9	C9ORF85	71918424	71918555	0	132	51	4980	51	4848	0.0	0.01051980198019802
chr9	GDA	72223119	72223227	0	109	51	5582	51	5473	0.0	0.009318472501370363
chr9	GDA	72214758	72214876	0	119	51	5582	51	5463	0.0	0.009335529928610654
chr9	LINC01504	72336765	72336864	0	100	5057	4345	5057	4245	0.0	1.191283863368669
chr9	LINC01504	72328663	72328721	1488	59	5057	4345	3569	4286	25.220338983050848	0.8327111525898273
chr9	TMC1	72577901	72578023	51	123	105	8743	54	8620	0.4146341463414634	0.0062645011600928075
chr9	TMC1	72648596	72648664	0	69	105	8743	105	8674	0.0	0.012105141803089694
chr9	TMC1	72700517	72700643	0	127	105	8743	105	8616	0.0	0.012186629526462395
chr9	TMC1	72830630	72830682	0	53	105	8743	105	8690	0.0	0.012082853855005753
chr9	TMC1	72627920	72628063	0	144	105	8743	105	8599	0.0	0.012210722176997325
chr9	TMC1	72817084	72817288	3	205	105	8743	102	8538	0.014634146341463415	0.011946591707659873
chr9	TMC1	72818678	72818748	0	71	105	8743	105	8672	0.0	0.012107933579335794
chr9	ANXA1	73154197	73154342	0	146	0	4467	0	4321	0.0	0.0
chr9	ANXA1	73154197	73154340	0	144	0	4467	0	4323	0.0	0.0
chr9	PCSK5	76302136	76302217	0	82	0	11876	0	11794	0.0	0.0
chr9	GCNT1	76460059	76460177	0	119	0	9269	0	9150	0.0	0.0
chr9	PCA3	76703918	76703958	0	41	408	12897	408	12856	0.0	0.031736154324828875
chr9	PCA3	76733589	76733729	0	141	408	12897	408	12756	0.0	0.03198494825964252
chr9	PCA3	76737715	76737786	0	72	408	12897	408	12825	0.0	0.03181286549707602
chr9	PCA3	76783704	76783887	0	184	408	12897	408	12713	0.0	0.0320931330134508
chr9	PCA3	76856436	76856581	0	146	408	12897	408	12751	0.0	0.03199749039291036
chr9	PCA3	76738658	76738796	0	139	408	12897	408	12758	0.0	0.031979934158959084
chr9	PCA3	76782667	76782832	51	166	408	12897	357	12731	0.3072289156626506	0.02804178776215537
chr9	VPS13A	77283354	77283471	0	118	0	20179	0	20061	0.0	0.0
chr9	VPS13A	77305556	77305637	0	82	0	20179	0	20097	0.0	0.0
chr9	CEP78	78240291	78240364	0	74	0	12902	0	12828	0.0	0.0
chr9	CEP78	78246668	78246782	0	115	0	12902	0	12787	0.0	0.0
chr9	CEP78	78262906	78262984	0	79	0	12902	0	12823	0.0	0.0
chr9	CEP78	78265858	78265906	0	49	0	12902	0	12853	0.0	0.0
chr9	CEP78	78250245	78250263	0	19	0	12902	0	12883	0.0	0.0
chr9	PSAT1	78328050	78328188	0	139	0	2215	0	2076	0.0	0.0
chr9	TLE4	79576132	79576177	0	46	102	8082	102	8036	0.0	0.012692882030861125
chr9	TLE4	79627373	79627448	0	76	102	8082	102	8006	0.0	0.012740444666500124
chr9	TLE4	79706746	79706899	0	154	102	8082	102	7928	0.0	0.012865792129162463
chr9	TLE4	79601414	79601509	0	96	102	8082	102	7986	0.0	0.012772351615326822
chr9	TLE4	79649819	79649858	0	40	102	8082	102	8042	0.0	0.012683412086545635
chr9	TLE4	79707122	79707218	0	97	102	8082	102	7985	0.0	0.012773951158422042
chr9	TLE4	79671208	79671338	0	131	102	8082	102	7951	0.0	0.01282857502200981
chr9	TLE4	79705888	79705942	0	55	102	8082	102	8027	0.0	0.012707113491964619
chr9	TLE4	79717996	79718071	0	76	102	8082	102	8006	0.0	0.012740444666500124
chr9	AL162726.3	82349803	82349848	0	46	816	4452	816	4406	0.0	0.1852019972764412
chr9	AL162726.3	82426291	82426376	0	86	816	4452	816	4366	0.0	0.1868987631699496
chr9	AL162726.3	82396707	82396800	0	94	816	4452	816	4358	0.0	0.1872418540614961
chr9	AL162726.3	82297381	82297540	0	160	816	4452	816	4292	0.0	0.19012115563839702
chr9	AL162726.3	82453344	82453458	0	115	816	4452	816	4337	0.0	0.18814848973945122
chr9	AL162726.3	82426981	82427026	0	46	816	4452	816	4406	0.0	0.1852019972764412
chr9	AL162726.3	82451602	82451729	0	128	816	4452	816	4324	0.0	0.1887141535615171
chr9	IDNK	83628006	83628211	0	206	408	1820	408	1614	0.0	0.2527881040892193
chr9	IDNK	83641547	83641591	0	45	408	1820	408	1775	0.0	0.22985915492957745
chr9	IDNK	83628180	83628211	0	32	408	1820	408	1788	0.0	0.22818791946308725
chr9	AL354733.1	83835550	83835705	0	156	227	2486	227	2330	0.0	0.09742489270386266
chr9	AL354733.1	83830867	83830939	0	73	227	2486	227	2413	0.0	0.09407376709490262
chr9	AL354733.2	83858863	83859160	0	298	47	3124	47	2826	0.0	0.016631280962491155
chr9	AL354733.2	83859576	83859674	0	99	47	3124	47	3025	0.0	0.015537190082644628
chr9	AL354733.2	83855055	83855177	0	123	47	3124	47	3001	0.0	0.015661446184605132
chr9	AL354733.2	83863660	83863822	0	163	47	3124	47	2961	0.0	0.015873015873015872
chr9	AL390838.1	84077905	84078087	0	183	0	2979	0	2796	0.0	0.0
chr9	NTRK2	84669301	84669423	0	123	3561	20370	3561	20247	0.0	0.17587790783819826
chr9	NTRK2	84669679	84669888	0	210	3561	20370	3561	20160	0.0	0.17663690476190477
chr9	NTRK2	84861039	84861087	0	49	3561	20370	3561	20321	0.0	0.17523743910240638
chr9	AL158828.1	86417085	86417235	0	151	0	1170	0	1019	0.0	0.0
chr9	AL159996.1	86754969	86755144	0	176	0	2722	0	2546	0.0	0.0
chr9	DAPK1	87637942	87638081	0	140	0	8937	0	8797	0.0	0.0
chr9	DAPK1	87639649	87639698	0	50	0	8937	0	8887	0.0	0.0
chr9	DAPK1	87697006	87697204	0	199	0	8937	0	8738	0.0	0.0
chr9	CTSL	87728584	87728809	0	226	0	5954	0	5728	0.0	0.0
chr9	CTSL	87730380	87730498	0	119	0	5954	0	5835	0.0	0.0
chr9	CTSL	87727593	87727729	0	137	0	5954	0	5817	0.0	0.0
chr9	CTSL	87727360	87727468	0	109	0	5954	0	5845	0.0	0.0
chr9	CTSL	87727360	87727395	0	36	0	5954	0	5918	0.0	0.0
chr9	CTSL	87728249	87728396	0	148	0	5954	0	5806	0.0	0.0
chr9	CTSL	87728584	87729085	0	502	0	5954	0	5452	0.0	0.0
chr9	SPIN1	88462495	88462749	0	255	306	4913	306	4658	0.0	0.06569343065693431
chr9	SPIN1	88426381	88426591	0	211	306	4913	306	4702	0.0	0.06507868991918332
chr9	UNQ6494	89700273	89700357	0	85	0	3355	0	3270	0.0	0.0
chr9	AL161629.1	90004948	90005141	0	194	0	3536	0	3342	0.0	0.0
chr9	AL161629.1	89979488	89979531	0	44	0	3536	0	3492	0.0	0.0
chr9	AL161629.1	90000640	90001218	0	579	0	3536	0	2957	0.0	0.0
chr9	AL161629.1	89978275	89978432	0	158	0	3536	0	3378	0.0	0.0
chr9	AL161629.1	89987951	89988057	0	107	0	3536	0	3429	0.0	0.0
chr9	AL161629.1	89988593	89988795	0	203	0	3536	0	3333	0.0	0.0
chr9	AL161629.1	89992609	89992764	0	156	0	3536	0	3380	0.0	0.0
chr9	AL161629.1	89971266	89971399	0	134	0	3536	0	3402	0.0	0.0
chr9	AL161629.1	89988730	89988795	0	66	0	3536	0	3470	0.0	0.0
chr9	SYK	90867130	90867199	0	70	541	5226	541	5156	0.0	0.10492629945694337
chr9	LINC00475	92141998	92142104	0	107	0	3692	0	3585	0.0	0.0
chr9	LINC00475	92157686	92157873	0	188	0	3692	0	3504	0.0	0.0
chr9	ANKRD19P	92828937	92829163	0	227	51	2511	51	2284	0.0	0.0223292469352014
chr9	SUSD3	93075783	93075972	0	190	65	1264	65	1074	0.0	0.06052141527001862
chr9	SUSD3	93079470	93079602	0	133	65	1264	65	1131	0.0	0.05747126436781609
chr9	CARD19	93111878	93111938	0	61	0	1748	0	1687	0.0	0.0
chr9	WNK2	93256298	93256454	0	157	0	12845	0	12688	0.0	0.0
chr9	WNK2	93268839	93268950	0	112	0	12845	0	12733	0.0	0.0
chr9	WNK2	93299069	93299261	0	193	0	12845	0	12652	0.0	0.0
chr9	FAM120A	93558580	93558718	0	139	153	6135	153	5996	0.0	0.02551701134089393
chr9	FAM120A	93530710	93530731	0	22	153	6135	153	6113	0.0	0.025028627515131685
chr9	AL442224.1	93825710	93826515	0	806	0	1617	0	811	0.0	0.0
chr9	AL442224.1	93845166	93845282	0	117	0	1617	0	1500	0.0	0.0
chr9	PTPDC1	94057117	94057179	54	63	1698	6381	1644	6318	0.8571428571428571	0.26020892687559355
chr9	AL158152.1	94149425	94149562	0	138	39	1242	39	1104	0.0	0.035326086956521736
chr9	AOPEP	94928424	94928531	0	108	88055	10810	88055	10702	0.0	8.227901326854793
chr9	AOPEP	95060693	95060810	1532	118	88055	10810	86523	10692	12.983050847457626	8.092312008978675
chr9	AOPEP	95082574	95082719	160	146	88055	10810	87895	10664	1.095890410958904	8.24221680420105
chr9	AOPEP	95085929	95086119	0	191	88055	10810	88055	10619	0.0	8.292212072699877
chr9	AL354861.2	95685142	95685251	0	110	0	515	0	405	0.0	0.0
chr9	ERCC6L2	95907077	95907271	0	195	781	16706	781	16511	0.0	0.04730179880079947
chr9	ERCC6L2	95997245	95997413	6	169	781	16706	775	16537	0.03550295857988166	0.046864606639656525
chr9	ERCC6L2	96004519	96004701	0	183	781	16706	781	16523	0.0	0.04726744537916843
chr9	ERCC6L2	95971543	95971595	0	53	781	16706	781	16653	0.0	0.04689845673452231
chr9	ERCC6L2	95954727	95954922	0	196	781	16706	781	16510	0.0	0.04730466384009691
chr9	ERCC6L2	95967318	95967625	0	308	781	16706	781	16398	0.0	0.04762775948286376
chr9	ERCC6L2	95967458	95967625	0	168	781	16706	781	16538	0.0	0.04722457370903374
chr9	AL449403.1	96093025	96093162	0	138	0	2230	0	2092	0.0	0.0
chr9	AL449403.1	96093025	96093095	0	71	0	2230	0	2159	0.0	0.0
chr9	AL589843.1	96720965	96721130	0	166	0	2839	0	2673	0.0	0.0
chr9	AL590705.2	97229036	97229164	14	129	224104	658	224090	529	0.10852713178294573	423.61058601134215
chr9	STRA6LP	97292555	97292675	0	121	430	7167	430	7046	0.0	0.0610275333522566
chr9	STRA6LP	97314392	97314521	0	130	430	7167	430	7037	0.0	0.061105584766235614
chr9	STRA6LP	97318462	97318582	0	121	430	7167	430	7046	0.0	0.0610275333522566
chr9	STRA6LP	97328019	97328146	0	128	430	7167	430	7039	0.0	0.061088222758914616
chr9	STRA6LP	97364017	97364128	0	112	430	7167	430	7055	0.0	0.06094968107725018
chr9	STRA6LP	97364050	97364128	0	79	430	7167	430	7088	0.0	0.06066591422121896
chr9	NCBP1	97643203	97643360	0	158	1049	3175	1049	3017	0.0	0.3476963871395426
chr9	NCBP1	97645610	97645732	132	123	1049	3175	917	3052	1.0731707317073171	0.30045871559633025
chr9	GALNT12	98823255	98823425	0	171	0	3177	0	3006	0.0	0.0
chr9	TGFBR1	99146484	99146609	0	126	156502	6833	156502	6707	0.0	23.334128522439244
chr9	TGFBR1	99132508	99132739	0	232	156502	6833	156502	6601	0.0	23.70883199515225
chr9	TGFBR1	99132496	99132739	0	244	156502	6833	156502	6589	0.0	23.752010927303083
chr9	NR4A3	99826729	99826801	0	73	255	6323	255	6250	0.0	0.0408
chr9	STX17	99959916	99960032	539	117	2999	8893	2460	8776	4.6068376068376065	0.28030993618960803
chr9	STX17	99916048	99916168	0	121	2999	8893	2999	8772	0.0	0.34188326493388055
chr9	STX17	99913989	99914151	0	163	2999	8893	2999	8730	0.0	0.34352806414662085
chr9	STX17	99945718	99945850	0	133	2999	8893	2999	8760	0.0	0.34235159817351596
chr9	MSANTD3	100429505	100429662	0	158	4879	3295	4879	3137	0.0	1.555307618744023
chr9	MSANTD3	100445168	100445237	0	70	4879	3295	4879	3225	0.0	1.5128682170542636
chr9	ZNF189	101399394	101399530	0	137	726	3438	726	3301	0.0	0.21993335352923357
chr9	ZNF189	101407411	101407532	0	122	726	3438	726	3316	0.0	0.2189384800965018
chr9	TMEM246-AS1	101474875	101475042	0	168	0	1819	0	1651	0.0	0.0
chr9	TMEM246-AS1	101479839	101479923	0	85	0	1819	0	1734	0.0	0.0
chr9	CYLC2	103016887	103016961	0	75	71	2285	71	2210	0.0	0.03212669683257918
chr9	SMC2	104135867	104136060	0	194	51	6461	51	6267	0.0	0.008137865007180469
chr9	NIPSNAP3B	104766324	104766535	0	212	0	1687	0	1475	0.0	0.0
chr9	NIPSNAP3B	104770848	104770998	0	151	0	1687	0	1536	0.0	0.0
chr9	FSD1L	105461519	105461615	0	97	0	9554	0	9457	0.0	0.0
chr9	FSD1L	105479353	105479376	0	24	0	9554	0	9530	0.0	0.0
chr9	FSD1L	105513598	105513631	0	34	0	9554	0	9520	0.0	0.0
chr9	FKTN	105603698	105603816	0	119	204	17148	204	17029	0.0	0.011979564272711258
chr9	FKTN	105573654	105573746	0	93	204	17148	204	17055	0.0	0.011961301671064205
chr9	FKTN	105623049	105623221	0	173	204	17148	204	16975	0.0	0.012017673048600883
chr9	FKTN	105574197	105574332	0	136	204	17148	204	17012	0.0	0.011991535386785799
chr9	FKTN	105570750	105570897	0	148	204	17148	204	17000	0.0	0.012
chr9	FKTN	105574197	105574278	0	82	204	17148	204	17066	0.0	0.011953591937185046
chr9	FKTN	105598085	105598183	0	99	204	17148	204	17049	0.0	0.011965511173675876
chr9	FKTN	105600917	105601041	0	125	204	17148	204	17023	0.0	0.011983786641602538
chr9	FKTN	105603863	105603947	0	85	204	17148	204	17063	0.0	0.011955693606048175
chr9	FKTN	105598630	105598701	0	72	204	17148	204	17076	0.0	0.011946591707659873
chr9	FKTN	105598505	105598701	0	197	204	17148	204	16951	0.0	0.012034688218984131
chr9	FKTN	105633355	105633474	0	120	204	17148	204	17028	0.0	0.011980267794221282
chr9	FKTN	105624281	105624396	0	116	204	17148	204	17032	0.0	0.011977454203851573
chr9	TMEM38B	105702706	105702822	0	117	0	4537	0	4420	0.0	0.0
chr9	TMEM38B	105749075	105749111	0	37	0	4537	0	4500	0.0	0.0
chr9	LINC01505	106558471	106558583	0	113	0	12891	0	12778	0.0	0.0
chr9	LINC01505	106588376	106588464	0	89	0	12891	0	12802	0.0	0.0
chr9	LINC01505	106500356	106500505	0	150	0	12891	0	12741	0.0	0.0
chr9	LINC01505	106499486	106499612	0	127	0	12891	0	12764	0.0	0.0
chr9	LINC01505	106588379	106588464	0	86	0	12891	0	12805	0.0	0.0
chr9	LINC01505	106588827	106588940	0	114	0	12891	0	12777	0.0	0.0
chr9	LINC01505	106598531	106598663	0	133	0	12891	0	12758	0.0	0.0
chr9	LINC01505	106456513	106456553	0	41	0	12891	0	12850	0.0	0.0
chr9	LINC01505	106464017	106464165	0	149	0	12891	0	12742	0.0	0.0
chr9	LINC01505	106588827	106589013	0	187	0	12891	0	12704	0.0	0.0
chr9	LINC01505	106564924	106565022	0	99	0	12891	0	12792	0.0	0.0
chr9	LINC01505	106572733	106572889	0	157	0	12891	0	12734	0.0	0.0
chr9	LINC01505	106639338	106639436	0	99	0	12891	0	12792	0.0	0.0
chr9	LINC01505	106666556	106667722	0	1167	0	12891	0	11724	0.0	0.0
chr9	LINC01505	106702168	106702241	0	74	0	12891	0	12817	0.0	0.0
chr9	ZNF462	106938915	106939107	0	193	51	9293	51	9100	0.0	0.005604395604395605
chr9	ABITRAM	108935637	108935689	0	53	0	2532	0	2479	0.0	0.0
chr9	PALM2AKAP2	109931926	109932028	2126	103	4235	18362	2109	18259	20.640776699029125	0.11550468262226847
chr9	PALM2AKAP2	110162093	110162132	0	40	4235	18362	4235	18322	0.0	0.23114288833096824
chr9	PALM2AKAP2	109942685	109943381	0	697	4235	18362	4235	17665	0.0	0.23973959807529013
chr9	PALM2AKAP2	110156318	110156497	0	180	4235	18362	4235	18182	0.0	0.23292267077329226
chr9	PALM2AKAP2	110136126	110138539	0	2414	4235	18362	4235	15948	0.0	0.2655505392525709
chr9	MUSK	110767819	110768083	0	265	0	9194	0	8929	0.0	0.0
chr9	MUSK	110784814	110785016	0	203	0	9194	0	8991	0.0	0.0
chr9	MUSK	110776631	110776655	0	25	0	9194	0	9169	0.0	0.0
chr9	MUSK	110728687	110728717	0	31	0	9194	0	9163	0.0	0.0
chr9	DNAJC25	111642856	111643094	84	239	41480	2609	41396	2370	0.3514644351464435	17.466666666666665
chr9	HSDL2	112403994	112404158	0	165	28	3320	28	3155	0.0	0.008874801901743265
chr9	HSDL2	112416840	112416944	0	105	28	3320	28	3215	0.0	0.008709175738724729
chr9	HSDL2	112408906	112409021	0	116	28	3320	28	3204	0.0	0.008739076154806492
chr9	KIAA1958	112617870	112617954	0	85	102	13144	102	13059	0.0	0.00781070526073972
chr9	SLC31A2	113158043	113158096	19	54	325	2479	306	2425	0.35185185185185186	0.12618556701030928
chr9	BSPRY	113368258	113368383	0	126	0	2345	0	2219	0.0	0.0
chr9	RGS3	113583449	113584427	0	979	88	11098	88	10119	0.0	0.008696511512995355
chr9	RGS3	113581558	113581658	0	101	88	11098	88	10997	0.0	0.008002182413385468
chr9	ZNF618	113998258	113998354	0	97	0	10399	0	10302	0.0	0.0
chr9	ZNF618	114008343	114008379	0	37	0	10399	0	10362	0.0	0.0
chr9	ZNF618	114016112	114016172	0	61	0	10399	0	10338	0.0	0.0
chr9	ZNF618	114028732	114028972	0	241	0	10399	0	10158	0.0	0.0
chr9	ZNF618	114028909	114028972	0	64	0	10399	0	10335	0.0	0.0
chr9	COL27A1	114194403	114194457	0	55	26787	14073	26787	14018	0.0	1.91090027108004
chr9	ATP6V1G1	114592551	114592657	0	107	897	3459	897	3352	0.0	0.2676014319809069
chr9	ATP6V1G1	114592551	114592652	0	102	897	3459	897	3357	0.0	0.26720285969615726
chr9	ATP6V1G1	114596506	114596588	0	83	897	3459	897	3376	0.0	0.2656990521327014
chr9	DELEC1	115068995	115069070	0	76	25667	6673	25667	6597	0.0	3.89070789752918
chr9	DELEC1	115157594	115157715	140	122	25667	6673	25527	6551	1.1475409836065573	3.896656998931461
chr9	DELEC1	115290822	115290937	150	116	25667	6673	25517	6557	1.293103448275862	3.891566265060241
chr9	TRIM32	116697372	116697433	0	62	0	3780	0	3718	0.0	0.0
chr9	AL161630.1	117652287	117652447	0	161	0	1469	0	1308	0.0	0.0
chr9	TLR4	117708562	117708729	0	168	0	13281	0	13113	0.0	0.0
chr9	AL160272.1	117870088	117870484	0	397	24107	10793	24107	10396	0.0	2.3188726433243554
chr9	TLR4	117708198	117708318	0	121	0	13281	0	13160	0.0	0.0
chr9	CUTALP	120844992	120845196	429	205	2176427	7206	2175998	7001	2.0926829268292684	310.8124553635195
chr9	CUTALP	120850362	120850657	0	296	2176427	7206	2176427	6910	0.0	314.96772793053543
chr9	CUTALP	120846681	120846803	0	123	2176427	7206	2176427	7083	0.0	307.27474234081603
chr9	CUTALP	120849922	120850006	0	85	2176427	7206	2176427	7121	0.0	305.63502317090297
chr9	CUTALP	120848936	120848979	0	44	2176427	7206	2176427	7162	0.0	303.8853672158615
chr9	CNTRL	121080305	121080478	0	174	0	9472	0	9298	0.0	0.0
chr9	GSN	121248275	121248323	0	49	0	7205	0	7156	0.0	0.0
chr9	GSN	121300055	121300126	0	72	0	7205	0	7133	0.0	0.0
chr9	GSN	121281469	121281562	0	94	0	7205	0	7111	0.0	0.0
chr9	GSN	121282438	121282550	0	113	0	7205	0	7092	0.0	0.0
chr9	DAB2IP	121699324	121699458	0	135	7	8270	7	8135	0.0	0.0008604794099569761
chr9	DAB2IP	121766493	121766730	0	238	7	8270	7	8032	0.0	0.0008715139442231076
chr9	MORN5	122169644	122169756	0	113	0	874	0	761	0.0	0.0
chr9	MRRF	122313226	122313386	0	161	102	11044	102	10883	0.0	0.009372415694201967
chr9	MRRF	122280442	122280598	0	157	102	11044	102	10887	0.0	0.0093689721686415
chr9	MRRF	122265461	122265780	0	320	102	11044	102	10724	0.0	0.009511376352107423
chr9	MRRF	122265461	122265545	0	85	102	11044	102	10959	0.0	0.0093074185600876
chr9	MRRF	122285779	122285946	0	168	102	11044	102	10876	0.0	0.009378447958808385
chr9	MRRF	122286038	122286166	0	129	102	11044	102	10915	0.0	0.009344938158497481
chr9	PTGS1	122377898	122378015	0	118	77	5785	77	5667	0.0	0.013587436033174518
chr9	PTGS1	122378774	122378918	0	145	77	5785	77	5640	0.0	0.013652482269503547
chr9	PTGS1	122371612	122371834	0	223	77	5785	77	5562	0.0	0.013843941028407048
chr9	PTGS1	122377927	122378015	0	89	77	5785	77	5696	0.0	0.013518258426966292
chr9	RABGAP1	122971664	122971952	0	289	44	7090	44	6801	0.0	0.006469636818114983
chr9	RABGAP1	123071411	123071501	0	91	44	7090	44	6999	0.0	0.006286612373196171
chr9	RABGAP1	122984484	122984719	0	236	44	7090	44	6854	0.0	0.006419608987452583
chr9	LHX2	124021818	124021867	0	50	51	2480	51	2430	0.0	0.020987654320987655
chr9	NEK6	124292848	124293013	0	166	37	4451	37	4285	0.0	0.008634772462077013
chr9	ADGRD2	124453998	124454097	0	100	984	4523	984	4423	0.0	0.22247343432059688
chr9	OLFML2A	124795023	124795131	0	109	4683	6780	4683	6671	0.0	0.70199370409234
chr9	RABEPK	125203007	125203066	0	60	0	3438	0	3378	0.0	0.0
chr9	RABEPK	125213369	125213522	0	154	0	3438	0	3284	0.0	0.0
chr9	RABEPK	125220326	125220397	0	72	0	3438	0	3366	0.0	0.0
chr9	GAPVD1	125337017	125337095	0	79	153	13657	153	13578	0.0	0.011268228015908087
chr9	GAPVD1	125268935	125268984	0	50	153	13657	153	13607	0.0	0.011244212537664437
chr9	GAPVD1	125295457	125295574	0	118	153	13657	153	13539	0.0	0.011300686904498116
chr9	GAPVD1	125342218	125342299	0	82	153	13657	153	13575	0.0	0.011270718232044199
chr9	GAPVD1	125335171	125335252	0	82	153	13657	153	13575	0.0	0.011270718232044199
chr9	GAPVD1	125309928	125310009	0	82	153	13657	153	13575	0.0	0.011270718232044199
chr9	PBX3	125915685	125915927	0	243	15540	4922	15540	4679	0.0	3.3212224834366317
chr9	PBX3	125962101	125962214	220	114	15540	4922	15320	4808	1.9298245614035088	3.1863560732113143
chr9	PBX3	125949377	125949440	0	64	15540	4922	15540	4858	0.0	3.1988472622478388
chr9	ZBTB43	126808792	126808915	0	124	51	2855	51	2731	0.0	0.01867447821310875
chr9	RALGPS1	127050042	127050132	153	91	143733	10527	143580	10436	1.6813186813186813	13.758144883096971
chr9	GARNL3	127264951	127265021	0	71	1369	6297	1369	6226	0.0	0.21988435592675876
chr9	GARNL3	127348923	127349035	0	113	1369	6297	1369	6184	0.0	0.2213777490297542
chr9	GARNL3	127387192	127387331	0	140	1369	6297	1369	6157	0.0	0.22234854636998538
chr9	SLC2A8	127402556	127402753	0	198	302	3446	302	3248	0.0	0.09298029556650246
chr9	SLC2A8	127405419	127405565	0	147	302	3446	302	3299	0.0	0.09154289178538952
chr9	SLC2A8	127397904	127398111	57	208	302	3446	245	3238	0.27403846153846156	0.07566399011735639
chr9	SLC2A8	127397375	127397538	0	164	302	3446	302	3282	0.0	0.09201706276660573
chr9	ZNF79	127428551	127428660	0	110	1104	2308	1104	2198	0.0	0.5022747952684259
chr9	LRSAM1	127454997	127455054	150	58	12203	8123	12053	8065	2.586206896551724	1.4944823310601363
chr9	LRSAM1	127455575	127455620	0	46	12203	8123	12203	8077	0.0	1.5108332301597127
chr9	LRSAM1	127482949	127483020	92	72	12203	8123	12111	8051	1.2777777777777777	1.5042851819649734
chr9	LRSAM1	127487675	127487763	393	89	12203	8123	11810	8034	4.415730337078652	1.4700024894199653
chr9	LRSAM1	127491214	127491295	0	82	12203	8123	12203	8041	0.0	1.5175973137669445
chr9	LRSAM1	127495319	127495418	306	100	12203	8123	11897	8023	3.06	1.4828617724043376
chr9	LRSAM1	127497252	127497334	0	83	12203	8123	12203	8040	0.0	1.5177860696517413
chr9	LRSAM1	127497252	127497362	0	111	12203	8123	12203	8012	0.0	1.52309036445332
chr9	LRSAM1	127486404	127486694	1020	291	12203	8123	11183	7832	3.5051546391752577	1.4278600612870276
chr9	LRSAM1	127482732	127482813	29	82	12203	8123	12174	8041	0.35365853658536583	1.5139907971645317
chr9	LRSAM1	127487494	127487553	480	60	12203	8123	11723	8063	8.0	1.453925337963537
chr9	LRSAM1	127492801	127492897	408	97	12203	8123	11795	8026	4.206185567010309	1.469598803887366
chr9	LRSAM1	127454997	127455040	132	44	12203	8123	12071	8079	3.0	1.4941205594751825
chr9	LRSAM1	127495319	127495414	306	96	12203	8123	11897	8027	3.1875	1.4821228354304223
chr9	LRSAM1	127497421	127497954	0	534	12203	8123	12203	7589	0.0	1.6079852417973381
chr9	LRSAM1	127487536	127487763	619	228	12203	8123	11584	7895	2.7149122807017543	1.4672577580747308
chr9	LRSAM1	127460876	127460998	261	123	12203	8123	11942	8000	2.1219512195121952	1.49275
chr9	LRSAM1	127487494	127487763	1039	270	12203	8123	11164	7853	3.848148148148148	1.4216223099452439
chr9	LRSAM1	127493750	127494081	357	332	12203	8123	11846	7791	1.0753012048192772	1.520472339879348
chr9	STXBP1	127684367	127684493	0	127	131172	8749	131172	8622	0.0	15.213639526791928
chr9	STXBP1	127673347	127673427	0	81	131172	8749	131172	8668	0.0	15.13290263036456
chr9	STXBP1	127686457	127686537	0	81	131172	8749	131172	8668	0.0	15.13290263036456
chr9	STXBP1	127653890	127654964	0	1075	131172	8749	131172	7674	0.0	17.093041438623924
chr9	STXBP1	127654941	127654964	0	24	131172	8749	131172	8725	0.0	15.03404011461318
chr9	STXBP1	127639427	127639617	101871	191	131172	8749	29301	8558	533.3560209424083	3.423813975227857
chr9	STXBP1	127642468	127642563	6292	96	131172	8749	124880	8653	65.54166666666667	14.431988905581878
chr9	STXBP1	127683917	127683970	0	54	131172	8749	131172	8695	0.0	15.085911443358253
chr9	CFAP157	127713019	127713206	2846	188	24993	3233	22147	3045	15.138297872340425	7.273234811165846
chr9	TTC16	127724755	127724897	0	143	10940	4244	10940	4101	0.0	2.6676420385271884
chr9	FPGS	127806972	127807087	0	116	720	3747	720	3631	0.0	0.19829248141007988
chr9	FPGS	127807208	127807286	0	79	720	3747	720	3668	0.0	0.19629225736095965
chr9	FPGS	127808557	127808705	0	149	720	3747	720	3598	0.0	0.2001111728738188
chr9	FPGS	127810944	127811011	66	68	720	3747	654	3679	0.9705882352941176	0.17776569720032617
chr9	FPGS	127806991	127807087	0	97	720	3747	720	3650	0.0	0.19726027397260273
chr9	AL157935.1	127938457	127938662	9	206	3459	2525	3450	2319	0.043689320388349516	1.4877102199223804
chr9	SLC25A25	128102079	128102115	0	37	25086	4949	25086	4912	0.0	5.107084690553746
chr9	SLC25A25	128099274	128099385	6281	112	25086	4949	18805	4837	56.080357142857146	3.887740334918338
chr9	DNM1	128226034	128226173	0	140	7596	9109	7596	8969	0.0	0.846917159103579
chr9	DNM1	128239984	128239996	0	13	7596	9109	7596	9096	0.0	0.8350923482849604
chr9	DNM1	128224250	128224389	180	140	7596	9109	7416	8969	1.2857142857142858	0.8268480321106032
chr9	DNM1	128253100	128253137	0	38	7596	9109	7596	9071	0.0	0.8373938926248484
chr9	DNM1	128221109	128221216	0	108	7596	9109	7596	9001	0.0	0.8439062326408177
chr9	DNM1	128226034	128226086	0	53	7596	9109	7596	9056	0.0	0.8387809187279152
chr9	DNM1	128234815	128234935	115	121	7596	9109	7481	8988	0.9504132231404959	0.8323319982198487
chr9	DNM1	128231985	128232124	0	140	7596	9109	7596	8969	0.0	0.846917159103579
chr9	SWI5	128278633	128278681	0	49	263	2509	263	2460	0.0	0.10691056910569105
chr9	CERCAM	128421203	128421511	0	309	17935	5550	17935	5241	0.0	3.422056859377981
chr9	ODF2	128469182	128469353	26050	172	30955	6418	4905	6246	151.45348837209303	0.7853025936599424
chr9	ODF2	128460512	128460666	0	155	30955	6418	30955	6263	0.0	4.942519559316621
chr9	ODF2	128457197	128457437	102	241	30955	6418	30853	6177	0.42323651452282157	4.99481949166262
chr9	ODF2	128460549	128460666	0	118	30955	6418	30955	6300	0.0	4.913492063492064
chr9	ODF2	128460157	128460299	0	143	30955	6418	30955	6275	0.0	4.933067729083666
chr9	SPTAN1	128568771	128568897	512	127	11571	15464	11059	15337	4.031496062992126	0.7210667014409597
chr9	SPTAN1	128592982	128593042	0	61	11571	15464	11571	15403	0.0	0.7512172953320781
chr9	SPTAN1	128609650	128609665	0	16	11571	15464	11571	15448	0.0	0.7490290005178664
chr9	SPTAN1	128555348	128555399	0	52	11571	15464	11571	15412	0.0	0.7507786140669608
chr9	SPTAN1	128629124	128629187	0	64	11571	15464	11571	15400	0.0	0.7513636363636363
chr9	SPTAN1	128572755	128572824	34	70	11571	15464	11537	15394	0.4857142857142857	0.7494478368195401
chr9	SPTAN1	128601344	128601400	81	57	11571	15464	11490	15407	1.4210526315789473	0.7457649120529629
chr9	PKN3	128715368	128715460	0	93	5747	3253	5747	3160	0.0	1.8186708860759493
chr9	TBC1D13	128790734	128790775	0	42	32	3944	32	3902	0.0	0.008200922603792926
chr9	LRRC8A	128886014	128886121	0	108	0	5216	0	5108	0.0	0.0
chr9	PHYHD1	128936582	128936645	0	64	0	2479	0	2415	0.0	0.0
chr9	PHYHD1	128937756	128937778	0	23	0	2479	0	2456	0.0	0.0
chr9	PHYHD1	128940598	128940715	0	118	0	2479	0	2361	0.0	0.0
chr9	PHYHD1	128937756	128937944	0	189	0	2479	0	2290	0.0	0.0
chr9	MIGA2	129051299	129051420	0	122	102	6138	102	6016	0.0	0.01695478723404255
chr9	MIGA2	129063243	129063316	0	74	102	6138	102	6064	0.0	0.016820580474934038
chr9	MIGA2	129039787	129039886	0	100	102	6138	102	6038	0.0	0.01689301093077178
chr9	MIGA2	129063544	129063631	0	88	102	6138	102	6050	0.0	0.016859504132231404
chr9	DOLPP1	129085022	129085107	0	86	441	2246	441	2160	0.0	0.20416666666666666
chr9	DOLPP1	129085517	129085616	0	100	441	2246	441	2146	0.0	0.2054986020503262
chr9	DOLPP1	129086138	129086267	0	130	441	2246	441	2116	0.0	0.20841209829867674
chr9	PTPA	129120512	129120610	0	99	4202	5645	4202	5546	0.0	0.7576631806707537
chr9	PTPA	129123051	129123138	0	88	4202	5645	4202	5557	0.0	0.7561633975166456
chr9	PTPA	129128984	129129110	0	127	4202	5645	4202	5518	0.0	0.7615077926785067
chr9	PTPA	129127963	129128068	0	106	4202	5645	4202	5539	0.0	0.7586206896551724
chr9	PTPA	129120512	129120628	0	117	4202	5645	4202	5528	0.0	0.7601302460202605
chr9	AL158151.1	129258793	129258882	0	90	2289	5653	2289	5563	0.0	0.41146863203307565
chr9	LINC01503	129341831	129342043	0	213	0	4676	0	4463	0.0	0.0
chr9	LINC01503	129341735	129342043	0	309	0	4676	0	4367	0.0	0.0
chr9	LINC01503	129341751	129342043	0	293	0	4676	0	4383	0.0	0.0
chr9	LINC01503	129356252	129356830	0	579	0	4676	0	4097	0.0	0.0
chr9	LINC01503	129341349	129342043	0	695	0	4676	0	3981	0.0	0.0
chr9	LINC00963	129493418	129493595	0	178	102	11349	102	11171	0.0	0.009130785068480888
chr9	LINC00963	129503322	129503672	0	351	102	11349	102	10998	0.0	0.009274413529732678
chr9	LINC00963	129493415	129493595	0	181	102	11349	102	11168	0.0	0.009133237822349571
chr9	LINC00963	129504891	129505043	0	153	102	11349	102	11196	0.0	0.009110396570203644
chr9	LINC00963	129493477	129493595	0	119	102	11349	102	11230	0.0	0.009082813891362422
chr9	LINC00963	129502396	129503139	0	744	102	11349	102	10605	0.0	0.009618104667609617
chr9	LINC00963	129490843	129491128	0	286	102	11349	102	11063	0.0	0.009219922263400524
chr9	LINC00963	129503325	129503672	0	348	102	11349	102	11001	0.0	0.009271884374147804
chr9	LINC00963	129502909	129503139	0	231	102	11349	102	11118	0.0	0.009174311926605505
chr9	LINC00963	129490810	129491128	0	319	102	11349	102	11030	0.0	0.009247506799637352
chr9	LINC00963	129502396	129502519	0	124	102	11349	102	11225	0.0	0.00908685968819599
chr9	AL391056.1	129577520	129577653	24	134	4155	3654	4131	3520	0.1791044776119403	1.1735795454545455
chr9	AL391056.1	129580440	129580558	0	119	4155	3654	4155	3535	0.0	1.1753889674681754
chr9	AL391056.1	129580478	129580558	0	81	4155	3654	4155	3573	0.0	1.1628883291351806
chr9	NTMT1	129632649	129632865	0	217	2997	3032	2997	2815	0.0	1.0646536412078154
chr9	NTMT1	129632649	129632801	0	153	2997	3032	2997	2879	0.0	1.0409864536297326
chr9	GPR107	130114576	130114663	17	88	8214	8332	8197	8244	0.19318181818181818	0.9942988840368753
chr9	GPR107	130110369	130110426	108	58	8214	8332	8106	8274	1.8620689655172413	0.9796954314720813
chr9	HMCN2	130427496	130427619	15480	124	83412	18709	67932	18585	124.83870967741936	3.6552058111380146
chr9	ASS1	130464110	130464167	42	58	46029	2714	45987	2656	0.7241379310344828	17.314382530120483
chr9	ASS1	130451601	130452043	3340	443	46029	2714	42689	2271	7.539503386004514	18.797446059004844
chr9	ASS1	130450271	130450333	72	63	46029	2714	45957	2651	1.1428571428571428	17.33572236891739
chr9	FUBP3	130580658	130581513	54127	856	178619	6625	124492	5769	63.23247663551402	21.57947651239383
chr9	FUBP3	130607297	130608393	867	1097	178619	6625	177752	5528	0.7903372835004557	32.154848046309695
chr9	EXOSC2	130698161	130698251	288	91	534111	2971	533823	2880	3.1648351648351647	185.35520833333334
chr9	EXOSC2	130697581	130697627	57031	47	534111	2971	477080	2924	1213.4255319148936	163.16005471956225
chr9	LAMC3	131080314	131080383	42	70	353485	8969	353443	8899	0.6	39.71715923137431
chr9	AIF1L	131106187	131106265	529	79	188475	4638	187946	4559	6.69620253164557	41.22526869927616
chr9	NUP214	131135939	131136006	0	68	271524	12057	271524	11989	0.0	22.647760447076486
chr9	NUP214	131147489	131147584	2308	96	271524	12057	269216	11961	24.041666666666668	22.50781707215116
chr9	NUP214	131187288	131187364	0	77	271524	12057	271524	11980	0.0	22.66477462437396
chr9	NUP214	131192207	131192292	0	86	271524	12057	271524	11971	0.0	22.68181438476318
chr9	NUP214	131195232	131195294	0	63	271524	12057	271524	11994	0.0	22.63831915957979
chr9	NUP214	131232283	131232308	0	26	271524	12057	271524	12031	0.0	22.568697531377275
chr9	NUP214	131147486	131147584	2419	99	271524	12057	269105	11958	24.434343434343436	22.50418130122094
chr9	NUP214	131229662	131229825	471	164	271524	12057	271053	11893	2.8719512195121952	22.79096947784411
chr9	NUP214	131232161	131232308	1805	148	271524	12057	269719	11909	12.195945945945946	22.648333193383156
chr9	PRRC2B	131459163	131459356	347	194	300633	12462	300286	12268	1.788659793814433	24.47717639387023
chr9	PRRC2B	131474453	131476535	112726	2083	300633	12462	187907	10379	54.117138742198755	18.10453800944214
chr9	PRRC2B	131494404	131494486	42	83	300633	12462	300591	12379	0.5060240963855421	24.28233298327813
chr9	POMT1	131504188	131504340	0	153	45660	6345	45660	6192	0.0	7.374031007751938
chr9	POMT1	131506113	131506220	0	108	45660	6345	45660	6237	0.0	7.320827320827321
chr9	POMT1	131507367	131507514	2233	148	45660	6345	43427	6197	15.087837837837839	7.007745683395191
chr9	POMT1	131508910	131509022	408	113	45660	6345	45252	6232	3.6106194690265485	7.261232349165597
chr9	POMT1	131513238	131513331	580	94	45660	6345	45080	6251	6.170212765957447	7.211646136618141
chr9	POMT1	131520079	131520193	153	115	45660	6345	45507	6230	1.3304347826086957	7.3044943820224715
chr9	POMT1	131506402	131506453	35	52	45660	6345	45625	6293	0.6730769230769231	7.250119180041316
chr9	POMT1	131507350	131507514	2312	165	45660	6345	43348	6180	14.012121212121212	7.014239482200647
chr9	POMT1	131506182	131506220	0	39	45660	6345	45660	6306	0.0	7.2407231208372975
chr9	POMT1	131504453	131504649	627	197	45660	6345	45033	6148	3.182741116751269	7.324821080026025
chr9	POMT1	131512040	131512136	0	97	45660	6345	45660	6248	0.0	7.3079385403329065
chr9	CFAP77	132482309	132482417	507	109	568975	2157	568468	2048	4.651376146788991	277.572265625
chr9	GFI1B	132989060	132989198	0	139	9434	6121	9434	5982	0.0	1.5770645269140755
chr9	GTF3C5	133042086	133042306	0	221	102	3434	102	3213	0.0	0.031746031746031744
chr9	GTF3C5	133054943	133054964	0	22	102	3434	102	3412	0.0	0.029894490035169988
chr9	GTF3C5	133043727	133043926	0	200	102	3434	102	3234	0.0	0.03153988868274583
chr9	ADAMTS13	133433640	133433704	0	65	6958	5712	6958	5647	0.0	1.2321586683194616
chr9	ADAMTS13	133457909	133458094	510	186	6958	5712	6448	5526	2.7419354838709675	1.166847629388346
chr9	ADAMTS13	133443375	133443561	0	187	6958	5712	6958	5525	0.0	1.2593665158371041
chr9	CACFD1	133465321	133465447	0	127	9908	3528	9908	3401	0.0	2.9132608056453986
chr9	CACFD1	133468339	133468464	1960	126	9908	3528	7948	3402	15.555555555555555	2.336272780717225
chr9	DBH	133639845	133639992	0	148	159	2758	159	2610	0.0	0.06091954022988506
chr9	FCN2	134882525	134882639	0	115	561	1070	561	955	0.0	0.587434554973822
chr9	OLFM1	135106748	135106855	0	108	0	6137	0	6029	0.0	0.0
chr9	OBP2A	135546777	135546911	236	135	15092	775	14856	640	1.7481481481481482	23.2125
chr9	PAEP	135564243	135564354	9786	112	105280	1461	95494	1349	87.375	70.78873239436619
chr9	LINC01502	135577633	135577774	0	142	102	2753	102	2611	0.0	0.03906549214860207
chr9	PAEPP1	135589410	135589484	0	75	0	531	0	456	0.0	0.0
chr9	KCNT1	135714576	135714720	0	145	58359	15507	58359	15362	0.0	3.7989194115349565
chr9	KCNT1	135785309	135785330	124	22	58359	15507	58235	15485	5.636363636363637	3.7607361963190185
chr9	KCNT1	135788099	135788162	0	64	58359	15507	58359	15443	0.0	3.7789937188370137
chr9	KCNT1	135742771	135742813	0	43	58359	15507	58359	15464	0.0	3.7738618727366786
chr9	PMPCA	136412809	136412892	0	84	0	6212	0	6128	0.0	0.0
chr9	PMPCA	136414552	136414647	0	96	0	6212	0	6116	0.0	0.0
chr9	EGFL7	136668240	136668362	0	123	18495	2577	18495	2454	0.0	7.536674816625917
chr9	EGFL7	136663407	136663623	0	217	18495	2577	18495	2360	0.0	7.836864406779661
chr9	TMEM141	136791710	136791777	0	68	0	1297	0	1229	0.0	0.0
chr9	CCDC183	136799712	136799790	0	79	641	2690	641	2611	0.0	0.24549980850248948
chr9	CCDC183	136805356	136805457	0	102	641	2690	641	2588	0.0	0.24768160741885625
chr9	PHPT1	136850505	136850560	0	56	829	1616	829	1560	0.0	0.5314102564102564
chr9	MAMDC4	136854761	136854850	70	90	34949	5342	34879	5252	0.7777777777777778	6.641089108910891
chr9	MAMDC4	136858185	136858276	0	92	34949	5342	34949	5250	0.0	6.656952380952381
chr9	MAMDC4	136856256	136856381	51	126	34949	5342	34898	5216	0.40476190476190477	6.6905674846625764
chr9	C8G	136945928	136945999	0	72	0	1082	0	1010	0.0	0.0
chr9	LCN12	136953847	136953964	0	118	34	1990	34	1872	0.0	0.018162393162393164
chr9	LCN12	136953923	136953964	0	42	34	1990	34	1948	0.0	0.017453798767967144
chr9	LCN12	136954723	136954826	0	104	34	1990	34	1886	0.0	0.018027571580063628
chr9	PAXX	136992639	136992700	0	62	0	1290	0	1228	0.0	0.0
chr9	PAXX	136993342	136993411	0	70	0	1290	0	1220	0.0	0.0
chr9	C9ORF139	137037284	137037394	0	111	1428	2900	1428	2789	0.0	0.5120114736464683
chr9	UAP1L1	137078049	137078254	0	206	0	4721	0	4515	0.0	0.0
chr9	MAN1B1	137088267	137088398	0	132	0	7364	0	7232	0.0	0.0
chr9	GRIN1	137165185	137165296	0	112	51	9609	51	9497	0.0	0.005370116879014426
chr9	GRIN1	137148151	137148214	0	64	51	9609	51	9545	0.0	0.005343111576741749
chr9	GRIN1	137164171	137164215	0	45	51	9609	51	9564	0.0	0.00533249686323714
chr9	NDOR1	137213966	137214068	0	103	0	2822	0	2719	0.0	0.0
chr9	STPG3	137252000	137252135	0	136	0	1512	0	1376	0.0	0.0
chr9	STPG3	137252000	137252055	0	56	0	1512	0	1456	0.0	0.0
chr9	ARRDC1	137613422	137613510	408	89	2629	2585	2221	2496	4.584269662921348	0.889823717948718
chr9	ARRDC1	137613459	137613510	176	52	2629	2585	2453	2533	3.3846153846153846	0.9684168969601263
chr9	ARRDC1	137613412	137613510	408	99	2629	2585	2221	2486	4.121212121212121	0.8934030571198712
chr9	EHMT1	137710966	137711030	204	65	73955	18118	73751	18053	3.1384615384615384	4.085248989087686
chr9	EHMT1	137752330	137752408	0	79	73955	18118	73955	18039	0.0	4.099728366317423
chr9	EHMT1	137775108	137775252	0	145	73955	18118	73955	17973	0.0	4.114783286040171
chr9	EHMT1	137650859	137651037	0	179	73955	18118	73955	17939	0.0	4.12258208372819
chr9	EHMT1	137637501	137637624	165	124	73955	18118	73790	17994	1.3306451612903225	4.100811381571635
chr9	EHMT1	137802856	137803010	0	155	73955	18118	73955	17963	0.0	4.117073985414463
chr9	EHMT1	137803243	137803352	0	110	73955	18118	73955	18008	0.0	4.106785872945357
chr9	CACNA1B	138069757	138069763	0	7	499	9765	499	9758	0.0	0.05113752818200451
chr9	FAM157B	138251537	138251596	0	60	0	2085	0	2025	0.0	0.0
chr9	FAM157B	138218598	138218710	0	113	0	2085	0	1972	0.0	0.0
chr9	FAM157B	138233738	138233826	0	89	0	2085	0	1996	0.0	0.0
chr9	AL449043.1	102472	102541	0	70	0	2456	0	2386	0.0	0.0
chr9	CBWD1	146101	146158	220	58	152803	10402	152583	10344	3.793103448275862	14.750870069605568
chr9	CBWD1	154708	154795	5596	88	152803	10402	147207	10314	63.59090909090909	14.272542175683537
chr9	CBWD1	163977	164037	4096	61	152803	10402	148707	10341	67.14754098360656	14.380330722367276
chr9	CBWD1	161566	161654	1084	89	152803	10402	151719	10313	12.179775280898877	14.711432172985552
chr9	CBWD1	177722	177820	5230	99	152803	10402	147573	10303	52.82828282828283	14.323303892070271
chr9	CBWD1	151304	151427	141	124	152803	10402	152662	10278	1.1370967741935485	14.853278848024907
chr9	CBWD1	160000	160140	510	141	152803	10402	152293	10261	3.617021276595745	14.841925738232142
chr9	CBWD1	147900	148040	393	141	152803	10402	152410	10261	2.7872340425531914	14.853328135659293
chr9	CBWD1	150508	150725	218	218	152803	10402	152585	10184	1.0	14.982816182246662
chr9	CBWD1	150641	150725	186	85	152803	10402	152617	10317	2.1882352941176473	14.792769215857323
chr9	CBWD1	164402	164448	32	47	152803	10402	152771	10355	0.6808510638297872	14.753355866731047
chr9	AL161725.1	456914	457047	0	134	0	4028	0	3894	0.0	0.0
chr9	AL161725.1	459715	459866	0	152	0	4028	0	3876	0.0	0.0
chr9	VLDLR-AS1	2503269	2503403	0	135	30234	6797	30234	6662	0.0	4.538276793755629
chr9	VLDLR-AS1	2525537	2525717	0	181	30234	6797	30234	6616	0.0	4.569830713422007
chr9	VLDLR-AS1	2536358	2536453	0	96	30234	6797	30234	6701	0.0	4.511863900910312
chr9	VLDLR-AS1	2425396	2425540	0	145	30234	6797	30234	6652	0.0	4.545099218280217
chr9	VLDLR-AS1	2425396	2425536	0	141	30234	6797	30234	6656	0.0	4.542367788461538
chr9	VLDLR-AS1	2530903	2531129	0	227	30234	6797	30234	6570	0.0	4.6018264840182646
chr9	RFX3	3301545	3301620	204	76	51957	10714	51753	10638	2.6842105263157894	4.864918217710096
chr9	RFX3	3490278	3490345	0	68	51957	10714	51957	10646	0.0	4.880424572609431
chr9	RFX3	3488775	3488895	0	121	51957	10714	51957	10593	0.0	4.904842820730671
chr9	GLIS3	4125733	4125941	3116	209	185872	11957	182756	11748	14.909090909090908	15.556350017024174
chr9	GLIS3	4286037	4286523	10702	487	185872	11957	175170	11470	21.975359342915812	15.272013949433305
chr9	SPATA6L	4604178	4604269	0	92	16117	5395	16117	5303	0.0	3.0392230812747503
chr9	SPATA6L	4626425	4626555	51	131	16117	5395	16066	5264	0.3893129770992366	3.052051671732523
chr9	SPATA6L	4656040	4656089	0	50	16117	5395	16117	5345	0.0	3.0153414405986902
chr9	SPATA6L	4596434	4596530	0	97	16117	5395	16117	5298	0.0	3.042091355228388
chr9	SPATA6L	4629090	4629168	0	79	16117	5395	16117	5316	0.0	3.031790820165538
chr9	SPATA6L	4617402	4617523	0	122	16117	5395	16117	5273	0.0	3.0565143182249193
chr9	SPATA6L	4627752	4627856	0	105	16117	5395	16117	5290	0.0	3.0466918714555766
chr9	SPATA6L	4646486	4646528	12	43	16117	5395	16105	5352	0.27906976744186046	3.009155455904335
chr9	AK3	4722505	4722625	54141	121	903733	4402	849592	4281	447.44628099173553	198.45643541228685
chr9	RLN2	5304095	5304196	0	102	0	1032	0	930	0.0	0.0
chr9	ERMP1	5805026	5805217	15536	192	489701	6309	474165	6117	80.91666666666667	77.51593918587542
chr9	ERMP1	5825091	5825219	5214	129	489701	6309	484487	6180	40.41860465116279	78.39595469255663
chr9	ERMP1	5791233	5791282	128	50	489701	6309	489573	6259	2.56	78.21904457581083
chr9	KIAA2026	5988344	5988545	3568	202	86960	6988	83392	6786	17.663366336633665	12.288829944002357
chr9	KIAA2026	5944870	5944960	408	91	86960	6988	86552	6897	4.483516483516484	12.549224300420473
chr9	KIAA2026	5933750	5933881	153	132	86960	6988	86807	6856	1.1590909090909092	12.661464410735123
chr9	GLDC	6534066	6534179	0	114	392959	8660	392959	8546	0.0	45.9816288322022
chr9	GLDC	6540050	6540146	6578	97	392959	8660	386381	8563	67.81443298969072	45.12215345089338
chr9	GLDC	6604587	6604784	31612	198	392959	8660	361347	8462	159.65656565656565	42.702316237296145
chr9	GLDC	6620183	6620319	10302	137	392959	8660	382657	8523	75.1970802919708	44.89698462982518
chr9	AL135923.2	7927002	7927056	0	55	0	1193	0	1138	0.0	0.0
chr9	AL135923.2	7960567	7960662	0	96	0	1193	0	1097	0.0	0.0
chr9	PTPRD	8497241	8497268	0	28	88108	8221	88108	8193	0.0	10.75405834248749
chr9	PTPRD	8500753	8501059	2898	307	88108	8221	85210	7914	9.439739413680782	10.766995198382613
chr9	PTPRD	8523512	8523524	0	13	88108	8221	88108	8208	0.0	10.734405458089668
chr9	PTPRD	8526626	8526644	0	19	88108	8221	88108	8202	0.0	10.742257985857108
chr9	PTPRD	8527344	8527353	0	10	88108	8221	88108	8211	0.0	10.730483497746924
chr9	PTPRD	8454579	8454594	0	16	88108	8221	88108	8205	0.0	10.738330286410726
chr9	PTPRD	8437197	8437239	0	43	88108	8221	88108	8178	0.0	10.773783321105405
chr9	PTPRD	8454579	8454591	0	13	88108	8221	88108	8208	0.0	10.734405458089668
chr9	PTPRD	8438700	8438820	0	121	88108	8221	88108	8100	0.0	10.877530864197531
chr9	PTPRD	9414751	9414823	0	73	88108	8221	88108	8148	0.0	10.81345115365734
chr9	MPDZ	13112023	13112146	2663	124	127719	9138	125056	9014	21.475806451612904	13.873530064344353
chr9	MPDZ	13115247	13115334	1019	88	127719	9138	126700	9050	11.579545454545455	14.0
chr9	MPDZ	13122086	13122170	441	85	127719	9138	127278	9053	5.188235294117647	14.059206892742738
chr9	MPDZ	13136711	13136803	2746	93	127719	9138	124973	9045	29.526881720430108	13.816804864566059
chr9	MPDZ	13143465	13143564	0	100	127719	9138	127719	9038	0.0	14.13133436601018
chr9	MPDZ	13147547	13147658	1145	112	127719	9138	126574	9026	10.223214285714286	14.023266120097496
chr9	MPDZ	13165366	13165408	0	43	127719	9138	127719	9095	0.0	14.042770753161077
chr9	NFIB	14102421	14102510	152	90	480871	12775	480719	12685	1.6888888888888889	37.89664958612534
chr9	NFIB	14093459	14093464	0	6	480871	12775	480871	12769	0.0	37.65925287806406
chr9	TTC39B	15224339	15224505	0	167	32442	12232	32442	12065	0.0	2.688934935764608
chr9	TTC39B	15224359	15224505	0	147	32442	12232	32442	12085	0.0	2.684484898634671
chr9	C9ORF92	16215215	16215279	0	65	1886	634	1886	569	0.0	3.314586994727592
chr9	BNC2	16727796	16727997	9583	202	179063	6298	169480	6096	47.44059405940594	27.801837270341206
chr9	BNC2	16738359	16738485	2605	127	179063	6298	176458	6171	20.511811023622048	28.59471722573327
chr9	SAXO1	18941636	18941839	0	204	1994	9095	1994	8891	0.0	0.22427173546282758
chr9	SLC24A2	19597228	19597279	0	52	0	10759	0	10707	0.0	0.0
chr9	MLLT3	20353524	20353596	168	73	5080	7326	4912	7253	2.3013698630136985	0.6772370053770853
chr9	MLLT3	20354807	20354879	0	73	5080	7326	5080	7253	0.0	0.7003998345512202
chr9	MLLT3	20380206	20380327	0	122	5080	7326	5080	7204	0.0	0.7051637978900611
chr9	MIR31HG	21476898	21477035	8792	138	156659	2820	147867	2682	63.710144927536234	55.1331096196868
chr9	CDKN2A	21968574	21968771	4104	198	3154250	3894	3150146	3696	20.727272727272727	852.3122294372295
chr9	CDKN2A	21993881	21994053	3566	173	3154250	3894	3150684	3721	20.612716763005782	846.730448804085
chr9	ELAVL2	23765008	23765099	99	92	329660	5152	329561	5060	1.076086956521739	65.1306324110672
chr9	ELAVL2	23693447	23693486	0	40	329660	5152	329660	5112	0.0	64.48748043818466
chr9	IZUMO3	24544742	24544760	0	19	0	1301	0	1282	0.0	0.0
chr9	CAAP1	26886103	26886188	24380	86	338516	3168	314136	3082	283.48837209302326	101.92602206359507
chr9	PLAA	26907833	26907998	72889	166	1071497	5213	998608	5047	439.0903614457831	197.86170001981375
chr9	PLAA	26917096	26917165	24413	70	1071497	5213	1047084	5143	348.75714285714287	203.59401127746452
chr9	LINC00032	27250045	27250174	0	130	0	3760	0	3630	0.0	0.0
chr9	LINC00032	27280427	27280615	0	189	0	3760	0	3571	0.0	0.0
chr9	EQTN	27292400	27292487	0	88	0	1420	0	1332	0.0	0.0
chr9	C9ORF72	27554592	27554625	9	34	47900	5415	47891	5381	0.2647058823529412	8.900018583906338
chr9	C9ORF72	27571135	27571260	0	126	47900	5415	47900	5289	0.0	9.056532425789374
chr9	DDX58	32492390	32492538	1641	149	65042	4658	63401	4509	11.013422818791947	14.060989132845421
chr9	TOPORS	32550773	32550968	3629	196	230562	4134	226933	3938	18.51530612244898	57.626460132046724
chr9	NDUFB6	32558909	32558954	80033	46	595122	1390	515089	1344	1739.8478260869565	383.25074404761904
chr9	NDUFB6	32570959	32571052	100539	94	595122	1390	494583	1296	1069.563829787234	381.62268518518516
chr9	APTX	32984630	32984857	115510	228	678291	14598	562781	14370	506.62280701754383	39.16360473208072
chr9	APTX	32985970	32986030	22622	61	678291	14598	655669	14537	370.8524590163934	45.10346013620417
chr9	APTX	32988082	32988124	15086	43	678291	14598	663205	14555	350.83720930232556	45.565441429062176
chr9	APTX	32987543	32987731	56215	189	678291	14598	622076	14409	297.43386243386243	43.172739260184606
chr9	APTX	32997242	32997348	4608	107	678291	14598	673683	14491	43.06542056074766	46.489752260023465
chr9	APTX	32988082	32988129	16035	48	678291	14598	662256	14550	334.0625	45.5158762886598
chr9	APTX	32989758	32989895	48434	138	678291	14598	629857	14460	350.9710144927536	43.55857538035961
chr9	APTX	32987543	32987846	90775	304	678291	14598	587516	14294	298.6019736842105	41.10228067720722
chr9	APTX	32988091	32988124	12412	34	678291	14598	665879	14564	365.05882352941177	45.72088711892337
chr9	APTX	32989434	32989480	569	47	678291	14598	677722	14551	12.106382978723405	46.575630540856295
chr9	BAG1	33262104	33262246	7709	143	514780	7084	507071	6941	53.90909090909091	73.05445901166979
chr9	AQP7	33386076	33386195	0	120	0	3491	0	3371	0.0	0.0
chr9	AQP7	33386968	33387092	0	125	0	3491	0	3366	0.0	0.0
chr9	AQP7	33395077	33395195	0	119	0	3491	0	3372	0.0	0.0
chr9	AQP7	33395077	33395513	0	437	0	3491	0	3054	0.0	0.0
chr9	AQP7	33386403	33386541	0	139	0	3491	0	3352	0.0	0.0
chr9	AQP7	33394126	33394277	0	152	0	3491	0	3339	0.0	0.0
chr9	AQP7	33401535	33401672	0	138	0	3491	0	3353	0.0	0.0
chr9	AQP3	33442300	33442518	459	219	918	2489	459	2270	2.095890410958904	0.20220264317180617
chr9	UBAP2	33932561	33932628	11143	68	1051334	8530	1040191	8462	163.86764705882354	122.92495863861971
chr9	UBAP2	33956078	33956146	4837	69	1051334	8530	1046497	8461	70.10144927536231	123.68478903202931
chr9	UBAP2	33963725	33963791	12690	67	1051334	8530	1038644	8463	189.40298507462686	122.7276379534444
chr9	UBAP2	34017049	34017189	17809	141	1051334	8530	1033525	8389	126.30496453900709	123.20002384074382
chr9	CNTFR	34581094	34581205	306	112	612	2109	306	1997	2.732142857142857	0.15322984476715074
chr9	DCTN3	34616029	34616113	87797	85	800833	2217	713036	2132	1032.9058823529413	334.44465290806755
chr9	SIGMAR1	34636996	34637089	187991	94	2520996	1897	2333005	1803	1999.904255319149	1293.957293399889
chr9	FANCG	35078140	35078343	49796	204	747748	2822	697952	2618	244.09803921568627	266.5974025974026
chr9	FANCG	35074370	35074494	44972	125	747748	2822	702776	2697	359.776	260.57693733778274
chr9	PIGO	35090065	35090280	24238	216	588556	4627	564318	4411	112.21296296296296	127.93425527091362
chr9	PIGO	35095878	35095976	1469	99	588556	4627	587087	4528	14.83838383838384	129.65702296819788
chr9	PIGO	35096154	35096480	271	327	588556	4627	588285	4300	0.8287461773700305	136.81046511627906
chr9	STOML2	35102685	35102823	147344	139	2575629	1815	2428285	1676	1060.0287769784172	1448.857398568019
chr9	STOML2	35101425	35101560	253393	136	2575629	1815	2322236	1679	1863.1838235294117	1383.1066110780225
chr9	CD72	35618507	35618519	0	13	13157	2901	13157	2888	0.0	4.555747922437673
chr9	SIT1	35650501	35650637	0	137	0	1331	0	1194	0.0	0.0
chr9	ARHGEF39	35662945	35663074	11543	130	507879	5665	496336	5535	88.79230769230769	89.67226738934056
chr9	ARHGEF39	35664755	35664850	5419	96	507879	5665	502460	5569	56.447916666666664	90.22445681450888
chr9	ARHGEF39	35662511	35662741	23604	231	507879	5665	484275	5434	102.18181818181819	89.11943319838056
chr9	TLN1	35704668	35704815	119995	148	5831058	9893	5711063	9745	810.777027027027	586.0505900461775
chr9	SPAG8	35810246	35810309	733	64	36576	2480	35843	2416	11.453125	14.83567880794702
chr9	SPAG8	35809403	35809512	12100	110	36576	2480	24476	2370	110.0	10.327426160337552
chr9	SPAG8	35809403	35810309	28301	907	36576	2480	8275	1573	31.202866593164277	5.260648442466624
chr9	FAM221B	35821437	35821628	0	192	0	3950	0	3758	0.0	0.0
chr9	FAM221B	35826791	35826937	0	147	0	3950	0	3803	0.0	0.0
chr9	FAM221B	35826791	35826969	0	179	0	3950	0	3771	0.0	0.0
chr9	GNE	36222776	36222998	39936	223	752218	5867	712282	5644	179.08520179372198	126.2016300496102
chr9	GNE	36236831	36236984	23568	154	752218	5867	728650	5713	153.03896103896105	127.54244705058638
chr9	GNE	36249191	36249397	22993	207	752218	5867	729225	5660	111.07729468599034	128.83833922261485
chr9	RNF38	36390466	36390616	1124	151	295937	5993	294813	5842	7.443708609271523	50.46439575487847
chr9	RNF38	36372495	36372593	131	99	295937	5993	295806	5894	1.3232323232323233	50.187648456057005
chr9	PAX5	36846842	36846929	0	88	8817	9583	8817	9495	0.0	0.9285939968404423
chr9	PAX5	36882003	36882105	0	103	8817	9583	8817	9480	0.0	0.9300632911392405
chr9	PAX5	36923354	36923484	51	131	8817	9583	8766	9452	0.3893129770992366	0.9274227676682184
chr9	PAX5	37002647	37002776	336	130	8817	9583	8481	9453	2.5846153846153848	0.8971754998413202
chr9	PAX5	37014996	37015194	510	199	8817	9583	8307	9384	2.562814070351759	0.885230179028133
chr9	PAX5	37020635	37020801	1071	167	8817	9583	7746	9416	6.413173652694611	0.822642310960068
chr9	PAX5	36966548	36966724	423	177	8817	9583	8394	9406	2.389830508474576	0.8924091005741016
chr9	PAX5	37006472	37006537	0	66	8817	9583	8817	9517	0.0	0.9264474098980772
chr9	PAX5	36930887	36930944	51	58	8817	9583	8766	9525	0.8793103448275862	0.9203149606299212
chr9	FBXO10	37525101	37525172	12318	72	559398	6042	547080	5970	171.08333333333334	91.63819095477388
chr9	FBXO10	37575521	37575661	0	141	559398	6042	559398	5901	0.0	94.79715302491103
chr9	AL138752.2	38015373	38015480	25	108	3033190	2603	3033165	2495	0.23148148148148148	1215.6973947895792
chr9	EXOSC3	37781985	37782137	160255	153	1087417	6782	927162	6629	1047.4183006535948	139.86453462060643
chr9	FAM95C	38541455	38541562	247	108	47876	3767	47629	3659	2.287037037037037	13.016944520360754
chr9	FAM95C	38573083	38573129	784	47	47876	3767	47092	3720	16.680851063829788	12.659139784946236
chr9	FAM95C	38541288	38541562	638	275	47876	3767	47238	3492	2.32	13.527491408934708
chr9	CNTNAP3	39078689	39078920	2178	232	253992	8468	251814	8236	9.387931034482758	30.574793589120933
chr9	CNTNAP3	39099910	39100150	8578	241	253992	8468	245414	8227	35.593360995850624	29.83031481706576
chr9	CNTNAP3	39109159	39109287	9138	129	253992	8468	244854	8339	70.83720930232558	29.362513490826238
chr9	CNTNAP3	39118102	39118259	4871	158	253992	8468	249121	8310	30.829113924050635	29.978459687123948
chr9	GLIDR	39809485	39809615	0	131	153	6332	153	6201	0.0	0.02467343976777939
chr9	GLIDR	39778893	39778944	0	52	153	6332	153	6280	0.0	0.024363057324840766
chr9	BX255923.2	41102462	41102531	0	70	204	4157	204	4087	0.0	0.04991436261316369
chr9	CBWD6	41156382	41156439	0	58	0	9106	0	9048	0.0	0.0
chr9	CBWD6	41165000	41165087	0	88	0	9106	0	9018	0.0	0.0
chr9	CBWD6	41174292	41174352	0	61	0	9106	0	9045	0.0	0.0
chr9	CBWD6	41188009	41188107	0	99	0	9106	0	9007	0.0	0.0
chr9	CBWD6	41171846	41171934	0	89	0	9106	0	9017	0.0	0.0
chr9	CBWD6	41161600	41161723	0	124	0	9106	0	8982	0.0	0.0
chr9	CBWD6	41170283	41170423	0	141	0	9106	0	8965	0.0	0.0
chr9	CBWD6	41160804	41161021	0	218	0	9106	0	8888	0.0	0.0
chr9	CBWD6	41160937	41161021	0	85	0	9106	0	9021	0.0	0.0
chr9	CBWD6	41170278	41170423	0	146	0	9106	0	8960	0.0	0.0
chr9	CNTNAP3B	41898768	41898999	0	232	7770	11751	7770	11519	0.0	0.6745377202882195
chr9	CNTNAP3B	41938243	41938400	0	158	7770	11751	7770	11593	0.0	0.6702320365737945
chr9	CNTNAP3B	41920069	41920309	0	241	7770	11751	7770	11510	0.0	0.6750651607298002
chr9	CNTNAP3B	41926655	41926778	0	124	7770	11751	7770	11627	0.0	0.6682721252257676
chr9	AL590399.3	62350469	62350559	0	91	0	790	0	699	0.0	0.0
chr9	LERFS	62859071	62859193	0	123	0	5599	0	5476	0.0	0.0
chr9	LERFS	62866966	62867110	0	145	0	5599	0	5454	0.0	0.0
chr9	LERFS	62867696	62867876	0	181	0	5599	0	5418	0.0	0.0
chr9	LERFS	62867696	62868233	0	538	0	5599	0	5061	0.0	0.0
chr9	LERFS	62873366	62873691	0	326	0	5599	0	5273	0.0	0.0
chr9	LERFS	62877148	62877428	0	281	0	5599	0	5318	0.0	0.0
chr9	LERFS	62880522	62880630	0	109	0	5599	0	5490	0.0	0.0
chr9	AL591379.1	63116963	63117071	0	109	0	5055	0	4946	0.0	0.0
chr9	AL591379.1	63125168	63125267	0	100	0	5055	0	4955	0.0	0.0
chr9	BMS1P10	63374871	63374969	0	99	0	1608	0	1509	0.0	0.0
chr9	AL669942.1	66049861	66049989	0	129	51	4138	51	4009	0.0	0.012721376901970565
chr9	AL669942.1	66051212	66051416	0	205	51	4138	51	3933	0.0	0.012967200610221205
chr9	AL669942.1	66049861	66050023	0	163	51	4138	51	3975	0.0	0.012830188679245283
chr9	AL669942.1	66050189	66050259	0	71	51	4138	51	4067	0.0	0.012539955741332678
chr9	ANKRD20A3P	66149224	66149339	0	116	0	9250	0	9134	0.0	0.0
chr9	ANKRD20A3P	66158324	66158440	0	117	0	9250	0	9133	0.0	0.0
chr9	ANKRD20A3P	66151583	66151809	0	227	0	9250	0	9023	0.0	0.0
chr9	PGM5-AS1	68356289	68356361	0	73	0	2358	0	2285	0.0	0.0
chr9	PGM5-AS1	68356289	68356346	0	58	0	2358	0	2300	0.0	0.0
chr9	AL161457.2	68398047	68398166	0	120	2664	4013	2664	3893	0.0	0.6843051631132803
chr9	AL161457.2	68398442	68398689	1068	248	2664	4013	1596	3765	4.306451612903226	0.4239043824701195
chr9	AL161457.2	68405723	68406008	0	286	2664	4013	2664	3727	0.0	0.7147840085859941
chr9	BANCR	69306147	69306290	0	144	0	853	0	709	0.0	0.0
chr9	APBA1	69458155	69458188	0	34	1122	11461	1122	11427	0.0	0.09818850091887635
chr9	MAMDC2-AS1	70082804	70082900	0	97	6553	9867	6553	9770	0.0	0.6707267144319345
chr9	MAMDC2-AS1	70081973	70082074	0	102	6553	9867	6553	9765	0.0	0.6710701484895033
chr9	MAMDC2-AS1	70079245	70079359	0	115	6553	9867	6553	9752	0.0	0.6719647251845775
chr9	MAMDC2-AS1	70082621	70082662	0	42	6553	9867	6553	9825	0.0	0.666972010178117
chr9	MAMDC2-AS1	70157511	70157742	0	232	6553	9867	6553	9635	0.0	0.6801245459263103
chr9	MAMDC2-AS1	70172559	70172865	0	307	6553	9867	6553	9560	0.0	0.6854602510460251
chr9	SMC5-AS1	70218314	70218485	0	172	0	2197	0	2025	0.0	0.0
chr9	TRPM3	70621243	70621273	0	31	6112	14073	6112	14042	0.0	0.43526563167639937
chr9	TRPM3	70625481	70625517	103	37	6112	14073	6009	14036	2.7837837837837838	0.4281134226275292
chr9	TRPM3	70811169	70811244	0	76	6112	14073	6112	13997	0.0	0.4366649996427806
chr9	CEMIP2	71734805	71734994	105	190	16873	9281	16768	9091	0.5526315789473685	1.8444615553844461
chr9	C9ORF57	72059512	72059656	0	145	0	1764	0	1619	0.0	0.0
chr9	C9ORF57	72059234	72059384	0	151	0	1764	0	1613	0.0	0.0
chr9	ZFAND5	72363469	72363606	0	138	306	6883	306	6745	0.0	0.04536693847294292
chr9	NMRK1	75069741	75069813	0	73	0	3129	0	3056	0.0	0.0
chr9	NMRK1	75078325	75078582	0	258	0	3129	0	2871	0.0	0.0
chr9	RFK	76392417	76392569	0	153	0	3275	0	3122	0.0	0.0
chr9	RFK	76388182	76388286	0	105	0	3275	0	3170	0.0	0.0
chr9	PRUNE2	76641971	76641980	0	10	766	13950	766	13940	0.0	0.054949784791965564
chr9	AL512634.1	79138787	79139042	0	256	4	2916	4	2660	0.0	0.0015037593984962407
chr9	LNCARSR	79529003	79529171	0	169	306	4277	306	4108	0.0	0.07448880233690361
chr9	LNCARSR	79534083	79534183	0	101	306	4277	306	4176	0.0	0.07327586206896551
chr9	LNCARSR	79527609	79527864	0	256	306	4277	306	4021	0.0	0.0761004725192738
chr9	TLE1	81673881	81673991	0	111	0	5206	0	5095	0.0	0.0
chr9	UBQLN1	83666349	83666433	0	85	0	4127	0	4042	0.0	0.0
chr9	UBQLN1	83666349	83666394	0	46	0	4127	0	4081	0.0	0.0
chr9	GKAP1	83768817	83768970	0	154	51	3420	51	3266	0.0	0.015615431720759338
chr9	GKAP1	83792950	83793017	0	68	51	3420	51	3352	0.0	0.015214797136038186
chr9	KIF27	83880296	83880494	0	199	570	7758	570	7559	0.0	0.07540679984124884
chr9	KIF27	83903059	83904018	0	960	570	7758	570	6798	0.0	0.08384819064430715
chr9	HNRNPK	83973901	83973973	0	73	51	4998	51	4925	0.0	0.010355329949238578
chr9	HNRNPK	83975461	83975505	0	45	51	4998	51	4953	0.0	0.01029678982434888
chr9	AL583827.1	85401684	85401963	0	280	51	4823	51	4543	0.0	0.011226062073519701
chr9	AGTPBP1	85660935	85660973	0	39	448	4966	448	4927	0.0	0.0909275421148772
chr9	AGTPBP1	85678334	85678398	0	65	448	4966	448	4901	0.0	0.09140991634360335
chr9	AGTPBP1	85712501	85712566	0	66	448	4966	448	4900	0.0	0.09142857142857143
chr9	AL353743.2	85786437	85786551	0	115	561	7271	561	7156	0.0	0.07839575181665735
chr9	AL353743.2	85787883	85788038	0	156	561	7271	561	7115	0.0	0.07884750527055516
chr9	AL353743.2	85792180	85792252	0	73	561	7271	561	7198	0.0	0.07793831619894415
chr9	AL353743.2	85787825	85788038	0	214	561	7271	561	7057	0.0	0.07949553634688962
chr9	AL353743.2	85803437	85803609	0	173	561	7271	561	7098	0.0	0.0790363482671175
chr9	AL353743.2	85792180	85792250	0	71	561	7271	561	7200	0.0	0.07791666666666666
chr9	GOLM1	86052536	86052591	0	56	294	4247	294	4191	0.0	0.07015032211882606
chr9	GOLM1	86084919	86085039	0	121	294	4247	294	4126	0.0	0.07125545322346098
chr9	C9ORF153	86227854	86228030	0	177	927	2935	927	2758	0.0	0.33611312545322697
chr9	C9ORF153	86227543	86228030	0	488	927	2935	927	2447	0.0	0.3788312219043727
chr9	TUT7	86309462	86309576	0	115	48546	6736	48546	6621	0.0	7.33212505663797
chr9	TUT7	86326370	86326491	0	122	48546	6736	48546	6614	0.0	7.339885092228606
chr9	CDK20	87970567	87970630	0	64	51	2638	51	2574	0.0	0.019813519813519812
chr9	CDK20	87969795	87969919	0	125	51	2638	51	2513	0.0	0.020294468762435337
chr9	LINC02843	88640510	88640581	679	72	3966	1616	3287	1544	9.430555555555555	2.1288860103626943
chr9	LINC02843	88644362	88644506	307	145	3966	1616	3659	1471	2.117241379310345	2.487423521414004
chr9	SEMA4D	89418362	89418437	0	76	255	13525	255	13449	0.0	0.018960517510595583
chr9	SEMA4D	89418055	89418118	0	64	255	13525	255	13461	0.0	0.01894361488745264
chr9	SEMA4D	89455887	89455953	0	67	255	13525	255	13458	0.0	0.018947837717342843
chr9	LINC01508	90380068	90380201	0	134	4556	2013	4556	1879	0.0	2.4246939861628527
chr9	LINC01508	90385015	90385583	0	569	4556	2013	4556	1444	0.0	3.155124653739612
chr9	LINC01501	90469533	90469741	0	209	20337	4017	20337	3808	0.0	5.340598739495798
chr9	LINC01501	90505722	90505780	0	59	20337	4017	20337	3958	0.0	5.138201111672562
chr9	LINC01501	90567163	90567217	0	55	20337	4017	20337	3962	0.0	5.133013629480061
chr9	LINC01501	90507257	90507340	0	84	20337	4017	20337	3933	0.0	5.170861937452327
chr9	DIRAS2	90626057	90626175	0	119	255	4446	255	4327	0.0	0.058932285648255145
chr9	DIRAS2	90625875	90626175	0	301	255	4446	255	4145	0.0	0.061519903498190594
chr9	AUH	91216058	91216106	0	49	0	2275	0	2226	0.0	0.0
chr9	AUH	91325317	91325404	0	88	0	2275	0	2187	0.0	0.0
chr9	SPTLC1	92050295	92050491	0	197	0	5615	0	5418	0.0	0.0
chr9	SPTLC1	92076797	92077035	0	239	0	5615	0	5376	0.0	0.0
chr9	SPTLC1	92046274	92046334	0	61	0	5615	0	5554	0.0	0.0
chr9	SPTLC1	92070123	92070296	0	174	0	5615	0	5441	0.0	0.0
chr9	SPTLC1	92079433	92079566	0	134	0	5615	0	5481	0.0	0.0
chr9	IARS1	92288125	92288282	0	158	33	7080	33	6922	0.0	0.0047674082635076566
chr9	IARS1	92240642	92240691	0	50	33	7080	33	7030	0.0	0.004694167852062589
chr9	NOL8	92311145	92311259	0	115	51	7731	51	7616	0.0	0.006696428571428571
chr9	NOL8	92324022	92324209	0	188	51	7731	51	7543	0.0	0.006761235582659419
chr9	NOL8	92323235	92323351	0	117	51	7731	51	7614	0.0	0.006698187549251379
chr9	NOL8	92319942	92320379	51	438	51	7731	0	7293	0.11643835616438356	0.0
chr9	NOL8	92324022	92324251	0	230	51	7731	51	7501	0.0	0.006799093454206106
chr9	NOL8	92319942	92320137	0	196	51	7731	51	7535	0.0	0.006768414067684141
chr9	NOL8	92324022	92324080	0	59	51	7731	51	7672	0.0	0.006647549530761209
chr9	ZNF484	92875014	92875059	0	46	0	4816	0	4770	0.0	0.0
chr9	ZNF484	92862139	92862165	0	27	0	4816	0	4789	0.0	0.0
chr9	FAM120AOS	93448368	93448489	0	122	306	9563	306	9441	0.0	0.032411820781696854
chr9	LINC02603	94223128	94223308	0	181	874	2651	874	2470	0.0	0.35384615384615387
chr9	LINC02603	94200813	94200872	0	60	874	2651	874	2591	0.0	0.33732149749131607
chr9	FBP1	94617767	94617860	0	94	51	1759	51	1665	0.0	0.03063063063063063
chr9	FBP1	94639140	94639334	0	195	51	1759	51	1564	0.0	0.03260869565217391
chr9	FANCC	95186500	95186645	0	146	21008	11365	21008	11219	0.0	1.872537659327926
chr9	FANCC	95186500	95186595	0	96	21008	11365	21008	11269	0.0	1.864229301623924
chr9	FANCC	95310241	95310355	0	115	21008	11365	21008	11250	0.0	1.8673777777777778
chr9	FANCC	95220921	95221065	0	145	21008	11365	21008	11220	0.0	1.8723707664884135
chr9	FANCC	95265595	95265754	0	160	21008	11365	21008	11205	0.0	1.8748772869254797
chr9	PTCH1	95477546	95477702	13454	157	134377	17222	120923	17065	85.69426751592357	7.086024025783768
chr9	PTCH1	95506406	95506599	0	194	134377	17222	134377	17028	0.0	7.891531595019967
chr9	PTCH1	95474011	95474143	34781	133	134377	17222	99596	17089	261.5112781954887	5.828076540464626
chr9	PTCH1	95485684	95485874	120	191	134377	17222	134257	17031	0.6282722513089005	7.8830955316775295
chr9	LINC00476	95851823	95852029	0	207	80796	6299	80796	6092	0.0	13.26263952724885
chr9	LINC00476	95874508	95874548	5803	41	80796	6299	74993	6258	141.53658536585365	11.983541067433684
chr9	LINC00476	95874508	95874622	8796	115	80796	6299	72000	6184	76.48695652173913	11.64294954721863
chr9	AL449403.2	96115640	96115760	0	121	4	3722	4	3601	0.0	0.0011108025548458762
chr9	HSD17B3	96240757	96240907	0	151	522	2354	522	2203	0.0	0.23694961416250568
chr9	HSD17B3	96246555	96246590	0	36	522	2354	522	2318	0.0	0.22519413287316653
chr9	HSD17B3	96252802	96252910	0	109	522	2354	522	2245	0.0	0.23251670378619155
chr9	HSD17B3	96254867	96254943	0	77	522	2354	522	2277	0.0	0.22924901185770752
chr9	SLC35D2	96321997	96322080	1134	84	34337	3843	33203	3759	13.5	8.83293429103485
chr9	HSD17B3	96239822	96239960	18	139	522	2354	504	2215	0.12949640287769784	0.2275395033860045
chr9	SLC35D2	96363217	96363387	714	171	34337	3843	33623	3672	4.175438596491228	9.156590413943356
chr9	CDC14B	96509672	96509789	0	118	102	10496	102	10378	0.0	0.00982848333012141
chr9	CDC14B	96515648	96515792	0	145	102	10496	102	10351	0.0	0.00985412037484301
chr9	PRXL2C	96645892	96646024	0	133	0	2942	0	2809	0.0	0.0
chr9	ZNF782	96844889	96845016	0	128	11861	4860	11861	4732	0.0	2.506551141166526
chr9	ZNF782	96852852	96853069	0	218	11861	4860	11861	4642	0.0	2.555148642826368
chr9	MFSD14C	96972852	96972948	0	97	3867	11896	3867	11799	0.0	0.3277396389524536
chr9	MFSD14C	96902916	96903108	0	193	3867	11896	3867	11703	0.0	0.33042809536016404
chr9	ANKRD18CP	97204860	97205034	133	175	2938	2996	2805	2821	0.76	0.9943282523927686
chr9	XPA	97682199	97682430	0	232	1890	1824	1890	1592	0.0	1.1871859296482412
chr9	XPA	97689533	97689639	51	107	1890	1824	1839	1717	0.4766355140186916	1.0710541642399534
chr9	PTCSC2	97805487	97805629	0	143	494	2293	494	2150	0.0	0.2297674418604651
chr9	PTCSC2	97805839	97806024	0	186	494	2293	494	2107	0.0	0.23445657332700523
chr9	PTCSC2	97804250	97804390	38	141	494	2293	456	2152	0.2695035460992908	0.21189591078066913
chr9	PTCSC2	97724412	97724530	0	119	494	2293	494	2174	0.0	0.22723091076356947
chr9	PTCSC2	97805361	97805629	432	269	494	2293	62	2024	1.6059479553903346	0.030632411067193676
chr9	TRMO	97916163	97916338	0	176	16533	4155	16533	3979	0.0	4.155064086453883
chr9	TRMO	97910917	97912975	15411	2059	16533	4155	1122	2096	7.484701311316173	0.5353053435114504
chr9	TRMO	97913978	97914026	0	49	16533	4155	16533	4106	0.0	4.026546517291768
chr9	TRMO	97912872	97912975	0	104	16533	4155	16533	4051	0.0	4.081214514934584
chr9	TBC1D2	98251784	98251926	0	143	3424	3592	3424	3449	0.0	0.9927515221803421
chr9	GABBR2	98311094	98311205	0	112	0	7372	0	7260	0.0	0.0
chr9	AL136084.1	98848927	98849141	0	215	0	4560	0	4345	0.0	0.0
chr9	AL136084.1	98869964	98870064	0	101	0	4560	0	4459	0.0	0.0
chr9	AL136084.1	98870802	98870984	0	183	0	4560	0	4377	0.0	0.0
chr9	AL136084.1	98870890	98870984	0	95	0	4560	0	4465	0.0	0.0
chr9	AL136084.1	98870432	98870771	0	340	0	4560	0	4220	0.0	0.0
chr9	AL136084.1	98869586	98869683	0	98	0	4560	0	4462	0.0	0.0
chr9	AL136084.1	98871359	98871396	0	38	0	4560	0	4522	0.0	0.0
chr9	AL136084.1	98869980	98870064	0	85	0	4560	0	4475	0.0	0.0
chr9	ALG2	99220978	99221137	102	160	21123	2973	21021	2813	0.6375	7.472804834696054
chr9	NAMA	99369731	99369868	0	138	6568	5398	6568	5260	0.0	1.2486692015209127
chr9	NAMA	99372920	99373114	459	195	6568	5398	6109	5203	2.353846153846154	1.1741303094368634
chr9	AL359710.1	99454537	99454643	120	107	1518	3770	1398	3663	1.1214953271028036	0.38165438165438165
chr9	AL359710.1	99805870	99805991	0	122	1518	3770	1518	3648	0.0	0.4161184210526316
chr9	ALDOB	101435708	101435762	0	55	0	2838	0	2783	0.0	0.0
chr9	PGAP4	101480670	101480725	0	56	4043	5556	4043	5500	0.0	0.7350909090909091
chr9	ABCA1	104903613	104903771	0	159	0	11395	0	11236	0.0	0.0
chr9	LINC01509	107430714	107430901	0	188	0	1125	0	937	0.0	0.0
chr9	LINC01509	107427280	107427335	0	56	0	1125	0	1069	0.0	0.0
chr9	ELP1	108874894	108874970	0	77	612	16260	612	16183	0.0	0.037817462769573006
chr9	ELP1	108879445	108879557	0	113	612	16260	612	16147	0.0	0.03790177741995417
chr9	ELP1	108918810	108918901	0	92	612	16260	612	16168	0.0	0.03785254824344384
chr9	ELP1	108930996	108931201	0	206	612	16260	612	16054	0.0	0.038121340475893856
chr9	ELP1	108875632	108875735	0	104	612	16260	612	16156	0.0	0.037880663530576876
chr9	ELP1	108930996	108931056	0	61	612	16260	612	16199	0.0	0.037780109883326134
chr9	ELP1	108898135	108898234	0	100	612	16260	612	16160	0.0	0.03787128712871287
chr9	ELP1	108930996	108931199	0	204	612	16260	612	16056	0.0	0.03811659192825112
chr9	ELP1	108919252	108919349	0	98	612	16260	612	16162	0.0	0.03786660066823413
chr9	ELP1	108884795	108884912	0	118	612	16260	612	16142	0.0	0.03791351753190435
chr9	ELP1	108870453	108870553	0	101	612	16260	612	16159	0.0	0.03787363079398478
chr9	ELP1	108874894	108874963	0	70	612	16260	612	16190	0.0	0.037801111797405806
chr9	ELP1	108877612	108877800	0	189	612	16260	612	16071	0.0	0.0380810154937465
chr9	ELP1	108920690	108920783	0	94	612	16260	612	16166	0.0	0.037857231226029936
chr9	TMEM245	109085996	109086020	0	25	0	9521	0	9496	0.0	0.0
chr9	FRRS1L	109149635	109149720	0	86	0	14539	0	14453	0.0	0.0
chr9	FRRS1L	109148442	109148567	0	126	0	14539	0	14413	0.0	0.0
chr9	FRRS1L	109150701	109150860	0	160	0	14539	0	14379	0.0	0.0
chr9	PTPN3	109422717	109422852	0	136	32	7175	32	7039	0.0	0.004546100298337832
chr9	TXN	110250819	110250879	0	61	409	1015	409	954	0.0	0.42872117400419285
chr9	TXNDC8	110329231	110329291	0	61	0	2145	0	2084	0.0	0.0
chr9	LPAR1	110973480	110973558	0	79	0	4168	0	4089	0.0	0.0
chr9	LPAR1	110945373	110945401	0	29	0	4168	0	4139	0.0	0.0
chr9	ECPAS	111472896	111473000	0	105	0	7307	0	7202	0.0	0.0
chr9	PTGR1	111592925	111592982	0	58	0	3783	0	3725	0.0	0.0
chr9	PTGR1	111594221	111594267	0	47	0	3783	0	3736	0.0	0.0
chr9	PTGR1	111564156	111564262	0	107	0	3783	0	3676	0.0	0.0
chr9	PTGR1	111589263	111589382	0	120	0	3783	0	3663	0.0	0.0
chr9	SHOC1	111718183	111718288	256	106	182063	6306	181807	6200	2.4150943396226414	29.323709677419355
chr9	SUSD1	112052398	112052438	0	41	1185	4096	1185	4055	0.0	0.2922318125770654
chr9	SUSD1	112042100	112042165	103	66	1185	4096	1082	4030	1.5606060606060606	0.2684863523573201
chr9	SUSD1	112052154	112052349	0	196	1185	4096	1185	3900	0.0	0.3038461538461538
chr9	PTBP3	112275843	112276013	0	171	4225	8252	4225	8081	0.0	0.522831332755847
chr9	PTBP3	112330440	112330474	0	35	4225	8252	4225	8217	0.0	0.5141779238164781
chr9	PTBP3	112297831	112297916	0	86	4225	8252	4225	8166	0.0	0.5173891746265001
chr9	C9ORF147	112484929	112485163	0	235	0	2401	0	2166	0.0	0.0
chr9	INIP	112689526	112689617	0	92	4493	4342	4493	4250	0.0	1.0571764705882354
chr9	INIP	112716460	112716541	0	82	4493	4342	4493	4260	0.0	1.054694835680751
chr9	FAM225B	113104914	113104985	0	72	204	5941	204	5869	0.0	0.03475890270914977
chr9	FAM225B	113104914	113104982	0	69	204	5941	204	5872	0.0	0.03474114441416894
chr9	WDR31	113330983	113331113	0	131	0	4343	0	4212	0.0	0.0
chr9	WDR31	113336287	113336440	0	154	0	4343	0	4189	0.0	0.0
chr9	WDR31	113330983	113331116	0	134	0	4343	0	4209	0.0	0.0
chr9	ALAD	113398077	113398124	0	48	0	4673	0	4625	0.0	0.0
chr9	KIF12	114092154	114092174	0	21	0	2858	0	2837	0.0	0.0
chr9	KIF12	114094180	114094271	0	92	0	2858	0	2766	0.0	0.0
chr9	KIF12	114096050	114096207	0	158	0	2858	0	2700	0.0	0.0
chr9	KIF12	114097300	114097436	0	137	0	2858	0	2721	0.0	0.0
chr9	KIF12	114098301	114098429	0	129	0	2858	0	2729	0.0	0.0
chr9	KIF12	114098301	114098414	0	114	0	2858	0	2744	0.0	0.0
chr9	AKNA	114368199	114368246	0	48	171855	10625	171855	10577	0.0	16.247990923702375
chr9	WHRN	114423313	114423523	426	211	7791	5296	7365	5085	2.018957345971564	1.448377581120944
chr9	TNC	115048259	115048532	0	274	41658	9672	41658	9398	0.0	4.4326452436688655
chr9	TNC	115062916	115063189	0	274	41658	9672	41658	9398	0.0	4.4326452436688655
chr9	TNC	115052739	115053015	40	277	41658	9672	41618	9395	0.1444043321299639	4.4298030867482705
chr9	TNC	115057152	115057425	391	274	41658	9672	41267	9398	1.427007299270073	4.391040646946159
chr9	TNC	115059729	115060002	1034	274	41658	9672	40624	9398	3.7737226277372264	4.322621834432858
chr9	TNC	115115002	115115106	0	105	41658	9672	41658	9567	0.0	4.3543430542489805
chr9	AL691420.1	115742952	115743070	0	119	3607	2999	3607	2880	0.0	1.2524305555555555
chr9	AL691420.1	115741127	115741291	0	165	3607	2999	3607	2834	0.0	1.2727593507410022
chr9	ASTN2	117141325	117141478	0	154	41143	8314	41143	8160	0.0	5.04203431372549
chr9	CDK5RAP2	120407011	120407248	0	238	0	9012	0	8774	0.0	0.0
chr9	CDK5RAP2	120443619	120443742	0	124	0	9012	0	8888	0.0	0.0
chr9	CDK5RAP2	120529977	120530140	0	164	0	9012	0	8848	0.0	0.0
chr9	CDK5RAP2	120453455	120453873	0	419	0	9012	0	8593	0.0	0.0
chr9	CDK5RAP2	120460571	120460667	0	97	0	9012	0	8915	0.0	0.0
chr9	CDK5RAP2	120460571	120460747	0	177	0	9012	0	8835	0.0	0.0
chr9	CDK5RAP2	120517756	120517886	0	131	0	9012	0	8881	0.0	0.0
chr9	PSMD5	120829098	120829208	0	111	0	3876	0	3765	0.0	0.0
chr9	PSMD5	120831330	120831459	0	130	0	3876	0	3746	0.0	0.0
chr9	PSMD5	120833311	120833456	0	146	0	3876	0	3730	0.0	0.0
chr9	PHF19	120861917	120862005	0	89	0	6613	0	6524	0.0	0.0
chr9	GGTA1	121479065	121479334	0	270	0	4510	0	4240	0.0	0.0
chr9	TTLL11	122031722	122031856	0	135	0	2780	0	2645	0.0	0.0
chr9	LHX6	122209613	122209717	0	105	153	5315	153	5210	0.0	0.029366602687140114
chr9	LHX6	122227799	122227859	0	61	153	5315	153	5254	0.0	0.02912066996574039
chr9	STRBP	123115763	123115883	0	121	10826	7338	10826	7217	0.0	1.5000692808646252
chr9	STRBP	123236829	123236966	561	138	10826	7338	10265	7200	4.065217391304348	1.4256944444444444
chr9	STRBP	123180867	123180975	0	109	10826	7338	10826	7229	0.0	1.4975791949093926
chr9	STRBP	123168188	123168258	396	71	10826	7338	10430	7267	5.577464788732394	1.435255263520022
chr9	DENND1A	123450692	123450749	0	58	50392	10288	50392	10230	0.0	4.925904203323558
chr9	DENND1A	123769513	123769563	0	51	50392	10288	50392	10237	0.0	4.922535899189215
chr9	DENND1A	123676719	123676789	357	71	50392	10288	50035	10217	5.028169014084507	4.897230106684937
chr9	PSMB7	124405316	124405432	0	117	0	1801	0	1684	0.0	0.0
chr9	NR5A1	124493029	124493149	0	121	3659	3421	3659	3300	0.0	1.1087878787878789
chr9	RPL35	124858457	124858537	0	81	0	1186	0	1105	0.0	0.0
chr9	RPL35	124858275	124858537	0	263	0	1186	0	923	0.0	0.0
chr9	SCAI	125065989	125066058	126	70	31420	13057	31294	12987	1.8	2.4096404096404096
chr9	SCAI	124975246	124975389	0	144	31420	13057	31420	12913	0.0	2.4332068458142957
chr9	SCAI	124974174	124974276	0	103	31420	13057	31420	12954	0.0	2.425505635324996
chr9	PPP6C	125160840	125160906	0	67	61	4370	61	4303	0.0	0.014176156170113875
chr9	PPP6C	125171908	125172001	10	94	61	4370	51	4276	0.10638297872340426	0.011927034611786716
chr9	MAPKAP1	125672315	125672643	4106	329	5583	6398	1477	6069	12.480243161094226	0.2433679354094579
chr9	MAPKAP1	125467971	125468109	0	139	5583	6398	5583	6259	0.0	0.8919955264419236
chr9	MAPKAP1	125484442	125484583	0	142	5583	6398	5583	6256	0.0	0.892423273657289
chr9	MAPKAP1	125506309	125506417	0	109	5583	6398	5583	6289	0.0	0.887740499284465
chr9	MAPKAP1	125669817	125669907	675	91	5583	6398	4908	6307	7.417582417582418	0.7781829713017282
chr9	MAPKAP1	125447324	125447487	0	164	5583	6398	5583	6234	0.0	0.8955726660250241
chr9	MAPKAP1	125599834	125599927	0	94	5583	6398	5583	6304	0.0	0.8856281725888325
chr9	MAPKAP1	125652116	125652257	0	142	5583	6398	5583	6256	0.0	0.892423273657289
chr9	MAPKAP1	125672399	125672643	3202	245	5583	6398	2381	6153	13.06938775510204	0.3869657077848204
chr9	MAPKAP1	125696216	125696404	0	189	5583	6398	5583	6209	0.0	0.8991786116927042
chr9	ANGPTL2	127107914	127108780	7885	867	46587	3631	38702	2764	9.094579008073818	14.002170767004342
chr9	RPL12	127449609	127449708	0	100	0	961	0	861	0.0	0.0
chr9	PTRH1	127714378	127714424	727	47	17408	3493	16681	3446	15.46808510638298	4.840684852002322
chr9	PTRH1	127714602	127714702	780	101	17408	3493	16628	3392	7.7227722772277225	4.902122641509434
chr9	TOR2A	127734298	127734564	0	267	174	2500	174	2233	0.0	0.07792207792207792
chr9	TOR2A	127732563	127732691	0	129	174	2500	174	2371	0.0	0.07338675664276677
chr9	SH2D3C	127761610	127761650	0	41	1589	4525	1589	4484	0.0	0.35437109723461196
chr9	SH2D3C	127766900	127767271	51	372	1589	4525	1538	4153	0.13709677419354838	0.3703346978088129
chr9	AK1	127872689	127872853	510	165	1722	2602	1212	2437	3.090909090909091	0.49733278621255644
chr9	AL157935.2	127879513	127879624	0	112	989	3832	989	3720	0.0	0.26586021505376345
chr9	ST6GALNAC6	127890636	127891043	102	408	4953	5316	4851	4908	0.25	0.9883863080684596
chr9	AL157935.2	127878386	127878479	0	94	989	3832	989	3738	0.0	0.26457998929909043
chr9	ST6GALNAC6	127890655	127891043	102	389	4953	5316	4851	4927	0.2622107969151671	0.9845747919626547
chr9	ST6GALNAC6	127897955	127898010	0	56	4953	5316	4953	5260	0.0	0.9416349809885931
chr9	AL157935.2	127878386	127878423	0	38	989	3832	989	3794	0.0	0.2606747496046389
chr9	ST6GALNAC4	127909950	127910058	7590	109	130955	2639	123365	2530	69.63302752293578	48.76086956521739
chr9	ST6GALNAC4	127912267	127912680	1953	414	130955	2639	129002	2225	4.717391304347826	57.97842696629213
chr9	ST6GALNAC4	127916407	127916494	0	88	130955	2639	130955	2551	0.0	51.33477067816543
chr9	PIP5KL1	127925866	127925979	0	114	2394	2806	2394	2692	0.0	0.8893016344725111
chr9	PIP5KL1	127927152	127927208	0	57	2394	2806	2394	2749	0.0	0.8708621316842489
chr9	PIP5KL1	127925957	127925979	0	23	2394	2806	2394	2783	0.0	0.8602227811713977
chr9	DPM2	127936552	127936655	0	104	981	2505	981	2401	0.0	0.40857975843398586
chr9	FAM102A	127953804	127953925	74	122	18166	6585	18092	6463	0.6065573770491803	2.7993192016091597
chr9	PTGES2	128124778	128124871	405	94	124196	4049	123791	3955	4.308510638297872	31.299873577749683
chr9	PTGES2	128125895	128126260	15763	366	124196	4049	108433	3683	43.068306010928964	29.441487917458595
chr9	CIZ1	128187862	128187934	0	73	70028	7924	70028	7851	0.0	8.91962807285696
chr9	CIZ1	128190328	128190444	0	117	70028	7924	70028	7807	0.0	8.969898808761368
chr9	CIZ1	128169622	128169700	0	79	70028	7924	70028	7845	0.0	8.926449968132568
chr9	CIZ1	128185546	128185776	0	231	70028	7924	70028	7693	0.0	9.102820746132847
chr9	GOLGA2	128267193	128267274	0	82	5934	5622	5934	5540	0.0	1.0711191335740071
chr9	GOLGA2	128272784	128272865	0	82	5934	5622	5934	5540	0.0	1.0711191335740071
chr9	DYNC2I2	128636917	128637027	0	111	102	2612	102	2501	0.0	0.04078368652538984
chr9	ZER1	128755407	128755659	51	253	1182	4387	1131	4134	0.2015810276679842	0.27358490566037735
chr9	SPOUT1	128823746	128823894	0	149	0	4538	0	4389	0.0	0.0
chr9	KYAT1	128838217	128838367	41	151	805	3604	764	3453	0.271523178807947	0.22125687807703445
chr9	KYAT1	128840610	128840672	0	63	805	3604	805	3541	0.0	0.2273369104772663
chr9	KYAT1	128842066	128842184	51	119	805	3604	754	3485	0.42857142857142855	0.2163558106169297
chr9	SH3GLB2	129012235	129012298	0	64	51	4688	51	4624	0.0	0.011029411764705883
chr9	SH3GLB2	129009452	129009467	0	16	51	4688	51	4672	0.0	0.01091609589041096
chr9	SH3GLB2	129013007	129013019	0	13	51	4688	51	4675	0.0	0.01090909090909091
chr9	SH3GLB2	129015739	129015860	0	122	51	4688	51	4566	0.0	0.011169513797634692
chr9	SH3GLB2	129015739	129015864	0	126	51	4688	51	4562	0.0	0.011179307321350284
chr9	CRAT	129104187	129104306	612	120	612	3826	0	3706	5.1	0.0
chr9	CRAT	129109178	129109277	0	100	612	3826	612	3726	0.0	0.1642512077294686
chr9	CRAT	129108762	129108903	0	142	612	3826	612	3684	0.0	0.16612377850162866
chr9	CRAT	129108407	129108478	0	72	612	3826	612	3754	0.0	0.16302610548748003
chr9	ASB6	129638572	129638659	0	88	7890	4628	7890	4540	0.0	1.7378854625550662
chr9	ASB6	129639201	129639310	0	110	7890	4628	7890	4518	0.0	1.746347941567065
chr9	TOR1A	129818177	129818297	0	121	0	4005	0	3884	0.0	0.0
chr9	C9ORF78	129834706	129834766	0	61	4386	4970	4386	4909	0.0	0.8934609900183337
chr9	FNBP1	129915965	129915980	0	16	7195	6618	7195	6602	0.0	1.0898212662829445
chr9	FNBP1	129923843	129924026	0	184	7195	6618	7195	6434	0.0	1.118277898663351
chr9	FNBP1	129923843	129923996	0	154	7195	6618	7195	6464	0.0	1.1130878712871286
chr9	AL157938.2	131136721	131136822	0	102	20637	3038	20637	2936	0.0	7.028950953678474
chr9	AL157938.2	131153152	131153345	7573	194	20637	3038	13064	2844	39.0360824742268	4.593530239099859
chr9	AL157938.2	131141677	131141766	214	90	20637	3038	20423	2948	2.3777777777777778	6.92774762550882
chr9	AL157938.2	131133626	131133715	10500	90	20637	3038	10137	2948	116.66666666666667	3.4386024423337855
chr9	AL157938.2	131163282	131163333	14	52	20637	3038	20623	2986	0.2692307692307692	6.906563965170797
chr9	AL157938.2	131164358	131164706	0	349	20637	3038	20637	2689	0.0	7.674600223131276
chr9	AL157938.2	131165164	131165270	0	107	20637	3038	20637	2931	0.0	7.040941658137155
chr9	UCK1	131528943	131529038	0	96	4284	2576	4284	2480	0.0	1.7274193548387098
chr9	UCK1	131526444	131526503	55	60	4284	2576	4229	2516	0.9166666666666666	1.6808426073131955
chr9	RAPGEF1	131630235	131630324	51	90	91199	7031	91148	6941	0.5666666666666667	13.131825385391155
chr9	RAPGEF1	131650128	131650242	0	115	91199	7031	91199	6916	0.0	13.186668594563331
chr9	RAPGEF1	131603960	131604053	0	94	91199	7031	91199	6937	0.0	13.146749315265964
chr9	MED27	131893884	131893992	20137	109	274132	3869	253995	3760	184.74311926605503	67.55186170212765
chr9	SETX	132269402	132269489	16	88	28973	11836	28957	11748	0.18181818181818182	2.4648450800136192
chr9	TTF1	132401454	132402828	58295	1375	224786	3226	166491	1851	42.39636363636364	89.94651539708266
chr9	AK8	132875114	132875199	0	86	1888	2747	1888	2661	0.0	0.7095077038707253
chr9	TSC1	132903650	132903817	0	168	614065	16580	614065	16412	0.0	37.41561052888131
chr9	TSC1	132904410	132904454	0	45	614065	16580	614065	16535	0.0	37.13728454792864
chr9	TSC1	132921362	132921436	0	75	614065	16580	614065	16505	0.0	37.20478642835504
chr9	TSC1	132925586	132925739	0	154	614065	16580	614065	16426	0.0	37.383720930232556
chr9	TSC1	132927200	132927304	0	105	614065	16580	614065	16475	0.0	37.27253414264037
chr9	TSC1	132935032	132935095	0	64	614065	16580	614065	16516	0.0	37.180007265681766
chr9	TSC1	132903650	132903802	0	153	614065	16580	614065	16427	0.0	37.38144518171303
chr9	TSC1	132928766	132928952	0	187	614065	16580	614065	16393	0.0	37.458976392362594
chr9	TSC1	132924814	132924939	0	126	614065	16580	614065	16454	0.0	37.32010453385195
chr9	TSC1	132924814	132924906	0	93	614065	16580	614065	16487	0.0	37.24540547097713
chr9	TSC1	132924814	132925007	0	194	614065	16580	614065	16386	0.0	37.474978640302695
chr9	TSC1	132931208	132931304	0	97	614065	16580	614065	16483	0.0	37.25444397257781
chr9	RALGDS	133107084	133107300	0	217	0	5371	0	5154	0.0	0.0
chr9	GBGT1	133156014	133156102	0	89	0	4024	0	3935	0.0	0.0
chr9	RALGDS	133104447	133104551	0	105	0	5371	0	5266	0.0	0.0
chr9	GBGT1	133156014	133156065	0	52	0	4024	0	3972	0.0	0.0
chr9	OBP2B	133208468	133208602	0	135	0	1102	0	967	0.0	0.0
chr9	OBP2B	133207839	133207945	0	107	0	1102	0	995	0.0	0.0
chr9	MED22	133346539	133346700	0	162	3176	7240	3176	7078	0.0	0.4487143260808138
chr9	SURF1	133356268	133356320	0	53	0	1767	0	1714	0.0	0.0
chr9	SURF4	133366598	133366675	0	78	601	2035	601	1957	0.0	0.30710270822687785
chr9	SURF4	133364839	133365026	295	188	601	2035	306	1847	1.5691489361702127	0.165674066053059
chr9	SURF4	133375238	133375388	0	151	601	2035	601	1884	0.0	0.3190021231422505
chr9	REXO4	133414664	133415011	0	348	0	2663	0	2315	0.0	0.0
chr9	REXO4	133414664	133414833	0	170	0	2663	0	2493	0.0	0.0
chr9	SLC2A6	133473414	133473600	1975	187	16598	2985	14623	2798	10.561497326203208	5.226233023588278
chr9	SLC2A6	133478253	133478416	459	164	16598	2985	16139	2821	2.798780487804878	5.721020914569301
chr9	VAV2	133769416	133769503	1256	88	559172	5715	557916	5627	14.272727272727273	99.14981339968011
chr9	VAV2	133787245	133787260	95	16	559172	5715	559077	5699	5.9375	98.10089489384103
chr9	VAV2	133810190	133810205	0	16	559172	5715	559172	5699	0.0	98.11756448499737
chr9	BRD3	134040033	134040269	0	237	26890	6896	26890	6659	0.0	4.038143865445262
chr9	SOHLH1	135693969	135694035	0	67	72	3499	72	3432	0.0	0.02097902097902098
chr9	CAMSAP1	135815889	135816005	0	117	8152	7044	8152	6927	0.0	1.1768442327125739
chr9	CAMSAP1	135862466	135862608	0	143	8152	7044	8152	6901	0.0	1.1812780756412113
chr9	CAMSAP1	135865331	135865364	0	34	8152	7044	8152	7010	0.0	1.1629101283880172
chr9	DNLZ	136362988	136363128	0	141	0	3102	0	2961	0.0	0.0
chr9	ENTR1	136408998	136409067	0	70	0	2733	0	2663	0.0	0.0
chr9	ENTR1	136410089	136410239	0	151	0	2733	0	2582	0.0	0.0
chr9	SEC16A	136445051	136445111	0	61	0	10006	0	9945	0.0	0.0
chr9	SEC16A	136445644	136445719	0	76	0	10006	0	9930	0.0	0.0
chr9	AGPAT2	136676584	136676680	0	97	13650	1830	13650	1733	0.0	7.876514714368148
chr9	LCN10	136740835	136740943	0	109	2040	3360	2040	3251	0.0	0.6274992310058444
chr9	LCN10	136741251	136741361	0	111	2040	3360	2040	3249	0.0	0.6278855032317636
chr9	LCN10	136741655	136741737	153	83	2040	3360	1887	3277	1.8433734939759037	0.5758315532499237
chr9	LCN10	136740835	136741014	0	180	2040	3360	2040	3180	0.0	0.6415094339622641
chr9	ABCA2	137010192	137010371	0	180	835073	10294	835073	10114	0.0	82.56604706347638
chr9	ABCA2	137023837	137023840	566	4	835073	10294	834507	10290	141.5	81.09883381924199
chr9	AL807752.6	137032735	137032879	459	145	816	895	357	750	3.1655172413793102	0.476
chr9	ENTPD2	137051210	137051370	0	161	0	2649	0	2488	0.0	0.0
chr9	DPP7	137111940	137112029	0	90	51	2550	51	2460	0.0	0.020731707317073172
chr9	DPP7	137111872	137112029	0	158	51	2550	51	2392	0.0	0.021321070234113712
chr9	DPP7	137113360	137113496	0	137	51	2550	51	2413	0.0	0.021135515955242438
chr9	DPP7	137113205	137113287	0	83	51	2550	51	2467	0.0	0.020672882042967168
chr9	EXD3	137352065	137352201	0	137	7338	7522	7338	7385	0.0	0.9936357481381178
chr9	EXD3	137354566	137354773	0	208	7338	7522	7338	7314	0.0	1.003281378178835
chr9	EXD3	137307607	137307646	0	40	7338	7522	7338	7482	0.0	0.9807538091419407
chr9	EXD3	137354699	137354773	0	75	7338	7522	7338	7447	0.0	0.9853632335168524
chr9	EXD3	137365126	137366156	0	1031	7338	7522	7338	6491	0.0	1.130488368510245
chr9	EXD3	137374611	137374763	735	153	7338	7522	6603	7369	4.803921568627451	0.8960510245623559
chr9	ENTPD8	137435718	137435829	0	112	0	2728	0	2616	0.0	0.0
chr9	NSMF	137453730	137453820	0	91	55	3951	55	3860	0.0	0.014248704663212436
chr9	NSMF	137455238	137455307	0	70	55	3951	55	3881	0.0	0.014171605256377222
chr9	NSMF	137455628	137455634	0	7	55	3951	55	3944	0.0	0.013945233265720081
chr9	PNPLA7	137547584	137547659	0	76	1763	9077	1763	9001	0.0	0.1958671258749028
chr9	DPH7	137564892	137564958	0	67	2991	4023	2991	3956	0.0	0.756066734074823
chr9	DPH7	137577469	137577603	918	135	2991	4023	2073	3888	6.8	0.533179012345679
chr9	DPH7	137577576	137577603	20	28	2991	4023	2971	3995	0.7142857142857143	0.7436795994993742
chr9	AL772363.1	137874063	137874232	0	170	0	4409	0	4239	0.0	0.0
chr10	TUBB8	48614	48725	0	112	0	2879	0	2767	0.0	0.0
chr10	TUBB8	48803	48912	0	110	0	2879	0	2769	0.0	0.0
chr10	TUBB8	48424	48725	0	302	0	2879	0	2577	0.0	0.0
chr10	DIP2C	311536	311566	0	31	12459	8604	12459	8573	0.0	1.4532835646798088
chr10	DIP2C	484780	484948	0	169	12459	8604	12459	8435	0.0	1.47705986959099
chr10	LARP4B	870012	870083	150	72	81305	8723	81155	8651	2.0833333333333335	9.380996416599237
chr10	LARP4B	924382	924433	0	52	81305	8723	81305	8671	0.0	9.376657824933687
chr10	IDI1	1043998	1044171	2057	174	23613	4349	21556	4175	11.82183908045977	5.16311377245509
chr10	LINC00700	1997870	1997954	0	85	51	4424	51	4339	0.0	0.01175386033648306
chr10	LINC02662	2172739	2172834	0	96	0	630	0	534	0.0	0.0
chr10	LINC02645	2501557	2501809	0	253	102	5534	102	5281	0.0	0.019314523764438554
chr10	LINC02645	2454982	2455121	0	140	102	5534	102	5394	0.0	0.018909899888765295
chr10	LINC02645	2485696	2485828	0	133	102	5534	102	5401	0.0	0.01888539159414923
chr10	LINC02645	2451203	2451331	0	129	102	5534	102	5405	0.0	0.01887141535615171
chr10	PITRM1	3140686	3140812	0	127	1244093	11641	1244093	11514	0.0	108.05046030918881
chr10	PITRM1	3143605	3143731	131963	127	1244093	11641	1112130	11514	1039.0787401574803	96.58936946326212
chr10	PITRM1	3156929	3157064	804	136	1244093	11641	1243289	11505	5.911764705882353	108.06510212950892
chr10	PITRM1	3170103	3170206	9281	104	1244093	11641	1234812	11537	89.24038461538461	107.0305972089798
chr10	PITRM1	3170777	3170953	2257	177	1244093	11641	1241836	11464	12.751412429378531	108.3248429867411
chr10	PITRM1	3170733	3170953	2798	221	1244093	11641	1241295	11420	12.660633484162895	108.69483362521892
chr10	PITRM1	3140686	3140765	0	80	1244093	11641	1244093	11561	0.0	107.61119280339071
chr10	LINC02668	3238260	3240502	0	2243	0	3685	0	1442	0.0	0.0
chr10	LINC02669	3499183	3499234	0	52	462	6362	462	6310	0.0	0.07321711568938194
chr10	LINC02669	3496152	3496236	0	85	462	6362	462	6277	0.0	0.07360203919069619
chr10	LINC02669	3496393	3496598	0	206	462	6362	462	6156	0.0	0.07504873294346978
chr10	LINC02669	3487331	3488352	0	1022	462	6362	462	5340	0.0	0.08651685393258426
chr10	LINC02669	3491883	3491966	0	84	462	6362	462	6278	0.0	0.07359031538706594
chr10	LINC02669	3499183	3499255	0	73	462	6362	462	6289	0.0	0.0734615996183813
chr10	KLF6	3780105	3780229	0	125	9	4846	9	4721	0.0	0.0019063757678457953
chr10	MANCR	4656033	4656252	0	220	0	2838	0	2618	0.0	0.0
chr10	MANCR	4656702	4656925	0	224	0	2838	0	2614	0.0	0.0
chr10	AKR1C2	4999199	4999277	0	79	0	5845	0	5766	0.0	0.0
chr10	AKR1C8P	5158599	5158709	0	111	255	2345	255	2234	0.0	0.11414503133393017
chr10	AKR1C8P	5161711	5161767	0	57	255	2345	255	2288	0.0	0.11145104895104894
chr10	AKR1C7P	5278077	5278191	0	115	0	903	0	788	0.0	0.0
chr10	CALML3-AS1	5524308	5524420	0	113	851	9210	851	9097	0.0	0.09354732329339342
chr10	AL732437.3	5550643	5550810	0	168	0	1372	0	1204	0.0	0.0
chr10	LASTR	5602357	5602496	0	140	0	4818	0	4678	0.0	0.0
chr10	LASTR	5596010	5596099	0	90	0	4818	0	4728	0.0	0.0
chr10	LASTR	5609686	5609797	0	112	0	4818	0	4706	0.0	0.0
chr10	LASTR	5617300	5617400	0	101	0	4818	0	4717	0.0	0.0
chr10	ASB13	5651212	5651363	0	152	1911	3010	1911	2858	0.0	0.6686494051784465
chr10	ASB13	5642472	5642553	0	82	1911	3010	1911	2928	0.0	0.6526639344262295
chr10	GDI2	5766493	5766638	295	146	8554	3932	8259	3786	2.0205479452054793	2.1814580031695723
chr10	GDI2	5794884	5795019	0	136	8554	3932	8554	3796	0.0	2.2534246575342465
chr10	GDI2	5800597	5800705	189	109	8554	3932	8365	3823	1.7339449541284404	2.1880721946115615
chr10	GDI2	5794884	5794989	0	106	8554	3932	8554	3826	0.0	2.23575535807632
chr10	GDI2	5811873	5811956	0	84	8554	3932	8554	3848	0.0	2.222972972972973
chr10	ANKRD16	5880297	5880376	0	80	51	3068	51	2988	0.0	0.01706827309236948
chr10	IL15RA	5963742	5963841	323	100	255746	3649	255423	3549	3.23	71.97041420118343
chr10	IL15RA	5968775	5968928	298	154	255746	3649	255448	3495	1.9350649350649352	73.089556509299
chr10	IL15RA	5966144	5966339	18440	196	255746	3649	237306	3453	94.08163265306122	68.72458731537793
chr10	IL15RA	5958240	5958351	61524	112	255746	3649	194222	3537	549.3214285714286	54.9115069267741
chr10	IL15RA	5968593	5968703	311	111	255746	3649	255435	3538	2.8018018018018016	72.19756924816281
chr10	IL15RA	5963742	5963838	302	97	255746	3649	255444	3552	3.11340206185567	71.91554054054055
chr10	IL2RA	6021477	6021693	0	217	0	3971	0	3754	0.0	0.0
chr10	IL2RA	6019869	6019941	0	73	0	3971	0	3898	0.0	0.0
chr10	IL2RA	6021504	6021693	0	190	0	3971	0	3781	0.0	0.0
chr10	PRKCQ	6441892	6442081	0	190	0	3314	0	3124	0.0	0.0
chr10	PRKCQ	6507435	6507496	0	62	0	3314	0	3252	0.0	0.0
chr10	AL392086.3	6826610	6826702	0	93	2244	14045	2244	13952	0.0	0.16083715596330275
chr10	AL392086.3	6826610	6826786	0	177	2244	14045	2244	13868	0.0	0.16181136429189502
chr10	AL392086.3	6986535	6986693	0	159	2244	14045	2244	13886	0.0	0.1616016131355322
chr10	LINC02642	7469685	7469741	0	57	0	2960	0	2903	0.0	0.0
chr10	CELF2-DT	10422597	10422774	0	178	0	6941	0	6763	0.0	0.0
chr10	CELF2-DT	10433923	10434031	0	109	0	6941	0	6832	0.0	0.0
chr10	SFTA1P	10784833	10784962	0	130	0	1202	0	1072	0.0	0.0
chr10	SFTA1P	10792371	10792525	0	155	0	1202	0	1047	0.0	0.0
chr10	LINC00710	10947445	10947556	0	112	0	6504	0	6392	0.0	0.0
chr10	LINC00710	10936623	10936716	0	94	0	6504	0	6410	0.0	0.0
chr10	LINC00710	10946785	10947556	0	772	0	6504	0	5732	0.0	0.0
chr10	LINC00710	10929600	10929655	0	56	0	6504	0	6448	0.0	0.0
chr10	LINC00710	10925002	10925188	0	187	0	6504	0	6317	0.0	0.0
chr10	LINC00710	10946024	10946094	0	71	0	6504	0	6433	0.0	0.0
chr10	LINC00710	10946785	10947319	0	535	0	6504	0	5969	0.0	0.0
chr10	LINC00710	10935233	10935413	0	181	0	6504	0	6323	0.0	0.0
chr10	LINC00710	10937437	10937561	0	125	0	6504	0	6379	0.0	0.0
chr10	LINC00710	10936623	10937561	0	939	0	6504	0	5565	0.0	0.0
chr10	LINC00710	10946785	10947122	0	338	0	6504	0	6166	0.0	0.0
chr10	LINC00710	10936623	10936704	0	82	0	6504	0	6422	0.0	0.0
chr10	CELF2-AS2	11071809	11072875	0	1067	0	4185	0	3118	0.0	0.0
chr10	CELF2-AS2	11078760	11078929	0	170	0	4185	0	4015	0.0	0.0
chr10	CELF2-AS2	11073983	11074084	0	102	0	4185	0	4083	0.0	0.0
chr10	CELF2-AS2	11099444	11099498	0	55	0	4185	0	4130	0.0	0.0
chr10	CELF2-AS2	11102113	11102182	0	70	0	4185	0	4115	0.0	0.0
chr10	CELF2-AS2	11104965	11105073	0	109	0	4185	0	4076	0.0	0.0
chr10	NUDT5	12184493	12184532	0	40	26597	4491	26597	4451	0.0	5.975511121096383
chr10	UCMA	13233734	13233800	120	67	6768	875	6648	808	1.791044776119403	8.227722772277227
chr10	PHYH	13298186	13298245	0	60	510	3388	510	3328	0.0	0.15324519230769232
chr10	SEPHS1	13322834	13323047	15031	214	38735	3895	23704	3681	70.23831775700934	6.439554468894322
chr10	SEPHS1	13344757	13345028	0	272	38735	3895	38735	3623	0.0	10.691415953629589
chr10	BEND7	13500509	13500679	0	171	0	5715	0	5544	0.0	0.0
chr10	BEND7	13446484	13446541	0	58	0	5715	0	5657	0.0	0.0
chr10	FRMD4A	13651902	13651974	0	73	49822	13266	49822	13193	0.0	3.776396573940726
chr10	FRMD4A	13693481	13693517	194	37	49822	13266	49628	13229	5.243243243243243	3.751455136442664
chr10	FRMD4A	13759164	13759506	0	343	49822	13266	49822	12923	0.0	3.8552967577187958
chr10	FRMD4A	13753055	13753100	0	46	49822	13266	49822	13220	0.0	3.7686838124054463
chr10	FRMD4A	14388680	14388903	0	224	49822	13266	49822	13042	0.0	3.820119613556203
chr10	FAM107B	14553321	14553387	0	67	720	6879	720	6812	0.0	0.10569583088667057
chr10	FAM107B	14527936	14528039	0	104	720	6879	720	6775	0.0	0.10627306273062731
chr10	FAM107B	14556361	14556405	43	45	720	6879	677	6834	0.9555555555555556	0.09906350599941469
chr10	FAM107B	14542578	14542686	0	109	720	6879	720	6770	0.0	0.10635155096011817
chr10	CDNF	14825478	14825620	48	143	252	1710	204	1567	0.3356643356643357	0.1301850670070198
chr10	CDNF	14834216	14834333	0	118	252	1710	252	1592	0.0	0.15829145728643215
chr10	CDNF	14836250	14836294	0	45	252	1710	252	1665	0.0	0.15135135135135136
chr10	CDNF	14825493	14825620	33	128	252	1710	219	1582	0.2578125	0.13843236409608092
chr10	DCLRE1C	14926842	14926897	0	56	105127	9612	105127	9556	0.0	11.001151109250733
chr10	DCLRE1C	14936537	14936593	0	57	105127	9612	105127	9555	0.0	11.002302459445316
chr10	DCLRE1C	14945104	14945189	2077	86	105127	9612	103050	9526	24.151162790697676	10.817761914759606
chr10	DCLRE1C	14949035	14949087	2082	53	105127	9612	103045	9559	39.283018867924525	10.779893294277644
chr10	DCLRE1C	14945434	14945565	7525	132	105127	9612	97602	9480	57.00757575757576	10.295569620253165
chr10	DCLRE1C	14942113	14942435	5755	323	105127	9612	99372	9289	17.81733746130031	10.697814619442351
chr10	DCLRE1C	14947524	14947609	1576	86	105127	9612	103551	9526	18.325581395348838	10.87035481839177
chr10	DCLRE1C	14942113	14942240	1634	128	105127	9612	103493	9484	12.765625	10.912378743146352
chr10	NMT2	15140986	15141029	275	44	11807	5881	11532	5837	6.25	1.9756724344697618
chr10	FAM171A1	15215995	15216110	0	116	90906	4190	90906	4074	0.0	22.313696612665684
chr10	FAM171A1	15254720	15254879	86793	160	90906	4190	4113	4030	542.45625	1.0205955334987593
chr10	MINDY3	15838227	15838279	0	53	297	4097	297	4044	0.0	0.07344213649851632
chr10	MINDY3	15837541	15837633	0	93	297	4097	297	4004	0.0	0.07417582417582418
chr10	RSU1	16816972	16817084	0	113	1424	4135	1424	4022	0.0	0.35405271009448036
chr10	RSU1	16782033	16782084	205	52	1424	4135	1219	4083	3.9423076923076925	0.2985549840803331
chr10	TRDMT1	17161482	17161548	42	67	195	15469	153	15402	0.6268656716417911	0.009933774834437087
chr10	TRDMT1	17162165	17162237	0	73	195	15469	195	15396	0.0	0.012665627435697584
chr10	TRDMT1	17168840	17168917	0	78	195	15469	195	15391	0.0	0.012669742057046325
chr10	TRDMT1	17169309	17169539	0	231	195	15469	195	15238	0.0	0.01279695498096863
chr10	VIM-AS1	17216166	17216274	0	109	153	2013	153	1904	0.0	0.08035714285714286
chr10	ST8SIA6	17379356	17379425	20	70	2518	4110	2498	4040	0.2857142857142857	0.6183168316831683
chr10	HACD1	17599289	17599411	0	123	255	3130	255	3007	0.0	0.08480212836714333
chr10	AL157895.1	19724926	19724981	0	56	0	4681	0	4625	0.0	0.0
chr10	NEBL	20793332	20793376	0	45	175	16049	175	16004	0.0	0.010934766308422895
chr10	NEBL	20818703	20818834	0	132	175	16049	175	15917	0.0	0.010994534145881762
chr10	DNAJC1	21920797	21920963	0	167	1274	2503	1274	2336	0.0	0.5453767123287672
chr10	DNAJC1	21928505	21928552	0	48	1274	2503	1274	2455	0.0	0.5189409368635438
chr10	AL513128.3	22469769	22469887	0	119	0	1708	0	1589	0.0	0.0
chr10	PIP4K2A	22569012	22569054	0	43	23123	5125	23123	5082	0.0	4.5499803227075954
chr10	AL139815.1	22970096	22970162	0	67	1030	2374	1030	2307	0.0	0.44646727351538795
chr10	ARHGAP21	24591224	24591330	0	107	1048	9962	1048	9855	0.0	0.10634195839675292
chr10	ARHGAP21	24622732	24622762	0	31	1048	9962	1048	9931	0.0	0.10552814419494512
chr10	ARHGAP21	24590453	24590550	0	98	1048	9962	1048	9864	0.0	0.10624493106244931
chr10	ARHGAP21	24590205	24590479	0	275	1048	9962	1048	9687	0.0	0.10818622896665635
chr10	PRTFDC1	24851387	24851464	0	78	10983	2334	10983	2256	0.0	4.868351063829787
chr10	ENKUR	24999400	24999546	0	147	2652	4084	2652	3937	0.0	0.6736093472186945
chr10	ABI1	26759061	26759235	0	175	90	4231	90	4056	0.0	0.022189349112426034
chr10	ABI1	26771074	26771089	0	16	90	4231	90	4215	0.0	0.021352313167259787
chr10	ABI1	26755654	26755741	0	88	90	4231	90	4143	0.0	0.02172338884866039
chr10	ABI1	26763879	26763960	0	82	90	4231	90	4149	0.0	0.021691973969631236
chr10	ABI1	26759061	26759238	0	178	90	4231	90	4053	0.0	0.02220577350111029
chr10	ABI1	26777064	26777241	0	178	90	4231	90	4053	0.0	0.02220577350111029
chr10	ABI1	26839732	26839783	0	52	90	4231	90	4179	0.0	0.021536252692031587
chr10	ANKRD26	27005616	27005723	584	108	193293	13297	192709	13189	5.407407407407407	14.611342785654712
chr10	ANKRD26	27061143	27061242	204	100	193293	13297	193089	13197	2.04	14.631279836326438
chr10	ANKRD26	27082802	27082833	0	32	193293	13297	193293	13265	0.0	14.57165473049378
chr10	ANKRD26	27030392	27030600	3939	209	193293	13297	189354	13088	18.84688995215311	14.46775672371638
chr10	ANKRD26	27098179	27098326	5	148	193293	13297	193288	13149	0.033783783783783786	14.699825081755266
chr10	ANKRD26	27037663	27037782	4733	120	193293	13297	188560	13177	39.44166666666667	14.309782196251044
chr10	ANKRD26	27060817	27060881	0	65	193293	13297	193293	13232	0.0	14.60799576783555
chr10	ANKRD26	27080031	27080153	0	123	193293	13297	193293	13174	0.0	14.672309093669348
chr10	ANKRD26	27080648	27080771	0	124	193293	13297	193293	13173	0.0	14.673422910498747
chr10	YME1L1	27142386	27142485	0	100	10735	5725	10735	5625	0.0	1.9084444444444444
chr10	YME1L1	27147497	27147668	0	172	10735	5725	10735	5553	0.0	1.933189267062849
chr10	YME1L1	27153226	27153281	0	56	10735	5725	10735	5669	0.0	1.8936320338684072
chr10	ACBD5	27208245	27208445	0	201	724	11777	724	11576	0.0	0.06254319281271596
chr10	ACBD5	27215534	27215641	0	108	724	11777	724	11669	0.0	0.062044733910360785
chr10	ACBD5	27217979	27218183	0	205	724	11777	724	11572	0.0	0.06256481161424127
chr10	ACBD5	27223206	27223239	0	34	724	11777	724	11743	0.0	0.06165375117091033
chr10	ACBD5	27231747	27231820	0	74	724	11777	724	11703	0.0	0.06186447919336922
chr10	ACBD5	27235091	27235212	0	122	724	11777	724	11655	0.0	0.06211926211926212
chr10	ACBD5	27204439	27204549	0	111	724	11777	724	11666	0.0	0.06206068918223898
chr10	ACBD5	27234357	27234488	0	132	724	11777	724	11645	0.0	0.06217260626878489
chr10	ACBD5	27221695	27221746	0	52	724	11777	724	11725	0.0	0.061748400852878464
chr10	ACBD5	27198983	27199101	0	119	724	11777	724	11658	0.0	0.062103276719849033
chr10	ACBD5	27220372	27220464	0	93	724	11777	724	11684	0.0	0.06196508045190004
chr10	ARMC4	27835980	27836040	0	61	2870	6364	2870	6303	0.0	0.4553387275900365
chr10	ARMC4	27853241	27853363	0	123	2870	6364	2870	6241	0.0	0.4598622015702612
chr10	MPP7	28254773	28254876	0	104	0	6190	0	6086	0.0	0.0
chr10	MPP7	28280099	28280140	0	42	0	6190	0	6148	0.0	0.0
chr10	LINC00837	28794541	28794643	0	103	918	4864	918	4761	0.0	0.19281663516068054
chr10	SVIL	29532528	29533458	0	931	277	12477	277	11546	0.0	0.023990992551533
chr10	SVIL	29526960	29527056	0	97	277	12477	277	12380	0.0	0.02237479806138934
chr10	SVIL	29508341	29508389	0	49	277	12477	277	12428	0.0	0.022288381074991953
chr10	MTPAP	30373659	30373853	0	195	294	8335	294	8140	0.0	0.036117936117936116
chr10	ZNF438	30857679	30857778	0	100	51	4283	51	4183	0.0	0.012192206550322734
chr10	ZNF438	30910359	30910440	0	82	51	4283	51	4201	0.0	0.012139966674601285
chr10	ZNF438	30984368	30984426	0	59	51	4283	51	4224	0.0	0.012073863636363636
chr10	ZNF438	30875330	30875509	0	180	51	4283	51	4103	0.0	0.012429929320009749
chr10	ZEB1-AS1	31309892	31310015	0	124	3603	3673	3603	3549	0.0	1.0152155536770922
chr10	ARHGAP12	31839304	31839319	0	16	28935	5865	28935	5849	0.0	4.94699948709181
chr10	ARHGAP12	31854065	31854206	0	142	28935	5865	28935	5723	0.0	5.055914730036694
chr10	ARHGAP12	31839636	31839711	0	76	28935	5865	28935	5789	0.0	4.9982725859388495
chr10	KIF5B	32018315	32018387	0	73	663	5892	663	5819	0.0	0.11393710259494759
chr10	EPC1	32273921	32274038	0	118	13807	6820	13807	6702	0.0	2.060131304088332
chr10	EPC1	32273013	32273082	0	70	13807	6820	13807	6750	0.0	2.0454814814814815
chr10	ITGB1	32901511	32901635	0	125	150	12473	150	12348	0.0	0.012147716229348883
chr10	ITGB1	32907062	32907143	0	82	150	12473	150	12391	0.0	0.012105560487450569
chr10	ITGB1	32936241	32936423	0	183	150	12473	150	12290	0.0	0.012205044751830757
chr10	ITGB1	32953592	32953809	0	218	150	12473	150	12255	0.0	0.012239902080783354
chr10	ITGB1	32936349	32936423	0	75	150	12473	150	12398	0.0	0.012098725600903372
chr10	ITGB1	32933350	32933583	0	234	150	12473	150	12239	0.0	0.012255903260070268
chr10	ITGB1	32933481	32933583	0	103	150	12473	150	12370	0.0	0.012126111560226353
chr10	ITGB1	32938553	32938730	0	178	150	12473	150	12295	0.0	0.012200081333875559
chr10	ITGB1	32921570	32921702	0	133	150	12473	150	12340	0.0	0.012155591572123177
chr10	ITGB1	32906464	32906580	0	117	150	12473	150	12356	0.0	0.012139851084493364
chr10	ITGB1	32906464	32906562	0	99	150	12473	150	12374	0.0	0.01212219169225796
chr10	ITGB1	32951674	32951758	0	85	150	12473	150	12388	0.0	0.012108492089118501
chr10	NRP1	33182697	33182748	1338	52	320899	9558	319561	9506	25.73076923076923	33.616768356827265
chr10	NRP1	33202911	33202995	1733	85	320899	9558	319166	9473	20.388235294117646	33.69217776839439
chr10	NRP1	33202890	33202995	1964	106	320899	9558	318935	9452	18.528301886792452	33.742594159966146
chr10	NRP1	33270674	33270856	9	183	320899	9558	320890	9375	0.04918032786885246	34.22826666666667
chr10	LINC00838	33770210	33770567	0	358	408	3582	408	3224	0.0	0.12655086848635236
chr10	LINC00838	33771553	33771720	0	168	408	3582	408	3414	0.0	0.1195079086115993
chr10	PARD3	34284134	34284245	0	112	2709	6541	2709	6429	0.0	0.4213719085394307
chr10	PARD3	34336198	34336243	0	46	2709	6541	2709	6495	0.0	0.41709006928406467
chr10	PARD3	34450316	34450448	44	133	2709	6541	2665	6408	0.3308270676691729	0.4158863920099875
chr10	PARD3	34372497	34372536	0	40	2709	6541	2709	6501	0.0	0.4167051222888786
chr10	CUL2	35011847	35011964	255	118	1053	5181	798	5063	2.1610169491525424	0.15761406280861148
chr10	CUL2	35089895	35090001	51	107	1053	5181	1002	5074	0.4766355140186916	0.1974773354355538
chr10	CUL2	35087754	35087876	126	123	1053	5181	927	5058	1.024390243902439	0.18327402135231316
chr10	AL392046.1	35119985	35120035	0	51	52	1393	52	1342	0.0	0.038748137108792845
chr10	ZNF248	37856434	37856532	0	99	459	6037	459	5938	0.0	0.0772987537891546
chr10	BX322639.1	42340500	42340556	0	57	255	7215	255	7158	0.0	0.03562447611064543
chr10	CCNYL2	42427199	42427251	0	53	0	3845	0	3792	0.0	0.0
chr10	CCNYL2	42446168	42446204	0	37	0	3845	0	3808	0.0	0.0
chr10	CCNYL2	42430157	42430225	0	69	0	3845	0	3776	0.0	0.0
chr10	ZNF37BP	42525539	42525660	0	122	0	2664	0	2542	0.0	0.0
chr10	ZNF33B	42632294	42632439	0	146	0	2830	0	2684	0.0	0.0
chr10	ZNF33B	42636919	42636972	0	54	0	2830	0	2776	0.0	0.0
chr10	LINC01518	42690732	42690842	9	111	60	2507	51	2396	0.08108108108108109	0.021285475792988316
chr10	ZNF239	43573636	43573677	0	42	0	2513	0	2471	0.0	0.0
chr10	ZNF239	43567898	43568021	0	124	0	2513	0	2389	0.0	0.0
chr10	LINC02659	43903427	43903589	357	163	21283	1824	20926	1661	2.1901840490797544	12.598434677904876
chr10	LINC02659	43903427	43904221	10305	795	21283	1824	10978	1029	12.962264150943396	10.668610301263362
chr10	LINC02659	43903427	43903600	358	174	21283	1824	20925	1650	2.057471264367816	12.681818181818182
chr10	TMEM72-AS1	44825501	44825581	0	81	51	9465	51	9384	0.0	0.005434782608695652
chr10	TMEM72-AS1	44830999	44831245	0	247	51	9465	51	9218	0.0	0.0055326535040138855
chr10	TMEM72-AS1	44885207	44885300	0	94	51	9465	51	9371	0.0	0.005442322057411162
chr10	TMEM72-AS1	44834065	44835319	0	1255	51	9465	51	8210	0.0	0.006211936662606578
chr10	TMEM72-AS1	44923080	44923226	0	147	51	9465	51	9318	0.0	0.005473277527366388
chr10	TMEM72-AS1	44823189	44823288	0	100	51	9465	51	9365	0.0	0.005445808862786973
chr10	TMEM72-AS1	44873634	44874087	0	454	51	9465	51	9011	0.0	0.005659749195427811
chr10	TMEM72-AS1	44826151	44826368	0	218	51	9465	51	9247	0.0	0.005515302260192495
chr10	TMEM72-AS1	44845339	44845407	0	69	51	9465	51	9396	0.0	0.005427841634738187
chr10	TMEM72-AS1	44830569	44830681	0	113	51	9465	51	9352	0.0	0.005453378956372969
chr10	TMEM72-AS1	44830569	44830707	0	139	51	9465	51	9326	0.0	0.005468582457645293
chr10	TMEM72-AS1	44937291	44937407	51	117	51	9465	0	9348	0.4358974358974359	0.0
chr10	TMEM72-AS1	44834065	44835315	0	1251	51	9465	51	8214	0.0	0.00620891161431702
chr10	AL358394.3	45121043	45121171	0	129	0	1228	0	1099	0.0	0.0
chr10	CEP164P1	45066332	45066522	0	191	51	4368	51	4177	0.0	0.01220971989466124
chr10	CEP164P1	45070477	45070663	0	187	51	4368	51	4181	0.0	0.012198038746711314
chr10	MARCHF8	45463150	45463996	0	847	4375	7527	4375	6680	0.0	0.6549401197604791
chr10	MARCHF8	45553111	45553204	0	94	4375	7527	4375	7433	0.0	0.5885914166554554
chr10	ZFAND4	45652983	45653059	0	77	0	6248	0	6171	0.0	0.0
chr10	ZFAND4	45662579	45662681	0	103	0	6248	0	6145	0.0	0.0
chr10	ZFAND4	45640240	45640421	0	182	0	6248	0	6066	0.0	0.0
chr10	FAM21FP	45720993	45721064	0	72	51	1544	51	1472	0.0	0.034646739130434784
chr10	AGAP4	45841652	45841687	0	36	892	3384	892	3348	0.0	0.26642771804062126
chr10	AGAP4	45844325	45844394	183	70	892	3384	709	3314	2.6142857142857143	0.21394085697042847
chr10	AGAP4	45846686	45846755	0	70	892	3384	892	3314	0.0	0.2691611345805673
chr10	NCOA4	46014853	46014942	0	90	0	4093	0	4003	0.0	0.0
chr10	NCOA4	46016539	46016694	0	156	0	4093	0	3937	0.0	0.0
chr10	NCOA4	46015125	46015266	0	142	0	4093	0	3951	0.0	0.0
chr10	NCOA4	46009123	46009212	0	90	0	4093	0	4003	0.0	0.0
chr10	NCOA4	46027431	46027528	0	98	0	4093	0	3995	0.0	0.0
chr10	MSMB	46038965	46039071	0	107	0	931	0	824	0.0	0.0
chr10	NPY4R	46463729	46463885	0	157	0	2036	0	1879	0.0	0.0
chr10	ANXA8	47473969	47474065	0	97	0	4421	0	4324	0.0	0.0
chr10	ANXA8	47475492	47475572	0	81	0	4421	0	4340	0.0	0.0
chr10	ANXA8	47476231	47476322	0	92	0	4421	0	4329	0.0	0.0
chr10	AL591684.2	47543015	47543203	0	189	0	1637	0	1448	0.0	0.0
chr10	FO681492.1	47761440	47761645	0	206	1416	4347	1416	4141	0.0	0.34194638976092734
chr10	AC245041.2	47956025	47956164	0	140	7498	2162	7498	2022	0.0	3.7082096933728983
chr10	FRMPD2	48244783	48244849	0	67	17759	8540	17759	8473	0.0	2.0959518470435503
chr10	FRMPD2	48249020	48249178	0	159	17759	8540	17759	8381	0.0	2.1189595513661854
chr10	ARHGAP22	48582952	48583152	0	201	0	6564	0	6363	0.0	0.0
chr10	TMEM273	49165204	49165283	0	80	0	3704	0	3624	0.0	0.0
chr10	TMEM273	49165765	49165796	0	32	0	3704	0	3672	0.0	0.0
chr10	TMEM273	49165204	49165361	0	158	0	3704	0	3546	0.0	0.0
chr10	ERCC6	49476214	49476310	0	97	11820	12679	11820	12582	0.0	0.9394372913686219
chr10	ERCC6	49493116	49493252	0	137	11820	12679	11820	12542	0.0	0.9424334236963802
chr10	ERCC6	49475326	49475496	0	171	11820	12679	11820	12508	0.0	0.9449952030700352
chr10	OGDHL	49756775	49756946	0	172	92	5631	92	5459	0.0	0.01685290346217256
chr10	OGDHL	49758388	49758593	0	206	92	5631	92	5425	0.0	0.01695852534562212
chr10	PARG	49922546	49922669	0	124	0	5150	0	5026	0.0	0.0
chr10	PARG	49935075	49935142	0	68	0	5150	0	5082	0.0	0.0
chr10	FAM21EP	50056783	50056911	0	129	0	2561	0	2432	0.0	0.0
chr10	ASAH2	50196772	50196919	0	148	0	7300	0	7152	0.0	0.0
chr10	ASAH2	50211029	50211134	0	106	0	7300	0	7194	0.0	0.0
chr10	ASAH2	50198300	50198369	0	70	0	7300	0	7230	0.0	0.0
chr10	SGMS1	50327204	50327322	0	119	0	6440	0	6321	0.0	0.0
chr10	A1CF	50859841	50859985	0	145	0	9619	0	9474	0.0	0.0
chr10	A1CF	50864032	50864080	0	49	0	9619	0	9570	0.0	0.0
chr10	A1CF	50862888	50862981	0	94	0	9619	0	9525	0.0	0.0
chr10	A1CF	50850664	50850807	0	144	0	9619	0	9475	0.0	0.0
chr10	PRKG1-AS1	52304228	52304302	0	75	51	6321	51	6246	0.0	0.008165225744476465
chr10	LNCAROD	52723869	52724018	0	150	102	2115	102	1965	0.0	0.051908396946564885
chr10	PCDH15	53820164	53820230	0	67	404	15436	404	15369	0.0	0.026286680981195912
chr10	PCDH15	53828564	53828573	0	10	404	15436	404	15426	0.0	0.026189550110203554
chr10	PCDH15	54089983	54090063	0	81	404	15436	404	15355	0.0	0.026310647997394986
chr10	PCDH15	54527811	54527877	0	67	404	15436	404	15369	0.0	0.026286680981195912
chr10	PCDH15	53825135	53825141	0	7	404	15436	404	15429	0.0	0.026184457839134097
chr10	PCDH15	54528387	54528402	0	16	404	15436	404	15420	0.0	0.026199740596627757
chr10	PCDH15	54195682	54195889	0	208	404	15436	404	15228	0.0	0.026530076175466245
chr10	PCDH15	53811548	53811619	0	72	404	15436	404	15364	0.0	0.026295235615725072
chr10	PCDH15	54189363	54189384	0	22	404	15436	404	15414	0.0	0.026209939016478525
chr10	PCDH15	54132874	54133007	0	134	404	15436	404	15302	0.0	0.0264017775454189
chr10	FAM13C	59361025	59361110	0	86	51	6772	51	6686	0.0	0.007627879150463655
chr10	FAM13C	59302800	59302864	0	65	51	6772	51	6707	0.0	0.007603995825257194
chr10	FAM13C	59327624	59327713	0	90	51	6772	51	6682	0.0	0.007632445375636037
chr10	MRLN	59738997	59739119	0	123	0	2534	0	2411	0.0	0.0
chr10	MRLN	59738997	59739095	0	99	0	2534	0	2435	0.0	0.0
chr10	ANK3	60068636	60076448	97	7813	87829	22486	87732	14673	0.012415205426852682	5.9791453690451855
chr10	ANK3	60082149	60082176	0	28	87829	22486	87829	22458	0.0	3.9108112921898655
chr10	ANK3	60166590	60166653	96	64	87829	22486	87733	22422	1.5	3.912808848452413
chr10	ANK3	60059697	60060006	605	310	87829	22486	87224	22176	1.9516129032258065	3.9332611832611835
chr10	ANK3	60053676	60053727	56	52	87829	22486	87773	22434	1.0769230769230769	3.912498885620041
chr10	ANK3	60145967	60146021	20573	55	87829	22486	67256	22431	374.05454545454546	2.998350497079934
chr10	ANK3	60073871	60076454	0	2584	87829	22486	87829	19902	0.0	4.41307406290825
chr10	ANK3	60059697	60060033	902	337	87829	22486	86927	22149	2.6765578635014835	3.9246467109124565
chr10	ANK3	60068648	60068869	85	222	87829	22486	87744	22264	0.38288288288288286	3.9410707869205894
chr10	ANK3	60111733	60111766	0	34	87829	22486	87829	22452	0.0	3.9118564047746305
chr10	ANK3	60108187	60108286	0	100	87829	22486	87829	22386	0.0	3.9233896185115698
chr10	ANK3	60137341	60137353	0	13	87829	22486	87829	22473	0.0	3.9082009522538157
chr10	RHOBTB1	60886111	60886230	0	120	0	2915	0	2795	0.0	0.0
chr10	RTKN2	62215028	62215091	0	64	51	9807	51	9743	0.0	0.005234527352971364
chr10	AC024597.1	62371932	62372024	0	93	3	2592	3	2499	0.0	0.0012004801920768306
chr10	AC024597.1	62344690	62344823	0	134	3	2592	3	2458	0.0	0.0012205044751830757
chr10	JMJD1C	63200475	63200677	0	203	1651	11063	1651	10860	0.0	0.15202578268876613
chr10	JMJD1C	63219877	63219983	0	107	1651	11063	1651	10956	0.0	0.15069368382621395
chr10	JMJD1C	63198512	63198727	0	216	1651	11063	1651	10847	0.0	0.1522079837743155
chr10	JMJD1C	63264650	63264764	0	115	1651	11063	1651	10948	0.0	0.15080379978078187
chr10	DNAJC12	67816039	67816129	0	91	0	2146	0	2055	0.0	0.0
chr10	DNAJC12	67816039	67816133	0	95	0	2146	0	2051	0.0	0.0
chr10	DNAJC12	67827541	67827683	0	143	0	2146	0	2003	0.0	0.0
chr10	HERC4	67959112	67959136	0	25	102	15726	102	15701	0.0	0.006496401503088976
chr10	HERC4	68032777	68032869	0	93	102	15726	102	15633	0.0	0.006524659374400307
chr10	HERC4	68044403	68044563	0	161	102	15726	102	15565	0.0	0.006553164150337295
chr10	HERC4	67988042	67988144	0	103	102	15726	102	15623	0.0	0.006528835690968444
chr10	HERC4	68039416	68039488	0	73	102	15726	102	15653	0.0	0.006516322749632659
chr10	PBLD	68296265	68296364	0	100	0	3053	0	2953	0.0	0.0
chr10	RUFY2	68345701	68345911	0	211	322	8004	322	7793	0.0	0.041319132554856926
chr10	RUFY2	68386058	68386128	0	71	322	8004	322	7933	0.0	0.04058994075381318
chr10	RUFY2	68396779	68396881	0	103	322	8004	322	7901	0.0	0.04075433489431717
chr10	RUFY2	68345830	68345911	0	82	322	8004	322	7922	0.0	0.04064630143903055
chr10	RUFY2	68404670	68404844	0	175	322	8004	322	7829	0.0	0.041129135266317535
chr10	DNA2	68470488	68470612	0	125	11	4023	11	3898	0.0	0.0028219599794766545
chr10	SLC25A16	68493448	68493570	0	123	153	6889	153	6766	0.0	0.022613065326633167
chr10	SLC25A16	68517083	68517185	0	103	153	6889	153	6786	0.0	0.022546419098143235
chr10	SLC25A16	68496433	68496512	0	80	153	6889	153	6809	0.0	0.022470259950066088
chr10	SLC25A16	68517083	68517265	0	183	153	6889	153	6706	0.0	0.022815389203698182
chr10	LINC02636	70001386	70001494	0	109	0	1534	0	1425	0.0	0.0
chr10	SAR1A	70162689	70162759	0	71	19372	3902	19372	3831	0.0	5.056643174105978
chr10	SAR1A	70155087	70155124	0	38	19372	3902	19372	3864	0.0	5.013457556935818
chr10	PPA1	70210194	70210419	409	226	42459	3893	42050	3667	1.8097345132743363	11.467139350968093
chr10	LRRC20	70323862	70324030	0	169	0	3632	0	3463	0.0	0.0
chr10	LRRC20	70340552	70340702	0	151	0	3632	0	3481	0.0	0.0
chr10	LRRC20	70376451	70376596	0	146	0	3632	0	3486	0.0	0.0
chr10	PRF1	70600363	70600906	1020	544	1348	2521	328	1977	1.875	0.16590794132524025
chr10	PSAP	71823887	71823896	0	10	0	3204	0	3194	0.0	0.0
chr10	ASCC1	72128081	72128167	6	87	17435	5932	17429	5845	0.06896551724137931	2.9818648417450815
chr10	ASCC1	72152868	72152988	0	121	17435	5932	17435	5811	0.0	3.0003441748408193
chr10	ASCC1	72102333	72102412	0	80	17435	5932	17435	5852	0.0	2.9793233082706765
chr10	ASCC1	72102849	72102967	765	119	17435	5932	16670	5813	6.428571428571429	2.867710304489936
chr10	ASCC1	72204421	72204505	0	85	17435	5932	17435	5847	0.0	2.981871044980332
chr10	ASCC1	72208024	72208146	0	123	17435	5932	17435	5809	0.0	3.001377173351696
chr10	ASCC1	72181934	72181994	14531	61	17435	5932	2904	5871	238.21311475409837	0.49463464486458864
chr10	ASCC1	72132233	72132341	0	109	17435	5932	17435	5823	0.0	2.9941610853511937
chr10	ASCC1	72133056	72133181	0	126	17435	5932	17435	5806	0.0	3.00292800551154
chr10	ASCC1	72198448	72198665	0	218	17435	5932	17435	5714	0.0	3.0512775638781937
chr10	ASCC1	72215781	72215854	0	74	17435	5932	17435	5858	0.0	2.9762717651075454
chr10	ASCC1	72212187	72212285	0	99	17435	5932	17435	5833	0.0	2.989027944453969
chr10	ASCC1	72215781	72216109	0	329	17435	5932	17435	5603	0.0	3.111725861145815
chr10	MICU1	72379463	72379583	168	121	2229	3871	2061	3750	1.3884297520661157	0.5496
chr10	MICU1	72524734	72524746	0	13	2229	3871	2229	3858	0.0	0.5777604976671851
chr10	MICU1	72509397	72509403	0	7	2229	3871	2229	3864	0.0	0.5768633540372671
chr10	MICU1	72477492	72477603	0	112	2229	3871	2229	3759	0.0	0.592976855546688
chr10	P4HA1	73016845	73016899	0	55	43	3109	43	3054	0.0	0.014079895219384414
chr10	ECD	73152292	73152421	0	130	0	2757	0	2627	0.0	0.0
chr10	ECD	73154255	73154448	0	194	0	2757	0	2563	0.0	0.0
chr10	ECD	73163732	73163950	0	219	0	2757	0	2538	0.0	0.0
chr10	ECD	73141386	73141485	0	100	0	2757	0	2657	0.0	0.0
chr10	CFAP70	73272927	73273017	0	91	0	3807	0	3716	0.0	0.0
chr10	CFAP70	73269613	73269715	0	103	0	3807	0	3704	0.0	0.0
chr10	ANXA7	73400802	73400857	0	56	51	2878	51	2822	0.0	0.018072289156626505
chr10	ANXA7	73396043	73396109	0	67	51	2878	51	2811	0.0	0.01814300960512273
chr10	PPP3CB	73439871	73439901	0	31	0	4509	0	4478	0.0	0.0
chr10	PPP3CB	73448663	73448690	0	28	0	4509	0	4481	0.0	0.0
chr10	USP54	73504849	73504990	0	142	307959	9532	307959	9390	0.0	32.79648562300319
chr10	USP54	73520907	73521027	0	121	307959	9532	307959	9411	0.0	32.72330251832962
chr10	USP54	73530703	73530835	0	133	307959	9532	307959	9399	0.0	32.76508139163741
chr10	USP54	73534599	73534770	0	172	307959	9532	307959	9360	0.0	32.90160256410256
chr10	USP54	73519796	73519992	0	197	307959	9532	307959	9335	0.0	32.98971612212105
chr10	AGAP5	73697094	73697163	0	70	0	2842	0	2772	0.0	0.0
chr10	AGAP5	73681007	73681341	0	335	0	2842	0	2507	0.0	0.0
chr10	BMS1P4	73720006	73720194	0	189	1133	2675	1133	2486	0.0	0.4557522123893805
chr10	CAMK2G	73828088	73828121	0	34	838	6806	838	6772	0.0	0.12374483165977555
chr10	CAMK2G	73839538	73839601	0	64	838	6806	838	6742	0.0	0.1242954612874518
chr10	CAMK2G	73819531	73819645	0	115	838	6806	838	6691	0.0	0.12524286354804962
chr10	CAMK2G	73825278	73825347	0	70	838	6806	838	6736	0.0	0.1244061757719715
chr10	CAMK2G	73819531	73819617	0	87	838	6806	838	6719	0.0	0.12472094061616312
chr10	CAMK2G	73825320	73825347	0	28	838	6806	838	6778	0.0	0.12363529064620832
chr10	AP3M1	74138805	74138931	950	127	2275	5701	1325	5574	7.480314960629921	0.2377108001435235
chr10	AC022540.1	74516722	74516901	0	180	54	1237	54	1057	0.0	0.0510879848628193
chr10	DUSP13	75105660	75105868	0	209	0	2053	0	1844	0.0	0.0
chr10	DUSP13	75107991	75108209	0	219	0	2053	0	1834	0.0	0.0
chr10	DUSP13	75099030	75099120	0	91	0	2053	0	1962	0.0	0.0
chr10	DUSP13	75101866	75101961	0	96	0	2053	0	1957	0.0	0.0
chr10	DUSP13	75103893	75104097	0	205	0	2053	0	1848	0.0	0.0
chr10	DUSP13	75107991	75108283	0	293	0	2053	0	1760	0.0	0.0
chr10	AC010997.3	75280269	75280331	0	63	1020	569	1020	506	0.0	2.015810276679842
chr10	KCNMA1	76889450	76889569	0	120	42679	29771	42679	29651	0.0	1.4393780985464233
chr10	KCNMA1	77011966	77012043	0	78	42679	29771	42679	29693	0.0	1.4373421345098172
chr10	KCNMA1	77025445	77025457	0	13	42679	29771	42679	29758	0.0	1.43420256737684
chr10	KCNMA1	77073096	77073252	0	157	42679	29771	42679	29614	0.0	1.4411764705882353
chr10	KCNMA1	77108480	77108572	0	93	42679	29771	42679	29678	0.0	1.4380686030055934
chr10	KCNMA1	77403861	77404023	134	163	42679	29771	42545	29608	0.8220858895705522	1.4369427181842744
chr10	KCNMA1	77008184	77008193	0	10	42679	29771	42679	29761	0.0	1.434057995363059
chr10	KCNMA1	76914056	76914137	0	82	42679	29771	42679	29689	0.0	1.4375357876654653
chr10	KCNMA1	76884988	76885017	0	30	42679	29771	42679	29741	0.0	1.4350223597054572
chr10	KCNMA1	77001406	77001580	48	175	42679	29771	42631	29596	0.2742857142857143	1.4404311393431546
chr10	KCNMA1	76977542	76977638	0	97	42679	29771	42679	29674	0.0	1.4382624519781626
chr10	KCNMA1	77108285	77108377	0	93	42679	29771	42679	29678	0.0	1.4380686030055934
chr10	KCNMA1	76974486	76974573	0	88	42679	29771	42679	29683	0.0	1.4378263652595762
chr10	KCNMA1	77012518	77012557	0	40	42679	29771	42679	29731	0.0	1.435505028421513
chr10	KCNMA1	76952036	76952159	650	124	42679	29771	42029	29647	5.241935483870968	1.4176476540628056
chr10	KCNMA1	77493797	77493929	0	133	42679	29771	42679	29638	0.0	1.440009447331129
chr10	KCNMA1	77249564	77249679	0	116	42679	29771	42679	29655	0.0	1.439183948743888
chr10	DLG5	77821081	77822101	0	1021	894	9074	894	8053	0.0	0.11101452874705078
chr10	DLG5	77845210	77845437	0	228	894	9074	894	8846	0.0	0.1010626271761248
chr10	POLR3A	78009536	78009675	0	140	153	8919	153	8779	0.0	0.01742795306982572
chr10	ZMIZ1-AS1	78960504	78960716	255	213	8166	4634	7911	4421	1.1971830985915493	1.7894141596923774
chr10	ZMIZ1-AS1	79066447	79066586	0	140	8166	4634	8166	4494	0.0	1.8170894526034713
chr10	ZMIZ1-AS1	79050281	79050417	228	137	8166	4634	7938	4497	1.6642335766423357	1.7651767845230153
chr10	ZMIZ1-AS1	79054595	79054728	0	134	8166	4634	8166	4500	0.0	1.8146666666666667
chr10	SFTPA2	79559968	79559998	0	31	80034	2541	80034	2510	0.0	31.88605577689243
chr10	SFTPA2	79559968	79560163	408	196	80034	2541	79626	2345	2.0816326530612246	33.955650319829424
chr10	SFTPA2	79559667	79559730	0	64	80034	2541	80034	2477	0.0	32.31085991118288
chr10	NUTM2B-AS1	79806038	79806122	0	85	1780319	19359	1780319	19274	0.0	92.36894261699699
chr10	NUTM2B-AS1	79808758	79808832	133	75	1780319	19359	1780186	19284	1.7733333333333334	92.31414644264676
chr10	NUTM2B-AS1	79808758	79808963	1102	206	1780319	19359	1779217	19153	5.349514563106796	92.89495118258236
chr10	NUTM2B-AS1	79808762	79808832	121	71	1780319	19359	1780198	19288	1.704225352112676	92.29562422231439
chr10	NUTM2B-AS1	79812112	79812177	1066	66	1780319	19359	1779253	19293	16.151515151515152	92.22272326750635
chr10	NUTM2B-AS1	79801949	79802003	683	55	1780319	19359	1779636	19304	12.418181818181818	92.19001243265645
chr10	NUTM2B-AS1	79808762	79808963	1090	202	1780319	19359	1779229	19157	5.396039603960396	92.87618103043275
chr10	TMEM254-AS1	80056318	80056405	0	88	0	3144	0	3056	0.0	0.0
chr10	ANXA11	80157640	80157763	0	124	116	8534	116	8410	0.0	0.013793103448275862
chr10	ANXA11	80176106	80176155	0	50	116	8534	116	8484	0.0	0.013672795851013672
chr10	ANXA11	80180940	80181136	0	197	116	8534	116	8337	0.0	0.01391387789372676
chr10	ANXA11	80171612	80171881	0	270	116	8534	116	8264	0.0	0.014036786060019362
chr10	ANXA11	80156377	80156498	92	122	116	8534	24	8412	0.7540983606557377	0.0028530670470756064
chr10	MAT1A	80283915	80284038	0	124	0	3083	0	2959	0.0	0.0
chr10	DYDC1	80354360	80354483	0	124	0	1245	0	1121	0.0	0.0
chr10	DYDC1	80354360	80354458	0	99	0	1245	0	1146	0.0	0.0
chr10	LRIT2	84222827	84222857	0	31	0	3060	0	3029	0.0	0.0
chr10	LINC02647	85419420	85419511	0	92	0	1989	0	1897	0.0	0.0
chr10	GRID1	85619866	85620033	0	168	63	6249	63	6081	0.0	0.010360138135175136
chr10	AL844892.2	86397287	86397455	0	169	51	3563	51	3394	0.0	0.015026517383618149
chr10	AL844892.2	86397287	86397458	0	172	51	3563	51	3391	0.0	0.015039811265113535
chr10	WAPL	86451966	86452131	0	166	0	7092	0	6926	0.0	0.0
chr10	MMRN2	86945560	86945689	0	130	0	5016	0	4886	0.0	0.0
chr10	NUTM2A-AS1	87246114	87246212	0	99	51	19888	51	19789	0.0	0.002577189347617363
chr10	NUTM2A-AS1	87307956	87308060	0	105	51	19888	51	19783	0.0	0.002577970985189304
chr10	NUTM2A-AS1	87333825	87334814	0	990	51	19888	51	18898	0.0	0.0026986982749497303
chr10	NUTM2A-AS1	87330891	87330965	0	75	51	19888	51	19813	0.0	0.0025740675314187655
chr10	NUTM2A-AS1	87330891	87331096	0	206	51	19888	51	19682	0.0	0.002591200081292552
chr10	NUTM2A-AS1	87291935	87292533	0	599	51	19888	51	19289	0.0	0.002643993986209757
chr10	NUTM2A-AS1	87329771	87329843	0	73	51	19888	51	19815	0.0	0.0025738077214231643
chr10	RNLS	88572902	88573061	51	160	7446	4798	7395	4638	0.31875	1.594437257438551
chr10	PANK1	89593812	89593989	0	178	2992	7649	2992	7471	0.0	0.40048186320439033
chr10	AL157400.3	89699523	89699671	306	149	1666	3244	1360	3095	2.053691275167785	0.4394184168012924
chr10	HTR7	90743592	90743690	0	99	279	3476	279	3377	0.0	0.08261770802487414
chr10	IDE	92463730	92464003	0	274	1764	14554	1764	14280	0.0	0.12352941176470589
chr10	IDE	92479276	92479421	0	146	1764	14554	1764	14408	0.0	0.12243198223209328
chr10	IDE	92478644	92478789	0	146	1764	14554	1764	14408	0.0	0.12243198223209328
chr10	IDE	92504793	92504897	0	105	1764	14554	1764	14449	0.0	0.12208457332687384
chr10	IDE	92507574	92507666	0	93	1764	14554	1764	14461	0.0	0.12198326533434756
chr10	IDE	92483254	92483337	0	84	1764	14554	1764	14470	0.0	0.12190739460953698
chr10	IDE	92465675	92465843	0	169	1764	14554	1764	14385	0.0	0.12262773722627737
chr10	IDE	92559033	92559215	0	183	1764	14554	1764	14371	0.0	0.1227471992206527
chr10	IDE	92465026	92465104	0	79	1764	14554	1764	14475	0.0	0.12186528497409327
chr10	IDE	92480792	92480916	0	125	1764	14554	1764	14429	0.0	0.12225379444174926
chr10	IDE	92554880	92554917	0	38	1764	14554	1764	14516	0.0	0.12152108018737945
chr10	IDE	92462483	92462604	0	122	1764	14554	1764	14432	0.0	0.12222838137472283
chr10	IDE	92479276	92480916	0	1641	1764	14554	1764	12913	0.0	0.1366065205606753
chr10	IDE	92554721	92554769	0	49	1764	14554	1764	14505	0.0	0.12161323681489142
chr10	MYOF	93341912	93341969	0	58	8913	8547	8913	8489	0.0	1.049946990222641
chr10	MYOF	93323269	93323358	0	90	8913	8547	8913	8457	0.0	1.0539198297268535
chr10	MYOF	93392916	93392955	0	40	8913	8547	8913	8507	0.0	1.0477254026096157
chr10	PLCE1-AS2	94106020	94106194	296	175	56408	4224	56112	4049	1.6914285714285715	13.858236601630033
chr10	PLCE1-AS2	94108357	94108391	0	35	56408	4224	56408	4189	0.0	13.465743614227739
chr10	PLCE1-AS2	94107066	94107155	0	90	56408	4224	56408	4134	0.0	13.644895984518627
chr10	PLCE1-AS1	94280593	94280629	175	37	277	2916	102	2879	4.72972972972973	0.035428968391802707
chr10	CYP2C8	95068566	95068628	0	63	1159	2543	1159	2480	0.0	0.46733870967741936
chr10	CYP2C8	95067528	95067691	0	164	1159	2543	1159	2379	0.0	0.48717948717948717
chr10	CYP2C8	95040921	95040960	0	40	1159	2543	1159	2503	0.0	0.46304434678385936
chr10	PDLIM1	95271632	95271784	22	153	15851	2235	15829	2082	0.1437908496732026	7.602785782901057
chr10	SORBS1	95322745	95322805	0	61	1829	10991	1829	10930	0.0	0.16733760292772187
chr10	SORBS1	95336520	95337294	0	775	1829	10991	1829	10216	0.0	0.17903288958496477
chr10	SORBS1	95351208	95351376	0	169	1829	10991	1829	10822	0.0	0.16900757715764184
chr10	SORBS1	95371325	95371427	0	103	1829	10991	1829	10888	0.0	0.16798310066127847
chr10	SORBS1	95371983	95372049	0	67	1829	10991	1829	10924	0.0	0.1674295129989015
chr10	SORBS1	95406117	95406147	0	31	1829	10991	1829	10960	0.0	0.16687956204379562
chr10	SORBS1	95414493	95414862	0	370	1829	10991	1829	10621	0.0	0.17220600696732888
chr10	SORBS1	95422189	95422216	21	28	1829	10991	1808	10963	0.75	0.16491836176229135
chr10	SORBS1	95434621	95434717	567	97	1829	10991	1262	10894	5.845360824742268	0.11584358362401322
chr10	SORBS1	95336520	95336805	0	286	1829	10991	1829	10705	0.0	0.17085474077533863
chr10	SORBS1	95386990	95387119	0	130	1829	10991	1829	10861	0.0	0.1684006997514041
chr10	SORBS1	95394610	95394673	0	64	1829	10991	1829	10927	0.0	0.1673835453463897
chr10	SORBS1	95375972	95376056	0	85	1829	10991	1829	10906	0.0	0.16770584999083074
chr10	SORBS1	95355626	95357105	0	1480	1829	10991	1829	9511	0.0	0.19230364840710756
chr10	SORBS1	95414493	95414655	0	163	1829	10991	1829	10828	0.0	0.1689139268562985
chr10	SORBS1	95395000	95395075	0	76	1829	10991	1829	10915	0.0	0.16756756756756758
chr10	SORBS1	95351215	95351376	0	162	1829	10991	1829	10829	0.0	0.1688983285621941
chr10	SORBS1	95415468	95416185	0	718	1829	10991	1829	10273	0.0	0.17803952107466173
chr10	ENTPD1-AS1	95847391	95847485	0	95	35357	22304	35357	22209	0.0	1.5920122472871359
chr10	ENTPD1-AS1	95904829	95904935	0	107	35357	22304	35357	22197	0.0	1.5928729107537054
chr10	ENTPD1-AS1	95878224	95878263	0	40	35357	22304	35357	22264	0.0	1.5880794107078693
chr10	ENTPD1-AS1	95981465	95981593	0	129	35357	22304	35357	22175	0.0	1.5944532130777902
chr10	ENTPD1-AS1	95904829	95904938	0	110	35357	22304	35357	22194	0.0	1.5930882220419933
chr10	ENTPD1-AS1	95897557	95897679	1800	123	35357	22304	33557	22181	14.634146341463415	1.512871376403228
chr10	BLNK	96196907	96197063	0	157	3299	6204	3299	6047	0.0	0.5455597817099388
chr10	BLNK	96215320	96215389	0	70	3299	6204	3299	6134	0.0	0.5378219758721878
chr10	BLNK	96223825	96223989	0	165	3299	6204	3299	6039	0.0	0.5462824971021693
chr10	OPALIN	96351377	96351410	0	34	32755	3882	32755	3848	0.0	8.512214137214137
chr10	OPALIN	96355254	96355290	0	37	32755	3882	32755	3845	0.0	8.51885565669701
chr10	TLL2	96432806	96432962	0	157	144529	7697	144529	7540	0.0	19.168302387267904
chr10	ARHGAP19	97256317	97256404	0	88	102	6182	102	6094	0.0	0.016737774860518542
chr10	ARHGAP19	97258659	97258754	0	96	102	6182	102	6086	0.0	0.01675977653631285
chr10	RRP12	97379627	97379770	356	144	1276159	8568	1275803	8424	2.4722222222222223	151.4485992402659
chr10	RRP12	97390422	97390539	233	118	1276159	8568	1275926	8450	1.9745762711864407	150.99715976331362
chr10	EXOSC1	97437699	97437750	1590	52	13919	1956	12329	1904	30.576923076923077	6.47531512605042
chr10	EXOSC1	97443236	97443311	7758	76	13919	1956	6161	1880	102.07894736842105	3.277127659574468
chr10	EXOSC1	97437190	97437275	324	86	13919	1956	13595	1870	3.7674418604651163	7.270053475935829
chr10	MMS19	97459361	97459526	0	166	0	4976	0	4810	0.0	0.0
chr10	MMS19	97459361	97459505	0	145	0	4976	0	4831	0.0	0.0
chr10	MMS19	97476834	97476963	0	130	0	4976	0	4846	0.0	0.0
chr10	MMS19	97484102	97484151	0	50	0	4976	0	4926	0.0	0.0
chr10	MMS19	97498272	97498392	0	121	0	4976	0	4855	0.0	0.0
chr10	MMS19	97480240	97480357	0	118	0	4976	0	4858	0.0	0.0
chr10	MMS19	97476834	97476919	0	86	0	4976	0	4890	0.0	0.0
chr10	MORN4	97616677	97616787	0	111	9656	2517	9656	2406	0.0	4.01330008312552
chr10	CRTAC1	97882785	97882828	0	44	2332	3570	2332	3526	0.0	0.6613726602382303
chr10	PYROXD2	98388353	98388508	0	156	51	3885	51	3729	0.0	0.013676588897827836
chr10	HPS1	98425817	98425985	0	169	28	5322	28	5153	0.0	0.005433727925480303
chr10	HPS1	98429790	98429889	28	100	28	5322	0	5222	0.28	0.0
chr10	HPS1	98431130	98431291	0	162	28	5322	28	5160	0.0	0.005426356589147287
chr10	HPS1	98435271	98435414	0	144	28	5322	28	5178	0.0	0.005407493240633449
chr10	HPSE2	98743882	98744056	1756	175	16818	4434	15062	4259	10.034285714285714	3.536510918055882
chr10	HPSE2	99144237	99144399	0	163	16818	4434	16818	4271	0.0	3.937719503629127
chr10	HPSE2	98461749	98461819	0	71	16818	4434	16818	4363	0.0	3.854687141874857
chr10	SLC25A28	99613695	99613924	612	230	612	1835	0	1605	2.6608695652173915	0.0
chr10	CWF19L1	100256261	100256476	0	216	204	3999	204	3783	0.0	0.05392545598731166
chr10	CWF19L1	100260217	100260319	0	103	204	3999	204	3896	0.0	0.052361396303901436
chr10	SEC31B	100489251	100489398	17	148	102	7409	85	7261	0.11486486486486487	0.011706376532158105
chr10	SEC31B	100490007	100490322	0	316	102	7409	102	7093	0.0	0.014380375017623008
chr10	SEC31B	100497134	100497280	0	147	102	7409	102	7262	0.0	0.01404571743321399
chr10	SEC31B	100498704	100498804	51	101	102	7409	51	7308	0.504950495049505	0.0069786535303776685
chr10	SEC31B	100501653	100501710	0	58	102	7409	102	7351	0.0	0.013875663175078221
chr10	SEC31B	100507424	100507567	0	144	102	7409	102	7265	0.0	0.014039917412250516
chr10	SEC31B	100509315	100509511	0	197	102	7409	102	7212	0.0	0.014143094841930116
chr10	SEC31B	100500109	100500159	0	51	102	7409	102	7358	0.0	0.01386246262571351
chr10	NDUFB8	100526398	100526554	0	157	0	2005	0	1848	0.0	0.0
chr10	AL133352.1	100523976	100524139	0	164	0	2152	0	1988	0.0	0.0
chr10	MRPL43	100987089	100987196	0	108	51	2672	51	2564	0.0	0.019890795631825272
chr10	MRPL43	100983947	100984074	0	128	51	2672	51	2544	0.0	0.020047169811320754
chr10	MRPL43	100986748	100986975	0	228	51	2672	51	2444	0.0	0.020867430441898527
chr10	MRPL43	100984033	100984074	0	42	51	2672	51	2630	0.0	0.019391634980988594
chr10	PDZD7	101030511	101030684	0	174	7	6620	7	6446	0.0	0.0010859447719515978
chr10	POLL	101585315	101585478	0	164	5033	5429	5033	5265	0.0	0.9559354226020893
chr10	POLL	101587121	101587200	51	80	5033	5429	4982	5349	0.6375	0.9313890446812488
chr10	POLL	101584601	101584720	0	120	5033	5429	5033	5309	0.0	0.9480128084385007
chr10	POLL	101587245	101587382	102	138	5033	5429	4931	5291	0.7391304347826086	0.931959931959932
chr10	FGF8	101775129	101775216	0	88	816	1427	816	1339	0.0	0.6094100074682599
chr10	FGF8	101775739	101775776	19	38	816	1427	797	1389	0.5	0.5737940964722822
chr10	NPM3	101782257	101782351	0	95	0	934	0	839	0.0	0.0
chr10	NPM3	101782838	101782924	0	87	0	934	0	847	0.0	0.0
chr10	OGA	101793912	101793998	0	87	0	5834	0	5747	0.0	0.0
chr10	OGA	101806044	101806143	0	100	0	5834	0	5734	0.0	0.0
chr10	OGA	101800241	101800400	0	160	0	5834	0	5674	0.0	0.0
chr10	KCNIP2	101828150	101828258	0	109	95	2412	95	2303	0.0	0.04125054277029961
chr10	KCNIP2	101828388	101828459	0	72	95	2412	95	2340	0.0	0.0405982905982906
chr10	KCNIP2	101829843	101829897	0	55	95	2412	95	2357	0.0	0.04030547305897327
chr10	KCNIP2	101829843	101829942	0	100	95	2412	95	2312	0.0	0.041089965397923874
chr10	KCNIP2	101831071	101831167	0	97	95	2412	95	2315	0.0	0.04103671706263499
chr10	ARMH3	101993537	101993603	642	67	66843	4773	66201	4706	9.582089552238806	14.067360815979601
chr10	CUEDC2	102425114	102425198	0	85	0	1207	0	1122	0.0	0.0
chr10	ACTR1A	102490548	102490613	0	66	58	3747	58	3681	0.0	0.015756587883727247
chr10	ACTR1A	102481836	102481898	0	63	58	3747	58	3684	0.0	0.015743756786102063
chr10	ACTR1A	102482000	102482175	0	176	58	3747	58	3571	0.0	0.016241949033884068
chr10	CYP17A1	102834035	102834122	0	88	102	2831	102	2743	0.0	0.03718556325191396
chr10	CYP17A1	102832992	102833208	0	217	102	2831	102	2614	0.0	0.03902065799540933
chr10	AL358790.1	102851507	102851629	0	123	0	927	0	804	0.0	0.0
chr10	NT5C2	103090610	103090787	0	178	2680	8572	2680	8394	0.0	0.31927567309983323
chr10	NT5C2	103111744	103111805	0	62	2680	8572	2680	8510	0.0	0.31492361927144535
chr10	NT5C2	103139405	103139479	0	75	2680	8572	2680	8497	0.0	0.315405437213134
chr10	NT5C2	103199407	103199505	0	99	2680	8572	2680	8473	0.0	0.31629883158267436
chr10	NT5C2	103181184	103181328	0	145	2680	8572	2680	8427	0.0	0.3180253945650884
chr10	NT5C2	103098047	103098088	0	42	2680	8572	2680	8530	0.0	0.3141852286049238
chr10	NT5C2	103105357	103105381	0	25	2680	8572	2680	8547	0.0	0.31356031356031355
chr10	NT5C2	103187124	103187246	0	123	2680	8572	2680	8449	0.0	0.3171973014557936
chr10	NT5C2	103111692	103111805	0	114	2680	8572	2680	8458	0.0	0.31685977772523055
chr10	NT5C2	103197764	103197857	0	94	2680	8572	2680	8478	0.0	0.3161122906345836
chr10	NT5C2	103100751	103100964	0	214	2680	8572	2680	8358	0.0	0.3206508734146925
chr10	NT5C2	103100751	103100943	0	193	2680	8572	2680	8379	0.0	0.3198472371404702
chr10	NT5C2	103136248	103136372	510	125	2680	8572	2170	8447	4.08	0.2568959393867645
chr10	NT5C2	103090610	103090638	0	29	2680	8572	2680	8543	0.0	0.3137071286433337
chr10	PCGF6	103347394	103347450	3809	57	27805	3020	23996	2963	66.82456140350877	8.098548768140398
chr10	PCGF6	103330251	103330368	0	118	27805	3020	27805	2902	0.0	9.58132322536182
chr10	ATP5MD	103394198	103394394	612	197	612	930	0	733	3.1065989847715736	0.0
chr10	ATP5MD	103395745	103396032	0	288	612	930	612	642	0.0	0.9532710280373832
chr10	CALHM2	103451082	103451285	51	204	8813	2801	8762	2597	0.25	3.373892953407778
chr10	SH3PXD2A	103622469	103622553	36	85	45519	11774	45483	11689	0.4235294117647059	3.891094191119856
chr10	COL17A1	104074183	104074231	0	49	9397	6693	9397	6644	0.0	1.414358819987959
chr10	COL17A1	104035262	104035373	308	112	9397	6693	9089	6581	2.75	1.381097097705516
chr10	COL17A1	104063537	104063643	114	107	9397	6693	9283	6586	1.0654205607476634	1.4095050106286062
chr10	COL17A1	104073950	104074019	0	70	9397	6693	9397	6623	0.0	1.4188434244300165
chr10	CFAP43	104146262	104146349	0	88	165441	7224	165441	7136	0.0	23.1839966367713
chr10	ITPRIP	104334788	104334997	35	210	25778	7302	25743	7092	0.16666666666666666	3.6298646362098137
chr10	SORCS1	106579090	106579251	0	162	919	6402	919	6240	0.0	0.14727564102564103
chr10	LINC01435	107901008	107901087	0	80	195	6685	195	6605	0.0	0.029523088569265707
chr10	LINC01435	107859148	107859227	0	80	195	6685	195	6605	0.0	0.029523088569265707
chr10	LINC01435	108053924	108054103	0	180	195	6685	195	6505	0.0	0.02997694081475788
chr10	LINC01435	108053430	108053489	0	60	195	6685	195	6625	0.0	0.02943396226415094
chr10	LINC01435	107873760	107873852	0	93	195	6685	195	6592	0.0	0.02958131067961165
chr10	LINC01435	107903081	107903166	0	86	195	6685	195	6599	0.0	0.029549931807849674
chr10	LINC01435	108060611	108060755	42	145	195	6685	153	6540	0.2896551724137931	0.023394495412844038
chr10	XPNPEP1	109880187	109880238	0	52	369	6715	369	6663	0.0	0.05538045925258892
chr10	XPNPEP1	109886245	109886341	0	97	369	6715	369	6618	0.0	0.0557570262919311
chr10	XPNPEP1	109888048	109888192	51	145	369	6715	318	6570	0.35172413793103446	0.048401826484018265
chr10	XPNPEP1	109875527	109875599	0	73	369	6715	369	6642	0.0	0.05555555555555555
chr10	XPNPEP1	109891721	109891826	0	106	369	6715	369	6609	0.0	0.055832955061280075
chr10	XPNPEP1	109893011	109893075	0	65	369	6715	369	6650	0.0	0.055488721804511275
chr10	XPNPEP1	109907690	109907815	0	126	369	6715	369	6589	0.0	0.05600242828957353
chr10	XPNPEP1	109915010	109915099	0	90	369	6715	369	6625	0.0	0.05569811320754717
chr10	XPNPEP1	109915022	109915099	0	78	369	6715	369	6637	0.0	0.05559740846768118
chr10	ADD3-AS1	109997448	109997575	0	128	0	7304	0	7176	0.0	0.0
chr10	ADD3-AS1	109951843	109951965	0	123	0	7304	0	7181	0.0	0.0
chr10	SMNDC1	110300546	110300736	0	191	0	5412	0	5221	0.0	0.0
chr10	BBIP1	110901537	110901612	0	76	0	7695	0	7619	0.0	0.0
chr10	BBIP1	110918120	110918213	0	94	0	7695	0	7601	0.0	0.0
chr10	BBIP1	110908523	110908551	0	29	0	7695	0	7666	0.0	0.0
chr10	BBIP1	110901025	110901279	0	255	0	7695	0	7440	0.0	0.0
chr10	BBIP1	110907679	110907836	0	158	0	7695	0	7537	0.0	0.0
chr10	BBIP1	110910749	110911039	0	291	0	7695	0	7404	0.0	0.0
chr10	BBIP1	110901025	110901122	0	98	0	7695	0	7597	0.0	0.0
chr10	GUCY2GP	112339998	112340036	0	39	20364	3290	20364	3251	0.0	6.263918794217164
chr10	AL157786.1	112408401	112408694	0	294	0	2873	0	2579	0.0	0.0
chr10	NRAP	113642933	113643038	0	106	0	5711	0	5605	0.0	0.0
chr10	CCDC186	114125885	114126105	0	221	102	9021	102	8800	0.0	0.011590909090909091
chr10	CCDC186	114173140	114173265	0	126	102	9021	102	8895	0.0	0.011467116357504217
chr10	AFAP1L2	114398850	114398904	120	55	732	5809	612	5754	2.1818181818181817	0.10636079249217935
chr10	ABLIM1	114447879	114448020	0	142	7103	10244	7103	10102	0.0	0.7031280934468422
chr10	ABLIM1	114485296	114485380	0	85	7103	10244	7103	10159	0.0	0.6991829904518161
chr10	ABLIM1	114453378	114453483	0	106	7103	10244	7103	10138	0.0	0.7006312882225291
chr10	ABLIM1	114473878	114473956	0	79	7103	10244	7103	10165	0.0	0.69877029021151
chr10	ABLIM1	114447879	114448026	0	148	7103	10244	7103	10096	0.0	0.7035459587955626
chr10	ABLIM1	114463044	114463164	0	121	7103	10244	7103	10123	0.0	0.7016694655734466
chr10	ABLIM1	114481478	114481526	0	49	7103	10244	7103	10195	0.0	0.6967140755272192
chr10	GFRA1	116211630	116211645	0	16	83206	9508	83206	9492	0.0	8.76590813316477
chr10	HSPA12A	116681790	116681877	0	88	22311	21134	22311	21046	0.0	1.0601064335265609
chr10	HSPA12A	116705150	116705278	0	129	22311	21134	22311	21005	0.0	1.0621756724589384
chr10	HSPA12A	116707199	116707285	0	87	22311	21134	22311	21047	0.0	1.0600560649973867
chr10	HSPA12A	116834934	116835022	0	89	22311	21134	22311	21045	0.0	1.0601568068424805
chr10	HSPA12A	116705150	116705376	0	227	22311	21134	22311	20907	0.0	1.0671545415411106
chr10	SHTN1	116979255	116979308	0	54	3733	8273	3733	8219	0.0	0.4541915074826621
chr10	AL513324.1	117828804	117828915	0	112	153	2042	153	1930	0.0	0.07927461139896373
chr10	AL513324.1	117827598	117828198	0	601	153	2042	153	1441	0.0	0.10617626648161
chr10	RAB11FIP2	118033981	118034041	0	61	316	5673	316	5612	0.0	0.05630791161796151
chr10	FAM204A	118335395	118335426	0	32	51	3598	51	3566	0.0	0.01430173864273696
chr10	FAM204A	118341726	118341927	0	202	51	3598	51	3396	0.0	0.015017667844522967
chr10	FAM204A	118322304	118322411	0	108	51	3598	51	3490	0.0	0.014613180515759312
chr10	CACUL1	118693701	118693749	42	49	4932	12418	4890	12369	0.8571428571428571	0.395343196701431
chr10	SFXN4	119146235	119146353	0	119	0	1930	0	1811	0.0	0.0
chr10	SFXN4	119161054	119161081	0	28	0	1930	0	1902	0.0	0.0
chr10	TIAL1	119580470	119580846	0	377	82	6812	82	6435	0.0	0.012742812742812743
chr10	TIAL1	119580470	119580538	0	69	82	6812	82	6743	0.0	0.012160759305946909
chr10	WDR11-AS1	120791727	120791926	0	200	37440	6721	37440	6521	0.0	5.741450697745744
chr10	WDR11-AS1	120830218	120830343	76	126	37440	6721	37364	6595	0.6031746031746031	5.665504169825626
chr10	WDR11-AS1	120808232	120808341	51	110	37440	6721	37389	6611	0.4636363636363636	5.655574043261232
chr10	WDR11-AS1	120791313	120791597	658	285	37440	6721	36782	6436	2.3087719298245615	5.715040397762586
chr10	FGFR2	121483697	121483803	0	107	137099	7609	137099	7502	0.0	18.274993335110636
chr10	FGFR2	121565437	121565704	0	268	137099	7609	137099	7341	0.0	18.675793488625526
chr10	FGFR2	121564501	121564579	0	79	137099	7609	137099	7530	0.0	18.2070385126162
chr10	FGFR2	121517318	121517463	0	146	137099	7609	137099	7463	0.0	18.370494439233553
chr10	FGFR2	121518681	121518829	0	149	137099	7609	137099	7460	0.0	18.377882037533514
chr10	FGFR2	121517466	121517472	0	7	137099	7609	137099	7602	0.0	18.03459615890555
chr10	FGFR2	121565636	121565704	0	69	137099	7609	137099	7540	0.0	18.18289124668435
chr10	ATE1	121898840	121898969	0	130	0	5400	0	5270	0.0	0.0
chr10	ATE1	121899865	121899994	0	130	0	5400	0	5270	0.0	0.0
chr10	NSMCE4A	121961840	121962107	0	268	1203	3380	1203	3112	0.0	0.3865681233933162
chr10	AC063960.2	122152509	122152814	0	306	0	4404	0	4098	0.0	0.0
chr10	CUZD1	122841177	122841328	0	152	0	2846	0	2694	0.0	0.0
chr10	FAM24B	122850423	122850550	0	128	0	1181	0	1053	0.0	0.0
chr10	FAM24B	122850423	122850520	0	98	0	1181	0	1083	0.0	0.0
chr10	IKZF5	123007025	123007176	0	152	102	4668	102	4516	0.0	0.022586359610274578
chr10	OAT	124411972	124412200	0	229	0	3121	0	2892	0.0	0.0
chr10	EEF1AKMT2	124762299	124762558	0	260	10370	5827	10370	5567	0.0	1.862762708819831
chr10	CTBP2	125110989	125111093	51	105	2193	9202	2142	9097	0.4857142857142857	0.23546224029899968
chr10	CTBP2	125133511	125133612	0	102	2193	9202	2193	9100	0.0	0.240989010989011
chr10	CTBP2	125088190	125088319	0	130	2193	9202	2193	9072	0.0	0.24173280423280424
chr10	EDRF1-DT	125711473	125711588	0	116	258	3240	258	3124	0.0	0.08258642765685019
chr10	EDRF1-AS1	125749374	125749528	0	155	0	1922	0	1767	0.0	0.0
chr10	EDRF1-AS1	125749374	125749646	0	273	0	1922	0	1649	0.0	0.0
chr10	EDRF1-AS1	125749374	125749547	0	174	0	1922	0	1748	0.0	0.0
chr10	MMP21	125772610	125772750	0	141	4	3450	4	3309	0.0	0.0012088244182532487
chr10	MMP21	125767531	125767704	4	174	4	3450	0	3276	0.022988505747126436	0.0
chr10	MMP21	125772217	125772359	0	143	4	3450	4	3307	0.0	0.0012095554883580285
chr10	UROS	125789282	125789528	0	247	284	8118	284	7871	0.0	0.036081819336805994
chr10	UROS	125798064	125798145	233	82	284	8118	51	8036	2.841463414634146	0.006346441015430563
chr10	UROS	125816176	125816260	0	85	284	8118	284	8033	0.0	0.03535416407319806
chr10	UROS	125795061	125795158	0	98	284	8118	284	8020	0.0	0.03541147132169576
chr10	UROS	125789282	125789363	0	82	284	8118	284	8036	0.0	0.0353409656545545
chr10	UROS	125802949	125803024	0	76	284	8118	284	8042	0.0	0.03531459835861726
chr10	UROS	125796789	125796861	0	73	284	8118	284	8045	0.0	0.03530142945929148
chr10	UROS	125802988	125803024	0	37	284	8118	284	8081	0.0	0.035144165326073507
chr10	UROS	125792578	125792744	0	167	284	8118	284	7951	0.0	0.03571877751226261
chr10	UROS	125794021	125794388	0	368	284	8118	284	7750	0.0	0.03664516129032258
chr10	UROS	125797411	125797425	0	15	284	8118	284	8103	0.0	0.035048747377514504
chr10	C10ORF90	126464695	126464986	41	292	40455	5430	40414	5138	0.1404109589041096	7.865706500583885
chr10	C10ORF90	126512022	126512116	0	95	40455	5430	40455	5335	0.0	7.582942830365511
chr10	AL359094.1	127015009	127015163	0	155	0	4247	0	4092	0.0	0.0
chr10	AL359094.1	127015922	127016097	0	176	0	4247	0	4071	0.0	0.0
chr10	AL359094.1	127007410	127007573	0	164	0	4247	0	4083	0.0	0.0
chr10	AL359094.1	127016497	127016581	0	85	0	4247	0	4162	0.0	0.0
chr10	AL359094.1	127018587	127018657	0	71	0	4247	0	4176	0.0	0.0
chr10	AL359094.1	127018587	127018960	0	374	0	4247	0	3873	0.0	0.0
chr10	INSYN2A	127153851	127153923	0	73	255	4846	255	4773	0.0	0.05342551854179761
chr10	MKI67	128114927	128116007	1000	1081	7872	12634	6872	11553	0.9250693802035153	0.5948238552756859
chr10	AL157832.2	129694118	129694315	0	198	0	2125	0	1927	0.0	0.0
chr10	EBF3	129839082	129839195	303	114	6674	5469	6371	5355	2.6578947368421053	1.1897292250233427
chr10	CFAP46	132810584	132810721	0	138	0	10758	0	10620	0.0	0.0
chr10	MIR202HG	133247553	133247701	0	149	0	1310	0	1161	0.0	0.0
chr10	ADAM8	133263687	133263765	0	79	0	4784	0	4705	0.0	0.0
chr10	ADAM8	133269896	133269974	0	79	0	4784	0	4705	0.0	0.0
chr10	ADAM8	133275483	133275587	0	105	0	4784	0	4679	0.0	0.0
chr10	ADAM8	133274795	133274990	0	196	0	4784	0	4588	0.0	0.0
chr10	TUBGCP2	133302791	133302980	0	190	0	7717	0	7527	0.0	0.0
chr10	TUBGCP2	133297320	133297404	0	85	0	7717	0	7632	0.0	0.0
chr10	FUOM	133357186	133357255	0	70	0	1277	0	1207	0.0	0.0
chr10	ZMYND11	221194	221356	0	163	1405	5345	1405	5182	0.0	0.2711308375144732
chr10	ZMYND11	237584	237677	0	94	1405	5345	1405	5251	0.0	0.2675680822700438
chr10	ZMYND11	240892	240970	0	79	1405	5345	1405	5266	0.0	0.26680592480060766
chr10	ZMYND11	218454	218499	0	46	1405	5345	1405	5299	0.0	0.26514436686167203
chr10	ZMYND11	197910	198005	191	96	1405	5345	1214	5249	1.9895833333333333	0.23128214898075825
chr10	PRR26	665955	666103	0	149	1311	6630	1311	6481	0.0	0.20228359821015277
chr10	GTPBP4	995928	996032	0	105	2599	6138	2599	6033	0.0	0.4307972816177689
chr10	IDI2-AS1	1035813	1035976	51	164	70418	3053	70367	2889	0.31097560975609756	24.35687088958117
chr10	IDI2-AS1	1035289	1035422	102	134	70418	3053	70316	2919	0.7611940298507462	24.089071599862965
chr10	IDI2-AS1	1035289	1035506	150	218	70418	3053	70268	2835	0.6880733944954128	24.78589065255732
chr10	AL713851.1	2559890	2560007	0	118	0	4358	0	4240	0.0	0.0
chr10	AL713851.1	2559334	2559407	0	74	0	4358	0	4284	0.0	0.0
chr10	PFKP	3103778	3103944	0	167	4246	6142	4246	5975	0.0	0.7106276150627615
chr10	PFKP	3100920	3101000	0	81	4246	6142	4246	6061	0.0	0.7005444646098004
chr10	PITRM1-AS1	3142971	3143088	75	118	601294	4376	601219	4258	0.635593220338983	141.19751056834195
chr10	LINC02660	3932655	3932972	0	318	0	1114	0	796	0.0	0.0
chr10	LINC02660	3934519	3934627	0	109	0	1114	0	1005	0.0	0.0
chr10	LINC00705	4659230	4659348	0	119	0	3203	0	3084	0.0	0.0
chr10	LINC00705	4671475	4671659	0	185	0	3203	0	3018	0.0	0.0
chr10	AKR1E2	4824961	4825038	0	78	0	2430	0	2352	0.0	0.0
chr10	AKR1E2	4833349	4833466	0	118	0	2430	0	2312	0.0	0.0
chr10	AKR1E2	4830674	4830842	0	169	0	2430	0	2261	0.0	0.0
chr10	AKR1E2	4837458	4837581	0	124	0	2430	0	2306	0.0	0.0
chr10	AKR1C3	5077899	5077977	0	79	51	3925	51	3846	0.0	0.01326053042121685
chr10	TASOR2	5735303	5735546	696	244	39262	10604	38566	10360	2.8524590163934427	3.7225868725868727
chr10	TASOR2	5709529	5709663	0	135	39262	10604	39262	10469	0.0	3.7503104403476932
chr10	TASOR2	5714134	5714207	0	74	39262	10604	39262	10530	0.0	3.728584995251662
chr10	TASOR2	5717658	5717750	0	93	39262	10604	39262	10511	0.0	3.7353248977261915
chr10	TASOR2	5712393	5712539	0	147	39262	10604	39262	10457	0.0	3.75461413407287
chr10	FBH1	5903019	5903175	78	157	15745	6628	15667	6471	0.4968152866242038	2.4211095657549064
chr10	FBH1	5924750	5924801	504	52	15745	6628	15241	6576	9.692307692307692	2.317670316301703
chr10	RBM17	6097047	6097188	0	142	0	6244	0	6102	0.0	0.0
chr10	PFKFB3	6221640	6221745	823	106	11553	6138	10730	6032	7.764150943396227	1.7788461538461537
chr10	PFKFB3	6226191	6226365	0	175	11553	6138	11553	5963	0.0	1.937447593493208
chr10	PFKFB3	6225160	6225248	0	89	11553	6138	11553	6049	0.0	1.9099024632170607
chr10	PFKFB3	6231262	6231314	0	53	11553	6138	11553	6085	0.0	1.8986031224322104
chr10	PFKFB3	6228195	6228218	168	24	11553	6138	11385	6114	7.0	1.8621197252208046
chr10	PFKFB3	6229108	6229180	0	73	11553	6138	11553	6065	0.0	1.9048639736191262
chr10	PFKFB3	6224505	6224623	0	119	11553	6138	11553	6019	0.0	1.919421830868915
chr10	LINC02649	6331500	6331603	0	104	3958	5103	3958	4999	0.0	0.791758351670334
chr10	PRKCQ-AS1	6582137	6582201	0	65	0	5311	0	5246	0.0	0.0
chr10	PRKCQ-AS1	6586762	6586880	0	119	0	5311	0	5192	0.0	0.0
chr10	PRKCQ-AS1	6585557	6585712	0	156	0	5311	0	5155	0.0	0.0
chr10	PRKCQ-AS1	6596845	6596894	0	50	0	5311	0	5261	0.0	0.0
chr10	PRKCQ-AS1	6584117	6584195	0	79	0	5311	0	5232	0.0	0.0
chr10	PRKCQ-AS1	6585797	6585846	0	50	0	5311	0	5261	0.0	0.0
chr10	PRKCQ-AS1	6615369	6615637	0	269	0	5311	0	5042	0.0	0.0
chr10	LINC00707	6812249	6812556	0	308	0	9845	0	9537	0.0	0.0
chr10	LINC00707	6817048	6817126	0	79	0	9845	0	9766	0.0	0.0
chr10	ITIH2	7705107	7705182	0	76	0	3352	0	3276	0.0	0.0
chr10	ITIH2	7707200	7707233	0	34	0	3352	0	3318	0.0	0.0
chr10	ITIH2	7709021	7709191	0	171	0	3352	0	3181	0.0	0.0
chr10	ATP5F1C	7806973	7807010	0	38	7739	2320	7739	2282	0.0	3.3913234005258546
chr10	ATP5F1C	7796120	7796155	419	36	7739	2320	7320	2284	11.63888888888889	3.2049036777583186
chr10	GATA3	8063992	8064138	0	147	8094	3404	8094	3257	0.0	2.485108996008597
chr10	GATA3	8063995	8064138	0	144	8094	3404	8094	3260	0.0	2.4828220858895707
chr10	CELF2	11217424	11217507	0	84	0	9833	0	9749	0.0	0.0
chr10	CELF2	11266597	11266677	0	81	0	9833	0	9752	0.0	0.0
chr10	CELF2	11325835	11325979	0	145	0	9833	0	9688	0.0	0.0
chr10	CELF2	10846062	10846156	0	95	0	9833	0	9738	0.0	0.0
chr10	CELF2	11320856	11320898	0	43	0	9833	0	9790	0.0	0.0
chr10	DHTKD1	12084539	12084751	0	213	9000	5312	9000	5099	0.0	1.765051970974701
chr10	DHTKD1	12087534	12087729	0	196	9000	5312	9000	5116	0.0	1.7591868647380766
chr10	DHTKD1	12106245	12106396	0	152	9000	5312	9000	5160	0.0	1.744186046511628
chr10	SEC61A2	12136104	12136170	27352	67	466722	3933	439370	3866	408.23880597014926	113.64976720124159
chr10	SEC61A2	12155777	12155931	0	155	466722	3933	466722	3778	0.0	123.53679195341451
chr10	SEC61A2	12157907	12158105	669	199	466722	3933	466053	3734	3.3618090452261304	124.81333690412427
chr10	SEC61A2	12167752	12167893	377	142	466722	3933	466345	3791	2.6549295774647885	123.01371669744131
chr10	SEC61A2	12149851	12149961	28678	111	466722	3933	438044	3822	258.36036036036035	114.61119832548404
chr10	SEC61A2	12156906	12157067	288	162	466722	3933	466434	3771	1.7777777777777777	123.68973747016706
chr10	SEC61A2	12160929	12161121	0	193	466722	3933	466722	3740	0.0	124.79197860962567
chr10	CDC123	12215739	12215835	70017	97	82649	2312	12632	2215	721.8247422680413	5.702934537246049
chr10	CDC123	12237143	12237266	305	124	82649	2312	82344	2188	2.4596774193548385	37.63436928702011
chr10	CDC123	12246148	12246277	0	130	82649	2312	82649	2182	0.0	37.87763519706691
chr10	CDC123	12249580	12249718	0	139	82649	2312	82649	2173	0.0	38.034514496088356
chr10	CAMK1D	12553224	12553356	0	133	7981	8709	7981	8576	0.0	0.9306203358208955
chr10	OPTN	13110273	13110476	51	204	1186	5158	1135	4954	0.25	0.22910779168348808
chr10	OPTN	13108137	13108289	0	153	1186	5158	1186	5005	0.0	0.23696303696303697
chr10	OPTN	13110179	13110476	102	298	1186	5158	1084	4860	0.3422818791946309	0.22304526748971193
chr10	OPTN	13108961	13109015	0	55	1186	5158	1186	5103	0.0	0.23241230648638056
chr10	MCM10	13164127	13164209	0	83	29238	5383	29238	5300	0.0	5.516603773584905
chr10	PRPF18	13591767	13591888	0	122	0	1856	0	1734	0.0	0.0
chr10	PRPF18	13597644	13597671	0	28	0	1856	0	1828	0.0	0.0
chr10	AL157392.3	13643487	13643765	306	279	13373	9029	13067	8750	1.096774193548387	1.4933714285714286
chr10	AL157392.3	13652407	13652489	0	83	13373	9029	13373	8946	0.0	1.4948580371115583
chr10	AL157392.3	13647132	13647276	0	145	13373	9029	13373	8884	0.0	1.505290409725349
chr10	AL157392.3	13648625	13648768	0	144	13373	9029	13373	8885	0.0	1.5051209904333145
chr10	AL157392.3	13648084	13648230	0	147	13373	9029	13373	8882	0.0	1.505629362756136
chr10	AL157392.3	13652845	13652882	0	38	13373	9029	13373	8991	0.0	1.487376265154043
chr10	AL157392.3	13642027	13642155	0	129	13373	9029	13373	8900	0.0	1.5025842696629212
chr10	AL157392.3	13646614	13646780	0	167	13373	9029	13373	8862	0.0	1.5090273076055067
chr10	AL157392.3	13654352	13654427	0	76	13373	9029	13373	8953	0.0	1.493689266167765
chr10	AL157392.3	13652845	13652929	0	85	13373	9029	13373	8944	0.0	1.4951923076923077
chr10	AL157392.3	13648619	13648768	0	150	13373	9029	13373	8879	0.0	1.5061380786124563
chr10	AL157392.3	13651369	13651426	0	58	13373	9029	13373	8971	0.0	1.4906922305205663
chr10	AL157392.3	13652845	13653148	0	304	13373	9029	13373	8725	0.0	1.5327220630372493
chr10	AL157392.3	13654088	13654258	0	171	13373	9029	13373	8858	0.0	1.5097087378640777
chr10	AC069544.2	14842133	14842846	0	714	0	4769	0	4055	0.0	0.0
chr10	SUV39H2	14881499	14881645	0	147	3990	3572	3990	3425	0.0	1.164963503649635
chr10	SUV39H2	14896845	14896977	0	133	3990	3572	3990	3439	0.0	1.160220994475138
chr10	SUV39H2	14896845	14897517	0	673	3990	3572	3990	2899	0.0	1.3763366678164883
chr10	MEIG1	14966439	14966606	0	168	714	1428	714	1260	0.0	0.5666666666666667
chr10	OLAH	15071794	15071877	0	84	52	2300	52	2216	0.0	0.023465703971119134
chr10	OLAH	15056823	15056982	0	160	52	2300	52	2140	0.0	0.024299065420560748
chr10	RPP38	15102217	15102336	0	120	4263	1880	4263	1760	0.0	2.422159090909091
chr10	LINC02654	16283732	16283908	0	177	0	2554	0	2377	0.0	0.0
chr10	LINC02654	16283729	16283908	0	180	0	2554	0	2374	0.0	0.0
chr10	LINC02654	16283735	16283908	0	174	0	2554	0	2380	0.0	0.0
chr10	PTER	16484336	16484816	0	481	4601	4009	4601	3528	0.0	1.3041383219954648
chr10	PTER	16505019	16505160	4	142	4601	4009	4597	3867	0.028169014084507043	1.1887768295836565
chr10	PTER	16437356	16437490	0	135	4601	4009	4601	3874	0.0	1.187661331956634
chr10	STAM	17672974	17673078	0	105	9102	4145	9102	4040	0.0	2.252970297029703
chr10	SLC39A12	17993180	17993291	0	112	2408	2821	2408	2709	0.0	0.8888888888888888
chr10	SLC39A12	17953190	17953537	0	348	2408	2821	2408	2473	0.0	0.9737161342498989
chr10	SLC39A12	17993183	17993291	0	109	2408	2821	2408	2712	0.0	0.887905604719764
chr10	CACNB2	18514235	18514369	0	135	1326	11186	1326	11051	0.0	0.11998914125418514
chr10	CACNB2	18536100	18536196	0	97	1326	11186	1326	11089	0.0	0.11957796014067995
chr10	CACNB2	18514979	18515041	0	63	1326	11186	1326	11123	0.0	0.11921244268632564
chr10	CACNB2	18506470	18506547	0	78	1326	11186	1326	11108	0.0	0.11937342455887648
chr10	CACNB2	18514510	18514530	0	21	1326	11186	1326	11165	0.0	0.11876399462606359
chr10	CACNB2	18522184	18522238	0	55	1326	11186	1326	11131	0.0	0.11912676309406163
chr10	MALRD1	19389182	19389362	0	181	28	7797	28	7616	0.0	0.003676470588235294
chr10	PLXDC2	20046868	20047015	0	148	0	12582	0	12434	0.0	0.0
chr10	MLLT10	21586293	21586348	0	56	51	8958	51	8902	0.0	0.005729049651763648
chr10	MLLT10	21534644	21534804	0	161	51	8958	51	8797	0.0	0.005797430942366716
chr10	MLLT10	21538832	21538912	0	81	51	8958	51	8877	0.0	0.005745184183845894
chr10	MLLT10	21682224	21682257	0	34	51	8958	51	8924	0.0	0.005714926042133572
chr10	MLLT10	21557620	21557824	0	205	51	8958	51	8753	0.0	0.005826573746144179
chr10	MLLT10	21668916	21669052	0	137	51	8958	51	8821	0.0	0.005781657408457091
chr10	MLLT10	21688490	21688538	0	49	51	8958	51	8909	0.0	0.005724548209675609
chr10	MLLT10	21551815	21551921	0	107	51	8958	51	8851	0.0	0.005762060784092193
chr10	MLLT10	21708587	21708657	0	71	51	8958	51	8887	0.0	0.005738719477889051
chr10	MLLT10	21571974	21572026	0	53	51	8958	51	8905	0.0	0.005727119595732734
chr10	MLLT10	21541262	21541361	0	100	51	8958	51	8858	0.0	0.005757507337999549
chr10	COMMD3	22317883	22317995	0	113	0	1905	0	1792	0.0	0.0
chr10	COMMD3	22318271	22318306	0	36	0	1905	0	1869	0.0	0.0
chr10	COMMD3	22318958	22319018	0	61	0	1905	0	1844	0.0	0.0
chr10	COMMD3	22317856	22317995	0	140	0	1905	0	1765	0.0	0.0
chr10	COMMD3	22318104	22318168	0	65	0	1905	0	1840	0.0	0.0
chr10	SPAG6	22412444	22412523	0	80	468	3848	468	3768	0.0	0.12420382165605096
chr10	SPAG6	22364852	22365019	0	168	468	3848	468	3680	0.0	0.12717391304347825
chr10	SPAG6	22411030	22411176	0	147	468	3848	468	3701	0.0	0.1264523101864361
chr10	ARMC3	22955806	22955932	0	127	7966	5988	7966	5861	0.0	1.359153728032759
chr10	ARMC3	22946143	22946261	765	119	7966	5988	7201	5869	6.428571428571429	1.2269551882773897
chr10	ARMC3	22961883	22962078	0	196	7966	5988	7966	5792	0.0	1.3753453038674033
chr10	ARMC3	22959398	22959574	0	177	7966	5988	7966	5811	0.0	1.3708483909826192
chr10	MSRB2	23119045	23119134	0	90	51	1985	51	1895	0.0	0.02691292875989446
chr10	KIAA1217	24494499	24494604	0	106	1785	10748	1785	10642	0.0	0.16773162939297126
chr10	KIAA1217	24542692	24542770	0	79	1785	10748	1785	10669	0.0	0.1673071515605961
chr10	KIAA1217	24536773	24536893	0	121	1785	10748	1785	10627	0.0	0.1679683824221323
chr10	KIAA1217	24542882	24544481	0	1600	1785	10748	1785	9148	0.0	0.19512461740271098
chr10	KIAA1217	24367118	24367168	0	51	1785	10748	1785	10697	0.0	0.16686921566794427
chr10	KIAA1217	24542506	24542542	0	37	1785	10748	1785	10711	0.0	0.16665110633927738
chr10	LINC00836	25652868	25653042	0	175	0	9665	0	9490	0.0	0.0
chr10	LINC00836	25668215	25668330	0	116	0	9665	0	9549	0.0	0.0
chr10	LINC00836	25686576	25686640	0	65	0	9665	0	9600	0.0	0.0
chr10	LINC00836	25695866	25695953	0	88	0	9665	0	9577	0.0	0.0
chr10	LINC00836	25716744	25716981	0	238	0	9665	0	9427	0.0	0.0
chr10	LINC00836	25682520	25683482	0	963	0	9665	0	8702	0.0	0.0
chr10	MYO3A	26120675	26120802	0	128	360	8475	360	8347	0.0	0.04312926800047921
chr10	MYO3A	26202963	26203107	0	145	360	8475	360	8330	0.0	0.04321728691476591
chr10	FAM238A	26592849	26592966	0	118	0	1095	0	977	0.0	0.0
chr10	FAM238B	26648950	26649050	0	101	0	1292	0	1191	0.0	0.0
chr10	PDSS1	26740644	26740817	0	174	0	1927	0	1753	0.0	0.0
chr10	MASTL	27180952	27181066	0	115	0	4672	0	4557	0.0	0.0
chr10	MASTL	27181479	27181581	0	103	0	4672	0	4569	0.0	0.0
chr10	RAB18	27533927	27533994	0	68	4897	6111	4897	6043	0.0	0.8103590931656462
chr10	RAB18	27531528	27531615	46	88	4897	6111	4851	6023	0.5227272727272727	0.8054125850904865
chr10	WAC	28595732	28596041	0	310	51	10128	51	9818	0.0	0.005194540639641474
chr10	WAC	28534233	28534346	0	114	51	10128	51	10014	0.0	0.005092869982025165
chr10	WAC	28611254	28611481	0	228	51	10128	51	9900	0.0	0.005151515151515152
chr10	LINC01517	28901176	28901314	1557	139	91692	8684	90135	8545	11.201438848920864	10.548273844353423
chr10	LINC01517	28907439	28907564	357	126	91692	8684	91335	8558	2.8333333333333335	10.672470203318532
chr10	LINC01517	28802899	28803046	0	148	91692	8684	91692	8536	0.0	10.741799437675727
chr10	LINC01517	28805107	28805258	612	152	91692	8684	91080	8532	4.026315789473684	10.675105485232068
chr10	LINC01517	28806931	28807022	0	92	91692	8684	91692	8592	0.0	10.671787709497206
chr10	LINC01517	28848215	28848366	651	152	91692	8684	91041	8532	4.282894736842105	10.670534458509142
chr10	SVIL-AS1	29418181	29418304	0	124	1734	5005	1734	4881	0.0	0.3552550706822373
chr10	SVIL-AS1	29458273	29458520	0	248	1734	5005	1734	4757	0.0	0.3645154509144419
chr10	MAP3K8	30437175	30437406	0	232	0	3527	0	3295	0.0	0.0
chr10	SVIL2P	30698116	30698241	0	126	34	3253	34	3127	0.0	0.010873041253597697
chr10	LINC02664	31206741	31206864	0	124	0	1651	0	1527	0.0	0.0
chr10	LINC02664	31248526	31248593	0	68	0	1651	0	1583	0.0	0.0
chr10	ZEB1	31495775	31495838	0	64	651	8673	651	8609	0.0	0.07561853873852944
chr10	ZEB1	31495778	31495838	0	61	651	8673	651	8612	0.0	0.07559219693450998
chr10	ZEB1	31461036	31461237	0	202	651	8673	651	8471	0.0	0.07685043088183213
chr10	ZEB1	31502347	31502509	0	163	651	8673	651	8510	0.0	0.07649823736780259
chr10	ZEB1	31387123	31387266	0	144	651	8673	651	8529	0.0	0.07632782272247626
chr10	ZEB1	31373017	31373173	0	157	651	8673	651	8516	0.0	0.07644434006575858
chr10	AL161935.1	31604255	31604414	102	160	28148	2434	28046	2274	0.6375	12.333333333333334
chr10	CCDC7	32471063	32471230	0	168	5648	8667	5648	8499	0.0	0.6645487704435816
chr10	CCDC7	32571858	32571893	22	36	5648	8667	5626	8631	0.6111111111111112	0.6518364036612212
chr10	CCDC7	32491921	32491997	0	77	5648	8667	5648	8590	0.0	0.6575087310826543
chr10	CCDC7	32694878	32694992	0	115	5648	8667	5648	8552	0.0	0.6604303086997194
chr10	CCDC7	32778976	32779084	153	109	5648	8667	5495	8558	1.4036697247706422	0.6420892731946717
chr10	CCDC7	32845242	32845326	0	85	5648	8667	5648	8582	0.0	0.6581216499650431
chr10	CCDC7	32574428	32574526	0	99	5648	8667	5648	8568	0.0	0.6591970121381886
chr10	ITGB1-DT	32960969	32961062	357	94	510	3238	153	3144	3.797872340425532	0.04866412213740458
chr10	AL450313.1	33687039	33687151	0	113	0	1990	0	1877	0.0	0.0
chr10	CREM	35137781	35137879	0	99	186	5551	186	5452	0.0	0.03411592076302274
chr10	CREM	35175852	35175999	36	148	186	5551	150	5403	0.24324324324324326	0.0277623542476402
chr10	CREM	35148367	35148491	0	125	186	5551	186	5426	0.0	0.03427939550313306
chr10	CREM	35188199	35188388	0	190	186	5551	186	5361	0.0	0.03469501958589815
chr10	CREM	35201450	35201486	0	37	186	5551	186	5514	0.0	0.03373231773667029
chr10	CREM	35179133	35179276	0	144	186	5551	186	5407	0.0	0.03439985204364712
chr10	CREM	35178888	35178986	0	99	186	5551	186	5452	0.0	0.03411592076302274
chr10	CREM	35178871	35178986	0	116	186	5551	186	5435	0.0	0.03422263109475621
chr10	CCNY	35529972	35530030	0	59	1643	6127	1643	6068	0.0	0.2707646671061305
chr10	CCNY	35455356	35455463	0	108	1643	6127	1643	6019	0.0	0.27296893171623193
chr10	CCNY	35483403	35483478	0	76	1643	6127	1643	6051	0.0	0.2715253677078169
chr10	CCNY	35394815	35394878	0	64	1643	6127	1643	6063	0.0	0.2709879597558964
chr10	ZNF33A	38015966	38016045	0	80	1581	7554	1581	7474	0.0	0.21153331549371154
chr10	ZNF33A	38012297	38012350	0	54	1581	7554	1581	7500	0.0	0.2108
chr10	ZNF37A	38094930	38095224	0	295	100204	13019	100204	12724	0.0	7.875196479094624
chr10	AL117339.4	38267279	38267400	0	122	3606	3973	3606	3851	0.0	0.9363801609971436
chr10	CCNYL4	38197499	38197551	0	53	0	1546	0	1493	0.0	0.0
chr10	HSD17B7P2	38369123	38369228	1918	106	2173	1515	255	1409	18.09433962264151	0.18097941802696949
chr10	AL133216.2	38415543	38415602	0	60	19905	7231	19905	7171	0.0	2.775763491842142
chr10	LINC00839	42492079	42492342	0	264	51	8183	51	7919	0.0	0.006440207096855664
chr10	RET	43111206	43111465	0	260	15130	6854	15130	6594	0.0	2.294510160752199
chr10	FXYD4	43373514	43373783	0	270	0	842	0	572	0.0	0.0
chr10	FXYD4	43375498	43375573	0	76	0	842	0	766	0.0	0.0
chr10	ZNF487	43476106	43476202	0	97	0	3028	0	2931	0.0	0.0
chr10	LINC00840	43859526	43860123	0	598	34681	7297	34681	6699	0.0	5.177041349455142
chr10	LINC00840	43845532	43845602	0	71	34681	7297	34681	7226	0.0	4.799474121228895
chr10	LINC00840	43849673	43849998	0	326	34681	7297	34681	6971	0.0	4.975039449146464
chr10	LINC00840	43867156	43867339	0	184	34681	7297	34681	7113	0.0	4.875720511739069
chr10	LINC00840	43874189	43874412	0	224	34681	7297	34681	7073	0.0	4.903294217446628
chr10	LINC00841	43909854	43909935	0	82	4332	4991	4332	4909	0.0	0.8824607863108576
chr10	TMEM72	44927920	44927987	0	68	102	3054	102	2986	0.0	0.03415941058271936
chr10	RASSF4	44984021	44984113	45	93	3443	8681	3398	8588	0.4838709677419355	0.39566837447601305
chr10	RASSF4	44980891	44980927	62	37	3443	8681	3381	8644	1.6756756756756757	0.39113836186950485
chr10	ALOX5	45444115	45444286	0	172	510	3570	510	3398	0.0	0.15008828722778106
chr10	WASHC2C	45751481	45751553	0	73	51	5493	51	5420	0.0	0.009409594095940959
chr10	WASHC2C	45777272	45777425	0	154	51	5493	51	5339	0.0	0.009552350627458326
chr10	WASHC2C	45785508	45785631	0	124	51	5493	51	5369	0.0	0.009498975600670517
chr10	WASHC2C	45728861	45729026	0	166	51	5493	51	5327	0.0	0.009573868969401165
chr10	WASHC2C	45786611	45786674	0	64	51	5493	51	5429	0.0	0.009393995210904402
chr10	ANTXRL	46306802	46306872	0	71	1923	2961	1923	2890	0.0	0.6653979238754325
chr10	ANTXRL	46309112	46309202	0	91	1923	2961	1923	2870	0.0	0.6700348432055749
chr10	ANTXRL	46308457	46308666	1275	210	1923	2961	648	2751	6.071428571428571	0.23555070883315157
chr10	ANXA8L1	46385711	46385807	0	97	1562	2872	1562	2775	0.0	0.5628828828828829
chr10	SYT15	46580893	46581036	0	144	0	4472	0	4328	0.0	0.0
chr10	SYT15	46580163	46580368	0	206	0	4472	0	4266	0.0	0.0
chr10	AL356056.1	46609091	46609255	0	165	0	1973	0	1808	0.0	0.0
chr10	AL356056.1	46607726	46607769	0	44	0	1973	0	1929	0.0	0.0
chr10	AL356056.1	46607375	46607769	0	395	0	1973	0	1578	0.0	0.0
chr10	BMS1P1	46797131	46797319	0	189	0	4572	0	4383	0.0	0.0
chr10	PTPN20	46943917	46944015	0	99	26526	4523	26526	4424	0.0	5.995931283905968
chr10	PTPN20	46967956	46968047	1393	92	26526	4523	25133	4431	15.141304347826088	5.67208305122997
chr10	PTPN20	46932376	46932533	0	158	26526	4523	26526	4365	0.0	6.076975945017182
chr10	PTPN20	46940622	46940717	0	96	26526	4523	26526	4427	0.0	5.991868082222724
chr10	PTPN20	46964985	46965137	17076	153	26526	4523	9450	4370	111.6078431372549	2.1624713958810067
chr10	PTPN20	46940581	46940717	0	137	26526	4523	26526	4386	0.0	6.047879616963065
chr10	PTPN20	46984229	46984564	0	336	26526	4523	26526	4187	0.0	6.335323620730834
chr10	PTPN20	46987339	46987555	0	217	26526	4523	26526	4306	0.0	6.160241523455643
chr10	PTPN20	46947840	46947955	0	116	26526	4523	26526	4407	0.0	6.019060585432267
chr10	PTPN20	46955095	46955203	249	109	26526	4523	26277	4414	2.2844036697247705	5.9531037607612145
chr10	NPY4R2	47920737	47920893	0	157	15424	1959	15424	1802	0.0	8.559378468368479
chr10	MAPK8	48404851	48404981	0	131	153	8831	153	8700	0.0	0.017586206896551725
chr10	MAPK8	48325896	48325965	0	70	153	8831	153	8761	0.0	0.01746375984476658
chr10	MAPK8	48364611	48364656	0	46	153	8831	153	8785	0.0	0.017416050085372795
chr10	FAM170B-AS1	49135655	49136081	0	427	0	2297	0	1870	0.0	0.0
chr10	FAM170B-AS1	49148606	49148663	0	58	0	2297	0	2239	0.0	0.0
chr10	FAM170B-AS1	49135876	49136081	0	206	0	2297	0	2091	0.0	0.0
chr10	CHAT	49614303	49614475	0	173	9081	6610	9081	6437	0.0	1.410750349541712
chr10	CHAT	49616022	49616092	0	71	9081	6610	9081	6539	0.0	1.3887444563388898
chr10	TIMM23B	49943234	49943358	0	125	0	3049	0	2924	0.0	0.0
chr10	TIMM23B	49945031	49945090	0	60	0	3049	0	2989	0.0	0.0
chr10	AGAP6	49988750	49988938	0	189	0	3178	0	2989	0.0	0.0
chr10	AGAP6	49989307	49989376	0	70	0	3178	0	3108	0.0	0.0
chr10	AGAP6	49994394	49994429	0	36	0	3178	0	3142	0.0	0.0
chr10	WASHC2A	50084071	50084165	0	95	0	5107	0	5012	0.0	0.0
chr10	WASHC2A	50126056	50126179	0	124	0	5107	0	4983	0.0	0.0
chr10	WASHC2A	50092161	50092233	0	73	0	5107	0	5034	0.0	0.0
chr10	WASHC2A	50117905	50118058	0	154	0	5107	0	4953	0.0	0.0
chr10	WASHC2A	50127159	50127222	0	64	0	5107	0	5043	0.0	0.0
chr10	ASAH2B	50745127	50745274	0	148	153	5888	153	5740	0.0	0.02665505226480836
chr10	ASAH2B	50744696	50744732	0	37	153	5888	153	5851	0.0	0.02614937617501282
chr10	ASAH2B	50745201	50745274	0	74	153	5888	153	5814	0.0	0.02631578947368421
chr10	ASAH2B	50743672	50743741	0	70	153	5888	153	5818	0.0	0.026297696803025093
chr10	PRKG1	52288930	52288993	0	64	714	11773	714	11709	0.0	0.06097873430694338
chr10	UBE2D1	58361494	58361526	0	33	0	2975	0	2942	0.0	0.0
chr10	TFAM	58390764	58390860	0	97	0	5290	0	5193	0.0	0.0
chr10	LINC00844	59022568	59022642	0	75	0	6009	0	5934	0.0	0.0
chr10	LINC00844	59000345	59000512	0	168	0	6009	0	5841	0.0	0.0
chr10	LINC00844	59000345	59000503	0	159	0	6009	0	5850	0.0	0.0
chr10	LINC00844	59001228	59001349	0	122	0	6009	0	5887	0.0	0.0
chr10	LINC00844	59013681	59013771	0	91	0	6009	0	5918	0.0	0.0
chr10	LINC00844	59000133	59000245	0	113	0	6009	0	5896	0.0	0.0
chr10	PHYHIPL	59206753	59206844	0	92	0	4047	0	3955	0.0	0.0
chr10	CDK1	60788059	60788230	0	172	0	3548	0	3376	0.0	0.0
chr10	ZNF365	62376180	62376936	0	757	360	4968	360	4211	0.0	0.08549038233198765
chr10	AC067752.1	62666128	62666202	0	75	765	3973	765	3898	0.0	0.19625448948178553
chr10	AC067752.1	62655366	62655631	0	266	765	3973	765	3707	0.0	0.20636633396277312
chr10	NRBF2	63146208	63146293	0	86	0	1905	0	1819	0.0	0.0
chr10	REEP3	63599669	63599712	0	44	0	5224	0	5180	0.0	0.0
chr10	AC013287.1	64316497	64316594	0	98	74	2952	74	2854	0.0	0.02592852137351086
chr10	LINC01515	65571424	65571579	0	156	510	17753	510	17597	0.0	0.028982212877194977
chr10	LINC01515	65585664	65585802	0	139	510	17753	510	17614	0.0	0.02895424094470308
chr10	LINC01515	65689502	65689611	0	110	510	17753	510	17643	0.0	0.028906648529161708
chr10	LINC01515	65679351	65679412	0	62	510	17753	510	17691	0.0	0.028828217737832798
chr10	LINC01515	65579882	65579948	0	67	510	17753	510	17686	0.0	0.02883636774850164
chr10	LINC01515	65637869	65638050	0	182	510	17753	510	17571	0.0	0.029025098173126172
chr10	LINC01515	65581611	65581673	0	63	510	17753	510	17690	0.0	0.02882984737139627
chr10	LINC01515	65689507	65689611	0	105	510	17753	510	17648	0.0	0.028898458748866727
chr10	LINC01515	65766555	65766623	0	69	510	17753	510	17684	0.0	0.028839629043202895
chr10	SIRT1	67888881	67889123	0	243	51	4575	51	4332	0.0	0.011772853185595568
chr10	SIRT1	67906162	67906287	0	126	51	4575	51	4449	0.0	0.011463250168577209
chr10	MYPN	68114232	68114296	0	65	0	6890	0	6825	0.0	0.0
chr10	HNRNPH3	68337857	68337996	0	140	0	3045	0	2905	0.0	0.0
chr10	CCAR1	68737844	68737889	0	46	0	6086	0	6040	0.0	0.0
chr10	CCAR1	68722454	68722577	0	124	0	6086	0	5962	0.0	0.0
chr10	CCAR1	68771205	68771445	0	241	0	6086	0	5845	0.0	0.0
chr10	CCAR1	68740628	68740661	0	34	0	6086	0	6052	0.0	0.0
chr10	CCAR1	68756272	68756483	0	212	0	6086	0	5874	0.0	0.0
chr10	CCAR1	68756525	68756632	0	108	0	6086	0	5978	0.0	0.0
chr10	STOX1	68884259	68886618	51	2360	51	3919	0	1559	0.021610169491525423	0.0
chr10	STOX1	68884259	68884459	0	201	51	3919	51	3718	0.0	0.013717052178590641
chr10	DDX50	68906283	68906337	0	55	0	2690	0	2635	0.0	0.0
chr10	DDX50	68934198	68934360	0	163	0	2690	0	2527	0.0	0.0
chr10	DDX50	68906225	68906337	0	113	0	2690	0	2577	0.0	0.0
chr10	KIFBP	69000423	69000522	0	100	0	6370	0	6270	0.0	0.0
chr10	KIFBP	69007626	69007751	0	126	0	6370	0	6244	0.0	0.0
chr10	KIFBP	69010899	69011015	0	117	0	6370	0	6253	0.0	0.0
chr10	KIFBP	68989716	68989859	0	144	0	6370	0	6226	0.0	0.0
chr10	KIFBP	68989716	68989742	0	27	0	6370	0	6343	0.0	0.0
chr10	KIFBP	68999714	68999814	0	101	0	6370	0	6269	0.0	0.0
chr10	KIFBP	69006841	69006929	0	89	0	6370	0	6281	0.0	0.0
chr10	KIFBP	69015357	69015436	0	80	0	6370	0	6290	0.0	0.0
chr10	KIFBP	68995203	68995278	0	76	0	6370	0	6294	0.0	0.0
chr10	SRGN	69097083	69097231	0	149	0	1220	0	1071	0.0	0.0
chr10	VPS26A	69132897	69133047	0	151	32	5127	32	4976	0.0	0.006430868167202572
chr10	VPS26A	69155811	69155887	0	77	32	5127	32	5050	0.0	0.006336633663366337
chr10	VPS26A	69158046	69158211	0	166	32	5127	32	4961	0.0	0.006450312437008668
chr10	VPS26A	69168488	69168631	0	144	32	5127	32	4983	0.0	0.006421834236403773
chr10	VPS26A	69157006	69157163	0	158	32	5127	32	4969	0.0	0.006439927550815053
chr10	HK1	69398594	69398828	0	235	102	6322	102	6087	0.0	0.016757023164120255
chr10	HK1	69300768	69300861	0	94	102	6322	102	6228	0.0	0.016377649325626204
chr10	HK1	69278523	69278785	0	263	102	6322	102	6059	0.0	0.016834461132200034
chr10	HK1	69271006	69271096	0	91	102	6322	102	6231	0.0	0.01636976408281175
chr10	HK1	69292257	69292350	0	94	102	6322	102	6228	0.0	0.016377649325626204
chr10	COL13A1	69880502	69880553	0	52	54222	9922	54222	9870	0.0	5.493617021276596
chr10	COL13A1	69919664	69919727	451	64	54222	9922	53771	9858	7.046875	5.454554676404951
chr10	COL13A1	69940987	69941023	0	37	54222	9922	54222	9885	0.0	5.485280728376328
chr10	COL13A1	69945670	69945724	0	55	54222	9922	54222	9867	0.0	5.495287321374278
chr10	COL13A1	69953947	69954025	0	79	54222	9922	54222	9843	0.0	5.508686376104846
chr10	COL13A1	69897474	69897531	0	58	54222	9922	54222	9864	0.0	5.496958637469587
chr10	COL13A1	69898696	69898762	0	67	54222	9922	54222	9855	0.0	5.5019786910197865
chr10	COL13A1	69932559	69932604	0	46	54222	9922	54222	9876	0.0	5.4902794653705955
chr10	COL13A1	69935349	69935391	86	43	54222	9922	54136	9879	2.0	5.4799068731653
chr10	COL13A1	69952881	69952968	0	88	54222	9922	54222	9834	0.0	5.5137278828554
chr10	COL13A1	69875127	69875163	0	37	54222	9922	54222	9885	0.0	5.485280728376328
chr10	COL13A1	69878038	69878065	0	28	54222	9922	54222	9894	0.0	5.480291085506368
chr10	COL13A1	69931159	69931256	0	98	54222	9922	54222	9824	0.0	5.519340390879479
chr10	COL13A1	69872183	69872210	0	28	54222	9922	54222	9894	0.0	5.480291085506368
chr10	COL13A1	69880413	69880553	0	141	54222	9922	54222	9781	0.0	5.543604948369287
chr10	COL13A1	69919664	69919701	165	38	54222	9922	54057	9884	4.342105263157895	5.469142047753945
chr10	COL13A1	69941235	69941347	0	113	54222	9922	54222	9809	0.0	5.527780609644204
chr10	MACROH2A2	70100207	70100297	1355	91	1154095	11836	1152740	11745	14.89010989010989	98.14729672200937
chr10	MACROH2A2	70109032	70109207	0	176	1154095	11836	1154095	11660	0.0	98.97898799313894
chr10	MACROH2A2	70091756	70091954	32136	199	1154095	11836	1121959	11637	161.48743718592965	96.41307897224371
chr10	MACROH2A2	70093734	70093845	7548	112	1154095	11836	1146547	11724	67.39285714285714	97.79486523370863
chr10	MACROH2A2	70055066	70055177	0	112	1154095	11836	1154095	11724	0.0	98.43867280791538
chr10	MACROH2A2	70065053	70065189	0	137	1154095	11836	1154095	11699	0.0	98.64902983160954
chr10	MACROH2A2	70083004	70083179	0	176	1154095	11836	1154095	11660	0.0	98.97898799313894
chr10	MACROH2A2	70083004	70083070	0	67	1154095	11836	1154095	11769	0.0	98.06228226697256
chr10	MACROH2A2	70095653	70095753	7418	101	1154095	11836	1146677	11735	73.44554455445545	97.71427354069024
chr10	MACROH2A2	70091756	70091841	570	86	1154095	11836	1153525	11750	6.627906976744186	98.17234042553191
chr10	MACROH2A2	70093019	70093507	18192	489	1154095	11836	1135903	11347	37.20245398773006	100.10601921212655
chr10	MACROH2A2	70092336	70092642	3312	307	1154095	11836	1150783	11529	10.788273615635179	99.81637609506463
chr10	MACROH2A2	70093222	70093507	12783	286	1154095	11836	1141312	11550	44.69580419580419	98.81489177489178
chr10	MACROH2A2	70094938	70095060	3889	123	1154095	11836	1150206	11713	31.617886178861788	98.19909502262443
chr10	MACROH2A2	70099484	70099641	409	158	1154095	11836	1153686	11678	2.588607594936709	98.79140263743791
chr10	MACROH2A2	70105951	70106250	2421	300	1154095	11836	1151674	11536	8.07	99.83304438280166
chr10	MACROH2A2	70108545	70108631	668	87	1154095	11836	1153427	11749	7.67816091954023	98.17235509405056
chr10	UNC5B	71288957	71288990	0	34	21	6858	21	6824	0.0	0.003077373974208675
chr10	SLC29A3	71344208	71344291	0	84	306	5448	306	5364	0.0	0.05704697986577181
chr10	SLC29A3	71351561	71351788	0	228	306	5448	306	5220	0.0	0.05862068965517241
chr10	SLC29A3	71352566	71352818	0	253	306	5448	306	5195	0.0	0.05890279114533205
chr10	CDH23	71643860	71643866	0	7	417	16489	417	16482	0.0	0.025300327630141974
chr10	CDH23	71725371	71725520	0	150	417	16489	417	16339	0.0	0.0255217577575127
chr10	CDH23	71734655	71734658	0	4	417	16489	417	16485	0.0	0.025295723384895358
chr10	CDH23	71813243	71813348	0	106	417	16489	417	16383	0.0	0.02545321369712507
chr10	CDH23	71635237	71635297	0	61	417	16489	417	16428	0.0	0.025383491599707816
chr10	ANAPC16	72220053	72220379	0	327	104	4329	104	4002	0.0	0.025987006496751622
chr10	ANAPC16	72230365	72230440	0	76	104	4329	104	4253	0.0	0.024453327063249472
chr10	MCU	72715110	72715226	0	117	0	4536	0	4419	0.0	0.0
chr10	MCU	72736484	72736571	0	88	0	4536	0	4448	0.0	0.0
chr10	MCU	72760550	72760672	0	123	0	4536	0	4413	0.0	0.0
chr10	MCU	72708282	72708356	0	75	0	4536	0	4461	0.0	0.0
chr10	OIT3	72924228	72924644	0	417	0	2374	0	1957	0.0	0.0
chr10	NUDT13	73124213	73124320	0	108	10	2532	10	2424	0.0	0.004125412541254125
chr10	NUDT13	73119450	73119522	0	73	10	2532	10	2459	0.0	0.004066693777958519
chr10	NUDT13	73125397	73125509	0	113	10	2532	10	2419	0.0	0.00413393964448119
chr10	NUDT13	73126672	73126827	0	156	10	2532	10	2376	0.0	0.004208754208754209
chr10	FAM149B1	73235192	73235318	0	127	51	6573	51	6446	0.0	0.007911883338504499
chr10	PPP3CB-AS1	73498297	73498867	0	571	0	5347	0	4776	0.0	0.0
chr10	PPP3CB-AS1	73498732	73498867	0	136	0	5347	0	5211	0.0	0.0
chr10	PPP3CB-AS1	73515827	73515925	0	99	0	5347	0	5248	0.0	0.0
chr10	PPP3CB-AS1	73518743	73518864	0	122	0	5347	0	5225	0.0	0.0
chr10	PPP3CB-AS1	73498649	73498867	0	219	0	5347	0	5128	0.0	0.0
chr10	AC073389.2	73668274	73668361	0	88	102	1844	102	1756	0.0	0.05808656036446469
chr10	SEC24C	73751107	73751243	737	137	471877	5320	471140	5183	5.37956204379562	90.90102257379895
chr10	SEC24C	73746629	73746716	0	88	471877	5320	471877	5232	0.0	90.19055810397553
chr10	SEC24C	73762097	73762166	51	70	471877	5320	471826	5250	0.7285714285714285	89.87161904761905
chr10	PLAU	73912040	73912068	0	29	162	2962	162	2933	0.0	0.055233549266962154
chr10	VCL	74111908	74112112	798	205	92314	9895	91516	9690	3.892682926829268	9.44437564499484
chr10	VCL	74043082	74043153	0	72	92314	9895	92314	9823	0.0	9.397739997963962
chr10	ADK	74224537	74224591	0	55	126	4677	126	4622	0.0	0.027260926006057985
chr10	ADK	74600378	74600493	0	116	126	4677	126	4561	0.0	0.02762552071914054
chr10	ADK	74525255	74525426	0	172	126	4677	126	4505	0.0	0.027968923418423972
chr10	ADK	74680411	74680514	0	104	126	4677	126	4573	0.0	0.0275530286464028
chr10	ADK	74174415	74174618	0	204	126	4677	126	4473	0.0	0.028169014084507043
chr10	ADK	74670182	74670269	0	88	126	4677	126	4589	0.0	0.027456962301154936
chr10	ADK	74527759	74528093	0	335	126	4677	126	4342	0.0	0.029018885306310457
chr10	ADK	74339144	74339240	0	97	126	4677	126	4580	0.0	0.027510917030567687
chr10	ADK	74242737	74243033	51	297	126	4677	75	4380	0.1717171717171717	0.017123287671232876
chr10	ADK	74686698	74686820	0	123	126	4677	126	4554	0.0	0.02766798418972332
chr10	KAT6B	74970019	74970101	2164	83	65073	24867	62909	24784	26.072289156626507	2.5382908327953517
chr10	KAT6B	74979223	74979339	771	117	65073	24867	64302	24750	6.589743589743589	2.598060606060606
chr10	KAT6B	74985079	74985241	0	163	65073	24867	65073	24704	0.0	2.6341078367875648
chr10	KAT6B	74989018	74989112	418	95	65073	24867	64655	24772	4.4	2.610003229452608
chr10	KAT6B	74838682	74838752	0	71	65073	24867	65073	24796	0.0	2.6243345700919503
chr10	KAT6B	74838682	74838783	0	102	65073	24867	65073	24765	0.0	2.627619624470018
chr10	SAMD8	75173731	75173763	0	33	292516	7145	292516	7112	0.0	41.12992125984252
chr10	VDAC2	75211481	75211659	51	179	87397	2840	87346	2661	0.2849162011173184	32.824502066892144
chr10	ZNF503-AS1	75358938	75359049	0	112	16636	5296	16636	5184	0.0	3.209104938271605
chr10	ZNF503-AS1	75358275	75358346	0	72	16636	5296	16636	5224	0.0	3.184532924961715
chr10	ZNF503-AS1	75285450	75285596	867	147	16636	5296	15769	5149	5.8979591836734695	3.0625364148378327
chr10	ZNF503-AS1	75343223	75343340	0	118	16636	5296	16636	5178	0.0	3.212823483970645
chr10	ZNF503-AS1	75298951	75299074	0	124	16636	5296	16636	5172	0.0	3.216550657385924
chr10	ZNF503-AS1	75343223	75343330	0	108	16636	5296	16636	5188	0.0	3.2066306861989204
chr10	ZNF503-AS1	75350351	75350470	0	120	16636	5296	16636	5176	0.0	3.214064914992272
chr10	ZNF503-AS1	75355772	75355868	0	97	16636	5296	16636	5199	0.0	3.1998461242546643
chr10	KCNMA1-AS1	76889533	76889768	202	236	86686	4191	86484	3955	0.8559322033898306	21.86700379266751
chr10	KCNMA1-AS1	76904726	76904875	0	150	86686	4191	86686	4041	0.0	21.451620885919326
chr10	KCNMA1-AS1	76975280	76975400	342	121	86686	4191	86344	4070	2.8264462809917354	21.214742014742015
chr10	RPS24	78040200	78040225	0	26	0	7223	0	7197	0.0	0.0
chr10	RPS24	78037964	78037982	0	19	0	7223	0	7204	0.0	0.0
chr10	RPS24	78037438	78037441	0	4	0	7223	0	7219	0.0	0.0
chr10	RPS24	78040203	78040225	0	23	0	7223	0	7200	0.0	0.0
chr10	RPS24	78048980	78049225	0	246	0	7223	0	6977	0.0	0.0
chr10	RPS24	78037964	78037993	0	30	0	7223	0	7193	0.0	0.0
chr10	AC012560.1	78465993	78466178	0	186	33935	1379	33935	1193	0.0	28.44509639564124
chr10	LINC00595	78527292	78527587	0	296	0	10323	0	10027	0.0	0.0
chr10	LINC00595	78210844	78210998	0	155	0	10323	0	10168	0.0	0.0
chr10	LINC00595	78386992	78387115	0	124	0	10323	0	10199	0.0	0.0
chr10	ZMIZ1	79290744	79290796	0	53	10319	6896	10319	6843	0.0	1.5079643431243606
chr10	SFTPA1	79611318	79611389	132	72	67542	2454	67410	2382	1.8333333333333333	28.299748110831235
chr10	SFTPA1	79611581	79611641	24	61	67542	2454	67518	2393	0.39344262295081966	28.21479314667781
chr10	AL512662.1	79941436	79941535	0	100	0	2086	0	1986	0.0	0.0
chr10	TMEM254	80086230	80086258	0	29	0	3006	0	2977	0.0	0.0
chr10	TMEM254	80081639	80081734	0	96	0	3006	0	2910	0.0	0.0
chr10	TMEM254	80090379	80090431	0	53	0	3006	0	2953	0.0	0.0
chr10	PLAC9	80144222	80144343	0	122	0	1245	0	1123	0.0	0.0
chr10	DYDC2	80356296	80356596	0	301	0	2473	0	2172	0.0	0.0
chr10	DYDC2	80357892	80358045	0	154	0	2473	0	2319	0.0	0.0
chr10	TSPAN14	80504727	80504778	0	52	408	17902	408	17850	0.0	0.022857142857142857
chr10	TSPAN14	80509300	80509471	0	172	408	17902	408	17730	0.0	0.023011844331641287
chr10	TSPAN14	80466440	80466538	0	99	408	17902	408	17803	0.0	0.022917485816997134
chr10	SH2D4B	80634284	80634505	0	222	51	4595	51	4373	0.0	0.011662474273953807
chr10	NRG3	82984782	82984854	0	73	102	5209	102	5136	0.0	0.01985981308411215
chr10	NRG3	82166726	82166826	0	101	102	5209	102	5108	0.0	0.019968676585747847
chr10	NRG3	82955190	82955233	0	44	102	5209	102	5165	0.0	0.019748305905130686
chr10	NRG3	82232741	82232819	0	79	102	5209	102	5130	0.0	0.019883040935672516
chr10	CDHR1	84211000	84211165	0	166	51	7747	51	7581	0.0	0.006727344677483181
chr10	RGR	84257892	84258006	0	115	0	4954	0	4839	0.0	0.0
chr10	RGR	84246884	84246970	0	87	0	4954	0	4867	0.0	0.0
chr10	RGR	84255136	84255394	0	259	0	4954	0	4695	0.0	0.0
chr10	RGR	84247590	84247747	0	158	0	4954	0	4796	0.0	0.0
chr10	RGR	84247497	84247747	0	251	0	4954	0	4703	0.0	0.0
chr10	RGR	84247640	84247747	0	108	0	4954	0	4846	0.0	0.0
chr10	RGR	84254696	84254737	0	42	0	4954	0	4912	0.0	0.0
chr10	CCSER2	84438511	84438707	0	197	153	8441	153	8244	0.0	0.018558951965065504
chr10	CCSER2	84499874	84499959	0	86	153	8441	153	8355	0.0	0.018312387791741474
chr10	CCSER2	84473031	84473146	0	116	153	8441	153	8325	0.0	0.018378378378378378
chr10	LINC01520	85461595	85461697	0	103	0	1531	0	1428	0.0	0.0
chr10	GRID1-AS1	85579490	85579603	0	114	0	1726	0	1612	0.0	0.0
chr10	OPN4	86657194	86657227	0	34	0	2483	0	2449	0.0	0.0
chr10	LDB3	86687068	86687272	0	205	153	6639	153	6434	0.0	0.023779919179359652
chr10	LDB3	86706530	86706719	0	190	153	6639	153	6449	0.0	0.023724608466428904
chr10	LDB3	86681435	86681803	0	369	153	6639	153	6270	0.0	0.024401913875598084
chr10	LDB3	86685677	86685700	0	24	153	6639	153	6615	0.0	0.02312925170068027
chr10	BMPR1A	86843405	86843510	0	106	51	9534	51	9428	0.0	0.005409418752651676
chr10	ADIRF	86970199	86970262	0	64	0	762	0	698	0.0	0.0
chr10	AGAP11	86998377	86998561	0	185	0	3090	0	2905	0.0	0.0
chr10	AGAP11	87003087	87003421	0	335	0	3090	0	2755	0.0	0.0
chr10	SHLD2	87175888	87176095	0	208	0	4250	0	4042	0.0	0.0
chr10	PAPSS2	87721755	87721770	0	16	51	4098	51	4082	0.0	0.012493875551200392
chr10	LIPJ	88590584	88590696	0	113	769	2082	769	1969	0.0	0.3905535804977146
chr10	LIPJ	88596789	88596936	204	148	769	2082	565	1934	1.3783783783783783	0.2921406411582213
chr10	LIPF	88665478	88665559	0	82	4308	2359	4308	2277	0.0	1.8919631093544138
chr10	FAS	89008888	89008997	204	110	9300	5421	9096	5311	1.8545454545454545	1.7126718132178498
chr10	FAS	89010752	89010815	224	64	9300	5421	9076	5357	3.5	1.694231846182565
chr10	FAS	89012198	89012335	596	138	9300	5421	8704	5283	4.318840579710145	1.6475487412455045
chr10	FAS	89011998	89012081	44	84	9300	5421	9256	5337	0.5238095238095238	1.7343076634813566
chr10	FAS	89013342	89013367	0	26	9300	5421	9300	5395	0.0	1.7238183503243745
chr10	FAS	89007699	89007837	56	139	9300	5421	9244	5282	0.4028776978417266	1.7500946611132147
chr10	AL353751.1	89285035	89285264	0	230	204	2464	204	2234	0.0	0.09131602506714413
chr10	IFIT1	89393106	89393341	0	236	204	4617	204	4381	0.0	0.046564711253138553
chr10	SLC16A12-AS1	89462866	89463078	0	213	0	694	0	481	0.0	0.0
chr10	LINC00865	89829969	89830304	0	336	0	5664	0	5328	0.0	0.0
chr10	RPP30	90895453	90895483	0	31	0	4432	0	4401	0.0	0.0
chr10	HECTD2	91484333	91484345	0	13	22033	8950	22033	8937	0.0	2.4653686919547946
chr10	KIF11	92632190	92632310	0	121	134068	5347	134068	5226	0.0	25.654037504783773
chr10	EXOC6	92919981	92920050	0	70	0	6513	0	6443	0.0	0.0
chr10	EXOC6	92999249	92999387	0	139	0	6513	0	6374	0.0	0.0
chr10	FFAR4	93579158	93579206	19	49	961840	4065	961821	4016	0.3877551020408163	239.4972609561753
chr10	PDE6C	93663027	93663178	0	152	1913	3383	1913	3231	0.0	0.5920767564221603
chr10	LGI1	93791687	93791739	0	53	85940	8705	85940	8652	0.0	9.932963476652796
chr10	LGI1	93758759	93758831	0	73	85940	8705	85940	8632	0.0	9.955977757182577
chr10	LGI1	93793893	93794161	0	269	85940	8705	85940	8436	0.0	10.187292555713608
chr10	LGI1	93782742	93783043	0	302	85940	8705	85940	8403	0.0	10.227299773890277
chr10	LGI1	93758759	93759291	714	533	85940	8705	85226	8172	1.3395872420262664	10.429025942241802
chr10	LGI1	93780281	93780332	0	52	85940	8705	85940	8653	0.0	9.93181555529874
chr10	PLCE1	94262493	94262732	751	240	39279	13715	38528	13475	3.129166666666667	2.859220779220779
chr10	PLCE1	94253940	94254096	0	157	39279	13715	39279	13558	0.0	2.897108718100015
chr10	PLCE1	94282790	94282832	0	43	39279	13715	39279	13672	0.0	2.8729520187244004
chr10	PLCE1	94282790	94282940	408	151	39279	13715	38871	13564	2.7019867549668874	2.865747567089354
chr10	PLCE1	94282793	94282832	0	40	39279	13715	39279	13675	0.0	2.8723217550274223
chr10	HELLS	94562811	94562876	0	66	1071	8582	1071	8516	0.0	0.12576326914044153
chr10	HELLS	94583987	94584125	0	139	1071	8582	1071	8443	0.0	0.1268506455051522
chr10	CYP2C18	94706783	94706960	0	178	1054	2319	1054	2141	0.0	0.49229332087809435
chr10	CYP2C19	94820495	94820637	0	143	459	6272	459	6129	0.0	0.07488986784140969
chr10	CYP2C9	94972103	94972245	0	143	0	4067	0	3924	0.0	0.0
chr10	ACSM6	95214851	95214975	0	125	30918	2819	30918	2694	0.0	11.476614699331849
chr10	ACSM6	95201440	95201521	0	82	30918	2819	30918	2737	0.0	11.296309828279139
chr10	ENTPD1	95842343	95842494	0	152	255	13872	255	13720	0.0	0.01858600583090379
chr10	ENTPD1	95823236	95823364	0	129	255	13872	255	13743	0.0	0.018554900676708144
chr10	ENTPD1	95839690	95839808	0	119	255	13872	255	13753	0.0	0.018541409147095178
chr10	CC2D2B	95913381	95913437	0	57	3532	7596	3532	7539	0.0	0.46849714816288635
chr10	CC2D2B	95988249	95988342	36	94	3532	7596	3496	7502	0.3829787234042553	0.4660090642495335
chr10	CC2D2B	96009824	96009923	0	100	3532	7596	3532	7496	0.0	0.47118463180362863
chr10	CC2D2B	96012184	96012367	777	184	3532	7596	2755	7412	4.2228260869565215	0.3716945493793848
chr10	CC2D2B	95952322	95952425	102	104	3532	7596	3430	7492	0.9807692307692307	0.4578216764548852
chr10	CC2D2B	95984596	95984695	0	100	3532	7596	3532	7496	0.0	0.47118463180362863
chr10	CC2D2B	95993008	95993112	0	105	3532	7596	3532	7491	0.0	0.47149913229208384
chr10	CC2D2B	96000794	96000827	0	34	3532	7596	3532	7562	0.0	0.4670722031208675
chr10	ZNF518A	96151415	96151566	0	152	6070	10378	6070	10226	0.0	0.593584979464111
chr10	ZNF518A	96155325	96155398	0	74	6070	10378	6070	10304	0.0	0.5890916149068323
chr10	LCOR	96833405	96833479	0	75	3745	26377	3745	26302	0.0	0.14238460953539656
chr10	LCOR	96944112	96944245	0	134	3745	26377	3745	26243	0.0	0.1427047212590024
chr10	LCOR	96833776	96833841	0	66	3745	26377	3745	26311	0.0	0.14233590513473451
chr10	LCOR	96951035	96951065	0	31	3745	26377	3745	26346	0.0	0.14214681545585667
chr10	LCOR	96944101	96944245	0	145	3745	26377	3745	26232	0.0	0.14276456236657517
chr10	LCOR	96954952	96955834	0	883	3745	26377	3745	25494	0.0	0.14689730917078528
chr10	LCOR	96954952	96955454	0	503	3745	26377	3745	25874	0.0	0.14473989332921078
chr10	LCOR	96954952	96955957	0	1006	3745	26377	3745	25371	0.0	0.1476094753852824
chr10	LCOR	96954952	96955671	0	720	3745	26377	3745	25657	0.0	0.14596406438788634
chr10	LCOR	96858291	96858416	0	126	3745	26377	3745	26251	0.0	0.14266123195306846
chr10	ZDHHC16	97452089	97452284	107	196	79890	2995	79783	2799	0.5459183673469388	28.504108610217934
chr10	ZDHHC16	97453798	97453846	0	49	79890	2995	79890	2946	0.0	27.118126272912424
chr10	ZDHHC16	97450356	97450536	5893	181	79890	2995	73997	2814	32.55801104972376	26.296019900497512
chr10	ZDHHC16	97448189	97448350	3087	162	79890	2995	76803	2833	19.055555555555557	27.110130603600425
chr10	ZDHHC16	97451670	97451918	3482	249	79890	2995	76408	2746	13.983935742971887	27.82520029133285
chr10	ANKRD2	97582314	97582413	0	100	0	1460	0	1360	0.0	0.0
chr10	ZFYVE27	97738476	97738649	0	174	255	3913	255	3739	0.0	0.06820005349023803
chr10	ZFYVE27	97748268	97748364	0	97	255	3913	255	3816	0.0	0.06682389937106918
chr10	ZFYVE27	97752856	97752877	0	22	255	3913	255	3891	0.0	0.06553585196607556
chr10	R3HCC1L	98186466	98186563	0	98	4	3583	4	3485	0.0	0.0011477761836441894
chr10	R3HCC1L	98208100	98209899	0	1800	4	3583	4	1783	0.0	0.002243409983174425
chr10	R3HCC1L	98211306	98211348	0	43	4	3583	4	3540	0.0	0.0011299435028248588
chr10	AL391684.1	99434638	99434759	32826	122	198544	7133	165718	7011	269.0655737704918	23.636856368563684
chr10	CUTC	99750368	99750396	0	29	51	1803	51	1774	0.0	0.02874859075535513
chr10	ABCC2	99796362	99796853	0	492	133	7721	133	7229	0.0	0.018398118688615298
chr10	ABCC2	99796390	99796853	0	464	133	7721	133	7257	0.0	0.01832713242386661
chr10	ABCC2	99849723	99849905	0	183	133	7721	133	7538	0.0	0.017643937383921466
chr10	DNMBP-AS1	99956481	99956591	0	111	408	3011	408	2900	0.0	0.1406896551724138
chr10	DNMBP-AS1	99955673	99955832	0	160	408	3011	408	2851	0.0	0.1431076815152578
chr10	AL138921.1	100231245	100231660	0	416	0	1287	0	871	0.0	0.0
chr10	OLMALINC	100380982	100381109	0	128	51	12654	51	12526	0.0	0.004071531215072649
chr10	OLMALINC	100394497	100394622	0	126	51	12654	51	12528	0.0	0.0040708812260536395
chr10	OLMALINC	100380894	100381109	0	216	51	12654	51	12438	0.0	0.004100337674867342
chr10	OLMALINC	100394285	100394377	0	93	51	12654	51	12561	0.0	0.004060186290900406
chr10	PAX2	100824901	100824984	0	84	102	6389	102	6305	0.0	0.0161776367961935
chr10	PAX2	100786942	100787011	0	70	102	6389	102	6319	0.0	0.016141794587751227
chr10	SLF2	100925404	100925481	0	78	102	8833	102	8755	0.0	0.011650485436893204
chr10	SEMA4G	100978848	100979018	0	171	51	4726	51	4555	0.0	0.01119648737650933
chr10	SEMA4G	100983304	100984357	0	1054	51	4726	51	3672	0.0	0.013888888888888888
chr10	SEMA4G	100969691	100969924	43	234	51	4726	8	4492	0.18376068376068377	0.0017809439002671415
chr10	KAZALD1	101062985	101063103	0	119	0	2983	0	2864	0.0	0.0
chr10	LINC01514	101186048	101186164	80	117	12621	1767	12541	1650	0.6837606837606838	7.600606060606061
chr10	LINC01514	101176988	101177102	51	115	12621	1767	12570	1652	0.4434782608695652	7.608958837772397
chr10	BTRC	101430344	101430452	0	109	8959	6630	8959	6521	0.0	1.373869038491029
chr10	BTRC	101461980	101462058	0	79	8959	6630	8959	6551	0.0	1.3675774690886888
chr10	DPCD	101605139	101605212	0	74	836	1670	836	1596	0.0	0.5238095238095238
chr10	DPCD	101608834	101608937	0	104	836	1670	836	1566	0.0	0.5338441890166028
chr10	NOLC1	102157018	102157074	0	57	51	3983	51	3926	0.0	0.012990320937340805
chr10	NOLC1	102160232	102160343	0	112	51	3983	51	3871	0.0	0.013174890209248256
chr10	NOLC1	102158048	102158214	0	167	51	3983	51	3816	0.0	0.013364779874213837
chr10	GBF1	102344050	102344182	0	133	16712	19267	16712	19134	0.0	0.8734190446325912
chr10	GBF1	102352457	102352518	0	62	16712	19267	16712	19205	0.0	0.8701900546732622
chr10	GBF1	102359269	102359435	0	167	16712	19267	16712	19100	0.0	0.8749738219895288
chr10	GBF1	102360183	102360395	0	213	16712	19267	16712	19054	0.0	0.8770861761309962
chr10	GBF1	102361021	102361120	0	100	16712	19267	16712	19167	0.0	0.8719152710387645
chr10	GBF1	102363255	102363396	0	142	16712	19267	16712	19125	0.0	0.8738300653594772
chr10	GBF1	102363709	102363798	0	90	16712	19267	16712	19177	0.0	0.87146060384836
chr10	GBF1	102367477	102367560	0	84	16712	19267	16712	19183	0.0	0.8711880310691759
chr10	GBF1	102368217	102368454	0	238	16712	19267	16712	19029	0.0	0.8782384781123548
chr10	GBF1	102368738	102368832	0	95	16712	19267	16712	19172	0.0	0.8716878781556436
chr10	GBF1	102369210	102369387	0	178	16712	19267	16712	19089	0.0	0.8754780239928754
chr10	GBF1	102369860	102369984	0	125	16712	19267	16712	19142	0.0	0.8730540173440602
chr10	GBF1	102375358	102375584	0	227	16712	19267	16712	19040	0.0	0.8777310924369748
chr10	GBF1	102376271	102376432	0	162	16712	19267	16712	19105	0.0	0.874744831196022
chr10	GBF1	102380248	102380362	0	115	16712	19267	16712	19152	0.0	0.8725981620718463
chr10	GBF1	102381126	102381255	0	130	16712	19267	16712	19137	0.0	0.8732821236348435
chr10	GBF1	102258928	102259034	2588	107	16712	19267	14124	19160	24.186915887850468	0.737160751565762
chr10	GBF1	102256614	102256729	807	116	16712	19267	15905	19151	6.956896551724138	0.830504934468174
chr10	GBF1	102359266	102359435	0	170	16712	19267	16712	19097	0.0	0.8751112740220978
chr10	GBF1	102380332	102380362	0	31	16712	19267	16712	19236	0.0	0.8687876897483885
chr10	GBF1	102368297	102368454	0	158	16712	19267	16712	19109	0.0	0.8745617248416976
chr10	GBF1	102354369	102354468	0	100	16712	19267	16712	19167	0.0	0.8719152710387645
chr10	GBF1	102354369	102354444	0	76	16712	19267	16712	19191	0.0	0.8708248658225209
chr10	GBF1	102284952	102285070	10311	119	16712	19267	6401	19148	86.6470588235294	0.33429078754961356
chr10	GBF1	102335562	102335743	472	182	16712	19267	16240	19085	2.5934065934065935	0.850930049777312
chr10	GBF1	102332407	102332526	0	120	16712	19267	16712	19147	0.0	0.8728260301874967
chr10	GBF1	102328810	102328952	0	143	16712	19267	16712	19124	0.0	0.8738757582095796
chr10	GBF1	102326359	102326420	0	62	16712	19267	16712	19205	0.0	0.8701900546732622
chr10	GBF1	102314330	102314424	23	95	16712	19267	16689	19172	0.24210526315789474	0.8704882119757981
chr10	GBF1	102314807	102314860	48	54	16712	19267	16664	19213	0.8888888888888888	0.8673294123770364
chr10	GBF1	102314810	102314860	42	51	16712	19267	16670	19216	0.8235294117647058	0.8675062447960034
chr10	GBF1	102346367	102346492	0	126	16712	19267	16712	19141	0.0	0.8730996290684917
chr10	GBF1	102363226	102363396	0	171	16712	19267	16712	19096	0.0	0.8751571009635526
chr10	GBF1	102364894	102364972	0	79	16712	19267	16712	19188	0.0	0.8709610173024808
chr10	GBF1	102368818	102368832	0	15	16712	19267	16712	19252	0.0	0.86806565551631
chr10	GBF1	102376934	102377140	0	207	16712	19267	16712	19060	0.0	0.876810073452256
chr10	GBF1	102376309	102376432	0	124	16712	19267	16712	19143	0.0	0.8730084103849971
chr10	GBF1	102380345	102380362	0	18	16712	19267	16712	19249	0.0	0.8682009455036626
chr10	RPARP-AS1	102451398	102452187	0	790	357	4289	357	3499	0.0	0.10202915118605316
chr10	MFSD13A	102470664	102471117	0	454	51	3539	51	3085	0.0	0.01653160453808752
chr10	TRIM8	102654652	102654748	70	97	204	4655	134	4558	0.7216494845360825	0.029398859148749453
chr10	SFXN2	102716613	102716711	0	99	139483	7940	139483	7841	0.0	17.78892998342048
chr10	SFXN2	102716588	102716711	0	124	139483	7940	139483	7816	0.0	17.845829068577277
chr10	SFXN2	102727674	102727791	153	118	139483	7940	139330	7822	1.2966101694915255	17.81257990283815
chr10	SFXN2	102717702	102717780	172	79	139483	7940	139311	7861	2.1772151898734178	17.721791120722553
chr10	SFXN2	102716233	102716329	5039	97	139483	7940	134444	7843	51.94845360824742	17.14190998342471
chr10	SFXN2	102715222	102715328	434	107	139483	7940	139049	7833	4.05607476635514	17.751691561343037
chr10	SFXN2	102724935	102724996	5	62	139483	7940	139478	7878	0.08064516129032258	17.704747397816703
chr10	SFXN2	102729722	102729808	0	87	139483	7940	139483	7853	0.0	17.761747103017957
chr10	SFXN2	102729318	102729394	159	77	139483	7940	139324	7863	2.064935064935065	17.71893679257281
chr10	CNNM2	103071773	103071839	0	67	51	16333	51	16266	0.0	0.003135374400590188
chr10	PDCD11	103399646	103399830	612	185	13508	7709	12896	7524	3.308108108108108	1.7139819245082404
chr10	SLK	104010815	104010908	0	94	20366	8127	20366	8033	0.0	2.5352919208265905
chr10	SLK	104013631	104013703	0	73	20366	8127	20366	8054	0.0	2.5286814005463123
chr10	GSTO1	104262978	104263077	588	100	1929	1700	1341	1600	5.88	0.838125
chr10	GSTO2	104275225	104275334	47	110	19526	9938	19479	9828	0.42727272727272725	1.981990231990232
chr10	GSTO2	104279369	104279471	0	103	19526	9938	19526	9835	0.0	1.9853584138281648
chr10	ADD3	110116258	110116410	0	153	0	6311	0	6158	0.0	0.0
chr10	ADD3	110100624	110100848	0	225	0	6311	0	6086	0.0	0.0
chr10	ADD3	110132304	110132400	0	97	0	6311	0	6214	0.0	0.0
chr10	MXI1	110244827	110244857	0	31	121	5912	121	5881	0.0	0.020574732188403333
chr10	MXI1	110244827	110244873	0	47	121	5912	121	5865	0.0	0.020630861040068203
chr10	MXI1	110260998	110261145	0	148	121	5912	121	5764	0.0	0.02099236641221374
chr10	MXI1	110245742	110245818	0	77	121	5912	121	5835	0.0	0.0207369323050557
chr10	MXI1	110279489	110279683	0	195	121	5912	121	5717	0.0	0.021164946650341087
chr10	PDCD4	110876669	110876753	0	85	51	4079	51	3994	0.0	0.012769153730595895
chr10	PDCD4	110894090	110894198	51	109	51	4079	0	3970	0.46788990825688076	0.0
chr10	PDCD4	110894411	110894522	0	112	51	4079	51	3967	0.0	0.012856062515754978
chr10	PDCD4	110875965	110876070	0	106	51	4079	51	3973	0.0	0.012836647369745784
chr10	SHOC2	110985627	110985765	0	139	51	4393	51	4254	0.0	0.011988716502115656
chr10	ACSL5	112411455	112411529	0	75	0	4259	0	4184	0.0	0.0
chr10	ACSL5	112426787	112426859	0	73	0	4259	0	4186	0.0	0.0
chr10	TCF7L2	112964555	112964624	0	70	0	6478	0	6408	0.0	0.0
chr10	TCF7L2	113160618	113160691	0	74	0	6478	0	6404	0.0	0.0
chr10	TCF7L2	113158666	113158717	0	52	0	6478	0	6426	0.0	0.0
chr10	TCF7L2	113159919	113159992	0	74	0	6478	0	6404	0.0	0.0
chr10	TCF7L2	113040024	113040126	0	103	0	6478	0	6375	0.0	0.0
chr10	TCF7L2	113089396	113089540	0	145	0	6478	0	6333	0.0	0.0
chr10	TCF7L2	113089399	113089540	0	142	0	6478	0	6336	0.0	0.0
chr10	TCF7L2	113161578	113161603	0	26	0	6478	0	6452	0.0	0.0
chr10	CASP7	113691996	113692070	0	75	51	3624	51	3549	0.0	0.014370245139475908
chr10	CASP7	113691963	113692070	0	108	51	3624	51	3516	0.0	0.014505119453924915
chr10	PLEKHS1	113755258	113755305	0	48	0	5610	0	5562	0.0	0.0
chr10	PLEKHS1	113755258	113755405	0	148	0	5610	0	5462	0.0	0.0
chr10	PLEKHS1	113777123	113777259	0	137	0	5610	0	5473	0.0	0.0
chr10	TDRD1	114227071	114227299	0	229	4771	5283	4771	5054	0.0	0.94400474871389
chr10	VWA2	114254914	114255048	0	135	918	6367	918	6232	0.0	0.14730423620025673
chr10	AL137025.1	114769042	114769120	408	79	714	2927	306	2848	5.1645569620253164	0.1074438202247191
chr10	ATRNL1	115096644	115096839	0	196	256	9992	256	9796	0.0	0.026133115557370357
chr10	ATRNL1	115128406	115128508	0	103	256	9992	256	9889	0.0	0.025887349580341792
chr10	ATRNL1	115165557	115165645	0	89	256	9992	256	9903	0.0	0.02585075229728365
chr10	ATRNL1	115334281	115334419	0	139	256	9992	256	9853	0.0	0.02598193443621232
chr10	ATRNL1	115931527	115931653	0	127	256	9992	256	9865	0.0	0.025950329447541814
chr10	PNLIPRP1	116594729	116594864	820	136	22506	4644	21686	4508	6.029411764705882	4.8105590062111805
chr10	PNLIPRP1	116600046	116600165	0	120	22506	4644	22506	4524	0.0	4.974801061007957
chr10	PNLIPRP1	116594315	116594864	2295	550	22506	4644	20211	4094	4.172727272727273	4.936736687835857
chr10	ENO4	116874075	116874201	600	127	4680	3194	4080	3067	4.724409448818897	1.330290185849364
chr10	ENO4	116849928	116849931	0	4	4680	3194	4680	3190	0.0	1.4670846394984327
chr10	ENO4	116864345	116864351	0	7	4680	3194	4680	3187	0.0	1.4684656416692814
chr10	EMX2	117545631	117545816	0	186	0	3265	0	3079	0.0	0.0
chr10	LINC02674	117747699	117747891	0	193	0	1050	0	857	0.0	0.0
chr10	AC022395.1	118043440	118043565	0	126	33	2089	33	1963	0.0	0.016811003565970453
chr10	CASC2	118052130	118052196	0	67	51	14207	51	14140	0.0	0.0036067892503536068
chr10	CASC2	118206521	118206621	0	101	51	14207	51	14106	0.0	0.0036154827732879625
chr10	AL354863.1	118241782	118241886	0	105	714	3474	714	3369	0.0	0.21193232413178986
chr10	AL354863.1	118245545	118245633	0	89	714	3474	714	3385	0.0	0.21093057607090104
chr10	AL354863.1	118241782	118242093	0	312	714	3474	714	3162	0.0	0.22580645161290322
chr10	DENND10	119111848	119111928	0	81	18635	5796	18635	5715	0.0	3.2607174103237093
chr10	DENND10	119110192	119110314	5	123	18635	5796	18630	5673	0.04065040650406504	3.28397673188789
chr10	INPP5F	119727432	119727469	0	38	4090	7441	4090	7403	0.0	0.5524787248412806
chr10	INPP5F	119791516	119791645	0	130	4090	7441	4090	7311	0.0	0.559430994392012
chr10	INPP5F	119792156	119792213	0	58	4090	7441	4090	7383	0.0	0.5539753487742111
chr10	INPP5F	119823814	119823902	0	89	4090	7441	4090	7352	0.0	0.5563112078346029
chr10	INPP5F	119781060	119781242	424	183	4090	7441	3666	7258	2.3169398907103824	0.5050978230917608
chr10	INPP5F	119792156	119792211	0	56	4090	7441	4090	7385	0.0	0.5538253215978335
chr10	INPP5F	119757894	119757977	0	84	4090	7441	4090	7357	0.0	0.5559331249150469
chr10	INPP5F	119759856	119760068	0	213	4090	7441	4090	7228	0.0	0.5658550083010515
chr10	INPP5F	119781634	119781771	0	138	4090	7441	4090	7303	0.0	0.5600438176092017
chr10	INPP5F	119825951	119826018	0	68	4090	7441	4090	7373	0.0	0.5547267055472671
chr10	INPP5F	119819766	119819834	0	69	4090	7441	4090	7372	0.0	0.5548019533369506
chr10	SEC23IP	119909040	119909130	0	91	208	6408	208	6317	0.0	0.03292702232072186
chr10	SEC23IP	119930328	119930431	0	104	208	6408	208	6304	0.0	0.03299492385786802
chr10	AC023282.1	120815643	120815715	450	73	173255	6283	172805	6210	6.164383561643835	27.826892109500804
chr10	AC023282.1	120812030	120812110	126	81	173255	6283	173129	6202	1.5555555555555556	27.91502741051274
chr10	AC023282.1	120814540	120814644	0	105	173255	6283	173255	6178	0.0	28.0438653285853
chr10	WDR11	120890715	120890887	0	173	9454	7675	9454	7502	0.0	1.26019728072514
chr10	WDR11	120860108	120860282	0	175	9454	7675	9454	7500	0.0	1.2605333333333333
chr10	WDR11	120867065	120867169	546	105	9454	7675	8908	7570	5.2	1.1767503302509907
chr10	WDR11	120856081	120856130	0	50	9454	7675	9454	7625	0.0	1.2398688524590165
chr10	TACC2	122143571	122143706	0	136	18255	18193	18255	18057	0.0	1.010965276624024
chr10	TACC2	122230350	122230440	0	91	18255	18193	18255	18102	0.0	1.0084521047398078
chr10	TACC2	122033093	122033153	0	61	18255	18193	18255	18132	0.0	1.006783587028458
chr10	TACC2	122209873	122209969	0	97	18255	18193	18255	18096	0.0	1.0087864721485411
chr10	TACC2	122229345	122229486	0	142	18255	18193	18255	18051	0.0	1.0113013129466513
chr10	TACC2	122213341	122213377	0	37	18255	18193	18255	18156	0.0	1.0054527428949107
chr10	TACC2	122245064	122245073	0	10	18255	18193	18255	18183	0.0	1.00395974261673
chr10	PLEKHA1	122428275	122428316	0	42	3050	22851	3050	22809	0.0	0.13371914595115963
chr10	PLEKHA1	122428275	122428420	0	146	3050	22851	3050	22705	0.0	0.13433164501211187
chr10	DMBT1	122597024	122597054	0	31	33448	9431	33448	9400	0.0	3.5582978723404257
chr10	DMBT1	122600063	122600093	0	31	33448	9431	33448	9400	0.0	3.5582978723404257
chr10	DMBT1	122629839	122629993	0	155	33448	9431	33448	9276	0.0	3.6058645968089693
chr10	DMBT1	122584321	122584351	216	31	33448	9431	33232	9400	6.967741935483871	3.5353191489361704
chr10	DMBT1L1	122779285	122779315	0	31	1249	8183	1249	8152	0.0	0.15321393523061824
chr10	DMBT1L1	122785035	122785405	0	371	1249	8183	1249	7812	0.0	0.1598822324628776
chr10	DMBT1L1	122794530	122794747	158	218	1249	8183	1091	7965	0.7247706422018348	0.1369742623979912
chr10	PSTK	122986868	122986962	0	95	102	6128	102	6033	0.0	0.016907011437095974
chr10	PSTK	122982732	122983024	0	293	102	6128	102	5835	0.0	0.017480719794344474
chr10	PSTK	122987333	122987504	0	172	102	6128	102	5956	0.0	0.01712558764271323
chr10	ACADSB	123037746	123037847	0	102	418	6246	418	6144	0.0	0.06803385416666667
chr10	LINC02641	123361888	123362147	475	260	2193	5335	1718	5075	1.8269230769230769	0.3385221674876847
chr10	LINC02641	123360907	123361019	0	113	2193	5335	2193	5222	0.0	0.4199540405974722
chr10	LINC02641	123360283	123360502	0	220	2193	5335	2193	5115	0.0	0.4287390029325513
chr10	LHPP	124517179	124517271	0	93	8731	4088	8731	3995	0.0	2.185481852315394
chr10	FAM53B-AS1	124707850	124707990	102	141	12718	1764	12616	1623	0.723404255319149	7.773259396179914
chr10	TEX36-AS1	125575024	125575139	0	116	0	754	0	638	0.0	0.0
chr10	TEX36-AS1	125576254	125576352	0	99	0	754	0	655	0.0	0.0
chr10	AL158835.1	125700512	125700620	41	109	41	4566	0	4457	0.3761467889908257	0.0
chr10	EDRF1	125729002	125729104	0	103	51	7630	51	7527	0.0	0.006775607811877242
chr10	EDRF1	125742219	125742345	0	127	51	7630	51	7503	0.0	0.006797281087564974
chr10	EDRF1	125752798	125752914	51	117	51	7630	0	7513	0.4358974358974359	0.0
chr10	EDRF1	125731864	125731925	0	62	51	7630	51	7568	0.0	0.0067389006342494714
chr10	EDRF1	125761227	125761314	0	88	51	7630	51	7542	0.0	0.006762132060461416
chr10	BCCIP	125830561	125830651	0	91	0	4505	0	4414	0.0	0.0
chr10	FANK1	125997419	125997485	0	67	0	3163	0	3096	0.0	0.0
chr10	FANK1	125989429	125989447	0	19	0	3163	0	3144	0.0	0.0
chr10	PTPRE	128060938	128061015	0	78	23724	9038	23724	8960	0.0	2.647767857142857
chr10	PTPRE	127964827	127964998	0	172	23724	9038	23724	8866	0.0	2.6758402887435144
chr10	PPP2R2D	131934893	131935006	0	114	369867	7403	369867	7289	0.0	50.743174646727944
chr10	PPP2R2D	131911561	131912598	408	1038	369867	7403	369459	6365	0.3930635838150289	58.04540455616654
chr10	PPP2R2D	131943967	131943997	0	31	369867	7403	369867	7372	0.0	50.17186652197504
chr10	JAKMIP3	132133311	132133527	0	217	0	12408	0	12191	0.0	0.0
chr10	JAKMIP3	132152957	132153023	0	67	0	12408	0	12341	0.0	0.0
chr10	JAKMIP3	132104671	132104943	0	273	0	12408	0	12135	0.0	0.0
chr10	JAKMIP3	132166982	132167055	0	74	0	12408	0	12334	0.0	0.0
chr10	JAKMIP3	132169909	132171255	0	1347	0	12408	0	11061	0.0	0.0
chr10	JAKMIP3	132169716	132169932	0	217	0	12408	0	12191	0.0	0.0
chr10	JAKMIP3	132169855	132170252	0	398	0	12408	0	12010	0.0	0.0
chr10	JAKMIP3	132169716	132171255	0	1540	0	12408	0	10868	0.0	0.0
chr10	JAKMIP3	132169716	132170915	0	1200	0	12408	0	11208	0.0	0.0
chr10	DPYSL4	132198414	132198483	0	70	0	3126	0	3056	0.0	0.0
chr10	DPYSL4	132202645	132202825	0	181	0	3126	0	2945	0.0	0.0
chr10	LRRC27	132342212	132342271	0	60	0	11495	0	11435	0.0	0.0
chr10	LRRC27	132348962	132349057	0	96	0	11495	0	11399	0.0	0.0
chr10	LRRC27	132355789	132355886	0	98	0	11495	0	11397	0.0	0.0
chr10	LINC01168	132967344	132967485	0	142	0	6002	0	5860	0.0	0.0
chr10	ZNF511	133309775	133309977	0	203	0	1349	0	1146	0.0	0.0
chr10	PAOX	133379998	133380485	0	488	0	2260	0	1772	0.0	0.0
chr10	PAOX	133383959	133384212	0	254	0	2260	0	2006	0.0	0.0
chr10	PAOX	133389589	133389747	0	159	0	2260	0	2101	0.0	0.0
chr10	PAOX	133382851	133382939	0	89	0	2260	0	2171	0.0	0.0
chr10	SCART1	133464605	133464911	0	307	0	7075	0	6768	0.0	0.0
chr10	CYP2E1	133528480	133528640	0	161	51	8835	51	8674	0.0	0.005879640304357851
chr10	CYP2E1	133532123	133532284	0	162	51	8835	51	8673	0.0	0.00588031822898651
chr10	CYP2E1	133533755	133533897	0	143	51	8835	51	8692	0.0	0.005867464335020708
chr10	CYP2E1	133531584	133531734	0	151	51	8835	51	8684	0.0	0.005872869645324735
chr10	AL731769.2	133574493	133574577	0	85	0	5667	0	5582	0.0	0.0
chr10	AL731769.2	133608143	133608388	0	246	0	5667	0	5421	0.0	0.0
chr11	ODF3	199368	199509	0	142	153	1543	153	1401	0.0	0.10920770877944326
chr11	RIC8A	210406	210445	0	40	1380437	4543	1380437	4503	0.0	306.559404841217
chr11	PSMD13	238997	239076	142891	80	1526979	2848	1384088	2768	1786.1375	500.03179190751445
chr11	PSMD13	244040	244075	58557	36	1526979	2848	1468422	2812	1626.5833333333333	522.1984352773826
chr11	PSMD13	251545	251626	70845	82	1526979	2848	1456134	2766	863.9634146341464	526.4403470715835
chr11	PSMD13	251819	251936	148719	118	1526979	2848	1378260	2730	1260.3305084745762	504.85714285714283
chr11	IFITM2	308754	308889	72	136	63476	1548	63404	1412	0.5294117647058824	44.903682719546744
chr11	PTDSS2	473894	473977	24235	84	455275	5471	431040	5387	288.51190476190476	80.01485056617784
chr11	PTDSS2	451384	451493	1448	110	455275	5471	453827	5361	13.163636363636364	84.65342286886775
chr11	PTDSS2	451351	451493	2052	143	455275	5471	453223	5328	14.34965034965035	85.06437687687688
chr11	RASSF7	561761	561892	8055	132	88742	2441	80687	2309	61.02272727272727	34.94456474664357
chr11	RASSF7	563395	563478	2743	84	88742	2441	85999	2357	32.654761904761905	36.48663555366992
chr11	EPS8L2	706676	706801	366	126	16540	4588	16174	4462	2.9047619047619047	3.6248319139399374
chr11	EPS8L2	721902	721991	302	90	16540	4588	16238	4498	3.3555555555555556	3.6100489106269453
chr11	EPS8L2	722090	722165	401	76	16540	4588	16139	4512	5.276315789473684	3.576906028368794
chr11	EPS8L2	708574	708643	0	70	16540	4588	16540	4518	0.0	3.66091190792386
chr11	EPS8L2	706673	706801	368	129	16540	4588	16172	4459	2.852713178294574	3.626822157434402
chr11	EPS8L2	706595	706801	978	207	16540	4588	15562	4381	4.72463768115942	3.552157041771285
chr11	TALDO1	752263	752473	459	211	1162017	2916	1161558	2705	2.175355450236967	429.41146025878004
chr11	AP006621.3	778112	778218	548	107	47002	1492	46454	1385	5.121495327102804	33.540794223826715
chr11	CRACR2B	830865	831032	1758	168	22384	3193	20626	3025	10.464285714285714	6.8185123966942145
chr11	CD151	833987	834067	269	81	1581008	3539	1580739	3458	3.3209876543209877	457.1252168883748
chr11	CD151	836768	836843	79282	76	1581008	3539	1501726	3463	1043.1842105263158	433.648859370488
chr11	CD151	834529	834591	54106	63	1581008	3539	1526902	3476	858.8253968253969	439.2698504027618
chr11	CD151	835019	835139	141	121	1581008	3539	1580867	3418	1.165289256198347	462.5122878876536
chr11	CD151	834529	834803	54597	275	1581008	3539	1526411	3264	198.53454545454545	467.6504289215686
chr11	CD151	834529	834745	54546	217	1581008	3539	1526462	3322	251.36405529953916	459.5009030704395
chr11	TSPAN4	862549	862741	179343	193	826493	4889	647150	4696	929.2383419689119	137.8087734241908
chr11	TSPAN4	865512	865614	112534	103	826493	4889	713959	4786	1092.5631067961165	149.17655662348517
chr11	TSPAN4	847200	847300	41403	101	826493	4889	785090	4788	409.9306930693069	163.9703425229741
chr11	TSPAN4	850287	850367	49459	81	826493	4889	777034	4808	610.604938271605	161.61272878535775
chr11	AP2A2	1000431	1000598	81867	168	1010076	8274	928209	8106	487.30357142857144	114.50888230940045
chr11	BRSK2	1444970	1445002	0	33	1862	6414	1862	6381	0.0	0.2918037925090111
chr11	BRSK2	1456954	1457049	0	96	1862	6414	1862	6318	0.0	0.29471351693573916
chr11	BRSK2	1459191	1459239	0	49	1862	6414	1862	6365	0.0	0.29253731343283584
chr11	BRSK2	1447797	1447863	0	67	1862	6414	1862	6347	0.0	0.29336694501339217
chr11	LSP1	1880086	1880224	0	139	0	6021	0	5882	0.0	0.0
chr11	LINC01150	1901715	1901770	0	56	306	1304	306	1248	0.0	0.24519230769230768
chr11	TNNT3	1923554	1923572	0	19	0	2739	0	2720	0.0	0.0
chr11	TNNT3	1929119	1929143	0	25	0	2739	0	2714	0.0	0.0
chr11	TNNT3	1923047	1923061	0	15	0	2739	0	2724	0.0	0.0
chr11	TNNT3	1926694	1926709	0	16	0	2739	0	2723	0.0	0.0
chr11	TNNT3	1925098	1925116	0	19	0	2739	0	2720	0.0	0.0
chr11	TNNT3	1921361	1921619	0	259	0	2739	0	2480	0.0	0.0
chr11	MRPL23	1955610	1955781	0	172	34	2986	34	2814	0.0	0.012082444918265814
chr11	TSPAN32	2308735	2308810	0	76	0	2972	0	2896	0.0	0.0
chr11	TSPAN32	2317343	2317525	0	183	0	2972	0	2789	0.0	0.0
chr11	TSPAN32	2317345	2317525	0	181	0	2972	0	2791	0.0	0.0
chr11	TSPAN32	2317426	2317525	0	100	0	2972	0	2872	0.0	0.0
chr11	CD81	2376820	2376920	0	101	5011	6256	5011	6155	0.0	0.8141348497156783
chr11	TSSC4	2401975	2402147	132	173	1326	2556	1194	2383	0.7630057803468208	0.5010490977759127
chr11	TSSC4	2401838	2401979	54	142	1326	2556	1272	2414	0.38028169014084506	0.5269262634631318
chr11	TSSC4	2401838	2402147	171	310	1326	2556	1155	2246	0.5516129032258065	0.5142475512021372
chr11	KCNQ1	2585211	2585307	0	97	0	4442	0	4345	0.0	0.0
chr11	KCNQ1	2521478	2521570	0	93	0	4442	0	4349	0.0	0.0
chr11	MRGPRG-AS1	3220226	3220359	0	134	0	2016	0	1882	0.0	0.0
chr11	MRGPRG-AS1	3219699	3219788	0	90	0	2016	0	1926	0.0	0.0
chr11	TSSC2	3397116	3397406	529	291	9692	3680	9163	3389	1.8178694158075601	2.703747418117439
chr11	TRPC2	3628722	3628819	0	98	0	3280	0	3182	0.0	0.0
chr11	TRPC2	3635274	3635353	0	80	0	3280	0	3200	0.0	0.0
chr11	PGAP2	3811249	3811424	0	176	752	3571	752	3395	0.0	0.2215022091310751
chr11	PGAP2	3822908	3822993	0	86	752	3571	752	3485	0.0	0.2157819225251076
chr11	PGAP2	3823882	3824135	0	254	752	3571	752	3317	0.0	0.22671088332830872
chr11	PGAP2	3817431	3817535	0	105	752	3571	752	3466	0.0	0.21696480092325446
chr11	PGAP2	3823612	3823740	0	129	752	3571	752	3442	0.0	0.21847762928529924
chr11	PGAP2	3817352	3817535	0	184	752	3571	752	3387	0.0	0.22202539120165338
chr11	PGAP2	3823616	3823740	0	125	752	3571	752	3446	0.0	0.21822402785838654
chr11	STIM1	4074501	4074679	0	179	27738	6805	27738	6626	0.0	4.186236039843043
chr11	STIM1	4088701	4088738	0	38	27738	6805	27738	6767	0.0	4.099009900990099
chr11	STIM1	3947562	3947667	0	106	27738	6805	27738	6699	0.0	4.140618002686968
chr11	STIM1	4084672	4084765	0	94	27738	6805	27738	6711	0.0	4.13321412606169
chr11	RRM1	4105605	4105691	286	87	131814	4257	131528	4170	3.2873563218390807	31.541486810551557
chr11	RRM1	4101992	4102081	0	90	131814	4257	131814	4167	0.0	31.632829373650107
chr11	RRM1	4106045	4106223	510	179	131814	4257	131304	4078	2.8491620111731844	32.1981363413438
chr11	OR52B5P	5558996	5559049	0	54	0	3523	0	3469	0.0	0.0
chr11	TRIM6	5603245	5603735	0	491	153	3973	153	3482	0.0	0.043940264215967834
chr11	TRIM6	5603607	5603735	0	129	153	3973	153	3844	0.0	0.039802289281997916
chr11	TRIM6	5605336	5605567	0	232	153	3973	153	3741	0.0	0.0408981555733761
chr11	TRIM6	5604533	5604629	0	97	153	3973	153	3876	0.0	0.039473684210526314
chr11	TRIM22	5697247	5697343	0	97	2008	4986	2008	4889	0.0	0.41071793822867664
chr11	OR56A3	5943329	5943486	0	158	765	4801	765	4643	0.0	0.1647641611027353
chr11	CCKBR	6269668	6269920	0	253	0	2398	0	2145	0.0	0.0
chr11	CCKBR	6264473	6264633	0	161	0	2398	0	2237	0.0	0.0
chr11	AC068733.3	6323584	6323692	0	109	1786	4772	1786	4663	0.0	0.3830152262491958
chr11	AC068733.3	6333615	6333708	0	94	1786	4772	1786	4678	0.0	0.3817870884993587
chr11	SMPD1	6393215	6393387	0	173	0	2455	0	2282	0.0	0.0
chr11	TIMM10B	6481756	6481852	0	97	857	2951	857	2854	0.0	0.3002803083391731
chr11	DNHD1	6558901	6559106	51	206	283334	18420	283283	18214	0.24757281553398058	15.55303612605688
chr11	ILK	6608693	6608790	0	98	5780	3225	5780	3127	0.0	1.8484170131116087
chr11	ILK	6609070	6609156	0	87	5780	3225	5780	3138	0.0	1.8419375398342894
chr11	ILK	6608045	6608211	6	167	5780	3225	5774	3058	0.03592814371257485	1.8881621975147156
chr11	ILK	6604852	6604943	0	92	5780	3225	5780	3133	0.0	1.8448771145866583
chr11	ZNF215	6943545	6943641	0	97	51	5918	51	5821	0.0	0.008761381205978355
chr11	ZNF215	6943082	6943215	0	134	51	5918	51	5784	0.0	0.008817427385892116
chr11	ZNF215	6927661	6927807	0	147	51	5918	51	5771	0.0	0.008837289897764685
chr11	SYT9	7314184	7314337	0	154	0	4785	0	4631	0.0	0.0
chr11	SYT9	7313394	7313941	0	548	0	4785	0	4237	0.0	0.0
chr11	PPFIBP2	7548343	7548499	0	157	0	8897	0	8740	0.0	0.0
chr11	PPFIBP2	7597559	7597673	0	115	0	8897	0	8782	0.0	0.0
chr11	PPFIBP2	7617111	7617294	0	184	0	8897	0	8713	0.0	0.0
chr11	PPFIBP2	7641032	7641065	0	34	0	8897	0	8863	0.0	0.0
chr11	PPFIBP2	7641032	7641083	0	52	0	8897	0	8845	0.0	0.0
chr11	EIF3F	7991780	7991851	0	72	306	8989	306	8917	0.0	0.03431647415049904
chr11	EIF3F	7991780	7991971	0	192	306	8989	306	8797	0.0	0.0347845856542003
chr11	EIF3F	7994102	7994237	0	136	306	8989	306	8853	0.0	0.03456455438834293
chr11	RPL27A	8684717	8684892	561	176	7067	3540	6506	3364	3.1875	1.9340071343638525
chr11	RPL27A	8684822	8684892	36	71	7067	3540	7031	3469	0.5070422535211268	2.026808878639377
chr11	RPL27A	8684685	8684892	561	208	7067	3540	6506	3332	2.6971153846153846	1.952581032412965
chr11	AC026894.1	8787053	8787286	0	234	51	1261	51	1027	0.0	0.04965920155793573
chr11	AKIP1	8917286	8917367	0	82	168	2242	168	2160	0.0	0.07777777777777778
chr11	AKIP1	8912452	8912533	0	82	168	2242	168	2160	0.0	0.07777777777777778
chr11	AC079296.1	9060374	9060535	6	162	12022	4344	12016	4182	0.037037037037037035	2.8732663797226206
chr11	AC079296.1	9056497	9057455	0	959	12022	4344	12022	3385	0.0	3.5515509601181683
chr11	IPO7	9392197	9392320	19	124	59420	6872	59401	6748	0.1532258064516129	8.802756372258447
chr11	IPO7	9403289	9403371	0	83	59420	6872	59420	6789	0.0	8.752393577846517
chr11	ZNF143	9472676	9472769	0	94	11364	4244	11364	4150	0.0	2.738313253012048
chr11	ZNF143	9474549	9474633	0	85	11364	4244	11364	4159	0.0	2.7323875931714356
chr11	ZNF143	9474552	9474633	0	82	11364	4244	11364	4162	0.0	2.7304180682364247
chr11	ZNF143	9473776	9473849	0	74	11364	4244	11364	4170	0.0	2.725179856115108
chr11	ZNF143	9463770	9463870	1276	101	11364	4244	10088	4143	12.633663366336634	2.4349505189476224
chr11	SWAP70	9713465	9713639	0	175	14774	6787	14774	6612	0.0	2.234422262552934
chr11	SWAP70	9703395	9703448	0	54	14774	6787	14774	6733	0.0	2.194267042922917
chr11	SBF2-AS1	9779816	9779942	0	127	12056	4738	12056	4611	0.0	2.614617219692041
chr11	SBF2-AS1	9780375	9780575	0	201	12056	4738	12056	4537	0.0	2.6572625082653736
chr11	SBF2-AS1	9784591	9784776	0	186	12056	4738	12056	4552	0.0	2.648506151142355
chr11	AMPD3	10478525	10478730	0	206	765	6622	765	6416	0.0	0.11923316708229427
chr11	IRAG1-AS1	10589011	10589150	0	140	1122	1391	1122	1251	0.0	0.8968824940047961
chr11	IRAG1-AS1	10586026	10586126	0	101	1122	1391	1122	1290	0.0	0.8697674418604651
chr11	IRAG1-AS1	10595720	10595795	0	76	1122	1391	1122	1315	0.0	0.8532319391634982
chr11	CTR9	10761946	10762054	0	109	18964	5798	18964	5689	0.0	3.3334505185445598
chr11	ZBED5-AS1	10865260	10865327	0	68	18091	4558	18091	4490	0.0	4.029175946547884
chr11	ZBED5-AS1	10896656	10896838	0	183	18091	4558	18091	4375	0.0	4.135085714285714
chr11	USP47	11880176	11880380	0	205	13932	11959	13932	11754	0.0	1.1852986217457886
chr11	USP47	11873799	11873859	0	61	13932	11959	13932	11898	0.0	1.1709531013615733
chr11	MICAL2	12249183	12249246	0	64	29104	16154	29104	16090	0.0	1.808825357364823
chr11	MICAL2	12153223	12153316	0	94	29104	16154	29104	16060	0.0	1.8122042341220423
chr11	TEAD1	12675408	12675561	0	154	1234	10563	1234	10409	0.0	0.11855125372273993
chr11	TEAD1	12901939	12902113	0	175	1234	10563	1234	10388	0.0	0.11879091259145168
chr11	TEAD1	12878888	12878900	0	13	1234	10563	1234	10550	0.0	0.11696682464454976
chr11	ARNTL	13349944	13350070	0	127	24812	6957	24812	6830	0.0	3.632796486090776
chr11	ARNTL	13326412	13326467	0	56	24812	6957	24812	6901	0.0	3.5954209534850023
chr11	ARNTL	13356738	13356777	0	40	24812	6957	24812	6917	0.0	3.5871042359404366
chr11	ARNTL	13309986	13310059	0	74	24812	6957	24812	6883	0.0	3.6048234781345343
chr11	ARNTL	13355225	13355296	0	72	24812	6957	24812	6885	0.0	3.6037763253449526
chr11	ARNTL	13355232	13355296	0	65	24812	6957	24812	6892	0.0	3.600116076610563
chr11	ARNTL	13355172	13355296	0	125	24812	6957	24812	6832	0.0	3.6317330210772836
chr11	ARNTL	13321820	13321919	0	100	24812	6957	24812	6857	0.0	3.618492051917748
chr11	ARNTL	13354989	13355010	0	22	24812	6957	24812	6935	0.0	3.5777937995674116
chr11	LINC02548	13840654	13840851	0	198	0	2483	0	2285	0.0	0.0
chr11	LINC02548	13844922	13845095	0	174	0	2483	0	2309	0.0	0.0
chr11	LINC02548	13810241	13810346	0	106	0	2483	0	2377	0.0	0.0
chr11	INSC	15200823	15200949	0	127	0	3468	0	3341	0.0	0.0
chr11	INSC	15241566	15241645	0	80	0	3468	0	3388	0.0	0.0
chr11	INSC	15184417	15184522	0	106	0	3468	0	3362	0.0	0.0
chr11	LINC02682	15920115	15920236	0	122	0	3435	0	3313	0.0	0.0
chr11	LINC02682	15917429	15917481	0	53	0	3435	0	3382	0.0	0.0
chr11	LINC02682	15922585	15922655	0	71	0	3435	0	3364	0.0	0.0
chr11	LINC02682	15918301	15918462	0	162	0	3435	0	3273	0.0	0.0
chr11	C11ORF58	16744600	16744684	0	85	306	9224	306	9139	0.0	0.03348287558813875
chr11	C11ORF58	16748096	16748157	0	62	306	9224	306	9162	0.0	0.03339882121807466
chr11	C11ORF58	16753883	16754035	0	153	306	9224	306	9071	0.0	0.033733877191048395
chr11	NUCB2	17276007	17276203	33	197	191245	9053	191212	8856	0.16751269035532995	21.591237579042456
chr11	NUCB2	17315385	17315475	559	91	191245	9053	190686	8962	6.142857142857143	21.277170274492303
chr11	NUCB2	17330126	17330297	0	172	191245	9053	191245	8881	0.0	21.534174079495553
chr11	NUCB2	17267587	17267681	24	95	191245	9053	191221	8958	0.25263157894736843	21.346394284438492
chr11	NUCB2	17275612	17275909	0	298	191245	9053	191245	8755	0.0	21.84408909194746
chr11	NUCB2	17286633	17286713	0	81	191245	9053	191245	8972	0.0	21.315760142666072
chr11	NUCB2	17317583	17317706	10814	124	191245	9053	180431	8929	87.20967741935483	20.207302049501624
chr11	NUCB2	17291239	17291365	0	127	191245	9053	191245	8926	0.0	21.425610575845845
chr11	NUCB2	17286633	17286717	0	85	191245	9053	191245	8968	0.0	21.325267618198037
chr11	NUCB2	17283460	17283564	0	105	191245	9053	191245	8948	0.0	21.37293249888243
chr11	OTOG	17591449	17591588	0	140	0	10880	0	10740	0.0	0.0
chr11	OTOG	17599670	17599697	0	28	0	10880	0	10852	0.0	0.0
chr11	KCNC1	17781669	17781901	0	233	0	12001	0	11768	0.0	0.0
chr11	KCNC1	17779455	17779644	0	190	0	12001	0	11811	0.0	0.0
chr11	KCNC1	17773768	17773830	0	63	0	12001	0	11938	0.0	0.0
chr11	SAA1	18266382	18266443	0	62	0	714	0	652	0.0	0.0
chr11	GTF2H1	18325946	18326153	0	208	17124	6442	17124	6234	0.0	2.7468719923002887
chr11	GTF2H1	18335753	18335946	0	194	17124	6442	17124	6248	0.0	2.740717029449424
chr11	GTF2H1	18325946	18326019	0	74	17124	6442	17124	6368	0.0	2.689070351758794
chr11	LDHA	18399430	18399548	0	119	408	4566	408	4447	0.0	0.09174724533393298
chr11	LDHA	18400836	18401010	0	175	408	4566	408	4391	0.0	0.09291733090412206
chr11	LDHA	18398797	18398988	0	192	408	4566	408	4374	0.0	0.09327846364883402
chr11	LDHA	18405448	18405572	0	125	408	4566	408	4441	0.0	0.09187120018013961
chr11	LDHA	18395123	18395273	0	151	408	4566	408	4415	0.0	0.09241223103057758
chr11	LDHA	18400629	18400745	0	117	408	4566	408	4449	0.0	0.09170600134861767
chr11	LDHA	18396479	18396610	0	132	408	4566	408	4434	0.0	0.09201623815967523
chr11	LDHC	18415183	18415301	0	119	2392	2097	2392	1978	0.0	1.2093023255813953
chr11	LDHC	18429736	18429910	2392	175	2392	2097	0	1922	13.668571428571429	0.0
chr11	LDHC	18446209	18446333	0	125	2392	2097	2392	1972	0.0	1.2129817444219066
chr11	LDHC	18434739	18434913	0	175	2392	2097	2392	1922	0.0	1.2445369406867846
chr11	LDHC	18429778	18429910	1639	133	2392	2097	753	1964	12.323308270676693	0.3834012219959267
chr11	LDHC	18438527	18438645	0	119	2392	2097	2392	1978	0.0	1.2093023255813953
chr11	ZDHHC13	19142977	19143123	0	147	41819	7703	41819	7556	0.0	5.534542085759661
chr11	AC009652.1	19301376	19301483	0	108	0	652	0	544	0.0	0.0
chr11	NAV2	20049835	20049901	0	67	61381	15007	61381	14940	0.0	4.108500669344043
chr11	NAV2	20082591	20082600	10	10	61381	15007	61371	14997	1.0	4.092218443688738
chr11	NAV2	19884293	19884362	0	70	61381	15007	61381	14937	0.0	4.109325835174399
chr11	NAV2	20056529	20056628	0	100	61381	15007	61381	14907	0.0	4.117595760381029
chr11	NAV2	20051288	20051333	0	46	61381	15007	61381	14961	0.0	4.102733774480315
chr11	HTATIP2	20376579	20376717	0	139	0	2801	0	2662	0.0	0.0
chr11	PRMT3	20392210	20392260	0	51	3154	5499	3154	5448	0.0	0.578928046989721
chr11	PRMT3	20393790	20393854	51	65	3154	5499	3103	5434	0.7846153846153846	0.5710342289289658
chr11	PRMT3	20388018	20388154	0	137	3154	5499	3154	5362	0.0	0.5882133532264081
chr11	SLC6A5	20604285	20604424	0	140	102	6937	102	6797	0.0	0.015006620567897602
chr11	NELL1	21534373	21534514	0	142	197	5341	197	5199	0.0	0.03789190228890171
chr11	NELL1	21560188	21560382	0	195	197	5341	197	5146	0.0	0.0382821609016712
chr11	NELL1	20674488	20674572	0	85	197	5341	197	5256	0.0	0.03748097412480974
chr11	NELL1	20847582	20847753	0	172	197	5341	197	5169	0.0	0.03811182046817566
chr11	GAS2	22731330	22731396	0	67	0	4135	0	4068	0.0	0.0
chr11	LINC02718	23164990	23165093	0	104	0	1360	0	1256	0.0	0.0
chr11	BBOX1	27093167	27093366	0	200	0	2152	0	1952	0.0	0.0
chr11	BDNF-AS	27540019	27540116	0	98	122520	12372	122520	12274	0.0	9.982075932866222
chr11	BDNF-AS	27658240	27658462	0	223	122520	12372	122520	12149	0.0	10.084780640381924
chr11	BDNF-AS	27658237	27658462	0	226	122520	12372	122520	12146	0.0	10.087271529721718
chr11	BDNF-AS	27675576	27676140	0	565	122520	12372	122520	11807	0.0	10.376895062251206
chr11	BDNF-AS	27584268	27584337	0	70	122520	12372	122520	12302	0.0	9.959356202243537
chr11	BDNF-AS	27676981	27677139	20616	159	122520	12372	101904	12213	129.66037735849056	8.343895848685827
chr11	BDNF-AS	27665260	27665392	39	133	122520	12372	122481	12239	0.2932330827067669	10.007435247977776
chr11	BDNF-AS	27658240	27658544	0	305	122520	12372	122520	12067	0.0	10.153310682025358
chr11	BDNF-AS	27658240	27658620	0	381	122520	12372	122520	11991	0.0	10.217663247435576
chr11	BDNF-AS	27592879	27592981	0	103	122520	12372	122520	12269	0.0	9.986143940011411
chr11	BDNF-AS	27691105	27691140	0	36	122520	12372	122520	12336	0.0	9.931906614785992
chr11	BDNF-AS	27675296	27676140	918	845	122520	12372	121602	11527	1.0863905325443788	10.549318990196928
chr11	BDNF-AS	27675296	27675496	513	201	122520	12372	122007	12171	2.5522388059701493	10.024402267685481
chr11	METTL15	28211061	28211198	0	138	9468	6379	9468	6241	0.0	1.5170645729850984
chr11	METTL15	28197440	28197549	0	110	9468	6379	9468	6269	0.0	1.5102887222842558
chr11	METTL15	28328094	28328165	0	72	9468	6379	9468	6307	0.0	1.501189154907246
chr11	METTL15	28296752	28296931	0	180	9468	6379	9468	6199	0.0	1.5273431198580416
chr11	METTL15	28122141	28122180	0	40	9468	6379	9468	6339	0.0	1.493610979649787
chr11	LINC02546	29622634	29623076	0	443	0	2969	0	2526	0.0	0.0
chr11	LINC02546	29622754	29623076	0	323	0	2969	0	2646	0.0	0.0
chr11	LINC02546	29622634	29622913	0	280	0	2969	0	2689	0.0	0.0
chr11	LINC02546	29621730	29621905	0	176	0	2969	0	2793	0.0	0.0
chr11	DNAJC24	31407455	31407543	0	89	1173	6529	1173	6440	0.0	0.18214285714285713
chr11	DNAJC24	31396282	31396394	0	113	1173	6529	1173	6416	0.0	0.18282418952618454
chr11	DNAJC24	31421971	31422132	0	162	1173	6529	1173	6367	0.0	0.18423119208418406
chr11	DNAJC24	31374102	31374205	0	104	1173	6529	1173	6425	0.0	0.18256809338521401
chr11	DNAJC24	31408109	31408330	0	222	1173	6529	1173	6307	0.0	0.18598382749326145
chr11	DNAJC24	31429482	31429606	0	125	1173	6529	1173	6404	0.0	0.18316677076826984
chr11	ELP4	31594769	31594901	0	133	19299	23173	19299	23040	0.0	0.8376302083333333
chr11	ELP4	31763410	31763549	31	140	19299	23173	19268	23033	0.22142857142857142	0.836538878999696
chr11	ELP4	31541430	31541476	0	47	19299	23173	19299	23126	0.0	0.8345152642047912
chr11	ELP4	31628238	31628419	0	182	19299	23173	19299	22991	0.0	0.8394154234265582
chr11	ELP4	31681786	31682075	0	290	19299	23173	19299	22883	0.0	0.8433771795656164
chr11	ELP4	31580682	31580800	0	119	19299	23173	19299	23054	0.0	0.837121540730459
chr11	ELP4	31573586	31573624	0	39	19299	23173	19299	23134	0.0	0.8342266793464165
chr11	ELP4	31714630	31714779	0	150	19299	23173	19299	23023	0.0	0.8382487078139252
chr11	ELP4	31780678	31780761	0	84	19299	23173	19299	23089	0.0	0.8358525704881112
chr11	ELP4	31687660	31687702	0	43	19299	23173	19299	23130	0.0	0.8343709468223087
chr11	PAUPAR	31829498	31829607	0	110	21750	7661	21750	7551	0.0	2.88041319030592
chr11	RCN1	32103003	32103158	0	156	0	3470	0	3314	0.0	0.0
chr11	WT1-AS	32437069	32437197	91	129	1009	5365	918	5236	0.7054263565891473	0.17532467532467533
chr11	EIF3M	32588593	32588732	0	140	129386	7442	129386	7302	0.0	17.71925499863051
chr11	EIF3M	32589011	32589135	0	125	129386	7442	129386	7317	0.0	17.68293016263496
chr11	EIF3M	32587011	32587144	0	134	129386	7442	129386	7308	0.0	17.704707170224413
chr11	EIF3M	32602078	32602114	6	37	129386	7442	129380	7405	0.16216216216216217	17.471978392977718
chr11	QSER1	32927961	32928123	0	163	76870	10924	76870	10761	0.0	7.143388160951584
chr11	QSER1	32966299	32966437	6	139	76870	10924	76864	10785	0.04316546762589928	7.126935558646268
chr11	TCP11L1	33040129	33040202	0	74	4539	5147	4539	5073	0.0	0.8947368421052632
chr11	TCP11L1	33056587	33056723	179	137	4539	5147	4360	5010	1.3065693430656935	0.8702594810379242
chr11	CSTF3-DT	33189367	33189557	0	191	3619	4016	3619	3825	0.0	0.9461437908496731
chr11	HIPK3	33348165	33348228	0	64	334970	8184	334970	8120	0.0	41.25246305418719
chr11	KIAA1549L	33591236	33591421	0	186	18319	13519	18319	13333	0.0	1.3739593489837245
chr11	CAPRIN1	34052420	34052636	51	217	289377	8803	289326	8586	0.2350230414746544	33.6974143955276
chr11	CAT	34457775	34457847	0	73	37304	3593	37304	3520	0.0	10.597727272727273
chr11	EHF	34651736	34651805	0	70	51	6633	51	6563	0.0	0.007770836507694652
chr11	PDHX	34931403	34931484	22	82	7271	3735	7249	3653	0.2682926829268293	1.9843963865316179
chr11	CD44	35180273	35180407	0	135	2183374	9710	2183374	9575	0.0	228.02861618798957
chr11	CD44	35198120	35198246	1019297	127	2183374	9710	1164077	9583	8025.96062992126	121.47312950015653
chr11	CD44	35201670	35201787	312	118	2183374	9710	2183062	9592	2.6440677966101696	227.5919516263553
chr11	CD44	35206111	35206243	480	133	2183374	9710	2182894	9577	3.6090225563909772	227.93087605722042
chr11	CD44	35211245	35211449	833247	205	2183374	9710	1350127	9505	4064.619512195122	142.04387164650183
chr11	CD44	35221653	35221732	0	80	2183374	9710	2183374	9630	0.0	226.726272066459
chr11	CD44	35214851	35214914	1114	64	2183374	9710	2182260	9646	17.40625	226.23470868753887
chr11	CD44	35196745	35196874	918	130	2183374	9710	2182456	9580	7.061538461538461	227.81377870563674
chr11	CD44	35208104	35208206	0	103	2183374	9710	2183374	9607	0.0	227.26907463308004
chr11	CD44	35209964	35210054	152	91	2183374	9710	2183222	9619	1.6703296703296704	226.969747374987
chr11	CD44	35204511	35204640	0	130	2183374	9710	2183374	9580	0.0	227.90960334029228
chr11	CD44	35198147	35198246	730522	100	2183374	9710	1452852	9610	7305.22	151.1812695109261
chr11	CD44	35206114	35206243	480	130	2183374	9710	2182894	9580	3.6923076923076925	227.85949895615866
chr11	LDLRAD3	36101914	36102031	0	118	4535	4585	4535	4467	0.0	1.0152227445713007
chr11	LDLRAD3	36227084	36227430	2334	347	4535	4585	2201	4238	6.726224783861672	0.5193487494100991
chr11	LDLRAD3	36036102	36036249	0	148	4535	4585	4535	4437	0.0	1.0220869957178274
chr11	PRR5L	36419254	36419303	0	50	14506	6635	14506	6585	0.0	2.2028853454821564
chr11	PRR5L	36446299	36446440	0	142	14506	6635	14506	6493	0.0	2.234098259664254
chr11	PRR5L	36451208	36451335	0	128	14506	6635	14506	6507	0.0	2.2292915321960964
chr11	PRR5L	36393845	36394011	0	167	14506	6635	14506	6468	0.0	2.2427334570191713
chr11	IFTAP	36633283	36633438	0	156	1173	10397	1173	10241	0.0	0.11453959574260326
chr11	IFTAP	36636050	36636117	0	68	1173	10397	1173	10329	0.0	0.11356375254138833
chr11	IFTAP	36648015	36648155	0	141	1173	10397	1173	10256	0.0	0.11437207488299532
chr11	IFTAP	36597643	36597730	0	88	1173	10397	1173	10309	0.0	0.11378407216994858
chr11	IFTAP	36610080	36610239	0	160	1173	10397	1173	10237	0.0	0.11458435088404806
chr11	IFTAP	36633285	36633438	0	154	1173	10397	1173	10243	0.0	0.11451723127989846
chr11	LINC01493	38648423	38648604	0	182	0	2429	0	2247	0.0	0.0
chr11	LINC01493	38648768	38648934	0	167	0	2429	0	2262	0.0	0.0
chr11	LINC01499	41808966	41809083	0	118	0	3065	0	2947	0.0	0.0
chr11	API5	43318420	43318482	0	63	42448	4580	42448	4517	0.0	9.397387646668143
chr11	API5	43326506	43326611	0	106	42448	4580	42448	4474	0.0	9.487706750111757
chr11	API5	43335277	43335354	0	78	42448	4580	42448	4502	0.0	9.428698356286095
chr11	API5	43318639	43318801	0	163	42448	4580	42448	4417	0.0	9.61014263074485
chr11	TTC17	43436163	43436334	18977	172	25362	11324	6385	11152	110.3313953488372	0.5725430416068866
chr11	TTC17	43370078	43370385	145	308	25362	11324	25217	11016	0.4707792207792208	2.2891249092229486
chr11	TTC17	43486415	43486451	0	37	25362	11324	25362	11287	0.0	2.247009834322672
chr11	HSD17B12	43798319	43798427	0	109	1275	4696	1275	4587	0.0	0.2779594506213211
chr11	ALKBH3	43883982	43884017	367	36	60763	2155	60396	2119	10.194444444444445	28.50212364322794
chr11	ALKBH3	43897194	43897354	0	161	60763	2155	60763	1994	0.0	30.472918756268808
chr11	ALKBH3	43892040	43892129	56	90	60763	2155	60707	2065	0.6222222222222222	29.398062953995158
chr11	ALKBH3	43901515	43901725	0	211	60763	2155	60763	1944	0.0	31.256687242798353
chr11	ACCS	44083423	44083577	0	155	63	4458	63	4303	0.0	0.014640948175691379
chr11	EXT2	44104616	44104783	685	168	5577	11714	4892	11546	4.0773809523809526	0.42369651827472715
chr11	EXT2	44197828	44198018	0	191	5577	11714	5577	11523	0.0	0.48398854464983077
chr11	EXT2	44236292	44236375	0	84	5577	11714	5577	11630	0.0	0.47953568357695614
chr11	EXT2	44103706	44103745	38	40	5577	11714	5539	11674	0.95	0.4744731882816515
chr11	CD82	44605354	44605429	0	76	1762	3641	1762	3565	0.0	0.49424964936886395
chr11	CD82	44618639	44618723	16	85	1762	3641	1746	3556	0.18823529411764706	0.49100112485939257
chr11	CD82	44566272	44566330	0	59	1762	3641	1762	3582	0.0	0.4919039642657733
chr11	CD82	44587709	44587886	416	178	1762	3641	1346	3463	2.337078651685393	0.38868033496967946
chr11	CD82	44585142	44585292	0	151	1762	3641	1762	3490	0.0	0.5048710601719197
chr11	TSPAN18	44909704	44909899	0	196	0	4392	0	4196	0.0	0.0
chr11	TSPAN18	44897751	44897828	0	78	0	4392	0	4314	0.0	0.0
chr11	LINC02685	44974795	44974893	0	99	0	1608	0	1509	0.0	0.0
chr11	LINC02685	44977308	44977402	0	95	0	1608	0	1513	0.0	0.0
chr11	LINC02685	44974574	44974893	0	320	0	1608	0	1288	0.0	0.0
chr11	PRDM11	45224216	45224843	0	628	33802	13952	33802	13324	0.0	2.5369258480936656
chr11	LINC02696	45355878	45355925	21	48	153	5170	132	5122	0.4375	0.025771183131589222
chr11	AC044839.1	45734540	45734799	0	260	0	6744	0	6484	0.0	0.0
chr11	AC044839.1	45739409	45739542	0	134	0	6744	0	6610	0.0	0.0
chr11	AC044839.1	45740900	45740963	0	64	0	6744	0	6680	0.0	0.0
chr11	AC044839.1	45741544	45741862	0	319	0	6744	0	6425	0.0	0.0
chr11	AC044839.1	45737055	45737085	0	31	0	6744	0	6713	0.0	0.0
chr11	AC044839.1	45741663	45741862	0	200	0	6744	0	6544	0.0	0.0
chr11	AC044839.1	45742423	45742670	0	248	0	6744	0	6496	0.0	0.0
chr11	AC044839.1	45741724	45741862	0	139	0	6744	0	6605	0.0	0.0
chr11	AC044839.1	45734547	45734799	0	253	0	6744	0	6491	0.0	0.0
chr11	CRY2	45860847	45861032	0	186	15675	5264	15675	5078	0.0	3.0868452146514374
chr11	CRY2	45862059	45862148	0	90	15675	5264	15675	5174	0.0	3.029570931580982
chr11	LARGE2	45926038	45926151	12593	114	88759	2871	76166	2757	110.46491228070175	27.62640551323903
chr11	LARGE2	45928176	45928372	957	197	88759	2871	87802	2674	4.8578680203045685	32.835452505609574
chr11	DGKZ	46368004	46368079	0	76	20198	8820	20198	8744	0.0	2.3099268069533396
chr11	DGKZ	46369940	46370009	403	70	20198	8820	19795	8750	5.757142857142857	2.2622857142857145
chr11	DGKZ	46368001	46368079	0	79	20198	8820	20198	8741	0.0	2.3107195973000803
chr11	MDK	46382293	46382461	0	169	4089	2201	4089	2032	0.0	2.012303149606299
chr11	MDK	46382056	46382133	0	78	4089	2201	4089	2123	0.0	1.9260480452190296
chr11	ATG13	46618324	46618375	200	52	8037	5435	7837	5383	3.8461538461538463	1.4558796210291658
chr11	ATG13	46621059	46621157	0	99	8037	5435	8037	5336	0.0	1.506184407796102
chr11	ATG13	46621041	46621157	0	117	8037	5435	8037	5318	0.0	1.5112824370063933
chr11	ATG13	46630044	46630100	0	57	8037	5435	8037	5378	0.0	1.494421718110822
chr11	ATG13	46618259	46618375	408	117	8037	5435	7629	5318	3.4871794871794872	1.4345618653629184
chr11	ATG13	46632322	46632459	165	138	8037	5435	7872	5297	1.1956521739130435	1.4861242212573154
chr11	ATG13	46664848	46664959	0	112	8037	5435	8037	5323	0.0	1.5098628592898742
chr11	ATG13	46630896	46630991	0	96	8037	5435	8037	5339	0.0	1.5053380782918149
chr11	ATG13	46644278	46644360	102	83	8037	5435	7935	5352	1.2289156626506024	1.4826233183856503
chr11	ATG13	46663996	46664095	0	100	8037	5435	8037	5335	0.0	1.5064667291471414
chr11	ATG13	46638498	46638610	76	113	8037	5435	7961	5322	0.672566371681416	1.4958662157083804
chr11	LRP4-AS1	46852851	46852946	0	96	1173	1643	1173	1547	0.0	0.7582417582417582
chr11	C11ORF49	46987207	46987310	0	104	5354	5413	5354	5309	0.0	1.008476172537201
chr11	C11ORF49	47137315	47137560	51	246	5354	5413	5303	5167	0.2073170731707317	1.0263208825237082
chr11	C11ORF49	47157022	47157218	0	197	5354	5413	5354	5216	0.0	1.0264570552147239
chr11	C11ORF49	47023338	47023394	0	57	5354	5413	5354	5356	0.0	0.9996265870052278
chr11	C11ORF49	47052387	47052518	0	132	5354	5413	5354	5281	0.0	1.0138231395569022
chr11	C11ORF49	47004364	47004456	0	93	5354	5413	5354	5320	0.0	1.006390977443609
chr11	C11ORF49	46948025	46948164	0	140	5354	5413	5354	5273	0.0	1.0153612744168405
chr11	C11ORF49	46991542	46991647	0	106	5354	5413	5354	5307	0.0	1.008856227623893
chr11	DDB2	47216857	47217049	0	193	11485	4822	11485	4629	0.0	2.481097429250378
chr11	DDB2	47232813	47232959	0	147	11485	4822	11485	4675	0.0	2.4566844919786095
chr11	DDB2	47234756	47234934	0	179	11485	4822	11485	4643	0.0	2.473616196424725
chr11	DDB2	47233226	47233474	0	249	11485	4822	11485	4573	0.0	2.5114804286026677
chr11	DDB2	47237618	47237712	1564	95	11485	4822	9921	4727	16.46315789473684	2.098794161201608
chr11	NR1H3	47260408	47260675	47185	268	281701	4063	234516	3795	176.0634328358209	61.796047430830036
chr11	NR1H3	47261546	47261726	63486	181	281701	4063	218215	3882	350.7513812154696	56.21200412158681
chr11	NR1H3	47250465	47250551	0	87	281701	4063	281701	3976	0.0	70.85035211267606
chr11	NR1H3	47259790	47259979	56	190	281701	4063	281645	3873	0.29473684210526313	72.72011360702298
chr11	NR1H3	47259179	47259259	1065	81	281701	4063	280636	3982	13.148148148148149	70.4761426418885
chr11	NR1H3	47259360	47259606	50009	247	281701	4063	231692	3816	202.4655870445344	60.71593291404612
chr11	NR1H3	47259100	47259259	1840	160	281701	4063	279861	3903	11.5	71.70407378939278
chr11	NR1H3	47260550	47260675	21500	126	281701	4063	260201	3937	170.63492063492063	66.09118618237237
chr11	MADD	47286432	47286534	0	103	75005	8408	75005	8305	0.0	9.03130644190247
chr11	MADD	47326737	47326807	0	71	75005	8408	75005	8337	0.0	8.99664147774979
chr11	MADD	47273826	47273976	81	151	75005	8408	74924	8257	0.5364238410596026	9.073997820031488
chr11	MADD	47288967	47289027	0	61	75005	8408	75005	8347	0.0	8.98586318437762
chr11	MADD	47292542	47292596	37	55	75005	8408	74968	8353	0.6727272727272727	8.974979049443315
chr11	MADD	47308979	47309042	0	64	75005	8408	75005	8344	0.0	8.989093959731544
chr11	MADD	47326543	47326552	0	10	75005	8408	75005	8398	0.0	8.931293165039294
chr11	SLC39A13	47413399	47413507	0	109	0	3873	0	3764	0.0	0.0
chr11	PTPMT1	47569699	47569891	0	193	6689	2574	6689	2381	0.0	2.8093238135237297
chr11	NDUFS3	47579268	47579334	0	67	2995	4322	2995	4255	0.0	0.7038777908343126
chr11	NDUFS3	47579268	47579338	0	71	2995	4322	2995	4251	0.0	0.7045401082098329
chr11	PTPRJ	48112746	48112983	204	238	64581	9648	64377	9410	0.8571428571428571	6.841339001062699
chr11	PTPRJ	48121002	48121266	579	265	64581	9648	64002	9383	2.1849056603773587	6.8210593626771825
chr11	OR8K3	56315999	56316057	0	59	51	2418	51	2359	0.0	0.02161933022467147
chr11	LINC02735	56874723	56874843	0	121	0	2905	0	2784	0.0	0.0
chr11	SERPING1	57598248	57598321	0	74	3060	6109	3060	6035	0.0	0.5070422535211268
chr11	SERPING1	57599878	57600377	1479	500	3060	6109	1581	5609	2.958	0.28186842574433946
chr11	SERPING1	57606407	57606547	0	141	3060	6109	3060	5968	0.0	0.5127345844504021
chr11	SERPING1	57598008	57598321	0	314	3060	6109	3060	5795	0.0	0.5280414150129422
chr11	SERPING1	57606009	57606213	51	205	3060	6109	3009	5904	0.24878048780487805	0.5096544715447154
chr11	SERPING1	57605323	57605508	0	186	3060	6109	3060	5923	0.0	0.5166300861050144
chr11	SERPING1	57599863	57600377	1479	515	3060	6109	1581	5594	2.8718446601941747	0.28262424025741867
chr11	SERPING1	57606710	57606799	0	90	3060	6109	3060	6019	0.0	0.5083900980229275
chr11	SERPING1	57605602	57606213	51	612	3060	6109	3009	5497	0.08333333333333333	0.5473894851737311
chr11	ZDHHC5	57682421	57682543	0	123	0	5308	0	5185	0.0	0.0
chr11	ZDHHC5	57672020	57673194	0	1175	0	5308	0	4133	0.0	0.0
chr11	TMX2	57737607	57737668	0	62	0	2143	0	2081	0.0	0.0
chr11	CTNND1	57814310	57814373	0	64	720	9351	720	9287	0.0	0.07752772693011736
chr11	CTNND1	57794009	57794081	0	73	720	9351	720	9278	0.0	0.0776029316663074
chr11	CTNND1	57806460	57806478	0	19	720	9351	720	9332	0.0	0.07715387912558937
chr11	TMX2	57737912	57738026	0	115	0	2143	0	2028	0.0	0.0
chr11	TMX2	57738353	57738430	0	78	0	2143	0	2065	0.0	0.0
chr11	TMX2	57738663	57739039	0	377	0	2143	0	1766	0.0	0.0
chr11	TMX2	57737835	57738026	0	192	0	2143	0	1951	0.0	0.0
chr11	TMX2	57737785	57738026	0	242	0	2143	0	1901	0.0	0.0
chr11	CTNND1	57789036	57789155	0	120	720	9351	720	9231	0.0	0.07799805004874878
chr11	CTNND1	57815914	57816001	0	88	720	9351	720	9263	0.0	0.0777285976465508
chr11	CTNND1	57791384	57791673	0	290	720	9351	720	9061	0.0	0.07946142809844388
chr11	CTNND1	57791493	57791673	0	181	720	9351	720	9170	0.0	0.07851690294438386
chr11	CTNND1	57762600	57762667	204	68	720	9351	516	9283	3.0	0.05558547883227405
chr11	GLYATL1	58947045	58947165	0	121	7038	4761	7038	4640	0.0	1.5168103448275863
chr11	GLYATL1	58942539	58942584	0	46	7038	4761	7038	4715	0.0	1.4926829268292683
chr11	GLYATL1	58947045	58947068	0	24	7038	4761	7038	4737	0.0	1.4857504749841672
chr11	FAM111B	59108667	59108712	0	46	0	3869	0	3823	0.0	0.0
chr11	FAM111B	59109539	59109706	0	168	0	3869	0	3701	0.0	0.0
chr11	FAM111A	59143496	59143695	0	200	107	6384	107	6184	0.0	0.017302716688227686
chr11	FAM111A	59145826	59145856	0	31	107	6384	107	6353	0.0	0.016842436644105147
chr11	FAM111A	59144808	59144896	0	89	107	6384	107	6295	0.0	0.016997617156473393
chr11	FAM111A	59144537	59144896	0	360	107	6384	107	6024	0.0	0.017762284196547146
chr11	AP000442.1	59635419	59635536	0	118	2208	1810	2208	1692	0.0	1.3049645390070923
chr11	AP000442.1	59635419	59635532	0	114	2208	1810	2208	1696	0.0	1.3018867924528301
chr11	STX3	59787036	59787136	0	101	0	6815	0	6714	0.0	0.0
chr11	STX3	59795371	59795482	0	112	0	6815	0	6703	0.0	0.0
chr11	STX3	59797282	59797396	0	115	0	6815	0	6700	0.0	0.0
chr11	MS4A3	60061145	60061316	0	172	0	2090	0	1918	0.0	0.0
chr11	MS4A3	60062467	60062605	0	139	0	2090	0	1951	0.0	0.0
chr11	MS4A3	60061489	60061554	0	66	0	2090	0	2024	0.0	0.0
chr11	MS4A2	60090335	60090470	0	136	0	4461	0	4325	0.0	0.0
chr11	MS4A4A	60302558	60302717	0	160	0	2959	0	2799	0.0	0.0
chr11	MS4A4A	60282593	60282739	0	147	0	2959	0	2812	0.0	0.0
chr11	MS4A4A	60296870	60297022	0	153	0	2959	0	2806	0.0	0.0
chr11	MS4A4A	60290048	60290242	0	195	0	2959	0	2764	0.0	0.0
chr11	MS4A6E	60335529	60335649	0	121	0	1064	0	943	0.0	0.0
chr11	MS4A7	60386716	60386773	0	58	357	3914	357	3856	0.0	0.09258298755186722
chr11	MS4A7	60392684	60392786	0	103	357	3914	357	3811	0.0	0.09367620047231698
chr11	MS4A7	60385087	60385222	0	136	357	3914	357	3778	0.0	0.09449444150344097
chr11	MS4A14	60405888	60405987	0	100	26	4014	26	3914	0.0	0.006642820643842616
chr11	MS4A14	60400403	60400454	0	52	26	4014	26	3962	0.0	0.006562342251388188
chr11	MS4A14	60404545	60404666	0	122	26	4014	26	3892	0.0	0.006680369989722507
chr11	MS4A5	60433764	60433917	0	154	0	921	0	767	0.0	0.0
chr11	MS4A5	60433849	60433917	0	69	0	921	0	852	0.0	0.0
chr11	MS4A1	60458048	60458208	0	161	0	4614	0	4453	0.0	0.0
chr11	MS4A1	60461071	60461160	0	90	0	4614	0	4524	0.0	0.0
chr11	MS4A12	60492919	60493032	18	114	204	1846	186	1732	0.15789473684210525	0.10739030023094688
chr11	MS4A12	60501044	60501182	0	139	204	1846	204	1707	0.0	0.1195079086115993
chr11	MS4A13	60525206	60525326	0	121	0	1316	0	1195	0.0	0.0
chr11	MS4A13	60523896	60523953	0	58	0	1316	0	1258	0.0	0.0
chr11	MS4A13	60529364	60529460	0	97	0	1316	0	1219	0.0	0.0
chr11	LINC00301	60657102	60657400	0	299	74159	1989	74159	1690	0.0	43.881065088757396
chr11	LINC00301	60658726	60658870	4961	145	74159	1989	69198	1844	34.213793103448275	37.52603036876356
chr11	LINC00301	60679902	60680023	0	122	74159	1989	74159	1867	0.0	39.72094268880557
chr11	LINC00301	60653688	60653783	0	96	74159	1989	74159	1893	0.0	39.17538298996302
chr11	LINC00301	60675138	60675248	0	111	74159	1989	74159	1878	0.0	39.48828541001065
chr11	MS4A8	60701283	60701473	12886	191	50013	2227	37127	2036	67.46596858638743	18.2352652259332
chr11	MS4A15	60767532	60767655	0	124	408	2290	408	2166	0.0	0.1883656509695291
chr11	MS4A15	60763705	60763958	0	254	408	2290	408	2036	0.0	0.20039292730844793
chr11	MS4A15	60767566	60767655	0	90	408	2290	408	2200	0.0	0.18545454545454546
chr11	MS4A15	60771437	60771758	0	322	408	2290	408	1968	0.0	0.2073170731707317
chr11	ZP1	60869536	60869900	0	365	0	1917	0	1552	0.0	0.0
chr11	TMEM132A	60931983	60932127	0	145	3761	5092	3761	4947	0.0	0.7602587426723266
chr11	CD6	61009571	61009874	0	304	204	4331	204	4027	0.0	0.05065805810777253
chr11	CD6	61013918	61014014	0	97	204	4331	204	4234	0.0	0.048181388757675955
chr11	CD6	61015712	61015835	0	124	204	4331	204	4207	0.0	0.04849061088661754
chr11	CD6	61018288	61018393	0	106	204	4331	204	4225	0.0	0.048284023668639056
chr11	CD6	60982624	60982770	0	147	204	4331	204	4184	0.0	0.04875717017208413
chr11	CD6	61015732	61015835	0	104	204	4331	204	4227	0.0	0.0482611781405252
chr11	CD6	61011069	61011135	0	67	204	4331	204	4264	0.0	0.04784240150093809
chr11	AP003721.2	61061301	61061426	72	126	137795	839	137723	713	0.5714285714285714	193.15988779803646
chr11	TKFC	61333548	61333650	0	103	0	7716	0	7613	0.0	0.0
chr11	TMEM138	61364432	61364518	0	87	51	4888	51	4801	0.0	0.010622786919391794
chr11	SDHAF2	61436760	61436960	4	201	4	1702	0	1501	0.01990049751243781	0.0
chr11	SDHAF2	61438003	61438113	0	111	4	1702	4	1591	0.0	0.00251414204902577
chr11	AP003108.2	61481781	61481918	55	138	1834	7534	1779	7396	0.39855072463768115	0.24053542455381288
chr11	SDHAF2	61437624	61437848	0	225	4	1702	4	1477	0.0	0.002708192281651997
chr11	AP003108.2	61445940	61446231	0	292	1834	7534	1834	7242	0.0	0.2532449599558133
chr11	PPP1R32	61486343	61486403	0	61	3510	2415	3510	2354	0.0	1.4910790144435004
chr11	PPP1R32	61486523	61486610	0	88	3510	2415	3510	2327	0.0	1.5083798882681565
chr11	PPP1R32	61489781	61489946	196	166	3510	2415	3314	2249	1.180722891566265	1.4735437972432193
chr11	AP002754.1	61598184	61598286	43	103	4817	2760	4774	2657	0.4174757281553398	1.7967632668423033
chr11	AP002754.1	61596892	61596979	0	88	4817	2760	4817	2672	0.0	1.8027694610778444
chr11	RPLP0P2	61630168	61630288	1010	121	19245	3820	18235	3699	8.347107438016529	4.929710732630441
chr11	MYRF	61780711	61780792	0	82	1453	9103	1453	9021	0.0	0.1610686176698814
chr11	BEST1	61955342	61955387	0	46	306	5587	306	5541	0.0	0.055224688684353006
chr11	BEST1	61951770	61951958	0	189	306	5587	306	5398	0.0	0.05668766209707299
chr11	INCENP	62141499	62141511	0	13	6824	3753	6824	3740	0.0	1.8245989304812835
chr11	ASRGL1	62356324	62356467	0	144	2438957	4595	2438957	4451	0.0	547.9570882947652
chr11	TTC9C	62733117	62733199	0	83	0	2634	0	2551	0.0	0.0
chr11	POLR2G	62762541	62762742	0	202	0	1552	0	1350	0.0	0.0
chr11	TMEM179B	62789600	62789679	0	80	0	1365	0	1285	0.0	0.0
chr11	SLC3A2	62870744	62870837	0	94	0	3522	0	3428	0.0	0.0
chr11	SLC3A2	62876783	62876879	0	97	0	3522	0	3425	0.0	0.0
chr11	SLC3A2	62871576	62871669	0	94	0	3522	0	3428	0.0	0.0
chr11	SLC3A2	62876786	62876879	0	94	0	3522	0	3428	0.0	0.0
chr11	SLC3A2	62882666	62882807	0	142	0	3522	0	3380	0.0	0.0
chr11	SLC3A2	62883988	62884112	0	125	0	3522	0	3397	0.0	0.0
chr11	SLC22A9	63373643	63373798	13	156	64	2376	51	2220	0.08333333333333333	0.022972972972972974
chr11	LGALS12	63511078	63511105	0	28	2389	2311	2389	2283	0.0	1.0464301357862462
chr11	PLAAT4	63539515	63539624	982	110	7871	1305	6889	1195	8.927272727272728	5.764853556485356
chr11	RTN3	63752506	63752645	70	140	208487	5524	208417	5384	0.5	38.710438335809805
chr11	RTN3	63704850	63704907	0	58	208487	5524	208487	5466	0.0	38.142517380168314
chr11	RTN3	63756111	63756170	25680	60	208487	5524	182807	5464	428.0	33.45662518301611
chr11	RTN3	63746946	63747024	0	79	208487	5524	208487	5445	0.0	38.289623507805324
chr11	RTN3	63718701	63721032	125983	2332	208487	5524	82504	3192	54.02358490566038	25.847117794486216
chr11	RTN3	63718980	63721032	125269	2053	208487	5524	83218	3471	61.01753531417438	23.975223278594065
chr11	MARK2	63903985	63904147	0	163	7176	8854	7176	8691	0.0	0.825681739730756
chr11	MARK2	63906087	63906114	20	28	7176	8854	7156	8826	0.7142857142857143	0.810786313165647
chr11	MARK2	63908259	63908304	0	46	7176	8854	7176	8808	0.0	0.8147138964577657
chr11	MARK2	63903985	63904354	0	370	7176	8854	7176	8484	0.0	0.8458274398868458
chr11	MARK2	63890221	63890295	0	75	7176	8854	7176	8779	0.0	0.8174051714318259
chr11	MARK2	63906087	63907567	306	1481	7176	8854	6870	7373	0.20661715057393654	0.931778109317781
chr11	NAA40	63946950	63947003	206	54	24809	5285	24603	5231	3.814814814814815	4.7033072070349835
chr11	FERMT3	64221015	64221140	0	126	101	2997	101	2871	0.0	0.035179380006966215
chr11	NUDT22	64227567	64227666	0	100	0	3038	0	2938	0.0	0.0
chr11	NUDT22	64229246	64229344	0	99	0	3038	0	2939	0.0	0.0
chr11	NUDT22	64227400	64227493	0	94	0	3038	0	2944	0.0	0.0
chr11	NUDT22	64229849	64230070	0	222	0	3038	0	2816	0.0	0.0
chr11	DNAJC4	64231031	64231147	0	117	51	2070	51	1953	0.0	0.026113671274961597
chr11	GPR137	64288064	64288214	0	151	51	3606	51	3455	0.0	0.014761215629522432
chr11	GPR137	64287720	64287946	0	227	51	3606	51	3379	0.0	0.015093222846996152
chr11	GPR137	64288602	64288721	0	120	51	3606	51	3486	0.0	0.014629948364888123
chr11	KCNK4	64292941	64293207	0	267	0	2595	0	2328	0.0	0.0
chr11	ESRRA	64307167	64307504	0	338	42	3109	42	2771	0.0	0.015156983038614218
chr11	ESRRA	64314743	64314911	39	169	42	3109	3	2940	0.23076923076923078	0.0010204081632653062
chr11	ESRRA	64314740	64314911	42	172	42	3109	0	2937	0.2441860465116279	0.0
chr11	ESRRA	64315000	64315270	0	271	42	3109	42	2838	0.0	0.014799154334038054
chr11	PRDX5	64320660	64320792	0	133	0	866	0	733	0.0	0.0
chr11	PRDX5	64319733	64319868	0	136	0	866	0	730	0.0	0.0
chr11	CCDC88B	64354003	64354170	0	168	51	6744	51	6576	0.0	0.007755474452554745
chr11	CCDC88B	64354003	64354028	0	26	51	6744	51	6718	0.0	0.00759154510270914
chr11	SLC22A11	64559134	64559238	255	105	344589	5168	344334	5063	2.4285714285714284	68.00987556784516
chr11	SLC22A11	64564307	64564428	11929	122	344589	5168	332660	5046	97.77868852459017	65.92548553309553
chr11	SLC22A11	64568669	64568778	0	110	344589	5168	344589	5058	0.0	68.12752075919336
chr11	SLC22A11	64569651	64569858	450	208	344589	5168	344139	4960	2.1634615384615383	69.38286290322581
chr11	SLC22A11	64569783	64569858	255	76	344589	5168	344334	5092	3.3552631578947367	67.62254516889239
chr11	SLC22A12	64593404	64593559	0	156	1245	2982	1245	2826	0.0	0.440552016985138
chr11	SLC22A12	64593634	64593803	0	170	1245	2982	1245	2812	0.0	0.44274537695590327
chr11	SLC22A12	64593404	64593457	0	54	1245	2982	1245	2928	0.0	0.42520491803278687
chr11	ARL2	65020418	65020499	0	82	51	1837	51	1755	0.0	0.02905982905982906
chr11	SNX15	65032167	65032203	0	37	59900	4844	59900	4807	0.0	12.46099438319118
chr11	SNX15	65034846	65034962	12100	117	59900	4844	47800	4727	103.41880341880342	10.112121853183838
chr11	SNX15	65038571	65038829	1377	259	59900	4844	58523	4585	5.316602316602316	12.764013086150491
chr11	SNX15	65032167	65032271	0	105	59900	4844	59900	4739	0.0	12.63979742561722
chr11	SAC3D1	65043024	65043164	0	141	3057	1673	3057	1532	0.0	1.9954308093994777
chr11	ZFPL1	65085114	65085226	300	113	18328	2401	18028	2288	2.6548672566371683	7.879370629370629
chr11	ZFPL1	65085114	65085314	308	201	18328	2401	18020	2200	1.5323383084577114	8.190909090909091
chr11	VPS51	65096997	65097127	336	131	200815	4595	200479	4464	2.564885496183206	44.91017025089606
chr11	VPS51	65107580	65107727	0	148	200815	4595	200815	4447	0.0	45.15740948954351
chr11	VPS51	65107186	65107372	0	187	200815	4595	200815	4408	0.0	45.55694192377496
chr11	VPS51	65111160	65111237	6434	78	200815	4595	194381	4517	82.48717948717949	43.03320788133717
chr11	TM7SF2	65115313	65115394	48	82	139494	2460	139446	2378	0.5853658536585366	58.640033641715725
chr11	TM7SF2	65112810	65112865	500	56	139494	2460	138994	2404	8.928571428571429	57.81780366056572
chr11	TM7SF2	65113219	65113414	12659	196	139494	2460	126835	2264	64.58673469387755	56.022526501766784
chr11	TM7SF2	65113490	65113594	14548	105	139494	2460	124946	2355	138.55238095238096	53.0556263269639
chr11	TM7SF2	65115475	65115598	153	124	139494	2460	139341	2336	1.2338709677419355	59.64940068493151
chr11	TM7SF2	65113523	65113594	2916	72	139494	2460	136578	2388	40.5	57.19346733668342
chr11	TM7SF2	65112810	65112894	954	85	139494	2460	138540	2375	11.223529411764705	58.33263157894737
chr11	TM7SF2	65113368	65113414	1996	47	139494	2460	137498	2413	42.46808510638298	56.98217985909656
chr11	TM7SF2	65115774	65115822	0	49	139494	2460	139494	2411	0.0	57.857320613853176
chr11	MRPL49	65124501	65124652	1444	152	4174	2385	2730	2233	9.5	1.2225705329153604
chr11	CAPN1	65183127	65183197	0	71	83832	5821	83832	5750	0.0	14.579478260869566
chr11	CAPN1	65186169	65186338	0	170	83832	5821	83832	5651	0.0	14.834896478499381
chr11	CAPN1	65182383	65182480	0	98	83832	5821	83832	5723	0.0	14.648261401362921
chr11	SLC22A20P	65220995	65221164	102	170	14373	3995	14271	3825	0.6	3.7309803921568627
chr11	SLC22A20P	65238661	65239480	27	820	14373	3995	14346	3175	0.032926829268292684	4.5184251968503935
chr11	POLA2	65266581	65266706	165489	126	499555	5587	334066	5461	1313.404761904762	61.17304522981139
chr11	DPF2	65340384	65340545	24519	162	445063	7024	420544	6862	151.35185185185185	61.28592247158263
chr11	DPF2	65341398	65341562	89717	165	445063	7024	355346	6859	543.739393939394	51.80726053360548
chr11	DPF2	65343990	65344069	175	80	445063	7024	444888	6944	2.1875	64.06797235023042
chr11	DPF2	65346246	65346359	4623	114	445063	7024	440440	6910	40.55263157894737	63.73950795947901
chr11	DPF2	65344579	65344621	32	43	445063	7024	445031	6981	0.7441860465116279	63.74888984386191
chr11	FRMD8	65389360	65389528	356	169	83407	4080	83051	3911	2.106508875739645	21.2352339555101
chr11	FRMD8	65393572	65393674	2183	103	83407	4080	81224	3977	21.194174757281555	20.423434749811417
chr11	SCYL1	65538269	65538324	0	56	4238	3914	4238	3858	0.0	1.0984966303784345
chr11	ZNRD2	65571390	65571779	0	390	2076	1874	2076	1484	0.0	1.398921832884097
chr11	EHBP1L1	65580927	65580963	68	37	10558	5816	10490	5779	1.837837837837838	1.8151929399550095
chr11	PCNX3	65620338	65620429	1591	92	4529234	8007	4527643	7915	17.293478260869566	572.0332280480101
chr11	SIPA1	65639135	65639251	3845	117	40736	4641	36891	4524	32.863247863247864	8.154509283819628
chr11	KAT5	65713347	65713503	0	157	102	3659	102	3502	0.0	0.02912621359223301
chr11	MUS81	65860674	65860888	0	215	1573	4721	1573	4506	0.0	0.3490901020861074
chr11	CTSW	65882608	65882689	0	82	5019	1700	5019	1618	0.0	3.1019777503090236
chr11	BANF1	66003234	66003373	1581	140	47359	1298	45778	1158	11.292857142857143	39.53195164075993
chr11	BANF1	66002843	66003070	14363	228	47359	1298	32996	1070	62.99561403508772	30.837383177570093
chr11	SF3B2	66055534	66055585	51652	52	867725	9289	816073	9237	993.3076923076923	88.34827324889034
chr11	SF3B2	66055537	66055585	51652	49	867725	9289	816073	9240	1054.1224489795918	88.31958874458874
chr11	PACS1	66242911	66243031	189	121	69941	8343	69752	8222	1.56198347107438	8.483580637314523
chr11	PACS1	66217505	66217617	0	113	69941	8343	69941	8230	0.0	8.498298906439855
chr11	KLC2	66261741	66261972	0	232	48687	3969	48687	3737	0.0	13.028364998662028
chr11	RAB1B	66272364	66272460	0	97	291200	1956	291200	1859	0.0	156.64335664335664
chr11	CNIH2	66281416	66281574	1494	159	22171	1769	20677	1610	9.39622641509434	12.842857142857143
chr11	NPAS4	66423122	66423232	486	111	17766	3436	17280	3325	4.378378378378378	5.196992481203008
chr11	PELI3	66468127	66468280	1571	154	8233	3910	6662	3756	10.2012987012987	1.7736954206602769
chr11	PELI3	66468832	66468904	176	73	8233	3910	8057	3837	2.410958904109589	2.0998175658066196
chr11	DPP3	66482192	66482470	663	279	3854	3901	3191	3622	2.3763440860215055	0.8810049696300386
chr11	DPP3	66485172	66485262	0	91	3854	3901	3854	3810	0.0	1.0115485564304463
chr11	DPP3	66495364	66495489	0	126	3854	3901	3854	3775	0.0	1.020927152317881
chr11	DPP3	66482195	66482470	663	276	3854	3901	3191	3625	2.402173913043478	0.8802758620689655
chr11	DPP3	66482179	66482470	663	292	3854	3901	3191	3609	2.2705479452054793	0.884178442781934
chr11	DPP3	66482288	66482470	474	183	3854	3901	3380	3718	2.5901639344262297	0.9090909090909091
chr11	BBS1	66511204	66511239	0	36	13407	5850	13407	5814	0.0	2.305985552115583
chr11	BBS1	66514405	66514678	372	274	13407	5850	13035	5576	1.3576642335766422	2.337697274031564
chr11	BBS1	66515539	66515586	815	48	13407	5850	12592	5802	16.979166666666668	2.1702861082385385
chr11	BBS1	66523171	66523365	102	195	13407	5850	13305	5655	0.5230769230769231	2.352785145888594
chr11	BBS1	66514505	66514678	372	174	13407	5850	13035	5676	2.1379310344827585	2.296511627906977
chr11	CCS	66593641	66593714	153	74	6491	2149	6338	2075	2.0675675675675675	3.0544578313253012
chr11	CCS	66593609	66593714	153	106	6491	2149	6338	2043	1.4433962264150944	3.1023005384238864
chr11	RBM14	66624213	66624324	2505	112	268761	6382	266256	6270	22.366071428571427	42.46507177033493
chr11	RBM4	66643449	66644140	1938	692	16039	6217	14101	5525	2.800578034682081	2.5522171945701357
chr11	RBM14	66623900	66623968	0	69	268761	6382	268761	6313	0.0	42.57262791066054
chr11	RBM4	66639699	66640123	0	425	16039	6217	16039	5792	0.0	2.769164364640884
chr11	RBM14	66618495	66618561	98	67	268761	6382	268663	6315	1.462686567164179	42.54362628661916
chr11	C11ORF80	66756352	66756505	0	154	2853	3974	2853	3820	0.0	0.7468586387434555
chr11	C11ORF80	66801030	66801102	0	73	2853	3974	2853	3901	0.0	0.7313509356575237
chr11	C11ORF80	66788159	66788269	35	111	2853	3974	2818	3863	0.3153153153153153	0.7294848563292777
chr11	C11ORF80	66796280	66796364	0	85	2853	3974	2853	3889	0.0	0.7336076112111083
chr11	C11ORF80	66822563	66822674	0	112	2853	3974	2853	3862	0.0	0.7387364060072501
chr11	C11ORF80	66748378	66748517	0	140	2853	3974	2853	3834	0.0	0.744131455399061
chr11	C11ORF80	66788159	66788273	39	115	2853	3974	2814	3859	0.3391304347826087	0.7292044571132418
chr11	C11ORF80	66821642	66821764	0	123	2853	3974	2853	3851	0.0	0.7408465333679564
chr11	C11ORF80	66801030	66801161	0	132	2853	3974	2853	3842	0.0	0.7425819885476315
chr11	C11ORF80	66839131	66839207	625	77	2853	3974	2228	3897	8.116883116883116	0.5717218373107519
chr11	RCE1	66845499	66845562	0	64	0	2143	0	2079	0.0	0.0
chr11	SYT12	67034644	67034838	510	195	378126	10117	377616	9922	2.6153846153846154	38.05845595646039
chr11	KDM2A	67243008	67243092	0	85	659011	10408	659011	10323	0.0	63.839097161677806
chr11	KDM2A	67131951	67132073	11702	123	659011	10408	647309	10285	95.13821138211382	62.937190082644626
chr11	GRK2	67282270	67282365	0	96	1979	4814	1979	4718	0.0	0.4194573972022043
chr11	GRK2	67283706	67283773	10	68	1979	4814	1969	4746	0.14705882352941177	0.4148756847871892
chr11	ANKRD13D	67289828	67289965	0	138	0	4350	0	4212	0.0	0.0
chr11	SSH3	67307548	67307737	0	190	49	3237	49	3047	0.0	0.01608139153265507
chr11	SSH3	67309396	67309543	0	148	49	3237	49	3089	0.0	0.015862738750404663
chr11	SSH3	67304117	67304155	0	39	49	3237	49	3198	0.0	0.015322076297686053
chr11	RAD9A	67392160	67392231	0	72	118048	3780	118048	3708	0.0	31.836030204962245
chr11	TBC1D10C	67406826	67407016	0	191	964	4302	964	4111	0.0	0.23449282413038192
chr11	CARNS1	67416175	67416202	0	28	714	5370	714	5342	0.0	0.13365780606514413
chr11	RPS6KB2	67428981	67429022	0	42	22	2864	22	2822	0.0	0.007795889440113395
chr11	RPS6KB2	67432355	67432492	0	138	22	2864	22	2726	0.0	0.008070432868672046
chr11	RPS6KB2	67432736	67432837	22	102	22	2864	0	2762	0.21568627450980393	0.0
chr11	RPS6KB2	67428912	67429022	0	111	22	2864	22	2753	0.0	0.007991282237559027
chr11	RPS6KB2	67432599	67432657	0	59	22	2864	22	2805	0.0	0.00784313725490196
chr11	RPS6KB2	67431367	67431515	0	149	22	2864	22	2715	0.0	0.008103130755064457
chr11	RPS6KB2	67432352	67432492	0	141	22	2864	22	2723	0.0	0.008079324274697026
chr11	AIP	67489266	67489455	0	190	15	1661	15	1471	0.0	0.010197144799456152
chr11	GSTP1	67584463	67584570	0	108	0	1247	0	1139	0.0	0.0
chr11	GSTP1	67586103	67586211	0	109	0	1247	0	1138	0.0	0.0
chr11	NDUFV1	67608395	67608478	0	84	0	3785	0	3701	0.0	0.0
chr11	NDUFV1	67611896	67611978	0	83	0	3785	0	3702	0.0	0.0
chr11	NDUFV1	67608399	67608478	0	80	0	3785	0	3705	0.0	0.0
chr11	NDUFV1	67607365	67607496	0	132	0	3785	0	3653	0.0	0.0
chr11	NDUFV1	67607298	67607324	0	27	0	3785	0	3758	0.0	0.0
chr11	NDUFV1	67608395	67608457	0	63	0	3785	0	3722	0.0	0.0
chr11	NDUFV1	67608431	67608478	0	48	0	3785	0	3737	0.0	0.0
chr11	ALDH3B1	68018526	68018637	0	112	109743	6638	109743	6526	0.0	16.816273368066195
chr11	ALDH3B1	68019714	68019796	0	83	109743	6638	109743	6555	0.0	16.74187643020595
chr11	NDUFS8	68031532	68031710	0	179	32031	3779	32031	3600	0.0	8.8975
chr11	NDUFS8	68035627	68035788	19245	162	32031	3779	12786	3617	118.79629629629629	3.5349737351396184
chr11	TCIRG1	68043370	68043497	168	128	2776	4293	2608	4165	1.3125	0.626170468187275
chr11	TCIRG1	68050486	68050664	0	179	2776	4293	2776	4114	0.0	0.6747690811861935
chr11	TCIRG1	68039791	68039962	586	172	2776	4293	2190	4121	3.4069767441860463	0.5314244115505945
chr11	TCIRG1	68046936	68046998	0	63	2776	4293	2776	4230	0.0	0.6562647754137115
chr11	AP002992.1	68129080	68130082	1224	1003	1224	1925	0	922	1.2203389830508475	0.0
chr11	LRP5	68389880	68390052	0	173	3032	6209	3032	6036	0.0	0.5023194168323393
chr11	LRP5	68404222	68404416	0	195	3032	6209	3032	6014	0.0	0.5041569670768208
chr11	LRP5	68445572	68445686	0	115	3032	6209	3032	6094	0.0	0.497538562520512
chr11	PPP6R3	68505144	68505249	565	106	257968	8173	257403	8067	5.330188679245283	31.9081442915582
chr11	PPP6R3	68522493	68522689	126120	197	257968	8173	131848	7976	640.2030456852792	16.530591775325977
chr11	PPP6R3	68505144	68505271	646	128	257968	8173	257322	8045	5.046875	31.98533250466128
chr11	PPP6R3	68515027	68515166	0	140	257968	8173	257968	8033	0.0	32.113531681812525
chr11	PPP6R3	68583042	68583129	0	88	257968	8173	257968	8085	0.0	31.906988249845394
chr11	PPP6R3	68519500	68519651	0	152	257968	8173	257968	8021	0.0	32.161575863358685
chr11	PPP6R3	68537658	68537891	1068	234	257968	8173	256900	7939	4.564102564102564	32.35923919889155
chr11	PPP6R3	68567013	68567166	0	154	257968	8173	257968	8019	0.0	32.16959720663424
chr11	PPP6R3	68609610	68609628	0	19	257968	8173	257968	8154	0.0	31.636987981358843
chr11	PPP6R3	68566998	68567166	0	169	257968	8173	257968	8004	0.0	32.229885057471265
chr11	PPP6R3	68609472	68609628	0	157	257968	8173	257968	8016	0.0	32.181636726546905
chr11	IGHMBP2	68906068	68906238	0	171	3517	8643	3517	8472	0.0	0.41513220018885744
chr11	IGHMBP2	68933794	68933913	0	120	3517	8643	3517	8523	0.0	0.41264812859321837
chr11	IGHMBP2	68935298	68935422	0	125	3517	8643	3517	8518	0.0	0.412890349847382
chr11	IGHMBP2	68908533	68908631	0	99	3517	8643	3517	8544	0.0	0.41163389513108617
chr11	IGHMBP2	68911439	68911603	129	165	3517	8643	3388	8478	0.7818181818181819	0.3996225524887945
chr11	IGHMBP2	68938181	68938354	0	174	3517	8643	3517	8469	0.0	0.41527925374896685
chr11	IGHMBP2	68906068	68906242	0	175	3517	8643	3517	8468	0.0	0.4153282947567312
chr11	IGHMBP2	68906068	68906384	0	317	3517	8643	3517	8326	0.0	0.4224117223156378
chr11	IGHMBP2	68930322	68930434	0	113	3517	8643	3517	8530	0.0	0.4123094958968347
chr11	IGHMBP2	68914184	68914350	0	167	3517	8643	3517	8476	0.0	0.41493629070316185
chr11	IGHMBP2	68917160	68917301	0	142	3517	8643	3517	8501	0.0	0.41371603340783436
chr11	IGHMBP2	68917163	68917301	0	139	3517	8643	3517	8504	0.0	0.4135700846660395
chr11	IGHMBP2	68917521	68917552	0	32	3517	8643	3517	8611	0.0	0.40843107653001975
chr11	IGHMBP2	68938657	68938844	0	188	3517	8643	3517	8455	0.0	0.41596688350088706
chr11	IGHMBP2	68928920	68928997	707	78	3517	8643	2810	8565	9.064102564102564	0.3280793928779918
chr11	IGHMBP2	68935330	68935422	0	93	3517	8643	3517	8550	0.0	0.41134502923976607
chr11	TPCN2	69079833	69079883	80	51	1979	7280	1899	7229	1.5686274509803921	0.2626919352607553
chr11	TPCN2	69085209	69085286	26	78	1979	7280	1953	7202	0.3333333333333333	0.2711746737017495
chr11	LINC01488	69491656	69491799	0	144	38063	4909	38063	4765	0.0	7.98803777544596
chr11	ANO1	70103065	70103164	0	100	14658	6051	14658	5951	0.0	2.4631154427827258
chr11	ANO1	70152449	70152461	26	13	14658	6051	14632	6038	2.0	2.423318979794634
chr11	ANO1	70155910	70155988	11	79	14658	6051	14647	5972	0.13924050632911392	2.4526121902210316
chr11	ANO1	70111125	70111191	40	67	14658	6051	14618	5984	0.5970149253731343	2.4428475935828877
chr11	PPFIA1	70382087	70382158	0	72	17259	10724	17259	10652	0.0	1.6202591062711227
chr11	PPFIA1	70350993	70351023	0	31	17259	10724	17259	10693	0.0	1.6140465725240811
chr11	PPFIA1	70322396	70322554	0	159	17259	10724	17259	10565	0.0	1.6336015144344533
chr11	PPFIA1	70333021	70333096	0	76	17259	10724	17259	10648	0.0	1.6208677685950412
chr11	PPFIA1	70374659	70374829	0	171	17259	10724	17259	10553	0.0	1.6354591111532266
chr11	PPFIA1	70343668	70343892	0	225	17259	10724	17259	10499	0.0	1.643870844842366
chr11	PPFIA1	70349922	70350039	0	118	17259	10724	17259	10606	0.0	1.6272864416368094
chr11	CTTN	70421469	70421580	33	112	64	5771	31	5659	0.29464285714285715	0.005477999646580668
chr11	NADSYN1	71476032	71477438	0	1407	8915	14232	8915	12825	0.0	0.6951267056530215
chr11	NADSYN1	71477344	71477438	0	95	8915	14232	8915	14137	0.0	0.6306146990167645
chr11	NADSYN1	71480218	71480274	0	57	8915	14232	8915	14175	0.0	0.6289241622574956
chr11	FAM86C1P	71791735	71791819	714	85	26749	3381	26035	3296	8.4	7.898968446601942
chr11	FAM86C1P	71793379	71793481	68	103	26749	3381	26681	3278	0.6601941747572816	8.139414276998169
chr11	FAM86C1P	71791738	71791819	681	82	26749	3381	26068	3299	8.304878048780488	7.901788420733555
chr11	RNF121	71957226	71957264	0	39	11427	3262	11427	3223	0.0	3.5454545454545454
chr11	RNF121	71982806	71982915	0	110	11427	3262	11427	3152	0.0	3.6253172588832485
chr11	RNF121	71978085	71978235	0	151	11427	3262	11427	3111	0.0	3.673095467695275
chr11	RNF121	71987003	71987111	0	109	11427	3262	11427	3153	0.0	3.6241674595623214
chr11	RNF121	71982760	71982915	0	156	11427	3262	11427	3106	0.0	3.679008370895042
chr11	RNF121	71962151	71962289	0	139	11427	3262	11427	3123	0.0	3.658981748318924
chr11	RNF121	71990596	71990717	0	122	11427	3262	11427	3140	0.0	3.639171974522293
chr11	IL18BP	71999258	71999370	1997	113	235124	3492	233127	3379	17.672566371681416	68.99289730689553
chr11	IL18BP	71999227	71999662	8008	436	235124	3492	227116	3056	18.36697247706422	74.31806282722513
chr11	IL18BP	71999616	71999662	2510	47	235124	3492	232614	3445	53.40425531914894	67.522206095791
chr11	LRTOMT	72093495	72093701	0	207	673	3353	673	3146	0.0	0.21392244119516846
chr11	LRTOMT	72089028	72089165	102	138	673	3353	571	3215	0.7391304347826086	0.1776049766718507
chr11	LRTOMT	72088296	72088380	61	85	673	3353	612	3268	0.7176470588235294	0.18727050183598531
chr11	LRTOMT	72089416	72089596	408	181	673	3353	265	3172	2.25414364640884	0.08354350567465321
chr11	LRTOMT	72085410	72085573	0	164	673	3353	673	3189	0.0	0.2110379429288178
chr11	LRTOMT	72088339	72088380	38	42	673	3353	635	3311	0.9047619047619048	0.19178495922681968
chr11	FOLR1	72190575	72190641	0	67	44	1608	44	1541	0.0	0.02855288773523686
chr11	FOLR2	72218560	72218734	0	175	0	1197	0	1022	0.0	0.0
chr11	FOLR2	72217336	72217423	0	88	0	1197	0	1109	0.0	0.0
chr11	FOLR2	72218572	72218734	0	163	0	1197	0	1034	0.0	0.0
chr11	INPPL1	72229662	72229752	0	91	51	6501	51	6410	0.0	0.00795631825273011
chr11	INPPL1	72238041	72238175	0	135	51	6501	51	6366	0.0	0.008011310084825637
chr11	ATG16L2	72824059	72824122	0	64	1810	7660	1810	7596	0.0	0.23828330700368616
chr11	ATG16L2	72828882	72828984	0	103	1810	7660	1810	7557	0.0	0.2395130342728596
chr11	ATG16L2	72823765	72823797	0	33	1810	7660	1810	7627	0.0	0.23731480267470828
chr11	ATG16L2	72823543	72823797	0	255	1810	7660	1810	7405	0.0	0.24442943956785956
chr11	P2RY6	73272339	73272466	0	128	1059	3193	1059	3065	0.0	0.34551386623164765
chr11	P2RY6	73295729	73295815	39	87	1059	3193	1020	3106	0.4482758620689655	0.3283966516419833
chr11	P2RY6	73272306	73272466	0	161	1059	3193	1059	3032	0.0	0.3492744063324538
chr11	AP000763.3	73406442	73406501	0	60	1164	347	1164	287	0.0	4.055749128919861
chr11	PLEKHB1	73650552	73650705	663	154	2054	3884	1391	3730	4.305194805194805	0.3729222520107239
chr11	PLEKHB1	73647388	73647529	0	142	2054	3884	2054	3742	0.0	0.5489043292357029
chr11	PLEKHB1	73655802	73655907	0	106	2054	3884	2054	3778	0.0	0.5436739015352038
chr11	PLEKHB1	73650531	73650705	683	175	2054	3884	1371	3709	3.902857142857143	0.369641412779725
chr11	PLEKHB1	73653369	73653461	0	93	2054	3884	2054	3791	0.0	0.5418095489316803
chr11	PLEKHB1	73648185	73648278	0	94	2054	3884	2054	3790	0.0	0.5419525065963061
chr11	MRPL48	73823012	73823070	13	59	11235	3843	11222	3784	0.22033898305084745	2.9656448202959833
chr11	MRPL48	73859906	73860009	102	104	11235	3843	11133	3739	0.9807692307692307	2.977534100026745
chr11	MRPL48	73808312	73808350	0	39	11235	3843	11235	3804	0.0	2.9534700315457414
chr11	MRPL48	73825707	73825796	0	90	11235	3843	11235	3753	0.0	2.993605115907274
chr11	MRPL48	73817822	73817947	0	126	11235	3843	11235	3717	0.0	3.022598870056497
chr11	MRPL48	73805026	73805079	541	54	11235	3843	10694	3789	10.018518518518519	2.8223805753496967
chr11	MRPL48	73843246	73843367	0	122	11235	3843	11235	3721	0.0	3.0193496371943027
chr11	MRPL48	73802080	73802177	0	98	11235	3843	11235	3745	0.0	3.0
chr11	MRPL48	73789334	73789490	5390	157	11235	3843	5845	3686	34.3312101910828	1.585729788388497
chr11	PAAF1	73914412	73914504	0	93	10023	5654	10023	5561	0.0	1.8023736737996763
chr11	PAAF1	73886928	73887099	816	172	10023	5654	9207	5482	4.744186046511628	1.6794965341116381
chr11	PAAF1	73887039	73887099	0	61	10023	5654	10023	5593	0.0	1.7920615054532452
chr11	PAAF1	73887030	73887099	128	70	10023	5654	9895	5584	1.8285714285714285	1.7720272206303724
chr11	POLD3	74604691	74604794	0	104	4754	5517	4754	5413	0.0	0.8782560502493996
chr11	SPCS2	74963594	74963687	0	94	3850	2959	3850	2865	0.0	1.343804537521815
chr11	NEU3	74994508	74994720	0	213	778	7219	778	7006	0.0	0.11104767342278048
chr11	NEU3	75004304	75004405	0	102	778	7219	778	7117	0.0	0.10931572291695939
chr11	SLCO2B1	75165786	75165949	0	164	346	6153	346	5989	0.0	0.05777258306895976
chr11	RPS3	75400693	75400824	0	132	0	4632	0	4500	0.0	0.0
chr11	RPS3	75404019	75404207	0	189	0	4632	0	4443	0.0	0.0
chr11	RPS3	75402351	75402446	0	96	0	4632	0	4536	0.0	0.0
chr11	RPS3	75400693	75400777	0	85	0	4632	0	4547	0.0	0.0
chr11	RPS3	75402303	75402446	0	144	0	4632	0	4488	0.0	0.0
chr11	RPS3	75401639	75401733	0	95	0	4632	0	4537	0.0	0.0
chr11	RPS3	75404053	75404207	0	155	0	4632	0	4477	0.0	0.0
chr11	SERPINH1	75563726	75563770	0	45	8991	5453	8991	5408	0.0	1.6625369822485208
chr11	DGAT2	75784617	75784746	0	130	804	3122	804	2992	0.0	0.26871657754010697
chr11	UVRAG	76012926	76013102	0	177	18811	7369	18811	7192	0.0	2.6155450500556174
chr11	UVRAG	76137193	76137452	0	260	18811	7369	18811	7109	0.0	2.6460824307216204
chr11	EMSY	76454748	76454790	0	43	2337	10232	2337	10189	0.0	0.22936500147217587
chr11	EMSY	76545796	76546297	0	502	2337	10232	2337	9730	0.0	0.24018499486125386
chr11	EMSY	76496214	76496469	0	256	2337	10232	2337	9976	0.0	0.23426222935044105
chr11	EMSY	76539598	76539640	0	43	2337	10232	2337	10189	0.0	0.22936500147217587
chr11	EMSY	76547027	76547100	0	74	2337	10232	2337	10158	0.0	0.23006497341996457
chr11	ACER3	76958978	76959031	43	54	49148	8264	49105	8210	0.7962962962962963	5.981120584652863
chr11	ACER3	76926556	76926667	0	112	49148	8264	49148	8152	0.0	6.028949950932287
chr11	ACER3	76868119	76868156	0	38	49148	8264	49148	8226	0.0	5.974714320447362
chr11	ACER3	76959076	76959200	43	125	49148	8264	49105	8139	0.344	6.033296473768276
chr11	ACER3	76994155	76994226	0	72	49148	8264	49148	8192	0.0	5.99951171875
chr11	ACER3	76957464	76957586	0	123	49148	8264	49148	8141	0.0	6.037096179830487
chr11	ACER3	76868119	76868267	0	149	49148	8264	49148	8115	0.0	6.056438693776956
chr11	B3GNT6	77037175	77037298	0	124	2004	2629	2004	2505	0.0	0.8
chr11	CAPN5	77116225	77116303	0	79	745	5580	745	5501	0.0	0.1354299218323941
chr11	CAPN5	77072990	77073137	0	148	745	5580	745	5432	0.0	0.13715022091310752
chr11	CAPN5	77071609	77071682	0	74	745	5580	745	5506	0.0	0.1353069378859426
chr11	CAPN5	77087941	77088061	66	121	745	5580	679	5459	0.5454545454545454	0.12438175490016487
chr11	MYO7A	77139400	77139480	0	81	153	9808	153	9727	0.0	0.01572941297419554
chr11	MYO7A	77166938	77166992	0	55	153	9808	153	9753	0.0	0.015687480775146107
chr11	AAMDC	77841018	77841060	142	43	8578	1874	8436	1831	3.302325581395349	4.607318405243037
chr11	AAMDC	77869721	77869817	0	97	8578	1874	8578	1777	0.0	4.827236916150816
chr11	AAMDC	77878701	77878756	0	56	8578	1874	8578	1818	0.0	4.718371837183718
chr11	AAMDC	77855344	77855482	0	139	8578	1874	8578	1735	0.0	4.944092219020173
chr11	AAMDC	77884779	77884916	6777	138	8578	1874	1801	1736	49.108695652173914	1.037442396313364
chr11	KCTD21-AS1	78141594	78141702	0	109	4415	4417	4415	4308	0.0	1.0248375116063138
chr11	KCTD21-AS1	78148976	78149093	0	118	4415	4417	4415	4299	0.0	1.0269830193068155
chr11	USP35	78199594	78199724	0	131	154	5765	154	5634	0.0	0.027334043308484202
chr11	USP35	78196235	78196918	0	684	154	5765	154	5081	0.0	0.030308994292462112
chr11	DDIAS	82913286	82913386	102	101	19164	5351	19062	5250	1.00990099009901	3.630857142857143
chr11	DDIAS	82928776	82928938	0	163	19164	5351	19164	5188	0.0	3.6939090208172707
chr11	DDIAS	82913956	82914170	333	215	19164	5351	18831	5136	1.5488372093023255	3.6664719626168223
chr11	DDIAS	82930156	82930274	0	119	19164	5351	19164	5232	0.0	3.6628440366972477
chr11	DDIAS	82913654	82913746	62	93	19164	5351	19102	5258	0.6666666666666666	3.6329402814758462
chr11	DDIAS	82913282	82913386	102	105	19164	5351	19062	5246	0.9714285714285714	3.633625619519634
chr11	RAB30-DT	83073302	83073447	0	146	0	6987	0	6841	0.0	0.0
chr11	PCF11	83161326	83161452	0	127	102	9968	102	9841	0.0	0.010364800325170207
chr11	ANKRD42	83245497	83245624	0	128	0	6726	0	6598	0.0	0.0
chr11	ANKRD42	83240758	83240934	0	177	0	6726	0	6549	0.0	0.0
chr11	DLG2-AS2	83647003	83647090	0	88	0	2124	0	2036	0.0	0.0
chr11	TMEM126B	85631144	85631316	0	173	11	2156	11	1983	0.0	0.005547150781643974
chr11	TMEM126B	85629131	85629262	0	132	11	2156	11	2024	0.0	0.005434782608695652
chr11	TMEM126B	85631686	85631808	0	123	11	2156	11	2033	0.0	0.0054107230693556324
chr11	TMEM126B	85629131	85629203	0	73	11	2156	11	2083	0.0	0.00528084493518963
chr11	TMEM126A	85650248	85650341	0	94	0	976	0	882	0.0	0.0
chr11	TMEM126A	85650311	85650341	0	31	0	976	0	945	0.0	0.0
chr11	CCDC83	85886199	85886367	0	169	0	2371	0	2202	0.0	0.0
chr11	CCDC83	85912648	85912741	0	94	0	2371	0	2277	0.0	0.0
chr11	CCDC83	85882512	85882675	0	164	0	2371	0	2207	0.0	0.0
chr11	EED	86270082	86270157	0	76	4029	6220	4029	6144	0.0	0.65576171875
chr11	HIKESHI	86306244	86306482	0	239	0	2980	0	2741	0.0	0.0
chr11	HIKESHI	86326512	86326676	0	165	0	2980	0	2815	0.0	0.0
chr11	HIKESHI	86345093	86345198	0	106	0	2980	0	2874	0.0	0.0
chr11	CCDC81	86387515	86387659	0	145	408	4095	408	3950	0.0	0.10329113924050633
chr11	CCDC81	86397620	86397742	0	123	408	4095	408	3972	0.0	0.1027190332326284
chr11	CCDC81	86408126	86408270	0	145	408	4095	408	3950	0.0	0.10329113924050633
chr11	CCDC81	86407613	86407701	0	89	408	4095	408	4006	0.0	0.1018472291562656
chr11	TMEM135	87071522	87071615	0	94	816	10006	816	9912	0.0	0.08232445520581114
chr11	TMEM135	87157340	87157406	0	67	816	10006	816	9939	0.0	0.08210081497132508
chr11	GRM5-AS1	88512063	88512164	0	102	204	4843	204	4741	0.0	0.043028896857203125
chr11	TRIM77	89714191	89714422	0	232	0	1359	0	1127	0.0	0.0
chr11	NAALAD2	90158144	90158238	0	95	263	6651	263	6556	0.0	0.040115924344112264
chr11	NAALAD2	90159238	90159337	0	100	263	6651	263	6551	0.0	0.040146542512593496
chr11	DISC1FP1	90361558	90361622	0	65	566	3223	566	3158	0.0	0.1792273590880304
chr11	DISC1FP1	90849383	90849540	566	158	566	3223	0	3065	3.5822784810126582	0.0
chr11	DISC1FP1	90602804	90602908	0	105	566	3223	566	3118	0.0	0.18152661962796665
chr11	DISC1FP1	90716396	90716440	0	45	566	3223	566	3178	0.0	0.17809943360604152
chr11	LINC02756	91803291	91803492	0	202	0	2679	0	2477	0.0	0.0
chr11	MTNR1B	92972460	92972591	0	132	0	2029	0	1897	0.0	0.0
chr11	DEUP1	93352302	93352408	0	107	1093	4161	1093	4054	0.0	0.26961026147015293
chr11	CEP295	93691926	93692030	0	105	285	8943	285	8838	0.0	0.032247114731839784
chr11	CEP295	93702775	93702919	0	145	285	8943	285	8798	0.0	0.03239372584678336
chr11	CEP295	93721953	93722050	0	98	285	8943	285	8845	0.0	0.0322215941209723
chr11	C11ORF54	93747296	93747448	0	153	204	5944	204	5791	0.0	0.03522707649801416
chr11	C11ORF54	93750345	93750444	0	100	204	5944	204	5844	0.0	0.03490759753593429
chr11	C11ORF54	93755209	93755386	0	178	204	5944	204	5766	0.0	0.03537981269510926
chr11	C11ORF54	93757315	93757465	0	151	204	5944	204	5793	0.0	0.03521491455204557
chr11	C11ORF54	93747301	93747448	0	148	204	5944	204	5796	0.0	0.035196687370600416
chr11	C11ORF54	93741962	93742066	0	105	204	5944	204	5839	0.0	0.034937489296112345
chr11	C11ORF54	93741962	93742094	0	133	204	5944	204	5811	0.0	0.035105833763551884
chr11	MED17	93788000	93788167	0	168	0	8731	0	8563	0.0	0.0
chr11	MED17	93794907	93795060	0	154	0	8731	0	8577	0.0	0.0
chr11	MED17	93797534	93797719	0	186	0	8731	0	8545	0.0	0.0
chr11	MED17	93801834	93801972	0	139	0	8731	0	8592	0.0	0.0
chr11	MED17	93807517	93807635	0	119	0	8731	0	8612	0.0	0.0
chr11	MED17	93809716	93809876	0	161	0	8731	0	8570	0.0	0.0
chr11	C11ORF54	93741962	93742141	0	180	204	5944	204	5764	0.0	0.03539208882720333
chr11	MED17	93794249	93794439	0	191	0	8731	0	8540	0.0	0.0
chr11	MED17	93807500	93807635	0	136	0	8731	0	8595	0.0	0.0
chr11	MED17	93790259	93790343	0	85	0	8731	0	8646	0.0	0.0
chr11	MED17	93790573	93790793	0	221	0	8731	0	8510	0.0	0.0
chr11	AP002784.1	94276956	94277109	43	154	82607	5352	82564	5198	0.2792207792207792	15.883801462100807
chr11	ANKRD49	94497901	94497964	0	64	204	3004	204	2940	0.0	0.06938775510204082
chr11	PIWIL4	94608184	94608686	77167	503	154282	4521	77115	4018	153.41351888667992	19.192384270781485
chr11	PIWIL4	94603983	94604056	15913	74	154282	4521	138369	4447	215.04054054054055	31.11513379806611
chr11	PIWIL4	94608582	94608686	15495	105	154282	4521	138787	4416	147.57142857142858	31.428215579710145
chr11	LINC02700	94639561	94639735	0	175	2382	3099	2382	2924	0.0	0.8146374829001368
chr11	LINC02700	94648016	94648108	0	93	2382	3099	2382	3006	0.0	0.7924151696606786
chr11	LINC02700	94648016	94648102	0	87	2382	3099	2382	3012	0.0	0.7908366533864541
chr11	AMOTL1	94795010	94795160	0	151	21574	10047	21574	9896	0.0	2.1800727566693614
chr11	KDM4D	94975653	94975748	0	96	0	2805	0	2709	0.0	0.0
chr11	AP000787.1	95204805	95204912	0	108	0	6723	0	6615	0.0	0.0
chr11	AP000787.1	95232879	95232919	0	41	0	6723	0	6682	0.0	0.0
chr11	CEP57	95822498	95822576	0	79	23130	6568	23130	6489	0.0	3.564493758668516
chr11	CEP57	95799231	95799388	0	158	23130	6568	23130	6410	0.0	3.6084243369734788
chr11	CEP57	95821870	95821978	0	109	23130	6568	23130	6459	0.0	3.5810496980956805
chr11	CEP57	95794220	95794359	0	140	23130	6568	23130	6428	0.0	3.5983198506533913
chr11	CEP57	95795515	95795559	0	45	23130	6568	23130	6523	0.0	3.5459144565384024
chr11	CEP57	95799236	95799388	0	153	23130	6568	23130	6415	0.0	3.6056118472330474
chr11	CNTN5	99325345	99325484	0	140	51	9136	51	8996	0.0	0.005669186305024455
chr11	CNTN5	99819543	99819765	0	223	51	9136	51	8913	0.0	0.00572197913160552
chr11	CNTN5	100224691	100224812	0	122	51	9136	51	9014	0.0	0.005657865542489461
chr11	ARHGAP42	100913451	100913553	0	103	7168	6134	7168	6031	0.0	1.1885259492621456
chr11	ARHGAP42	100986073	100986352	0	280	7168	6134	7168	5854	0.0	1.224461906388794
chr11	CEP126	101986831	101987041	0	211	7220	8212	7220	8001	0.0	0.9023872015998
chr11	CEP126	101956261	101956943	765	683	7220	8212	6455	7529	1.1200585651537336	0.8573515739141985
chr11	CEP126	101956867	101956943	0	77	7220	8212	7220	8135	0.0	0.8875230485556238
chr11	CEP126	101955791	101956943	765	1153	7220	8212	6455	7059	0.6634865568083261	0.9144354724465221
chr11	CFAP300	102066484	102066651	0	168	2883	2653	2883	2485	0.0	1.1601609657947687
chr11	YAP1	102186017	102186131	0	115	6829	6322	6829	6207	0.0	1.100209440953762
chr11	YAP1	102209516	102209564	208	49	6829	6322	6621	6273	4.244897959183674	1.0554758488761358
chr11	BIRC3	102319876	102320006	0	131	124532	7530	124532	7399	0.0	16.830923097715907
chr11	BIRC3	102321836	102325362	122393	3527	124532	7530	2139	4003	34.7017295151687	0.5343492380714464
chr11	BIRC3	102326728	102326851	50	124	124532	7530	124482	7406	0.4032258064516129	16.808263570078314
chr11	BIRC2	102350843	102350943	0	101	153	3556	153	3455	0.0	0.04428364688856729
chr11	BIRC2	102348597	102348764	0	168	153	3556	153	3388	0.0	0.04515938606847698
chr11	DYNC2H1	103399662	103399872	0	211	4092	15101	4092	14890	0.0	0.2748153122901276
chr11	DYNC2H1	103241526	103241547	0	22	4092	15101	4092	15079	0.0	0.27137078055573977
chr11	GRIA4	105965946	105966061	0	116	1236	10106	1236	9990	0.0	0.12372372372372373
chr11	GRIA4	105971913	105972028	0	116	1236	10106	1236	9990	0.0	0.12372372372372373
chr11	AASDHPPT	106090556	106090678	0	123	0	6010	0	5887	0.0	0.0
chr11	ELMOD1	107625396	107625532	0	137	3900	5874	3900	5737	0.0	0.6797978037301725
chr11	ELMOD1	107650884	107650908	0	25	3900	5874	3900	5849	0.0	0.6667806462643187
chr11	CUL5	108046269	108046369	0	101	21854	5279	21854	5178	0.0	4.220548474314407
chr11	CUL5	108049889	108050066	0	178	21854	5279	21854	5101	0.0	4.2842579886296805
chr11	ACAT1	108135141	108135242	0	102	10524	5827	10524	5725	0.0	1.8382532751091702
chr11	ACAT1	108140064	108140215	153	152	10524	5827	10371	5675	1.006578947368421	1.827488986784141
chr11	ACAT1	108143982	108144047	51	66	10524	5827	10473	5761	0.7727272727272727	1.8179135566741884
chr11	ACAT1	108127885	108127979	54	95	10524	5827	10470	5732	0.5684210526315789	1.8265875785066295
chr11	ACAT1	108131906	108131954	0	49	10524	5827	10524	5778	0.0	1.8213914849428867
chr11	ATM	108235669	108235834	292	166	85809	19441	85517	19275	1.7590361445783131	4.4366796368352786
chr11	ATM	108271063	108271146	0	84	85809	19441	85809	19357	0.0	4.43296998501834
chr11	ATM	108294926	108295059	0	134	85809	19441	85809	19307	0.0	4.44445019940954
chr11	ATM	108307896	108307984	0	89	85809	19441	85809	19352	0.0	4.434115336916081
chr11	ATM	108293312	108293477	51	166	85809	19441	85758	19275	0.3072289156626506	4.449182879377432
chr11	ATM	108320709	108320780	0	72	85809	19441	85809	19369	0.0	4.430223553100315
chr11	ATM	108225500	108225574	1723	75	85809	19441	84086	19366	22.973333333333333	4.341939481565631
chr11	ATM	108224783	108224871	0	89	85809	19441	85809	19352	0.0	4.434115336916081
chr11	ATM	108226163	108226247	0	85	85809	19441	85809	19356	0.0	4.433199008059517
chr11	LINC02732	110366360	110366534	102	175	102	2329	0	2154	0.5828571428571429	0.0
chr11	LINC02732	110381925	110382021	0	97	102	2329	102	2232	0.0	0.0456989247311828
chr11	C11ORF53	111281397	111281440	0	44	0	1348	0	1304	0.0	0.0
chr11	COLCA2	111299785	111299890	0	106	0	2014	0	1908	0.0	0.0
chr11	COLCA2	111299785	111300017	0	233	0	2014	0	1781	0.0	0.0
chr11	AP002008.2	111452408	111452588	0	181	12019	5357	12019	5176	0.0	2.322063369397218
chr11	AP002008.2	111455384	111455620	0	237	12019	5357	12019	5120	0.0	2.3474609375
chr11	HOATZ	111524882	111524963	17	82	58	983	41	901	0.2073170731707317	0.04550499445061043
chr11	HOATZ	111519008	111519188	0	181	58	983	58	802	0.0	0.07231920199501247
chr11	LAYN	111549617	111549775	0	159	808	3154	808	2995	0.0	0.2697829716193656
chr11	LAYN	111541561	111541585	0	25	808	3154	808	3129	0.0	0.25822946628315757
chr11	C11ORF1	111883135	111883202	391	68	593	3520	202	3452	5.75	0.058516801853997685
chr11	C11ORF1	111881484	111881615	2	132	593	3520	591	3388	0.015151515151515152	0.17443919716646988
chr11	HSPB2-C11ORF52	111913440	111913971	816	532	2907	2064	2091	1532	1.5338345864661653	1.364882506527415
chr11	NKAPD1	112078214	112078315	0	102	2919	4338	2919	4236	0.0	0.6890934844192634
chr11	NKAPD1	112074886	112074916	0	31	2919	4338	2919	4307	0.0	0.677733921523102
chr11	SDHD	112088244	112088535	228	292	6674	2799	6446	2507	0.7808219178082192	2.5712006382130035
chr11	SDHD	112087856	112087973	1182	118	6674	2799	5492	2681	10.016949152542374	2.0484893696381947
chr11	SDHD	112088866	112089004	481	139	6674	2799	6193	2660	3.460431654676259	2.3281954887218044
chr11	SDHD	112088866	112089011	533	146	6674	2799	6141	2653	3.6506849315068495	2.3147380324161326
chr11	SDHD	112093079	112093209	40	131	6674	2799	6634	2668	0.3053435114503817	2.4865067466266866
chr11	AP002884.2	112170622	112170674	0	53	1736	1027	1736	974	0.0	1.782340862422998
chr11	SDHD	112091078	112091132	306	55	6674	2799	6368	2744	5.5636363636363635	2.3206997084548107
chr11	BCO2	112179277	112179482	0	206	51	6492	51	6286	0.0	0.008113267578746421
chr11	BCO2	112179277	112179569	0	293	51	6492	51	6199	0.0	0.008227133408614293
chr11	PTS	112230625	112230682	0	58	0	3138	0	3080	0.0	0.0
chr11	PTS	112230207	112230230	0	24	0	3138	0	3114	0.0	0.0
chr11	AP003100.2	112639681	112639751	0	71	0	5543	0	5472	0.0	0.0
chr11	NCAM1	113221295	113221325	0	31	2349	12494	2349	12463	0.0	0.18847789456792105
chr11	NCAM1	113231195	113231273	0	79	2349	12494	2349	12415	0.0	0.1892066049134112
chr11	NCAM1	113246367	113246370	0	4	2349	12494	2349	12490	0.0	0.18807045636509206
chr11	NCAM1	113242804	113242846	0	43	2349	12494	2349	12451	0.0	0.1886595454180387
chr11	NCAM1	113272932	113273048	0	117	2349	12494	2349	12377	0.0	0.1897875090894401
chr11	NCAM1	113236300	113236315	0	16	2349	12494	2349	12478	0.0	0.18825132232729605
chr11	NCAM1	113243551	113243790	0	240	2349	12494	2349	12254	0.0	0.19169250856863065
chr11	NCAM1	113272932	113273748	0	817	2349	12494	2349	11677	0.0	0.20116468270960006
chr11	TTC12	113315950	113316315	0	366	0	4931	0	4565	0.0	0.0
chr11	TTC12	113315950	113316053	0	104	0	4931	0	4827	0.0	0.0
chr11	TTC12	113329919	113329979	0	61	0	4931	0	4870	0.0	0.0
chr11	TTC12	113316242	113316315	0	74	0	4931	0	4857	0.0	0.0
chr11	TTC12	113334965	113335037	0	73	0	4931	0	4858	0.0	0.0
chr11	TTC12	113329641	113329808	0	168	0	4931	0	4763	0.0	0.0
chr11	TTC12	113364834	113365060	0	227	0	4931	0	4704	0.0	0.0
chr11	ANKK1	113394727	113394782	0	56	0	2617	0	2561	0.0	0.0
chr11	HTR3B	113942981	113943192	0	212	84	4836	84	4624	0.0	0.018166089965397925
chr11	HTR3A	113986014	113986175	0	162	0	2686	0	2524	0.0	0.0
chr11	ZBTB16	114061370	114061561	0	192	11424	11948	11424	11756	0.0	0.9717591017352841
chr11	ZBTB16	114121817	114121914	0	98	11424	11948	11424	11850	0.0	0.9640506329113924
chr11	RBM7	114401697	114401860	0	164	8262	6246	8262	6082	0.0	1.35843472541927
chr11	RBM7	114402827	114402915	0	89	8262	6246	8262	6157	0.0	1.3418872827675816
chr11	REXO2	114440655	114440739	0	85	0	3443	0	3358	0.0	0.0
chr11	REXO2	114444540	114444652	0	113	0	3443	0	3330	0.0	0.0
chr11	REXO2	114444585	114444652	0	68	0	3443	0	3375	0.0	0.0
chr11	REXO2	114443855	114443933	0	79	0	3443	0	3364	0.0	0.0
chr11	LINC02703	115942252	115942387	0	136	0	1379	0	1243	0.0	0.0
chr11	LINC02702	116655034	116655190	75961	157	210120	1108	134159	951	483.828025477707	141.0715036803365
chr11	APOA1-AS	116853869	116854022	51	154	51	1008	0	854	0.33116883116883117	0.0
chr11	PAFAH1B2	117171621	117171746	1005	126	321556	6079	320551	5953	7.976190476190476	53.846967915336805
chr11	SIDT2	117182059	117182105	297	47	30453	6733	30156	6686	6.319148936170213	4.510320071791804
chr11	SIDT2	117189951	117190025	1004	75	30453	6733	29449	6658	13.386666666666667	4.423100030039051
chr11	SIDT2	117193852	117193963	17	112	30453	6733	30436	6621	0.15178571428571427	4.5968886875094395
chr11	SIDT2	117187891	117187954	0	64	30453	6733	30453	6669	0.0	4.566351776878093
chr11	SIDT2	117186989	117187001	0	13	30453	6733	30453	6720	0.0	4.531696428571428
chr11	TAGLN	117199632	117199829	999	198	50922	4328	49923	4130	5.045454545454546	12.087893462469733
chr11	RNF214	117282745	117282850	8476	106	68990	4317	60514	4211	79.9622641509434	14.370458323438614
chr11	CEP164	117338565	117338668	0	104	153	12616	153	12512	0.0	0.012228260869565218
chr11	CEP164	117382795	117382942	0	148	153	12616	153	12468	0.0	0.012271414821944177
chr11	CEP164	117335604	117335680	0	77	153	12616	153	12539	0.0	0.012201929978467183
chr11	CEP164	117354931	117356617	51	1687	153	12616	102	10929	0.03023117960877297	0.009332967334614329
chr11	IL10RA	117989441	117989620	0	180	51	8065	51	7885	0.0	0.006467977171845276
chr11	IL10RA	117986683	117986813	0	131	51	8065	51	7934	0.0	0.006428031257877489
chr11	IL10RA	117986606	117986813	0	208	51	8065	51	7857	0.0	0.006491027109583811
chr11	TMPRSS4	118115137	118115280	0	144	51	7122	51	6978	0.0	0.007308684436801376
chr11	TMPRSS4	118098984	118099098	0	115	51	7122	51	7007	0.0	0.007278435849864422
chr11	TMPRSS4	118103100	118103253	0	154	51	7122	51	6968	0.0	0.007319173363949483
chr11	TMPRSS4	118098984	118099034	0	51	51	7122	51	7071	0.0	0.007212558336868901
chr11	CD3E	118312152	118312170	19	19	4387	2293	4368	2274	1.0	1.920844327176781
chr11	CD3G	118350551	118350683	612	133	19016	3315	18404	3182	4.601503759398496	5.783783783783784
chr11	CD3G	118349263	118349322	0	60	19016	3315	19016	3255	0.0	5.842089093701997
chr11	ATP5MG	118405656	118405709	3724	54	64969	2122	61245	2068	68.96296296296296	29.615570599613154
chr11	KMT2A	118482421	118482495	0	75	497670	22794	497670	22719	0.0	21.90545358510498
chr11	KMT2A	118484861	118484975	0	115	497670	22794	497670	22679	0.0	21.944089245557564
chr11	KMT2A	118439023	118439122	2	100	497670	22794	497668	22694	0.02	21.929496783290737
chr11	KMT2A	118471661	118471985	158202	325	497670	22794	339468	22469	486.7753846153846	15.108282522586675
chr11	TTC36	118527921	118528056	15071	136	33358	1013	18287	877	110.81617647058823	20.851767388825543
chr11	TMEM25	118532149	118532461	0	313	0	4816	0	4503	0.0	0.0
chr11	TMEM25	118532916	118533207	0	292	0	4816	0	4524	0.0	0.0
chr11	TMEM25	118532096	118532461	0	366	0	4816	0	4450	0.0	0.0
chr11	TMEM25	118532409	118532461	0	53	0	4816	0	4763	0.0	0.0
chr11	TMEM25	118533419	118533551	0	133	0	4816	0	4683	0.0	0.0
chr11	TMEM25	118532245	118532461	0	217	0	4816	0	4599	0.0	0.0
chr11	TMEM25	118531774	118531871	0	98	0	4816	0	4718	0.0	0.0
chr11	ARCN1	118581245	118581509	0	265	1247	3861	1247	3596	0.0	0.3467741935483871
chr11	ARCN1	118573619	118573783	0	165	1247	3861	1247	3696	0.0	0.3373917748917749
chr11	PHLDB1	118632158	118632296	170	139	251388	19655	251218	19516	1.223021582733813	12.872412379585981
chr11	PHLDB1	118642253	118642394	306	142	251388	19655	251082	19513	2.1549295774647885	12.867421718854096
chr11	PHLDB1	118655859	118655892	0	34	251388	19655	251388	19621	0.0	12.812191019825697
chr11	PHLDB1	118613293	118613450	0	158	251388	19655	251388	19497	0.0	12.893675950146177
chr11	PHLDB1	118624791	118624845	91	55	251388	19655	251297	19600	1.6545454545454545	12.821275510204082
chr11	PHLDB1	118644646	118644691	0	46	251388	19655	251388	19609	0.0	12.82003161813453
chr11	PHLDB1	118634922	118635051	94	130	251388	19655	251294	19525	0.7230769230769231	12.870371318822023
chr11	FOXR1	118979441	118979668	306	228	70662	1235	70356	1007	1.3421052631578947	69.8669314796425
chr11	CENATAC	119013231	119013262	0	32	9498	4795	9498	4763	0.0	1.9941213520890195
chr11	CENATAC	119001612	119001825	5999	214	9498	4795	3499	4581	28.03271028037383	0.7638070290329623
chr11	TRAPPC4	119020149	119020253	0	105	2682	4642	2682	4537	0.0	0.5911395195062816
chr11	TRAPPC4	119019142	119019317	0	176	2682	4642	2682	4466	0.0	0.6005373936408419
chr11	VPS11	119069441	119069577	0	137	1173	4315	1173	4178	0.0	0.2807563427477262
chr11	VPS11	119081091	119081314	0	224	1173	4315	1173	4091	0.0	0.28672696162307504
chr11	HMBS	119088254	119088308	12	55	597	3568	585	3513	0.21818181818181817	0.16652433817250215
chr11	HMBS	119089081	119089131	0	51	597	3568	597	3517	0.0	0.16974694341768554
chr11	HMBS	119089682	119089760	0	79	597	3568	597	3489	0.0	0.1711092003439381
chr11	HMBS	119092124	119092163	0	40	597	3568	597	3528	0.0	0.16921768707482993
chr11	HMBS	119092403	119092523	0	121	597	3568	597	3447	0.0	0.1731940818102698
chr11	HMBS	119089099	119089131	0	33	597	3568	597	3535	0.0	0.16888260254596887
chr11	HMBS	119085810	119085893	0	84	597	3568	597	3484	0.0	0.17135476463834673
chr11	HINFP	119126934	119127125	0	192	8701	5658	8701	5466	0.0	1.5918404683497989
chr11	HINFP	119121782	119122013	1369	232	8701	5658	7332	5426	5.900862068965517	1.351271654994471
chr11	NLRX1	119172355	119172425	9896	71	644490	4706	634594	4635	139.38028169014083	136.91348435814456
chr11	PDZD3	119187269	119187459	0	191	62557	3455	62557	3264	0.0	19.165747549019606
chr11	CBL	119284968	119285100	0	133	118253	6239	118253	6106	0.0	19.366688503111693
chr11	USP2-AS1	119469808	119469975	0	168	102	9657	102	9489	0.0	0.010749288650015808
chr11	USP2-AS1	119395541	119395663	0	123	102	9657	102	9534	0.0	0.010698552548772814
chr11	USP2-AS1	119394980	119395154	0	175	102	9657	102	9482	0.0	0.010757224214300781
chr11	AP003393.1	119656950	119657098	0	149	153	6121	153	5972	0.0	0.025619557937039517
chr11	POU2F3	120309424	120309586	0	163	53282	5379	53282	5216	0.0	10.21510736196319
chr11	POU2F3	120301042	120301089	0	48	53282	5379	53282	5331	0.0	9.994747702119678
chr11	TLCD5	120327121	120327640	0	520	11308	4308	11308	3788	0.0	2.9852164730728616
chr11	TLCD5	120327440	120327640	0	201	11308	4308	11308	4107	0.0	2.7533479425371317
chr11	ARHGEF12	120409393	120409450	0	58	153	19664	153	19606	0.0	0.00780373355095379
chr11	GRIK4	120653684	120653792	0	109	7840	7503	7840	7394	0.0	1.060319177711658
chr11	TBCEL	121055051	121055308	0	258	51	6539	51	6281	0.0	0.008119726158255056
chr11	TBCEL	121036504	121036612	0	109	51	6539	51	6430	0.0	0.007931570762052876
chr11	TBCEL	121035732	121035944	0	213	51	6539	51	6326	0.0	0.008061966487511856
chr11	TBCEL	121053629	121053732	0	104	51	6539	51	6435	0.0	0.007925407925407926
chr11	TBCEL	121057507	121057614	0	108	51	6539	51	6431	0.0	0.007930337428082725
chr11	GRAMD1B	123432017	123432126	0	110	31401	14786	31401	14676	0.0	2.139615699100572
chr11	GRAMD1B	123618344	123618356	0	13	31401	14786	31401	14773	0.0	2.1255669126108443
chr11	GRAMD1B	123578409	123578430	0	22	31401	14786	31401	14764	0.0	2.12686263885126
chr11	OR10G4	124014918	124015240	0	323	0	3599	0	3276	0.0	0.0
chr11	VWA5A	124116565	124116680	0	116	102	6379	102	6263	0.0	0.016286124860290595
chr11	OR8G3P	124214571	124214660	0	90	0	1347	0	1257	0.0	0.0
chr11	TBRG1	124625670	124625903	0	234	6751	5659	6751	5425	0.0	1.2444239631336405
chr11	TBRG1	124626472	124626609	0	138	6751	5659	6751	5521	0.0	1.2227857272233291
chr11	TBRG1	124624930	124625001	255	72	6751	5659	6496	5587	3.5416666666666665	1.1626991229640236
chr11	ROBO3	124877266	124877309	0	44	10160	6444	10160	6400	0.0	1.5875
chr11	ROBO3	124877936	124878131	357	196	10160	6444	9803	6248	1.8214285714285714	1.5689820742637643
chr11	ROBO3	124878297	124878436	124	140	10160	6444	10036	6304	0.8857142857142857	1.592005076142132
chr11	ROBO3	124877160	124877184	0	25	10160	6444	10160	6419	0.0	1.5828010593550397
chr11	ROBO3	124878583	124878796	0	214	10160	6444	10160	6230	0.0	1.6308186195826646
chr11	ROBO3	124877284	124877309	0	26	10160	6444	10160	6418	0.0	1.5830476784044873
chr11	SLC37A2	125084233	125084319	0	87	0	6174	0	6087	0.0	0.0
chr11	SLC37A2	125086203	125086260	0	58	0	6174	0	6116	0.0	0.0
chr11	PKNOX2	125235044	125235115	0	72	200	5946	200	5874	0.0	0.03404834865509023
chr11	PKNOX2	125385550	125385722	0	173	200	5946	200	5773	0.0	0.034644032565390614
chr11	PKNOX2	125331818	125331925	0	108	200	5946	200	5838	0.0	0.0342583076396026
chr11	PKNOX2	125351283	125351392	0	110	200	5946	200	5836	0.0	0.03427004797806717
chr11	PKNOX2	125239615	125239728	0	114	200	5946	200	5832	0.0	0.03429355281207133
chr11	PKNOX2	125332615	125332688	0	74	200	5946	200	5872	0.0	0.0340599455040872
chr11	PKNOX2	125367845	125367985	0	141	200	5946	200	5805	0.0	0.034453057708871665
chr11	EI24	125570103	125570190	55	88	130	3327	75	3239	0.625	0.02315529484408768
chr11	EI24	125575802	125575931	0	130	130	3327	130	3197	0.0	0.04066312167657179
chr11	EI24	125581210	125581322	0	113	130	3327	130	3214	0.0	0.04044803982576229
chr11	EI24	125575304	125575408	0	105	130	3327	130	3222	0.0	0.040347610180012414
chr11	EI24	125575250	125575408	0	159	130	3327	130	3168	0.0	0.041035353535353536
chr11	EI24	125575262	125575408	0	147	130	3327	130	3180	0.0	0.040880503144654086
chr11	EI24	125575308	125575408	0	101	130	3327	130	3226	0.0	0.040297582145071294
chr11	EI24	125577735	125577906	0	172	130	3327	130	3155	0.0	0.04120443740095087
chr11	STT3A	125595880	125596003	0	124	425	7052	425	6928	0.0	0.06134526558891455
chr11	STT3A	125593637	125593725	0	89	425	7052	425	6963	0.0	0.06103690937814161
chr11	STT3A	125611427	125611519	0	93	425	7052	425	6959	0.0	0.06107199310245725
chr11	STT3A	125594049	125594097	0	49	425	7052	425	7003	0.0	0.06068827645294873
chr11	CHEK1	125627606	125627830	0	225	0	4401	0	4176	0.0	0.0
chr11	CHEK1	125653745	125653847	0	103	0	4401	0	4298	0.0	0.0
chr11	CHEK1	125626416	125626575	0	160	0	4401	0	4241	0.0	0.0
chr11	CHEK1	125656205	125656335	0	131	0	4401	0	4270	0.0	0.0
chr11	PATE1	125747375	125747411	42	37	2273	2073	2231	2036	1.135135135135135	1.0957760314341847
chr11	PATE4	125837867	125837984	0	118	153	2889	153	2771	0.0	0.05521472392638037
chr11	HYLS1	125899103	125899158	0	56	1316	2395	1316	2339	0.0	0.5626336041043181
chr11	DDX25	125905211	125905278	0	68	1530	10966	1530	10898	0.0	0.14039273261148835
chr11	DDX25	125922099	125922305	0	207	1530	10966	1530	10759	0.0	0.14220652476996004
chr11	VSIG10L2	125953399	125953690	0	292	73	5122	73	4830	0.0	0.015113871635610766
chr11	VSIG10L2	125954086	125954211	0	126	73	5122	73	4996	0.0	0.014611689351481185
chr11	FAM118B	126229224	126229293	164	70	7194	3544	7030	3474	2.342857142857143	2.0236039147956246
chr11	FAM118B	126234994	126235087	0	94	7194	3544	7194	3450	0.0	2.0852173913043477
chr11	FAM118B	126250505	126250733	969	229	7194	3544	6225	3315	4.2314410480349345	1.8778280542986425
chr11	FAM118B	126233585	126233721	96	137	7194	3544	7098	3407	0.7007299270072993	2.0833577927795717
chr11	FAM118B	126229224	126229336	164	113	7194	3544	7030	3431	1.4513274336283186	2.048965316234334
chr11	FOXRED1	126274930	126275021	0	92	124337	4405	124337	4313	0.0	28.8284256897751
chr11	FOXRED1	126271436	126271657	51	222	124337	4405	124286	4183	0.22972972972972974	29.71216830026297
chr11	FOXRED1	126274926	126275021	0	96	124337	4405	124337	4309	0.0	28.855186818287304
chr11	TIRAP	126289664	126289833	357	170	3754	3600	3397	3430	2.1	0.9903790087463556
chr11	TIRAP	126291424	126291569	0	146	3754	3600	3754	3454	0.0	1.0868558193398958
chr11	TIRAP	126290461	126290585	0	125	3754	3600	3754	3475	0.0	1.0802877697841726
chr11	TIRAP	126289664	126289817	357	154	3754	3600	3397	3446	2.3181818181818183	0.985780615206036
chr11	DCPS	126338285	126338399	0	115	1355	7888	1355	7773	0.0	0.1743213688408594
chr11	ST3GAL4	126358414	126358511	0	98	0	5834	0	5736	0.0	0.0
chr11	ST3GAL4	126407573	126407634	0	62	0	5834	0	5772	0.0	0.0
chr11	ST3GAL4	126408098	126408194	0	97	0	5834	0	5737	0.0	0.0
chr11	ST3GAL4	126408306	126408496	0	191	0	5834	0	5643	0.0	0.0
chr11	ST3GAL4	126358197	126358348	0	152	0	5834	0	5682	0.0	0.0
chr11	AP001993.1	127053337	127053688	0	352	0	9479	0	9127	0.0	0.0
chr11	AP001993.1	127075982	127076078	0	97	0	9479	0	9382	0.0	0.0
chr11	AP001993.1	127078927	127079031	0	105	0	9479	0	9374	0.0	0.0
chr11	AP001993.1	127023971	127024163	0	193	0	9479	0	9286	0.0	0.0
chr11	AP001993.1	127072988	127073268	0	281	0	9479	0	9198	0.0	0.0
chr11	AP001993.1	127072988	127073296	0	309	0	9479	0	9170	0.0	0.0
chr11	AP001993.1	127048692	127048812	0	121	0	9479	0	9358	0.0	0.0
chr11	AP001993.1	127080433	127080567	0	135	0	9479	0	9344	0.0	0.0
chr11	LINC02725	128100725	128100750	0	26	25	2534	25	2508	0.0	0.009968102073365232
chr11	LINC02725	128167171	128167271	0	101	25	2534	25	2433	0.0	0.010275380189066995
chr11	LINC02725	128168182	128168371	0	190	25	2534	25	2344	0.0	0.010665529010238909
chr11	LINC02098	128210536	128210716	0	181	0	991	0	810	0.0	0.0
chr11	LINC02098	128211386	128211719	0	334	0	991	0	657	0.0	0.0
chr11	LINC02098	128211637	128211719	0	83	0	991	0	908	0.0	0.0
chr11	FLI1	128764650	128764821	0	172	0	6548	0	6376	0.0	0.0
chr11	FLI1	128748236	128748290	0	55	0	6548	0	6493	0.0	0.0
chr11	KCNJ5	128909851	128909940	0	90	1959	6241	1959	6151	0.0	0.31848479921963907
chr11	APLP2	130109428	130109602	102	175	16012	7164	15910	6989	0.5828571428571429	2.276434396909429
chr11	APLP2	130123611	130123779	51	169	16012	7164	15961	6995	0.30177514792899407	2.281772694781987
chr11	APLP2	130137255	130137291	0	37	16012	7164	16012	7127	0.0	2.24666760207661
chr11	APLP2	130100269	130100425	2092	157	16012	7164	13920	7007	13.32484076433121	1.986584843727701
chr11	APLP2	130101925	130102000	1326	76	16012	7164	14686	7088	17.44736842105263	2.0719525959367946
chr11	APLP2	130110537	130110661	0	125	16012	7164	16012	7039	0.0	2.2747549367807927
chr11	NTM	132146281	132146514	0	234	255	6509	255	6275	0.0	0.04063745019920319
chr11	NTM	131660928	131661048	0	121	255	6509	255	6388	0.0	0.03991859737006888
chr11	NTM	132330152	132330185	0	34	255	6509	255	6475	0.0	0.039382239382239385
chr11	NTM	132317654	132317690	0	37	255	6509	255	6472	0.0	0.03940049443757725
chr11	LINC02731	134037511	134037641	0	131	55927	5070	55927	4939	0.0	11.323547276776676
chr11	JAM3	134070171	134070278	1365	108	5011	5317	3646	5209	12.63888888888889	0.6999424073718564
chr11	JAM3	134144240	134144393	0	154	5011	5317	5011	5163	0.0	0.9705597520821228
chr11	VPS26B	134234896	134235053	0	158	14839	6455	14839	6297	0.0	2.3565189772907735
chr11	VPS26B	134236341	134236746	204	406	14839	6455	14635	6049	0.5024630541871922	2.419408166639114
chr11	ACAD8	134257087	134257257	0	171	0	6406	0	6235	0.0	0.0
chr11	ACAD8	134258514	134258624	0	111	0	6406	0	6295	0.0	0.0
chr11	ACAD8	134256547	134256648	0	102	0	6406	0	6304	0.0	0.0
chr11	GLB1L3	134313395	134313474	0	80	80	8157	80	8077	0.0	0.009904667574594527
chr11	B3GAT1-DT	134467864	134467987	0	124	0	7092	0	6968	0.0	0.0
chr11	B3GAT1-DT	134469486	134469601	0	116	0	7092	0	6976	0.0	0.0
chr11	LINC02706	134714719	134714780	0	62	0	2836	0	2774	0.0	0.0
chr11	LINC01001	135174	135860	4697	687	43444	3834	38747	3147	6.836972343522562	12.312360978709883
chr11	BET1L	205610	205667	14497	58	125728	1695	111231	1637	249.94827586206895	67.9480757483201
chr11	SIRT3	224077	224239	9737	163	177198	5564	167461	5401	59.736196319018404	31.005554526939456
chr11	SIRT3	230451	230552	4635	102	177198	5564	172563	5462	45.44117647058823	31.593372391065543
chr11	SIRT3	233342	233534	11500	193	177198	5564	165698	5371	59.58549222797927	30.85049339043009
chr11	SIRT3	233342	233437	5253	96	177198	5564	171945	5468	54.71875	31.44568397951719
chr11	SIRT3	230451	230641	4641	191	177198	5564	172557	5373	24.298429319371728	32.11557788944724
chr11	SIRT3	233910	234004	1982	95	177198	5564	175216	5469	20.86315789473684	32.03803254708356
chr11	SIRT3	233342	233486	7718	145	177198	5564	169480	5419	53.227586206896554	31.27514301531648
chr11	IFITM3	320112	320248	3241	137	1476482	1156	1473241	1019	23.656934306569344	1445.7713444553483
chr11	SIGIRR	406842	406993	12086	152	126442	2873	114356	2721	79.51315789473684	42.02719588386623
chr11	SIGIRR	408072	408206	0	135	126442	2873	126442	2738	0.0	46.18042366691015
chr11	SIGIRR	408694	408893	0	200	126442	2873	126442	2673	0.0	47.303404414515526
chr11	SIGIRR	409867	410027	0	161	126442	2873	126442	2712	0.0	46.62315634218289
chr11	SIGIRR	409216	409308	0	93	126442	2873	126442	2780	0.0	45.48273381294964
chr11	RNH1	504823	504996	45868	174	944500	5394	898632	5220	263.60919540229884	172.15172413793104
chr11	RNH1	504823	504888	17660	66	944500	5394	926840	5328	267.57575757575756	173.95645645645646
chr11	RNH1	505377	505461	1272	85	944500	5394	943228	5309	14.964705882352941	177.66585044264457
chr11	HRAS	533276	533358	6538	83	356838	1889	350300	1806	78.7710843373494	193.96456256921374
chr11	LMNTD2	559346	559498	255	153	5672	2775	5417	2622	1.6666666666666667	2.0659801678108316
chr11	IRF7	613950	614037	573	88	64800	2356	64227	2268	6.511363636363637	28.31878306878307
chr11	IRF7	614173	614399	4422	227	64800	2356	60378	2129	19.480176211453745	28.359793330201974
chr11	CDHR5	618598	619162	0	565	2710	3877	2710	3312	0.0	0.8182367149758454
chr11	CDHR5	621811	621904	34	94	2710	3877	2676	3783	0.3617021276595745	0.7073750991276765
chr11	CDHR5	618598	619180	0	583	2710	3877	2710	3294	0.0	0.8227079538554949
chr11	CDHR5	621811	621835	0	25	2710	3877	2710	3852	0.0	0.7035306334371755
chr11	DEAF1	651161	651407	1125	247	256240	4162	255115	3915	4.554655870445344	65.16347381864624
chr11	DEAF1	678693	678822	19065	130	256240	4162	237175	4032	146.65384615384616	58.823164682539684
chr11	GATD1	770992	771104	25925	113	428922	5390	402997	5277	229.42477876106196	76.36858063293538
chr11	GATD1	773521	773629	29733	109	428922	5390	399189	5281	272.7798165137615	75.58966104904374
chr11	GATD1	770313	770398	24910	86	428922	5390	404012	5304	289.6511627906977	76.17119155354449
chr11	GATD1	775065	775142	22822	78	428922	5390	406100	5312	292.5897435897436	76.44954819277109
chr11	GATD1	770678	770903	21407	226	428922	5390	407515	5164	94.72123893805309	78.91460108443067
chr11	GATD1	773427	773629	29908	203	428922	5390	399014	5187	147.33004926108376	76.92577597840756
chr11	SLC25A22	796042	796367	1786	326	300554	4564	298768	4238	5.478527607361963	70.49740443605474
chr11	CHID1	884067	884169	62987	103	707943	4078	644956	3975	611.5242718446602	162.25308176100629
chr11	CHID1	893426	893519	43948	94	707943	4078	663995	3984	467.531914893617	166.66541164658634
chr11	CHID1	903703	903778	459	76	707943	4078	707484	4002	6.0394736842105265	176.7826086956522
chr11	CHID1	869213	869345	1746	133	707943	4078	706197	3945	13.12781954887218	179.0106463878327
chr11	CHID1	908541	908645	6076	105	707943	4078	701867	3973	57.86666666666667	176.65919959728166
chr11	CHID1	903655	903753	234	99	707943	4078	707709	3979	2.3636363636363638	177.86102035687358
chr11	CHID1	908214	908296	0	83	707943	4078	707943	3995	0.0	177.2072590738423
chr11	TOLLIP	1290226	1290409	0	184	74708	5727	74708	5543	0.0	13.477900054122317
chr11	TOLLIP	1295644	1295794	8681	151	74708	5727	66027	5576	57.49006622516556	11.841284074605452
chr11	TOLLIP	1283282	1283597	0	316	74708	5727	74708	5411	0.0	13.806690075771577
chr11	IFITM10	1747666	1748119	0	454	51	4795	51	4341	0.0	0.011748445058742226
chr11	CTSD	1753532	1753670	0	139	1773	3467	1773	3328	0.0	0.5327524038461539
chr11	H19	1995875	1995941	0	67	0	2821	0	2754	0.0	0.0
chr11	H19	1995875	1995998	0	124	0	2821	0	2697	0.0	0.0
chr11	IGF2	2140134	2140299	0	166	102	6266	102	6100	0.0	0.016721311475409836
chr11	TH	2166886	2167032	0	147	0	3044	0	2897	0.0	0.0
chr11	TH	2170689	2170770	0	82	0	3044	0	2962	0.0	0.0
chr11	TH	2166632	2166768	0	137	0	3044	0	2907	0.0	0.0
chr11	C11ORF21	2300519	2300613	0	95	0	4079	0	3984	0.0	0.0
chr11	C11ORF21	2300683	2300768	0	86	0	4079	0	3993	0.0	0.0
chr11	SLC22A18AS	2899395	2899790	0	396	0	2058	0	1662	0.0	0.0
chr11	NAP1L4	2979206	2979237	0	32	9882	5136	9882	5104	0.0	1.936128526645768
chr11	NAP1L4	2949226	2949264	0	39	9882	5136	9882	5097	0.0	1.938787522071807
chr11	NAP1L4	2989128	2989271	51	144	9882	5136	9831	4992	0.3541666666666667	1.9693509615384615
chr11	NAP1L4	2954300	2954410	362	111	9882	5136	9520	5025	3.2612612612612613	1.8945273631840795
chr11	NAP1L4	2988076	2988126	0	51	9882	5136	9882	5085	0.0	1.943362831858407
chr11	NAP1L4	2983745	2983813	221	69	9882	5136	9661	5067	3.2028985507246377	1.9066508782316953
chr11	NAP1L4	2981701	2981799	459	99	9882	5136	9423	5037	4.636363636363637	1.8707564026206076
chr11	NAP1L4	2990908	2990992	20	85	9882	5136	9862	5051	0.23529411764705882	1.9524846565036627
chr11	CARS1	3002540	3002600	35	61	105140	7131	105105	7070	0.5737704918032787	14.866336633663366
chr11	CARS1	3047752	3048001	24550	250	105140	7131	80590	6881	98.2	11.711960470861793
chr11	CARS1	3054876	3055039	0	164	105140	7131	105140	6967	0.0	15.091143964403617
chr11	CARS1	3040447	3040581	21536	135	105140	7131	83604	6996	159.52592592592592	11.950257289879932
chr11	OSBPL5	3120420	3120624	510	205	8309	7227	7799	7022	2.4878048780487805	1.1106522358302477
chr11	OSBPL5	3120543	3120624	510	82	8309	7227	7799	7145	6.219512195121951	1.0915325402379286
chr11	ZNF195	3360719	3360788	0	70	5428	7243	5428	7173	0.0	0.7567266136902272
chr11	ZNF195	3361742	3361889	0	148	5428	7243	5428	7095	0.0	0.765045806906272
chr11	ZNF195	3373576	3373675	237	100	5428	7243	5191	7143	2.37	0.7267254654906902
chr11	ZNF195	3373576	3373656	219	81	5428	7243	5209	7162	2.7037037037037037	0.7273108070371405
chr11	ZNF195	3377616	3377900	937	285	5428	7243	4491	6958	3.287719298245614	0.6454440931302098
chr11	ZNF195	3362545	3362602	0	58	5428	7243	5428	7185	0.0	0.7554627696590118
chr11	ZNF195	3361975	3362032	0	58	5428	7243	5428	7185	0.0	0.7554627696590118
chr11	ZNF195	3361975	3362073	0	99	5428	7243	5428	7144	0.0	0.7597984322508399
chr11	ZNF195	3377616	3377802	459	187	5428	7243	4969	7056	2.4545454545454546	0.7042233560090703
chr11	ZNF195	3369356	3369502	153	147	5428	7243	5275	7096	1.0408163265306123	0.7433765501691093
chr11	NUP98	3685972	3686194	0	223	217375	9424	217375	9201	0.0	23.625149440278232
chr11	NUP98	3700609	3700839	19519	231	217375	9424	197856	9193	84.4978354978355	21.52246274339171
chr11	NUP98	3744508	3744649	62068	142	217375	9424	155307	9282	437.09859154929575	16.732062055591467
chr11	NUP98	3696684	3696800	15195	117	217375	9424	202180	9307	129.87179487179486	21.72343397442785
chr11	NUP98	3686063	3686194	0	132	217375	9424	217375	9292	0.0	23.39377959535084
chr11	TRIM68	4603244	4603340	0	97	0	3796	0	3699	0.0	0.0
chr11	TRIM68	4605078	4605561	0	484	0	3796	0	3312	0.0	0.0
chr11	OR51E2	4685777	4685856	0	80	0	2911	0	2831	0.0	0.0
chr11	HBD	5233990	5234213	0	224	0	1158	0	934	0.0	0.0
chr11	AC104389.6	5253342	5253405	0	64	0	655	0	591	0.0	0.0
chr11	AC104389.5	5626600	5626854	2848	255	4472	5285	1624	5030	11.168627450980392	0.3228628230616302
chr11	TRIM5	5665980	5666081	0	102	16953	4811	16953	4709	0.0	3.6001274155871736
chr11	TRIM5	5667688	5667711	0	24	16953	4811	16953	4787	0.0	3.5414664716941715
chr11	TRIM5	5665168	5665395	1105	228	16953	4811	15848	4583	4.8464912280701755	3.4579969452323804
chr11	TRIM5	5683985	5684139	0	155	16953	4811	16953	4656	0.0	3.6411082474226806
chr11	OR56A4	6006248	6006403	0	156	0	3937	0	3781	0.0	0.0
chr11	CAVIN3	6319656	6319752	0	97	0	1559	0	1462	0.0	0.0
chr11	APBB1	6404744	6404784	0	41	1509	5258	1509	5217	0.0	0.28924669350201265
chr11	APBB1	6410626	6411361	510	736	1509	5258	999	4522	0.6929347826086957	0.22091994692613887
chr11	APBB1	6401976	6401982	0	7	1509	5258	1509	5251	0.0	0.2873738335555132
chr11	APBB1	6403646	6403822	51	177	1509	5258	1458	5081	0.288135593220339	0.28695138752214133
chr11	APBB1	6403937	6404058	0	122	1509	5258	1509	5136	0.0	0.29380841121495327
chr11	TRIM3	6465564	6465732	714	169	4384	6639	3670	6470	4.224852071005917	0.5672333848531684
chr11	TRIM3	6473083	6473248	449	166	4384	6639	3935	6473	2.7048192771084336	0.607909779082342
chr11	ARFIP2	6479139	6479357	3131	219	44516	5066	41385	4847	14.296803652968036	8.538271095523005
chr11	ARFIP2	6480322	6480463	160	142	44516	5066	44356	4924	1.1267605633802817	9.008123476848091
chr11	ARFIP2	6479139	6479258	0	120	44516	5066	44516	4946	0.0	9.000404367165386
chr11	ARFIP2	6480322	6480423	98	102	44516	5066	44418	4964	0.9607843137254902	8.948025785656728
chr11	ARFIP2	6478578	6478652	6528	75	44516	5066	37988	4991	87.04	7.611300340613104
chr11	TPP1	6616314	6616503	966	190	38502	5275	37536	5085	5.08421052631579	7.381710914454278
chr11	TPP1	6618775	6618915	459	141	38502	5275	38043	5134	3.25531914893617	7.410011686793923
chr11	TPP1	6615764	6615848	386	85	38502	5275	38116	5190	4.541176470588235	7.34412331406551
chr11	MRPL17	6682746	6682815	0	70	0	902	0	832	0.0	0.0
chr11	AC107884.1	7440126	7441719	0	1594	0	5841	0	4247	0.0	0.0
chr11	AC107884.1	7457795	7457943	0	149	0	5841	0	5692	0.0	0.0
chr11	AC107884.1	7457795	7457959	0	165	0	5841	0	5676	0.0	0.0
chr11	AC107884.1	7451812	7451963	0	152	0	5841	0	5689	0.0	0.0
chr11	AC107884.1	7456817	7456849	0	33	0	5841	0	5808	0.0	0.0
chr11	CYB5R2	7665826	7665939	0	114	867	5718	867	5604	0.0	0.15471092077087795
chr11	CYB5R2	7666450	7666550	0	101	867	5718	867	5617	0.0	0.1543528573971871
chr11	RIC3	8126658	8126804	8843	147	11739	2602	2896	2455	60.156462585034014	1.179633401221996
chr11	RIC3	8153374	8153423	0	50	11739	2602	11739	2552	0.0	4.599921630094044
chr11	STK33	8413494	8413692	617	199	1086	7588	469	7389	3.100502512562814	0.06347272973338747
chr11	STK33	8440677	8440753	0	77	1086	7588	1086	7511	0.0	0.14458793769138598
chr11	STK33	8464708	8464822	0	115	1086	7588	1086	7473	0.0	0.1453231633881975
chr11	STK33	8533347	8533496	315	150	1086	7588	771	7438	2.1	0.1036568970153267
chr11	STK33	8476686	8476751	0	66	1086	7588	1086	7522	0.0	0.14437649561286892
chr11	TRIM66	8678133	8678169	20	37	7796	11781	7776	11744	0.5405405405405406	0.662125340599455
chr11	DENND2B	8702571	8702720	0	150	208720	10617	208720	10467	0.0	19.94076621763638
chr11	DENND2B	8713997	8714042	84	46	208720	10617	208636	10571	1.826086956521739	19.736637971809667
chr11	DENND2B	8750620	8750725	153	106	208720	10617	208567	10511	1.4433962264150944	19.842736181143565
chr11	DENND2B	8729949	8731209	1548	1261	208720	10617	207172	9356	1.2275971451229184	22.143223599828985
chr11	DENND2B	8811246	8811335	0	90	208720	10617	208720	10527	0.0	19.827111237769547
chr11	DENND2B	8699856	8700012	0	157	208720	10617	208720	10460	0.0	19.95411089866157
chr11	DENND2B	8711903	8712036	1216	134	208720	10617	207504	10483	9.074626865671641	19.794333683105982
chr11	DENND2B	8831555	8831688	0	134	208720	10617	208720	10483	0.0	19.910331012114852
chr11	DENND2B	8839309	8839350	100	42	208720	10617	208620	10575	2.380952380952381	19.727659574468085
chr11	DENND2B	8870953	8871088	0	136	208720	10617	208720	10481	0.0	19.914130331075278
chr11	DENND2B	8857342	8857436	0	95	208720	10617	208720	10522	0.0	19.836532978521195
chr11	C11ORF16	8921293	8921515	0	223	5916	2139	5916	1916	0.0	3.0876826722338206
chr11	C11ORF16	8927502	8927682	0	181	5916	2139	5916	1958	0.0	3.0214504596527068
chr11	TMEM9B	8962091	8962183	0	93	318	2833	318	2740	0.0	0.11605839416058394
chr11	NRIP3	8985710	8985850	26967	141	56787	2146	29820	2005	191.25531914893617	14.87281795511222
chr11	SCUBE2	9027363	9027561	0	199	1483	7780	1483	7581	0.0	0.19562063052367762
chr11	SCUBE2	9033625	9033796	0	172	1483	7780	1483	7608	0.0	0.19492639327024186
chr11	SCUBE2	9052745	9052832	0	88	1483	7780	1483	7692	0.0	0.19279771190847633
chr11	SCUBE2	9053636	9053759	0	124	1483	7780	1483	7656	0.0	0.1937042842215256
chr11	DENND5A	9143402	9143485	0	84	92880	7876	92880	7792	0.0	11.919917864476385
chr11	DENND5A	9147029	9147151	0	123	92880	7876	92880	7753	0.0	11.979878756610344
chr11	DENND5A	9152357	9152442	0	86	92880	7876	92880	7790	0.0	11.922978177150192
chr11	DENND5A	9207560	9207632	0	73	92880	7876	92880	7803	0.0	11.90311418685121
chr11	DENND5A	9142721	9142845	0	125	92880	7876	92880	7751	0.0	11.982969939362663
chr11	DENND5A	9140188	9140248	0	61	92880	7876	92880	7815	0.0	11.884836852207293
chr11	DENND5A	9176771	9176902	0	132	92880	7876	92880	7744	0.0	11.993801652892563
chr11	DENND5A	9207172	9207208	0	37	92880	7876	92880	7839	0.0	11.848450057405282
chr11	TMEM41B	9286454	9286593	3269	140	12544	4285	9275	4145	23.35	2.237635705669481
chr11	SBF2	9992414	9992543	0	130	19548	15076	19548	14946	0.0	1.3079084704937776
chr11	SBF2	9998265	9998379	0	115	19548	15076	19548	14961	0.0	1.3065971525967515
chr11	SBF2	9828595	9828632	0	38	19548	15076	19548	15038	0.0	1.299906902513632
chr11	SBF2	9819228	9819303	0	76	19548	15076	19548	15000	0.0	1.3032
chr11	SBF2	9828125	9828221	0	97	19548	15076	19548	14979	0.0	1.3050270378529942
chr11	RNF141	10531826	10532015	0	190	3826	7833	3826	7643	0.0	0.5005887740416067
chr11	IRAG1	10594145	10594195	0	51	0	7711	0	7660	0.0	0.0
chr11	IRAG1	10625965	10626583	0	619	0	7711	0	7092	0.0	0.0
chr11	IRAG1	10627972	10628025	0	54	0	7711	0	7657	0.0	0.0
chr11	IRAG1	10633967	10634071	0	105	0	7711	0	7606	0.0	0.0
chr11	IRAG1	10652024	10652182	0	159	0	7711	0	7552	0.0	0.0
chr11	IRAG1	10690264	10690369	0	106	0	7711	0	7605	0.0	0.0
chr11	IRAG1	10633967	10634074	0	108	0	7711	0	7603	0.0	0.0
chr11	IRAG1	10658383	10658579	0	197	0	7711	0	7514	0.0	0.0
chr11	IRAG1	10687508	10687777	0	270	0	7711	0	7441	0.0	0.0
chr11	EIF4G2	10801660	10801774	0	115	31748	7294	31748	7179	0.0	4.422342944699819
chr11	EIF4G2	10804912	10805015	0	104	31748	7294	31748	7190	0.0	4.41557719054242
chr11	EIF4G2	10806819	10806885	0	67	31748	7294	31748	7227	0.0	4.392970803929708
chr11	EIF4G2	10807254	10807381	0	128	31748	7294	31748	7166	0.0	4.430365615406084
chr11	EIF4G2	10808276	10808508	0	233	31748	7294	31748	7061	0.0	4.496246990511259
chr11	EIF4G2	10807254	10807319	0	66	31748	7294	31748	7228	0.0	4.3923630326508025
chr11	DKK3	11998695	11998779	0	85	38821	4948	38821	4863	0.0	7.982932346288299
chr11	DKK3	12008369	12008608	0	240	38821	4948	38821	4708	0.0	8.245751911639761
chr11	LINC00958	12988401	12988466	0	66	131401	5127	131401	5061	0.0	25.963445959296582
chr11	LINC00958	12984225	12984338	0	114	131401	5127	131401	5013	0.0	26.212048673449033
chr11	LINC00958	12986039	12986144	0	106	131401	5127	131401	5021	0.0	26.17028480382394
chr11	LINC00958	12984225	12984325	0	101	131401	5127	131401	5026	0.0	26.14424990051731
chr11	LINC00958	12984229	12984338	0	110	131401	5127	131401	5017	0.0	26.191150089695036
chr11	BTBD10	13445023	13445181	527	159	14985	3285	14458	3126	3.3144654088050314	4.625079974408189
chr11	BTBD10	13462621	13462797	0	177	14985	3285	14985	3108	0.0	4.821428571428571
chr11	RRAS2	14356685	14356769	0	85	3052	3469	3052	3384	0.0	0.9018912529550828
chr11	RRAS2	14308206	14308317	0	112	3052	3469	3052	3357	0.0	0.9091450700029788
chr11	PSMA1	14507655	14507766	0	112	15416	2912	15416	2800	0.0	5.505714285714285
chr11	PSMA1	14513569	14513699	0	131	15416	2912	15416	2781	0.0	5.543329737504495
chr11	PSMA1	14519904	14520211	4977	308	15416	2912	10439	2604	16.15909090909091	4.0088325652841785
chr11	CYP2R1	14880135	14880768	342	634	1209	4037	867	3403	0.5394321766561514	0.25477519835439316
chr11	CYP2R1	14890431	14890469	0	39	1209	4037	1209	3998	0.0	0.3024012006003001
chr11	CALCA	14968825	14968997	0	173	0	2106	0	1933	0.0	0.0
chr11	AC073172.1	15589080	15589250	0	171	0	900	0	729	0.0	0.0
chr11	AC087379.1	15725679	15725791	0	113	0	1813	0	1700	0.0	0.0
chr11	AC087379.1	15703750	15703809	0	60	0	1813	0	1753	0.0	0.0
chr11	AC087379.1	15710961	15711020	0	60	0	1813	0	1753	0.0	0.0
chr11	SOX6	16095995	16096118	0	124	0	19677	0	19553	0.0	0.0
chr11	PLEKHA7	16780941	16781052	0	112	88190	10535	88190	10423	0.0	8.461095653842463
chr11	PLEKHA7	16815174	16815294	0	121	88190	10535	88190	10414	0.0	8.468407912425581
chr11	PLEKHA7	16807143	16807224	0	82	88190	10535	88190	10453	0.0	8.43681239835454
chr11	RPS13	17076442	17076547	0	106	0	1798	0	1692	0.0	0.0
chr11	PIK3C2A	17094260	17094385	0	126	888007	9241	888007	9115	0.0	97.42260010970926
chr11	PIK3C2A	17194388	17194414	0	27	888007	9241	888007	9214	0.0	96.37584111135229
chr11	ABCC8	17393696	17393759	2269	64	51038	9821	48769	9757	35.453125	4.9983601516859695
chr11	ABCC8	17395171	17395275	1002	105	51038	9821	50036	9716	9.542857142857143	5.14985590778098
chr11	ABCC8	17397683	17397797	4024	115	51038	9821	47014	9706	34.99130434782609	4.843807953842984
chr11	ABCC8	17407353	17407453	0	101	51038	9821	51038	9720	0.0	5.25082304526749
chr11	ABCC8	17413393	17413478	0	86	51038	9821	51038	9735	0.0	5.242732408834104
chr11	ABCC8	17430813	17430959	0	147	51038	9821	51038	9674	0.0	5.275790779408724
chr11	ABCC8	17442719	17442882	0	164	51038	9821	51038	9657	0.0	5.285078181629906
chr11	ABCC8	17470100	17470222	0	123	51038	9821	51038	9698	0.0	5.262734584450402
chr11	ABCC8	17474885	17475027	0	143	51038	9821	51038	9678	0.0	5.2736102500516635
chr11	ABCC8	17395171	17395470	2661	300	51038	9821	48377	9521	8.87	5.0810839197563284
chr11	ABCC8	17430813	17431032	0	220	51038	9821	51038	9601	0.0	5.315904593271534
chr11	ABCC8	17428564	17428702	0	139	51038	9821	51038	9682	0.0	5.271431522412724
chr11	ABCC8	17428564	17428670	0	107	51038	9821	51038	9714	0.0	5.254066296067531
chr11	ABCC8	17432203	17432244	0	42	51038	9821	51038	9779	0.0	5.219143061662747
chr11	ABCC8	17465397	17465577	0	181	51038	9821	51038	9640	0.0	5.2943983402489625
chr11	ABCC8	17408199	17408302	0	104	51038	9821	51038	9717	0.0	5.25244417001132
chr11	ABCC8	17443177	17443312	0	136	51038	9821	51038	9685	0.0	5.269798657718121
chr11	ABCC8	17412873	17412977	0	105	51038	9821	51038	9716	0.0	5.252984767393989
chr11	ABCC8	17432203	17432346	0	144	51038	9821	51038	9677	0.0	5.27415521339258
chr11	ABCC8	17399006	17399101	3496	96	51038	9821	47542	9725	36.416666666666664	4.888637532133676
chr11	ABCC8	17443163	17443312	0	150	51038	9821	51038	9671	0.0	5.277427360148899
chr11	ABCC8	17444281	17444401	0	121	51038	9821	51038	9700	0.0	5.261649484536083
chr11	USH1C	17523210	17523267	0	58	306	4935	306	4877	0.0	0.06274348985031782
chr11	USH1C	17517400	17517474	0	75	306	4935	306	4860	0.0	0.06296296296296296
chr11	USH1C	17495568	17495677	0	110	306	4935	306	4825	0.0	0.06341968911917098
chr11	LINC02729	17696542	17696626	0	85	0	762	0	677	0.0	0.0
chr11	SERGEF	17988596	17988755	0	160	9464	3044	9464	2884	0.0	3.2815533980582523
chr11	SERGEF	17999493	17999572	0	80	9464	3044	9464	2964	0.0	3.192982456140351
chr11	SERGEF	18004440	18004535	0	96	9464	3044	9464	2948	0.0	3.2103120759837176
chr11	SERGEF	17918694	17918779	0	86	9464	3044	9464	2958	0.0	3.1994590939824206
chr11	SERGEF	17959469	17959636	0	168	9464	3044	9464	2876	0.0	3.290681502086231
chr11	SERGEF	17846584	17846761	0	178	9464	3044	9464	2866	0.0	3.302163293789253
chr11	SERGEF	17926737	17926846	0	110	9464	3044	9464	2934	0.0	3.225630538513974
chr11	SERGEF	17992930	17992993	0	64	9464	3044	9464	2980	0.0	3.175838926174497
chr11	SERGEF	18010070	18010139	0	70	9464	3044	9464	2974	0.0	3.1822461331540013
chr11	SERGEF	18010074	18010139	0	66	9464	3044	9464	2978	0.0	3.177971793149765
chr11	SERGEF	18001945	18002058	0	114	9464	3044	9464	2930	0.0	3.2300341296928328
chr11	TPH1	18029164	18029361	0	198	3016	5637	3016	5439	0.0	0.5545136973708402
chr11	SAAL1	18083534	18083731	0	198	1518	2752	1518	2554	0.0	0.5943617854346124
chr11	SAAL1	18083534	18083728	0	195	1518	2752	1518	2557	0.0	0.5936644505279625
chr11	SAAL1	18083534	18083709	0	176	1518	2752	1518	2576	0.0	0.5892857142857143
chr11	SAAL1	18086865	18087054	0	190	1518	2752	1518	2562	0.0	0.5925058548009368
chr11	SAA2	18248455	18248516	0	62	0	2249	0	2187	0.0	0.0
chr11	HPS5	18285345	18285459	0	115	26850	6458	26850	6343	0.0	4.233012769982658
chr11	HPS5	18291441	18292019	0	579	26850	6458	26850	5879	0.0	4.567103248851845
chr11	HPS5	18292898	18292976	50	79	26850	6458	26800	6379	0.6329113924050633	4.201285467941684
chr11	HPS5	18317750	18317907	714	158	26850	6458	26136	6300	4.518987341772152	4.148571428571429
chr11	HPS5	18280508	18280642	0	135	26850	6458	26850	6323	0.0	4.246402024355527
chr11	TSG101	18514677	18514841	0	165	1016	3400	1016	3235	0.0	0.314064914992272
chr11	TSG101	18519518	18519603	0	86	1016	3400	1016	3314	0.0	0.30657815328907667
chr11	TSG101	18480484	18480635	0	152	1016	3400	1016	3248	0.0	0.312807881773399
chr11	TSG101	18516098	18516164	6	67	1016	3400	1010	3333	0.08955223880597014	0.30303030303030304
chr11	UEVLD	18534329	18534453	51	125	49524	5531	49473	5406	0.408	9.15149833518313
chr11	UEVLD	18546879	18547050	0	172	49524	5531	49524	5359	0.0	9.24127635752939
chr11	UEVLD	18570213	18570377	0	165	49524	5531	49524	5366	0.0	9.229221021244875
chr11	UEVLD	18575346	18575412	1	67	49524	5531	49523	5464	0.014925373134328358	9.063506588579795
chr11	UEVLD	18578723	18578808	0	86	49524	5531	49524	5445	0.0	9.095316804407714
chr11	UEVLD	18536405	18536469	0	65	49524	5531	49524	5466	0.0	9.060373216245884
chr11	UEVLD	18566346	18566482	0	137	49524	5531	49524	5394	0.0	9.18131256952169
chr11	IGSF22	18708206	18708295	0	90	628	4857	628	4767	0.0	0.13173903922802602
chr11	IGSF22	18712081	18712384	0	304	628	4857	628	4553	0.0	0.13793103448275862
chr11	PTPN5	18771938	18772071	0	134	512	5512	512	5378	0.0	0.0952026775753068
chr11	PTPN5	18771938	18772026	0	89	512	5512	512	5423	0.0	0.09441268670477596
chr11	CSRP3	19186215	19186348	97	134	4465	1641	4368	1507	0.7238805970149254	2.898473788984738
chr11	CSRP3	19188135	19188304	127	170	4465	1641	4338	1471	0.7470588235294118	2.9490142760027194
chr11	CSRP3	19201478	19201647	0	170	4465	1641	4465	1471	0.0	3.035350101971448
chr11	LINC01495	22447113	22447476	0	364	0	858	0	494	0.0	0.0
chr11	LINC01495	22467846	22467945	0	100	0	858	0	758	0.0	0.0
chr11	MUC15	26563115	26563265	0	151	0	3593	0	3442	0.0	0.0
chr11	MUC15	26567051	26567139	0	89	0	3593	0	3504	0.0	0.0
chr11	SLC5A12	26716272	26716354	0	83	0	7588	0	7505	0.0	0.0
chr11	LGR4	27412788	27412860	0	73	54267	6373	54267	6300	0.0	8.613809523809524
chr11	LIN7C	27501494	27501566	0	73	1020	4847	1020	4774	0.0	0.213657310431504
chr11	BDNF	27658819	27658926	0	108	77118	7518	77118	7410	0.0	10.407287449392712
chr11	BDNF	27674059	27674342	0	284	77118	7518	77118	7234	0.0	10.660492120541885
chr11	BDNF	27660155	27660272	0	118	77118	7518	77118	7400	0.0	10.421351351351351
chr11	LINC02755	29520123	29520216	0	94	0	1133	0	1039	0.0	0.0
chr11	MPPED2	30504735	30504833	0	99	0	8211	0	8112	0.0	0.0
chr11	DCDC1	30882042	30883518	0	1477	0	12605	0	11128	0.0	0.0
chr11	DCDC1	31290646	31290852	0	207	0	12605	0	12398	0.0	0.0
chr11	DCDC1	31215169	31215263	0	95	0	12605	0	12510	0.0	0.0
chr11	IMMP1L	31437075	31437154	0	80	12906	3848	12906	3768	0.0	3.4251592356687897
chr11	IMMP1L	31463171	31463305	0	135	12906	3848	12906	3713	0.0	3.475895502289254
chr11	IMMP1L	31477500	31477759	0	260	12906	3848	12906	3588	0.0	3.596989966555184
chr11	IMMP1L	31460625	31460714	153	90	12906	3848	12753	3758	1.7	3.393560404470463
chr11	IMMP1L	31473723	31473786	0	64	12906	3848	12906	3784	0.0	3.410676532769556
chr11	IMMP1L	31447982	31449091	4465	1110	12906	3848	8441	2738	4.0225225225225225	3.0829072315558803
chr11	IMMP1L	31469739	31469797	0	59	12906	3848	12906	3789	0.0	3.4061757719714962
chr11	IMMP1L	31469757	31469797	0	41	12906	3848	12906	3807	0.0	3.3900709219858154
chr11	AC131571.1	31635542	31635640	0	99	99	6618	99	6519	0.0	0.015186378278877128
chr11	AC131571.1	31727786	31727895	0	110	99	6618	99	6508	0.0	0.015212046711739398
chr11	AC131571.1	31655933	31656969	0	1037	99	6618	99	5581	0.0	0.017738756495251747
chr11	PAX6	31790709	31790860	0	152	62146	17695	62146	17543	0.0	3.542495582283532
chr11	PAX6	31801870	31801912	0	43	62146	17695	62146	17652	0.0	3.520620892816678
chr11	PAX6	31802703	31802834	0	132	62146	17695	62146	17563	0.0	3.5384615384615383
chr11	PAX6	31810827	31811015	10028	189	62146	17695	52118	17506	53.05820105820106	2.9771506911915915
chr11	PAX6	31803583	31803726	653	144	62146	17695	61493	17551	4.534722222222222	3.5036750042732607
chr11	PAX6	31801229	31801326	0	98	62146	17695	62146	17597	0.0	3.5316247087571746
chr11	PAX6	31803397	31803471	418	75	62146	17695	61728	17620	5.573333333333333	3.5032917139614077
chr11	PAX6	31812148	31812277	45	130	62146	17695	62101	17565	0.34615384615384615	3.5354967264446344
chr11	WT1	32392665	32392755	0	91	0	6874	0	6783	0.0	0.0
chr11	WT1	32396256	32396407	0	152	0	6874	0	6722	0.0	0.0
chr11	WT1	32416489	32416540	0	52	0	6874	0	6822	0.0	0.0
chr11	CSTF3	33156707	33156803	154	97	23526	4539	23372	4442	1.5876288659793814	5.261593876632148
chr11	CSTF3	33144869	33144973	0	105	23526	4539	23526	4434	0.0	5.305818673883627
chr11	AL049629.2	33702667	33702737	120	71	120	958	0	887	1.6901408450704225	0.0
chr11	CD59	33731423	33731468	104316	46	113802	10567	9486	10521	2267.7391304347825	0.9016253207869974
chr11	CD59	33733494	33733610	40	117	113802	10567	113762	10450	0.3418803418803419	10.886315789473684
chr11	CD59	33722916	33723029	0	114	113802	10567	113802	10453	0.0	10.887018080933704
chr11	CD59	33716825	33716868	0	44	113802	10567	113802	10523	0.0	10.814596597928347
chr11	CD59	33711383	33711505	0	123	113802	10567	113802	10444	0.0	10.896399846801991
chr11	CD59	33713378	33713469	0	92	113802	10567	113802	10475	0.0	10.864152744630072
chr11	CD59	33733494	33733614	40	121	113802	10567	113762	10446	0.3305785123966942	10.89048439594103
chr11	FBXO3	33755770	33755975	0	206	6402	5200	6402	4994	0.0	1.2819383259911894
chr11	FBXO3	33763205	33763286	2658	82	6402	5200	3744	5118	32.41463414634146	0.731535756154748
chr11	ELF5	34493478	34493712	7349	235	130479	4922	123130	4687	31.272340425531915	26.270535523789203
chr11	ELF5	34490008	34490059	494	52	130479	4922	129985	4870	9.5	26.690965092402465
chr11	APIP	34895009	34895110	0	102	0	5227	0	5125	0.0	0.0
chr11	SLC1A2	35280866	35281001	0	136	7793529	13109	7793529	12973	0.0	600.7499421876205
chr11	SLC1A2	35292286	35292520	0	235	7793529	13109	7793529	12874	0.0	605.3696597794003
chr11	SLC1A2	35301518	35301645	0	128	7793529	13109	7793529	12981	0.0	600.3797088051768
chr11	SLC1A2	35260843	35260965	0	123	7793529	13109	7793529	12986	0.0	600.1485445864778
chr11	SLC1A2	35261669	35261740	0	72	7793529	13109	7793529	13037	0.0	597.800797729539
chr11	SLC1A2	35261669	35261862	0	194	7793529	13109	7793529	12915	0.0	603.4478513356562
chr11	SLC1A2	35380380	35380541	0	162	7793529	13109	7793529	12947	0.0	601.9563605468448
chr11	SLC1A2	35322560	35322679	0	120	7793529	13109	7793529	12989	0.0	600.0099314804835
chr11	SLC1A2	35322764	35323309	0	546	7793529	13109	7793529	12563	0.0	620.3557271352385
chr11	SLC1A2	35370940	35371096	0	157	7793529	13109	7793529	12952	0.0	601.723980852378
chr11	SLC1A2	35418949	35419007	0	59	7793529	13109	7793529	13050	0.0	597.2052873563218
chr11	SLC1A2	35391539	35391608	0	70	7793529	13109	7793529	13039	0.0	597.7091034588542
chr11	PAMR1	35451887	35451938	0	52	0	3879	0	3827	0.0	0.0
chr11	PAMR1	35513370	35513477	0	108	0	3879	0	3771	0.0	0.0
chr11	COMMD9	36277088	36277123	0	36	1122	4778	1122	4742	0.0	0.2366090257275411
chr11	COMMD9	36280711	36280837	0	127	1122	4778	1122	4651	0.0	0.24123844334551708
chr11	TRAF6	36501718	36501811	51	94	111125	8138	111074	8044	0.5425531914893617	13.808304326205867
chr11	RAG2	36594806	36595195	0	390	0	3438	0	3048	0.0	0.0
chr11	RAG2	36594806	36595001	0	196	0	3438	0	3242	0.0	0.0
chr11	LINC02759	38634970	38635095	0	126	0	1928	0	1802	0.0	0.0
chr11	LRRC4C	40241518	40241598	0	81	18	5365	18	5284	0.0	0.0034065102195306586
chr11	LRRC4C	40933634	40933723	0	90	18	5365	18	5275	0.0	0.0034123222748815166
chr11	LRRC4C	40140800	40140853	0	54	18	5365	18	5311	0.0	0.0033891922425155338
chr11	LINC02741	41620347	41620399	0	53	0	2732	0	2679	0.0	0.0
chr11	LINC02741	41591105	41591196	0	92	0	2732	0	2640	0.0	0.0
chr11	LINC02745	42025986	42026062	0	77	0	1565	0	1488	0.0	0.0
chr11	LINC02740	42250270	42250416	0	147	0	2061	0	1914	0.0	0.0
chr11	LINC02740	42253058	42253129	0	72	0	2061	0	1989	0.0	0.0
chr11	ALKBH3-AS1	43919585	43919662	896	78	6383	2165	5487	2087	11.487179487179487	2.6291327264015334
chr11	ALKBH3-AS1	43916668	43916921	459	254	6383	2165	5924	1911	1.8070866141732282	3.099947671376243
chr11	TP53I11	44937554	44937613	0	60	0	7153	0	7093	0.0	0.0
chr11	TP53I11	44936802	44936899	0	98	0	7153	0	7055	0.0	0.0
chr11	TP53I11	44941002	44941077	0	76	0	7153	0	7077	0.0	0.0
chr11	TP53I11	44939165	44939281	0	117	0	7153	0	7036	0.0	0.0
chr11	TP53I11	44939113	44939190	0	78	0	7153	0	7075	0.0	0.0
chr11	TP53I11	44936879	44936899	0	21	0	7153	0	7132	0.0	0.0
chr11	TP53I11	44936558	44936689	0	132	0	7153	0	7021	0.0	0.0
chr11	AC018716.2	45410991	45411145	0	155	51	3377	51	3222	0.0	0.015828677839851025
chr11	AC103855.2	45533422	45533532	0	111	51	4073	51	3962	0.0	0.01287228672387683
chr11	AC103855.2	45532648	45532880	0	233	51	4073	51	3840	0.0	0.01328125
chr11	AC103855.2	45541142	45541269	0	128	51	4073	51	3945	0.0	0.012927756653992395
chr11	PEX16	45915467	45915568	0	102	0	2915	0	2813	0.0	0.0
chr11	PEX16	45916973	45917141	0	169	0	2915	0	2746	0.0	0.0
chr11	PHF21A	45938156	45938312	854	157	76881	9390	76027	9233	5.439490445859873	8.234268385140258
chr11	PHF21A	45945839	45946003	0	165	76881	9390	76881	9225	0.0	8.333983739837398
chr11	PHF21A	46090454	46090566	0	113	76881	9390	76881	9277	0.0	8.287269591462758
chr11	PHF21A	45946075	45946098	0	24	76881	9390	76881	9366	0.0	8.208520179372197
chr11	PHF21A	46092182	46092223	0	42	76881	9390	76881	9348	0.0	8.224326059050064
chr11	PHF21A	45935120	45935246	370	127	76881	9390	76511	9263	2.9133858267716537	8.259851020187844
chr11	PHF21A	45935120	45935157	195	38	76881	9390	76686	9352	5.131578947368421	8.199957228400342
chr11	PHF21A	46049399	46049497	0	99	76881	9390	76881	9291	0.0	8.274782047142397
chr11	PHF21A	46090454	46090581	0	128	76881	9390	76881	9262	0.0	8.300690995465342
chr11	PHF21A	46083554	46083611	0	58	76881	9390	76881	9332	0.0	8.238426918131161
chr11	PHF21A	46117921	46118114	0	194	76881	9390	76881	9196	0.0	8.360265332753372
chr11	PHF21A	46118741	46118800	0	60	76881	9390	76881	9330	0.0	8.240192926045015
chr11	PHF21A	46117921	46118145	0	225	76881	9390	76881	9165	0.0	8.388543371522095
chr11	LINC02710	46216252	46216372	0	121	102	1999	102	1878	0.0	0.054313099041533544
chr11	LINC02710	46216252	46216368	0	117	102	1999	102	1882	0.0	0.05419766206163656
chr11	AMBRA1	46410275	46410368	0	94	140410	7626	140410	7532	0.0	18.64179500796601
chr11	AMBRA1	46508190	46508370	0	181	140410	7626	140410	7445	0.0	18.859637340496977
chr11	AMBRA1	46512726	46512813	682	88	140410	7626	139728	7538	7.75	18.536481825417884
chr11	AMBRA1	46547112	46547296	0	185	140410	7626	140410	7441	0.0	18.869775567800026
chr11	AMBRA1	46549019	46549051	163	33	140410	7626	140247	7593	4.9393939393939394	18.470564994073488
chr11	ARHGAP1	46682050	46682182	0	133	236130	6156	236130	6023	0.0	39.20471525817699
chr11	CKAP5	46754887	46755067	0	181	87120	8584	87120	8403	0.0	10.367725812209924
chr11	CKAP5	46754887	46754983	0	97	87120	8584	87120	8487	0.0	10.265111346765641
chr11	CKAP5	46760351	46760375	0	25	87120	8584	87120	8559	0.0	10.17875920084122
chr11	LRP4	46902782	46902929	0	148	30547	8786	30547	8638	0.0	3.536351007177587
chr11	ARFGAP2	47175850	47175923	288	74	45245	5269	44957	5195	3.891891891891892	8.653897978825794
chr11	ARFGAP2	47176515	47176634	1600	120	45245	5269	43645	5149	13.333333333333334	8.476403185084482
chr11	ARFGAP2	47173758	47173840	34	83	45245	5269	45211	5186	0.40963855421686746	8.71789433089086
chr11	ARFGAP2	47175014	47175098	183	85	45245	5269	45062	5184	2.152941176470588	8.692515432098766
chr11	ARFGAP2	47172280	47172333	72	54	45245	5269	45173	5215	1.3333333333333333	8.662128475551294
chr11	ARFGAP2	47175181	47175313	767	133	45245	5269	44478	5136	5.7669172932330826	8.660046728971963
chr11	ARFGAP2	47173758	47173882	51	125	45245	5269	45194	5144	0.408	8.785769828926906
chr11	ARFGAP2	47172709	47172751	0	43	45245	5269	45245	5226	0.0	8.657673172598546
chr11	ARFGAP2	47173758	47173915	81	158	45245	5269	45164	5111	0.5126582278481012	8.836626883193112
chr11	ARFGAP2	47175871	47175923	36	53	45245	5269	45209	5216	0.6792452830188679	8.66736963190184
chr11	PACSIN3	47178365	47178487	2483	123	145656	2765	143173	2642	20.1869918699187	54.19114307342922
chr11	PACSIN3	47182673	47182764	13766	92	145656	2765	131890	2673	149.6304347826087	49.34156378600823
chr11	PACSIN3	47182673	47182809	14204	137	145656	2765	131452	2628	103.67883211678833	50.01978691019787
chr11	PACSIN3	47184319	47184497	458	179	145656	2765	145198	2586	2.558659217877095	56.1477184841454
chr11	ACP2	47245473	47245572	212	100	30222	3486	30010	3386	2.12	8.862965150620202
chr11	ACP2	47248037	47248133	185	97	30222	3486	30037	3389	1.907216494845361	8.863086456181765
chr11	ACP2	47245304	47245422	162	119	30222	3486	30060	3367	1.361344537815126	8.927828927828928
chr11	ACP2	47245304	47245427	174	124	30222	3486	30048	3362	1.403225806451613	8.937537180249851
chr11	ACP2	47245304	47245394	162	91	30222	3486	30060	3395	1.7802197802197801	8.85419734904271
chr11	AC090559.1	47395489	47395577	0	89	153	2935	153	2846	0.0	0.05375966268446943
chr11	AC090559.1	47405509	47405547	0	39	153	2935	153	2896	0.0	0.05283149171270718
chr11	PSMC3	47424428	47424491	0	64	0	1859	0	1795	0.0	0.0
chr11	PSMC3	47425120	47425246	0	127	0	1859	0	1732	0.0	0.0
chr11	RAPSN	47442655	47442814	0	160	313532	1884	313532	1724	0.0	181.86310904872389
chr11	CELF1	47483452	47483532	0	81	37678	9012	37678	8931	0.0	4.218788489530848
chr11	CELF1	47471997	47472102	0	106	37678	9012	37678	8906	0.0	4.23063103525713
chr11	CELF1	47499452	47499604	4674	153	37678	9012	33004	8859	30.54901960784314	3.725476916130489
chr11	CELF1	47506857	47506897	0	41	37678	9012	37678	8971	0.0	4.199977705941366
chr11	CELF1	47564350	47564469	0	120	37678	9012	37678	8892	0.0	4.237291947818264
chr11	CELF1	47494330	47494443	0	114	37678	9012	37678	8898	0.0	4.2344347044279615
chr11	MTCH2	47635544	47635571	0	28	9654	2894	9654	2866	0.0	3.3684577808792744
chr11	AGBL2	47677270	47677401	0	132	213849	5082	213849	4950	0.0	43.20181818181818
chr11	AGBL2	47685892	47686049	204	158	213849	5082	213645	4924	1.2911392405063291	43.38850528025995
chr11	AGBL2	47705520	47705634	0	115	213849	5082	213849	4967	0.0	43.053956110328166
chr11	AGBL2	47705863	47705917	0	55	213849	5082	213849	5027	0.0	42.540083548836286
chr11	AGBL2	47710697	47710902	0	206	213849	5082	213849	4876	0.0	43.85746513535685
chr11	FNBP4	47722975	47723316	714	342	100478	6583	99764	6241	2.087719298245614	15.98525877263259
chr11	FNBP4	47754527	47754664	0	138	100478	6583	100478	6445	0.0	15.590069821567106
chr11	FNBP4	47765269	47765362	222	94	100478	6583	100256	6489	2.3617021276595747	15.450146401602712
chr11	NUP160	47840377	47840588	1016	212	33797	8120	32781	7908	4.7924528301886795	4.145295902883157
chr11	NUP160	47827074	47827194	226	121	33797	8120	33571	7999	1.8677685950413223	4.196899612451556
chr11	FOLH1	49148638	49148731	0	94	0	5358	0	5264	0.0	0.0
chr11	FOLH1	49185668	49185855	0	188	0	5358	0	5170	0.0	0.0
chr11	FOLH1	49200254	49200441	0	188	0	5358	0	5170	0.0	0.0
chr11	FOLH1	49206777	49206874	0	98	0	5358	0	5260	0.0	0.0
chr11	FOLH1	49206279	49206332	0	54	0	5358	0	5304	0.0	0.0
chr11	FOLH1	49207763	49207901	0	139	0	5358	0	5219	0.0	0.0
chr11	AP002512.3	56466106	56466248	0	143	0	4676	0	4533	0.0	0.0
chr11	SSRP1	57335067	57335240	25372	174	37797	5904	12425	5730	145.816091954023	2.168411867364747
chr11	SSRP1	57330732	57330741	0	10	37797	5904	37797	5894	0.0	6.412792670512386
chr11	SLC43A3	57409934	57410121	0	188	69264	4537	69264	4349	0.0	15.926419866636008
chr11	SLC43A3	57425540	57425670	0	131	69264	4537	69264	4406	0.0	15.720381298229686
chr11	SLC43A3	57426587	57426652	0	66	69264	4537	69264	4471	0.0	15.49183627823753
chr11	SLC43A3	57425540	57425709	0	170	69264	4537	69264	4367	0.0	15.860773986718572
chr11	SLC43A1	57497752	57497845	0	94	3948	3545	3948	3451	0.0	1.1440162271805274
chr11	SLC43A1	57496030	57496164	147	135	3948	3545	3801	3410	1.0888888888888888	1.1146627565982405
chr11	SLC43A1	57515099	57515201	0	103	3948	3545	3948	3442	0.0	1.147007553747821
chr11	YPEL4	57646750	57646794	0	45	0	2700	0	2655	0.0	0.0
chr11	YPEL4	57647472	57647686	0	215	0	2700	0	2485	0.0	0.0
chr11	AP003557.1	58503689	58503816	0	128	0	1007	0	879	0.0	0.0
chr11	LPXN	58553854	58554145	0	292	9	2445	9	2153	0.0	0.0041802136553646075
chr11	LPXN	58564154	58564201	9	48	9	2445	0	2397	0.1875	0.0
chr11	GLYATL2	58840693	58840831	0	139	694	1766	694	1627	0.0	0.4265519360786724
chr11	AP001636.3	59055294	59055446	0	153	0	6599	0	6446	0.0	0.0
chr11	LINC02739	59563813	59563906	186	94	7197	1663	7011	1569	1.9787234042553192	4.468451242829828
chr11	OSBP	59593603	59593724	0	122	246944	5011	246944	4889	0.0	50.51012476989159
chr11	TCN1	59863906	59864086	0	181	0	1509	0	1328	0.0	0.0
chr11	MS4A6A	60179830	60179965	0	136	102	3986	102	3850	0.0	0.026493506493506493
chr11	MS4A6A	60178259	60178316	0	58	102	3986	102	3928	0.0	0.025967413441955193
chr11	MS4A6A	60178793	60178828	0	36	102	3986	102	3950	0.0	0.025822784810126582
chr11	MS4A4E	60212973	60213132	0	160	100	2892	100	2732	0.0	0.036603221083455345
chr11	MS4A4E	60228593	60228627	0	35	100	2892	100	2857	0.0	0.03500175008750438
chr11	MS4A4E	60224964	60225093	0	130	100	2892	100	2762	0.0	0.036205648081100654
chr11	MS4A4E	60213214	60213332	0	119	100	2892	100	2773	0.0	0.03606202668589975
chr11	PRPF19	60898100	60898271	18243	172	98734	2747	80491	2575	106.06395348837209	31.25864077669903
chr11	PRPF19	60905364	60905452	1695	89	98734	2747	97039	2658	19.04494382022472	36.50827689992475
chr11	SLC15A3	60937515	60937566	0	52	204	4224	204	4172	0.0	0.0488974113135187
chr11	SLC15A3	60941121	60941290	0	170	204	4224	204	4054	0.0	0.05032067094227923
chr11	SLC15A3	60942034	60942145	0	112	204	4224	204	4112	0.0	0.04961089494163424
chr11	DDB1	61316284	61316393	0	110	51	11635	51	11525	0.0	0.004425162689804772
chr11	CYB561A3	61353783	61353992	0	210	102	8318	102	8108	0.0	0.012580167735569808
chr11	CYB561A3	61357202	61357371	0	170	102	8318	102	8148	0.0	0.012518409425625921
chr11	CYB561A3	61357732	61357828	0	97	102	8318	102	8221	0.0	0.012407249726310668
chr11	CYB561A3	61353783	61353823	0	41	102	8318	102	8277	0.0	0.012323305545487495
chr11	CYB561A3	61352984	61353139	0	156	102	8318	102	8162	0.0	0.012496937025238911
chr11	CYB561A3	61359425	61359571	0	147	102	8318	102	8171	0.0	0.012483172194345858
chr11	CPSF7	61420469	61420573	0	105	1321	4905	1321	4800	0.0	0.27520833333333333
chr11	CPSF7	61421053	61421127	0	75	1321	4905	1321	4830	0.0	0.27349896480331265
chr11	CPSF7	61420546	61420573	0	28	1321	4905	1321	4877	0.0	0.27086323559565306
chr11	CPSF7	61421191	61421257	0	67	1321	4905	1321	4838	0.0	0.27304671351798265
chr11	CPSF7	61420469	61420530	0	62	1321	4905	1321	4843	0.0	0.2727648151971918
chr11	CPSF7	61421053	61421130	0	78	1321	4905	1321	4827	0.0	0.2736689455148125
chr11	SYT7	61546030	61546255	0	226	19743	7567	19743	7341	0.0	2.6894156109521865
chr11	SYT7	61547176	61547308	0	133	19743	7567	19743	7434	0.0	2.655770782889427
chr11	SYT7	61546534	61546659	0	126	19743	7567	19743	7441	0.0	2.6532724096223625
chr11	TMEM258	61789784	61789990	0	207	0	1996	0	1789	0.0	0.0
chr11	FADS1	61813242	61813353	0	112	1071	9399	1071	9287	0.0	0.11532249380854959
chr11	FADS1	61811818	61811978	0	161	1071	9399	1071	9238	0.0	0.115934184888504
chr11	FADS1	61828449	61828708	0	260	1071	9399	1071	9139	0.0	0.11719006455848562
chr11	RAB3IL1	61906465	61906684	5811	220	470185	3204	464374	2984	26.413636363636364	155.62131367292224
chr11	RAB3IL1	61905392	61905536	2113	145	470185	3204	468072	3059	14.572413793103449	153.0147106897679
chr11	RAB3IL1	61898841	61898931	879	91	470185	3204	469306	3113	9.659340659340659	150.7568262126566
chr11	FTH1	61965368	61965515	0	148	0	1914	0	1766	0.0	0.0
chr11	AHNAK	62491731	62491831	35027	101	983314	18368	948287	18267	346.8019801980198	51.912574588054966
chr11	AHNAK	62536238	62536287	0	50	983314	18368	983314	18318	0.0	53.68020526258325
chr11	TUT1	62582470	62582592	51	123	34785	3550	34734	3427	0.4146341463414634	10.135395389553546
chr11	B3GAT3	62621054	62621293	65779	240	319391	2413	253612	2173	274.07916666666665	116.71053842613898
chr11	B3GAT3	62621054	62621123	21215	70	319391	2413	298176	2343	303.07142857142856	127.26248399487837
chr11	GANAB	62634309	62634375	592	67	18778	5054	18186	4987	8.835820895522389	3.6466813715660717
chr11	GANAB	62639358	62639467	92	110	18778	5054	18686	4944	0.8363636363636363	3.7795307443365695
chr11	GANAB	62639929	62640069	325	141	18778	5054	18453	4913	2.3049645390070923	3.7559535925096683
chr11	GANAB	62639929	62640066	319	138	18778	5054	18459	4916	2.3115942028985508	3.7548820179007323
chr11	LBHD1	62669640	62669803	0	164	562	2716	562	2552	0.0	0.22021943573667713
chr11	LBHD1	62671239	62671388	51	150	562	2716	511	2566	0.34	0.19914263445050662
chr11	UBXN1	62676812	62677005	0	194	258	1724	258	1530	0.0	0.16862745098039217
chr11	BSCL2	62691279	62691421	0	143	166	3676	166	3533	0.0	0.04698556467591282
chr11	BSCL2	62692662	62692797	0	136	166	3676	166	3540	0.0	0.04689265536723164
chr11	BSCL2	62705300	62705617	18	318	166	3676	148	3358	0.05660377358490566	0.044073853484216795
chr11	BSCL2	62702467	62702549	0	83	166	3676	166	3593	0.0	0.04620094628444197
chr11	BSCL2	62705300	62705558	18	259	166	3676	148	3417	0.0694980694980695	0.04331284752707053
chr11	BSCL2	62709146	62709254	0	109	166	3676	166	3567	0.0	0.04653770675637791
chr11	BSCL2	62706612	62706711	0	100	166	3676	166	3576	0.0	0.046420581655480984
chr11	NXF1	62796459	62796567	0	109	1207	5978	1207	5869	0.0	0.20565684102913614
chr11	NXF1	62801093	62801201	0	109	1207	5978	1207	5869	0.0	0.20565684102913614
chr11	NXF1	62798538	62798575	0	38	1207	5978	1207	5940	0.0	0.2031986531986532
chr11	NXF1	62804081	62804210	0	130	1207	5978	1207	5848	0.0	0.2063953488372093
chr11	STX5	62827560	62827631	0	72	51	2433	51	2361	0.0	0.021601016518424398
chr11	STX5	62830357	62830520	0	164	51	2433	51	2269	0.0	0.02247686205376818
chr11	WDR74	62833617	62833674	0	58	153	4116	153	4058	0.0	0.037703302119270574
chr11	SNHG1	62852810	62852839	0	30	0	3736	0	3706	0.0	0.0
chr11	SNHG1	62854017	62854064	0	48	0	3736	0	3688	0.0	0.0
chr11	SNHG1	62854887	62854938	0	52	0	3736	0	3684	0.0	0.0
chr11	SNHG1	62855132	62855216	0	85	0	3736	0	3651	0.0	0.0
chr11	SNHG1	62855423	62855466	0	44	0	3736	0	3692	0.0	0.0
chr11	SNHG1	62855132	62855208	0	77	0	3736	0	3659	0.0	0.0
chr11	SNHG1	62854518	62854551	0	34	0	3736	0	3702	0.0	0.0
chr11	SNHG1	62855423	62855745	0	323	0	3736	0	3413	0.0	0.0
chr11	SNHG1	62852810	62852993	0	184	0	3736	0	3552	0.0	0.0
chr11	SNHG1	62854518	62854938	0	421	0	3736	0	3315	0.0	0.0
chr11	CHRM1	62920672	62920764	0	93	0	3254	0	3161	0.0	0.0
chr11	SLC22A8	63014625	63014983	0	359	0	3652	0	3293	0.0	0.0
chr11	SLC22A8	63014625	63014710	0	86	0	3652	0	3566	0.0	0.0
chr11	SLC22A8	63014625	63014962	0	338	0	3652	0	3314	0.0	0.0
chr11	SLC22A25	63167908	63168060	0	153	48	3763	48	3610	0.0	0.013296398891966758
chr11	ATL3	63671289	63671411	0	123	13735	7614	13735	7491	0.0	1.8335335736216793
chr11	MACROD1	63998837	63998872	414	36	104815	2110	104401	2074	11.5	50.337994214079075
chr11	MACROD1	64015251	64015281	557	31	104815	2110	104258	2079	17.967741935483872	50.148148148148145
chr11	TRPT1	64224099	64224210	0	112	51	1812	51	1700	0.0	0.03
chr11	TRPT1	64225498	64225580	0	83	51	1812	51	1729	0.0	0.029496818970503182
chr11	TRPT1	64225785	64225869	0	85	51	1812	51	1727	0.0	0.029530978575564564
chr11	TRPT1	64224099	64224162	0	64	51	1812	51	1748	0.0	0.02917620137299771
chr11	BAD	64271612	64271803	0	192	51	1713	51	1521	0.0	0.03353057199211045
chr11	BAD	64276903	64277043	51	141	51	1713	0	1572	0.3617021276595745	0.0
chr11	NRXN2	64626462	64626552	878	91	158895	9747	158017	9656	9.648351648351648	16.364643744821873
chr11	NRXN2	64677013	64677037	0	25	158895	9747	158895	9722	0.0	16.3438592882123
chr11	NRXN2	64692846	64692876	5	31	158895	9747	158890	9716	0.16129032258064516	16.35343762865377
chr11	NRXN2	64653695	64653722	0	28	158895	9747	158895	9719	0.0	16.348904208251877
chr11	NRXN2	64676992	64677037	0	46	158895	9747	158895	9701	0.0	16.37923925368519
chr11	NRXN2	64690404	64690476	0	73	158895	9747	158895	9674	0.0	16.42495348356419
chr11	RASGRP2	64740367	64740449	0	83	255	5724	255	5641	0.0	0.04520475093068605
chr11	RASGRP2	64743816	64743868	0	53	255	5724	255	5671	0.0	0.04496561453006524
chr11	RASGRP2	64740367	64740446	0	80	255	5724	255	5644	0.0	0.045180722891566265
chr11	RASGRP2	64744332	64744482	0	151	255	5724	255	5573	0.0	0.04575632513906334
chr11	SF1	64773429	64773505	84	77	135	5987	51	5910	1.0909090909090908	0.008629441624365483
chr11	SF1	64765950	64766155	0	206	135	5987	135	5781	0.0	0.0233523611831863
chr11	SF1	64777986	64778146	0	161	135	5987	135	5826	0.0	0.023171987641606592
chr11	MAP4K2	64800899	64801031	0	133	589097	7589	589097	7456	0.0	79.00979077253218
chr11	MAP4K2	64801578	64801621	0	44	589097	7589	589097	7545	0.0	78.07779986746189
chr11	MEN1	64805033	64805198	2280	166	168530	4392	166250	4226	13.734939759036145	39.339801230477995
chr11	MEN1	64805887	64806013	1396	127	168530	4392	167134	4265	10.992125984251969	39.187338804220396
chr11	EHD1	64878834	64879156	116499	323	897331	6786	780832	6463	360.6780185758514	120.81572025375213
chr11	MAJIN	64946089	64946153	488	65	59397	2337	58909	2272	7.507692307692308	25.92825704225352
chr11	NAALADL1	65046188	65046362	50825	175	135480	3759	84655	3584	290.42857142857144	23.620256696428573
chr11	NAALADL1	65047474	65047565	2424	92	135480	3759	133056	3667	26.347826086956523	36.28470139078266
chr11	NAALADL1	65047980	65048048	1568	69	135480	3759	133912	3690	22.72463768115942	36.29051490514905
chr11	NAALADL1	65054249	65054354	2361	106	135480	3759	133119	3653	22.27358490566038	36.44100739118533
chr11	NAALADL1	65057370	65057493	1339	124	135480	3759	134141	3635	10.798387096774194	36.902613480055024
chr11	NAALADL1	65046444	65046526	0	83	135480	3759	135480	3676	0.0	36.855277475516864
chr11	TMEM262	65088682	65088750	800	69	17216	697	16416	628	11.594202898550725	26.14012738853503
chr11	TMEM262	65088650	65088750	1029	101	17216	697	16187	596	10.188118811881187	27.159395973154364
chr11	FAU	65120980	65121036	117	57	645	821	528	764	2.0526315789473686	0.6910994764397905
chr11	SYVN1	65132247	65132351	0	105	454	5209	454	5104	0.0	0.0889498432601881
chr11	SYVN1	65132731	65132780	82	50	454	5209	372	5159	1.64	0.07210699748013182
chr11	SYVN1	65132247	65132308	0	62	454	5209	454	5147	0.0	0.08820672236254129
chr11	SLC25A45	65379375	65379561	1442	187	320273	4923	318831	4736	7.711229946524064	67.32073479729729
chr11	SLC25A45	65379866	65379938	341	73	320273	4923	319932	4850	4.671232876712328	65.96536082474226
chr11	SLC25A45	65381914	65381969	735	56	320273	4923	319538	4867	13.125	65.65399630162318
chr11	SLC25A45	65377332	65377423	0	92	320273	4923	320273	4831	0.0	66.29538397847237
chr11	SLC25A45	65381874	65381969	843	96	320273	4923	319430	4827	8.78125	66.17567847524342
chr11	SLC25A45	65380533	65380622	31713	90	320273	4923	288560	4833	352.3666666666667	59.70618663356093
chr11	SLC25A45	65380533	65380632	33827	100	320273	4923	286446	4823	338.27	59.39166493883475
chr11	LTBP3	65540012	65540153	918	142	366713	10116	365795	9974	6.464788732394366	36.67485462201724
chr11	LTBP3	65552859	65552982	0	124	366713	10116	366713	9992	0.0	36.70066052842274
chr11	LTBP3	65553424	65553530	0	107	366713	10116	366713	10009	0.0	36.63832550704366
chr11	KCNK7	65593309	65593383	0	75	707	1463	707	1388	0.0	0.5093659942363112
chr11	RELA	65660123	65660215	175334	93	1911399	4483	1736065	4390	1885.3118279569892	395.45899772209566
chr11	RELA	65661686	65661835	5746	150	1911399	4483	1905653	4333	38.306666666666665	439.79990768520656
chr11	RELA	65661936	65662088	20112	153	1911399	4483	1891287	4330	131.45098039215685	436.7868360277136
chr11	RELA	65662178	65662205	3142	28	1911399	4483	1908257	4455	112.21428571428571	428.34051627384963
chr11	RELA	65661686	65661868	5788	183	1911399	4483	1905611	4300	31.628415300546447	443.1653488372093
chr11	RELA	65661686	65661819	5698	134	1911399	4483	1905701	4349	42.52238805970149	438.1929179121637
chr11	RELA	65662178	65662347	23914	170	1911399	4483	1887485	4313	140.6705882352941	437.6269418038488
chr11	RNASEH2C	65717662	65717893	0	232	867	4492	867	4260	0.0	0.2035211267605634
chr11	CFL1	65858096	65858630	1603	535	591844	5673	590241	5138	2.9962616822429906	114.87757882444531
chr11	CFL1	65858096	65858342	1348	247	591844	5673	590496	5426	5.4574898785425106	108.82712863988205
chr11	EFEMP2	65866844	65867079	0	236	4023	4066	4023	3830	0.0	1.0503916449086161
chr11	EFEMP2	65866809	65867079	0	271	4023	4066	4023	3795	0.0	1.0600790513833993
chr11	EFEMP2	65867020	65867079	0	60	4023	4066	4023	4006	0.0	1.0042436345481778
chr11	EFEMP2	65866844	65866934	0	91	4023	4066	4023	3975	0.0	1.0120754716981133
chr11	EFEMP2	65866865	65867079	0	215	4023	4066	4023	3851	0.0	1.0446637237081278
chr11	FIBP	65886321	65886422	0	102	3824	3155	3824	3053	0.0	1.2525384867343596
chr11	FOSL1	65894013	65894121	255	109	1134	1891	879	1782	2.3394495412844036	0.49326599326599324
chr11	FOSL1	65896808	65897006	0	199	1134	1891	1134	1692	0.0	0.6702127659574468
chr11	FOSL1	65894013	65894116	255	104	1134	1891	879	1787	2.451923076923077	0.4918858421936206
chr11	EIF1AD	66000302	66000481	11022	180	113060	3333	102038	3153	61.233333333333334	32.36219473517285
chr11	EIF1AD	66000302	66000406	0	105	113060	3333	113060	3228	0.0	35.02478314745973
chr11	EIF1AD	66000302	66000505	19208	204	113060	3333	93852	3129	94.15686274509804	29.994247363374882
chr11	YIF1A	66285380	66285536	408	157	13169	2353	12761	2196	2.5987261146496814	5.8110200364298725
chr11	YIF1A	66285700	66285758	0	59	13169	2353	13169	2294	0.0	5.740627724498692
chr11	YIF1A	66287811	66287916	255	106	13169	2353	12914	2247	2.4056603773584904	5.747218513573654
chr11	YIF1A	66288080	66288292	3886	213	13169	2353	9283	2140	18.24413145539906	4.337850467289719
chr11	YIF1A	66286940	66287014	237	75	13169	2353	12932	2278	3.16	5.6769095697980685
chr11	RIN1	66335977	66336158	148	182	376111	5231	375963	5049	0.8131868131868132	74.46286393345217
chr11	BRMS1	66338242	66338282	0	41	0	2375	0	2334	0.0	0.0
chr11	SLC29A2	66366430	66366564	22	135	16751	2733	16729	2598	0.16296296296296298	6.439183987682833
chr11	MRPL11	66436801	66436909	139	109	68365	2546	68226	2437	1.275229357798165	27.995896594173164
chr11	MRPL11	66436815	66436909	83	95	68365	2546	68282	2451	0.8736842105263158	27.858833129334965
chr11	ZDHHC24	66524154	66524276	210	123	127283	6543	127073	6420	1.7073170731707317	19.79330218068536
chr11	ZDHHC24	66529311	66529488	116690	178	127283	6543	10593	6365	655.561797752809	1.6642576590730558
chr11	CTSF	66564741	66564806	56	66	24341	3628	24285	3562	0.8484848484848485	6.817798989331836
chr11	CTSF	66565830	66565927	0	98	24341	3628	24341	3530	0.0	6.895467422096317
chr11	RBM4B	66668614	66669291	0	678	1136	4297	1136	3619	0.0	0.31389886709035647
chr11	RBM4B	66666271	66666493	12	223	1136	4297	1124	4074	0.053811659192825115	0.2758959253804615
chr11	RBM4B	66670935	66670983	0	49	1136	4297	1136	4248	0.0	0.2674199623352166
chr11	SPTBN2	66721349	66721440	0	92	5905	12863	5905	12771	0.0	0.46237569493383446
chr11	PC	66957868	66957996	340	129	7868	7336	7528	7207	2.635658914728682	1.0445400305258776
chr11	PC	66954248	66954436	0	189	7868	7336	7868	7147	0.0	1.1008814887365328
chr11	PC	66948087	66948203	657	117	7868	7336	7211	7219	5.615384615384615	0.9988918132705361
chr11	PC	66957739	66957996	340	258	7868	7336	7528	7078	1.317829457364341	1.0635772817179994
chr11	PC	66952429	66952468	110	40	7868	7336	7758	7296	2.75	1.0633223684210527
chr11	POLD4	67352690	67352802	146846	113	1383863	2477	1237017	2364	1299.5221238938052	523.2728426395939
chr11	PPP1CA	67399560	67399665	0	106	0	3928	0	3822	0.0	0.0
chr11	PPP1CA	67401067	67401232	0	166	0	3928	0	3762	0.0	0.0
chr11	PPP1CA	67401067	67401199	0	133	0	3928	0	3795	0.0	0.0
chr11	CORO1B	67440701	67440836	0	136	51	5227	51	5091	0.0	0.010017678255745434
chr11	TMEM134	67464802	67464856	0	55	0	1799	0	1744	0.0	0.0
chr11	TMEM134	67465055	67465100	0	46	0	1799	0	1753	0.0	0.0
chr11	TMEM134	67465055	67465267	0	213	0	1799	0	1586	0.0	0.0
chr11	PITPNM1	67504102	67504221	0	120	0	6465	0	6345	0.0	0.0
chr11	CABP2	67522545	67522716	21	172	174	1496	153	1324	0.12209302325581395	0.11555891238670694
chr11	CABP2	67522541	67522716	21	176	174	1496	153	1320	0.11931818181818182	0.1159090909090909
chr11	DOC2GP	67615614	67615686	0	73	0	1664	0	1591	0.0	0.0
chr11	ALDH3B2	67667472	67667635	0	164	151	3617	151	3453	0.0	0.0437300897770055
chr11	ALDH3B2	67671062	67671325	0	264	151	3617	151	3353	0.0	0.04503429764390098
chr11	ALDH3B2	67674435	67674606	100	172	151	3617	51	3445	0.5813953488372093	0.014804063860667634
chr11	FAM86C2P	67796683	67796833	3020	151	42841	3409	39821	3258	20.0	12.222529158993247
chr11	FAM86C2P	67799373	67799475	376	103	42841	3409	42465	3306	3.650485436893204	12.844827586206897
chr11	CHKA	68081403	68081457	0	55	345	3785	345	3730	0.0	0.09249329758713137
chr11	CHKA	68061492	68061830	0	339	345	3785	345	3446	0.0	0.10011607661056297
chr11	KMT5B	68180131	68180200	0	70	57474	8333	57474	8263	0.0	6.955585138569527
chr11	KMT5B	68189916	68190152	1422	237	57474	8333	56052	8096	6.0	6.923418972332016
chr11	KMT5B	68179469	68179537	214	69	57474	8333	57260	8264	3.101449275362319	6.928848015488867
chr11	KMT5B	68174087	68174210	11283	124	57474	8333	46191	8209	90.99193548387096	5.626872944329395
chr11	TESMIN	68742317	68742394	0	78	52332	4604	52332	4526	0.0	11.562527618205921
chr11	TESMIN	68744990	68745111	0	122	52332	4604	52332	4482	0.0	11.676037483266398
chr11	MRPL21	68900534	68900605	0	72	1410	2831	1410	2759	0.0	0.5110547299746285
chr11	MRPL21	68900547	68900605	0	59	1410	2831	1410	2772	0.0	0.5086580086580087
chr11	LTO1	69671748	69671819	0	72	0	5823	0	5751	0.0	0.0
chr11	LTO1	69673215	69673321	0	107	0	5823	0	5716	0.0	0.0
chr11	LTO1	69674550	69674766	0	217	0	5823	0	5606	0.0	0.0
chr11	FGF4	69774023	69774127	0	105	0	3168	0	3063	0.0	0.0
chr11	SHANK2	70500569	70500599	0	31	2103	19063	2103	19032	0.0	0.11049810844892811
chr11	SHANK2	70501922	70501931	0	10	2103	19063	2103	19053	0.0	0.11037631868997008
chr11	SHANK2	70477151	70477232	0	82	2103	19063	2103	18981	0.0	0.11079500553184764
chr11	SHANK2	70502205	70502286	0	82	2103	19063	2103	18981	0.0	0.11079500553184764
chr11	SHANK2	70500569	70500590	0	22	2103	19063	2103	19041	0.0	0.11044587994328028
chr11	SHANK2	70500569	70500596	0	28	2103	19063	2103	19035	0.0	0.11048069345941687
chr11	SHANK2	70895396	70895567	0	172	2103	19063	2103	18891	0.0	0.11132285215181832
chr11	ALG1L9P	71802857	71802972	108	116	156387	10393	156279	10277	0.9310344827586207	15.206675099737277
chr11	AP002495.1	71923308	71923475	0	168	53	3091	53	2923	0.0	0.018132056106739652
chr11	AP002495.1	71925932	71926104	0	173	53	3091	53	2918	0.0	0.0181631254283756
chr11	NUMA1	72008091	72008145	0	55	248740	15188	248740	15133	0.0	16.43692592347849
chr11	NUMA1	72012894	72016260	72827	3367	248740	15188	175913	11821	21.62964062964063	14.88139751290077
chr11	NUMA1	72062588	72062686	0	99	248740	15188	248740	15089	0.0	16.48485651799324
chr11	NUMA1	72012400	72012442	0	43	248740	15188	248740	15145	0.0	16.423902277979533
chr11	NUMA1	72069841	72069911	0	71	248740	15188	248740	15117	0.0	16.454322947674804
chr11	NUMA1	72068104	72068231	55	128	248740	15188	248685	15060	0.4296875	16.512948207171316
chr11	NUMA1	72049418	72049539	0	122	248740	15188	248740	15066	0.0	16.51002256737024
chr11	NUMA1	72068495	72068617	0	123	248740	15188	248740	15065	0.0	16.511118486558246
chr11	NUMA1	72076567	72076757	0	191	248740	15188	248740	14997	0.0	16.585983863439356
chr11	NUMA1	72050661	72050833	0	173	248740	15188	248740	15015	0.0	16.566100566100566
chr11	NUMA1	72068078	72068231	81	154	248740	15188	248659	15034	0.525974025974026	16.539776506585074
chr11	LAMTOR1	72098288	72098415	0	128	0	2695	0	2567	0.0	0.0
chr11	ANAPC15	72111411	72111496	0	86	306	2872	306	2786	0.0	0.10983488872936109
chr11	ANAPC15	72111441	72111496	0	56	306	2872	306	2816	0.0	0.10866477272727272
chr11	ANAPC15	72111156	72111286	0	131	306	2872	306	2741	0.0	0.11163808828894564
chr11	CLPB	72302303	72302348	0	46	10858	12455	10858	12409	0.0	0.8750100733338706
chr11	CLPB	72372924	72373014	0	91	10858	12455	10858	12364	0.0	0.8781947589776772
chr11	CLPB	72402965	72403052	156	88	10858	12455	10702	12367	1.7727272727272727	0.8653675103096952
chr11	CLPB	72408097	72408204	8866	108	10858	12455	1992	12347	82.0925925925926	0.1613347371831214
chr11	CLPB	72310943	72311051	0	109	10858	12455	10858	12346	0.0	0.8794751336465252
chr11	CLPB	72302303	72302373	0	71	10858	12455	10858	12384	0.0	0.8767764857881137
chr11	PDE2A	72608661	72608751	0	91	22969	7220	22969	7129	0.0	3.2219105063823816
chr11	PDE2A	72642253	72642326	0	74	22969	7220	22969	7146	0.0	3.214245731877974
chr11	PDE2A	72631077	72631139	0	63	22969	7220	22969	7157	0.0	3.209305574961576
chr11	PDE2A	72668297	72668426	0	130	22969	7220	22969	7090	0.0	3.239633286318759
chr11	ARAP1	72704151	72704334	102	184	20402	8718	20300	8534	0.5543478260869565	2.378720412467776
chr11	ARAP1	72692752	72692785	0	34	20402	8718	20402	8684	0.0	2.349378166743436
chr11	STARD10	72755700	72755753	0	54	51	2748	51	2694	0.0	0.01893095768374165
chr11	STARD10	72757766	72757884	0	119	51	2748	51	2629	0.0	0.019399011030810195
chr11	STARD10	72790336	72790390	0	55	51	2748	51	2693	0.0	0.018937987374675083
chr11	FCHSD2	72842620	72842841	0	222	2867	5269	2867	5047	0.0	0.5680602338022588
chr11	FCHSD2	73000989	73001134	0	146	2867	5269	2867	5123	0.0	0.5596330275229358
chr11	FCHSD2	73140030	73140128	301	99	2867	5269	2566	5170	3.04040404040404	0.49632495164410056
chr11	FCHSD2	72900256	72900328	0	73	2867	5269	2867	5196	0.0	0.5517705927636644
chr11	FCHSD2	73077617	73077670	0	54	2867	5269	2867	5215	0.0	0.5497603068072867
chr11	FAM168A	73468404	73468492	0	89	29037	7898	29037	7809	0.0	3.7184018440261237
chr11	FAM168A	73425021	73425048	0	28	29037	7898	29037	7870	0.0	3.6895806861499363
chr11	RAB6A	73679653	73679720	0	68	5363	4907	5363	4839	0.0	1.108286836123166
chr11	RAB6A	73718612	73718718	0	107	5363	4907	5363	4800	0.0	1.1172916666666666
chr11	RAB6A	73718784	73718890	255	107	5363	4907	5108	4800	2.383177570093458	1.0641666666666667
chr11	RAB6A	73720845	73720899	457	55	5363	4907	4906	4852	8.309090909090909	1.0111294311624073
chr11	COA4	73876478	73876575	0	98	339	1840	339	1742	0.0	0.19460390355912743
chr11	UCP2	73975490	73975671	0	182	26833	2740	26833	2558	0.0	10.489835809225958
chr11	UCP2	73980014	73980052	0	39	26833	2740	26833	2701	0.0	9.934468715290633
chr11	P4HA3	74276984	74277144	0	161	1020	3632	1020	3471	0.0	0.2938634399308557
chr11	P4HA3	74287115	74287291	0	177	1020	3632	1020	3455	0.0	0.2952243125904486
chr11	KCNE3	74462747	74462855	0	109	2123926	3605	2123926	3496	0.0	607.5303203661327
chr11	KCNE3	74464261	74464325	27	65	2123926	3605	2123899	3540	0.4153846153846154	599.9714689265537
chr11	CHRDL2	74703304	74703499	0	196	36616	3110	36616	2914	0.0	12.565545641729582
chr11	CHRDL2	74708301	74708395	1253	95	36616	3110	35363	3015	13.189473684210526	11.729021558872304
chr11	CHRDL2	74701591	74701646	0	56	36616	3110	36616	3054	0.0	11.989521938441388
chr11	CHRDL2	74713385	74713479	102	95	36616	3110	36514	3015	1.0736842105263158	12.110779436152571
chr11	XRRA1	74851087	74851203	0	117	153	8801	153	8684	0.0	0.017618608935974205
chr11	XRRA1	74933800	74933872	0	73	153	8801	153	8728	0.0	0.017529789184234645
chr11	XRRA1	74945017	74945085	0	69	153	8801	153	8732	0.0	0.017521759047182776
chr11	XRRA1	74843853	74843959	0	107	153	8801	153	8694	0.0	0.017598343685300208
chr11	XRRA1	74859157	74859283	0	127	153	8801	153	8674	0.0	0.017638920913073553
chr11	XRRA1	74862980	74863021	0	42	153	8801	153	8759	0.0	0.01746774745975568
chr11	XRRA1	74927390	74927488	0	99	153	8801	153	8702	0.0	0.017582165019535738
chr11	XRRA1	74933824	74933872	0	49	153	8801	153	8752	0.0	0.017481718464351006
chr11	XRRA1	74940784	74940882	0	99	153	8801	153	8702	0.0	0.017582165019535738
chr11	XRRA1	74851988	74852082	0	95	153	8801	153	8706	0.0	0.01757408683666437
chr11	XRRA1	74906238	74906456	0	219	153	8801	153	8582	0.0	0.01782801211838732
chr11	OR2AT4	75096088	75096222	0	135	612	1838	612	1703	0.0	0.35936582501467995
chr11	OR2AT4	75096088	75096160	0	73	612	1838	612	1765	0.0	0.346742209631728
chr11	ARRB1	75267651	75267703	0	53	1012245	9907	1012245	9854	0.0	102.72427440633246
chr11	ARRB1	75271700	75271724	0	25	1012245	9907	1012245	9882	0.0	102.43321190042502
chr11	ARRB1	75290008	75290039	32	32	1012245	9907	1012213	9875	1.0	102.50258227848101
chr11	GDPD5	75449884	75449983	0	100	472	9722	472	9622	0.0	0.04905425067553523
chr11	GDPD5	75479243	75479488	0	246	472	9722	472	9476	0.0	0.049810046433094134
chr11	GDPD5	75448491	75448649	0	159	472	9722	472	9563	0.0	0.049356896371431556
chr11	GDPD5	75439339	75439354	0	16	472	9722	472	9706	0.0	0.04862971357922934
chr11	THAP12	76364337	76364432	0	96	307	7895	307	7799	0.0	0.039364021028336964
chr11	LRRC32	76659582	76661508	714	1927	816	4460	102	2533	0.3705241307732226	0.040268456375838924
chr11	GDPD4	77279305	77279399	0	95	777	2911	777	2816	0.0	0.27592329545454547
chr11	PAK1	77337323	77337423	6	101	77038	5942	77032	5841	0.0594059405940594	13.188152713576443
chr11	PAK1	77392330	77392541	357	212	77038	5942	76681	5730	1.6839622641509433	13.38237347294939
chr11	PAK1	77325327	77325376	32	50	77038	5942	77006	5892	0.64	13.069585879158181
chr11	PAK1	77455880	77455937	30	58	77038	5942	77008	5884	0.5172413793103449	13.087695445275322
chr11	PAK1	77397026	77397158	0	133	77038	5942	77038	5809	0.0	13.261835083491134
chr11	PAK1	77408153	77408232	102	80	77038	5942	76936	5862	1.275	13.124530876833845
chr11	CLNS1A	77622499	77622673	0	175	23819	4489	23819	4314	0.0	5.521325915623551
chr11	CLNS1A	77625716	77625818	0	103	23819	4489	23819	4386	0.0	5.430688554491564
chr11	CLNS1A	77629762	77629899	2324	138	23819	4489	21495	4351	16.840579710144926	4.940243622155826
chr11	CLNS1A	77624962	77625070	204	109	23819	4489	23615	4380	1.871559633027523	5.391552511415525
chr11	CLNS1A	77621865	77622044	686	180	23819	4489	23133	4309	3.811111111111111	5.36853098166628
chr11	RSF1	77725544	77725699	0	156	165239	15757	165239	15601	0.0	10.591564643292097
chr11	RSF1	77747035	77747128	1	94	165239	15757	165238	15663	0.010638297872340425	10.549575432548043
chr11	INTS4	77978995	77979102	0	108	30387	5755	30387	5647	0.0	5.381087302992739
chr11	INTS4	77987603	77987698	0	96	30387	5755	30387	5659	0.0	5.369676621311186
chr11	INTS4	77987528	77987698	0	171	30387	5755	30387	5584	0.0	5.441797994269341
chr11	NDUFC2	78072997	78073141	0	145	204	2119	204	1974	0.0	0.1033434650455927
chr11	NDUFC2-KCTD14	78038663	78038758	0	96	0	830	0	734	0.0	0.0
chr11	NDUFC2	78072997	78073072	0	76	204	2119	204	2043	0.0	0.09985315712187959
chr11	ALG8	78109441	78109581	0	141	1326	3191	1326	3050	0.0	0.43475409836065576
chr11	ALG8	78127357	78127436	0	80	1326	3191	1326	3111	0.0	0.4262295081967213
chr11	ALG8	78102873	78102948	0	76	1326	3191	1326	3115	0.0	0.42568218298555377
chr11	ALG8	78107716	78107764	0	49	1326	3191	1326	3142	0.0	0.42202418841502226
chr11	ALG8	78112649	78112770	0	122	1326	3191	1326	3069	0.0	0.43206256109481916
chr11	ALG8	78127357	78127439	0	83	1326	3191	1326	3108	0.0	0.4266409266409266
chr11	ALG8	78114703	78114798	0	96	1326	3191	1326	3095	0.0	0.4284329563812601
chr11	ALG8	78135229	78135347	561	119	1326	3191	765	3072	4.714285714285714	0.2490234375
chr11	ALG8	78138709	78138767	0	59	1326	3191	1326	3132	0.0	0.42337164750957856
chr11	KCTD21	78186680	78186816	0	137	10529	3974	10529	3837	0.0	2.744070888715142
chr11	KCTD21	78177738	78177985	10	248	10529	3974	10519	3726	0.04032258064516129	2.8231347289318305
chr11	KCTD21	78176887	78176985	7323	99	10529	3974	3206	3875	73.96969696969697	0.8273548387096774
chr11	GAB2	78250156	78250400	0	245	0	6790	0	6545	0.0	0.0
chr11	GAB2	78364015	78364103	0	89	0	6790	0	6701	0.0	0.0
chr11	NARS2	78441090	78441117	0	28	0	3161	0	3133	0.0	0.0
chr11	NARS2	78493062	78493195	0	134	0	3161	0	3027	0.0	0.0
chr11	TENM4	78778601	78778628	0	28	153	11480	153	11452	0.0	0.013360111770869718
chr11	TENM4	79148709	79148806	0	98	153	11480	153	11382	0.0	0.013442277279915656
chr11	MIR4300HG	82349925	82350004	0	80	34	4311	34	4231	0.0	0.008035925313164737
chr11	MIR4300HG	82015607	82015734	0	128	34	4311	34	4183	0.0	0.008128137700215157
chr11	MIR4300HG	82096460	82096608	0	149	34	4311	34	4162	0.0	0.008169149447381067
chr11	AP000793.1	82610012	82610090	301	79	7385	1063	7084	984	3.810126582278481	7.199186991869919
chr11	PRCP	82884822	82884885	0	64	15247	13162	15247	13098	0.0	1.1640708505115285
chr11	PRCP	82859976	82860117	0	142	15247	13162	15247	13020	0.0	1.1710445468509985
chr11	RAB30	82994038	82994122	0	85	71094	11843	71094	11758	0.0	6.046436468787209
chr11	RAB30	83034171	83034272	0	102	71094	11843	71094	11741	0.0	6.055191210288732
chr11	RAB30	82994038	82994106	0	69	71094	11843	71094	11774	0.0	6.0382198063529815
chr11	RAB30	83060076	83060178	0	103	71094	11843	71094	11740	0.0	6.055706984667802
chr11	RAB30	83034726	83034782	0	57	71094	11843	71094	11786	0.0	6.0320719497709145
chr11	AP000873.2	83192123	83192197	0	75	0	1749	0	1674	0.0	0.0
chr11	AP000873.2	83192427	83192541	0	115	0	1749	0	1634	0.0	0.0
chr11	CCDC90B	83265864	83265979	0	116	51	5909	51	5793	0.0	0.008803728638011392
chr11	CCDC90B	83278725	83278829	0	105	51	5909	51	5804	0.0	0.008787043418332184
chr11	CCDC90B	83280140	83280260	0	121	51	5909	51	5788	0.0	0.008811333794056669
chr11	CCDC90B	83266866	83267038	0	173	51	5909	51	5736	0.0	0.00889121338912134
chr11	CCDC90B	83285126	83285211	0	86	51	5909	51	5823	0.0	0.008758371973209686
chr11	DLG2	83472726	83472777	0	52	226	16296	226	16244	0.0	0.013912829352376262
chr11	DLG2	83930327	83930483	0	157	226	16296	226	16139	0.0	0.014003345932213892
chr11	DLG2	83480371	83480413	0	43	226	16296	226	16253	0.0	0.013905125207653971
chr11	DLG2	84251237	84251291	0	55	226	16296	226	16241	0.0	0.013915399298072778
chr11	DLG2	83651838	83651930	0	93	226	16296	226	16203	0.0	0.013948034314633092
chr11	DLG2	84272141	84272300	0	160	226	16296	226	16136	0.0	0.014005949429846306
chr11	CREBZF	85661636	85661749	0	114	1457	4015	1457	3901	0.0	0.37349397590361444
chr11	SYTL2	85711112	85711232	0	121	205524	11277	205524	11156	0.0	18.422732162065255
chr11	SYTL2	85714412	85714507	64351	96	205524	11277	141173	11181	670.3229166666666	12.62615150702084
chr11	SYTL2	85717482	85717530	0	49	205524	11277	205524	11228	0.0	18.304595653722835
chr11	SYTL2	85757624	85758114	1326	491	205524	11277	204198	10786	2.70061099796334	18.931763396996107
chr11	SYTL2	85708037	85708150	0	114	205524	11277	205524	11163	0.0	18.41117979037893
chr11	SYTL2	85717482	85717726	0	245	205524	11277	205524	11032	0.0	18.62980420594634
chr11	SYTL2	85716346	85716428	181	83	205524	11277	205343	11194	2.180722891566265	18.344023584062892
chr11	SYTL2	85717044	85717140	108	97	205524	11277	205416	11180	1.1134020618556701	18.373524150268338
chr11	PICALM	85976622	85976682	192	61	5336	6364	5144	6303	3.1475409836065573	0.8161193082659052
chr11	PICALM	85990249	85990399	680	151	5336	6364	4656	6213	4.503311258278146	0.7493964268469339
chr11	PICALM	86026291	86026367	20	77	5336	6364	5316	6287	0.2597402597402597	0.8455543184348656
chr11	PICALM	85978069	85978093	0	25	5336	6364	5336	6339	0.0	0.8417731503391702
chr11	PICALM	85990249	85990378	323	130	5336	6364	5013	6234	2.4846153846153847	0.8041385948026949
chr11	PICALM	85960674	85960777	0	104	5336	6364	5336	6260	0.0	0.8523961661341853
chr11	PICALM	85974707	85974812	228	106	5336	6364	5108	6258	2.150943396226415	0.8162352189197827
chr11	PICALM	86068650	86068733	0	84	5336	6364	5336	6280	0.0	0.8496815286624204
chr11	ME3	86457365	86457759	0	395	1941	3801	1941	3406	0.0	0.5698766881972989
chr11	RAB38	88149674	88149955	0	282	153	1435	153	1153	0.0	0.1326973113616652
chr11	CTSC	88309162	88309318	0	157	51	15798	51	15641	0.0	0.0032606610830509556
chr11	CTSC	88312387	88312554	0	168	51	15798	51	15630	0.0	0.0032629558541266796
chr11	CTSC	88296132	88296264	0	133	51	15798	51	15665	0.0	0.003255665496329397
chr11	CTSC	88312449	88312554	0	106	51	15798	51	15692	0.0	0.00325006372673974
chr11	CTSC	88328111	88328196	0	86	51	15798	51	15712	0.0	0.003245926680244399
chr11	CTSC	88334936	88335082	0	147	51	15798	51	15651	0.0	0.003258577726662833
chr11	CTSC	88312426	88312554	0	129	51	15798	51	15669	0.0	0.003254834386367988
chr11	CTSC	88327243	88327358	0	116	51	15798	51	15682	0.0	0.003252136207116439
chr11	CTSC	88327928	88328016	0	89	51	15798	51	15709	0.0	0.003246546565662996
chr11	GRM5	88525308	88525404	0	97	583	8672	583	8575	0.0	0.06798833819241983
chr11	NOX4	89342073	89342193	0	121	0	6122	0	6001	0.0	0.0
chr11	TRIM49	89801701	89801932	0	232	0	2171	0	1939	0.0	0.0
chr11	TRIM49D1	89914911	89915142	0	232	1011	2172	1011	1940	0.0	0.5211340206185567
chr11	CHORDC1	90215173	90215230	0	58	0	7182	0	7124	0.0	0.0
chr11	CHORDC1	90206747	90206810	0	64	0	7182	0	7118	0.0	0.0
chr11	CHORDC1	90216463	90216553	0	91	0	7182	0	7091	0.0	0.0
chr11	TAF1D	93738108	93738499	0	392	188	5700	188	5308	0.0	0.03541823662396383
chr11	TAF1D	93739236	93739331	0	96	188	5700	188	5604	0.0	0.03354746609564597
chr11	TAF1D	93738108	93738440	0	333	188	5700	188	5367	0.0	0.035028880193776785
chr11	GPR83	94396398	94396524	0	127	1224	4281	1224	4154	0.0	0.29465575349061146
chr11	MRE11	94445809	94445893	0	85	1931	7556	1931	7471	0.0	0.2584660687993575
chr11	MRE11	94479673	94479761	197	89	1931	7556	1734	7467	2.2134831460674156	0.23222177581357975
chr11	MRE11	94445809	94445890	0	82	1931	7556	1931	7474	0.0	0.25836232271875836
chr11	AP000943.2	94695820	94695907	706	88	706	1181	0	1093	8.022727272727273	0.0
chr11	SESN3	95189778	95189961	0	184	408	10592	408	10408	0.0	0.03920061491160646
chr11	SESN3	95200910	95201103	0	194	408	10592	408	10398	0.0	0.03923831506058857
chr11	SESN3	95224451	95224484	0	34	408	10592	408	10558	0.0	0.03864368251562796
chr11	SESN3	95201236	95201355	51	120	408	10592	357	10472	0.425	0.03409090909090909
chr11	FAM76B	95779077	95779135	0	59	828	5340	828	5281	0.0	0.15678848702897177
chr11	FAM76B	95788858	95788947	0	90	828	5340	828	5250	0.0	0.15771428571428572
chr11	MTMR2	95841616	95841709	0	94	3022	10675	3022	10581	0.0	0.2856062753993006
chr11	MTMR2	95882373	95882496	51	124	3022	10675	2971	10551	0.4112903225806452	0.2815846839162165
chr11	MTMR2	95888155	95888261	51	107	3022	10675	2971	10568	0.4766355140186916	0.28113171839515516
chr11	MTMR2	95887611	95887684	0	74	3022	10675	3022	10601	0.0	0.2850674464673144
chr11	MTMR2	95917376	95917486	0	111	3022	10675	3022	10564	0.0	0.28606588413479744
chr11	MTMR2	95914241	95914312	58	72	3022	10675	2964	10603	0.8055555555555556	0.27954352541733474
chr11	MTMR2	95914241	95914333	154	93	3022	10675	2868	10582	1.6559139784946237	0.271026271026271
chr11	MTMR2	95866383	95866486	1071	104	3022	10675	1951	10571	10.298076923076923	0.18456153627849778
chr11	MTMR2	95887325	95887373	0	49	3022	10675	3022	10626	0.0	0.2843967626576322
chr11	MTMR2	95887611	95887759	0	149	3022	10675	3022	10526	0.0	0.28709861295838873
chr11	MTMR2	95866402	95866486	1071	85	3022	10675	1951	10590	12.6	0.1842304060434372
chr11	MTMR2	95907861	95907923	0	63	3022	10675	3022	10612	0.0	0.28477195627591406
chr11	CCDC82	96385936	96386020	0	85	0	14215	0	14130	0.0	0.0
chr11	CCDC82	96389364	96389523	0	160	0	14215	0	14055	0.0	0.0
chr11	CCDC82	96388694	96388829	0	136	0	14215	0	14079	0.0	0.0
chr11	LINC02713	97918837	97918976	0	140	0	1903	0	1763	0.0	0.0
chr11	LINC02713	97916688	97916923	0	236	0	1903	0	1667	0.0	0.0
chr11	PGR	101049928	101050059	0	132	208	14342	208	14210	0.0	0.014637579169598874
chr11	PGR	101062446	101062752	0	307	208	14342	208	14035	0.0	0.01482009262557891
chr11	PGR	101091759	101091876	0	118	208	14342	208	14224	0.0	0.014623172103487065
chr11	PGR	101049928	101050007	0	80	208	14342	208	14262	0.0	0.014584209788248493
chr11	TRPC6	101476300	101476534	0	235	0	5630	0	5395	0.0	0.0
chr11	TRPC6	101488936	101489101	0	166	0	5630	0	5464	0.0	0.0
chr11	TRPC6	101491555	101491738	0	184	0	5630	0	5446	0.0	0.0
chr11	TMEM123	102448811	102448868	0	58	0	4452	0	4394	0.0	0.0
chr11	TMEM123	102448235	102448375	0	141	0	4452	0	4311	0.0	0.0
chr11	MMP8	102714555	102714709	0	155	38865	3451	38865	3296	0.0	11.791565533980583
chr11	MMP8	102722990	102723078	0	89	38865	3451	38865	3362	0.0	11.560083283759667
chr11	MMP8	102723479	102723546	0	68	38865	3451	38865	3383	0.0	11.488323972805203
chr11	MMP8	102723834	102723945	0	112	38865	3451	38865	3339	0.0	11.639712488769092
chr11	MMP13	102945118	102945236	0	119	7075	1695	7075	1576	0.0	4.489213197969543
chr11	DCUN1D5	103064274	103064377	0	104	3904	12866	3904	12762	0.0	0.30590816486444133
chr11	DCUN1D5	103082747	103082839	0	93	3904	12866	3904	12773	0.0	0.3056447193298364
chr11	DCUN1D5	103089226	103089318	0	93	3904	12866	3904	12773	0.0	0.3056447193298364
chr11	DCUN1D5	103083255	103083326	0	72	3904	12866	3904	12794	0.0	0.3051430357980303
chr11	DCUN1D5	103079908	103079997	0	90	3904	12866	3904	12776	0.0	0.3055729492798998
chr11	LINC02552	104544698	104544786	0	89	0	15741	0	15652	0.0	0.0
chr11	LINC02552	104572556	104572597	0	42	0	15741	0	15699	0.0	0.0
chr11	LINC02552	104595481	104595533	0	53	0	15741	0	15688	0.0	0.0
chr11	LINC02552	104572075	104572222	0	148	0	15741	0	15593	0.0	0.0
chr11	LINC02552	104600302	104600382	0	81	0	15741	0	15660	0.0	0.0
chr11	LINC02552	104607022	104607136	0	115	0	15741	0	15626	0.0	0.0
chr11	CASP12	104887195	104887305	0	111	17	1795	17	1684	0.0	0.010095011876484561
chr11	CASP12	104891169	104891404	0	236	17	1795	17	1559	0.0	0.010904425914047467
chr11	CASP12	104897216	104897468	0	253	17	1795	17	1542	0.0	0.011024643320363165
chr11	CASP12	104892896	104892991	17	96	17	1795	0	1699	0.17708333333333334	0.0
chr11	CASP12	104891197	104891404	0	208	17	1795	17	1587	0.0	0.010712035286704474
chr11	CASP4LP	104906449	104907618	0	1170	0	3314	0	2144	0.0	0.0
chr11	CASP4LP	104906959	104907116	0	158	0	3314	0	3156	0.0	0.0
chr11	CASP4	104944747	104944851	0	105	0	5500	0	5395	0.0	0.0
chr11	CASP4	104951895	104952005	0	111	0	5500	0	5389	0.0	0.0
chr11	CASP4	104950924	104951098	0	175	0	5500	0	5325	0.0	0.0
chr11	CASP5	104995188	104995253	0	66	0	1603	0	1537	0.0	0.0
chr11	CASP5	105003273	105003383	0	111	0	1603	0	1492	0.0	0.0
chr11	CASP5	105008806	105009019	0	214	0	1603	0	1389	0.0	0.0
chr11	CASP5	105008806	105008980	0	175	0	1603	0	1428	0.0	0.0
chr11	CASP5	105007082	105007334	0	253	0	1603	0	1350	0.0	0.0
chr11	CASP5	105008806	105009053	0	248	0	1603	0	1355	0.0	0.0
chr11	CASP1	105029123	105029267	0	145	0	3706	0	3561	0.0	0.0
chr11	CASP1	105026225	105026356	0	132	0	3706	0	3574	0.0	0.0
chr11	CASP1	105031164	105031280	0	117	0	3706	0	3589	0.0	0.0
chr11	CASP1	105033063	105033126	0	64	0	3706	0	3642	0.0	0.0
chr11	CARD16	105043482	105043545	0	64	0	1212	0	1148	0.0	0.0
chr11	KBTBD3	106058864	106059109	0	246	51	4712	51	4466	0.0	0.01141961486789073
chr11	KBTBD3	106076506	106076707	0	202	51	4712	51	4510	0.0	0.01130820399113082
chr11	GUCY1A2	106746550	106746643	0	94	1071	16316	1071	16222	0.0	0.06602145234866232
chr11	GUCY1A2	106936649	106936712	0	64	1071	16316	1071	16252	0.0	0.06589958158995816
chr11	CWF19L2	107345413	107345490	0	78	2151	3600	2151	3522	0.0	0.610732538330494
chr11	ALKBH8	107549752	107549823	0	72	0	4215	0	4143	0.0	0.0
chr11	SLN	107711962	107712162	0	201	0	909	0	708	0.0	0.0
chr11	SLC35F2	107804717	107804770	0	54	763	3496	763	3442	0.0	0.22167344567112143
chr11	SLC35F2	107815789	107815965	84	177	763	3496	679	3319	0.4745762711864407	0.20457969267851764
chr11	SLC35F2	107840666	107840750	0	85	763	3496	763	3411	0.0	0.2236880680152448
chr11	NPAT	108208420	108208584	0	165	13280	7108	13280	6943	0.0	1.9127178453118248
chr11	C11ORF65	108407095	108407149	0	55	6794	3784	6794	3729	0.0	1.821936175918477
chr11	C11ORF65	108462547	108462640	0	94	6794	3784	6794	3690	0.0	1.8411924119241192
chr11	C11ORF65	108431745	108431838	0	94	6794	3784	6794	3690	0.0	1.8411924119241192
chr11	POGLUT3	108479300	108479495	0	196	0	4948	0	4752	0.0	0.0
chr11	POGLUT3	108478023	108478140	0	118	0	4948	0	4830	0.0	0.0
chr11	EXPH5	108528135	108528184	0	50	3737	10736	3737	10686	0.0	0.3497099008047913
chr11	RDX	110264778	110264874	0	97	1253	6114	1253	6017	0.0	0.20824331061991025
chr11	RDX	110286999	110287207	0	209	1253	6114	1253	5905	0.0	0.2121930567315834
chr11	RDX	110279680	110279756	0	77	1253	6114	1253	6037	0.0	0.20755342057313236
chr11	RDX	110181791	110181838	0	48	1253	6114	1253	6066	0.0	0.20656116056709528
chr11	RDX	110263959	110264234	0	276	1253	6114	1253	5838	0.0	0.2146282973621103
chr11	RDX	110200277	110200386	0	110	1253	6114	1253	6004	0.0	0.2086942038640906
chr11	RDX	110263331	110263435	0	105	1253	6114	1253	6009	0.0	0.20852055250457646
chr11	RDX	110272910	110273051	0	142	1253	6114	1253	5972	0.0	0.20981245813797722
chr11	RDX	110272910	110273033	0	124	1253	6114	1253	5990	0.0	0.20918196994991653
chr11	ARHGAP20	110712126	110712423	0	298	0	7144	0	6846	0.0	0.0
chr11	ARHGAP20	110690971	110691039	0	69	0	7144	0	7075	0.0	0.0
chr11	BTG4	111507834	111507918	0	85	335	1808	335	1723	0.0	0.19442832269297736
chr11	PPP2R1B	111753442	111753577	0	136	31825	6705	31825	6569	0.0	4.844725224539504
chr11	PPP2R1B	111764804	111764905	14	102	31825	6705	31811	6603	0.13725490196078433	4.817658640012116
chr11	PPP2R1B	111765293	111765384	0	92	31825	6705	31825	6613	0.0	4.812490548918796
chr11	ALG9	111853648	111853736	0	89	4268	7995	4268	7906	0.0	0.5398431570958766
chr11	ALG9	111857601	111857737	2316	137	4268	7995	1952	7858	16.905109489051096	0.24840926444387884
chr11	ALG9	111865180	111865251	0	72	4268	7995	4268	7923	0.0	0.5386848416004039
chr11	ALG9	111870231	111870370	0	140	4268	7995	4268	7855	0.0	0.5433481858688733
chr11	ALG9	111788440	111788569	0	130	4268	7995	4268	7865	0.0	0.5426573426573427
chr11	ALG9	111805093	111805315	0	223	4268	7995	4268	7772	0.0	0.5491507977354606
chr11	ALG9	111798093	111798195	57	103	4268	7995	4211	7892	0.5533980582524272	0.5335783071464775
chr11	ALG9	111871351	111871489	0	139	4268	7995	4268	7856	0.0	0.5432790224032586
chr11	FDXACB1	111878555	111878712	572	158	2259	3557	1687	3399	3.6202531645569622	0.49632244777875845
chr11	ALG9	111870227	111870370	0	144	4268	7995	4268	7851	0.0	0.5436250159215387
chr11	AP001781.2	111875697	111876104	0	408	3653	3366	3653	2958	0.0	1.2349560513860716
chr11	CRYAB	111912262	111912338	0	77	67289	3377	67289	3300	0.0	20.39060606060606
chr11	PIH1D2	112067794	112068005	153	212	2913	3232	2760	3020	0.7216981132075472	0.9139072847682119
chr11	TIMM8B	112085977	112086310	1311	334	1526	1169	215	835	3.9251497005988023	0.25748502994011974
chr11	IL18	112153591	112153603	0	13	0	1822	0	1809	0.0	0.0
chr11	DRD2	113414374	113414461	0	88	0	4125	0	4037	0.0	0.0
chr11	DRD2	113416862	113416999	0	138	0	4125	0	3987	0.0	0.0
chr11	DRD2	113413334	113413340	0	7	0	4125	0	4118	0.0	0.0
chr11	DRD2	113474229	113474415	0	187	0	4125	0	3938	0.0	0.0
chr11	TMPRSS5	113689764	113689917	0	154	27126	2681	27126	2527	0.0	10.734467748318163
chr11	TMPRSS5	113699961	113700168	15531	208	27126	2681	11595	2473	74.66826923076923	4.688637282652649
chr11	TMPRSS5	113698904	113699027	612	124	27126	2681	26514	2557	4.935483870967742	10.369182635901447
chr11	TMPRSS5	113700065	113700168	357	104	27126	2681	26769	2577	3.4326923076923075	10.38766006984866
chr11	TMPRSS5	113699594	113699693	1066	100	27126	2681	26060	2581	10.66	10.09686168151879
chr11	USP28	113806488	113806584	0	97	75	5659	75	5562	0.0	0.01348435814455232
chr11	USP28	113817657	113817837	0	181	75	5659	75	5478	0.0	0.013691128148959474
chr11	USP28	113831919	113831993	0	75	75	5659	75	5584	0.0	0.013431232091690544
chr11	USP28	113834248	113834335	0	88	75	5659	75	5571	0.0	0.013462574044157244
chr11	USP28	113831919	113831989	0	71	75	5659	75	5588	0.0	0.013421617752326413
chr11	USP28	113835206	113835327	0	122	75	5659	75	5537	0.0	0.013545241105291674
chr11	USP28	113808022	113808136	0	115	75	5659	75	5544	0.0	0.013528138528138528
chr11	USP28	113828843	113828920	0	78	75	5659	75	5581	0.0	0.013438451890342233
chr11	USP28	113874516	113874800	0	285	75	5659	75	5374	0.0	0.013956084852995905
chr11	USP28	113874516	113874879	0	364	75	5659	75	5295	0.0	0.014164305949008499
chr11	NXPE1	114551973	114552085	0	113	0	4399	0	4286	0.0	0.0
chr11	NXPE1	114528795	114528832	0	38	0	4399	0	4361	0.0	0.0
chr11	CADM1	115190887	115190941	0	55	0	10877	0	10822	0.0	0.0
chr11	CADM1	115209573	115209657	0	85	0	10877	0	10792	0.0	0.0
chr11	CADM1	115198405	115198438	0	34	0	10877	0	10843	0.0	0.0
chr11	CADM1	115445760	115445836	0	77	0	10877	0	10800	0.0	0.0
chr11	LINC00900	115758806	115758906	0	101	0	5016	0	4915	0.0	0.0
chr11	ZPR1	116782157	116782244	0	88	276	5417	276	5329	0.0	0.05179208106586602
chr11	ZPR1	116785098	116785146	0	49	276	5417	276	5368	0.0	0.05141579731743666
chr11	ZPR1	116787481	116787643	0	163	276	5417	276	5254	0.0	0.0525314046440807
chr11	ZPR1	116787481	116787602	0	122	276	5417	276	5295	0.0	0.05212464589235127
chr11	APOA1	116837000	116837157	0	158	0	980	0	822	0.0	0.0
chr11	SIK3	116861273	116861383	0	111	6548	6921	6548	6810	0.0	0.9615271659324522
chr11	SIK3	116867945	116868089	0	145	6548	6921	6548	6776	0.0	0.9663518299881936
chr11	SIK3	116875865	116876009	0	145	6548	6921	6548	6776	0.0	0.9663518299881936
chr11	SIK3	116950132	116950256	0	125	6548	6921	6548	6796	0.0	0.9635079458505003
chr11	PCSK7	117207066	117207160	79	95	126985	20140	126906	20045	0.8315789473684211	6.331055125966575
chr11	PCSK7	117230348	117230468	70	121	126985	20140	126915	20019	0.5785123966942148	6.339727259103851
chr11	PCSK7	117231126	117231217	0	92	126985	20140	126985	20048	0.0	6.334048284118117
chr11	BACE1	117291711	117291813	0	103	1224	7202	1224	7099	0.0	0.17241865051415692
chr11	FXYD2	117822405	117822480	0	76	51	3961	51	3885	0.0	0.013127413127413128
chr11	FXYD6	117840318	117840368	0	51	0	4097	0	4046	0.0	0.0
chr11	FXYD6	117841147	117841184	0	38	0	4097	0	4059	0.0	0.0
chr11	FXYD6	117858210	117858286	0	77	0	4097	0	4020	0.0	0.0
chr11	FXYD6	117844109	117844206	0	98	0	4097	0	3999	0.0	0.0
chr11	FXYD6	117840343	117840368	0	26	0	4097	0	4071	0.0	0.0
chr11	FXYD6	117840236	117840368	0	133	0	4097	0	3964	0.0	0.0
chr11	TMPRSS13	117911767	117911860	0	94	51	5382	51	5288	0.0	0.009644478063540091
chr11	TMPRSS13	117917169	117917274	0	106	51	5382	51	5276	0.0	0.009666413949962092
chr11	TMPRSS13	117918408	117918838	0	431	51	5382	51	4951	0.0	0.010300949303171077
chr11	SCN2B	118170318	118170422	0	105	0	5359	0	5254	0.0	0.0
chr11	JAML	118214823	118214886	0	64	153	6176	153	6112	0.0	0.025032722513089006
chr11	MPZL3	118237049	118237260	357	212	9755	3989	9398	3777	1.6839622641509433	2.4882181625628808
chr11	CD3D	118339774	118339906	51	133	3643	775	3592	642	0.38345864661654133	5.595015576323988
chr11	CD3D	118340374	118340593	0	220	3643	775	3643	555	0.0	6.563963963963964
chr11	AP001267.3	118527468	118527575	3727	108	5520	2698	1793	2590	34.50925925925926	0.6922779922779922
chr11	IFT46	118545408	118545494	0	87	51	3589	51	3502	0.0	0.014563106796116505
chr11	IFT46	118557737	118557890	0	154	51	3589	51	3435	0.0	0.014847161572052401
chr11	IFT46	118565789	118565917	0	129	51	3589	51	3460	0.0	0.014739884393063583
chr11	TREH	118661636	118661729	258	94	2797	3196	2539	3102	2.74468085106383	0.8185041908446163
chr11	TREH	118663338	118663439	455	102	2797	3196	2342	3094	4.46078431372549	0.7569489334195216
chr11	BCL9L	118903235	118903452	0	218	911886	10481	911886	10263	0.0	88.85179771996492
chr11	SLC37A4	119026602	119026688	0	87	2425	4259	2425	4172	0.0	0.5812559923298178
chr11	SLC37A4	119027627	119027872	263	246	2425	4259	2162	4013	1.0691056910569106	0.5387490655370047
chr11	SLC37A4	119028193	119028426	51	234	2425	4259	2374	4025	0.21794871794871795	0.5898136645962733
chr11	SLC37A4	119030231	119030735	0	505	2425	4259	2425	3754	0.0	0.6459776238678743
chr11	SLC37A4	119025691	119025757	0	67	2425	4259	2425	4192	0.0	0.5784828244274809
chr11	SLC37A4	119030547	119030735	0	189	2425	4259	2425	4070	0.0	0.5958230958230958
chr11	SLC37A4	119027627	119027770	263	144	2425	4259	2162	4115	1.8263888888888888	0.5253948967193196
chr11	SLC37A4	119028734	119028834	0	101	2425	4259	2425	4158	0.0	0.5832130832130832
chr11	HYOU1	119049017	119049203	888	187	43386	6178	42498	5991	4.748663101604278	7.093640460691036
chr11	HYOU1	119055749	119055843	0	95	43386	6178	43386	6083	0.0	7.1323360184119675
chr11	HYOU1	119056278	119056418	0	141	43386	6178	43386	6037	0.0	7.186682126884214
chr11	HYOU1	119049017	119049370	1048	354	43386	6178	42338	5824	2.9604519774011298	7.269574175824176
chr11	HYOU1	119056069	119056167	0	99	43386	6178	43386	6079	0.0	7.137029116631025
chr11	HYOU1	119056278	119056405	0	128	43386	6178	43386	6050	0.0	7.171239669421488
chr11	DPAGT1	119097854	119098043	0	190	1117	3974	1117	3784	0.0	0.2951902748414376
chr11	DPAGT1	119100629	119100843	0	215	1117	3974	1117	3759	0.0	0.2971534982708167
chr11	DPAGT1	119101017	119101138	63	122	1117	3974	1054	3852	0.5163934426229508	0.2736240913811007
chr11	DPAGT1	119097141	119097297	0	157	1117	3974	1117	3817	0.0	0.292638197537333
chr11	DPAGT1	119100629	119100877	0	249	1117	3974	1117	3725	0.0	0.2998657718120805
chr11	DPAGT1	119100629	119100750	0	122	1117	3974	1117	3852	0.0	0.28997923156801664
chr11	DPAGT1	119100629	119100827	0	199	1117	3974	1117	3775	0.0	0.2958940397350993
chr11	DPAGT1	119097854	119097925	0	72	1117	3974	1117	3902	0.0	0.28626345463864683
chr11	DPAGT1	119101017	119101047	9	31	1117	3974	1108	3943	0.2903225806451613	0.28100431143799137
chr11	MCAM	119310348	119310466	0	119	880	6707	880	6588	0.0	0.13357619914996965
chr11	MCAM	119315138	119315263	0	126	880	6707	880	6581	0.0	0.13371827989667223
chr11	C1QTNF5	119340183	119340440	0	258	1256	1540	1256	1282	0.0	0.9797191887675507
chr11	MFRP	119341856	119341984	0	129	318	4110	318	3981	0.0	0.07987942727957799
chr11	MFRP	119346271	119346374	0	104	318	4110	318	4006	0.0	0.07938092860708937
chr11	C1QTNF5	119340291	119340440	0	150	1256	1540	1256	1390	0.0	0.9035971223021583
chr11	USP2	119372706	119373521	0	816	1013	4538	1013	3722	0.0	0.2721655024180548
chr11	THY1	119420868	119420929	0	62	51	2543	51	2481	0.0	0.020556227327690448
chr11	TRIM29	120116958	120117057	0	100	0	7755	0	7655	0.0	0.0
chr11	TRIM29	120113536	120113655	0	120	0	7755	0	7635	0.0	0.0
chr11	AP001150.1	120265326	120265440	0	115	204	2609	204	2494	0.0	0.0817963111467522
chr11	MIR100HG	122032257	122032310	0	54	1420	24445	1420	24391	0.0	0.058218195235947685
chr11	MIR100HG	122040216	122040249	0	34	1420	24445	1420	24411	0.0	0.05817049690713203
chr11	MIR100HG	122038026	122038243	81	218	1420	24445	1339	24227	0.37155963302752293	0.05526891484707145
chr11	MIR100HG	122033313	122033462	784	150	1420	24445	636	24295	5.226666666666667	0.02617822597242231
chr11	MIR100HG	122066135	122066434	0	300	1420	24445	1420	24145	0.0	0.05881134810519777
chr11	MIR100HG	122067382	122067511	0	130	1420	24445	1420	24315	0.0	0.05840016450750565
chr11	MIR100HG	122034282	122034411	0	130	1420	24445	1420	24315	0.0	0.05840016450750565
chr11	MIR100HG	122064179	122066434	51	2256	1420	24445	1369	22189	0.022606382978723406	0.06169723736986795
chr11	MIR100HG	122100373	122101167	0	795	1420	24445	1420	23650	0.0	0.06004228329809725
chr11	MIR100HG	122100373	122100406	0	34	1420	24445	1420	24411	0.0	0.05817049690713203
chr11	MIR100HG	122155550	122155632	0	83	1420	24445	1420	24362	0.0	0.05828749692143502
chr11	MIR100HG	122100373	122101029	0	657	1420	24445	1420	23788	0.0	0.05969396334286195
chr11	MIR100HG	122180335	122180398	0	64	1420	24445	1420	24381	0.0	0.05824207374594972
chr11	MIR100HG	122202763	122202909	0	147	1420	24445	1420	24298	0.0	0.05844102395258869
chr11	MIR100HG	122189453	122189525	0	73	1420	24445	1420	24372	0.0	0.05826358115870671
chr11	MIR100HG	122292283	122292403	0	121	1420	24445	1420	24324	0.0	0.05837855615852656
chr11	MIR100HG	122293306	122293606	0	301	1420	24445	1420	24144	0.0	0.05881378396288933
chr11	MIR100HG	122116132	122116323	0	192	1420	24445	1420	24253	0.0	0.05854945779903517
chr11	MIR100HG	122234280	122234375	0	96	1420	24445	1420	24349	0.0	0.058318616780976634
chr11	MIR100HG	122384365	122384621	0	257	1420	24445	1420	24188	0.0	0.05870679675872333
chr11	HSPA8	123060592	123060798	867	207	17786	4221	16919	4014	4.188405797101449	4.214997508719482
chr11	HSPA8	123060592	123060675	0	84	17786	4221	17786	4137	0.0	4.299250664732898
chr11	SCN3B	123633111	123633776	0	666	51	7226	51	6560	0.0	0.007774390243902439
chr11	SCN3B	123638776	123638829	0	54	51	7226	51	7172	0.0	0.007110987172336865
chr11	SCN3B	123641341	123641817	0	477	51	7226	51	6749	0.0	0.007556675062972292
chr11	ZNF202	123740392	123740536	20	145	428	4708	408	4563	0.13793103448275862	0.08941485864562787
chr11	ZNF202	123740116	123740232	0	117	428	4708	428	4591	0.0	0.09322587671531257
chr11	ZNF202	123739433	123739543	0	111	428	4708	428	4597	0.0	0.09310419839025451
chr11	OR10N1P	124108233	124108407	51	175	51	1347	0	1172	0.2914285714285714	0.0
chr11	ESAM	124756206	124756362	510	157	27441	2750	26931	2593	3.248407643312102	10.386039336675665
chr11	MSANTD2	124774718	124774974	0	257	5975	4540	5975	4283	0.0	1.395050198459024
chr11	MSANTD2	124774718	124774818	0	101	5975	4540	5975	4439	0.0	1.3460238792520838
chr11	MSANTD2	124774718	124774831	0	114	5975	4540	5975	4426	0.0	1.349977406235879
chr11	TMEM218	125101443	125101521	0	79	0	4681	0	4602	0.0	0.0
chr11	TMEM218	125110643	125110746	0	104	0	4681	0	4577	0.0	0.0
chr11	TMEM218	125110490	125110549	0	60	0	4681	0	4621	0.0	0.0
chr11	TMEM218	125102131	125102317	0	187	0	4681	0	4494	0.0	0.0
chr11	TMEM218	125102131	125102302	0	172	0	4681	0	4509	0.0	0.0
chr11	FEZ1	125463483	125463570	2256	88	1524623	9010	1522367	8922	25.636363636363637	170.63068818650527
chr11	FEZ1	125460497	125460666	0	170	1524623	9010	1524623	8840	0.0	172.46866515837104
chr11	FEZ1	125469048	125469156	0	109	1524623	9010	1524623	8901	0.0	171.28670935849905
chr11	PATE2	125777873	125778002	0	130	51	1670	51	1540	0.0	0.033116883116883114
chr11	PUS3	125895906	125896330	0	425	0	2015	0	1590	0.0	0.0
chr11	PUS3	125900678	125900844	0	167	0	2015	0	1848	0.0	0.0
chr11	CDON	126010810	126010918	0	109	604	10623	604	10514	0.0	0.0574472132394902
chr11	SRPRA	126268002	126268086	0	85	2932	4160	2932	4075	0.0	0.7195092024539878
chr11	KIRREL3	126435267	126435303	0	37	0	6615	0	6578	0.0	0.0
chr11	ETS1	128480190	128480451	0	262	0	7163	0	6901	0.0	0.0
chr11	KCNJ1	128850720	128850890	0	171	87325	4642	87325	4471	0.0	19.53142473719526
chr11	KCNJ1	128866522	128866655	0	134	87325	4642	87325	4508	0.0	19.37111801242236
chr11	ARHGAP32	129123887	129123929	0	43	88	11572	88	11529	0.0	0.007632925665712551
chr11	NFRKB	129893296	129893385	0	90	6409	6363	6409	6273	0.0	1.021680216802168
chr11	NFRKB	129893061	129893101	0	41	6409	6363	6409	6322	0.0	1.0137614678899083
chr11	PRDM10	129912084	129912225	0	142	3983	6649	3983	6507	0.0	0.6121100353465498
chr11	PRDM10	129929409	129929421	0	13	3983	6649	3983	6636	0.0	0.6002109704641351
chr11	PRDM10	129955511	129955571	1394	61	3983	6649	2589	6588	22.852459016393443	0.3929872495446266
chr11	PRDM10	129912123	129912225	0	103	3983	6649	3983	6546	0.0	0.608463183623587
chr11	ZBTB44	130236109	130236216	0	108	153	9568	153	9460	0.0	0.016173361522198733
chr11	SNX19	130880621	130880806	0	186	51	15366	51	15180	0.0	0.0033596837944664033
chr11	SNX19	130907952	130908083	0	132	51	15366	51	15234	0.0	0.00334777471445451
chr11	SNX19	130914693	130914749	0	57	51	15366	51	15309	0.0	0.003331373701744072
chr11	OPCML	132435158	132435185	0	28	0	7595	0	7567	0.0	0.0
chr11	OPCML	132942925	132943010	0	86	0	7595	0	7509	0.0	0.0
chr11	NCAPD3	134216935	134217098	0	164	1385	11001	1385	10837	0.0	0.12780289748085263
chr11	NCAPD3	134183012	134183153	0	142	1385	11001	1385	10859	0.0	0.12754397274150475
chr11	THYN1	134248808	134248959	0	152	0	1816	0	1664	0.0	0.0
chr12	IQSEC3	125632	125912	0	281	680	4806	680	4525	0.0	0.15027624309392265
chr12	CCDC77	405510	405564	0	55	3801	3567	3801	3512	0.0	1.0822892938496582
chr12	CCDC77	409367	409421	0	55	3801	3567	3801	3512	0.0	1.0822892938496582
chr12	NINJ2-AS1	632774	632957	0	184	51	4365	51	4181	0.0	0.012198038746711314
chr12	WNK1	871264	871348	0	85	12640	16067	12640	15982	0.0	0.790889750969841
chr12	WNK1	879572	880031	0	460	12640	16067	12640	15607	0.0	0.8098929967322356
chr12	WNK1	882942	883059	0	118	12640	16067	12640	15949	0.0	0.7925261771897925
chr12	WNK1	867865	869104	51	1240	12640	16067	12589	14827	0.04112903225806452	0.8490591488500708
chr12	WNK1	901560	901632	0	73	12640	16067	12640	15994	0.0	0.7902963611354258
chr12	WNK1	865109	865364	1994	256	12640	16067	10646	15811	7.7890625	0.6733286952121941
chr12	WNK1	880720	880999	0	280	12640	16067	12640	15787	0.0	0.8006587698739469
chr12	WNK1	904452	904494	0	43	12640	16067	12640	16024	0.0	0.7888167748377434
chr12	ERC1	1263033	1263165	0	133	28231	12243	28231	12110	0.0	2.33121387283237
chr12	ERC1	1112214	1112298	0	85	28231	12243	28231	12158	0.0	2.322010199045896
chr12	ERC1	1027422	1027539	492	118	28231	12243	27739	12125	4.169491525423729	2.2877525773195875
chr12	ERC1	1204500	1204512	0	13	28231	12243	28231	12230	0.0	2.308340147179068
chr12	ERC1	1410388	1410453	102	66	28231	12243	28129	12177	1.5454545454545454	2.3100106758643344
chr12	ERC1	1480842	1480898	0	57	28231	12243	28231	12186	0.0	2.316674872804858
chr12	WNT5B	1639683	1639976	585	294	7053	3765	6468	3471	1.989795918367347	1.8634399308556613
chr12	CACNA1C	2648474	2648507	0	34	41248	19162	41248	19128	0.0	2.1564199079882895
chr12	CACNA1C	2681949	2682054	0	106	41248	19162	41248	19056	0.0	2.1645675902602854
chr12	CACNA1C	2597229	2597289	0	61	41248	19162	41248	19101	0.0	2.159468090675881
chr12	CACNA1C	2597436	2597496	11	61	41248	19162	41237	19101	0.18032786885245902	2.158892204596618
chr12	CACNA1C	2633628	2633712	0	85	41248	19162	41248	19077	0.0	2.1621848298998794
chr12	CACNA1C	2634296	2634380	22	85	41248	19162	41226	19077	0.25882352941176473	2.1610316087435133
chr12	CACNA1C	2547449	2547524	0	76	41248	19162	41248	19086	0.0	2.1611652520171853
chr12	CACNA1C	2680362	2680575	0	214	41248	19162	41248	18948	0.0	2.1769052142706355
chr12	FKBP4	2796264	2796368	0	105	38727	2595	38727	2490	0.0	15.553012048192771
chr12	ITFG2	2840841	2840995	0	155	177	6111	177	5956	0.0	0.029717931497649428
chr12	RHNO1	2885262	2885534	0	273	0	2529	0	2256	0.0	0.0
chr12	RHNO1	2885282	2885492	0	211	0	2529	0	2318	0.0	0.0
chr12	RHNO1	2885161	2885534	0	374	0	2529	0	2155	0.0	0.0
chr12	RHNO1	2877932	2878113	0	182	0	2529	0	2347	0.0	0.0
chr12	RHNO1	2886977	2887111	0	135	0	2529	0	2394	0.0	0.0
chr12	RHNO1	2885282	2885534	0	253	0	2529	0	2276	0.0	0.0
chr12	TULP3	2920762	2920922	0	161	46562	2658	46562	2497	0.0	18.64717661193432
chr12	TULP3	2930905	2930939	2007	35	46562	2658	44555	2623	57.34285714285714	16.986275257338924
chr12	TULP3	2933417	2933530	27556	114	46562	2658	19006	2544	241.71929824561403	7.470911949685535
chr12	TULP3	2937630	2937729	21	100	46562	2658	46541	2558	0.21	18.19429241594996
chr12	TULP3	2930247	2930345	0	99	46562	2658	46562	2559	0.0	18.19538882375928
chr12	TULP3	2940021	2940081	178	61	46562	2658	46384	2597	2.918032786885246	17.860608394301117
chr12	TEAD4	2994737	2994992	281	256	16150	2289	15869	2033	1.09765625	7.805705853418593
chr12	TEAD4	3011003	3011068	49	66	16150	2289	16101	2223	0.7424242424242424	7.242914979757085
chr12	TEAD4	3017397	3017526	81	130	16150	2289	16069	2159	0.6230769230769231	7.442797591477536
chr12	TEAD4	3017062	3017095	0	34	16150	2289	16150	2255	0.0	7.1618625277161865
chr12	TSPAN9	3083652	3083719	0	68	857	6917	857	6849	0.0	0.12512775587677033
chr12	TSPAN9	3206279	3206418	0	140	857	6917	857	6777	0.0	0.1264571344252619
chr12	TSPAN9	3201176	3201256	0	81	857	6917	857	6836	0.0	0.12536571094207138
chr12	AC084375.1	4020979	4021081	0	103	0	1060	0	957	0.0	0.0
chr12	CCND2	4285274	4285316	0	43	0	7998	0	7955	0.0	0.0
chr12	RAD51AP1	4546308	4546418	0	111	0	2491	0	2380	0.0	0.0
chr12	RAD51AP1	4556352	4556550	0	199	0	2491	0	2292	0.0	0.0
chr12	RAD51AP1	4545781	4545832	0	52	0	2491	0	2439	0.0	0.0
chr12	RAD51AP1	4556352	4556502	0	151	0	2491	0	2340	0.0	0.0
chr12	RAD51AP1	4545218	4545312	0	95	0	2491	0	2396	0.0	0.0
chr12	DYRK4	4607326	4607387	36	62	9867	7067	9831	7005	0.5806451612903226	1.403426124197002
chr12	DYRK4	4573329	4573356	0	28	9867	7067	9867	7039	0.0	1.401761613865606
chr12	DYRK4	4580823	4580977	0	155	9867	7067	9867	6912	0.0	1.4275173611111112
chr12	NDUFA9	4662532	4662635	2827	104	22580	9831	19753	9727	27.182692307692307	2.0307391796031666
chr12	AC005833.1	4685258	4685325	0	68	20756	3979	20756	3911	0.0	5.307082587573511
chr12	AC005906.2	5023523	5023621	0	99	0	7869	0	7770	0.0	0.0
chr12	AC005906.2	4979689	4979775	0	87	0	7869	0	7782	0.0	0.0
chr12	AC005906.2	5021687	5021768	0	82	0	7869	0	7787	0.0	0.0
chr12	AC005906.2	5018301	5018381	0	81	0	7869	0	7788	0.0	0.0
chr12	CD9	6200421	6200565	0	145	0	4900	0	4755	0.0	0.0
chr12	CD9	6200383	6200565	0	183	0	4900	0	4717	0.0	0.0
chr12	CD9	6200892	6200973	0	82	0	4900	0	4818	0.0	0.0
chr12	CD9	6232936	6233005	0	70	0	4900	0	4830	0.0	0.0
chr12	CD9	6205958	6206084	0	127	0	4900	0	4773	0.0	0.0
chr12	LTBR	6386065	6386162	0	98	51	5914	51	5816	0.0	0.008768913342503439
chr12	LTBR	6388397	6388505	0	109	51	5914	51	5805	0.0	0.008785529715762274
chr12	LTBR	6387797	6387910	0	114	51	5914	51	5800	0.0	0.008793103448275863
chr12	TAPBPL	6458644	6458947	0	304	51	3198	51	2894	0.0	0.017622667588113337
chr12	TAPBPL	6453066	6453297	0	232	51	3198	51	2966	0.0	0.017194875252865813
chr12	NCAPD2	6510074	6510133	41	60	73536	6409	73495	6349	0.6833333333333333	11.57583871475823
chr12	COPS7A	6724613	6724818	0	206	255	2633	255	2427	0.0	0.10506798516687268
chr12	COPS7A	6730668	6730820	0	153	255	2633	255	2480	0.0	0.1028225806451613
chr12	COPS7A	6727925	6728001	0	77	255	2633	255	2556	0.0	0.09976525821596244
chr12	COPS7A	6725864	6725959	0	96	255	2633	255	2537	0.0	0.10051241623965314
chr12	COPS7A	6727670	6727800	0	131	255	2633	255	2502	0.0	0.10191846522781775
chr12	COPS7A	6725647	6725757	102	111	255	2633	153	2522	0.918918918918919	0.060666137985725614
chr12	CD4	6799537	6799623	0	87	1531	3864	1531	3777	0.0	0.4053481599152767
chr12	CD4	6800306	6800471	614	166	1531	3864	917	3698	3.6987951807228914	0.24797187669010276
chr12	CD4	6800071	6800187	837	117	1531	3864	694	3747	7.153846153846154	0.18521483853749665
chr12	CD4	6798879	6799074	0	196	1531	3864	1531	3668	0.0	0.4173936750272628
chr12	GPR162	6823467	6823763	0	297	69	2902	69	2605	0.0	0.026487523992322456
chr12	GPR162	6823467	6824765	0	1299	69	2902	69	1603	0.0	0.043044291952588895
chr12	P3H3	6833741	6833809	10190	69	159943	3979	149753	3910	147.68115942028984	38.3
chr12	P3H3	6833743	6833809	10044	67	159943	3979	149899	3912	149.91044776119404	38.317740286298566
chr12	P3H3	6833745	6833809	9902	65	159943	3979	150041	3914	152.33846153846153	38.33444047010731
chr12	GNB3	6840868	6841033	40809	166	344104	2973	303295	2807	245.83734939759037	108.04951905949412
chr12	GNB3	6841772	6841903	51	132	344104	2973	344053	2841	0.38636363636363635	121.10278071101725
chr12	RPL13P5	6882195	6882327	0	133	12391	1337	12391	1204	0.0	10.291528239202657
chr12	LRRC23	6905844	6905954	0	111	644	3064	644	2953	0.0	0.21808330511344395
chr12	LRRC23	6912729	6913027	0	299	644	3064	644	2765	0.0	0.23291139240506328
chr12	LRRC23	6907314	6907445	0	132	644	3064	644	2932	0.0	0.21964529331514324
chr12	LRRC23	6909889	6910026	0	138	644	3064	644	2926	0.0	0.22009569377990432
chr12	ENO2	6922055	6922164	0	110	50	3883	50	3773	0.0	0.013252054068380599
chr12	C12ORF57	6944106	6944173	206	68	39744	1715	39538	1647	3.0294117647058822	24.006071645415908
chr12	PTPN6	6951463	6951520	0	58	435502	4799	435502	4741	0.0	91.85867960345918
chr12	PTPN6	6951608	6951731	602	124	435502	4799	434900	4675	4.854838709677419	93.02673796791444
chr12	EMG1	6975228	6975378	34224	151	4822006	6141	4787782	5990	226.64900662251657	799.2958263772955
chr12	EMG1	6983001	6983206	191	206	4822006	6141	4821815	5935	0.9271844660194175	812.4372367312552
chr12	C1S	7062474	7062682	0	209	66899	5258	66899	5049	0.0	13.249950485244604
chr12	C1RL-AS1	7110063	7110147	0	85	20420	6108	20420	6023	0.0	3.390337041341524
chr12	C1RL-AS1	7115385	7118677	6015	3293	20420	6108	14405	2815	1.8266018827816581	5.1172291296625225
chr12	PEX5	7199010	7199113	0	104	2178	5387	2178	5283	0.0	0.4122657580919932
chr12	PEX5	7190361	7190524	0	164	2178	5387	2178	5223	0.0	0.4170017231476163
chr12	PEX5	7190887	7190923	0	37	2178	5387	2178	5350	0.0	0.40710280373831775
chr12	PEX5	7190021	7190216	0	196	2178	5387	2178	5191	0.0	0.4195723367366596
chr12	PEX5	7202240	7202351	0	112	2178	5387	2178	5275	0.0	0.41289099526066353
chr12	PEX5	7190361	7190569	0	209	2178	5387	2178	5178	0.0	0.4206257242178447
chr12	PEX5	7212771	7212871	0	101	2178	5387	2178	5286	0.0	0.4120317820658343
chr12	NECAP1	8091768	8091850	0	83	1348	8370	1348	8287	0.0	0.16266441414263305
chr12	NECAP1	8092675	8092784	0	110	1348	8370	1348	8260	0.0	0.16319612590799032
chr12	NECAP1	8095600	8095703	0	104	1348	8370	1348	8266	0.0	0.163077667553835
chr12	NECAP1	8091839	8091850	0	12	1348	8370	1348	8358	0.0	0.16128260349365878
chr12	NECAP1	8094650	8094743	0	94	1348	8370	1348	8276	0.0	0.16288061865635572
chr12	CLEC4A	8129263	8129362	0	100	0	1287	0	1187	0.0	0.0
chr12	CLEC4A	8125560	8125677	0	118	0	1287	0	1169	0.0	0.0
chr12	CLEC4A	8135584	8135736	0	153	0	1287	0	1134	0.0	0.0
chr12	FAM66C	8187731	8188225	0	495	68343	4631	68343	4136	0.0	16.523936170212767
chr12	FAM66C	8193519	8193655	204	137	68343	4631	68139	4494	1.489051094890511	15.162216288384514
chr12	FAM66C	8195276	8195412	6979	137	68343	4631	61364	4494	50.941605839416056	13.654650645304852
chr12	RIMKLB	8699784	8700614	0	831	272	7829	272	6998	0.0	0.038868248070877395
chr12	AC092490.1	8789999	8790263	24	265	228	2265	204	2000	0.09056603773584905	0.102
chr12	PHC1	8919755	8919866	51	112	72809	5613	72758	5501	0.45535714285714285	13.226322486820578
chr12	PHC1	8935123	8935238	0	116	72809	5613	72809	5497	0.0	13.245224668000727
chr12	PHC1	8916060	8916069	0	10	72809	5613	72809	5603	0.0	12.994645725504194
chr12	PHC1	8921600	8921750	0	151	72809	5613	72809	5462	0.0	13.330098864884658
chr12	PHC1	8919755	8919917	51	163	72809	5613	72758	5450	0.3128834355828221	13.350091743119266
chr12	PHC1	8933206	8933350	25327	145	72809	5613	47482	5468	174.6689655172414	8.683613752743234
chr12	KLRG1	8995118	8995288	0	171	26	2466	26	2295	0.0	0.011328976034858388
chr12	KLRG1	8992205	8992310	0	106	26	2466	26	2360	0.0	0.011016949152542373
chr12	AC010175.1	9247580	9247677	0	98	102	1292	102	1194	0.0	0.08542713567839195
chr12	LINC02367	9394530	9394657	0	128	952	5657	952	5529	0.0	0.17218303490685477
chr12	LINC02367	9377559	9377610	0	52	952	5657	952	5605	0.0	0.16984834968777876
chr12	AC092821.3	9513559	9513634	0	76	35540	5997	35540	5921	0.0	6.002364465461915
chr12	AC092821.3	9656567	9656649	0	83	35540	5997	35540	5914	0.0	6.009469056476158
chr12	AC092821.3	9655124	9655303	0	180	35540	5997	35540	5817	0.0	6.1096785284510915
chr12	AC092821.3	9656567	9656697	0	131	35540	5997	35540	5866	0.0	6.058643027616775
chr12	AC092821.3	9655220	9655303	0	84	35540	5997	35540	5913	0.0	6.010485371215965
chr12	CLEC2D	9680922	9681033	0	112	102	6863	102	6751	0.0	0.015108872759591172
chr12	CLEC2D	9693033	9693115	0	83	102	6863	102	6780	0.0	0.01504424778761062
chr12	CLEC2D	9693415	9693948	51	534	102	6863	51	6329	0.09550561797752809	0.00805814504661084
chr12	CLEC2D	9692827	9692931	0	105	102	6863	102	6758	0.0	0.015093222846996152
chr12	CLEC2D	9680189	9680251	0	63	102	6863	102	6800	0.0	0.015
chr12	CLEC2D	9692827	9693948	102	1122	102	6863	0	5741	0.09090909090909091	0.0
chr12	CLEC2D	9693824	9693948	0	125	102	6863	102	6738	0.0	0.015138023152270703
chr12	KLRF1	9833302	9833452	1720	151	3362	1266	1642	1115	11.390728476821192	1.472645739910314
chr12	KLRF1	9842320	9842433	651	114	3362	1266	2711	1152	5.7105263157894735	2.353298611111111
chr12	KLRF1	9841811	9841951	0	141	3362	1266	3362	1125	0.0	2.9884444444444442
chr12	KLRF1	9842301	9842433	708	133	3362	1266	2654	1133	5.323308270676692	2.3424536628420123
chr12	CLEC12A	9978965	9979064	0	100	0	3258	0	3158	0.0	0.0
chr12	TMEM52B	10182549	10182593	0	45	0	3474	0	3429	0.0	0.0
chr12	GABARAPL1	10213835	10214187	0	353	0	3148	0	2795	0.0	0.0
chr12	GABARAPL1	10218062	10218141	0	80	0	3148	0	3068	0.0	0.0
chr12	GABARAPL1	10214668	10214779	0	112	0	3148	0	3036	0.0	0.0
chr12	GABARAPL1	10213835	10213974	0	140	0	3148	0	3008	0.0	0.0
chr12	KLRD1	10304465	10304547	0	83	204	15814	204	15731	0.0	0.012968024918949845
chr12	KLRD1	10309387	10309480	0	94	204	15814	204	15720	0.0	0.012977099236641221
chr12	KLRD1	10309625	10309688	0	64	204	15814	204	15750	0.0	0.012952380952380953
chr12	KLRK1-AS1	10374034	10374136	403	103	11933	3848	11530	3745	3.912621359223301	3.0787716955941256
chr12	LINC02366	10776511	10776801	63	291	349	966	286	675	0.21649484536082475	0.4237037037037037
chr12	LINC02366	10774805	10774866	0	62	349	966	349	904	0.0	0.3860619469026549
chr12	LINC02366	10775864	10775984	0	121	349	966	349	845	0.0	0.41301775147928993
chr12	LINC02366	10775888	10775984	0	97	349	966	349	869	0.0	0.4016110471806674
chr12	LINC02366	10775891	10775984	0	94	349	966	349	872	0.0	0.40022935779816515
chr12	BCL2L14	12068128	12068222	0	95	11	5083	11	4988	0.0	0.0022052927024859663
chr12	BCL2L14	12072224	12072499	0	276	11	5083	11	4807	0.0	0.002288329519450801
chr12	BCL2L14	12077705	12077978	0	274	11	5083	11	4809	0.0	0.0022873778332293615
chr12	BORCS5	12361205	12361349	0	145	51	6525	51	6380	0.0	0.00799373040752351
chr12	APOLD1	12726296	12726373	0	78	56026	7208	56026	7130	0.0	7.857784011220196
chr12	APOLD1	12812260	12812440	0	181	56026	7208	56026	7027	0.0	7.972961434467056
chr12	DDX47	12821207	12821396	0	190	8160	4034	8160	3844	0.0	2.1227887617065555
chr12	DDX47	12823869	12824016	0	148	8160	4034	8160	3886	0.0	2.0998455995882654
chr12	GPRC5A	12908242	12909171	5149	930	26318	7667	21169	6737	5.536559139784946	3.1421997921923706
chr12	GPRC5D-AS1	12978940	12979021	33422	82	88580	3432	55158	3350	407.5853658536585	16.465074626865672
chr12	GPRC5D-AS1	12966758	12966857	25	100	88580	3432	88555	3332	0.25	26.577130852340936
chr12	GPRC5D-AS1	12979999	12980391	50113	393	88580	3432	38467	3039	127.51399491094148	12.657782165185916
chr12	EMP1	13199177	13199533	0	357	10180	6588	10180	6231	0.0	1.6337666506178783
chr12	EMP1	13213478	13213575	0	98	10180	6588	10180	6490	0.0	1.568567026194145
chr12	EMP1	13211468	13211588	96	121	10180	6588	10084	6467	0.7933884297520661	1.5593010669553116
chr12	ATF7IP	14423908	14425473	0	1566	162	12643	162	11077	0.0	0.01462489843820529
chr12	ATF7IP	14457206	14457295	0	90	162	12643	162	12553	0.0	0.012905281605990599
chr12	ATF7IP	14369145	14369324	0	180	162	12643	162	12463	0.0	0.012998475487442832
chr12	ATF7IP	14420301	14420446	0	146	162	12643	162	12497	0.0	0.012963111146675203
chr12	C12ORF60	14829637	14829679	0	43	1392	4525	1392	4482	0.0	0.31057563587684067
chr12	PTPRO	15501619	15502063	0	445	51	18862	51	18417	0.0	0.002769180648314058
chr12	PTPRO	15551550	15551671	0	122	51	18862	51	18740	0.0	0.0027214514407684098
chr12	PTPRO	15560192	15560276	0	85	51	18862	51	18777	0.0	0.002716088832081802
chr12	PTPRO	15565592	15565628	0	37	51	18862	51	18825	0.0	0.0027091633466135457
chr12	PTPRO	15570088	15570135	0	48	51	18862	51	18814	0.0	0.0027107473158286383
chr12	PTPRO	15569099	15569284	0	186	51	18862	51	18676	0.0	0.0027307774684086528
chr12	STRAP	15883540	15883676	0	137	0	2226	0	2089	0.0	0.0
chr12	STRAP	15900946	15901012	0	67	0	2226	0	2159	0.0	0.0
chr12	STRAP	15883082	15883121	0	40	0	2226	0	2186	0.0	0.0
chr12	DERA	15982307	15982436	0	130	1868	2827	1868	2697	0.0	0.692621431219874
chr12	DERA	15916116	15916316	0	201	1868	2827	1868	2626	0.0	0.7113480578827114
chr12	DERA	15958187	15958335	0	149	1868	2827	1868	2678	0.0	0.6975354742345033
chr12	DERA	15911690	15911753	84	64	1868	2827	1784	2763	1.3125	0.6456749909518639
chr12	DERA	15958239	15958335	0	97	1868	2827	1868	2730	0.0	0.6842490842490843
chr12	MGST1	16357604	16357699	0	96	51	6231	51	6135	0.0	0.008312958435207823
chr12	MGST1	16354230	16354270	0	41	51	6231	51	6190	0.0	0.008239095315024232
chr12	MGST1	16354230	16354378	0	149	51	6231	51	6082	0.0	0.008385399539625124
chr12	AC092793.1	17069510	17069646	0	137	0	1632	0	1495	0.0	0.0
chr12	AC048352.1	17657281	17657357	0	77	0	4229	0	4152	0.0	0.0
chr12	PIK3C2G	18362763	18362886	0	124	0	6128	0	6004	0.0	0.0
chr12	PLEKHA5	19260948	19261021	45	74	45	12573	0	12499	0.6081081081081081	0.0
chr12	PLEKHA5	19270187	19270205	0	19	45	12573	45	12554	0.0	0.003584514895650789
chr12	PLEKHA5	19320020	19320056	0	37	45	12573	45	12536	0.0	0.003589661774090619
chr12	PLEKHA5	19346993	19347182	0	190	45	12573	45	12383	0.0	0.0036340143745457482
chr12	PLEKHA5	19314813	19314894	0	82	45	12573	45	12491	0.0	0.003602593867584661
chr12	AEBP2	19514670	19514784	0	115	1948	6279	1948	6164	0.0	0.31602855288773524
chr12	AEBP2	19515420	19515434	0	15	1948	6279	1948	6264	0.0	0.3109833971902937
chr12	AC024901.1	20008644	20008767	0	124	0	2765	0	2641	0.0	0.0
chr12	SLCO1C1	20715138	20715285	0	148	67590	4794	67590	4646	0.0	14.547998278088679
chr12	SLCO1B3	20813523	20813638	0	116	459	3560	459	3444	0.0	0.1332752613240418
chr12	AC022335.1	21089907	21089929	0	23	0	865	0	842	0.0	0.0
chr12	AC022335.1	21119603	21119627	0	25	0	865	0	840	0.0	0.0
chr12	IAPP	21373641	21373733	0	93	0	2157	0	2064	0.0	0.0
chr12	IAPP	21376322	21376364	0	43	0	2157	0	2114	0.0	0.0
chr12	PYROXD1	21441206	21441300	0	95	0	5425	0	5330	0.0	0.0
chr12	PYROXD1	21452080	21452154	0	75	0	5425	0	5350	0.0	0.0
chr12	PYROXD1	21456864	21457086	0	223	0	5425	0	5202	0.0	0.0
chr12	GOLT1B	21506884	21506976	0	93	204	3657	204	3564	0.0	0.05723905723905724
chr12	GOLT1B	21508382	21508561	0	180	204	3657	204	3477	0.0	0.058671268334771355
chr12	GOLT1B	21515237	21515270	0	34	204	3657	204	3623	0.0	0.05630692796025393
chr12	GOLT1B	21507943	21508109	0	167	204	3657	204	3490	0.0	0.05845272206303725
chr12	GOLT1B	21507116	21507151	0	36	204	3657	204	3621	0.0	0.056338028169014086
chr12	CMAS	22055148	22055291	0	144	51	1792	51	1648	0.0	0.030946601941747573
chr12	CMAS	22058566	22058700	0	135	51	1792	51	1657	0.0	0.030778515389257695
chr12	CMAS	22061280	22061452	0	173	51	1792	51	1619	0.0	0.03150092649783817
chr12	AC053513.1	22601351	22601470	0	120	363	1213	363	1093	0.0	0.3321134492223239
chr12	ETNK1	22682280	22682339	0	60	16633	13315	16633	13255	0.0	1.2548472274613354
chr12	ETNK1	22656431	22656745	0	315	16633	13315	16633	13000	0.0	1.2794615384615384
chr12	AC084816.1	22869320	22869413	0	94	34	6101	34	6007	0.0	0.005660063259530548
chr12	AC084816.1	22787559	22787720	0	162	34	6101	34	5939	0.0	0.005724869506650952
chr12	AC084816.1	23046107	23046201	0	95	34	6101	34	6006	0.0	0.005661005661005661
chr12	AC084816.1	23167038	23167078	0	41	34	6101	34	6060	0.0	0.005610561056105611
chr12	SOX5-AS1	24227710	24227818	0	109	0	3161	0	3052	0.0	0.0
chr12	SOX5-AS1	24230558	24230615	0	58	0	3161	0	3103	0.0	0.0
chr12	SOX5-AS1	24239879	24239998	0	120	0	3161	0	3041	0.0	0.0
chr12	AC023796.1	24771459	24771562	0	104	0	2536	0	2432	0.0	0.0
chr12	AC023796.1	24765597	24765691	0	95	0	2536	0	2441	0.0	0.0
chr12	AC023796.1	24760615	24760783	0	169	0	2536	0	2367	0.0	0.0
chr12	AC023796.1	24760129	24760194	0	66	0	2536	0	2470	0.0	0.0
chr12	IRAG2	25061591	25061653	0	63	1435	6459	1435	6396	0.0	0.22435897435897437
chr12	IRAG2	25066364	25066512	0	149	1435	6459	1435	6310	0.0	0.22741679873217116
chr12	IRAG2	25104360	25104462	0	103	1435	6459	1435	6356	0.0	0.22577092511013216
chr12	IRAG2	25062819	25062900	0	82	1435	6459	1435	6377	0.0	0.22502744237102085
chr12	IRAG2	25101937	25102025	912	89	1435	6459	523	6370	10.247191011235955	0.08210361067503924
chr12	ETFRF1	25203724	25203832	0	109	94	2377	94	2268	0.0	0.04144620811287478
chr12	ETFRF1	25203724	25203823	0	100	94	2377	94	2277	0.0	0.041282389108476064
chr12	RASSF8	25995036	25995130	0	95	1275	5419	1275	5324	0.0	0.2394815927873779
chr12	FGFR1OP2	26960514	26960628	0	115	153	5892	153	5777	0.0	0.02648433442963476
chr12	FGFR1OP2	26953548	26953706	0	159	153	5892	153	5733	0.0	0.026687598116169546
chr12	MED21	27026419	27026534	0	116	867	2970	867	2854	0.0	0.3037841625788367
chr12	MED21	27060826	27060993	867	168	867	2970	0	2802	5.160714285714286	0.0
chr12	STK38L	27308338	27308461	0	124	1680	6882	1680	6758	0.0	0.24859425865640722
chr12	STK38L	27312548	27312672	0	125	1680	6882	1680	6757	0.0	0.24863104928222585
chr12	STK38L	27297029	27297158	0	130	1680	6882	1680	6752	0.0	0.24881516587677724
chr12	STK38L	27300553	27300601	0	49	1680	6882	1680	6833	0.0	0.24586565198302357
chr12	ARNTL2	27376345	27376387	0	43	1734	7001	1734	6958	0.0	0.24920954297211842
chr12	ARNTL2	27418087	27418196	0	110	1734	7001	1734	6891	0.0	0.25163256421419244
chr12	ARNTL2	27370128	27370230	0	103	1734	7001	1734	6898	0.0	0.251377210785735
chr12	ARNTL2	27370167	27370230	0	64	1734	7001	1734	6937	0.0	0.24996396136658497
chr12	SMCO2	27475581	27475731	2396	151	4001	1987	1605	1836	15.867549668874172	0.8741830065359477
chr12	PPFIBP1	27647728	27647842	0	115	33707	11261	33707	11146	0.0	3.0241342185537414
chr12	PPFIBP1	27655142	27655235	612	94	33707	11261	33095	11167	6.51063829787234	2.9636428763320497
chr12	PPFIBP1	27674191	27674221	0	31	33707	11261	33707	11230	0.0	3.0015138023152272
chr12	PPFIBP1	27687384	27687507	0	124	33707	11261	33707	11137	0.0	3.026578073089701
chr12	PPFIBP1	27658815	27658848	0	34	33707	11261	33707	11227	0.0	3.002315845729046
chr12	PPFIBP1	27677063	27677096	0	34	33707	11261	33707	11227	0.0	3.002315845729046
chr12	MRPS35	27714779	27714820	0	42	1122	1939	1122	1897	0.0	0.5914602003162889
chr12	MRPS35	27735446	27735556	0	111	1122	1939	1122	1828	0.0	0.6137855579868708
chr12	MRPS35	27725576	27725667	0	92	1122	1939	1122	1847	0.0	0.607471575527883
chr12	KLHL42	27797246	27797349	0	104	78045	7360	78045	7256	0.0	10.755926130099228
chr12	CCDC91	28304625	28304711	0	87	0	7033	0	6946	0.0	0.0
chr12	CCDC91	28391303	28391411	0	109	0	7033	0	6924	0.0	0.0
chr12	CCDC91	28198942	28199056	0	115	0	7033	0	6918	0.0	0.0
chr12	CCDC91	28412753	28412938	0	186	0	7033	0	6847	0.0	0.0
chr12	CCDC91	28571216	28571263	0	48	0	7033	0	6985	0.0	0.0
chr12	CCDC91	28573239	28573338	0	100	0	7033	0	6933	0.0	0.0
chr12	FAR2	29270411	29270638	0	228	1122	5429	1122	5201	0.0	0.2157277446644876
chr12	FAR2	29293299	29293475	0	177	1122	5429	1122	5252	0.0	0.21363290175171362
chr12	FAR2	29291415	29291494	0	80	1122	5429	1122	5349	0.0	0.20975883342680876
chr12	FAR2	29332844	29332908	0	65	1122	5429	1122	5364	0.0	0.20917225950782997
chr12	AC010198.2	30798144	30798315	0	172	97577	18419	97577	18247	0.0	5.347563983120513
chr12	AC010198.2	30796982	30797210	0	229	97577	18419	97577	18190	0.0	5.364321055525013
chr12	TSPAN11	30953980	30954075	0	96	17025	7125	17025	7029	0.0	2.422108408023901
chr12	DDX11	31084582	31084669	102	88	102	7413	0	7325	1.1590909090909092	0.0
chr12	DDX11	31089402	31089490	0	89	102	7413	102	7324	0.0	0.013926815947569634
chr12	DDX11	31101832	31101982	0	151	102	7413	102	7262	0.0	0.01404571743321399
chr12	DDX11	31103316	31103395	0	80	102	7413	102	7333	0.0	0.013909723169234965
chr12	DDX11	31084968	31085126	0	159	102	7413	102	7254	0.0	0.014061207609594707
chr12	DDX11	31086024	31086212	0	189	102	7413	102	7224	0.0	0.014119601328903655
chr12	DDX11	31103321	31103395	0	75	102	7413	102	7338	0.0	0.013900245298446443
chr12	DDX11	31077944	31078288	0	345	102	7413	102	7068	0.0	0.014431239388794566
chr12	ETFBKMT	31666086	31666217	44	132	2084	6875	2040	6743	0.3333333333333333	0.3025359632211182
chr12	RESF1	31970188	31970356	0	169	51	6654	51	6485	0.0	0.007864302235929066
chr12	RESF1	31980877	31985957	51	5081	51	6654	0	1573	0.010037394213737453	0.0
chr12	RESF1	31987238	31987322	0	85	51	6654	51	6569	0.0	0.0077637387730248135
chr12	BICD1	32338785	32338979	32	195	3892	12614	3860	12419	0.1641025641025641	0.3108140752073436
chr12	FGD4	32576265	32576449	0	185	3865	7667	3865	7482	0.0	0.51657310879444
chr12	FGD4	32581959	32582467	0	509	3865	7667	3865	7158	0.0	0.5399552947750769
chr12	FGD4	32600409	32600509	0	101	3865	7667	3865	7566	0.0	0.5108379592915675
chr12	FGD4	32556873	32556995	0	123	3865	7667	3865	7544	0.0	0.5123276776246023
chr12	FGD4	32624658	32624751	0	94	3865	7667	3865	7573	0.0	0.5103657731414235
chr12	FGD4	32637649	32637855	0	207	3865	7667	3865	7460	0.0	0.5180965147453083
chr12	DNM1L	32707366	32707413	0	48	684	7139	684	7091	0.0	0.09646030179100268
chr12	DNM1L	32708152	32708224	0	73	684	7139	684	7066	0.0	0.09680158505519389
chr12	DNM1L	32710928	32711015	0	88	684	7139	684	7051	0.0	0.09700751666430293
chr12	DNM1L	32713208	32713371	0	164	684	7139	684	6975	0.0	0.09806451612903226
chr12	DNM1L	32718642	32718763	0	122	684	7139	684	7017	0.0	0.09747755451047456
chr12	DNM1L	32738263	32738296	0	34	684	7139	684	7105	0.0	0.09627023223082336
chr12	DNM1L	32705824	32705863	0	40	684	7139	684	7099	0.0	0.09635159881673475
chr12	DNM1L	32737864	32737942	0	79	684	7139	684	7060	0.0	0.09688385269121813
chr12	DNM1L	32706689	32706814	0	126	684	7139	684	7013	0.0	0.09753315271638385
chr12	DNM1L	32732537	32732610	0	74	684	7139	684	7065	0.0	0.09681528662420383
chr12	C12ORF40	39643778	39643917	0	140	0	4475	0	4335	0.0	0.0
chr12	C12ORF40	39684120	39684312	0	193	0	4475	0	4282	0.0	0.0
chr12	LRRK2	40240482	40240617	0	136	120	11039	120	10903	0.0	0.011006145097679538
chr12	LRRK2	40257247	40257377	0	131	120	11039	120	10908	0.0	0.011001100110011002
chr12	LRRK2	40227890	40227916	0	27	120	11039	120	11012	0.0	0.010897203051216855
chr12	LRRK2	40300812	40301064	0	253	120	11039	120	10786	0.0	0.011125533098460968
chr12	CNTN1	40910072	40910105	0	34	51	7523	51	7489	0.0	0.006809987982374149
chr12	CNTN1	40895949	40896109	0	161	51	7523	51	7362	0.0	0.0069274653626731865
chr12	CNTN1	40763095	40763198	0	104	51	7523	51	7419	0.0	0.006874241811564901
chr12	CNTN1	41061761	41061884	0	124	51	7523	51	7399	0.0	0.0068928233545073655
chr12	PDZRN4	41459950	41460070	0	121	250	4885	250	4764	0.0	0.05247691015952981
chr12	PDZRN4	41477864	41477920	51	57	250	4885	199	4828	0.8947368421052632	0.041217895608947806
chr12	LINC02400	41764737	41764806	0	70	0	1273	0	1203	0.0	0.0
chr12	PPHLN1	42351884	42352049	0	166	1122	8564	1122	8398	0.0	0.13360323886639677
chr12	PPHLN1	42384939	42384996	0	58	1122	8564	1122	8506	0.0	0.13190688925464378
chr12	PPHLN1	42332659	42332702	0	44	1122	8564	1122	8520	0.0	0.1316901408450704
chr12	PPHLN1	42374862	42375074	0	213	1122	8564	1122	8351	0.0	0.13435516704586278
chr12	PPHLN1	42374637	42374733	0	97	1122	8564	1122	8467	0.0	0.1325144679343333
chr12	PPHLN1	42374955	42375074	0	120	1122	8564	1122	8444	0.0	0.13287541449549975
chr12	LINC02450	42693827	42693931	0	105	1421	1477	1421	1372	0.0	1.0357142857142858
chr12	IRAK4	43768102	43768272	0	171	51	5626	51	5455	0.0	0.009349220898258478
chr12	IRAK4	43763301	43763456	0	156	51	5626	51	5470	0.0	0.009323583180987203
chr12	IRAK4	43771219	43771365	0	147	51	5626	51	5479	0.0	0.0093082679321044
chr12	IRAK4	43771037	43771104	0	68	51	5626	51	5558	0.0	0.009175962576466355
chr12	IRAK4	43760924	43760972	0	49	51	5626	51	5577	0.0	0.00914470145239376
chr12	TMEM117	43944209	43944342	0	134	2142	3451	2142	3317	0.0	0.6457642447995177
chr12	TMEM117	44143524	44143624	0	101	2142	3451	2142	3350	0.0	0.6394029850746269
chr12	TMEM117	44376594	44376724	0	131	2142	3451	2142	3320	0.0	0.6451807228915662
chr12	ANO6	45302013	45302093	0	81	2876	8262	2876	8181	0.0	0.3515462657376849
chr12	ANO6	45270461	45270524	0	64	2876	8262	2876	8198	0.0	0.35081727250548916
chr12	ANO6	45228167	45228273	2821	107	2876	8262	55	8155	26.364485981308412	0.00674432863274065
chr12	ARID2	45904341	45904398	0	58	1780	12025	1780	11967	0.0	0.1487423748642099
chr12	AC008014.1	46470152	46470262	0	111	11101	4863	11101	4752	0.0	2.3360690235690234
chr12	PCED1B	47216221	47216689	0	469	0	2624	0	2155	0.0	0.0
chr12	PCED1B	47223527	47223672	0	146	0	2624	0	2478	0.0	0.0
chr12	PCED1B	47223923	47224039	0	117	0	2624	0	2507	0.0	0.0
chr12	LINC02156	47405079	47405201	0	123	153	2804	153	2681	0.0	0.057068258112644536
chr12	LINC02156	47415083	47415232	0	150	153	2804	153	2654	0.0	0.05764883195177091
chr12	LINC02156	47408430	47408514	0	85	153	2804	153	2719	0.0	0.05627068775285031
chr12	LINC02156	47418184	47418272	0	89	153	2804	153	2715	0.0	0.056353591160221
chr12	AC004241.1	47717491	47717636	0	146	0	5115	0	4969	0.0	0.0
chr12	AC004241.1	47719599	47719699	0	101	0	5115	0	5014	0.0	0.0
chr12	LINC02354	47832153	47832337	0	185	51	950	51	765	0.0	0.06666666666666667
chr12	TMEM106C	47966088	47966172	0	85	357	3201	357	3116	0.0	0.11456996148908857
chr12	TMEM106C	47965837	47965997	0	161	357	3201	357	3040	0.0	0.1174342105263158
chr12	TMEM106C	47965281	47965345	0	65	357	3201	357	3136	0.0	0.11383928571428571
chr12	PFKM	48135290	48135383	0	94	1671	6825	1671	6731	0.0	0.2482543455652949
chr12	PFKM	48142781	48142946	0	166	1671	6825	1671	6659	0.0	0.25093857936627123
chr12	PFKM	48108071	48108194	0	124	1671	6825	1671	6701	0.0	0.2493657663035368
chr12	PFKM	48107364	48107455	0	92	1671	6825	1671	6733	0.0	0.24818060300014852
chr12	PFKM	48118481	48118577	0	97	1671	6825	1671	6728	0.0	0.24836504161712247
chr12	PFKM	48125324	48125562	126	239	1671	6825	1545	6586	0.5271966527196653	0.23458852110537504
chr12	PFKM	48132018	48132211	0	194	1671	6825	1671	6631	0.0	0.25199819031820236
chr12	C12ORF54	48489095	48489294	0	200	3164	1886	3164	1686	0.0	1.8766310794780545
chr12	C12ORF54	48495551	48495595	76	45	3164	1886	3088	1841	1.6888888888888889	1.6773492667028789
chr12	TEX49	48736087	48736172	449	86	740	667	291	581	5.22093023255814	0.5008605851979346
chr12	CACNB3	48823680	48823803	0	124	102	6342	102	6218	0.0	0.016403988420714055
chr12	CACNB3	48824257	48824373	0	117	102	6342	102	6225	0.0	0.0163855421686747
chr12	CACNB3	48824948	48824968	0	21	102	6342	102	6321	0.0	0.01613668723303275
chr12	CACNB3	48825162	48825243	0	82	102	6342	102	6260	0.0	0.016293929712460065
chr12	CACNB3	48824260	48824373	0	114	102	6342	102	6228	0.0	0.016377649325626204
chr12	CACNB3	48819635	48819942	0	308	102	6342	102	6034	0.0	0.01690420947961551
chr12	DDN-AS1	49009314	49009389	42	76	48	1408	6	1332	0.5526315789473685	0.0045045045045045045
chr12	DDN-AS1	49009308	49009389	48	82	48	1408	0	1326	0.5853658536585366	0.0
chr12	TUBA1C	49256396	49256511	0	116	27164	3750	27164	3634	0.0	7.474958723170061
chr12	TUBA1C	49257883	49258001	0	119	27164	3750	27164	3631	0.0	7.481134673643624
chr12	TROAP	49323844	49324037	17968	194	1269930	3637	1251962	3443	92.61855670103093	363.6253267499274
chr12	TROAP	49325500	49325658	8042	159	1269930	3637	1261888	3478	50.57861635220126	362.82001150086256
chr12	TROAP	49323844	49323946	7360	103	1269930	3637	1262570	3534	71.45631067961165	357.26372382569326
chr12	DNAJC22	49347643	49348105	0	463	9943	5151	9943	4688	0.0	2.1209470989761092
chr12	SPATS2	49454224	49454385	458	162	27818	6730	27360	6568	2.8271604938271606	4.165651644336175
chr12	SPATS2	49371227	49371290	0	64	27818	6730	27818	6666	0.0	4.173117311731173
chr12	SPATS2	49512861	49512905	0	45	27818	6730	27818	6685	0.0	4.161256544502618
chr12	SPATS2	49519072	49519182	0	111	27818	6730	27818	6619	0.0	4.202749660069497
chr12	SPATS2	49367519	49367587	0	69	27818	6730	27818	6661	0.0	4.176249812340489
chr12	SPATS2	49441729	49441816	2546	88	27818	6730	25272	6642	28.931818181818183	3.8048780487804876
chr12	SPATS2	49406472	49406565	474	94	27818	6730	27344	6636	5.042553191489362	4.120554550934298
chr12	SPATS2	49387053	49387137	0	85	27818	6730	27818	6645	0.0	4.186305492851768
chr12	SPATS2	49486249	49486348	0	100	27818	6730	27818	6630	0.0	4.195776772247361
chr12	KCNH3	49542333	49542408	0	76	1101	4514	1101	4438	0.0	0.2480847228481298
chr12	PRPF40B	49630544	49630625	0	82	696	8412	696	8330	0.0	0.08355342136854742
chr12	TMBIM6	49741201	49741329	0	129	2757	5925	2757	5796	0.0	0.4756728778467909
chr12	TMBIM6	49744412	49744542	0	131	2757	5925	2757	5794	0.0	0.47583707283396615
chr12	TMBIM6	49741956	49742115	0	160	2757	5925	2757	5765	0.0	0.4782307025151778
chr12	TMBIM6	49749617	49749856	51	240	2757	5925	2706	5685	0.2125	0.47598944591029024
chr12	TMBIM6	49743416	49743565	186	150	2757	5925	2571	5775	1.24	0.4451948051948052
chr12	TMBIM6	49741956	49742280	0	325	2757	5925	2757	5600	0.0	0.4923214285714286
chr12	TMBIM6	49742437	49742607	0	171	2757	5925	2757	5754	0.0	0.4791449426485923
chr12	LINC02395	49926947	49927083	0	137	85306	6673	85306	6536	0.0	13.05171358629131
chr12	LINC02395	49924139	49924513	148	375	85306	6673	85158	6298	0.39466666666666667	13.52143537630994
chr12	LINC02395	49928970	49929062	74	93	85306	6673	85232	6580	0.7956989247311828	12.953191489361702
chr12	LINC02395	49921925	49921979	440	55	85306	6673	84866	6618	8.0	12.823511634935025
chr12	LINC02395	49923781	49923877	51	97	85306	6673	85255	6576	0.5257731958762887	12.964568126520682
chr12	LINC02395	49928967	49929062	74	96	85306	6673	85232	6577	0.7708333333333334	12.959099893568496
chr12	LINC02395	49923781	49924000	51	220	85306	6673	85255	6453	0.2318181818181818	13.211684487835116
chr12	LINC02395	49926080	49926145	0	66	85306	6673	85306	6607	0.0	12.911457545028
chr12	LINC02395	49924330	49924513	0	184	85306	6673	85306	6489	0.0	13.14624749576206
chr12	LINC02395	49923781	49924513	204	733	85306	6673	85102	5940	0.2783083219645293	14.326936026936027
chr12	LINC02395	49925261	49925388	0	128	85306	6673	85306	6545	0.0	13.033766233766233
chr12	LINC02395	49926080	49926137	0	58	85306	6673	85306	6615	0.0	12.895842781557068
chr12	ASIC1	50076967	50077049	0	83	8646	4848	8646	4765	0.0	1.8144805876180483
chr12	ASIC1	50076967	50077060	0	94	8646	4848	8646	4754	0.0	1.8186790071518721
chr12	SMARCD1	50087362	50087485	43	124	1742	4503	1699	4379	0.3467741935483871	0.3879881251427266
chr12	SMARCD1	50088520	50088637	102	118	1742	4503	1640	4385	0.864406779661017	0.37400228050171036
chr12	SMARCD1	50096849	50096972	0	124	1742	4503	1742	4379	0.0	0.3978077186572277
chr12	GPD1	50104414	50104458	0	45	28	3832	28	3787	0.0	0.0073937153419593345
chr12	GPD1	50106287	50106426	0	140	28	3832	28	3692	0.0	0.007583965330444204
chr12	GPD1	50107566	50107800	0	235	28	3832	28	3597	0.0	0.00778426466499861
chr12	COX14	50112831	50112903	0	73	0	974	0	901	0.0	0.0
chr12	COX14	50118492	50118552	0	61	0	974	0	913	0.0	0.0
chr12	LARP4	50453459	50453672	7123	214	97448	8113	90325	7899	33.28504672897196	11.434991771110267
chr12	LARP4	50461134	50461347	0	214	97448	8113	97448	7899	0.0	12.336751487530067
chr12	LARP4	50402674	50402813	0	140	97448	8113	97448	7973	0.0	12.222250094067478
chr12	LARP4	50416345	50416434	168	90	97448	8113	97280	8023	1.8666666666666667	12.125140221862146
chr12	LARP4	50412404	50412453	253	50	97448	8113	97195	8063	5.06	12.054446235892348
chr12	DIP2B	50691048	50691151	0	104	6695	10390	6695	10286	0.0	0.6508846976472876
chr12	ATF1	50788207	50788325	0	119	6290	2841	6290	2722	0.0	2.310800881704629
chr12	LETMD1	51052091	51052207	0	117	564	3857	564	3740	0.0	0.15080213903743314
chr12	LETMD1	51053777	51053860	0	84	564	3857	564	3773	0.0	0.14948316989133315
chr12	LETMD1	51055834	51056021	0	188	564	3857	564	3669	0.0	0.15372035977105478
chr12	LETMD1	51056143	51056245	0	103	564	3857	564	3754	0.0	0.1502397442727757
chr12	LETMD1	51058031	51058128	0	98	564	3857	564	3759	0.0	0.15003990422984836
chr12	LETMD1	51052087	51052207	0	121	564	3857	564	3736	0.0	0.15096359743040685
chr12	LETMD1	51049033	51049185	0	153	564	3857	564	3704	0.0	0.15226781857451405
chr12	LETMD1	51055986	51056021	0	36	564	3857	564	3821	0.0	0.147605338916514
chr12	LETMD1	51052091	51052246	0	156	564	3857	564	3701	0.0	0.1523912456092948
chr12	LETMD1	51058005	51058128	0	124	564	3857	564	3733	0.0	0.15108491829627646
chr12	LETMD1	51058074	51058128	0	55	564	3857	564	3802	0.0	0.14834297738032615
chr12	DAZAP2	51240342	51240461	0	120	84	3807	84	3687	0.0	0.022782750203417412
chr12	DAZAP2	51240870	51241039	84	170	84	3807	0	3637	0.49411764705882355	0.0
chr12	DAZAP2	51240870	51241116	84	247	84	3807	0	3560	0.340080971659919	0.0
chr12	DAZAP2	51240966	51241116	0	151	84	3807	84	3656	0.0	0.022975929978118162
chr12	DAZAP2	51240898	51241116	28	219	84	3807	56	3588	0.1278538812785388	0.01560758082497213
chr12	SCN8A	51780648	51780771	0	124	6609	16021	6609	15897	0.0	0.4157388186450274
chr12	SCN8A	51768112	51768172	0	61	6609	16021	6609	15960	0.0	0.41409774436090224
chr12	SCN8A	51780201	51780271	0	71	6609	16021	6609	15950	0.0	0.41435736677115986
chr12	ANKRD33	51889070	51889196	0	127	2064	2094	2064	1967	0.0	1.0493136756481953
chr12	ANKRD33	51889066	51889196	0	131	2064	2094	2064	1963	0.0	1.0514518593988793
chr12	ACVRL1	51913098	51913350	0	253	400	4519	400	4266	0.0	0.09376465072667604
chr12	ACVR1B	51986817	51986942	0	126	0	5670	0	5544	0.0	0.0
chr12	ACVR1B	51982685	51982808	0	124	0	5670	0	5546	0.0	0.0
chr12	ACVR1B	51960055	51960187	0	133	0	5670	0	5537	0.0	0.0
chr12	NR4A1	52052495	52052645	0	151	1734	6100	1734	5949	0.0	0.2914775592536561
chr12	NR4A1	52052473	52052645	0	173	1734	6100	1734	5927	0.0	0.29255947359541085
chr12	LINC00592	52212043	52212156	0	114	328	2261	328	2147	0.0	0.1527713088029809
chr12	LINC00592	52212598	52213027	0	430	328	2261	328	1831	0.0	0.1791370835608957
chr12	LINC00592	52213479	52213688	0	210	328	2261	328	2051	0.0	0.1599219892735251
chr12	LINC00592	52221976	52222028	0	53	328	2261	328	2208	0.0	0.14855072463768115
chr12	LINC00592	52222689	52222943	0	255	328	2261	328	2006	0.0	0.16350947158524426
chr12	LINC00592	52221340	52221489	0	150	328	2261	328	2111	0.0	0.15537659876835622
chr12	LINC00592	52222685	52223074	0	390	328	2261	328	1871	0.0	0.17530732228754678
chr12	LINC00592	52222689	52223074	0	386	328	2261	328	1875	0.0	0.17493333333333333
chr12	EIF4B	53016472	53016610	0	139	0	5369	0	5230	0.0	0.0
chr12	EIF4B	53022492	53022627	0	136	0	5369	0	5233	0.0	0.0
chr12	EIF4B	53019909	53020026	0	118	0	5369	0	5251	0.0	0.0
chr12	EIF4B	53027781	53027919	0	139	0	5369	0	5230	0.0	0.0
chr12	EIF4B	53025226	53025345	0	120	0	5369	0	5249	0.0	0.0
chr12	EIF4B	53022253	53022366	0	114	0	5369	0	5255	0.0	0.0
chr12	IGFBP6	53099266	53099324	0	59	0	1352	0	1293	0.0	0.0
chr12	SOAT2	53105560	53105620	0	61	0	2088	0	2027	0.0	0.0
chr12	SOAT2	53118889	53118935	0	47	0	2088	0	2041	0.0	0.0
chr12	ESPL1	53285923	53286912	0	990	2923	7320	2923	6330	0.0	0.4617693522906793
chr12	PFDN5	53295838	53295941	0	104	9874	2927	9874	2823	0.0	3.497697484945094
chr12	PFDN5	53296243	53296275	0	33	9874	2927	9874	2894	0.0	3.4118866620594335
chr12	PFDN5	53296218	53296275	0	58	9874	2927	9874	2869	0.0	3.441617288253747
chr12	PFDN5	53296429	53296467	0	39	9874	2927	9874	2888	0.0	3.4189750692520775
chr12	AC073611.1	53303033	53303193	0	161	0	2859	0	2698	0.0	0.0
chr12	AC073611.1	53305907	53306060	0	154	0	2859	0	2705	0.0	0.0
chr12	PFDN5	53296429	53296551	0	123	9874	2927	9874	2804	0.0	3.521398002853067
chr12	PFDN5	53297849	53297924	0	76	9874	2927	9874	2851	0.0	3.4633461943177832
chr12	AC073611.1	53303033	53303172	0	140	0	2859	0	2719	0.0	0.0
chr12	PFDN5	53296453	53296551	0	99	9874	2927	9874	2828	0.0	3.4915134370579914
chr12	MYG1	53306197	53306320	0	124	192	2506	192	2382	0.0	0.08060453400503778
chr12	AMHR2	53428895	53429010	0	116	62865	3292	62865	3176	0.0	19.79376574307305
chr12	PCBP2	53455346	53455370	0	25	60444	6885	60444	6860	0.0	8.811078717201166
chr12	PCBP2	53464759	53464852	0	94	60444	6885	60444	6791	0.0	8.900603740244442
chr12	PCBP2	53465931	53465973	41	43	60444	6885	60403	6842	0.9534883720930233	8.82826658871675
chr12	PCBP2	53467804	53467843	108	40	60444	6885	60336	6845	2.7	8.814609203798392
chr12	PCBP2	53460330	53460425	6332	96	60444	6885	54112	6789	65.95833333333333	7.970540580350567
chr12	TARBP2	53502014	53502184	0	171	51	3979	51	3808	0.0	0.013392857142857142
chr12	TARBP2	53505134	53505262	0	129	51	3979	51	3850	0.0	0.013246753246753246
chr12	TARBP2	53502059	53502184	0	126	51	3979	51	3853	0.0	0.013236439138333765
chr12	TARBP2	53503026	53503129	0	104	51	3979	51	3875	0.0	0.013161290322580645
chr12	AC076968.2	53848858	53848956	408	99	88160	3598	87752	3499	4.121212121212121	25.079165475850242
chr12	AC076968.2	53875154	53875248	78	95	88160	3598	88082	3503	0.8210526315789474	25.144733085926347
chr12	AC076968.2	53860783	53860878	306	96	88160	3598	87854	3502	3.1875	25.0868075385494
chr12	AC023794.2	54093590	54093646	0	57	0	1667	0	1610	0.0	0.0
chr12	AC023794.2	54092601	54092727	0	127	0	1667	0	1540	0.0	0.0
chr12	LINC02381	54140245	54140444	0	200	0	4290	0	4090	0.0	0.0
chr12	HNRNPA1	54281385	54281502	0	118	0	4239	0	4121	0.0	0.0
chr12	HNRNPA1	54281794	54281941	0	148	0	4239	0	4091	0.0	0.0
chr12	HNRNPA1	54282572	54282665	0	94	0	4239	0	4145	0.0	0.0
chr12	HNRNPA1	54282799	54282874	0	76	0	4239	0	4163	0.0	0.0
chr12	HNRNPA1	54283811	54283967	0	157	0	4239	0	4082	0.0	0.0
chr12	HNRNPA1	54284257	54284317	0	61	0	4239	0	4178	0.0	0.0
chr12	HNRNPA1	54284239	54284317	0	79	0	4239	0	4160	0.0	0.0
chr12	HNRNPA1	54283078	54283234	0	157	0	4239	0	4082	0.0	0.0
chr12	HNRNPA1	54282572	54282662	0	91	0	4239	0	4148	0.0	0.0
chr12	HNRNPA1	54281352	54281502	0	151	0	4239	0	4088	0.0	0.0
chr12	HNRNPA1	54286661	54286732	0	72	0	4239	0	4167	0.0	0.0
chr12	HNRNPA1	54283062	54283234	0	173	0	4239	0	4066	0.0	0.0
chr12	HNRNPA1	54283791	54283967	0	177	0	4239	0	4062	0.0	0.0
chr12	HNRNPA1	54283778	54283967	0	190	0	4239	0	4049	0.0	0.0
chr12	HNRNPA1	54283891	54283967	0	77	0	4239	0	4162	0.0	0.0
chr12	HNRNPA1	54285973	54286112	0	140	0	4239	0	4099	0.0	0.0
chr12	HNRNPA1	54285984	54286112	0	129	0	4239	0	4110	0.0	0.0
chr12	HNRNPA1	54285950	54286112	0	163	0	4239	0	4076	0.0	0.0
chr12	HNRNPA1	54284517	54284601	0	85	0	4239	0	4154	0.0	0.0
chr12	HNRNPA1	54286679	54286732	0	54	0	4239	0	4185	0.0	0.0
chr12	COPZ1	54325082	54325181	0	100	64857	3204	64857	3104	0.0	20.89465206185567
chr12	COPZ1	54340546	54340615	630	70	64857	3204	64227	3134	9.0	20.493618379068284
chr12	COPZ1	54343224	54343316	0	93	64857	3204	64857	3111	0.0	20.847637415621985
chr12	COPZ1	54340462	54340615	630	154	64857	3204	64227	3050	4.090909090909091	21.058032786885246
chr12	COPZ1	54345459	54345515	0	57	64857	3204	64857	3147	0.0	20.609151572926596
chr12	COPZ1	54346611	54346674	163	64	64857	3204	64694	3140	2.546875	20.603184713375796
chr12	COPZ1	54342205	54342287	0	83	64857	3204	64857	3121	0.0	20.780839474527394
chr12	PDE1B	54554216	54554377	0	162	63100	7322	63100	7160	0.0	8.812849162011172
chr12	OR9K2	55126827	55126911	0	85	0	3123	0	3038	0.0	0.0
chr12	BLOC1S1	55716932	55717005	0	74	0	1506	0	1432	0.0	0.0
chr12	RDH5	55721688	55721947	0	260	51	2787	51	2527	0.0	0.020182034032449545
chr12	ORMDL2	55819090	55819173	0	84	0	2692	0	2608	0.0	0.0
chr12	ORMDL2	55818998	55819173	0	176	0	2692	0	2516	0.0	0.0
chr12	TMEM198B	55831256	55831349	0	94	0	4040	0	3946	0.0	0.0
chr12	TMEM198B	55832958	55833014	0	57	0	4040	0	3983	0.0	0.0
chr12	TMEM198B	55832958	55833038	0	81	0	4040	0	3959	0.0	0.0
chr12	TMEM198B	55832958	55833125	0	168	0	4040	0	3872	0.0	0.0
chr12	TMEM198B	55832870	55833014	0	145	0	4040	0	3895	0.0	0.0
chr12	TMEM198B	55834568	55834726	0	159	0	4040	0	3881	0.0	0.0
chr12	DGKA	55935304	55935404	0	101	93	7520	93	7419	0.0	0.01253538212697129
chr12	DGKA	55936652	55936856	0	205	93	7520	93	7315	0.0	0.012713602187286397
chr12	DGKA	55938510	55938560	0	51	93	7520	93	7469	0.0	0.012451466059713482
chr12	DGKA	55940081	55940170	0	90	93	7520	93	7430	0.0	0.012516823687752355
chr12	DGKA	55941509	55941584	0	76	93	7520	93	7444	0.0	0.012493283181085437
chr12	DGKA	55938637	55938698	0	62	93	7520	93	7458	0.0	0.01246983105390185
chr12	DGKA	55940081	55940168	0	88	93	7520	93	7432	0.0	0.01251345532831001
chr12	CDK2	55967856	55967934	0	79	102	3698	102	3619	0.0	0.028184581376070737
chr12	CDK2	55969474	55969576	51	103	102	3698	51	3595	0.49514563106796117	0.014186369958275382
chr12	CDK2	55970597	55970741	0	145	102	3698	102	3553	0.0	0.028708133971291867
chr12	RAB5B	55989946	55990098	0	153	149	6535	149	6382	0.0	0.023346913193356314
chr12	RAB5B	55990681	55990804	0	124	149	6535	149	6411	0.0	0.023241304008734986
chr12	RAB5B	55979371	55979474	0	104	149	6535	149	6431	0.0	0.023169025034986784
chr12	RAB5B	55985599	55985723	47	125	149	6535	102	6410	0.376	0.01591263650546022
chr12	RAB5B	55980888	55980922	0	35	149	6535	149	6500	0.0	0.022923076923076924
chr12	SUOX	56002542	56002720	0	179	51	4350	51	4171	0.0	0.012227283625029969
chr12	SUOX	55997614	55997723	0	110	51	4350	51	4240	0.0	0.012028301886792454
chr12	SUOX	56002211	56002271	0	61	51	4350	51	4289	0.0	0.011890883655863837
chr12	SUOX	55999332	55999458	0	127	51	4350	51	4223	0.0	0.012076722708974662
chr12	SUOX	55999332	55999590	0	259	51	4350	51	4091	0.0	0.012466389635785871
chr12	SUOX	56001308	56001472	0	165	51	4350	51	4185	0.0	0.012186379928315413
chr12	SUOX	56002603	56002720	0	118	51	4350	51	4232	0.0	0.012051039697542534
chr12	SUOX	56001885	56001948	0	64	51	4350	51	4286	0.0	0.01189920671955203
chr12	IKZF4	56011416	56011494	0	79	0	6273	0	6194	0.0	0.0
chr12	IKZF4	56023670	56023764	0	95	0	6273	0	6178	0.0	0.0
chr12	RPL41	56117188	56117211	502	24	6722	1110	6220	1086	20.916666666666668	5.72744014732965
chr12	ESYT1	56142284	56142425	2481	142	70184	5186	67703	5044	17.471830985915492	13.422482157018239
chr12	MYL6	56160625	56160670	0	46	2762	3310	2762	3264	0.0	0.8462009803921569
chr12	MYL6	56159586	56159730	196	145	2762	3310	2566	3165	1.3517241379310345	0.8107424960505529
chr12	MYL6	56159622	56159730	187	109	2762	3310	2575	3201	1.7155963302752293	0.8044361137144642
chr12	MYL6	56159586	56159622	10	37	2762	3310	2752	3273	0.2702702702702703	0.8408188206538344
chr12	MYL6	56162562	56162639	0	78	2762	3310	2762	3232	0.0	0.8545792079207921
chr12	NABP2	56223583	56223712	1497	130	106498	2114	105001	1984	11.515384615384615	52.923891129032256
chr12	SLC39A5	56230830	56230873	0	44	306	2914	306	2870	0.0	0.10662020905923345
chr12	SLC39A5	56230239	56230295	0	57	306	2914	306	2857	0.0	0.1071053552677634
chr12	SLC39A5	56237149	56237340	0	192	306	2914	306	2722	0.0	0.112417340191036
chr12	AC073896.2	56312406	56312499	14	94	2055	3830	2041	3736	0.14893617021276595	0.546306209850107
chr12	RBMS2	56562416	56562583	0	168	91014	8931	91014	8763	0.0	10.386169120164327
chr12	RBMS2	56568974	56569033	0	60	91014	8931	91014	8871	0.0	10.259722691917483
chr12	RBMS2	56581183	56581263	0	81	91014	8931	91014	8850	0.0	10.28406779661017
chr12	RBMS2	56539685	56539764	0	80	91014	8931	91014	8851	0.0	10.282905886340526
chr12	HSD17B6	56763217	56763414	0	198	11	2281	11	2083	0.0	0.00528084493518963
chr12	NAB2	57093406	57093598	0	193	352	2762	352	2569	0.0	0.1370182950564422
chr12	LRP1	57191319	57191512	0	194	15218	20587	15218	20393	0.0	0.7462364536850881
chr12	NXPH4	57221306	57221544	0	239	153	2155	153	1916	0.0	0.07985386221294363
chr12	SHMT2	57230802	57231000	0	199	0	3713	0	3514	0.0	0.0
chr12	SHMT2	57232452	57232575	0	124	0	3713	0	3589	0.0	0.0
chr12	SHMT2	57231480	57231560	0	81	0	3713	0	3632	0.0	0.0
chr12	SHMT2	57232482	57232575	0	94	0	3713	0	3619	0.0	0.0
chr12	SHMT2	57232424	57232575	0	152	0	3713	0	3561	0.0	0.0
chr12	MARS1	57489895	57489971	5026	77	247514	6060	242488	5983	65.27272727272727	40.52950025071035
chr12	MARS1	57498156	57498273	6023	118	247514	6060	241491	5942	51.04237288135593	40.64136654325143
chr12	MARS1	57489423	57489558	33220	136	247514	6060	214294	5924	244.26470588235293	36.17386900742741
chr12	MARS1	57489266	57489345	8390	80	247514	6060	239124	5980	104.875	39.98729096989967
chr12	MARS1	57489018	57489109	21008	92	247514	6060	226506	5968	228.34782608695653	37.953418230563
chr12	MARS1	57516138	57516158	0	21	247514	6060	247514	6039	0.0	40.985924821990395
chr12	MBD6	57524028	57524416	0	389	102	4948	102	4559	0.0	0.02237332748409739
chr12	KIF5A	57564107	57564212	0	106	105466	8616	105466	8510	0.0	12.393184488836663
chr12	KIF5A	57572579	57572726	2509	148	105466	8616	102957	8468	16.9527027027027	12.158360888049126
chr12	KIF5A	57579185	57579206	0	22	105466	8616	105466	8594	0.0	12.272050267628577
chr12	KIF5A	57582601	57582629	0	29	105466	8616	105466	8587	0.0	12.282054268079655
chr12	KIF5A	57583100	57583215	0	116	105466	8616	105466	8500	0.0	12.407764705882354
chr12	KIF5A	57561517	57561554	0	38	105466	8616	105466	8578	0.0	12.29494054558172
chr12	KIF5A	57582854	57582861	0	8	105466	8616	105466	8608	0.0	12.252091078066915
chr12	KIF5A	57582776	57582861	0	86	105466	8616	105466	8530	0.0	12.364126611957795
chr12	PIP4K2C	57599399	57599438	5669	40	92982	3262	87313	3222	141.725	27.099006828057107
chr12	PIP4K2C	57595887	57596031	0	145	92982	3262	92982	3117	0.0	29.83060635226179
chr12	PIP4K2C	57597957	57598062	500	106	92982	3262	92482	3156	4.716981132075472	29.303548795944234
chr12	DTX3	57605988	57606029	3345	42	46673	3005	43328	2963	79.64285714285714	14.623017212284847
chr12	DTX3	57605343	57605731	12431	389	46673	3005	34242	2616	31.956298200514137	13.089449541284404
chr12	DTX3	57605570	57605731	4118	162	46673	3005	42555	2843	25.419753086419753	14.968343299331693
chr12	SLC26A10	57624499	57624606	8415	108	237533	3092	229118	2984	77.91666666666667	76.78217158176943
chr12	SLC26A10	57625235	57625318	30626	84	237533	3092	206907	3008	364.5952380952381	68.78557180851064
chr12	SLC26A10	57622786	57622934	0	149	237533	3092	237533	2943	0.0	80.71117906897723
chr12	SLC26A10	57624723	57624793	46804	71	237533	3092	190729	3021	659.2112676056338	63.134392585236675
chr12	SLC26A10	57625235	57625330	34529	96	237533	3092	203004	2996	359.6770833333333	67.75834445927904
chr12	OS9	57694749	57694926	0	178	7815	4766	7815	4588	0.0	1.7033565823888404
chr12	OS9	57696274	57696373	0	100	7815	4766	7815	4666	0.0	1.6748821260180027
chr12	OS9	57694705	57694926	0	222	7815	4766	7815	4544	0.0	1.719850352112676
chr12	OS9	57720098	57720263	0	166	7815	4766	7815	4600	0.0	1.6989130434782609
chr12	OS9	57695542	57695677	0	136	7815	4766	7815	4630	0.0	1.687904967602592
chr12	TSPAN31	57746349	57746448	0	100	51	4546	51	4446	0.0	0.011470985155195682
chr12	EEF1AKMT3	57774628	57774767	153	140	3322	3164	3169	3024	1.0928571428571427	1.0479497354497354
chr12	TSFM	57792985	57793073	0	89	1745	3221	1745	3132	0.0	0.5571519795657727
chr12	TSFM	57783940	57784170	585	231	1745	3221	1160	2990	2.5324675324675323	0.3879598662207358
chr12	TSFM	57783614	57783652	18	39	1745	3221	1727	3182	0.46153846153846156	0.542740414833438
chr12	TSFM	57791964	57792027	20	64	1745	3221	1725	3157	0.3125	0.5464048146974976
chr12	TSFM	57802173	57802264	0	92	1745	3221	1745	3129	0.0	0.5576861617130073
chr12	TSFM	57783614	57784170	1419	557	1745	3221	326	2664	2.547576301615799	0.12237237237237238
chr12	ATP23	57946994	57947076	0	83	54359	3335	54359	3252	0.0	16.715559655596557
chr12	ATP23	57945627	57945673	0	47	54359	3335	54359	3288	0.0	16.532542579075425
chr12	AC020637.1	58803241	58803349	0	109	0	1739	0	1630	0.0	0.0
chr12	AC020637.1	58811921	58812033	0	113	0	1739	0	1626	0.0	0.0
chr12	SLC16A7	59696392	59696524	0	133	0	13706	0	13573	0.0	0.0
chr12	SLC16A7	59734049	59734187	0	139	0	13706	0	13567	0.0	0.0
chr12	SLC16A7	59735929	59735988	0	60	0	13706	0	13646	0.0	0.0
chr12	SLC16A7	59768125	59768323	0	199	0	13706	0	13507	0.0	0.0
chr12	SLC16A7	59733715	59733831	0	117	0	13706	0	13589	0.0	0.0
chr12	USP15	62325871	62325933	0	63	130357	19446	130357	19383	0.0	6.725326316875613
chr12	USP15	62396294	62396398	0	105	130357	19446	130357	19341	0.0	6.739930717129414
chr12	USP15	62312285	62312309	0	25	130357	19446	130357	19421	0.0	6.712167241645641
chr12	USP15	62349220	62349307	0	88	130357	19446	130357	19358	0.0	6.734011778076248
chr12	USP15	62328292	62328405	0	114	130357	19446	130357	19332	0.0	6.743068487481895
chr12	MON2	62544765	62544768	0	4	1012	15990	1012	15986	0.0	0.06330539221819091
chr12	MON2	62566013	62566031	0	19	1012	15990	1012	15971	0.0	0.06336484878842903
chr12	MON2	62588855	62588916	0	62	1012	15990	1012	15928	0.0	0.06353591160220995
chr12	MON2	62470700	62470778	0	79	1012	15990	1012	15911	0.0	0.06360379611589466
chr12	MON2	62490035	62490116	0	82	1012	15990	1012	15908	0.0	0.06361579079708322
chr12	RXYLT1	63782540	63782704	0	165	0	4507	0	4342	0.0	0.0
chr12	TBK1	64455839	64455957	0	119	23165	12697	23165	12578	0.0	1.8417077436794402
chr12	TBK1	64460188	64460329	0	142	23165	12697	23165	12555	0.0	1.8450816407805655
chr12	TBK1	64474229	64474390	0	162	23165	12697	23165	12535	0.0	1.8480255285201437
chr12	TBK1	64481841	64482021	818	181	23165	12697	22347	12516	4.519337016574585	1.7854745925215725
chr12	TBK1	64488486	64488588	0	103	23165	12697	23165	12594	0.0	1.839367952993489
chr12	TBK1	64490040	64490119	0	80	23165	12697	23165	12617	0.0	1.8360149005310296
chr12	TBK1	64495698	64495775	0	78	23165	12697	23165	12619	0.0	1.835723908392107
chr12	TBK1	64495981	64496089	0	109	23165	12697	23165	12588	0.0	1.840244677470607
chr12	TBK1	64497967	64498039	86	73	23165	12697	23079	12624	1.178082191780822	1.8281844106463878
chr12	TBK1	64495698	64495772	0	75	23165	12697	23165	12622	0.0	1.8352875930914276
chr12	TBK1	64494752	64494977	141	226	23165	12697	23024	12471	0.6238938053097345	1.8462031914040573
chr12	TBK1	64455815	64455957	0	143	23165	12697	23165	12554	0.0	1.845228612394456
chr12	TBK1	64460246	64460329	0	84	23165	12697	23165	12613	0.0	1.836597161658606
chr12	TBK1	64499066	64499280	0	215	23165	12697	23165	12482	0.0	1.8558724563371254
chr12	TBK1	64455916	64455957	0	42	23165	12697	23165	12655	0.0	1.830501777953378
chr12	TBK1	64457750	64458018	0	269	23165	12697	23165	12428	0.0	1.8639362729320887
chr12	TBK1	64457907	64458018	0	112	23165	12697	23165	12585	0.0	1.8406833531982518
chr12	TBK1	64479711	64479918	51	208	23165	12697	23114	12489	0.24519230769230768	1.8507486588197615
chr12	TBK1	64453979	64454181	0	203	23165	12697	23165	12494	0.0	1.8540899631823275
chr12	TBK1	64462472	64462521	0	50	23165	12697	23165	12647	0.0	1.8316596821380564
chr12	TBK1	64464572	64464657	0	86	23165	12697	23165	12611	0.0	1.8368884307350726
chr12	TBK1	64485454	64485513	720	60	23165	12697	22445	12637	12.0	1.7761335760069636
chr12	TBK1	64468875	64469289	48	415	23165	12697	23117	12282	0.11566265060240964	1.8821853118384628
chr12	TBK1	64471743	64471995	0	253	23165	12697	23165	12444	0.0	1.8615396978463516
chr12	TBK1	64469990	64470108	0	119	23165	12697	23165	12578	0.0	1.8417077436794402
chr12	TBK1	64468572	64468672	0	101	23165	12697	23165	12596	0.0	1.8390758971101937
chr12	TBK1	64475639	64475845	0	207	23165	12697	23165	12490	0.0	1.854683746997598
chr12	TBK1	64487148	64487311	0	164	23165	12697	23165	12533	0.0	1.8483204340540973
chr12	TBK1	64495703	64495775	0	73	23165	12697	23165	12624	0.0	1.8349968314321927
chr12	TBK1	64499066	64499144	0	79	23165	12697	23165	12618	0.0	1.835869392930734
chr12	TBK1	64500104	64500313	15	210	23165	12697	23150	12487	0.07142857142857142	1.853928085208617
chr12	RASSF3	64688215	64688453	0	239	1692	4232	1692	3993	0.0	0.4237415477084899
chr12	TBC1D30	64787359	64787381	0	23	182499	9874	182499	9851	0.0	18.525936453151964
chr12	TBC1D30	64830376	64830502	1171	127	182499	9874	181328	9747	9.220472440944881	18.60346773366164
chr12	LINC02389	64900576	64900698	0	123	2862	7783	2862	7660	0.0	0.37362924281984333
chr12	LINC02389	64987728	64987855	0	128	2862	7783	2862	7655	0.0	0.3738732854343566
chr12	LINC02389	64884915	64884983	0	69	2862	7783	2862	7714	0.0	0.3710137412496759
chr12	LINC02389	64885193	64885300	383	108	2862	7783	2479	7675	3.5462962962962963	0.32299674267100975
chr12	LINC02389	64981619	64981789	0	171	2862	7783	2862	7612	0.0	0.3759852863899107
chr12	LINC02389	64947315	64947462	0	148	2862	7783	2862	7635	0.0	0.374852652259332
chr12	MSRB3	65308528	65308655	0	128	0	7420	0	7292	0.0	0.0
chr12	MSRB3	65306862	65307026	0	165	0	7420	0	7255	0.0	0.0
chr12	AC090023.1	65559971	65560044	0	74	88	1031	88	957	0.0	0.09195402298850575
chr12	HMGA2	65842133	65842254	0	122	2044	14141	2044	14019	0.0	0.14580212568656822
chr12	HMGA2	65867488	65867807	0	320	2044	14141	2044	13821	0.0	0.1478908906736126
chr12	HMGA2	65881742	65881890	0	149	2044	14141	2044	13992	0.0	0.1460834762721555
chr12	IRAK3	66203710	66203893	0	184	19681	9701	19681	9517	0.0	2.06798360827992
chr12	HELB	66313985	66314163	132	179	2736	4541	2604	4362	0.7374301675977654	0.5969738651994498
chr12	DYRK2	67649796	67649945	0	150	22559	9476	22559	9326	0.0	2.4189363070984347
chr12	IFNG-AS1	68006089	68006146	0	58	51	4547	51	4489	0.0	0.011361104923145467
chr12	IFNG-AS1	68013530	68013648	0	119	51	4547	51	4428	0.0	0.011517615176151762
chr12	IFNG-AS1	67989946	67990048	0	103	51	4547	51	4444	0.0	0.011476147614761477
chr12	RAP1B	68648698	68648781	0	84	51	16213	51	16129	0.0	0.003162006324012648
chr12	RAP1B	68651994	68652051	0	58	51	16213	51	16155	0.0	0.003156917363045497
chr12	RAP1B	68654111	68654252	0	142	51	16213	51	16071	0.0	0.0031734179578122084
chr12	RAP1B	68656305	68656449	0	145	51	16213	51	16068	0.0	0.0031740104555638537
chr12	RAP1B	68657100	68657217	0	118	51	16213	51	16095	0.0	0.003168685927306617
chr12	RAP1B	68624670	68624873	0	204	51	16213	51	16009	0.0	0.0031857080392279345
chr12	RAP1B	68624507	68624873	0	367	51	16213	51	15846	0.0	0.003218477849299508
chr12	RAP1B	68624674	68624873	0	200	51	16213	51	16013	0.0	0.0031849122587897334
chr12	RAP1B	68641033	68641153	0	121	51	16213	51	16092	0.0	0.003169276659209545
chr12	RAP1B	68641037	68641153	0	117	51	16213	51	16096	0.0	0.003168489065606362
chr12	RAP1B	68648705	68648781	0	77	51	16213	51	16136	0.0	0.0031606346058502726
chr12	RAP1B	68650399	68650468	0	70	51	16213	51	16143	0.0	0.0031592640773090504
chr12	RAP1B	68648669	68648781	0	113	51	16213	51	16100	0.0	0.0031677018633540373
chr12	RAP1B	68647992	68648095	0	104	51	16213	51	16109	0.0	0.0031659320876528648
chr12	RAP1B	68621445	68621491	0	47	51	16213	51	16166	0.0	0.003154769268835828
chr12	NUP107	68691967	68692112	0	146	9427	8054	9427	7908	0.0	1.1920839656044513
chr12	NUP107	68700725	68700853	0	129	9427	8054	9427	7925	0.0	1.1895268138801263
chr12	NUP107	68725726	68725796	0	71	9427	8054	9427	7983	0.0	1.1808843793060253
chr12	MDM2	68813553	68813628	0	76	0	10870	0	10794	0.0	0.0
chr12	MDM2	68816811	68816945	0	135	0	10870	0	10735	0.0	0.0
chr12	MDM2	68824554	68824651	0	98	0	10870	0	10772	0.0	0.0
chr12	MDM2	68828770	68828931	0	162	0	10870	0	10708	0.0	0.0
chr12	MDM2	68836671	68836749	0	79	0	10870	0	10791	0.0	0.0
chr12	MDM2	68820324	68820374	0	51	0	10870	0	10819	0.0	0.0
chr12	MDM2	68814602	68814689	0	88	0	10870	0	10782	0.0	0.0
chr12	MDM2	68835828	68835984	0	157	0	10870	0	10713	0.0	0.0
chr12	MDM2	68815627	68815720	0	94	0	10870	0	10776	0.0	0.0
chr12	MDM2	68824362	68824430	0	69	0	10870	0	10801	0.0	0.0
chr12	MDM2	68820884	68820910	0	27	0	10870	0	10843	0.0	0.0
chr12	MDM2	68819952	68819997	0	46	0	10870	0	10824	0.0	0.0
chr12	MDM2	68823414	68823514	0	101	0	10870	0	10769	0.0	0.0
chr12	AC127894.1	69219454	69219580	182	127	12319	1739	12137	1612	1.4330708661417322	7.529156327543424
chr12	CPSF6	69252085	69252216	0	132	4911	7934	4911	7802	0.0	0.6294539861573956
chr12	CPSF6	69255001	69256052	255	1052	4911	7934	4656	6882	0.2423954372623574	0.6765475152571927
chr12	CPSF6	69258034	69258145	0	112	4911	7934	4911	7822	0.0	0.6278445410380977
chr12	LYZ	69352219	69352298	0	80	0	1728	0	1648	0.0	0.0
chr12	YEATS4	69361316	69361433	0	118	0	1790	0	1672	0.0	0.0
chr12	YEATS4	69364176	69364299	0	124	0	1790	0	1666	0.0	0.0
chr12	FRS2	69480298	69480359	0	62	0	7260	0	7198	0.0	0.0
chr12	FRS2	69569004	69569096	0	93	0	7260	0	7167	0.0	0.0
chr12	FRS2	69486201	69486297	0	97	0	7260	0	7163	0.0	0.0
chr12	FRS2	69537915	69537983	0	69	0	7260	0	7191	0.0	0.0
chr12	FRS2	69557799	69557856	0	58	0	7260	0	7202	0.0	0.0
chr12	FRS2	69491537	69491651	0	115	0	7260	0	7145	0.0	0.0
chr12	CCT2	69597967	69598071	0	105	153	4246	153	4141	0.0	0.03694759719874426
chr12	CCT2	69599862	69600004	0	143	153	4246	153	4103	0.0	0.03728978796002925
chr12	CCT2	69585750	69586009	0	260	153	4246	153	3986	0.0	0.0383843452082288
chr12	RAB3IP	69801608	69801721	0	114	24835	10469	24835	10355	0.0	2.39835828102366
chr12	RAB3IP	69812777	69812877	0	101	24835	10469	24835	10368	0.0	2.395351080246914
chr12	RAB3IP	69800208	69800337	0	130	24835	10469	24835	10339	0.0	2.4020698326724053
chr12	MYRFL	69955362	69955437	0	76	1436	3627	1436	3551	0.0	0.4043931286961419
chr12	CNOT2	70319297	70319364	0	68	1946	10263	1946	10195	0.0	0.19087788131436978
chr12	CNOT2	70330286	70330469	714	184	1946	10263	1232	10079	3.880434782608696	0.12223434864569897
chr12	CNOT2	70342257	70342307	0	51	1946	10263	1946	10212	0.0	0.19056012534273403
chr12	CNOT2	70346179	70346324	0	146	1946	10263	1946	10117	0.0	0.19234951072452308
chr12	CNOT2	70294236	70294294	0	59	1946	10263	1946	10204	0.0	0.19070952567620542
chr12	CNOT2	70297758	70297879	0	122	1946	10263	1946	10141	0.0	0.1918942905038951
chr12	CNOT2	70285399	70285586	51	188	1946	10263	1895	10075	0.2712765957446808	0.1880893300248139
chr12	CNOT2	70301704	70301865	0	162	1946	10263	1946	10101	0.0	0.19265419265419265
chr12	CNOT2	70332766	70332846	0	81	1946	10263	1946	10182	0.0	0.19112158711451582
chr12	CNOT2	70294070	70294294	0	225	1946	10263	1946	10038	0.0	0.19386331938633194
chr12	CNOT2	70290726	70290803	0	78	1946	10263	1946	10185	0.0	0.19106529209621992
chr12	CNOT2	70337755	70337820	0	66	1946	10263	1946	10197	0.0	0.19084044326762772
chr12	KCNMB4	70422706	70422849	0	144	51	4864	51	4720	0.0	0.010805084745762712
chr12	AC025569.1	70470212	70470308	0	97	50	6358	50	6261	0.0	0.007985944737262418
chr12	AC025569.1	70522523	70522630	0	108	50	6358	50	6250	0.0	0.008
chr12	AC025569.1	70527674	70527738	0	65	50	6358	50	6293	0.0	0.00794533608771651
chr12	AC025569.1	70507894	70508001	9	108	50	6358	41	6250	0.08333333333333333	0.00656
chr12	AC025569.1	70510407	70510577	0	171	50	6358	50	6187	0.0	0.008081461128171973
chr12	AC025569.1	70520785	70520928	0	144	50	6358	50	6214	0.0	0.00804634695848085
chr12	AC025569.1	70525359	70525426	0	68	50	6358	50	6290	0.0	0.00794912559618442
chr12	LGR5	71553072	71553288	0	217	0	5242	0	5025	0.0	0.0
chr12	LGR5	71561780	71561852	0	73	0	5242	0	5169	0.0	0.0
chr12	TMEM19	71690338	71690430	0	93	102	3519	102	3426	0.0	0.0297723292469352
chr12	TBC1D15	71841100	71841231	0	132	0	8252	0	8120	0.0	0.0
chr12	TBC1D15	71880468	71880607	0	140	0	8252	0	8112	0.0	0.0
chr12	TBC1D15	71884810	71885021	0	212	0	8252	0	8040	0.0	0.0
chr12	TBC1D15	71894324	71894375	0	52	0	8252	0	8200	0.0	0.0
chr12	TBC1D15	71854562	71854602	0	41	0	8252	0	8211	0.0	0.0
chr12	TBC1D15	71854784	71854853	0	70	0	8252	0	8182	0.0	0.0
chr12	TBC1D15	71861404	71861496	0	93	0	8252	0	8159	0.0	0.0
chr12	TPH2	72042824	72042884	0	61	5182	6953	5182	6892	0.0	0.7518862449216482
chr12	GLIPR1L1	75369959	75369986	0	28	0	1360	0	1332	0.0	0.0
chr12	GLIPR1L2	75413597	75413701	0	105	0	3778	0	3673	0.0	0.0
chr12	GLIPR1L2	75403016	75403146	0	131	0	3778	0	3647	0.0	0.0
chr12	GLIPR1	75490405	75490518	0	114	0	6217	0	6103	0.0	0.0
chr12	GLIPR1	75487738	75487809	0	72	0	6217	0	6145	0.0	0.0
chr12	LNCOG	76302761	76302879	0	119	0	2113	0	1994	0.0	0.0
chr12	ZDHHC17	76797433	76797537	0	105	9808	7820	9808	7715	0.0	1.2712896953985742
chr12	ZDHHC17	76809042	76809120	87	79	9808	7820	9721	7741	1.1012658227848102	1.2557809068595789
chr12	ZDHHC17	76821057	76821167	0	111	9808	7820	9808	7709	0.0	1.2722791542353094
chr12	ZDHHC17	76781628	76781683	0	56	9808	7820	9808	7764	0.0	1.263266357547656
chr12	ZDHHC17	76769072	76769201	6049	130	9808	7820	3759	7690	46.53076923076923	0.48881664499349803
chr12	ZDHHC17	76813312	76813449	0	138	9808	7820	9808	7682	0.0	1.2767508461338193
chr12	NAV3	77994802	77994871	0	70	48	13128	48	13058	0.0	0.00367590748966151
chr12	NAV3	78127166	78127208	0	43	48	13128	48	13085	0.0	0.0036683225066870464
chr12	NAV3	78176438	78176459	0	22	48	13128	48	13106	0.0	0.0036624446818251184
chr12	NAV3	78177619	78177685	48	67	48	13128	0	13061	0.7164179104477612	0.0
chr12	NAV3	78188608	78188777	0	170	48	13128	48	12958	0.0	0.0037042753511344344
chr12	NAV3	78121939	78122428	0	490	48	13128	48	12638	0.0	0.0037980693147649943
chr12	SYT1	79047296	79047362	0	67	429	6410	429	6343	0.0	0.06763361185558883
chr12	SYT1	78995758	78995847	0	90	429	6410	429	6320	0.0	0.06787974683544304
chr12	SYT1	79103013	79103055	0	43	429	6410	429	6367	0.0	0.0673786712737553
chr12	OTOGL	80296826	80296961	0	136	16535	12344	16535	12208	0.0	1.3544397116644824
chr12	OTOGL	80366267	80366353	0	87	16535	12344	16535	12257	0.0	1.3490250469119687
chr12	OTOGL	80361067	80361185	0	119	16535	12344	16535	12225	0.0	1.3525562372188138
chr12	PTPRQ	80422944	80423148	0	205	81	12477	81	12272	0.0	0.0066003911342894395
chr12	PTPRQ	80423696	80423833	0	138	81	12477	81	12339	0.0	0.006564551422319475
chr12	PTPRQ	80436124	80436382	0	259	81	12477	81	12218	0.0	0.006629562939924701
chr12	PTPRQ	80648896	80648923	0	28	81	12477	81	12449	0.0	0.0065065467105791626
chr12	LINC01490	80764221	80764324	0	104	0	1770	0	1666	0.0	0.0
chr12	LINC01490	80763589	80763704	0	116	0	1770	0	1654	0.0	0.0
chr12	LINC01490	80763589	80763617	0	29	0	1770	0	1741	0.0	0.0
chr12	LINC01490	80763589	80763648	0	60	0	1770	0	1710	0.0	0.0
chr12	LINC01490	80767347	80767656	0	310	0	1770	0	1460	0.0	0.0
chr12	ACSS3	81199659	81199711	0	53	102	16849	102	16796	0.0	0.006072874493927126
chr12	PPFIA2-AS1	81292342	81292362	0	21	0	2017	0	1996	0.0	0.0
chr12	PPFIA2-AS1	81298062	81298163	0	102	0	2017	0	1915	0.0	0.0
chr12	PPFIA2-AS1	81284215	81284379	0	165	0	2017	0	1852	0.0	0.0
chr12	AC069228.1	81471161	81471308	0	148	510	9203	510	9055	0.0	0.05632247377139702
chr12	AC069228.1	81521185	81521250	0	66	510	9203	510	9137	0.0	0.05581700777060304
chr12	AC069228.1	81424660	81424698	0	39	510	9203	510	9164	0.0	0.05565255347010039
chr12	METTL25	82369448	82369560	51	113	51	3661	0	3548	0.45132743362831856	0.0
chr12	TMTC2	82857009	82857580	0	572	51	8337	51	7765	0.0	0.006567933032839665
chr12	AC090679.2	84293927	84294141	0	215	0	1075	0	860	0.0	0.0
chr12	LRRIQ1	85052176	85052251	0	76	766	8823	766	8747	0.0	0.08757288213101636
chr12	NTS	85878344	85878569	0	226	0	1559	0	1333	0.0	0.0
chr12	C12ORF29	88045581	88045779	0	199	0	4662	0	4463	0.0	0.0
chr12	C12ORF29	88040147	88040265	0	119	0	4662	0	4543	0.0	0.0
chr12	C12ORF29	88036041	88036073	0	33	0	4662	0	4629	0.0	0.0
chr12	TMTC3	88153290	88153509	0	220	75	7342	75	7122	0.0	0.010530749789385004
chr12	TMTC3	88172965	88173089	0	125	75	7342	75	7217	0.0	0.010392129693778578
chr12	LINC02392	90297073	90297143	0	71	0	2438	0	2367	0.0	0.0
chr12	LINC02822	90679634	90679945	0	312	153	12517	153	12205	0.0	0.012535845964768538
chr12	LINC02823	91365116	91365224	0	109	0	1948	0	1839	0.0	0.0
chr12	LINC02823	91356899	91357114	0	216	0	1948	0	1732	0.0	0.0
chr12	LINC02823	91366430	91366473	0	44	0	1948	0	1904	0.0	0.0
chr12	CLLU1	92425377	92425934	14	558	153	6813	139	6255	0.025089605734767026	0.022222222222222223
chr12	PLEKHG7	92721384	92721523	0	140	51	5995	51	5855	0.0	0.008710503842869342
chr12	AC138123.2	93106321	93106414	0	94	0	2993	0	2899	0.0	0.0
chr12	NUDT4	93380987	93381031	0	45	51	10086	51	10041	0.0	0.005079175380938153
chr12	MRPL42	93476953	93477017	0	65	0	15816	0	15751	0.0	0.0
chr12	MRPL42	93470485	93470590	0	106	0	15816	0	15710	0.0	0.0
chr12	MRPL42	93470485	93470505	0	21	0	15816	0	15795	0.0	0.0
chr12	CRADD	93859318	93859442	0	125	43496	4087	43496	3962	0.0	10.97829379101464
chr12	PLXNC1	94259336	94259375	0	40	4320	9844	4320	9804	0.0	0.44063647490820074
chr12	PLXNC1	94298631	94298795	0	165	4320	9844	4320	9679	0.0	0.4463270999070152
chr12	VEZT	95256549	95256622	0	74	959	7893	959	7819	0.0	0.12264995523724262
chr12	VEZT	95258244	95258287	0	44	959	7893	959	7849	0.0	0.12218116957574213
chr12	VEZT	95257149	95257239	0	91	959	7893	959	7802	0.0	0.12291720071776467
chr12	VEZT	95262905	95263081	0	177	959	7893	959	7716	0.0	0.12428719543805081
chr12	VEZT	95224179	95224236	0	58	959	7893	959	7835	0.0	0.12239948947032546
chr12	VEZT	95258244	95258282	0	39	959	7893	959	7854	0.0	0.12210338680926916
chr12	VEZT	95263745	95263797	0	53	959	7893	959	7840	0.0	0.12232142857142857
chr12	VEZT	95243940	95244009	0	70	959	7893	959	7823	0.0	0.12258724274574971
chr12	VEZT	95257153	95257239	0	87	959	7893	959	7806	0.0	0.12285421470663592
chr12	METAP2	95476070	95476178	0	109	3743	4434	3743	4325	0.0	0.8654335260115606
chr12	METAP2	95483214	95483280	0	67	3743	4434	3743	4367	0.0	0.8571101442637966
chr12	METAP2	95511894	95511998	0	105	3743	4434	3743	4329	0.0	0.8646338646338646
chr12	METAP2	95482126	95482210	0	85	3743	4434	3743	4349	0.0	0.8606576224419407
chr12	METAP2	95476142	95476178	0	37	3743	4434	3743	4397	0.0	0.8512622242438026
chr12	METAP2	95476073	95476178	0	106	3743	4434	3743	4328	0.0	0.8648336414048059
chr12	AMDHD1	95954910	95954975	0	66	0	2618	0	2552	0.0	0.0
chr12	ELK3	96246939	96247734	612	796	83156	4653	82544	3857	0.7688442211055276	21.4010889292196
chr12	ELK3	96198025	96198142	0	118	83156	4653	83156	4535	0.0	18.33649393605292
chr12	CFAP54	96503885	96504029	0	145	9930	12986	9930	12841	0.0	0.773304259792851
chr12	CFAP54	96682141	96682336	357	196	9930	12986	9573	12790	1.8214285714285714	0.7484753713838936
chr12	NEDD1	96907603	96907624	0	22	153	4482	153	4460	0.0	0.03430493273542601
chr12	NEDD1	96907701	96907856	0	156	153	4482	153	4326	0.0	0.03536754507628294
chr12	NEDD1	96907603	96907856	0	254	153	4482	153	4228	0.0	0.03618732261116367
chr12	NEDD1	96917620	96917737	0	118	153	4482	153	4364	0.0	0.03505957836846929
chr12	RMST	97465667	97465727	0	61	65	10114	65	10053	0.0	0.0064657316224012735
chr12	RMST	97493176	97493285	0	110	65	10114	65	10004	0.0	0.0064974010395841665
chr12	RMST	97495930	97496056	0	127	65	10114	65	9987	0.0	0.0065084609992990886
chr12	RMST	97564149	97564328	0	180	65	10114	65	9934	0.0	0.006543185021139521
chr12	RMST	97491643	97491712	0	70	65	10114	65	10044	0.0	0.006471525288729589
chr12	RMST	97541205	97541357	0	153	65	10114	65	9961	0.0	0.006525449252083124
chr12	RMST	97551831	97552082	0	252	65	10114	65	9862	0.0	0.006590955181504766
chr12	RMST	97493180	97493285	0	106	65	10114	65	10008	0.0	0.00649480415667466
chr12	RMST	97483430	97483488	0	59	65	10114	65	10055	0.0	0.006464445549477871
chr12	RMST	97541205	97541308	0	104	65	10114	65	10010	0.0	0.006493506493506494
chr12	TMPO	98544229	98544349	0	121	0	8456	0	8335	0.0	0.0
chr12	TMPO	98544441	98544537	0	97	0	8456	0	8359	0.0	0.0
chr12	TMPO	98544950	98545061	0	112	0	8456	0	8344	0.0	0.0
chr12	SLC25A3	98601170	98601281	0	112	306	7682	306	7570	0.0	0.040422721268163805
chr12	APAF1	98703370	98703499	0	130	112	7025	112	6895	0.0	0.016243654822335026
chr12	APAF1	98725414	98725540	0	127	112	7025	112	6898	0.0	0.016236590316033632
chr12	ACTR6	100210072	100210208	0	137	927	3828	927	3691	0.0	0.2511514494716879
chr12	ACTR6	100208771	100208889	0	119	927	3828	927	3709	0.0	0.24993259638716636
chr12	SCYL2	100282942	100283147	0	206	0	6940	0	6734	0.0	0.0
chr12	SCYL2	100317680	100317692	0	13	0	6940	0	6927	0.0	0.0
chr12	SCYL2	100319223	100319286	0	64	0	6940	0	6876	0.0	0.0
chr12	SCYL2	100327184	100327234	0	51	0	6940	0	6889	0.0	0.0
chr12	SLC17A8	100402595	100402745	95	151	6052	4286	5957	4135	0.6291390728476821	1.4406287787182588
chr12	NR1H4	100532457	100532598	0	142	8695	3643	8695	3501	0.0	2.4835761211082548
chr12	NR1H4	100532457	100532610	0	154	8695	3643	8695	3489	0.0	2.4921180854112928
chr12	NR1H4	100490815	100490982	0	168	8695	3643	8695	3475	0.0	2.502158273381295
chr12	NR1H4	100499852	100500024	0	173	8695	3643	8695	3470	0.0	2.505763688760807
chr12	GAS2L3	100591735	100591856	0	122	21233	6817	21233	6695	0.0	3.1714712471994027
chr12	GAS2L3	100592373	100592449	0	77	21233	6817	21233	6740	0.0	3.1502967359050444
chr12	GAS2L3	100611007	100611263	2576	257	21233	6817	18657	6560	10.023346303501945	2.8440548780487807
chr12	ANO4	100922225	100922330	0	106	7729	5033	7729	4927	0.0	1.568703064745281
chr12	ANO4	101083677	101083818	0	142	7729	5033	7729	4891	0.0	1.580249437742793
chr12	ANO4	101079192	101079275	0	84	7729	5033	7729	4949	0.0	1.5617296423519904
chr12	MYBPC1	101636671	101636728	0	58	5459	7493	5459	7435	0.0	0.7342299932750505
chr12	MYBPC1	101682603	101682662	0	60	5459	7493	5459	7433	0.0	0.7344275528050586
chr12	MYBPC1	101684381	101684424	0	44	5459	7493	5459	7449	0.0	0.7328500469861726
chr12	MYBPC1	101614495	101614531	0	37	5459	7493	5459	7456	0.0	0.7321620171673819
chr12	MYBPC1	101617201	101617243	0	43	5459	7493	5459	7450	0.0	0.732751677852349
chr12	MYBPC1	101666743	101666797	0	55	5459	7493	5459	7438	0.0	0.7339338531863404
chr12	MYBPC1	101626871	101626910	0	40	5459	7493	5459	7453	0.0	0.7324567288340266
chr12	MYBPC1	101627768	101627804	0	37	5459	7493	5459	7456	0.0	0.7321620171673819
chr12	MYBPC1	101600359	101600455	0	97	5459	7493	5459	7396	0.0	0.7381016765819362
chr12	MYBPC1	101621527	101621587	0	61	5459	7493	5459	7432	0.0	0.7345263724434876
chr12	CHPT1	101719489	101719516	126	28	2281	4140	2155	4112	4.5	0.5240758754863813
chr12	CHPT1	101717236	101717394	0	159	2281	4140	2281	3981	0.0	0.5729716151720673
chr12	DRAM1	101908185	101908363	0	179	57	3949	57	3770	0.0	0.015119363395225464
chr12	DRAM1	101890087	101890221	51	135	57	3949	6	3814	0.37777777777777777	0.0015731515469323545
chr12	PARPBP	102148229	102148463	0	235	29611	4762	29611	4527	0.0	6.540976364037994
chr12	PARPBP	102195311	102195447	0	137	29611	4762	29611	4625	0.0	6.402378378378378
chr12	PARPBP	102151569	102151800	0	232	29611	4762	29611	4530	0.0	6.536644591611479
chr12	PARPBP	102150263	102150371	728	109	29611	4762	28883	4653	6.678899082568807	6.207393079733505
chr12	PARPBP	102148234	102148463	0	230	29611	4762	29611	4532	0.0	6.533759929390997
chr12	PARPBP	102182548	102182627	0	80	29611	4762	29611	4682	0.0	6.324434002563008
chr12	AC068643.2	103155222	103155269	0	48	0	2446	0	2398	0.0	0.0
chr12	AC068643.2	103164399	103164437	0	39	0	2446	0	2407	0.0	0.0
chr12	AC068643.2	103164690	103164763	0	74	0	2446	0	2372	0.0	0.0
chr12	AC068643.2	103155146	103155269	0	124	0	2446	0	2322	0.0	0.0
chr12	AC068643.2	103161580	103161630	0	51	0	2446	0	2395	0.0	0.0
chr12	LINC02401	103548667	103548980	0	314	0	4467	0	4153	0.0	0.0
chr12	LINC02401	103563675	103563820	0	146	0	4467	0	4321	0.0	0.0
chr12	LINC02401	103557408	103557596	0	189	0	4467	0	4278	0.0	0.0
chr12	LINC02401	103548854	103548980	0	127	0	4467	0	4340	0.0	0.0
chr12	LINC02401	103563678	103563820	0	143	0	4467	0	4324	0.0	0.0
chr12	STAB2	103704880	103705027	0	148	70	9297	70	9149	0.0	0.0076511094108645756
chr12	HSP90B1	103931710	103931748	0	39	0	4445	0	4406	0.0	0.0
chr12	TDG	103967853	103967971	0	119	0	4696	0	4577	0.0	0.0
chr12	TDG	103972959	103973033	0	75	0	4696	0	4621	0.0	0.0
chr12	TDG	103983135	103983218	0	84	0	4696	0	4612	0.0	0.0
chr12	TDG	103976917	103977060	0	144	0	4696	0	4552	0.0	0.0
chr12	HCFC2	104087985	104088038	0	54	10	6717	10	6663	0.0	0.0015008254539997
chr12	TXNRD1	104311289	104311412	0	124	195270	6737	195270	6613	0.0	29.52820202631181
chr12	TXNRD1	104288930	104289040	0	111	195270	6737	195270	6626	0.0	29.470268638696044
chr12	TXNRD1	104290992	104291104	0	113	195270	6737	195270	6624	0.0	29.479166666666668
chr12	TXNRD1	104289465	104289542	0	78	195270	6737	195270	6659	0.0	29.324222856284727
chr12	TXNRD1	104309758	104310099	81	342	195270	6737	195189	6395	0.23684210526315788	30.522126661454262
chr12	TXNRD1	104309758	104309950	81	193	195270	6737	195189	6544	0.41968911917098445	29.827169926650367
chr12	TXNRD1	104346018	104346155	779	138	195270	6737	194491	6599	5.644927536231884	29.472798908925594
chr12	C12ORF45	104991711	104991848	0	138	10710	24741	10710	24603	0.0	0.4353127667357639
chr12	WASHC4	105111124	105111264	0	141	12354	7697	12354	7556	0.0	1.63499205929063
chr12	WASHC4	105160000	105160148	0	149	12354	7697	12354	7548	0.0	1.636724960254372
chr12	WASHC4	105155109	105155208	4847	100	12354	7697	7507	7597	48.47	0.9881532183756746
chr12	C12ORF75	105365806	105365842	0	37	765	2703	765	2666	0.0	0.28694673668417103
chr12	C12ORF75	105348601	105348626	0	26	765	2703	765	2677	0.0	0.28576765035487484
chr12	TCP11L2	106304092	106304231	0	140	0	6342	0	6202	0.0	0.0
chr12	TCP11L2	106312292	106312434	0	143	0	6342	0	6199	0.0	0.0
chr12	TCP11L2	106307281	106307370	0	90	0	6342	0	6252	0.0	0.0
chr12	RFX4	106608796	106608883	0	88	385	6711	385	6623	0.0	0.058130756454778804
chr12	RFX4	106662180	106662262	0	83	385	6711	385	6628	0.0	0.05808690404345202
chr12	RIC8B	106775323	106775425	0	103	1504	7787	1504	7684	0.0	0.19573138990109318
chr12	RIC8B	106783996	106784044	0	49	1504	7787	1504	7738	0.0	0.194365469113466
chr12	RIC8B	106814695	106815304	0	610	1504	7787	1504	7177	0.0	0.20955831127211927
chr12	RIC8B	106797976	106798069	76	94	1504	7787	1428	7693	0.8085106382978723	0.18562329390354868
chr12	RIC8B	106874480	106874567	0	88	1504	7787	1504	7699	0.0	0.1953500454604494
chr12	RIC8B	106870822	106870942	0	121	1504	7787	1504	7666	0.0	0.1961909731280981
chr12	RIC8B	106868300	106868423	0	124	1504	7787	1504	7663	0.0	0.1962677802427248
chr12	RIC8B	106873031	106873174	0	144	1504	7787	1504	7643	0.0	0.19678136857255005
chr12	TMEM263	106959287	106959385	0	99	0	4777	0	4678	0.0	0.0
chr12	TMEM263	106957081	106957149	0	69	0	4777	0	4708	0.0	0.0
chr12	TMEM263	106967282	106967401	0	120	0	4777	0	4657	0.0	0.0
chr12	TMEM263	106959269	106959385	0	117	0	4777	0	4660	0.0	0.0
chr12	BTBD11	107520486	107520636	0	151	102	7936	102	7785	0.0	0.013102119460500963
chr12	WSCD2	108195281	108196214	0	934	1122	6757	1122	5823	0.0	0.19268418341061308
chr12	WSCD2	108167424	108167581	0	158	1122	6757	1122	6599	0.0	0.17002576147901197
chr12	WSCD2	108244521	108244581	0	61	1122	6757	1122	6696	0.0	0.16756272401433692
chr12	ISCU	108567919	108568016	0	98	0	2718	0	2620	0.0	0.0
chr12	ISCU	108567657	108567743	0	87	0	2718	0	2631	0.0	0.0
chr12	ISCU	108564059	108564155	0	97	0	2718	0	2621	0.0	0.0
chr12	ISCU	108567657	108567757	0	101	0	2718	0	2617	0.0	0.0
chr12	DAO	108884997	108885200	0	204	0	2970	0	2766	0.0	0.0
chr12	DAO	108887449	108887564	0	116	0	2970	0	2854	0.0	0.0
chr12	DAO	108889468	108889545	0	78	0	2970	0	2892	0.0	0.0
chr12	USP30	109057925	109058108	0	184	115985	5010	115985	4826	0.0	24.033360961458765
chr12	USP30	109054679	109054792	0	114	115985	5010	115985	4896	0.0	23.689746732026144
chr12	USP30	109056681	109056791	0	111	115985	5010	115985	4899	0.0	23.6752398448663
chr12	UNG	109101901	109101999	0	99	1508	2552	1508	2453	0.0	0.6147574398695475
chr12	ACACB	109247605	109247703	0	99	46399	14561	46399	14462	0.0	3.20833909556078
chr12	ACACB	109260064	109260149	0	86	46399	14561	46399	14475	0.0	3.2054576856649395
chr12	UBE3B	109481636	109481742	0	107	135155	11625	135155	11518	0.0	11.734242055912485
chr12	UBE3B	109509595	109509714	42	120	135155	11625	135113	11505	0.35	11.743850499782702
chr12	UBE3B	109517916	109518013	210	98	135155	11625	134945	11527	2.142857142857143	11.706862149735404
chr12	MVK	109579801	109579946	0	146	1020	6501	1020	6355	0.0	0.16050354051927615
chr12	MVK	109581394	109581550	0	157	1020	6501	1020	6344	0.0	0.16078184110970997
chr12	MVK	109575997	109576145	0	149	1020	6501	1020	6352	0.0	0.1605793450881612
chr12	MVK	109590770	109590861	0	92	1020	6501	1020	6409	0.0	0.15915119363395225
chr12	MVK	109579164	109579282	0	119	1020	6501	1020	6382	0.0	0.1598245064243184
chr12	MVK	109590682	109590861	0	180	1020	6501	1020	6321	0.0	0.16136687233032748
chr12	ANKRD13A	110033796	110033957	204	162	47958	6836	47754	6674	1.2592592592592593	7.15522924782739
chr12	IFT81	110132546	110132636	0	91	1108	6495	1108	6404	0.0	0.17301686445971268
chr12	IFT81	110143381	110143545	0	165	1108	6495	1108	6330	0.0	0.1750394944707741
chr12	ATP2A2	110322991	110323072	98	82	46604	7473	46506	7391	1.1951219512195121	6.292247327831146
chr12	ATP2A2	110347392	110347453	0	62	46604	7473	46604	7411	0.0	6.28849008231008
chr12	FAM216A	110485077	110485199	51	123	25711	2675	25660	2552	0.4146341463414634	10.054858934169278
chr12	RAD9B	110515049	110515156	0	108	0	3723	0	3615	0.0	0.0
chr12	RAD9B	110512778	110512878	0	101	0	3723	0	3622	0.0	0.0
chr12	RAD9B	110530524	110530633	0	110	0	3723	0	3613	0.0	0.0
chr12	RAD9B	110511427	110511583	0	157	0	3723	0	3566	0.0	0.0
chr12	TCTN1	110619835	110619956	0	122	6981	5815	6981	5693	0.0	1.226242754259617
chr12	TCTN1	110634395	110634463	0	69	6981	5815	6981	5746	0.0	1.2149321266968325
chr12	TCTN1	110647748	110647893	533	146	6981	5815	6448	5669	3.6506849315068495	1.1374140059975304
chr12	TCTN1	110634669	110634779	0	111	6981	5815	6981	5704	0.0	1.2238779803646564
chr12	TCTN1	110616720	110616904	0	185	6981	5815	6981	5630	0.0	1.2399644760213144
chr12	TCTN1	110616276	110616352	0	77	6981	5815	6981	5738	0.0	1.216626002091321
chr12	TCTN1	110628051	110628224	0	174	6981	5815	6981	5641	0.0	1.2375465343024286
chr12	TCTN1	110616747	110616904	0	158	6981	5815	6981	5657	0.0	1.2340463143008662
chr12	TCTN1	110627929	110628224	23	296	6981	5815	6958	5519	0.0777027027027027	1.260735640514586
chr12	TCTN1	110641023	110641149	0	127	6981	5815	6981	5688	0.0	1.2273206751054853
chr12	TCTN1	110644966	110645129	0	164	6981	5815	6981	5651	0.0	1.2353565740576888
chr12	CCDC63	110853404	110853574	0	171	89852	2196	89852	2025	0.0	44.37135802469136
chr12	CCDC63	110879905	110880087	1348	183	89852	2196	88504	2013	7.366120218579235	43.96621957277695
chr12	CCDC63	110852858	110852963	0	106	89852	2196	89852	2090	0.0	42.991387559808615
chr12	LINC01405	110938289	110938512	7707	224	85609	5398	77902	5174	34.40625	15.056436026285272
chr12	ACAD10	111712497	111712657	0	161	51	8026	51	7865	0.0	0.006484424666242848
chr12	ACAD10	111715820	111715962	0	143	51	8026	51	7883	0.0	0.006469618165672967
chr12	ACAD10	111727961	111728143	0	183	51	8026	51	7843	0.0	0.006502613795741426
chr12	ACAD10	111729805	111729956	0	152	51	8026	51	7874	0.0	0.006477012954025908
chr12	ACAD10	111686350	111686374	0	25	51	8026	51	8001	0.0	0.006374203224596925
chr12	ACAD10	111710272	111710365	0	94	51	8026	51	7932	0.0	0.006429652042360061
chr12	ALDH2	111783157	111783298	0	142	2472	6558	2472	6416	0.0	0.385286783042394
chr12	ALDH2	111799905	111800063	1331	159	2472	6558	1141	6399	8.371069182389936	0.17830911079856226
chr12	ALDH2	111775604	111775720	0	117	2472	6558	2472	6441	0.0	0.38379133674895205
chr12	MAPKAPK5	111868752	111868861	0	110	106850	8890	106850	8780	0.0	12.169703872437358
chr12	MAPKAPK5	111882789	111882853	0	65	106850	8890	106850	8825	0.0	12.107648725212465
chr12	ERP29	112019755	112019894	0	140	204	3054	204	2914	0.0	0.07000686341798215
chr12	TRAFD1	112140118	112140205	1	88	4657	3776	4656	3688	0.011363636363636364	1.262472885032538
chr12	TRAFD1	112133139	112133320	663	182	4657	3776	3994	3594	3.642857142857143	1.1112966054535336
chr12	TRAFD1	112126084	112126149	10	66	4657	3776	4647	3710	0.15151515151515152	1.2525606469002695
chr12	RPH3A	112792142	112792263	0	122	103767	9716	103767	9594	0.0	10.815822388993121
chr12	RPH3A	112828300	112828389	0	90	103767	9716	103767	9626	0.0	10.77986702680241
chr12	RPH3A	112836490	112836502	0	13	103767	9716	103767	9703	0.0	10.694321343914254
chr12	RPH3A	112847695	112847842	0	148	103767	9716	103767	9568	0.0	10.845213210702342
chr12	RPH3A	112718005	112718087	0	83	103767	9716	103767	9633	0.0	10.772033634381813
chr12	RPH3A	112617724	112617842	338	119	103767	9716	103429	9597	2.8403361344537816	10.77722204855684
chr12	RPH3A	112836498	112836502	0	5	103767	9716	103767	9711	0.0	10.685511275872722
chr12	RPH3A	112813321	112813385	403	65	103767	9716	103364	9651	6.2	10.710185473007979
chr12	RPH3A	112831744	112831853	0	110	103767	9716	103767	9606	0.0	10.802311055590256
chr12	OAS3	112941569	112941852	0	284	197695	8177	197695	7893	0.0	25.046876979602178
chr12	OAS2	112987037	112987308	240	272	306	5140	66	4868	0.8823529411764706	0.013557929334428924
chr12	OAS2	112987037	112987083	0	47	306	5140	306	5093	0.0	0.06008246612998233
chr12	CFAP73	113154413	113154635	0	223	0	1734	0	1511	0.0	0.0
chr12	RITA1	113186192	113186316	0	125	0	2313	0	2188	0.0	0.0
chr12	RITA1	113186184	113186316	0	133	0	2313	0	2180	0.0	0.0
chr12	TPCN1	113226727	113226964	102	238	102	8434	0	8196	0.42857142857142855	0.0
chr12	TPCN1	113225243	113225336	0	94	102	8434	102	8340	0.0	0.01223021582733813
chr12	TPCN1	113245911	113246063	0	153	102	8434	102	8281	0.0	0.012317352976693636
chr12	TPCN1	113284717	113284771	0	55	102	8434	102	8379	0.0	0.01217329036877909
chr12	TPCN1	113288494	113288526	0	33	102	8434	102	8401	0.0	0.012141411736698013
chr12	PLBD2	113369115	113369209	0	95	5084	5277	5084	5182	0.0	0.9810883828637592
chr12	PLBD2	113384850	113384946	0	97	5084	5277	5084	5180	0.0	0.9814671814671815
chr12	SDSL	113427961	113428156	0	196	1415	2082	1415	1886	0.0	0.7502651113467657
chr12	SDSL	113429159	113429299	0	141	1415	2082	1415	1941	0.0	0.729005667181865
chr12	SDSL	113427129	113427251	0	123	1415	2082	1415	1959	0.0	0.7223072996426748
chr12	AC026765.3	114749843	114750024	0	182	0	2312	0	2130	0.0	0.0
chr12	AC026765.3	114748095	114748210	0	116	0	2312	0	2196	0.0	0.0
chr12	AC026765.3	114752899	114753011	0	113	0	2312	0	2199	0.0	0.0
chr12	RNFT2	116849313	116849484	0	172	717	4472	717	4300	0.0	0.16674418604651162
chr12	RNFT2	116748661	116748744	0	84	717	4472	717	4388	0.0	0.16340018231540565
chr12	RFC5	118017689	118017815	0	127	0	3264	0	3137	0.0	0.0
chr12	RFC5	118017994	118018053	0	60	0	3264	0	3204	0.0	0.0
chr12	RFC5	118017689	118018053	0	365	0	3264	0	2899	0.0	0.0
chr12	RFC5	118017689	118017852	0	164	0	3264	0	3100	0.0	0.0
chr12	SUDS3	118401982	118402004	0	23	37	5572	37	5549	0.0	0.006667868084339521
chr12	SRRM4	119144538	119144554	0	17	714	11922	714	11905	0.0	0.05997480050398992
chr12	HSPB8	119187024	119187088	0	65	0	3593	0	3528	0.0	0.0
chr12	HSPB8	119213676	119213741	0	66	0	3593	0	3527	0.0	0.0
chr12	HSPB8	119187249	119187321	0	73	0	3593	0	3520	0.0	0.0
chr12	HSPB8	119187208	119187321	0	114	0	3593	0	3479	0.0	0.0
chr12	HSPB8	119187191	119187321	0	131	0	3593	0	3462	0.0	0.0
chr12	PRKAB1	119671494	119671668	0	175	51	3766	51	3591	0.0	0.014202172096908938
chr12	BICDL1	120072510	120072729	0	220	137	5177	137	4957	0.0	0.02763768408311479
chr12	BICDL1	120074442	120074586	0	145	137	5177	137	5032	0.0	0.027225755166931636
chr12	BICDL1	120090910	120091019	0	110	137	5177	137	5067	0.0	0.02703769488849418
chr12	PXN-AS1	120210929	120211106	0	178	1224	4119	1224	3941	0.0	0.31058107079421465
chr12	AC003982.1	120393501	120393577	0	77	0	414	0	337	0.0	0.0
chr12	GATC	120454932	120455030	0	99	153	4421	153	4322	0.0	0.035400277649236464
chr12	RNF10	120552498	120552698	1734	201	481108	5535	479374	5334	8.626865671641792	89.87139107611549
chr12	RNF10	120562944	120563070	0	127	481108	5535	481108	5408	0.0	88.96227810650888
chr12	RNF10	120566824	120566980	102	157	481108	5535	481006	5378	0.6496815286624203	89.43956861286723
chr12	RNF10	120571190	120571291	1224	102	481108	5535	479884	5433	12.0	88.32762746180747
chr12	RNF10	120539367	120539468	14	102	481108	5535	481094	5433	0.13725490196078433	88.55034051168784
chr12	RNF10	120574467	120574537	13682	71	481108	5535	467426	5464	192.70422535211267	85.54648609077599
chr12	CABP1	120656092	120656272	17955	181	527789	4733	509834	4552	99.1988950276243	112.00219683655536
chr12	MLEC	120695094	120695152	876	59	5634	2623	4758	2564	14.847457627118644	1.8556942277691109
chr12	MLEC	120694823	120695000	1020	178	5634	2623	4614	2445	5.730337078651686	1.887116564417178
chr12	HNF1A	120988832	120989032	0	201	191671	4197	191671	3996	0.0	47.96571571571572
chr12	HNF1A	120993519	120993706	0	188	191671	4197	191671	4009	0.0	47.810177101521575
chr12	HNF1A	120994163	120994405	0	243	191671	4197	191671	3954	0.0	48.47521497218007
chr12	P2RX7	121160901	121160974	15228	74	80309	5559	65081	5485	205.78378378378378	11.865268915223336
chr12	P2RX7	121162423	121162520	0	98	80309	5559	80309	5461	0.0	14.705914667643288
chr12	P2RX7	121167487	121167624	102	138	80309	5559	80207	5421	0.7391304347826086	14.795609666113263
chr12	P2RX7	121154784	121154953	14489	170	80309	5559	65820	5389	85.22941176470589	12.213768788272407
chr12	P2RX7	121162270	121162520	0	251	80309	5559	80309	5308	0.0	15.129804069329314
chr12	P2RX7	121166057	121166187	51	131	80309	5559	80258	5428	0.3893129770992366	14.785924834193073
chr12	P2RX7	121155235	121155374	0	140	80309	5559	80309	5419	0.0	14.819892969182506
chr12	P2RX4	121217133	121217281	459	149	1351	2757	892	2608	3.0805369127516777	0.34202453987730064
chr12	P2RX4	121222946	121223043	0	98	1351	2757	1351	2659	0.0	0.5080857465212486
chr12	P2RX4	121216954	121217002	0	49	1351	2757	1351	2708	0.0	0.4988921713441654
chr12	P2RX4	121222729	121222767	0	39	1351	2757	1351	2718	0.0	0.49705665930831494
chr12	P2RX4	121222946	121222962	0	17	1351	2757	1351	2740	0.0	0.4930656934306569
chr12	RNF34	121402741	121402807	0	67	153	4729	153	4662	0.0	0.032818532818532815
chr12	RNF34	121404848	121405113	0	266	153	4729	153	4463	0.0	0.03428187317947569
chr12	TMEM120B	121774657	121774722	0	66	96729	6676	96729	6610	0.0	14.633736762481089
chr12	TMEM120B	121776821	121777897	306	1077	96729	6676	96423	5599	0.2841225626740947	17.22146811930702
chr12	PSMD9	121899633	121899845	803	213	9381	8780	8578	8567	3.7699530516431925	1.0012839967316447
chr12	PSMD9	121910941	121911006	0	66	9381	8780	9381	8714	0.0	1.076543493229286
chr12	PSMD9	121894738	121894841	0	104	9381	8780	9381	8676	0.0	1.0812586445366528
chr12	PSMD9	121899633	121899889	803	257	9381	8780	8578	8523	3.124513618677043	1.0064531268332746
chr12	AC156455.1	122064549	122064682	569	134	1310	1721	741	1587	4.246268656716418	0.4669187145557656
chr12	AC156455.1	122064138	122064433	0	296	1310	1721	1310	1425	0.0	0.9192982456140351
chr12	MLXIP	122132291	122132383	0	93	100599	13103	100599	13010	0.0	7.732436587240584
chr12	B3GNT4	122204521	122204684	239	164	26754	2353	26515	2189	1.4573170731707317	12.112836911831886
chr12	CLIP1-AS1	122396582	122396705	0	124	1425	1812	1425	1688	0.0	0.8441943127962085
chr12	KNTC1	122544158	122544269	0	112	30269	10601	30269	10489	0.0	2.8857851082085997
chr12	KNTC1	122617406	122617501	0	96	30269	10601	30269	10505	0.0	2.8813898143741077
chr12	CCDC62	122823365	122823459	198	95	11163	4293	10965	4198	2.0842105263157893	2.61195807527394
chr12	HIP1R	122860422	122860523	0	102	26778	6969	26778	6867	0.0	3.8995194408038443
chr12	OGFOD2	122976252	122976401	51	150	44735	3734	44684	3584	0.34	12.467633928571429
chr12	OGFOD2	122975810	122975867	0	58	44735	3734	44735	3676	0.0	12.169477693144723
chr12	OGFOD2	122976653	122976767	588	115	44735	3734	44147	3619	5.113043478260869	12.198673666758774
chr12	OGFOD2	122977980	122978091	95	112	44735	3734	44640	3622	0.8482142857142857	12.324682495858642
chr12	OGFOD2	122976600	122976767	612	168	44735	3734	44123	3566	3.642857142857143	12.373247335950644
chr12	OGFOD2	122977980	122978199	95	220	44735	3734	44640	3514	0.4318181818181818	12.703471826977802
chr12	OGFOD2	122977980	122978057	95	78	44735	3734	44640	3656	1.2179487179487178	12.210065645514224
chr12	C12ORF65	123233739	123233924	64	186	565267	6318	565203	6132	0.34408602150537637	92.17270058708415
chr12	KMT5A	123389432	123389554	0	123	330	4523	330	4400	0.0	0.075
chr12	TMED2	123587610	123587631	0	22	515	3838	515	3816	0.0	0.134958071278826
chr12	DDX55	123616510	123616603	0	94	1252	5270	1252	5176	0.0	0.24188562596599691
chr12	DDX55	123607431	123607523	490	93	1252	5270	762	5177	5.268817204301075	0.14718949198377437
chr12	GTF2H3	123639263	123639343	2532	81	9642	3941	7110	3860	31.25925925925926	1.8419689119170986
chr12	GTF2H3	123655770	123655824	0	55	9642	3941	9642	3886	0.0	2.481214616572311
chr12	GTF2H3	123647962	123648126	114	165	9642	3941	9528	3776	0.6909090909090909	2.5233050847457625
chr12	GTF2H3	123639293	123639343	1457	51	9642	3941	8185	3890	28.568627450980394	2.1041131105398456
chr12	GTF2H3	123639956	123640001	69	46	9642	3941	9573	3895	1.5	2.4577663671373555
chr12	GTF2H3	123654923	123654998	0	76	9642	3941	9642	3865	0.0	2.4946959896507117
chr12	ATP6V0A2	123742028	123742093	10512	66	27623	17237	17111	17171	159.27272727272728	0.9965057364160503
chr12	ATP6V0A2	123735892	123736540	7094	649	27623	17237	20529	16588	10.930662557781202	1.2375813841331083
chr12	DNAH10	123793941	123794112	7780	172	126523	16312	118743	16140	45.23255813953488	7.357063197026022
chr12	DNAH10	123932617	123932731	0	115	126523	16312	126523	16197	0.0	7.811508304006915
chr12	ZNF664	123988042	123988138	153	97	23395	6130	23242	6033	1.577319587628866	3.8524780374606333
chr12	ZNF664	123988045	123988138	153	94	23395	6130	23242	6036	1.627659574468085	3.850563286944997
chr12	AACS	125078095	125078370	0	276	204	16061	204	15785	0.0	0.012923661704149509
chr12	AACS	125136661	125136864	0	204	204	16061	204	15857	0.0	0.012864980765592483
chr12	LINC02826	126030564	126030821	0	258	0	3943	0	3685	0.0	0.0
chr12	LINC02826	126027205	126027313	0	109	0	3943	0	3834	0.0	0.0
chr12	LINC02826	126028213	126028320	0	108	0	3943	0	3835	0.0	0.0
chr12	LINC02359	126111090	126111225	0	136	51	9009	51	8873	0.0	0.005747774146286487
chr12	AC007368.1	126225264	126225314	0	51	51	5841	51	5790	0.0	0.008808290155440414
chr12	AC007368.1	126350458	126350613	51	156	51	5841	0	5685	0.3269230769230769	0.0
chr12	LINC02347	126460882	126461000	0	119	0	5846	0	5727	0.0	0.0
chr12	LINC02347	126466548	126466727	0	180	0	5846	0	5666	0.0	0.0
chr12	LINC02347	126442965	126443027	0	63	0	5846	0	5783	0.0	0.0
chr12	LINC02347	126457932	126458541	0	610	0	5846	0	5236	0.0	0.0
chr12	LINC02347	126457932	126458130	0	199	0	5846	0	5647	0.0	0.0
chr12	LINC02347	126462717	126462825	0	109	0	5846	0	5737	0.0	0.0
chr12	LINC02347	126466548	126467321	0	774	0	5846	0	5072	0.0	0.0
chr12	LINC00943	126725582	126725673	0	92	0	8509	0	8417	0.0	0.0
chr12	LINC00943	126742739	126743480	0	742	0	8509	0	7767	0.0	0.0
chr12	LINC00943	126744769	126744919	0	151	0	8509	0	8358	0.0	0.0
chr12	LINC00943	126744769	126744888	0	120	0	8509	0	8389	0.0	0.0
chr12	LINC00943	126744774	126744919	0	146	0	8509	0	8363	0.0	0.0
chr12	LINC00943	126743375	126743480	0	106	0	8509	0	8403	0.0	0.0
chr12	LINC00943	126744774	126744888	0	115	0	8509	0	8394	0.0	0.0
chr12	LINC00943	126743339	126743480	0	142	0	8509	0	8367	0.0	0.0
chr12	AC078878.2	126885864	126885938	0	75	0	1291	0	1216	0.0	0.0
chr12	LINC02393	127893867	127893961	0	95	0	2323	0	2228	0.0	0.0
chr12	LINC00507	127944717	127944799	0	83	0	6567	0	6484	0.0	0.0
chr12	LINC00507	127948823	127948958	0	136	0	6567	0	6431	0.0	0.0
chr12	LINC00507	127944717	127944787	0	71	0	6567	0	6496	0.0	0.0
chr12	LINC00507	127948823	127948922	0	100	0	6567	0	6467	0.0	0.0
chr12	LINC00507	127934289	127934349	0	61	0	6567	0	6506	0.0	0.0
chr12	LINC00507	127947471	127947949	0	479	0	6567	0	6088	0.0	0.0
chr12	LINC00507	127942381	127942980	0	600	0	6567	0	5967	0.0	0.0
chr12	LINC00507	127918915	127919115	0	201	0	6567	0	6366	0.0	0.0
chr12	GLT1D1	128899235	128899287	0	53	0	3493	0	3440	0.0	0.0
chr12	GLT1D1	128906906	128906954	0	49	0	3493	0	3444	0.0	0.0
chr12	TMEM132D-AS1	129110992	129111139	0	148	0	696	0	548	0.0	0.0
chr12	TMEM132D-AS1	129111419	129111515	0	97	0	696	0	599	0.0	0.0
chr12	TMEM132D-AS1	129111419	129111669	0	251	0	696	0	445	0.0	0.0
chr12	RAN	130872583	130872629	0	47	0	3779	0	3732	0.0	0.0
chr12	RAN	130872583	130872617	0	35	0	3779	0	3744	0.0	0.0
chr12	RAN	130874033	130874084	0	52	0	3779	0	3727	0.0	0.0
chr12	ADGRD1	130981883	130982063	0	181	0	12355	0	12174	0.0	0.0
chr12	ADGRD1	130968976	130969072	0	97	0	12355	0	12258	0.0	0.0
chr12	LINC01257	131215406	131215548	0	143	0	4249	0	4106	0.0	0.0
chr12	LINC01257	131212204	131212286	0	83	0	4249	0	4166	0.0	0.0
chr12	SFSWAP	131764455	131764686	0	232	204	8562	204	8330	0.0	0.024489795918367346
chr12	SFSWAP	131785072	131785228	0	157	204	8562	204	8405	0.0	0.024271267102914933
chr12	MMP17	131838194	131838327	0	134	0	3010	0	2876	0.0	0.0
chr12	PUS1	131929734	131929796	0	63	0	5331	0	5268	0.0	0.0
chr12	EP400	131981488	131981596	0	109	51	16228	51	16119	0.0	0.003163967988088591
chr12	EP400	131963531	131963642	0	112	51	16228	51	16116	0.0	0.0031645569620253164
chr12	EP400P1	132090848	132090943	0	96	0	11921	0	11825	0.0	0.0
chr12	EP400P1	132103996	132105304	0	1309	0	11921	0	10612	0.0	0.0
chr12	EP400P1	132085256	132085316	0	61	0	11921	0	11860	0.0	0.0
chr12	EP400P1	132091394	132091516	0	123	0	11921	0	11798	0.0	0.0
chr12	EP400P1	132084963	132085316	0	354	0	11921	0	11567	0.0	0.0
chr12	EP400P1	132109767	132109832	0	66	0	11921	0	11855	0.0	0.0
chr12	NOC4L	132150980	132151041	0	62	0	2036	0	1974	0.0	0.0
chr12	NOC4L	132146239	132146365	0	127	0	2036	0	1909	0.0	0.0
chr12	FBRSL1	132571067	132571136	0	70	69289	9402	69289	9332	0.0	7.4248821260180025
chr12	FBRSL1	132574089	132574158	146	70	69289	9402	69143	9332	2.085714285714286	7.40923703386198
chr12	P2RX2	132619678	132619750	46	73	35491	1867	35445	1794	0.6301369863013698	19.75752508361204
chr12	P2RX2	132619843	132619919	238	77	35491	1867	35253	1790	3.090909090909091	19.69441340782123
chr12	PXMP2	132695883	132696046	0	164	0	1427	0	1263	0.0	0.0
chr12	PXMP2	132701249	132701369	0	121	0	1427	0	1306	0.0	0.0
chr12	PXMP2	132702428	132702564	0	137	0	1427	0	1290	0.0	0.0
chr12	ZNF26	133007436	133007532	0	97	51	4793	51	4696	0.0	0.0108603066439523
chr12	ZNF26	133001632	133001731	0	100	51	4793	51	4693	0.0	0.010867249094395908
chr12	ZNF84	133050523	133050586	0	64	306	8823	306	8759	0.0	0.03493549491951136
chr12	ZNF140	133081272	133081329	0	58	1325	4746	1325	4688	0.0	0.28263651877133106
chr12	ZNF140	133093414	133093505	0	92	1325	4746	1325	4654	0.0	0.2847013321873657
chr12	ZNF140	133081531	133081613	0	83	1325	4746	1325	4663	0.0	0.2841518335835299
chr12	ZNF140	133100986	133101053	612	68	1325	4746	713	4678	9.0	0.15241556220607097
chr12	ZNF10	133130836	133131014	1974	179	40038	5508	38064	5329	11.027932960893855	7.142803527866391
chr12	ZNF10	133144433	133144525	0	93	40038	5508	40038	5415	0.0	7.393905817174515
chr12	ZNF10	133143519	133143622	0	104	40038	5508	40038	5404	0.0	7.408956328645448
chr12	ZNF10	133139198	133139249	0	52	40038	5508	40038	5456	0.0	7.338343108504398
chr12	ZNF268	133187871	133188072	0	202	564660	14004	564660	13802	0.0	40.91146210694102
chr12	ZNF268	133191488	133191615	0	128	564660	14004	564660	13876	0.0	40.69328336696454
chr12	ZNF268	133193427	133193533	0	107	564660	14004	564660	13897	0.0	40.63179103403612
chr12	ZNF268	133191907	133192003	0	97	564660	14004	564660	13907	0.0	40.602574243186886
chr12	ZNF268	133184663	133184759	0	97	564660	14004	564660	13907	0.0	40.602574243186886
chr12	ZNF268	133187864	133188072	0	209	564660	14004	564660	13795	0.0	40.932221819499816
chr12	ZNF268	133191533	133191615	0	83	564660	14004	564660	13921	0.0	40.561741254220244
chr12	SLC6A12	197899	198003	0	105	0	5131	0	5026	0.0	0.0
chr12	SLC6A12	201761	201849	0	89	0	5131	0	5042	0.0	0.0
chr12	SLC6A12	210204	210568	0	365	0	5131	0	4766	0.0	0.0
chr12	SLC6A12	212025	212110	0	86	0	5131	0	5045	0.0	0.0
chr12	SLC6A13	259850	260057	0	208	0	3973	0	3765	0.0	0.0
chr12	SLC6A13	238170	238343	0	174	0	3973	0	3799	0.0	0.0
chr12	KDM5A	384030	384153	622	124	2447	12060	1825	11936	5.016129032258065	0.15289879356568364
chr12	KDM5A	387247	387274	0	28	2447	12060	2447	12032	0.0	0.20337433510638298
chr12	RAD52	932974	933076	0	103	10810	4296	10810	4193	0.0	2.5781063677557836
chr12	RAD52	926795	926946	0	152	10810	4296	10810	4144	0.0	2.6085907335907335
chr12	RAD52	936806	936882	0	77	10810	4296	10810	4219	0.0	2.562218535197914
chr12	RAD52	931219	931321	0	103	10810	4296	10810	4193	0.0	2.5781063677557836
chr12	CACNA2D4	1810542	1810587	885	46	41714	7501	40829	7455	19.23913043478261	5.476727028839705
chr12	CACNA2D4	1811661	1811723	0	63	41714	7501	41714	7438	0.0	5.6082280182844855
chr12	CACNA2D4	1801573	1801644	0	72	41714	7501	41714	7429	0.0	5.6150222102571
chr12	CACNA2D4	1853950	1854044	0	95	41714	7501	41714	7406	0.0	5.632460167431812
chr12	CACNA2D4	1874603	1874675	0	73	41714	7501	41714	7428	0.0	5.615778136779753
chr12	CACNA2D4	1878314	1878389	0	76	41714	7501	41714	7425	0.0	5.618047138047138
chr12	CACNA2D4	1878314	1878441	0	128	41714	7501	41714	7373	0.0	5.657669876576699
chr12	DCP1B	1991120	1991246	0	127	0	4542	0	4415	0.0	0.0
chr12	CACNA1C-AS4	2222199	2222420	0	222	0	1791	0	1569	0.0	0.0
chr12	FOXM1	2865354	2865399	0	46	102	4411	102	4365	0.0	0.02336769759450172
chr12	FOXM1	2872095	2872247	51	153	102	4411	51	4258	0.3333333333333333	0.011977454203851573
chr12	FOXM1	2872095	2872244	51	150	102	4411	51	4261	0.34	0.011969021356489086
chr12	FOXM1	2861298	2861412	0	115	102	4411	102	4296	0.0	0.023743016759776536
chr12	AC005865.1	3331809	3332392	0	584	459	4670	459	4086	0.0	0.11233480176211454
chr12	THCAT155	3489928	3490241	0	314	0	6525	0	6211	0.0	0.0
chr12	PARP11	3828909	3829030	0	122	0	3337	0	3215	0.0	0.0
chr12	PARP11	3863835	3863957	0	123	0	3337	0	3214	0.0	0.0
chr12	PARP11	3814994	3815053	0	60	0	3337	0	3277	0.0	0.0
chr12	C12ORF4	4518773	4518880	0	108	51	4948	51	4840	0.0	0.010537190082644627
chr12	C12ORF4	4529868	4530050	0	183	51	4948	51	4765	0.0	0.010703043022035676
chr12	C12ORF4	4536016	4536219	0	204	51	4948	51	4744	0.0	0.010750421585160203
chr12	C12ORF4	4536016	4536211	0	196	51	4948	51	4752	0.0	0.010732323232323232
chr12	C12ORF4	4502310	4502482	0	173	51	4948	51	4775	0.0	0.01068062827225131
chr12	C12ORF4	4536016	4536082	0	67	51	4948	51	4881	0.0	0.010448678549477565
chr12	AKAP3	4641898	4642004	0	107	6262	3678	6262	3571	0.0	1.7535704284514142
chr12	AKAP3	4641898	4642033	0	136	6262	3678	6262	3542	0.0	1.7679277244494636
chr12	LINC02443	5239887	5240112	0	226	89	3988	89	3762	0.0	0.023657628920786815
chr12	LINC02443	5243067	5243281	0	215	89	3988	89	3773	0.0	0.023588656241717465
chr12	LINC02443	5239979	5240112	0	134	89	3988	89	3854	0.0	0.02309289050337312
chr12	ANO2	5732865	5732877	0	13	0	5698	0	5685	0.0	0.0
chr12	ANO2	5836777	5836780	0	4	0	5698	0	5694	0.0	0.0
chr12	ANO2	5851956	5851959	0	4	0	5698	0	5694	0.0	0.0
chr12	VWF	6122724	6122966	0	243	51	10404	51	10161	0.0	0.005019191024505462
chr12	TNFRSF1A	6330852	6330926	0	75	41294	3562	41294	3487	0.0	11.842271293375394
chr12	TNFRSF1A	6333736	6333865	0	130	41294	3562	41294	3432	0.0	12.032051282051283
chr12	TNFRSF1A	6334090	6334244	0	155	41294	3562	41294	3407	0.0	12.120340475491634
chr12	TNFRSF1A	6333844	6333865	0	22	41294	3562	41294	3540	0.0	11.664971751412429
chr12	TNFRSF1A	6333736	6333838	0	103	41294	3562	41294	3459	0.0	11.938132408210466
chr12	SCNN1A	6349163	6349221	0	59	767827	5671	767827	5612	0.0	136.8187811831789
chr12	SCNN1A	6362050	6362241	0	192	767827	5671	767827	5479	0.0	140.13998904909656
chr12	SCNN1A	6362067	6362241	0	175	767827	5671	767827	5496	0.0	139.7065138282387
chr12	CD27-AS1	6448639	6448737	51	99	421931	3028	421880	2929	0.5151515151515151	144.03550699897576
chr12	CD27-AS1	6448639	6448757	71	119	421931	3028	421860	2909	0.5966386554621849	145.01890684083878
chr12	CD27-AS1	6450340	6450980	45209	641	421931	3028	376722	2387	70.52886115444618	157.82237117720987
chr12	VAMP1	6466224	6466351	0	128	765	3275	765	3147	0.0	0.2430886558627264
chr12	MRPL51	6492861	6492972	0	112	42363	1177	42363	1065	0.0	39.777464788732395
chr12	IFFO1	6549475	6549484	0	10	4080	4956	4080	4946	0.0	0.8249090173877881
chr12	IFFO1	6551397	6551503	0	107	4080	4956	4080	4849	0.0	0.8414106001237368
chr12	NOP2	6564149	6564248	18	100	30073	4122	30055	4022	0.18	7.472650422675286
chr12	NOP2	6558015	6558137	153	123	30073	4122	29920	3999	1.2439024390243902	7.481870467616904
chr12	CHD4	6580581	6580699	0	119	844242	11254	844242	11135	0.0	75.81876964526269
chr12	CHD4	6583197	6583378	0	182	844242	11254	844242	11072	0.0	76.25018063583815
chr12	CHD4	6570868	6571032	906	165	844242	11254	843336	11089	5.490909090909091	76.05158264947245
chr12	CHD4	6583195	6583378	0	184	844242	11254	844242	11070	0.0	76.2639566395664
chr12	CHD4	6583197	6583375	0	179	844242	11254	844242	11075	0.0	76.22952595936795
chr12	CHD4	6580581	6580679	0	99	844242	11254	844242	11155	0.0	75.68283281039892
chr12	CHD4	6572929	6572984	2124	56	844242	11254	842118	11198	37.92857142857143	75.20253616717271
chr12	CHD4	6590072	6590213	0	142	844242	11254	844242	11112	0.0	75.9757019438445
chr12	ACRBP	6646482	6646577	255549	96	10651507	2699	10395958	2603	2661.96875	3993.8371110257394
chr12	ING4	6652270	6652418	0	149	435	2186	435	2037	0.0	0.21354933726067746
chr12	ING4	6653229	6653396	0	168	435	2186	435	2018	0.0	0.2155599603567889
chr12	ING4	6656726	6656798	0	73	435	2186	435	2113	0.0	0.2058684335068623
chr12	ING4	6652270	6652309	0	40	435	2186	435	2146	0.0	0.20270270270270271
chr12	ING4	6655637	6655913	0	277	435	2186	435	1909	0.0	0.2278679937139864
chr12	ING4	6657804	6657852	12	49	435	2186	423	2137	0.24489795918367346	0.19794103883949463
chr12	ZNF384	6678662	6678710	0	49	143357	3521	143357	3472	0.0	41.28945852534562
chr12	ZNF384	6688166	6688226	580	61	143357	3521	142777	3460	9.508196721311476	41.265028901734105
chr12	ZNF384	6672349	6672532	14613	184	143357	3521	128744	3337	79.41847826086956	38.580761162721004
chr12	ZNF384	6677166	6677259	255	94	143357	3521	143102	3427	2.7127659574468086	41.757222060110884
chr12	CDCA3	6850832	6851009	0	178	2011	4204	2011	4026	0.0	0.49950322901142574
chr12	CDCA3	6849322	6849429	0	108	2011	4204	2011	4096	0.0	0.490966796875
chr12	CDCA3	6849322	6849413	0	92	2011	4204	2011	4112	0.0	0.489056420233463
chr12	PHB2	6965910	6965916	6471	7	427344	2236	420873	2229	924.4285714285714	188.81695827725437
chr12	PHB2	6969497	6969577	23953	81	427344	2236	403391	2155	295.71604938271605	187.18839907192574
chr12	PHB2	6969955	6970063	88	109	427344	2236	427256	2127	0.8073394495412844	200.87259050305596
chr12	LPCAT3	6981003	6981182	4801	180	4462196	4160	4457395	3980	26.67222222222222	1119.9484924623116
chr12	LPCAT3	6981594	6981632	451	39	4462196	4160	4461745	4121	11.564102564102564	1082.685027905848
chr12	LPCAT3	7001427	7001486	0	60	4462196	4160	4462196	4100	0.0	1088.340487804878
chr12	C1R	7085860	7086016	21952	157	241510	4719	219558	4562	139.82165605095543	48.127575624726
chr12	C1R	7091451	7091680	849	230	241510	4719	240661	4489	3.6913043478260867	53.611271998217866
chr12	C1RL	7099685	7099760	386	76	32165	4392	31779	4316	5.078947368421052	7.36306765523633
chr12	C1R	7091451	7091636	695	186	241510	4719	240815	4533	3.736559139784946	53.12486212221487
chr12	C1RL	7099900	7100026	60	127	32165	4392	32105	4265	0.47244094488188976	7.527549824150059
chr12	C1RL	7108250	7108479	0	230	32165	4392	32165	4162	0.0	7.728255646323883
chr12	CD163L1	7398263	7398584	0	322	2207	5555	2207	5233	0.0	0.4217466080642079
chr12	CD163	7481160	7481256	0	97	204	5760	204	5663	0.0	0.03602330920007064
chr12	CD163	7482642	7482762	0	121	204	5760	204	5639	0.0	0.03617662706153573
chr12	APOBEC1	7654604	7654632	0	29	0	899	0	870	0.0	0.0
chr12	CLEC4C	7741420	7741531	0	112	0	1574	0	1462	0.0	0.0
chr12	CLEC4C	7746330	7746423	0	94	0	1574	0	1480	0.0	0.0
chr12	SLC2A14	7831603	7831764	0	162	64	5594	64	5432	0.0	0.011782032400589101
chr12	SLC2A14	7871872	7871948	0	77	64	5594	64	5517	0.0	0.011600507522204097
chr12	SLC2A14	7863368	7863457	0	90	64	5594	64	5504	0.0	0.011627906976744186
chr12	SLC2A14	7871178	7871283	0	106	64	5594	64	5488	0.0	0.011661807580174927
chr12	SLC2A14	7872110	7872372	51	263	64	5594	13	5331	0.19391634980988592	0.0024385668730069407
chr12	SLC2A14	7870840	7871062	0	223	64	5594	64	5371	0.0	0.011915844349283188
chr12	SLC2A14	7839716	7839920	0	205	64	5594	64	5389	0.0	0.011876043792911486
chr12	SLC2A3	7933809	7933902	0	94	177	5763	177	5669	0.0	0.03122243781972129
chr12	FAM90A1	8225835	8225992	51	158	62	2545	11	2387	0.3227848101265823	0.004608294930875576
chr12	FAM90A1	8225835	8226014	51	180	62	2545	11	2365	0.2833333333333333	0.004651162790697674
chr12	CLEC4E	8536089	8536205	0	117	29	2107	29	1990	0.0	0.01457286432160804
chr12	AICDA	8604806	8604922	0	117	0	3111	0	2994	0.0	0.0
chr12	AICDA	8605214	8605485	0	272	0	3111	0	2839	0.0	0.0
chr12	AICDA	8604806	8604892	0	87	0	3111	0	3024	0.0	0.0
chr12	MFAP5	8651661	8651691	0	31	0	3781	0	3750	0.0	0.0
chr12	MFAP5	8660862	8660898	0	37	0	3781	0	3744	0.0	0.0
chr12	MFAP5	8654436	8654481	0	46	0	3781	0	3735	0.0	0.0
chr12	MFAP5	8648486	8648555	0	70	0	3781	0	3711	0.0	0.0
chr12	M6PR	8946715	8946824	0	110	612	2693	612	2583	0.0	0.23693379790940766
chr12	A2M	9112376	9112536	255	161	194976	6357	194721	6196	1.5838509316770186	31.426888315041964
chr12	PZP	9164132	9164259	0	128	1020	6291	1020	6163	0.0	0.1655038130780464
chr12	PZP	9162596	9162648	0	53	1020	6291	1020	6238	0.0	0.1635139467778134
chr12	AC010186.1	9647455	9647564	35	110	86	719	51	609	0.3181818181818182	0.08374384236453201
chr12	CLECL1	9718640	9718774	0	135	2	1576	2	1441	0.0	0.0013879250520471894
chr12	CLEC2B	9862498	9862573	0	76	0	2643	0	2567	0.0	0.0
chr12	CLEC1B	9998281	9998380	32	100	32	3679	0	3579	0.32	0.0
chr12	CLEC1A	10089123	10089222	0	100	0	3177	0	3077	0.0	0.0
chr12	CLEC1A	10081236	10081413	0	178	0	3177	0	2999	0.0	0.0
chr12	CLEC1A	10092421	10092519	0	99	0	3177	0	3078	0.0	0.0
chr12	CLEC7A	10123244	10123363	0	120	0	3288	0	3168	0.0	0.0
chr12	CLEC7A	10126570	10126708	0	139	0	3288	0	3149	0.0	0.0
chr12	CLEC7A	10127746	10127845	0	100	0	3288	0	3188	0.0	0.0
chr12	CLEC7A	10125086	10125173	0	88	0	3288	0	3200	0.0	0.0
chr12	CLEC7A	10125296	10125448	0	153	0	3288	0	3135	0.0	0.0
chr12	CLEC7A	10127039	10127089	0	51	0	3288	0	3237	0.0	0.0
chr12	OLR1	10160346	10160462	0	117	0	1852	0	1735	0.0	0.0
chr12	OLR1	10160785	10160925	0	141	0	1852	0	1711	0.0	0.0
chr12	OLR1	10167186	10167308	0	123	0	1852	0	1729	0.0	0.0
chr12	KLRC4-KLRK1	10379446	10379482	0	37	11309	2526	11309	2489	0.0	4.543591803937324
chr12	KLRC4-KLRK1	10389942	10390027	0	86	11309	2526	11309	2440	0.0	4.63483606557377
chr12	KLRC4-KLRK1	10393809	10393867	0	59	11309	2526	11309	2467	0.0	4.584110255370896
chr12	KLRC4-KLRK1	10405849	10405950	0	102	11309	2526	11309	2424	0.0	4.66542904290429
chr12	KLRC4-KLRK1	10409388	10409478	0	91	11309	2526	11309	2435	0.0	4.64435318275154
chr12	KLRC4-KLRK1	10391834	10391891	0	58	11309	2526	11309	2468	0.0	4.582252836304701
chr12	KLRC1	10449913	10449967	0	55	102	2736	102	2681	0.0	0.03804550540842969
chr12	MAGOHB	10609097	10609383	0	287	0	3788	0	3501	0.0	0.0
chr12	MAGOHB	10612639	10612978	0	340	0	3788	0	3448	0.0	0.0
chr12	MAGOHB	10612814	10612978	0	165	0	3788	0	3623	0.0	0.0
chr12	STYK1	10637070	10637196	0	127	0	3454	0	3327	0.0	0.0
chr12	STYK1	10667288	10667455	0	168	0	3454	0	3286	0.0	0.0
chr12	STYK1	10640669	10640734	0	66	0	3454	0	3388	0.0	0.0
chr12	YBX3	10709907	10710114	0	208	85	7024	85	6816	0.0	0.012470657276995305
chr12	PRH1	10883060	10883096	0	37	0	2778	0	2741	0.0	0.0
chr12	AC018630.4	10884153	10884275	0	123	761	1630	761	1507	0.0	0.5049767750497678
chr12	PRH1	11121009	11121180	0	172	0	2778	0	2606	0.0	0.0
chr12	AC078950.1	11435125	11435158	0	34	0	1264	0	1230	0.0	0.0
chr12	AC078950.1	11434991	11435158	0	168	0	1264	0	1096	0.0	0.0
chr12	LRP6	12126690	12126921	0	232	2312	9350	2312	9118	0.0	0.25356437815310373
chr12	LRP6	12244261	12244655	255	395	2312	9350	2057	8955	0.6455696202531646	0.2297040759352317
chr12	MANSC1	12348178	12348248	0	71	204	5721	204	5650	0.0	0.036106194690265485
chr12	DUSP16	12480222	12480346	255	125	937	7143	682	7018	2.04	0.09717868338557993
chr12	DUSP16	12500518	12500682	0	165	937	7143	937	6978	0.0	0.13427916308397822
chr12	DUSP16	12554535	12554659	0	125	937	7143	937	7018	0.0	0.1335138216015959
chr12	GPRC5D	12942260	12942328	3031	69	6371	1128	3340	1059	43.927536231884055	3.153918791312559
chr12	GSG1	13087906	13088059	0	154	918	3041	918	2887	0.0	0.3179771388985106
chr12	GSG1	13089207	13089276	0	70	918	3041	918	2971	0.0	0.3089868731066981
chr12	GSG1	13089207	13089348	0	142	918	3041	918	2899	0.0	0.31666091755777853
chr12	GRIN2B	13981341	13981576	0	236	0	6171	0	5935	0.0	0.0
chr12	PLBD1	14553192	14553412	0	221	102	2387	102	2166	0.0	0.04709141274238227
chr12	WBP11	14801877	14802032	0	156	2491	5271	2491	5115	0.0	0.48699902248289345
chr12	ART4	14840444	14841153	1734	710	1887	5248	153	4538	2.4422535211267604	0.03371529308065227
chr12	ART4	14841081	14841153	0	73	1887	5248	1887	5175	0.0	0.3646376811594203
chr12	MGP	14882971	14883047	0	77	561	2892	561	2815	0.0	0.19928952042628775
chr12	MGP	14884812	14884887	0	76	561	2892	561	2816	0.0	0.19921875
chr12	ARHGDIB	14956175	14956333	18791	159	92362	1780	73571	1621	118.18238993710692	45.386181369524984
chr12	RERG	15121062	15121119	0	58	0	4162	0	4104	0.0	0.0
chr12	EPS8	15665755	15665892	0	138	3754	8578	3754	8440	0.0	0.4447867298578199
chr12	EPS8	15681225	15681302	0	78	3754	8578	3754	8500	0.0	0.4416470588235294
chr12	EPS8	15787962	15788010	0	49	3754	8578	3754	8529	0.0	0.4401453863289952
chr12	EPS8	15828180	15828372	0	193	3754	8578	3754	8385	0.0	0.44770423375074536
chr12	EPS8	15672453	15672504	0	52	3754	8578	3754	8526	0.0	0.44030025803424816
chr12	EPS8	15713265	15713325	0	61	3754	8578	3754	8517	0.0	0.44076552776799344
chr12	EPS8	15634738	15634762	0	25	3754	8578	3754	8553	0.0	0.4389103238629721
chr12	EPS8	15837572	15837724	0	153	3754	8578	3754	8425	0.0	0.4455786350148368
chr12	EPS8	15665022	15665106	0	85	3754	8578	3754	8493	0.0	0.44201106793830214
chr12	EPS8	15684196	15684302	0	107	3754	8578	3754	8471	0.0	0.4431590131035297
chr12	EPS8	15684168	15684302	0	135	3754	8578	3754	8443	0.0	0.44462868648584625
chr12	LMO3	16606065	16606132	0	68	51	6936	51	6868	0.0	0.007425742574257425
chr12	LMO3	16594136	16594261	0	126	51	6936	51	6810	0.0	0.007488986784140969
chr12	AC092110.1	17156722	17156874	51	153	51	1842	0	1689	0.3333333333333333	0.0
chr12	RERGL	18089228	18089385	0	158	0	1560	0	1402	0.0	0.0
chr12	PLCZ1	18705165	18705315	0	151	0	2968	0	2817	0.0	0.0
chr12	PLCZ1	18723310	18723542	0	233	0	2968	0	2735	0.0	0.0
chr12	PLCZ1	18723310	18723545	0	236	0	2968	0	2732	0.0	0.0
chr12	PLCZ1	18683543	18683631	0	89	0	2968	0	2879	0.0	0.0
chr12	PLCZ1	18705165	18705284	0	120	0	2968	0	2848	0.0	0.0
chr12	PLCZ1	18713736	18713825	0	90	0	2968	0	2878	0.0	0.0
chr12	PLCZ1	18685489	18685658	0	170	0	2968	0	2798	0.0	0.0
chr12	LINC02468	20125738	20125835	0	98	50	1350	50	1252	0.0	0.039936102236421724
chr12	LINC02468	20125726	20125835	0	110	50	1350	50	1240	0.0	0.04032258064516129
chr12	SLCO1A2	21314548	21314681	0	134	0	11312	0	11178	0.0	0.0
chr12	SLCO1A2	21318781	21318923	0	143	0	11312	0	11169	0.0	0.0
chr12	SLCO1A2	21374398	21374525	0	128	0	11312	0	11184	0.0	0.0
chr12	SLCO1A2	21319371	21319579	0	209	0	11312	0	11103	0.0	0.0
chr12	RECQL	21501169	21501215	0	47	0	3755	0	3708	0.0	0.0
chr12	RECQL	21501169	21501372	0	204	0	3755	0	3551	0.0	0.0
chr12	LDHB	21656987	21657214	2659	228	11324	2807	8665	2579	11.662280701754385	3.3598293912369135
chr12	LDHB	21657750	21657835	47	86	11324	2807	11277	2721	0.5465116279069767	4.144432194046306
chr12	KCNJ8	21774545	21774683	0	139	530	2516	530	2377	0.0	0.22297013041649139
chr12	ABCC9	21882765	21882873	0	109	753533	11660	753533	11551	0.0	65.23530430265778
chr12	ABCC9	21938017	21938077	0	61	753533	11660	753533	11599	0.0	64.96534183981377
chr12	ST8SIA1	22068862	22069020	0	159	35452	13989	35452	13830	0.0	2.563412870571222
chr12	ST8SIA1	22255279	22255389	0	111	35452	13989	35452	13878	0.0	2.5545467646634963
chr12	ST8SIA1	22325797	22325932	0	136	35452	13989	35452	13853	0.0	2.559156861329676
chr12	C2CD5	22493222	22493337	0	116	0	6790	0	6674	0.0	0.0
chr12	C2CD5	22506710	22506819	0	110	0	6790	0	6680	0.0	0.0
chr12	C2CD5	22458483	22458585	0	103	0	6790	0	6687	0.0	0.0
chr12	C2CD5	22512646	22512679	0	34	0	6790	0	6756	0.0	0.0
chr12	C2CD5	22458483	22458555	0	73	0	6790	0	6717	0.0	0.0
chr12	C2CD5	22502738	22502804	0	67	0	6790	0	6723	0.0	0.0
chr12	C2CD5	22459491	22459542	0	52	0	6790	0	6738	0.0	0.0
chr12	SOX5	23546315	23546424	0	110	468	11064	468	10954	0.0	0.04272411904327186
chr12	SOX5	23575660	23575838	0	179	468	11064	468	10885	0.0	0.04299494717501148
chr12	SOX5	24059222	24059296	0	75	468	11064	468	10989	0.0	0.042588042588042586
chr12	SOX5	24407484	24407566	0	83	468	11064	468	10981	0.0	0.04261906930152081
chr12	BCAT1	24881300	24881411	0	112	102	11431	102	11319	0.0	0.009011396766498807
chr12	BCAT1	24901813	24901885	0	73	102	11431	102	11358	0.0	0.008980454305335447
chr12	CFAP94	25158471	25158563	0	93	68	3013	68	2920	0.0	0.023287671232876714
chr12	CFAP94	25190613	25190631	0	19	68	3013	68	2994	0.0	0.022712090848363394
chr12	CFAP94	25161112	25161197	0	86	68	3013	68	2927	0.0	0.023231978134608814
chr12	CFAP94	25185748	25185786	0	39	68	3013	68	2974	0.0	0.022864828513786146
chr12	CFAP94	25158689	25158737	0	49	68	3013	68	2964	0.0	0.022941970310391364
chr12	CFAP94	25192693	25192826	0	134	68	3013	68	2879	0.0	0.023619312261201807
chr12	KRAS	25215436	25215560	0	125	51	6852	51	6727	0.0	0.0075813884346662705
chr12	LMNTD1	25526098	25526218	0	121	63	3102	63	2981	0.0	0.021133847702113386
chr12	LMNTD1	25547224	25547351	0	128	63	3102	63	2974	0.0	0.021183591123066576
chr12	LMNTD1	25552870	25552989	24	120	63	3102	39	2982	0.2	0.013078470824949699
chr12	LMNTD1	25546373	25546554	39	182	63	3102	24	2920	0.21428571428571427	0.00821917808219178
chr12	LMNTD1	25549325	25549546	0	222	63	3102	63	2880	0.0	0.021875
chr12	RASSF8-AS1	25955137	25955241	0	105	26179	9597	26179	9492	0.0	2.758006742520017
chr12	RASSF8-AS1	25956226	25956347	12023	122	26179	9597	14156	9475	98.54918032786885	1.494036939313984
chr12	RASSF8-AS1	25952757	25953076	12	320	26179	9597	26167	9277	0.0375	2.820631669720815
chr12	AC022509.1	26231922	26231985	0	64	51	2404	51	2340	0.0	0.021794871794871794
chr12	ITPR2	26790156	26790227	0	72	2400	13851	2400	13779	0.0	0.17417809710428914
chr12	ITPR2	26486816	26486933	102	118	2400	13851	2298	13733	0.864406779661017	0.16733415859608242
chr12	INTS13	26914407	26914578	0	172	81	3078	81	2906	0.0	0.027873365450791467
chr12	INTS13	26917643	26917733	0	91	81	3078	81	2987	0.0	0.02711750920656177
chr12	INTS13	26937657	26937809	51	153	81	3078	30	2925	0.3333333333333333	0.010256410256410256
chr12	TM7SF3	26979783	26979936	0	154	217	5517	217	5363	0.0	0.04046242774566474
chr12	TM7SF3	26982772	26982859	0	88	217	5517	217	5429	0.0	0.03997052864247559
chr12	TM7SF3	27003235	27003390	0	156	217	5517	217	5361	0.0	0.04047752285021451
chr12	TM7SF3	26976259	26976357	0	99	217	5517	217	5418	0.0	0.040051679586563305
chr12	TM7SF3	26977951	26978094	13	144	217	5517	204	5373	0.09027777777777778	0.03796761585706309
chr12	TM7SF3	26983492	26983596	0	105	217	5517	217	5412	0.0	0.040096082779009605
chr12	TM7SF3	26999525	26999676	0	152	217	5517	217	5365	0.0	0.040447343895619756
chr12	TM7SF3	26996741	26996862	0	122	217	5517	217	5395	0.0	0.0402224281742354
chr12	TM7SF3	27003235	27003405	0	171	217	5517	217	5346	0.0	0.040591096146651705
chr12	AC009509.1	27704737	27704924	0	188	940	1560	940	1372	0.0	0.685131195335277
chr12	ERGIC2	29356381	29356477	0	97	663	5842	663	5745	0.0	0.1154046997389034
chr12	ERGIC2	29372463	29372520	0	58	663	5842	663	5784	0.0	0.1146265560165975
chr12	ERGIC2	29372854	29372967	0	114	663	5842	663	5728	0.0	0.11574720670391062
chr12	TMTC1	29572104	29572218	0	115	62696	14707	62696	14592	0.0	4.296600877192983
chr12	LINC02386	30288408	30288463	0	56	0	1074	0	1018	0.0	0.0
chr12	IPO8	30686320	30686659	0	340	153	6688	153	6348	0.0	0.024102079395085067
chr12	CAPRIN2	30731342	30731510	0	169	204	8052	204	7883	0.0	0.02587847266269187
chr12	CAPRIN2	30711738	30711782	0	45	204	8052	204	8007	0.0	0.025477707006369428
chr12	CAPRIN2	30719078	30719225	0	148	204	8052	204	7904	0.0	0.025809716599190284
chr12	CAPRIN2	30720810	30720915	0	106	204	8052	204	7946	0.0	0.025673294739491568
chr12	CAPRIN2	30733628	30733711	0	84	204	8052	204	7968	0.0	0.025602409638554216
chr12	CAPRIN2	30753343	30753559	0	217	204	8052	204	7835	0.0	0.026037013401403956
chr12	DDX11-AS1	31060659	31060770	0	112	0	3844	0	3732	0.0	0.0
chr12	AC024940.1	31112111	31112288	0	178	2720	7252	2720	7074	0.0	0.3845066440486288
chr12	AC024940.1	31115202	31115703	0	502	2720	7252	2720	6750	0.0	0.40296296296296297
chr12	AC024940.1	31183213	31183323	0	111	2720	7252	2720	7141	0.0	0.3808990337487747
chr12	AC024940.1	31177009	31177084	0	76	2720	7252	2720	7176	0.0	0.379041248606466
chr12	SINHCAF	31298076	31298224	0	149	51	5586	51	5437	0.0	0.0093801728894611
chr12	SINHCAF	31296909	31297044	0	136	51	5586	51	5450	0.0	0.009357798165137614
chr12	DENND5B	31479588	31480255	0	668	6112	11371	6112	10703	0.0	0.5710548444361394
chr12	DENND5B	31499605	31499671	0	67	6112	11371	6112	11304	0.0	0.5406935598018401
chr12	DENND5B	31540919	31541031	0	113	6112	11371	6112	11258	0.0	0.542902824658021
chr12	AMN1	31709292	31709425	0	134	134	3144	134	3010	0.0	0.04451827242524917
chr12	AMN1	31714440	31714631	0	192	134	3144	134	2952	0.0	0.04539295392953929
chr12	AMN1	31719217	31719356	0	140	134	3144	134	3004	0.0	0.04460719041278296
chr12	AMN1	31714881	31714951	12	71	134	3144	122	3073	0.16901408450704225	0.039700618288317606
chr12	PKP2	32843181	32843313	0	133	49968	6985	49968	6852	0.0	7.2924693520140105
chr12	SYT10	33423909	33424009	1	101	1	5091	0	4990	0.009900990099009901	0.0
chr12	AC140847.2	34211873	34212021	0	149	918	2159	918	2010	0.0	0.45671641791044776
chr12	LINC02406	39095544	39095809	0	266	0	1374	0	1108	0.0	0.0
chr12	LINC02406	39093465	39093541	0	77	0	1374	0	1297	0.0	0.0
chr12	KIF21A	39315228	39315240	0	13	12	10156	12	10143	0.0	0.0011830819284235432
chr12	KIF21A	39318072	39318201	0	130	12	10156	12	10026	0.0	0.0011968880909634949
chr12	KIF21A	39322667	39322882	0	216	12	10156	12	9940	0.0	0.0012072434607645875
chr12	KIF21A	39330241	39330262	0	22	12	10156	12	10134	0.0	0.0011841326228537595
chr12	KIF21A	39333211	39333280	0	70	12	10156	12	10086	0.0	0.001189767995240928
chr12	KIF21A	39346465	39346504	0	40	12	10156	12	10116	0.0	0.0011862396204033216
chr12	KIF21A	39315228	39315243	0	16	12	10156	12	10140	0.0	0.001183431952662722
chr12	KIF21A	39315931	39315970	0	40	12	10156	12	10116	0.0	0.0011862396204033216
chr12	KIF21A	39321347	39322882	0	1536	12	10156	12	8620	0.0	0.0013921113689095127
chr12	GXYLT1	42129758	42129851	0	94	0	7500	0	7406	0.0	0.0
chr12	YAF2	42210547	42210619	0	73	0	6459	0	6386	0.0	0.0
chr12	YAF2	42237598	42237724	0	127	0	6459	0	6332	0.0	0.0
chr12	YAF2	42199135	42199235	0	101	0	6459	0	6358	0.0	0.0
chr12	YAF2	42172139	42172209	0	71	0	6459	0	6388	0.0	0.0
chr12	YAF2	42210354	42210454	0	101	0	6459	0	6358	0.0	0.0
chr12	YAF2	42235613	42235755	0	143	0	6459	0	6316	0.0	0.0
chr12	YAF2	42212443	42212484	0	42	0	6459	0	6417	0.0	0.0
chr12	ZCRB1	42324018	42324104	0	87	102	8686	102	8599	0.0	0.011861844400511688
chr12	ZCRB1	42322417	42322446	0	30	102	8686	102	8656	0.0	0.01178373382624769
chr12	ZCRB1	42324067	42324104	0	38	102	8686	102	8648	0.0	0.01179463459759482
chr12	PRICKLE1	42483757	42483985	672	229	2753	8022	2081	7793	2.9344978165938866	0.26703451815732065
chr12	PRICKLE1	42584358	42584480	0	123	2753	8022	2753	7899	0.0	0.34852512976326117
chr12	PRICKLE1	42550207	42550329	0	123	2753	8022	2753	7899	0.0	0.34852512976326117
chr12	LINC02402	42629460	42629686	328	227	1378	1549	1050	1322	1.4449339207048457	0.794251134644478
chr12	ADAMTS20	43429616	43429724	0	109	0	7564	0	7455	0.0	0.0
chr12	PUS7L	43754335	43755261	0	927	0	14023	0	13096	0.0	0.0
chr12	PUS7L	43755216	43755261	0	46	0	14023	0	13977	0.0	0.0
chr12	TWF1	43805830	43805885	0	56	0	3656	0	3600	0.0	0.0
chr12	TWF1	43804494	43804572	0	79	0	3656	0	3577	0.0	0.0
chr12	TWF1	43798564	43798585	0	22	0	3656	0	3634	0.0	0.0
chr12	TWF1	43805523	43805637	0	115	0	3656	0	3541	0.0	0.0
chr12	TWF1	43804175	43804240	0	66	0	3656	0	3590	0.0	0.0
chr12	TWF1	43805830	43806002	0	173	0	3656	0	3483	0.0	0.0
chr12	NELL2	44532580	44532721	0	142	22	6365	22	6223	0.0	0.0035352723766672025
chr12	NELL2	44875506	44875639	0	134	22	6365	22	6231	0.0	0.0035307334296260633
chr12	NELL2	44881778	44881839	0	62	22	6365	22	6303	0.0	0.0034904013961605585
chr12	PLEKHA8P1	45190793	45190961	0	169	0	2324	0	2155	0.0	0.0
chr12	SCAF11	45974189	45975734	0	1546	0	14007	0	12461	0.0	0.0
chr12	SLC38A1	46243199	46243314	0	116	1080	10037	1080	9921	0.0	0.10885999395222255
chr12	SLC38A1	46239678	46239893	0	216	1080	10037	1080	9821	0.0	0.10996843498625394
chr12	SLC38A1	46254813	46254936	0	124	1080	10037	1080	9913	0.0	0.1089478462624836
chr12	SLC38A2	46363020	46363145	0	126	718	6328	718	6202	0.0	0.11576910673976137
chr12	SLC38A2	46370511	46370627	0	117	718	6328	718	6211	0.0	0.11560135243922073
chr12	SLC38A4	46803602	46803794	0	193	212883	2622	212883	2429	0.0	87.64223960477563
chr12	SLC38A4	46824305	46824385	0	81	212883	2622	212883	2541	0.0	83.77922077922078
chr12	AMIGO2	47079141	47079248	0	108	0	3967	0	3859	0.0	0.0
chr12	AMIGO2	47079146	47079248	0	103	0	3967	0	3864	0.0	0.0
chr12	PCED1B-AS1	47206510	47206588	0	79	0	1838	0	1759	0.0	0.0
chr12	PCED1B-AS1	47206510	47206585	0	76	0	1838	0	1762	0.0	0.0
chr12	PCED1B-AS1	47210639	47210761	0	123	0	1838	0	1715	0.0	0.0
chr12	PCED1B-AS1	47209280	47209458	0	179	0	1838	0	1659	0.0	0.0
chr12	RPAP3	47679492	47679594	0	103	1345	5369	1345	5266	0.0	0.2554120774781618
chr12	RPAP3	47702687	47702846	0	160	1345	5369	1345	5209	0.0	0.25820694951046264
chr12	ENDOU	47720752	47720875	0	124	51	2689	51	2565	0.0	0.019883040935672516
chr12	ENDOU	47718128	47718194	0	67	51	2689	51	2622	0.0	0.019450800915331808
chr12	RAPGEF3	47740641	47740823	0	183	102	11994	102	11811	0.0	0.008636017272034544
chr12	RAPGEF3	47743529	47743676	0	148	102	11994	102	11846	0.0	0.008610501435083573
chr12	RAPGEF3	47739370	47739418	0	49	102	11994	102	11945	0.0	0.008539137714524905
chr12	HDAC7	47802223	47802274	0	52	51	7662	51	7610	0.0	0.0067017082785808145
chr12	HDAC7	47795905	47796016	0	112	51	7662	51	7550	0.0	0.006754966887417219
chr12	HDAC7	47792537	47792669	0	133	51	7662	51	7529	0.0	0.006773807942621862
chr12	HDAC7	47798784	47798972	0	189	51	7662	51	7473	0.0	0.006824568446407065
chr12	HDAC7	47784694	47784801	0	108	51	7662	51	7554	0.0	0.006751389992057188
chr12	HDAC7	47788834	47788951	0	118	51	7662	51	7544	0.0	0.00676033934252386
chr12	HDAC7	47819119	47819142	0	24	51	7662	51	7638	0.0	0.006677140612725845
chr12	VDR	47882693	47882774	0	82	153	5295	153	5213	0.0	0.029349702666410897
chr12	VDR	47899836	47899958	0	123	153	5295	153	5172	0.0	0.029582366589327145
chr12	COL2A1	47999918	48000125	0	208	68	6719	68	6511	0.0	0.010443864229765013
chr12	SENP1	48089162	48089293	0	132	1493	5824	1493	5692	0.0	0.2622979620520028
chr12	ASB8	48150086	48150140	0	55	31	4093	31	4038	0.0	0.007677067855373947
chr12	ASB8	48151609	48151665	12	57	31	4093	19	4036	0.21052631578947367	0.004707631318136769
chr12	ASB8	48150086	48150170	0	85	31	4093	31	4008	0.0	0.007734530938123752
chr12	ASB8	48151564	48151665	12	102	31	4093	19	3991	0.11764705882352941	0.00476071160110248
chr12	ASB8	48157121	48157257	0	137	31	4093	31	3956	0.0	0.007836198179979777
chr12	ZNF641	48350045	48350218	0	174	0	8510	0	8336	0.0	0.0
chr12	ZNF641	48347148	48347343	0	196	0	8510	0	8314	0.0	0.0
chr12	KANSL2	48679035	48679150	0	116	0	3188	0	3072	0.0	0.0
chr12	KANSL2	48660467	48660619	0	153	0	3188	0	3035	0.0	0.0
chr12	KANSL2	48662559	48662654	0	96	0	3188	0	3092	0.0	0.0
chr12	KANSL2	48679035	48679238	0	204	0	3188	0	2984	0.0	0.0
chr12	KANSL2	48681857	48682065	0	209	0	3188	0	2979	0.0	0.0
chr12	KANSL2	48681971	48682065	0	95	0	3188	0	3093	0.0	0.0
chr12	CCNT1	48695998	48696162	0	165	51	7391	51	7226	0.0	0.007057846664821478
chr12	ADCY6	48773939	48774098	0	160	51	8137	51	7977	0.0	0.006393380970289583
chr12	DDX23	48837523	48837657	0	135	51	4903	51	4768	0.0	0.010696308724832215
chr12	DDX23	48835119	48835214	0	96	51	4903	51	4807	0.0	0.010609527771999168
chr12	DDX23	48847255	48847347	0	93	51	4903	51	4810	0.0	0.010602910602910603
chr12	DDX23	48847255	48847350	0	96	51	4903	51	4807	0.0	0.010609527771999168
chr12	ARF3	48939996	48940107	0	112	0	2250	0	2138	0.0	0.0
chr12	ARF3	48941567	48941577	0	11	0	2250	0	2239	0.0	0.0
chr12	ARF3	48953112	48953274	0	163	0	2250	0	2087	0.0	0.0
chr12	ARF3	48956097	48956350	0	254	0	2250	0	1996	0.0	0.0
chr12	WNT10B	48969109	48969144	0	36	51	2607	51	2571	0.0	0.019836639439906652
chr12	PRKAG1	49003557	49003595	0	39	51	3614	51	3575	0.0	0.014265734265734267
chr12	PRKAG1	49004506	49004633	25	128	51	3614	26	3486	0.1953125	0.007458405048766495
chr12	PRKAG1	49005742	49005852	0	111	51	3614	51	3503	0.0	0.014558949471881244
chr12	PRKAG1	49005667	49005742	0	76	51	3614	51	3538	0.0	0.014414923685698135
chr12	PRKAG1	49005742	49005881	0	140	51	3614	51	3474	0.0	0.01468048359240069
chr12	PRKAG1	49008425	49008599	0	175	51	3614	51	3439	0.0	0.014829892410584472
chr12	PRKAG1	49016606	49016839	0	234	51	3614	51	3380	0.0	0.015088757396449704
chr12	PRKAG1	49017156	49017550	0	395	51	3614	51	3219	0.0	0.015843429636533086
chr12	KMT2D	49024052	49024100	0	49	47391	20387	47391	20338	0.0	2.33017012488937
chr12	RHEBL1	49066967	49067035	0	69	306	1307	306	1238	0.0	0.24717285945072698
chr12	RHEBL1	49066955	49067035	0	81	306	1307	306	1226	0.0	0.2495921696574225
chr12	LMBR1L	49097943	49098105	102	163	5090	4888	4988	4725	0.6257668711656442	1.0556613756613757
chr12	LMBR1L	49104447	49104551	0	105	5090	4888	5090	4783	0.0	1.0641856575371107
chr12	LMBR1L	49105923	49105957	0	35	5090	4888	5090	4853	0.0	1.048835771687616
chr12	LMBR1L	49106960	49107045	0	86	5090	4888	5090	4802	0.0	1.0599750104123282
chr12	LMBR1L	49106544	49106746	0	203	5090	4888	5090	4685	0.0	1.0864461045891143
chr12	LMBR1L	49109726	49109881	244	156	5090	4888	4846	4732	1.564102564102564	1.0240912933220625
chr12	LMBR1L	49104718	49104885	51	168	5090	4888	5039	4720	0.30357142857142855	1.067584745762712
chr12	LMBR1L	49106510	49106746	0	237	5090	4888	5090	4651	0.0	1.0943883035906257
chr12	LMBR1L	49104745	49104885	36	141	5090	4888	5054	4747	0.2553191489361702	1.0646724246892774
chr12	LMBR1L	49106653	49106746	0	94	5090	4888	5090	4794	0.0	1.0617438464747602
chr12	TUBA1B	49130118	49130402	0	285	357	2468	357	2183	0.0	0.16353641777370592
chr12	TUBA1B	49130118	49130274	0	157	357	2468	357	2311	0.0	0.15447858070099524
chr12	TUBA1B	49130118	49130344	0	227	357	2468	357	2241	0.0	0.15930388219544847
chr12	TUBA1A	49186989	49187084	0	96	255	3106	255	3010	0.0	0.08471760797342193
chr12	MCRS1	49566721	49566841	51	121	486	3102	435	2981	0.4214876033057851	0.1459241865145924
chr12	MCRS1	49567646	49567749	0	104	486	3102	486	2998	0.0	0.16210807204803201
chr12	MCRS1	49566076	49566215	0	140	486	3102	486	2962	0.0	0.16407832545577314
chr12	FAM186B	49587561	49587752	0	192	1038	4585	1038	4393	0.0	0.23628499886182563
chr12	FMNL3	49658441	49658594	459	154	1009711	11520	1009252	11366	2.9805194805194803	88.79570649304945
chr12	FMNL3	49646638	49646753	0	116	1009711	11520	1009711	11404	0.0	88.54007365836549
chr12	FAIM2	49887385	49887439	0	55	19060	6072	19060	6017	0.0	3.167691540634868
chr12	FAIM2	49889480	49889568	401	89	19060	6072	18659	5983	4.50561797752809	3.118669563763998
chr12	AC025154.2	49954133	49954348	8163	216	42147	1579	33984	1363	37.791666666666664	24.933235509904623
chr12	RACGAP1	49997039	49997204	368	166	20521	4511	20153	4345	2.216867469879518	4.638204833141542
chr12	RACGAP1	50006433	50006636	452	204	20521	4511	20069	4307	2.215686274509804	4.659623868121662
chr12	RACGAP1	50019743	50019806	0	64	20521	4511	20521	4447	0.0	4.614571621317742
chr12	RACGAP1	50016630	50016719	0	90	20521	4511	20521	4421	0.0	4.641710020357385
chr12	RACGAP1	50018515	50018589	0	75	20521	4511	20521	4436	0.0	4.626014427412083
chr12	RACGAP1	50021061	50021177	153	117	20521	4511	20368	4394	1.3076923076923077	4.635411925352754
chr12	RACGAP1	50016630	50016715	0	86	20521	4511	20521	4425	0.0	4.637514124293785
chr12	CERS5	50134545	50134702	0	158	7353	5888	7353	5730	0.0	1.2832460732984292
chr12	CERS5	50137727	50137820	51	94	7353	5888	7302	5794	0.5425531914893617	1.2602692440455643
chr12	CERS5	50142052	50142110	0	59	7353	5888	7353	5829	0.0	1.2614513638703035
chr12	CERS5	50143951	50144057	0	107	7353	5888	7353	5781	0.0	1.2719252724442138
chr12	CERS5	50144768	50144969	243	202	7353	5888	7110	5686	1.202970297029703	1.2504396763981709
chr12	CERS5	50132961	50133064	0	104	7353	5888	7353	5784	0.0	1.271265560165975
chr12	CERS5	50135432	50135652	153	221	7353	5888	7200	5667	0.6923076923076923	1.270513499205929
chr12	CERS5	50132961	50134068	0	1108	7353	5888	7353	4780	0.0	1.538284518828452
chr12	CERS5	50138566	50138617	24	52	7353	5888	7329	5836	0.46153846153846156	1.2558259081562715
chr12	CERS5	50154227	50154320	5	94	7353	5888	7348	5794	0.05319148936170213	1.2682084915429754
chr12	CERS5	50165821	50165943	0	123	7353	5888	7353	5765	0.0	1.275455333911535
chr12	CERS5	50153828	50153951	0	124	7353	5888	7353	5764	0.0	1.275676613462873
chr12	CERS5	50148471	50148588	0	118	7353	5888	7353	5770	0.0	1.2743500866551127
chr12	LIMA1	50192451	50192561	306	111	21120	5924	20814	5813	2.7567567567567566	3.5805952176156888
chr12	LIMA1	50185389	50185448	2854	60	21120	5924	18266	5864	47.56666666666667	3.1149386084583903
chr12	LIMA1	50201302	50201324	0	23	21120	5924	21120	5901	0.0	3.5790543975597355
chr12	LIMA1	50249682	50249786	0	105	21120	5924	21120	5819	0.0	3.6294896030245747
chr12	SLC11A2	51000597	51000633	0	37	2170	9310	2170	9273	0.0	0.23401272511592797
chr12	SLC11A2	51010694	51010766	0	73	2170	9310	2170	9237	0.0	0.2349247591209267
chr12	SLC11A2	51000562	51000633	0	72	2170	9310	2170	9238	0.0	0.2348993288590604
chr12	SLC11A2	51005652	51005677	0	26	2170	9310	2170	9284	0.0	0.23373545885394226
chr12	SLC11A2	51008475	51008624	0	150	2170	9310	2170	9160	0.0	0.2368995633187773
chr12	SLC11A2	51006173	51006271	0	99	2170	9310	2170	9211	0.0	0.23558788405167735
chr12	CSRNP2	51076410	51076647	1084	238	6462	5233	5378	4995	4.554621848739496	1.0766766766766767
chr12	CSRNP2	51082520	51082694	0	175	6462	5233	6462	5058	0.0	1.2775800711743772
chr12	TFCP2	51109120	51109273	204	154	2265	2120	2061	1966	1.3246753246753247	1.048321464903357
chr12	POU6F1	51196798	51196927	0	130	13086	6060	13086	5930	0.0	2.206745362563238
chr12	POU6F1	51199746	51199868	0	123	13086	6060	13086	5937	0.0	2.204143506821627
chr12	POU6F1	51206788	51206883	0	96	13086	6060	13086	5964	0.0	2.194164989939638
chr12	SMAGP	51251464	51251583	0	120	51	2875	51	2755	0.0	0.018511796733212342
chr12	SMAGP	51253573	51253593	0	21	51	2875	51	2854	0.0	0.017869656622284513
chr12	BIN2	51302019	51302115	0	97	724	3267	724	3170	0.0	0.22839116719242902
chr12	BIN2	51313822	51313903	0	82	724	3267	724	3185	0.0	0.2273155416012559
chr12	BIN2	51304119	51304265	0	147	724	3267	724	3120	0.0	0.23205128205128206
chr12	GALNT6	51360720	51360838	0	119	8114	7363	8114	7244	0.0	1.120099392600773
chr12	GALNT6	51383460	51383582	1071	123	8114	7363	7043	7240	8.707317073170731	0.9727900552486188
chr12	GALNT6	51390849	51390937	0	89	8114	7363	8114	7274	0.0	1.1154797910365686
chr12	GALNT6	51382312	51382509	98	198	8114	7363	8016	7165	0.494949494949495	1.1187718073970692
chr12	GALNT6	51391081	51391195	0	115	8114	7363	8114	7248	0.0	1.1194812362030906
chr12	LINC02874	52206513	52206643	0	131	918	2111	918	1980	0.0	0.4636363636363636
chr12	LINC02874	52210576	52210925	0	350	918	2111	918	1761	0.0	0.5212947189097104
chr12	LINC02874	52208104	52208388	0	285	918	2111	918	1826	0.0	0.5027382256297919
chr12	KRT5	52518452	52518493	0	42	0	4142	0	4100	0.0	0.0
chr12	KRT74	52569489	52569531	756	43	91544	3016	90788	2973	17.58139534883721	30.537504204507233
chr12	KRT72	52590835	52590961	0	127	9968	2164	9968	2037	0.0	4.893470790378007
chr12	KRT72	52599270	52599409	0	140	9968	2164	9968	2024	0.0	4.924901185770751
chr12	KRT72	52599270	52599302	0	33	9968	2164	9968	2131	0.0	4.67761614265603
chr12	KRT73	52614578	52614674	0	97	0	2660	0	2563	0.0	0.0
chr12	KRT77	52698175	52698260	0	86	2697	4023	2697	3937	0.0	0.6850393700787402
chr12	KRT4	52811762	52811977	0	216	0	2886	0	2670	0.0	0.0
chr12	KRT78	52839452	52839487	0	36	0	3271	0	3235	0.0	0.0
chr12	KRT8	52901158	52901219	0	62	0	6121	0	6059	0.0	0.0
chr12	KRT8	52949455	52949585	0	131	0	6121	0	5990	0.0	0.0
chr12	KRT8	52949455	52949517	0	63	0	6121	0	6058	0.0	0.0
chr12	AC068888.1	53045599	53045653	0	55	0	5374	0	5319	0.0	0.0
chr12	AC068888.1	53045064	53045186	0	123	0	5374	0	5251	0.0	0.0
chr12	AC068888.1	53053395	53053574	0	180	0	5374	0	5194	0.0	0.0
chr12	AC068888.1	53043097	53043147	0	51	0	5374	0	5323	0.0	0.0
chr12	AC068888.1	53045960	53046061	0	102	0	5374	0	5272	0.0	0.0
chr12	AC068888.1	53045586	53045653	0	68	0	5374	0	5306	0.0	0.0
chr12	SPRYD3	53074648	53074784	0	137	0	2839	0	2702	0.0	0.0
chr12	SPRYD3	53078060	53078171	0	112	0	2839	0	2727	0.0	0.0
chr12	CSAD	53161126	53161191	0	66	0	4328	0	4262	0.0	0.0
chr12	CSAD	53171325	53171441	0	117	0	4328	0	4211	0.0	0.0
chr12	CSAD	53171272	53171441	0	170	0	4328	0	4158	0.0	0.0
chr12	ITGB7	53200242	53200446	0	205	0	4220	0	4015	0.0	0.0
chr12	ITGB7	53201071	53201194	0	124	0	4220	0	4096	0.0	0.0
chr12	ITGB7	53201117	53201194	0	78	0	4220	0	4142	0.0	0.0
chr12	ITGB7	53193707	53193901	0	195	0	4220	0	4025	0.0	0.0
chr12	ITGB7	53201146	53201194	0	49	0	4220	0	4171	0.0	0.0
chr12	ITGB7	53206673	53206804	0	132	0	4220	0	4088	0.0	0.0
chr12	RARG	53215645	53215794	0	150	0	4962	0	4812	0.0	0.0
chr12	RARG	53227361	53227687	0	327	0	4962	0	4635	0.0	0.0
chr12	RARG	53231168	53231235	0	68	0	4962	0	4894	0.0	0.0
chr12	AAAS	53307844	53307929	0	86	2530	4055	2530	3969	0.0	0.6374401612496851
chr12	AAAS	53315334	53315426	0	93	2530	4055	2530	3962	0.0	0.6385663806158506
chr12	AAAS	53314750	53314849	0	100	2530	4055	2530	3955	0.0	0.6396965865992414
chr12	SP7	53335625	53335693	0	69	2712	3390	2712	3321	0.0	0.8166214995483289
chr12	ATF7	53552540	53552637	0	98	1502	4276	1502	4178	0.0	0.3595021541407372
chr12	ATP5MC2	53673695	53673812	0	118	74800	2796	74800	2678	0.0	27.93129200896191
chr12	CALCOCO1	53716259	53716415	0	157	142072	7583	142072	7426	0.0	19.131699434419605
chr12	CALCOCO1	53712774	53712846	36	73	142072	7583	142036	7510	0.4931506849315068	18.912916111850866
chr12	CALCOCO1	53725689	53725759	0	71	142072	7583	142072	7512	0.0	18.912673056443026
chr12	CALCOCO1	53726243	53726334	0	92	142072	7583	142072	7491	0.0	18.96569216393005
chr12	CISTR	53755819	53755935	0	117	51	2038	51	1921	0.0	0.02654867256637168
chr12	HOTAIR	53964230	53964283	0	54	102	2610	102	2556	0.0	0.03990610328638498
chr12	HOTAIR	53967268	53967394	0	127	102	2610	102	2483	0.0	0.04107933950865888
chr12	SMUG1	54187818	54187905	0	88	0	4520	0	4432	0.0	0.0
chr12	SMUG1	54183655	54183959	0	305	0	4520	0	4215	0.0	0.0
chr12	SMUG1	54188514	54188596	0	83	0	4520	0	4437	0.0	0.0
chr12	SMUG1	54186846	54187011	0	166	0	4520	0	4354	0.0	0.0
chr12	SMUG1	54187818	54187840	0	23	0	4520	0	4497	0.0	0.0
chr12	NFE2	54300146	54300276	0	131	0	2368	0	2237	0.0	0.0
chr12	ZNF385A	54371472	54371715	1020	244	129026	3203	128006	2959	4.180327868852459	43.259885096316324
chr12	ZNF385A	54375843	54375954	3901	112	129026	3203	125125	3091	34.830357142857146	40.480427046263344
chr12	ZNF385A	54371472	54371642	1020	171	129026	3203	128006	3032	5.964912280701754	42.218337730870715
chr12	ZNF385A	54384858	54385002	408	145	129026	3203	128618	3058	2.8137931034482757	42.0595160235448
chr12	ZNF385A	54372893	54373031	204	139	129026	3203	128822	3064	1.4676258992805755	42.04373368146214
chr12	ITGA5	54399644	54399758	1962	115	428189	7121	426227	7006	17.06086956521739	60.83742506423066
chr12	ITGA5	54409484	54409597	643	114	428189	7121	427546	7007	5.640350877192983	61.01698301698302
chr12	ITGA5	54411833	54411964	62	132	428189	7121	428127	6989	0.4696969696969697	61.25726141078838
chr12	GTSF1	54459312	54459453	0	142	370	2536	370	2394	0.0	0.1545530492898914
chr12	GTSF1	54465066	54465167	0	102	370	2536	370	2434	0.0	0.15201314708299096
chr12	PPP1R1A	54581975	54582131	2566	157	162541	2983	159975	2826	16.343949044585987	56.60828025477707
chr12	PPP1R1A	54582731	54582795	759	65	162541	2983	161782	2918	11.676923076923076	55.44276901987663
chr12	GLYCAM1	54608618	54608846	0	229	0	529	0	300	0.0	0.0
chr12	GLYCAM1	54608652	54608846	0	195	0	529	0	334	0.0	0.0
chr12	DCD	54644883	54644947	0	65	3836	885	3836	820	0.0	4.678048780487805
chr12	DCD	54645983	54646150	3679	168	3836	885	157	717	21.898809523809526	0.21896792189679218
chr12	TESPA1	54961167	54961267	0	101	0	5057	0	4956	0.0	0.0
chr12	TESPA1	54966052	54966151	0	100	0	5057	0	4957	0.0	0.0
chr12	TESPA1	54981773	54981945	0	173	0	5057	0	4884	0.0	0.0
chr12	TESPA1	54983993	54984166	0	174	0	5057	0	4883	0.0	0.0
chr12	AC122685.1	55476548	55476601	0	54	0	686	0	632	0.0	0.0
chr12	ITGA7	55694777	55694970	0	194	64	6257	64	6063	0.0	0.010555830446973445
chr12	ITGA7	55698382	55698576	0	195	64	6257	64	6062	0.0	0.010557571758495546
chr12	ITGA7	55701378	55701416	0	39	64	6257	64	6218	0.0	0.010292698616918623
chr12	ITGA7	55699869	55699989	0	121	64	6257	64	6136	0.0	0.010430247718383311
chr12	ITGA7	55700261	55700393	0	133	64	6257	64	6124	0.0	0.010450685826257348
chr12	ITGA7	55686201	55686314	0	114	64	6257	64	6143	0.0	0.01041836236366596
chr12	SARNP	55800853	55800900	0	48	10588	3377	10588	3329	0.0	3.180534695103635
chr12	AC023055.1	55820238	55820449	0	212	10588	2553	10588	2341	0.0	4.522853481418197
chr12	DNAJC14	55829488	55829636	0	149	51	4199	51	4050	0.0	0.012592592592592593
chr12	MMP19	55837554	55837682	0	129	0	4340	0	4211	0.0	0.0
chr12	MMP19	55839495	55839741	0	247	0	4340	0	4093	0.0	0.0
chr12	MMP19	55841105	55841236	0	132	0	4340	0	4208	0.0	0.0
chr12	MMP19	55841105	55841207	0	103	0	4340	0	4237	0.0	0.0
chr12	PYM1	55914275	55914366	13	92	51	2413	38	2321	0.14130434782608695	0.016372253339077984
chr12	PYM1	55927075	55927267	0	193	51	2413	51	2220	0.0	0.022972972972972974
chr12	PMEL	55957922	55958084	38	163	180	3339	142	3176	0.2331288343558282	0.044710327455919394
chr12	PMEL	55961316	55961463	0	148	180	3339	180	3191	0.0	0.05640864932623002
chr12	PMEL	55961621	55961732	0	112	180	3339	180	3227	0.0	0.05577936163619461
chr12	PMEL	55965935	55966062	0	128	180	3339	180	3211	0.0	0.05605730302086578
chr12	SMARCC2	56171678	56171937	2545	260	18364	7617	15819	7357	9.788461538461538	2.1501970912056545
chr12	SMARCC2	56172936	56173029	42	94	18364	7617	18322	7523	0.44680851063829785	2.435464575302406
chr12	SMARCC2	56183860	56183930	0	71	18364	7617	18364	7546	0.0	2.433607209117413
chr12	SMARCC2	56164302	56164368	0	67	18364	7617	18364	7550	0.0	2.432317880794702
chr12	RNF41	56216428	56216613	18720	186	81660	6543	62940	6357	100.64516129032258	9.900896649362908
chr12	RNF41	56207167	56207310	1236	144	81660	6543	80424	6399	8.583333333333334	12.568213783403657
chr12	RNF41	56212995	56213138	12284	144	81660	6543	69376	6399	85.30555555555556	10.841694014689795
chr12	RNF41	56212995	56213077	695	83	81660	6543	80965	6460	8.373493975903614	12.53328173374613
chr12	ANKRD52	56254577	56254720	0	144	297	8841	297	8697	0.0	0.0341497067954467
chr12	CS	56282419	56282608	0	190	198	5231	198	5041	0.0	0.03927792104741123
chr12	CS	56283791	56283857	0	67	198	5231	198	5164	0.0	0.0383423702556158
chr12	CS	56285915	56286023	0	109	198	5231	198	5122	0.0	0.038656774697383836
chr12	CS	56298608	56298691	0	84	198	5231	198	5147	0.0	0.03846901107441228
chr12	CS	56291219	56291306	0	88	198	5231	198	5143	0.0	0.03849893058526152
chr12	CS	56282859	56282991	96	133	198	5231	102	5098	0.7218045112781954	0.02000784621420165
chr12	CS	56291630	56291793	0	164	198	5231	198	5067	0.0	0.03907637655417407
chr12	CS	56285144	56285244	0	101	198	5231	198	5130	0.0	0.03859649122807018
chr12	CNPY2	56315129	56315242	0	114	5335	2842	5335	2728	0.0	1.9556451612903225
chr12	PAN2	56318236	56318434	0	199	14046	6864	14046	6665	0.0	2.1074268567141785
chr12	PAN2	56319087	56319181	0	95	14046	6864	14046	6769	0.0	2.075048013000443
chr12	PAN2	56332812	56333208	1943	397	14046	6864	12103	6467	4.894206549118388	1.8715014689964435
chr12	STAT2	56349162	56349261	19	100	8810	4706	8791	4606	0.19	1.9085974815458098
chr12	STAT2	56351291	56351450	16	160	8810	4706	8794	4546	0.1	1.9344478662560494
chr12	STAT2	56353232	56353285	0	54	8810	4706	8810	4652	0.0	1.8938091143594153
chr12	MIP	56455791	56455884	0	94	641	3560	641	3466	0.0	0.1849394114252741
chr12	MIP	56458477	56458574	0	98	641	3560	641	3462	0.0	0.18515309069901792
chr12	GLS2	56479051	56479181	579	131	1146	3878	567	3747	4.419847328244275	0.1513210568454764
chr12	GLS2	56475043	56475110	0	68	1146	3878	1146	3810	0.0	0.30078740157480316
chr12	GLS2	56480287	56480387	357	101	1146	3878	789	3777	3.5346534653465347	0.20889594916600476
chr12	GLS2	56475043	56475183	0	141	1146	3878	1146	3737	0.0	0.3066630987423067
chr12	GLS2	56479051	56479147	491	97	1146	3878	655	3781	5.061855670103093	0.1732345940227453
chr12	GLS2	56475944	56475977	0	34	1146	3878	1146	3844	0.0	0.29812695109261184
chr12	BAZ2A	56617394	56617532	290	139	302825	10465	302535	10326	2.0863309352517985	29.298373038930855
chr12	BAZ2A	56630775	56630865	0	91	302825	10465	302825	10374	0.0	29.1907653749759
chr12	ATP5F1B	56639979	56640192	0	214	82695	2227	82695	2013	0.0	41.08047690014903
chr12	ATP5F1B	56642672	56642831	2152	160	82695	2227	80543	2067	13.45	38.96613449443638
chr12	ATP5F1B	56645170	56645353	0	184	82695	2227	82695	2043	0.0	40.477239353891335
chr12	ATP5F1B	56642672	56642684	293	13	82695	2227	82402	2214	22.53846153846154	37.218608852755196
chr12	PTGES3	56670274	56670364	0	91	1252079	3408	1252079	3317	0.0	377.4733192643955
chr12	PTGES3	56671748	56671847	420	100	1252079	3408	1251659	3308	4.2	378.37333736396613
chr12	PTGES3	56666203	56666266	202467	64	1252079	3408	1049612	3344	3163.546875	313.8791866028708
chr12	PTGES3	56686868	56686917	1	50	1252079	3408	1252078	3358	0.02	372.86420488385943
chr12	NACA	56724451	56724572	0	122	95495	7785	95495	7663	0.0	12.46182957066423
chr12	NACA	56715870	56716110	6302	241	95495	7785	89193	7544	26.149377593360995	11.823038176033934
chr12	NACA	56715870	56716206	6397	337	95495	7785	89098	7448	18.98219584569733	11.962674543501612
chr12	NACA	56719725	56721459	45508	1735	95495	7785	49987	6050	26.229394812680116	8.262314049586777
chr12	NACA	56715870	56721459	137688	5590	95495	7785	-42193	2195	24.631127012522363	-19.22232346241458
chr12	NACA	56719536	56719596	255	61	95495	7785	95240	7724	4.180327868852459	12.330398757120664
chr12	NACA	56724451	56724523	0	73	95495	7785	95495	7712	0.0	12.382650414937759
chr12	NACA	56724451	56724549	0	99	95495	7785	95495	7686	0.0	12.424538121259433
chr12	PRIM1	56740011	56740128	0	118	16988	2848	16988	2730	0.0	6.222710622710623
chr12	RDH16	56954905	56955164	243	260	2213	3468	1970	3208	0.9346153846153846	0.6140897755610972
chr12	TAC3	57012821	57012875	0	55	1875	1582	1875	1527	0.0	1.2278978388998036
chr12	TAC3	57012620	57012737	306	118	1875	1582	1569	1464	2.593220338983051	1.0717213114754098
chr12	TAC3	57010726	57010903	0	178	1875	1582	1875	1404	0.0	1.3354700854700854
chr12	TAC3	57012133	57012291	28	159	1875	1582	1847	1423	0.1761006289308176	1.297962052002811
chr12	MYO1A	57047060	57047107	36	48	1335020	4229	1334984	4181	0.75	319.29777565175795
chr12	NEMP1	57064070	57064185	28919	116	2256038	5740	2227119	5624	249.30172413793105	396.00266714082505
chr12	NEMP1	57069233	57069306	0	74	2256038	5740	2256038	5666	0.0	398.17119661136604
chr12	STAT6	57107604	57107743	1791	140	416367	7192	414576	7052	12.792857142857143	58.78842881452071
chr12	STAT6	57108162	57108299	280612	138	416367	7192	135755	7054	2033.4202898550725	19.24510915792458
chr12	STAT6	57100845	57100899	0	55	416367	7192	416367	7137	0.0	58.33921815889029
chr12	STAT6	57110042	57110110	341	69	416367	7192	416026	7123	4.942028985507246	58.40600870419767
chr12	STAT6	57107658	57107743	724	86	416367	7192	415643	7106	8.418604651162791	58.49183788347875
chr12	STAT6	57110076	57110110	190	35	416367	7192	416177	7157	5.428571428571429	58.149643705463184
chr12	STAT6	57109940	57110110	1941	171	416367	7192	414426	7021	11.350877192982455	59.026634382566584
chr12	STAC3	57245144	57245211	0	68	0	2103	0	2035	0.0	0.0
chr12	STAC3	57249570	57249637	0	68	0	2103	0	2035	0.0	0.0
chr12	STAC3	57249570	57249730	0	161	0	2103	0	1942	0.0	0.0
chr12	R3HDM2	57288856	57288910	0	55	1142	5933	1142	5878	0.0	0.19428376998979244
chr12	R3HDM2	57395748	57395818	1142	71	1142	5933	0	5862	16.08450704225352	0.0
chr12	R3HDM2	57272452	57272554	0	103	1142	5933	1142	5830	0.0	0.19588336192109776
chr12	R3HDM2	57289008	57289040	0	33	1142	5933	1142	5900	0.0	0.1935593220338983
chr12	R3HDM2	57292571	57292667	0	97	1142	5933	1142	5836	0.0	0.19568197395476353
chr12	R3HDM2	57305639	57305663	0	25	1142	5933	1142	5908	0.0	0.1932972241029113
chr12	R3HDM2	57292571	57292649	0	79	1142	5933	1142	5854	0.0	0.1950802869832593
chr12	ARHGAP9	57473602	57473708	0	107	36177	4871	36177	4764	0.0	7.593828715365239
chr12	ARHGAP9	57474041	57474176	23	136	36177	4871	36154	4735	0.16911764705882354	7.635480464625132
chr12	ARHGAP9	57474422	57474476	0	55	36177	4871	36177	4816	0.0	7.5118355481727574
chr12	ARHGAP9	57476870	57476963	102	94	36177	4871	36075	4777	1.0851063829787233	7.551810759891145
chr12	ARHGAP9	57473602	57473691	0	90	36177	4871	36177	4781	0.0	7.566827023635223
chr12	DCTN2	57532212	57532315	2146	104	34174	6940	32028	6836	20.634615384615383	4.68519602106495
chr12	DCTN2	57533237	57533303	0	67	34174	6940	34174	6873	0.0	4.972210097482904
chr12	DCTN2	57533952	57534097	394	146	34174	6940	33780	6794	2.6986301369863015	4.972034147777451
chr12	DCTN2	57535483	57535545	0	63	34174	6940	34174	6877	0.0	4.969318016576996
chr12	DCTN2	57546027	57546096	0	70	34174	6940	34174	6870	0.0	4.9743813682678315
chr12	DCTN2	57538518	57538524	0	7	34174	6940	34174	6933	0.0	4.929179287465743
chr12	DCTN2	57541363	57541372	0	10	34174	6940	34174	6930	0.0	4.931313131313131
chr12	DCTN2	57538482	57538524	0	43	34174	6940	34174	6897	0.0	4.954907930984486
chr12	B4GALNT1	57629047	57629146	186	100	1115704	7003	1115518	6903	1.86	161.59901492104882
chr12	B4GALNT1	57630477	57630518	0	42	1115704	7003	1115704	6961	0.0	160.27927021979602
chr12	B4GALNT1	57631199	57631364	306	166	1115704	7003	1115398	6837	1.8433734939759037	163.14143630247185
chr12	B4GALNT1	57629047	57629174	214	128	1115704	7003	1115490	6875	1.671875	162.2530909090909
chr12	B4GALNT1	57631199	57631254	0	56	1115704	7003	1115704	6947	0.0	160.6022743630344
chr12	B4GALNT1	57631338	57631364	0	27	1115704	7003	1115704	6976	0.0	159.93463302752295
chr12	B4GALNT1	57632540	57632581	0	42	1115704	7003	1115704	6961	0.0	160.27927021979602
chr12	AGAP2	57728317	57728377	0	61	2401	6748	2401	6687	0.0	0.35905488260804547
chr12	CDK4	57751206	57751342	110	137	2680	2948	2570	2811	0.8029197080291971	0.9142653859836357
chr12	CDK4	57751499	57751736	2293	238	2680	2948	387	2710	9.634453781512605	0.14280442804428045
chr12	CDK4	57751499	57751659	1426	161	2680	2948	1254	2787	8.857142857142858	0.44994617868675996
chr12	CDK4	57751499	57751696	1800	198	2680	2948	880	2750	9.090909090909092	0.32
chr12	CDK4	57751499	57751752	2293	254	2680	2948	387	2694	9.027559055118111	0.14365256124721604
chr12	METTL1	57769771	57769956	153	186	1054	1954	901	1768	0.8225806451612904	0.5096153846153846
chr12	METTL1	57771093	57771257	102	165	1054	1954	952	1789	0.6181818181818182	0.5321408608160983
chr12	METTL1	57771479	57771605	264	127	1054	1954	790	1827	2.078740157480315	0.43240284619594965
chr12	AVIL	57803523	57803669	51	147	4185	5206	4134	5059	0.3469387755102041	0.8171575410160111
chr12	AVIL	57815577	57815692	0	116	4185	5206	4185	5090	0.0	0.8222003929273084
chr12	AC083805.1	57886527	57886696	199	170	165128	5555	164929	5385	1.1705882352941177	30.627483751160632
chr12	AC083805.1	57872852	57872976	0	125	165128	5555	165128	5430	0.0	30.410313075506444
chr12	GIHCG	57935469	57935553	570	85	47654	3815	47084	3730	6.705882352941177	12.623056300268097
chr12	GIHCG	57935394	57935553	1775	160	47654	3815	45879	3655	11.09375	12.552393980848153
chr12	GIHCG	57935469	57935592	930	124	47654	3815	46724	3691	7.5	12.658900027092928
chr12	GIHCG	57935469	57935572	742	104	47654	3815	46912	3711	7.134615384615385	12.641336566963083
chr12	GIHCG	57935297	57935553	2633	257	47654	3815	45021	3558	10.245136186770427	12.65345699831366
chr12	LRIG3	58880368	58880478	0	111	409	5787	409	5676	0.0	0.07205778717406625
chr12	TAFA2	62023651	62023779	0	129	91	8739	91	8610	0.0	0.01056910569105691
chr12	TAFA2	61720686	61720924	0	239	91	8739	91	8500	0.0	0.010705882352941176
chr12	TAFA2	61890341	61890423	0	83	91	8739	91	8656	0.0	0.010512939001848428
chr12	DPY19L2	63580661	63580836	0	176	152	5637	152	5461	0.0	0.027833730086064823
chr12	DPY19L2	63624039	63624131	0	93	152	5637	152	5544	0.0	0.027417027417027416
chr12	DPY19L2	63663757	63663845	4	89	152	5637	148	5548	0.0449438202247191	0.026676279740447006
chr12	DPY19L2	63590998	63591127	0	130	152	5637	152	5507	0.0	0.027601234792082804
chr12	C12ORF56	64277679	64277803	0	125	6800	5084	6800	4959	0.0	1.3712442024601734
chr12	C12ORF56	64318574	64318980	1326	407	6800	5084	5474	4677	3.257985257985258	1.1704083814410948
chr12	C12ORF56	64312678	64312752	0	75	6800	5084	6800	5009	0.0	1.357556398482731
chr12	GNS	64728955	64729057	44	103	44	6283	0	6180	0.42718446601941745	0.0
chr12	GNS	64752697	64752757	0	61	44	6283	44	6222	0.0	0.007071681131468981
chr12	GNS	64756666	64756762	0	97	44	6283	44	6186	0.0	0.007112835434852894
chr12	AC025419.1	65626611	65626685	0	75	3896	4040	3896	3965	0.0	0.9825977301387138
chr12	AC025419.1	65538683	65538761	0	79	3896	4040	3896	3961	0.0	0.983590002524615
chr12	AC025419.1	65613178	65613277	70	100	3896	4040	3826	3940	0.7	0.9710659898477157
chr12	AC025419.1	65587342	65587452	0	111	3896	4040	3896	3929	0.0	0.9916009162636803
chr12	AC025419.1	65561863	65561941	0	79	3896	4040	3896	3961	0.0	0.983590002524615
chr12	TMBIM4	66138723	66138769	0	47	153	2161	153	2114	0.0	0.07237464522232734
chr12	TMBIM4	66160164	66160305	0	142	153	2161	153	2019	0.0	0.07578008915304606
chr12	TMBIM4	66168914	66169353	0	440	153	2161	153	1721	0.0	0.08890180127832656
chr12	TMBIM4	66138723	66138734	0	12	153	2161	153	2149	0.0	0.07119590507212657
chr12	TMBIM4	66169289	66169353	0	65	153	2161	153	2096	0.0	0.07299618320610687
chr12	GRIP1	66377016	66377061	0	46	4528	6603	4528	6557	0.0	0.6905597071831631
chr12	GRIP1	66455408	66455564	0	157	4528	6603	4528	6446	0.0	0.7024511324852621
chr12	GRIP1	66596846	66596927	0	82	4528	6603	4528	6521	0.0	0.6943720288299341
chr12	GRIP1	66456186	66456342	0	157	4528	6603	4528	6446	0.0	0.7024511324852621
chr12	GRIP1	66462923	66463093	0	171	4528	6603	4528	6432	0.0	0.7039800995024875
chr12	GRIP1	66455408	66455561	0	154	4528	6603	4528	6449	0.0	0.7021243603659482
chr12	MDM1	68296922	68296982	0	61	104	5181	104	5120	0.0	0.0203125
chr12	MDM1	68325440	68325575	0	136	104	5181	104	5045	0.0	0.020614469772051537
chr12	MDM1	68326656	68327021	0	366	104	5181	104	4815	0.0	0.021599169262720666
chr12	MDM1	68316580	68316610	0	31	104	5181	104	5150	0.0	0.020194174757281552
chr12	CPM	68885791	68885889	0	99	0	2730	0	2631	0.0	0.0
chr12	CPM	68885791	68885885	0	95	0	2730	0	2635	0.0	0.0
chr12	BEST3	69676915	69677068	0	154	126531	6878	126531	6724	0.0	18.817816775728733
chr12	BEST3	69693673	69693907	0	235	126531	6878	126531	6643	0.0	19.04726780069246
chr12	BEST3	69697646	69697813	0	168	126531	6878	126531	6710	0.0	18.857078986587183
chr12	BEST3	69694369	69694464	0	96	126531	6878	126531	6782	0.0	18.65688587437334
chr12	AC025263.1	69730572	69730696	0	125	0	2799	0	2674	0.0	0.0
chr12	PRANCR	70242180	70242229	0	50	1341	5036	1341	4986	0.0	0.26895306859205775
chr12	PRANCR	70224964	70225032	0	69	1341	5036	1341	4967	0.0	0.2699818804107107
chr12	PRANCR	70229851	70230018	0	168	1341	5036	1341	4868	0.0	0.2754724732949877
chr12	PRANCR	70243065	70243204	0	140	1341	5036	1341	4896	0.0	0.27389705882352944
chr12	PTPRB	70566434	70566704	51	271	483	14362	432	14091	0.1881918819188192	0.030657866723440494
chr12	PTPRB	70576381	70576645	0	265	483	14362	483	14097	0.0	0.03426260906575867
chr12	PTPRB	70589963	70590233	0	271	483	14362	483	14091	0.0	0.03427719821162444
chr12	PTPRR	70701136	70701323	0	188	94	5055	94	4867	0.0	0.019313745633860693
chr12	PTPRR	70639518	70639672	0	155	94	5055	94	4900	0.0	0.019183673469387756
chr12	PTPRR	70672719	70672976	0	258	94	5055	94	4797	0.0	0.01959558057119033
chr12	TSPAN8	71277350	71277412	0	63	0	2436	0	2373	0.0	0.0
chr12	TRHDE-AS1	72264481	72264621	0	141	591	8148	591	8007	0.0	0.07381041588609966
chr12	TRHDE-AS1	72261197	72261428	0	232	591	8148	591	7916	0.0	0.0746589186457807
chr12	TRHDE-AS1	72261197	72264621	612	3425	591	8148	-21	4723	0.17868613138686132	-0.004446326487402075
chr12	TRHDE-AS1	72259385	72259540	0	156	591	8148	591	7992	0.0	0.07394894894894895
chr12	TRHDE-AS1	72264481	72264616	0	136	591	8148	591	8012	0.0	0.0737643534697953
chr12	AC090503.2	73127889	73128016	0	128	0	1043	0	915	0.0	0.0
chr12	LINC02882	73835059	73835114	0	56	4	8438	4	8382	0.0	0.0004772130756382725
chr12	LINC02882	74321534	74321694	0	161	4	8438	4	8277	0.0	0.00048326688413676455
chr12	LINC02882	74194073	74194153	0	81	4	8438	4	8357	0.0	0.00047864066052411155
chr12	LINC02882	74339664	74339795	0	132	4	8438	4	8306	0.0	0.0004815795810257645
chr12	LINC02882	74377562	74377632	4	71	4	8438	0	8367	0.056338028169014086	0.0
chr12	LINC02882	74332233	74332395	0	163	4	8438	4	8275	0.0	0.00048338368580060423
chr12	LINC02882	74203797	74203890	0	94	4	8438	4	8344	0.0	0.00047938638542665386
chr12	LINC02882	74325997	74326171	0	175	4	8438	4	8263	0.0	0.00048408568316592036
chr12	LINC02882	74340142	74340256	0	115	4	8438	4	8323	0.0	0.00048059593896431575
chr12	KCNC2	75042279	75042374	0	96	204	5547	204	5451	0.0	0.03742432581177765
chr12	KCNC2	75048152	75048317	0	166	204	5547	204	5381	0.0	0.037911168927708606
chr12	KCNC2	75049884	75049988	0	105	204	5547	204	5442	0.0	0.037486218302094816
chr12	CAPS2	75323176	75323222	0	47	21	6680	21	6633	0.0	0.003165988240615106
chr12	CAPS2	75298870	75298966	0	97	21	6680	21	6583	0.0	0.0031900349384778974
chr12	CAPS2	75322973	75323087	0	115	21	6680	21	6565	0.0	0.003198781416603199
chr12	CAPS2	75390321	75390381	0	61	21	6680	21	6619	0.0	0.0031726846955733496
chr12	CAPS2	75371078	75371482	0	405	21	6680	21	6275	0.0	0.003346613545816733
chr12	KRR1	75503903	75504074	0	172	0	10603	0	10431	0.0	0.0
chr12	NAP1L1	76059797	76059878	0	82	0	4739	0	4657	0.0	0.0
chr12	NAP1L1	76068908	76068994	0	87	0	4739	0	4652	0.0	0.0
chr12	NAP1L1	76074202	76074239	0	38	0	4739	0	4701	0.0	0.0
chr12	NAP1L1	76067370	76067473	0	104	0	4739	0	4635	0.0	0.0
chr12	NAP1L1	76057743	76057776	0	34	0	4739	0	4705	0.0	0.0
chr12	NAP1L1	76056573	76056672	0	100	0	4739	0	4639	0.0	0.0
chr12	NAP1L1	76059776	76059878	0	103	0	4739	0	4636	0.0	0.0
chr12	NAP1L1	76061009	76061087	0	79	0	4739	0	4660	0.0	0.0
chr12	OSBPL8	76450850	76450988	1478	139	290153	9227	288675	9088	10.633093525179856	31.764414612676056
chr12	OSBPL8	76534233	76534281	0	49	290153	9227	290153	9178	0.0	31.613968184789716
chr12	OSBPL8	76459858	76459895	0	38	290153	9227	290153	9189	0.0	31.576123626074654
chr12	OSBPL8	76450850	76450979	1478	130	290153	9227	288675	9097	11.36923076923077	31.732988897438716
chr12	OSBPL8	76537956	76537986	0	31	290153	9227	290153	9196	0.0	31.552087864288822
chr12	OSBPL8	76410563	76410634	109	72	290153	9227	290044	9155	1.5138888888888888	31.681485527034408
chr12	OSBPL8	76537003	76537041	0	39	290153	9227	290153	9188	0.0	31.57956029603831
chr12	CSRP2	76862809	76862959	0	151	1351	3237	1351	3086	0.0	0.43778353856124436
chr12	E2F7	77025557	77025982	0	426	0	6305	0	5879	0.0	0.0
chr12	E2F7	77044245	77044269	0	25	0	6305	0	6280	0.0	0.0
chr12	PPP1R12A	79786373	79786478	0	106	7802	10162	7802	10056	0.0	0.7758552108194113
chr12	PPP1R12A	79805591	79805768	0	178	7802	10162	7802	9984	0.0	0.7814503205128205
chr12	PPP1R12A	79806165	79806333	0	169	7802	10162	7802	9993	0.0	0.780746522565796
chr12	PPP1R12A	79822115	79822190	0	76	7802	10162	7802	10086	0.0	0.7735474915724767
chr12	PPP1R12A	79782570	79782595	0	26	7802	10162	7802	10136	0.0	0.7697316495659037
chr12	PPP1R12A	79779338	79779351	0	14	7802	10162	7802	10148	0.0	0.7688214426487978
chr12	PPP1R12A	79789597	79789680	0	84	7802	10162	7802	10078	0.0	0.7741615399880929
chr12	PPP1R12A	79779320	79779351	0	32	7802	10162	7802	10130	0.0	0.7701875616979269
chr12	PPP1R12A	79806165	79806297	0	133	7802	10162	7802	10029	0.0	0.7779439625087247
chr12	PPP1R12A	79810394	79810511	0	118	7802	10162	7802	10044	0.0	0.7767821585025886
chr12	PPP1R12A	79848787	79848931	0	145	7802	10162	7802	10017	0.0	0.7788759109513826
chr12	LIN7A	80848098	80848175	0	78	0	6803	0	6725	0.0	0.0
chr12	AC078955.1	81104768	81104828	0	61	0	909	0	848	0.0	0.0
chr12	PPFIA2	81261948	81262040	0	93	0	7396	0	7303	0.0	0.0
chr12	PPFIA2	81368102	81368166	0	65	0	7396	0	7331	0.0	0.0
chr12	PPFIA2	81284240	81284303	0	64	0	7396	0	7332	0.0	0.0
chr12	PPFIA2	81439971	81440046	0	76	0	7396	0	7320	0.0	0.0
chr12	PPFIA2	81676790	81676844	0	55	0	7396	0	7341	0.0	0.0
chr12	PPFIA2	81312159	81312168	0	10	0	7396	0	7386	0.0	0.0
chr12	PPFIA2	81283009	81283039	0	31	0	7396	0	7365	0.0	0.0
chr12	SLC6A15	84891831	84892308	0	478	51	8520	51	8042	0.0	0.0063417060432728175
chr12	TSPAN19	85015887	85015971	0	85	0	1576	0	1491	0.0	0.0
chr12	TSPAN19	85024651	85024772	0	122	0	1576	0	1454	0.0	0.0
chr12	TSPAN19	85027898	85028023	0	126	0	1576	0	1450	0.0	0.0
chr12	TSPAN19	85035132	85035256	0	125	0	1576	0	1451	0.0	0.0
chr12	MGAT4C	86028087	86028207	0	121	0	3695	0	3574	0.0	0.0
chr12	MGAT4C	86028103	86028204	0	102	0	3695	0	3593	0.0	0.0
chr12	MGAT4C	86022448	86022544	0	97	0	3695	0	3598	0.0	0.0
chr12	C12ORF50	87987849	87987966	0	118	52	5625	52	5507	0.0	0.009442527692028328
chr12	CEP290	88054339	88054413	0	75	102	21189	102	21114	0.0	0.004830917874396135
chr12	CEP290	88059897	88060020	0	124	102	21189	102	21065	0.0	0.004842155233800142
chr12	CEP290	88060829	88060994	0	166	102	21189	102	21023	0.0	0.004851828949246064
chr12	CEP290	88114419	88114562	0	144	102	21189	102	21045	0.0	0.004846756949394155
chr12	CEP290	88117032	88117145	0	114	102	21189	102	21075	0.0	0.004839857651245552
chr12	CEP290	88130544	88130565	0	22	102	21189	102	21167	0.0	0.004818821750838569
chr12	CEP290	88131164	88131218	0	55	102	21189	102	21134	0.0	0.004826346172045046
chr12	CEP290	88068037	88068046	0	10	102	21189	102	21179	0.0	0.00481609141130365
chr12	CEP290	88115477	88115570	0	94	102	21189	102	21095	0.0	0.004835269021095046
chr12	CEP290	88115765	88116533	0	769	102	21189	102	20420	0.0	0.004995102840352595
chr12	CEP290	88119020	88119150	0	131	102	21189	102	21058	0.0	0.004843764839965809
chr12	KITLG	88515533	88515617	0	85	1316	6217	1316	6132	0.0	0.2146118721461187
chr12	KITLG	88564207	88564344	0	138	1316	6217	1316	6079	0.0	0.21648297417338377
chr12	DUSP6	89350587	89351025	0	439	0	3814	0	3375	0.0	0.0
chr12	POC1B	89459637	89459718	0	82	0	8786	0	8704	0.0	0.0
chr12	POC1B	89497170	89497342	0	173	0	8786	0	8613	0.0	0.0
chr12	POC1B	89460015	89460038	0	24	0	8786	0	8762	0.0	0.0
chr12	POC1B	89467616	89467685	0	70	0	8786	0	8716	0.0	0.0
chr12	POC1B	89497038	89497342	0	305	0	8786	0	8481	0.0	0.0
chr12	ATP2B1	89598589	89598743	0	155	0	9425	0	9270	0.0	0.0
chr12	ATP2B1	89601325	89601433	0	109	0	9425	0	9316	0.0	0.0
chr12	ATP2B1	89598656	89598743	0	88	0	9425	0	9337	0.0	0.0
chr12	DCN	91164604	91164717	0	114	23	7464	23	7350	0.0	0.003129251700680272
chr12	DCN	91158295	91158509	0	215	23	7464	23	7249	0.0	0.0031728514277831426
chr12	DCN	91179361	91179686	0	326	23	7464	23	7138	0.0	0.00322219108994116
chr12	DCN	91157074	91157188	0	115	23	7464	23	7349	0.0	0.003129677507143829
chr12	LINC01619	91990287	91990362	0	76	0	4212	0	4136	0.0	0.0
chr12	LINC01619	91990283	91990362	0	80	0	4212	0	4132	0.0	0.0
chr12	EEA1	92864859	92864987	0	129	0	10182	0	10053	0.0	0.0
chr12	EEA1	92879246	92879363	0	118	0	10182	0	10064	0.0	0.0
chr12	AC124947.1	93339638	93339736	0	99	408	1299	408	1200	0.0	0.34
chr12	UBE2N	93410733	93410874	0	142	51	4147	51	4005	0.0	0.012734082397003745
chr12	SOCS2-AS1	93567063	93567159	0	97	0	4449	0	4352	0.0	0.0
chr12	CEP83	94435274	94435327	0	54	0	6852	0	6798	0.0	0.0
chr12	CEP83	94328204	94328308	0	105	0	6852	0	6747	0.0	0.0
chr12	CEP83	94434002	94434053	0	52	0	6852	0	6800	0.0	0.0
chr12	NDUFA12	94996903	94996976	0	74	0	1804	0	1730	0.0	0.0
chr12	NDUFA12	94994169	94994257	0	89	0	1804	0	1715	0.0	0.0
chr12	NDUFA12	94972394	94972489	0	96	0	1804	0	1708	0.0	0.0
chr12	NR2C1	95040475	95040597	0	123	0	5319	0	5196	0.0	0.0
chr12	NR2C1	95049067	95049233	0	167	0	5319	0	5152	0.0	0.0
chr12	NR2C1	95059905	95059984	0	80	0	5319	0	5239	0.0	0.0
chr12	NR2C1	95067330	95067391	0	62	0	5319	0	5257	0.0	0.0
chr12	NR2C1	95031348	95031488	0	141	0	5319	0	5178	0.0	0.0
chr12	FGD6	95084497	95084646	0	150	51	10068	51	9918	0.0	0.00514216575922565
chr12	FGD6	95208842	95211267	0	2426	51	10068	51	7642	0.0	0.006673645642501963
chr12	AC084879.1	95380853	95380958	0	106	15392	3186	15392	3080	0.0	4.997402597402598
chr12	AC084879.1	95396814	95397000	0	187	15392	3186	15392	2999	0.0	5.132377459153051
chr12	USP44	95520996	95521202	51	207	2247	5382	2196	5175	0.2463768115942029	0.42434782608695654
chr12	USP44	95528806	95529002	0	197	2247	5382	2247	5185	0.0	0.43336547733847636
chr12	USP44	95535372	95535426	0	55	2247	5382	2247	5327	0.0	0.42181340341655715
chr12	NTN4	95670077	95670146	0	70	198	4379	198	4309	0.0	0.04595033650498956
chr12	CCDC38	95919553	95919623	0	71	45448	4874	45448	4803	0.0	9.462419321257547
chr12	CCDC38	95919438	95919623	0	186	45448	4874	45448	4688	0.0	9.694539249146757
chr12	HAL	95976428	95976498	0	71	104	5065	104	4994	0.0	0.020824989987985584
chr12	HAL	95993771	95993838	0	68	104	5065	104	4997	0.0	0.020812487492495497
chr12	HAL	95993643	95993674	0	32	104	5065	104	5033	0.0	0.020663620107291874
chr12	LTA4H	96003837	96003920	0	84	406	5226	406	5142	0.0	0.07895760404511863
chr12	LTA4H	96003837	96003981	25	145	406	5226	381	5081	0.1724137931034483	0.07498523912615628
chr12	CDK17	96334718	96334865	0	148	32716	6488	32716	6340	0.0	5.160252365930599
chr12	IKBIP	98634295	98634413	0	119	0	4167	0	4048	0.0	0.0
chr12	ANKS1B	98829173	98829353	0	181	630	9547	630	9366	0.0	0.06726457399103139
chr12	ANKS1B	99779870	99779972	0	103	630	9547	630	9444	0.0	0.06670902160101652
chr12	ANKS1B	98807843	98807915	0	73	630	9547	630	9474	0.0	0.06649778340721976
chr12	ANKS1B	98807843	98807918	0	76	630	9547	630	9471	0.0	0.06651884700665188
chr12	ANKS1B	98829173	98829251	0	79	630	9547	630	9468	0.0	0.06653992395437262
chr12	UHRF1BP1L	100084475	100084658	0	184	102	6666	102	6482	0.0	0.01573588398642394
chr12	UHRF1BP1L	100128579	100128725	0	147	102	6666	102	6519	0.0	0.015646571560055222
chr12	GOLGA2P5	100157348	100157445	0	98	177	6935	177	6837	0.0	0.025888547608600262
chr12	GOLGA2P5	100170763	100170852	0	90	177	6935	177	6845	0.0	0.025858290723155587
chr12	GOLGA2P5	100171221	100171260	0	40	177	6935	177	6895	0.0	0.02567077592458303
chr12	AC010203.1	100198843	100198972	0	130	0	1297	0	1167	0.0	0.0
chr12	DEPDC4	100263496	100263893	0	398	0	3131	0	2733	0.0	0.0
chr12	DEPDC4	100261729	100261768	0	40	0	3131	0	3091	0.0	0.0
chr12	DEPDC4	100253488	100253715	0	228	0	3131	0	2903	0.0	0.0
chr12	DEPDC4	100263496	100263692	0	197	0	3131	0	2934	0.0	0.0
chr12	ARL1	101405843	101405981	0	139	0	4578	0	4439	0.0	0.0
chr12	ARL1	101403141	101403255	0	115	0	4578	0	4463	0.0	0.0
chr12	GNPTAB	101756419	101756566	0	148	115615	9249	115615	9101	0.0	12.703549060542798
chr12	WASHC3	102039867	102039978	0	112	0	2668	0	2556	0.0	0.0
chr12	WASHC3	102048289	102048397	0	109	0	2668	0	2559	0.0	0.0
chr12	WASHC3	102017719	102017805	0	87	0	2668	0	2581	0.0	0.0
chr12	WASHC3	102039867	102039975	0	109	0	2668	0	2559	0.0	0.0
chr12	WASHC3	102019276	102019371	0	96	0	2668	0	2572	0.0	0.0
chr12	WASHC3	102050188	102050291	0	104	0	2668	0	2564	0.0	0.0
chr12	WASHC3	102050517	102050639	0	123	0	2668	0	2545	0.0	0.0
chr12	NUP37	102079058	102079216	0	159	18686	3500	18686	3341	0.0	5.592936246632744
chr12	IGF1	102417954	102418003	0	50	108	8123	108	8073	0.0	0.013377926421404682
chr12	PAH	102846894	102846951	0	58	8	7403	8	7345	0.0	0.0010891763104152485
chr12	PAH	102866595	102866663	0	69	8	7403	8	7334	0.0	0.00109080992637033
chr12	PAH	102913801	102913933	0	133	8	7403	8	7270	0.0	0.0011004126547455295
chr12	PAH	102917070	102917225	0	156	8	7403	8	7247	0.0	0.0011039050641644817
chr12	C12ORF42	103267633	103267708	0	76	0	4757	0	4681	0.0	0.0
chr12	C12ORF42	103273791	103273883	0	93	0	4757	0	4664	0.0	0.0
chr12	C12ORF42	103268857	103268962	0	106	0	4757	0	4651	0.0	0.0
chr12	C12ORF42	103378707	103378792	0	86	0	4757	0	4671	0.0	0.0
chr12	C12ORF42	103368011	103368106	0	96	0	4757	0	4661	0.0	0.0
chr12	NT5DC3	103785570	103785747	0	178	51	5597	51	5419	0.0	0.009411330503782987
chr12	TTC41P	103844510	103844649	0	140	0	5454	0	5314	0.0	0.0
chr12	TTC41P	103890764	103890904	0	141	0	5454	0	5313	0.0	0.0
chr12	C12ORF73	103953413	103953534	0	122	0	2983	0	2861	0.0	0.0
chr12	C12ORF73	103954874	103954968	0	95	0	2983	0	2888	0.0	0.0
chr12	C12ORF73	103955705	103955771	0	67	0	2983	0	2916	0.0	0.0
chr12	GLT8D2	104021356	104021491	0	136	0	3287	0	3151	0.0	0.0
chr12	NFYB	104131753	104131838	0	86	0	4909	0	4823	0.0	0.0
chr12	SLC41A2	104909654	104909762	0	109	327	5166	327	5057	0.0	0.06466284358315207
chr12	SLC41A2	104931631	104931791	0	161	327	5166	327	5005	0.0	0.06533466533466534
chr12	APPL2	105229124	105229223	0	100	1206	5070	1206	4970	0.0	0.2426559356136821
chr12	CKAP4	106254077	106254219	0	143	0	3671	0	3528	0.0	0.0
chr12	AC079385.1	106507627	106507810	0	184	182	2427	182	2243	0.0	0.08114132857779759
chr12	AC079385.1	106683501	106683744	0	244	182	2427	182	2183	0.0	0.08337150710032067
chr12	MTERF2	106985114	106985225	0	112	0	1176	0	1064	0.0	0.0
chr12	MTERF2	106985114	106985215	0	102	0	1176	0	1074	0.0	0.0
chr12	MTERF2	106980620	106980713	0	94	0	1176	0	1082	0.0	0.0
chr12	CMKLR1	108293588	108293664	0	77	0	5672	0	5595	0.0	0.0
chr12	CMKLR1	108329994	108330207	0	214	0	5672	0	5458	0.0	0.0
chr12	SART3	108537487	108537595	0	109	51	7034	51	6925	0.0	0.007364620938628159
chr12	SART3	108544426	108544478	0	53	51	7034	51	6981	0.0	0.00730554361839278
chr12	SART3	108544426	108544532	0	107	51	7034	51	6927	0.0	0.0073624945864010395
chr12	SART3	108542769	108542851	0	83	51	7034	51	6951	0.0	0.0073370738023306
chr12	TMEM119	108594163	108594545	0	383	0	3188	0	2805	0.0	0.0
chr12	TMEM119	108594336	108594545	0	210	0	3188	0	2978	0.0	0.0
chr12	CORO1C	108701123	108701323	0	201	51	4794	51	4593	0.0	0.011103853690398433
chr12	SSH1	108802321	108802368	0	48	64	14534	64	14486	0.0	0.00441805881540798
chr12	SSH1	108811259	108811328	0	70	64	14534	64	14464	0.0	0.004424778761061947
chr12	SSH1	108818248	108818313	0	66	64	14534	64	14468	0.0	0.004423555432679016
chr12	SSH1	108823257	108823361	0	105	64	14534	64	14429	0.0	0.004435511816480699
chr12	SVOP	108977397	108977496	0	100	64420	7114	64420	7014	0.0	9.184488166524094
chr12	SVOP	108978577	108978663	0	87	64420	7114	64420	7027	0.0	9.167496798064608
chr12	ALKBH2	109090008	109090207	89	200	138	1630	49	1430	0.445	0.03426573426573427
chr12	FOXN4	109287396	109287524	0	129	150	3545	150	3416	0.0	0.043911007025761124
chr12	KCTD10	109457991	109458078	0	88	0	7167	0	7079	0.0	0.0
chr12	KCTD10	109460635	109460805	0	171	0	7167	0	6996	0.0	0.0
chr12	KCTD10	109469514	109469728	0	215	0	7167	0	6952	0.0	0.0
chr12	KCTD10	109457991	109458081	0	91	0	7167	0	7076	0.0	0.0
chr12	KCTD10	109469514	109471377	0	1864	0	7167	0	5303	0.0	0.0
chr12	KCTD10	109457991	109458184	0	194	0	7167	0	6973	0.0	0.0
chr12	KCTD10	109457991	109458048	0	58	0	7167	0	7109	0.0	0.0
chr12	MMAB	109571648	109571710	0	63	0	6029	0	5966	0.0	0.0
chr12	MMAB	109561242	109561329	0	88	0	6029	0	5941	0.0	0.0
chr12	MMAB	109568769	109568863	0	95	0	6029	0	5934	0.0	0.0
chr12	MMAB	109569971	109570094	0	124	0	6029	0	5905	0.0	0.0
chr12	MMAB	109567010	109567167	0	158	0	6029	0	5871	0.0	0.0
chr12	FAM222A-AS1	109742104	109742165	0	62	0	1072	0	1010	0.0	0.0
chr12	TRPV4	109796524	109796704	0	181	0	3893	0	3712	0.0	0.0
chr12	TRPV4	109800617	109800758	0	142	0	3893	0	3751	0.0	0.0
chr12	TRPV4	109800617	109800787	0	171	0	3893	0	3722	0.0	0.0
chr12	GLTP	109857854	109858193	0	340	91	2752	91	2412	0.0	0.037728026533996685
chr12	GLTP	109858139	109858193	0	55	91	2752	91	2697	0.0	0.033741193919169445
chr12	GIT2	109965759	109965765	57	7	29637	13482	29580	13475	8.142857142857142	2.1951762523191096
chr12	GIT2	109991626	109991760	813	135	29637	13482	28824	13347	6.022222222222222	2.1595864239154867
chr12	GIT2	109967313	109967319	0	7	29637	13482	29637	13475	0.0	2.1994063079777364
chr12	GIT2	109951166	109951316	0	151	29637	13482	29637	13331	0.0	2.2231640537093993
chr12	GIT2	109945259	109945349	0	91	29637	13482	29637	13391	0.0	2.213202897468449
chr12	ANAPC7	110377392	110377617	1020	226	17915	6021	16895	5795	4.513274336283186	2.915444348576359
chr12	ANAPC7	110388511	110388623	47	113	17915	6021	17868	5908	0.415929203539823	3.024373730534868
chr12	ANAPC7	110396265	110396452	0	188	17915	6021	17915	5833	0.0	3.0713183610492027
chr12	ARPC3	110440311	110440388	0	78	4117	2641	4117	2563	0.0	1.6063207179087007
chr12	GPN3	110468155	110468375	882	221	34280	2573	33398	2352	3.990950226244344	14.19982993197279
chr12	VPS29	110492995	110493231	0	237	502	3202	502	2965	0.0	0.16930860033726813
chr12	VPS29	110499534	110499546	0	13	502	3202	502	3189	0.0	0.15741611790529947
chr12	VPS29	110498819	110498859	0	41	502	3202	502	3161	0.0	0.15881050300537805
chr12	VPS29	110501416	110501559	0	144	502	3202	502	3058	0.0	0.16415958142576847
chr12	VPS29	110499456	110499546	246	91	502	3202	256	3111	2.7032967032967035	0.0822886531661845
chr12	HVCN1	110683224	110683264	0	41	275	3009	275	2968	0.0	0.09265498652291106
chr12	ATXN2	111464661	111464715	0	55	0	13978	0	13923	0.0	0.0
chr12	ATXN2	111485264	111485331	0	68	0	13978	0	13910	0.0	0.0
chr12	ATXN2	111510384	111510582	0	199	0	13978	0	13779	0.0	0.0
chr12	ATXN2	111516153	111516363	0	211	0	13978	0	13767	0.0	0.0
chr12	ATXN2	111552905	111552977	0	73	0	13978	0	13905	0.0	0.0
chr12	ATXN2	111453676	111453845	0	170	0	13978	0	13808	0.0	0.0
chr12	ATXN2	111479069	111479102	0	34	0	13978	0	13944	0.0	0.0
chr12	ATXN2	111485270	111485331	0	62	0	13978	0	13916	0.0	0.0
chr12	ATXN2	111516153	111516399	0	247	0	13978	0	13731	0.0	0.0
chr12	ATXN2	111455044	111455119	0	76	0	13978	0	13902	0.0	0.0
chr12	ATXN2	111510384	111510444	0	61	0	13978	0	13917	0.0	0.0
chr12	ATXN2	111461138	111461305	0	168	0	13978	0	13810	0.0	0.0
chr12	ATXN2	111555882	111555919	0	38	0	13978	0	13940	0.0	0.0
chr12	ATXN2	111482786	111482831	0	46	0	13978	0	13932	0.0	0.0
chr12	MAPKAPK5-AS1	111841326	111841470	0	145	1380	2732	1380	2587	0.0	0.5334364128333977
chr12	TMEM116	111936691	111936830	0	140	2696	5425	2696	5285	0.0	0.5101229895931882
chr12	TMEM116	111943264	111943369	0	106	2696	5425	2696	5319	0.0	0.50686219214138
chr12	TMEM116	112003799	112003863	0	65	2696	5425	2696	5360	0.0	0.5029850746268657
chr12	TMEM116	111965594	111965759	510	166	2696	5425	2186	5259	3.072289156626506	0.4156683780186347
chr12	TMEM116	111978735	111978787	0	53	2696	5425	2696	5372	0.0	0.501861504095309
chr12	TMEM116	111936741	111936830	0	90	2696	5425	2696	5335	0.0	0.5053420805998126
chr12	TMEM116	112005601	112005686	0	86	2696	5425	2696	5339	0.0	0.5049634763064245
chr12	NAA25	112087682	112087801	5338	120	15851	9927	10513	9807	44.483333333333334	1.0719893953298665
chr12	NAA25	112093050	112093136	0	87	15851	9927	15851	9840	0.0	1.6108739837398374
chr12	NAA25	112049482	112049611	0	130	15851	9927	15851	9797	0.0	1.6179442686536696
chr12	NAA25	112097240	112097441	88	202	15851	9927	15763	9725	0.43564356435643564	1.6208740359897171
chr12	HECTD4	112168632	112168806	0	175	90497	19857	90497	19682	0.0	4.597957524641805
chr12	RPL6	112408419	112408656	0	238	425	3049	425	2811	0.0	0.1511917467093561
chr12	RASAL1	113112085	113112278	0	194	12	4715	12	4521	0.0	0.0026542800265428003
chr12	DDX54	113164066	113164285	51	220	51	5086	0	4866	0.2318181818181818	0.0
chr12	SLC8B1	113320330	113320498	0	169	0	6033	0	5864	0.0	0.0
chr12	SLC8B1	113334442	113334838	0	397	0	6033	0	5636	0.0	0.0
chr12	SLC8B1	113302139	113302700	0	562	0	6033	0	5471	0.0	0.0
chr12	SLC8B1	113334442	113334835	0	394	0	6033	0	5639	0.0	0.0
chr12	LINC01234	113767074	113767208	0	135	139044	11884	139044	11749	0.0	11.834539109711464
chr12	LINC01234	113767074	113767236	0	163	139044	11884	139044	11721	0.0	11.86281034041464
chr12	LINC01234	113753430	113753563	0	134	139044	11884	139044	11750	0.0	11.833531914893618
chr12	RBM19	113959211	113959404	0	194	30665	5676	30665	5482	0.0	5.593761400948559
chr12	TBX5	114403751	114403936	0	186	2142	4453	2142	4267	0.0	0.50199203187251
chr12	TBX3	114679912	114679972	0	61	51	5966	51	5905	0.0	0.008636748518204911
chr12	MED13L	115968939	115969097	0	159	234	26268	234	26109	0.0	0.008962426749396759
chr12	SPRING1	116723066	116723223	0	158	3790	8683	3790	8525	0.0	0.44457478005865103
chr12	TESC	117041946	117041994	0	49	21	1937	21	1888	0.0	0.011122881355932203
chr12	TESC	117056805	117056886	0	82	21	1937	21	1855	0.0	0.011320754716981131
chr12	TESC	117048680	117048810	0	131	21	1937	21	1806	0.0	0.011627906976744186
chr12	FBXO21	117166897	117167077	663	181	100148	6901	99485	6720	3.6629834254143647	14.804315476190476
chr12	NOS1	117255935	117256037	571	103	21842	13145	21271	13042	5.543689320388349	1.6309615089710168
chr12	WSB2	118038287	118038388	0	102	255	3937	255	3835	0.0	0.06649282920469361
chr12	VSIG10	118082126	118082429	0	304	408	7227	408	6923	0.0	0.05893398815542395
chr12	TAOK3	118212913	118212995	0	83	551	9442	551	9359	0.0	0.058873811304626565
chr12	TAOK3	118239226	118239272	0	47	551	9442	551	9395	0.0	0.05864821713677488
chr12	TAOK3	118296941	118297163	0	223	551	9442	551	9219	0.0	0.05976787070181148
chr12	TAOK3	118283604	118283702	0	99	551	9442	551	9343	0.0	0.0589746334153912
chr12	TAOK3	118261496	118261673	0	178	551	9442	551	9264	0.0	0.05947754749568221
chr12	TAOK3	118295239	118295381	0	143	551	9442	551	9299	0.0	0.05925368319174105
chr12	LINC02423	118759973	118760067	0	95	0	1060	0	965	0.0	0.0
chr12	AC002070.1	119402314	119402430	0	117	0	1471	0	1354	0.0	0.0
chr12	CIT	119710250	119710386	0	137	51	25017	51	24880	0.0	0.00204983922829582
chr12	CIT	119770784	119770910	0	127	51	25017	51	24890	0.0	0.0020490156689433508
chr12	RAB35	120098810	120098935	0	126	16608	3944	16608	3818	0.0	4.349921424829754
chr12	RAB35	120108591	120108703	0	113	16608	3944	16608	3831	0.0	4.335160532498042
chr12	RPLP0	120198553	120198739	0	187	5008	2408	5008	2221	0.0	2.254840162089149
chr12	RPLP0	120198853	120199000	526	148	5008	2408	4482	2260	3.554054054054054	1.9831858407079646
chr12	RPLP0	120198553	120198631	0	79	5008	2408	5008	2329	0.0	2.1502790897380852
chr12	RPLP0	120198894	120199000	204	107	5008	2408	4804	2301	1.9065420560747663	2.0877879182963928
chr12	RPLP0	120198553	120198770	1313	218	5008	2408	3695	2190	6.022935779816514	1.687214611872146
chr12	RPLP0	120200045	120200150	0	106	5008	2408	5008	2302	0.0	2.1754995655951346
chr12	PXN	120215559	120215661	0	103	16239	7481	16239	7378	0.0	2.2010029818378967
chr12	PXN	120215929	120216090	0	162	16239	7481	16239	7319	0.0	2.2187457302910234
chr12	PXN	120216272	120216581	479	310	16239	7481	15760	7171	1.5451612903225806	2.1977409008506483
chr12	PXN	120224642	120224727	0	86	16239	7481	16239	7395	0.0	2.195943204868154
chr12	PLA2G1B	120324933	120325061	0	129	0	628	0	499	0.0	0.0
chr12	MSI1	120351343	120351400	0	58	145	3090	145	3032	0.0	0.04782321899736148
chr12	SRSF9	120464732	120464822	0	91	306	3090	306	2999	0.0	0.10203401133711237
chr12	COQ5	120516566	120516788	0	223	38542	2512	38542	2289	0.0	16.837920489296636
chr12	COQ5	120522213	120522363	124	151	38542	2512	38418	2361	0.8211920529801324	16.27191867852605
chr12	COQ5	120526456	120526546	0	91	38542	2512	38542	2421	0.0	15.919867823213549
chr12	COQ5	120523884	120524002	0	119	38542	2512	38542	2393	0.0	16.106142916840785
chr12	POP5	120579773	120579923	2071	151	31286	1561	29215	1410	13.71523178807947	20.71985815602837
chr12	SPPL3	120791468	120791557	0	90	166191	6675	166191	6585	0.0	25.237813211845104
chr12	HNF1A-AS1	120976798	120976921	816	124	17971	4467	17155	4343	6.580645161290323	3.9500345383375546
chr12	C12ORF43	121010827	121010926	0	100	346834	6147	346834	6047	0.0	57.35637506201422
chr12	C12ORF43	121012429	121012686	234	258	346834	6147	346600	5889	0.9069767441860465	58.85549329257938
chr12	OASL	121027575	121027817	0	243	14226	3523	14226	3280	0.0	4.337195121951219
chr12	OASL	121033460	121033743	0	284	14226	3523	14226	3239	0.0	4.392096326026551
chr12	OASL	121023989	121024137	0	149	14226	3523	14226	3374	0.0	4.216360403082395
chr12	CAMKK2	121244572	121244615	0	44	8580	7180	8580	7136	0.0	1.2023542600896862
chr12	CAMKK2	121248605	121248734	7254	130	8580	7180	1326	7050	55.8	0.18808510638297873
chr12	ANAPC5	121331346	121331428	0	83	3586	10333	3586	10250	0.0	0.34985365853658534
chr12	ANAPC5	121347801	121347881	0	81	3586	10333	3586	10252	0.0	0.3497854077253219
chr12	ANAPC5	121330582	121330672	0	91	3586	10333	3586	10242	0.0	0.3501269283343097
chr12	ANAPC5	121331226	121331428	0	203	3586	10333	3586	10130	0.0	0.3539980256663376
chr12	ANAPC5	121351059	121351203	0	145	3586	10333	3586	10188	0.0	0.3519827247742442
chr12	KDM2B	121443679	121443793	380	115	81393	13372	81013	13257	3.3043478260869565	6.110960247416459
chr12	KDM2B	121575780	121575859	0	80	81393	13372	81393	13292	0.0	6.1234577189286785
chr12	KDM2B	121516468	121516520	0	53	81393	13372	81393	13319	0.0	6.111044372700653
chr12	MORN3	121653074	121653259	0	186	1300	3863	1300	3677	0.0	0.3535490889311939
chr12	LINC01089	121801571	121801608	0	38	77	3882	77	3844	0.0	0.020031217481789803
chr12	LINC01089	121802630	121802784	0	155	77	3882	77	3727	0.0	0.020660048296216798
chr12	LINC01089	121802630	121802806	0	177	77	3882	77	3705	0.0	0.02078272604588394
chr12	DIABLO	122218265	122218397	9815	133	88805	5932	78990	5799	73.796992481203	13.621314019658563
chr12	DIABLO	122224511	122224644	612	134	88805	5932	88193	5798	4.567164179104478	15.21093480510521
chr12	AC048338.2	122225964	122226653	0	690	28421	2108	28421	1418	0.0	20.043018335684064
chr12	DIABLO	122220529	122220627	731	99	88805	5932	88074	5833	7.383838383838384	15.099262815018001
chr12	DIABLO	122224644	122224748	0	105	88805	5932	88805	5827	0.0	15.240260854642182
chr12	DIABLO	122209772	122209858	0	87	88805	5932	88805	5845	0.0	15.193327630453378
chr12	DIABLO	122209696	122209858	9	163	88805	5932	88796	5769	0.05521472392638037	15.39192234356041
chr12	VPS33A	122250982	122251099	0	118	23099	5708	23099	5590	0.0	4.132200357781753
chr12	VPS33A	122264711	122264804	0	94	23099	5708	23099	5614	0.0	4.114535090844318
chr12	VPS33A	122241008	122241131	652	124	23099	5708	22447	5584	5.258064516129032	4.019878223495702
chr12	VPS33A	122265635	122265725	5703	91	23099	5708	17396	5617	62.67032967032967	3.0970268826775857
chr12	CLIP1	122336631	122336748	0	118	128133	17314	128133	17196	0.0	7.4513258897418
chr12	CLIP1	122355114	122355312	10955	199	128133	17314	117178	17115	55.050251256281406	6.846508910312592
chr12	CLIP1	122347374	122347479	102	106	128133	17314	128031	17208	0.9622641509433962	7.440202231520223
chr12	CLIP1	122351110	122351143	0	34	128133	17314	128133	17280	0.0	7.415104166666667
chr12	CLIP1	122276438	122276444	0	7	128133	17314	128133	17307	0.0	7.403536141445658
chr12	CLIP1	122322113	122324381	0	2269	128133	17314	128133	15045	0.0	8.51665004985045
chr12	CLIP1	122400131	122400243	0	113	128133	17314	128133	17201	0.0	7.44915993256206
chr12	ZCCHC8	122483459	122483563	0	105	33165	7908	33165	7803	0.0	4.250288350634372
chr12	ZCCHC8	122483278	122483563	0	286	33165	7908	33165	7622	0.0	4.351220152191026
chr12	ZCCHC8	122483278	122483344	0	67	33165	7908	33165	7841	0.0	4.229690090549675
chr12	ZCCHC8	122490934	122491053	0	120	33165	7908	33165	7788	0.0	4.258474576271187
chr12	RSRC2	122506833	122506923	0	91	2176	7431	2176	7340	0.0	0.2964577656675749
chr12	RSRC2	122522142	122522299	0	158	2176	7431	2176	7273	0.0	0.2991887804207342
chr12	RSRC2	122520503	122520581	0	79	2176	7431	2176	7352	0.0	0.2959738846572361
chr12	RSRC2	122514711	122514728	0	18	2176	7431	2176	7413	0.0	0.2935383785242142
chr12	RSRC2	122513766	122513874	0	109	2176	7431	2176	7322	0.0	0.29718656104889374
chr12	RSRC2	122522798	122522906	0	109	2176	7431	2176	7322	0.0	0.29718656104889374
chr12	RSRC2	122526169	122526293	0	125	2176	7431	2176	7306	0.0	0.2978373939228032
chr12	ABCB9	122940806	122940995	0	190	36075	13134	36075	12944	0.0	2.787005562422744
chr12	ABCB9	122944390	122944519	0	130	36075	13134	36075	13004	0.0	2.7741464164872345
chr12	PITPNM2	122991754	122991898	51	145	94599	9192	94548	9047	0.35172413793103446	10.450757157068642
chr12	PITPNM2	122989786	122989948	26342	163	94599	9192	68257	9029	161.6073619631902	7.559751910510577
chr12	MPHOSPH9	123162114	123162218	0	105	13302	8436	13302	8331	0.0	1.5966870723802664
chr12	MPHOSPH9	123203249	123203375	0	127	13302	8436	13302	8309	0.0	1.6009146708388495
chr12	MPHOSPH9	123223037	123223127	0	91	13302	8436	13302	8345	0.0	1.594008388256441
chr12	MPHOSPH9	123227462	123227616	0	155	13302	8436	13302	8281	0.0	1.60632773819587
chr12	MPHOSPH9	123226287	123226351	0	65	13302	8436	13302	8371	0.0	1.5890574602795364
chr12	MPHOSPH9	123162114	123162192	0	79	13302	8436	13302	8357	0.0	1.591719516572933
chr12	MPHOSPH9	123227545	123227616	0	72	13302	8436	13302	8364	0.0	1.5903873744619799
chr12	MPHOSPH9	123227462	123227572	0	111	13302	8436	13302	8325	0.0	1.597837837837838
chr12	RILPL1	123475662	123475750	20	89	35658	5702	35638	5613	0.2247191011235955	6.349189381792268
chr12	EIF2B1	123624786	123624862	0	77	726	3177	726	3100	0.0	0.23419354838709677
chr12	CCDC92	123944271	123944364	898	94	12908	6039	12010	5945	9.553191489361701	2.0201850294365014
chr12	CCDC92	123956283	123956444	7733	162	12908	6039	5175	5877	47.73456790123457	0.8805513016845329
chr12	NCOR2	124327408	124327633	0	226	7711	12472	7711	12246	0.0	0.6296749959170341
chr12	NCOR2	124340601	124340751	0	151	7711	12472	7711	12321	0.0	0.6258420582744907
chr12	NCOR2	124374412	124374463	0	52	7711	12472	7711	12420	0.0	0.62085346215781
chr12	NCOR2	124457105	124457162	6563	58	7711	12472	1148	12414	113.15517241379311	0.09247623650716932
chr12	NCOR2	124327546	124327633	0	88	7711	12472	7711	12384	0.0	0.6226582687338501
chr12	NCOR2	124340601	124340694	0	94	7711	12472	7711	12378	0.0	0.6229600904831152
chr12	SCARB1	124782682	124782811	389	130	22253	4213	21864	4083	2.9923076923076923	5.354886113152094
chr12	LINC00939	125982799	125983009	0	211	255	6810	255	6599	0.0	0.038642218517957266
chr12	AC006065.4	126665444	126665564	0	121	0	1197	0	1076	0.0	0.0
chr12	LINC00944	126732310	126732407	0	98	0	4790	0	4692	0.0	0.0
chr12	LINC00944	126732342	126732407	0	66	0	4790	0	4724	0.0	0.0
chr12	LINC00944	126747930	126748127	0	198	0	4790	0	4592	0.0	0.0
chr12	LINC00944	126763414	126763498	0	85	0	4790	0	4705	0.0	0.0
chr12	LINC00944	126760931	126761057	0	127	0	4790	0	4663	0.0	0.0
chr12	LINC00944	126770192	126770254	0	63	0	4790	0	4727	0.0	0.0
chr12	LINC02405	126923029	126923205	0	177	0	7641	0	7464	0.0	0.0
chr12	LINC02405	126997209	126997301	0	93	0	7641	0	7548	0.0	0.0
chr12	LINC02405	126975838	126975917	0	80	0	7641	0	7561	0.0	0.0
chr12	LINC02376	127276166	127276240	0	75	0	1050	0	975	0.0	0.0
chr12	LINC02411	127635357	127635402	0	46	0	2406	0	2360	0.0	0.0
chr12	LINC02411	127633767	127634768	0	1002	0	2406	0	1404	0.0	0.0
chr12	LINC02411	127633767	127634746	0	980	0	2406	0	1426	0.0	0.0
chr12	LINC02411	127632574	127632784	0	211	0	2406	0	2195	0.0	0.0
chr12	LINC02411	127632373	127632784	0	412	0	2406	0	1994	0.0	0.0
chr12	LINC02369	128112196	128112423	0	228	0	2394	0	2166	0.0	0.0
chr12	SLC15A4	128809942	128810111	0	170	0	5009	0	4839	0.0	0.0
chr12	SLC15A4	128809942	128810053	0	112	0	5009	0	4897	0.0	0.0
chr12	FZD10-AS1	130157043	130157210	0	168	0	11504	0	11336	0.0	0.0
chr12	RIMBP2	130424141	130424858	0	718	0	9642	0	8924	0.0	0.0
chr12	RIMBP2	130470692	130470743	0	52	0	9642	0	9590	0.0	0.0
chr12	RIMBP2	130469148	130469169	0	22	0	9642	0	9620	0.0	0.0
chr12	RIMBP2	130471749	130472338	0	590	0	9642	0	9052	0.0	0.0
chr12	RIMBP2	130469019	130469169	0	151	0	9642	0	9491	0.0	0.0
chr12	RIMBP2	130517827	130517917	0	91	0	9642	0	9551	0.0	0.0
chr12	STX2	130795994	130796120	0	127	51	3735	51	3608	0.0	0.014135254988913526
chr12	STX2	130812309	130812443	0	135	51	3735	51	3600	0.0	0.014166666666666666
chr12	AC073578.1	131474306	131474458	0	153	24	1513	24	1360	0.0	0.01764705882352941
chr12	AC073578.1	131465076	131465182	24	107	24	1513	0	1406	0.22429906542056074	0.0
chr12	GALNT9	132240506	132240728	1088	223	35802	4904	34714	4681	4.878923766816143	7.4159367656483655
chr12	POLE	132680606	132680687	0	82	210011	15952	210011	15870	0.0	13.233207309388783
chr12	POLE	132658691	132658743	0	53	210011	15952	210011	15899	0.0	13.209069752814642
chr12	POLE	132678451	132678569	0	119	210011	15952	210011	15833	0.0	13.264131876460556
chr12	ANKLE2	132729678	132730270	0	593	0	16453	0	15860	0.0	0.0
chr12	ANKLE2	132741808	132741891	0	84	0	16453	0	16369	0.0	0.0
chr12	CHFR	132851617	132851737	0	121	0	16627	0	16506	0.0	0.0
chr12	CHFR	132869618	132869798	0	181	0	16627	0	16446	0.0	0.0
chr12	CHFR	132862332	132862425	0	94	0	16627	0	16533	0.0	0.0
chr12	CHFR	132851617	132851734	0	118	0	16627	0	16509	0.0	0.0
chr12	CHFR	132870723	132870783	0	61	0	16627	0	16566	0.0	0.0
chr12	CHFR	132869618	132869834	0	217	0	16627	0	16410	0.0	0.0
chr12	CHFR	132898999	132899213	0	215	0	16627	0	16412	0.0	0.0
chr12	ZNF605	132948147	132948270	0	124	0	10832	0	10708	0.0	0.0
chr12	ZNF605	132932712	132932805	0	94	0	10832	0	10738	0.0	0.0
chr12	ZNF891	133128327	133128467	357	141	10055	15585	9698	15444	2.5319148936170213	0.6279461279461279
chr13	ANKRD26P3	19331625	19331883	0	259	0	4491	0	4232	0.0	0.0
chr13	TPTE2	19473913	19474075	0	163	1636	2310	1636	2147	0.0	0.7619934792734048
chr13	TPTE2	19467224	19467344	1619	121	1636	2310	17	2189	13.380165289256198	0.0077661032434901784
chr13	TPTE2	19482487	19482547	0	61	1636	2310	1636	2249	0.0	0.727434415295687
chr13	PSPC1	19699379	19699398	0	20	1795	4829	1795	4809	0.0	0.3732584736951549
chr13	ZMYM5	19838699	19838985	0	287	0	3733	0	3446	0.0	0.0
chr13	GJB6	20230697	20230807	0	111	24488	3279	24488	3168	0.0	7.72979797979798
chr13	GJB6	20231381	20231505	0	125	24488	3279	24488	3154	0.0	7.764109067850349
chr13	GJB6	20230865	20231061	384	197	24488	3279	24104	3082	1.9492385786802031	7.82089552238806
chr13	GJB6	20231381	20231492	0	112	24488	3279	24488	3167	0.0	7.732238711714556
chr13	GJB6	20230697	20230813	0	117	24488	3279	24488	3162	0.0	7.744465528146742
chr13	GJB6	20230741	20230813	0	73	24488	3279	24488	3206	0.0	7.638178415470992
chr13	CRYL1	20476870	20476992	0	123	5210	4343	5210	4220	0.0	1.2345971563981042
chr13	CRYL1	20439592	20439754	204	163	5210	4343	5006	4180	1.2515337423312884	1.1976076555023925
chr13	CRYL1	20515720	20515820	0	101	5210	4343	5210	4242	0.0	1.2281942479962282
chr13	CRYL1	20513450	20513681	0	232	5210	4343	5210	4111	0.0	1.267331549501338
chr13	CRYL1	20418397	20419084	1652	688	5210	4343	3558	3655	2.4011627906976742	0.9734610123119015
chr13	CRYL1	20472965	20473074	0	110	5210	4343	5210	4233	0.0	1.230805575242145
chr13	CRYL1	20405903	20406128	51	226	5210	4343	5159	4117	0.22566371681415928	1.2530969152295361
chr13	SKA3	21172619	21172681	0	63	2703	2980	2703	2917	0.0	0.9266369557764826
chr13	SKA3	21155692	21155811	0	120	2703	2980	2703	2860	0.0	0.9451048951048951
chr13	LINC00539	21311685	21311843	0	159	82789	4251	82789	4092	0.0	20.231915933528835
chr13	LINC00539	21312278	21312365	0	88	82789	4251	82789	4163	0.0	19.886860437184723
chr13	LINC00539	21312145	21312360	0	216	82789	4251	82789	4035	0.0	20.517719950433705
chr13	LINC00539	21312638	21312761	0	124	82789	4251	82789	4127	0.0	20.060334383329295
chr13	LINC00539	21312145	21312365	0	221	82789	4251	82789	4030	0.0	20.54317617866005
chr13	LINC00539	21312150	21312365	0	216	82789	4251	82789	4035	0.0	20.517719950433705
chr13	ZDHHC20	21378660	21378738	345	79	46553	5585	46208	5506	4.367088607594937	8.392299309843807
chr13	ZDHHC20	21425651	21425678	0	28	46553	5585	46553	5557	0.0	8.377361885909664
chr13	ZDHHC20	21381900	21381945	0	46	46553	5585	46553	5539	0.0	8.404585665282543
chr13	MICU2	21496051	21496160	0	110	1054	3528	1054	3418	0.0	0.30836746635459333
chr13	MICU2	21515533	21515560	0	28	1054	3528	1054	3500	0.0	0.30114285714285716
chr13	LINC00424	21875365	21875566	640	202	30561	1915	29921	1713	3.1683168316831685	17.46701692936369
chr13	LINC00424	21875365	21875985	17527	621	30561	1915	13034	1294	28.223832528180353	10.072642967542503
chr13	LINC00621	22876297	22876474	0	178	102	6924	102	6746	0.0	0.015120071153276016
chr13	SACS	23341444	23341690	0	247	255	15925	255	15678	0.0	0.016264829697665517
chr13	SACS	23371077	23371165	0	89	255	15925	255	15836	0.0	0.016102551149280123
chr13	CENPJ	24889315	24889400	0	86	720	5689	720	5603	0.0	0.12850258789933963
chr13	CENPJ	24886233	24886385	0	153	720	5689	720	5536	0.0	0.13005780346820808
chr13	CENPJ	24886234	24886385	0	152	720	5689	720	5537	0.0	0.13003431461080006
chr13	TPTE2P1	24967391	24967453	0	63	0	3308	0	3245	0.0	0.0
chr13	LINC00463	25176675	25176849	0	175	0	2935	0	2760	0.0	0.0
chr13	WASF3-AS1	26622625	26622746	2619	122	816204	3667	813585	3545	21.4672131147541	229.50211565585332
chr13	MTIF3	27441016	27441077	0	62	0	1611	0	1549	0.0	0.0
chr13	MTIF3	27449851	27449918	0	68	0	1611	0	1543	0.0	0.0
chr13	FLT3	28025283	28025415	0	133	343539	4185	343539	4052	0.0	84.78257650542942
chr13	MTUS2-AS2	29242528	29242698	535673	171	539533	1062	3860	891	3132.590643274854	4.332210998877666
chr13	MTUS2-AS1	29482113	29482377	0	265	0	2573	0	2308	0.0	0.0
chr13	LINC00426	30364068	30364205	0	138	237191	4490	237191	4352	0.0	54.501608455882355
chr13	LINC00426	30367600	30367717	0	118	237191	4490	237191	4372	0.0	54.252287282708146
chr13	HMGB1	30461638	30461688	0	51	0	7702	0	7651	0.0	0.0
chr13	TEX26-AS1	30899913	30899986	0	74	1281	6332	1281	6258	0.0	0.20469798657718122
chr13	TEX26-AS1	30883937	30884060	44	124	1281	6332	1237	6208	0.3548387096774194	0.19925902061855671
chr13	TEX26-AS1	30932108	30932474	0	367	1281	6332	1281	5965	0.0	0.21475272422464375
chr13	HSPH1	31143791	31143923	0	133	2499	6340	2499	6207	0.0	0.402609956500725
chr13	N4BP2L1	32403655	32403761	0	107	0	5266	0	5159	0.0	0.0
chr13	N4BP2L1	32411527	32411592	0	66	0	5266	0	5200	0.0	0.0
chr13	N4BP2L1	32416550	32416703	0	154	0	5266	0	5112	0.0	0.0
chr13	N4BP2L1	32415958	32416029	0	72	0	5266	0	5194	0.0	0.0
chr13	N4BP2L1	32420370	32420576	0	207	0	5266	0	5059	0.0	0.0
chr13	N4BP2L2	32521372	32521449	0	78	102	10496	102	10418	0.0	0.009790746784411596
chr13	N4BP2L2	32527407	32527532	0	126	102	10496	102	10370	0.0	0.009836065573770493
chr13	N4BP2L2	32535768	32537027	0	1260	102	10496	102	9236	0.0	0.01104374187960156
chr13	N4BP2L2	32538617	32538684	0	68	102	10496	102	10428	0.0	0.009781357882623706
chr13	N4BP2L2	32536932	32537027	0	96	102	10496	102	10400	0.0	0.009807692307692307
chr13	N4BP2L2	32522181	32522270	0	90	102	10496	102	10406	0.0	0.009802037286181049
chr13	N4BP2L2	32527457	32527532	0	76	102	10496	102	10420	0.0	0.009788867562380038
chr13	AL139383.1	33663885	33664137	0	253	681	6334	681	6081	0.0	0.11198815984213123
chr13	DCLK1	35788211	35788285	0	75	2435	14471	2435	14396	0.0	0.16914420672409003
chr13	CCDC169	36283468	36283509	0	42	1185	8851	1185	8809	0.0	0.13452151208990804
chr13	CCDC169	36283468	36283505	0	38	1185	8851	1185	8813	0.0	0.13446045614433225
chr13	CCDC169	36295777	36295857	0	81	1185	8851	1185	8770	0.0	0.13511972633979474
chr13	CCDC169	36240569	36240666	216	98	1185	8851	969	8753	2.204081632653061	0.11070490117673941
chr13	SPART	36368873	36368990	0	118	3128	5898	3128	5780	0.0	0.5411764705882353
chr13	SMAD9	36867272	36867383	0	112	9997	5843	9997	5731	0.0	1.7443727098237656
chr13	SMAD9	36874209	36874354	78	146	9997	5843	9919	5697	0.5342465753424658	1.7410918027031772
chr13	ALG5	36994988	36995035	0	48	0	2243	0	2195	0.0	0.0
chr13	SUPT20H	37010551	37010655	0	105	23892	10212	23892	10107	0.0	2.363906203621253
chr13	SUPT20H	37025319	37025437	0	119	23892	10212	23892	10093	0.0	2.3671851778460318
chr13	SUPT20H	37029764	37029836	0	73	23892	10212	23892	10139	0.0	2.3564454088174376
chr13	SUPT20H	37045246	37045373	0	128	23892	10212	23892	10084	0.0	2.369297897659659
chr13	SUPT20H	37048563	37048599	0	37	23892	10212	23892	10175	0.0	2.348108108108108
chr13	SUPT20H	37045246	37045376	0	131	23892	10212	23892	10081	0.0	2.3700029758952486
chr13	POSTN	37571368	37571458	0	91	54485	4931	54485	4840	0.0	11.257231404958677
chr13	POSTN	37574571	37574652	774	82	54485	4931	53711	4849	9.439024390243903	11.076716848834812
chr13	POSTN	37569299	37569383	0	85	54485	4931	54485	4846	0.0	11.243293437886917
chr13	POSTN	37570579	37570669	0	91	54485	4931	54485	4840	0.0	11.257231404958677
chr13	TRPC4	37651264	37651459	0	196	364	3351	364	3155	0.0	0.11537242472266244
chr13	TRPC4	37663415	37663729	0	315	364	3351	364	3036	0.0	0.11989459815546773
chr13	TRPC4	37691998	37692335	0	338	364	3351	364	3013	0.0	0.1208098240955858
chr13	TRPC4	37745936	37746455	0	520	364	3351	364	2831	0.0	0.12857647474390674
chr13	TRPC4	37651249	37651459	0	211	364	3351	364	3140	0.0	0.1159235668789809
chr13	LINC00571	38062148	38062234	0	87	0	1581	0	1494	0.0	0.0
chr13	LINC00571	38059518	38059708	0	191	0	1581	0	1390	0.0	0.0
chr13	STOML3	38980051	38980135	0	85	0	2006	0	1921	0.0	0.0
chr13	PROSER1	39034130	39034196	0	67	0	6068	0	6001	0.0	0.0
chr13	LINC00598	40377050	40377228	0	179	8794	19717	8794	19538	0.0	0.45009724639164705
chr13	LINC00598	40466506	40466677	0	172	8794	19717	8794	19545	0.0	0.4499360450243029
chr13	LINC00598	40473993	40474095	0	103	8794	19717	8794	19614	0.0	0.4483532170898338
chr13	LINC00598	40343956	40344205	0	250	8794	19717	8794	19467	0.0	0.45173884008835463
chr13	LINC00598	40451063	40451203	0	141	8794	19717	8794	19576	0.0	0.4492235390273805
chr13	LINC00598	40457513	40458668	0	1156	8794	19717	8794	18561	0.0	0.4737891277409622
chr13	LINC00598	40469995	40470162	0	168	8794	19717	8794	19549	0.0	0.4498439817893498
chr13	LINC00598	40480235	40480468	0	234	8794	19717	8794	19483	0.0	0.451367859159267
chr13	TPTE2P5	40908158	40908212	0	55	0	2529	0	2474	0.0	0.0
chr13	SUGT1P3	40921473	40921531	0	59	0	1143	0	1084	0.0	0.0
chr13	ELF1	40951583	40951701	0	119	306	4453	306	4334	0.0	0.07060452238117212
chr13	MTRF1	41257672	41257796	0	125	88	3854	88	3729	0.0	0.02359882005899705
chr13	MTRF1	41262047	41262331	51	285	88	3854	37	3569	0.17894736842105263	0.010367049593723731
chr13	MTRF1	41262410	41262481	37	72	88	3854	51	3782	0.5138888888888888	0.013484928609201481
chr13	MTRF1	41257672	41257797	0	126	88	3854	88	3728	0.0	0.023605150214592276
chr13	EPSTI1	42889210	42889242	0	33	11511	4643	11511	4610	0.0	2.4969631236442518
chr13	EPSTI1	42919299	42919332	0	34	11511	4643	11511	4609	0.0	2.4975048817530916
chr13	EPSTI1	42970611	42970670	0	60	11511	4643	11511	4583	0.0	2.5116735762600917
chr13	EPSTI1	42991098	42991182	0	85	11511	4643	11511	4558	0.0	2.5254497586660816
chr13	LINC00390	44119650	44119765	0	116	255	5805	255	5689	0.0	0.044823343294076286
chr13	LINC00390	44119650	44119762	0	113	255	5805	255	5692	0.0	0.04479971890372453
chr13	TPT1	45339496	45339602	0	107	102	6154	102	6047	0.0	0.016867868364478254
chr13	TPT1	45340711	45340785	0	75	102	6154	102	6079	0.0	0.016779075505839777
chr13	TPT1	45337466	45337553	0	88	102	6154	102	6066	0.0	0.016815034619188922
chr13	TPT1	45340711	45340820	0	110	102	6154	102	6044	0.0	0.016876240900066182
chr13	SLC25A30	45408926	45409074	0	149	0	5015	0	4866	0.0	0.0
chr13	SLC25A30	45411361	45411480	0	120	0	5015	0	4895	0.0	0.0
chr13	SLC25A30	45411732	45411938	0	207	0	5015	0	4808	0.0	0.0
chr13	ERICH6B	45607563	45607615	3763	53	20988	2960	17225	2907	71.0	5.925352597179223
chr13	CPB2	46067306	46067417	375	112	4593	6711	4218	6599	3.3482142857142856	0.6391877557205637
chr13	CPB2	46064647	46064741	0	95	4593	6711	4593	6616	0.0	0.6942261185006046
chr13	LCP1	46194023	46194105	0	83	9894	5101	9894	5018	0.0	1.9717018732562774
chr13	RUBCNL	46345446	46345600	0	155	252	15943	252	15788	0.0	0.015961489739042312
chr13	RUBCNL	46371940	46372597	0	658	252	15943	252	15285	0.0	0.01648675171736997
chr13	RUBCNL	46377889	46378005	0	117	252	15943	252	15826	0.0	0.01592316441299128
chr13	RUBCNL	46363735	46363853	0	119	252	15943	252	15824	0.0	0.015925176946410515
chr13	RUBCNL	46371499	46371648	0	150	252	15943	252	15793	0.0	0.01595643639587159
chr13	RUBCNL	46354762	46354863	252	102	252	15943	0	15841	2.4705882352941178	0.0
chr13	RUBCNL	46376491	46376584	0	94	252	15943	252	15849	0.0	0.01590005678591709
chr13	RUBCNL	46368488	46368615	0	128	252	15943	252	15815	0.0	0.015934239645905787
chr13	RUBCNL	46371940	46372078	0	139	252	15943	252	15804	0.0	0.015945330296127564
chr13	RUBCNL	46371940	46372210	0	271	252	15943	252	15672	0.0	0.016079632465543645
chr13	LINC01198	46460944	46461170	0	227	51	5378	51	5151	0.0	0.009900990099009901
chr13	LINC01198	46465842	46465987	0	146	51	5378	51	5232	0.0	0.00974770642201835
chr13	LINC01198	46460944	46461085	0	142	51	5378	51	5236	0.0	0.00974025974025974
chr13	LINC01198	46465903	46465987	0	85	51	5378	51	5293	0.0	0.009635367466465143
chr13	LINC01198	46465908	46465987	0	80	51	5378	51	5298	0.0	0.009626274065685165
chr13	LINC01198	46463933	46464019	0	87	51	5378	51	5291	0.0	0.009639009639009639
chr13	LINC01198	46460989	46461170	0	182	51	5378	51	5196	0.0	0.009815242494226328
chr13	LINC01198	46466608	46466709	0	102	51	5378	51	5276	0.0	0.009666413949962092
chr13	ESD	46790596	46790661	0	66	1998	3540	1998	3474	0.0	0.5751295336787565
chr13	HTR2A	46895494	46896234	0	741	52	5632	52	4891	0.0	0.01063177264363116
chr13	SUCLA2	47996842	47997023	0	182	103	8002	103	7820	0.0	0.013171355498721228
chr13	SUCLA2	47965577	47965640	0	64	103	8002	103	7938	0.0	0.012975560594608214
chr13	SUCLA2	47991502	47991678	0	177	103	8002	103	7825	0.0	0.013162939297124601
chr13	SUCLA2	47956839	47956878	0	40	103	8002	103	7962	0.0	0.012936448128610901
chr13	SUCLA2	47994799	47994896	0	98	103	8002	103	7904	0.0	0.013031376518218623
chr13	SUCLA2	48015170	48015248	0	79	103	8002	103	7923	0.0	0.01300012621481762
chr13	MED4	48093547	48093687	0	141	0	2599	0	2458	0.0	0.0
chr13	RB1-DT	48297602	48297940	0	339	0	1836	0	1497	0.0	0.0
chr13	LPAR6	48401297	48401407	0	111	4	3454	4	3343	0.0	0.0011965300628178283
chr13	LPAR6	48408623	48408767	0	145	4	3454	4	3309	0.0	0.0012088244182532487
chr13	LPAR6	48404180	48404263	0	84	4	3454	4	3370	0.0	0.0011869436201780415
chr13	LPAR6	48416312	48416564	0	253	4	3454	4	3201	0.0	0.0012496094970321774
chr13	RCBTB2	48510628	48510771	3110	144	5726	3559	2616	3415	21.59722222222222	0.7660322108345534
chr13	RCBTB2	48521897	48521962	429	66	5726	3559	5297	3493	6.5	1.5164614944174062
chr13	CAB39L	49344178	49344238	0	61	0	4839	0	4778	0.0	0.0
chr13	CAB39L	49401132	49401270	0	139	0	4839	0	4700	0.0	0.0
chr13	EBPL	49663056	49663195	15	140	199	1567	184	1427	0.10714285714285714	0.1289418360196216
chr13	EBPL	49669776	49669846	0	71	199	1567	199	1496	0.0	0.13302139037433156
chr13	EBPL	49661865	49661927	0	63	199	1567	199	1504	0.0	0.13231382978723405
chr13	SPRYD7	49931017	49931134	0	118	2409	3342	2409	3224	0.0	0.7472084367245657
chr13	DLEU2	50045117	50045232	0	116	20270	11660	20270	11544	0.0	1.7558905058905059
chr13	DLEU2	50070581	50070641	0	61	20270	11660	20270	11599	0.0	1.7475644452107941
chr13	DLEU2	50071515	50071629	18	115	20270	11660	20252	11545	0.1565217391304348	1.7541792983975748
chr13	DLEU2	50075558	50075653	0	96	20270	11660	20270	11564	0.0	1.75285368384642
chr13	RNASEH2B-AS1	50886057	50886127	0	71	1326	7830	1326	7759	0.0	0.17089831163809768
chr13	RNASEH2B-AS1	50889608	50889735	0	128	1326	7830	1326	7702	0.0	0.1721630745260971
chr13	RNASEH2B-AS1	50904720	50904863	0	144	1326	7830	1326	7686	0.0	0.1725214676034348
chr13	RNASEH2B-AS1	50891303	50891504	0	202	1326	7830	1326	7628	0.0	0.17383324593602517
chr13	GUCY1B2	51028207	51028404	0	198	15	4035	15	3837	0.0	0.003909304143862392
chr13	GUCY1B2	51034002	51034159	0	158	15	4035	15	3877	0.0	0.003868970853752902
chr13	INTS6	51423029	51423090	0	62	255	25534	255	25472	0.0	0.010010992462311559
chr13	DHRS12	51797825	51797908	0	84	0	3227	0	3143	0.0	0.0
chr13	TMEM272	51822054	51822137	0	84	186	4158	186	4074	0.0	0.045655375552282766
chr13	TMEM272	51826565	51826625	186	61	186	4158	0	4097	3.0491803278688523	0.0
chr13	ATP7B	51944108	51944291	0	184	102820	13652	102820	13468	0.0	7.6343926343926345
chr13	ATP7B	51946283	51946478	0	196	102820	13652	102820	13456	0.0	7.641200951248513
chr13	ATP7B	51949661	51949796	146	136	102820	13652	102674	13516	1.0735294117647058	7.596478248002367
chr13	ATP7B	51958310	51958544	0	235	102820	13652	102820	13417	0.0	7.6634120891406425
chr13	ATP7B	51960147	51960322	409	176	102820	13652	102411	13476	2.3238636363636362	7.599510240427427
chr13	ATP7B	51949715	51949796	95	82	102820	13652	102725	13570	1.1585365853658536	7.570007369196758
chr13	ATP7B	51961836	51961913	0	78	102820	13652	102820	13574	0.0	7.574775305731546
chr13	ATP7B	51958310	51958400	0	91	102820	13652	102820	13561	0.0	7.582036722955534
chr13	ATP7B	51947850	51947870	0	21	102820	13652	102820	13631	0.0	7.543100286112538
chr13	ATP7B	51972594	51972832	0	239	102820	13652	102820	13413	0.0	7.6656974576903005
chr13	NEK5	52099742	52099876	0	135	207928	7079	207928	6944	0.0	29.943548387096776
chr13	NEK5	52082237	52082312	0	76	207928	7079	207928	7003	0.0	29.691275167785236
chr13	NEK5	52093053	52093235	0	183	207928	7079	207928	6896	0.0	30.151972157772622
chr13	NEK5	52108317	52108404	0	88	207928	7079	207928	6991	0.0	29.74224002288657
chr13	NEK5	52112267	52112365	0	99	207928	7079	207928	6980	0.0	29.789111747851003
chr13	NEK5	52127594	52127662	0	69	207928	7079	207928	7010	0.0	29.661626248216834
chr13	NEK5	52127365	52127504	0	140	207928	7079	207928	6939	0.0	29.96512465773166
chr13	NEK3	52135728	52135863	0	136	103	4289	103	4153	0.0	0.02480134842282687
chr13	NEK3	52141019	52141069	0	51	103	4289	103	4238	0.0	0.024303916941953753
chr13	NEK3	52154079	52154173	0	95	103	4289	103	4194	0.0	0.024558893657606103
chr13	MRPS31P5	52183975	52184114	0	140	1956	3514	1956	3374	0.0	0.5797273266152935
chr13	TPTE2P2	52258528	52258590	0	63	60337	4148	60337	4085	0.0	14.770379436964504
chr13	MRPS31P5	52184272	52184408	204	137	1956	3514	1752	3377	1.489051094890511	0.5188036718981345
chr13	TPTE2P2	52221735	52221806	0	72	60337	4148	60337	4076	0.0	14.802993130520118
chr13	THSD1	52386027	52386186	0	160	7641	3711	7641	3551	0.0	2.151788228667981
chr13	VPS36	52417436	52417679	0	244	0	6014	0	5770	0.0	0.0
chr13	LINC01065	53110860	53110940	0	81	0	3128	0	3047	0.0	0.0
chr13	LINC01065	53149356	53149504	0	149	0	3128	0	2979	0.0	0.0
chr13	LINC01065	53137209	53137345	0	137	0	3128	0	2991	0.0	0.0
chr13	LINC00458	54130873	54131071	0	199	0	2502	0	2303	0.0	0.0
chr13	DIAPH3	60093627	60093732	0	106	0	7262	0	7156	0.0	0.0
chr13	DIAPH3	60132956	60132989	0	34	0	7262	0	7228	0.0	0.0
chr13	DIAPH3	60112009	60112186	0	178	0	7262	0	7084	0.0	0.0
chr13	LINC00448	62742222	62742405	0	184	0	1274	0	1090	0.0	0.0
chr13	LINC00448	62740300	62740460	0	161	0	1274	0	1113	0.0	0.0
chr13	LINC00448	62733046	62733146	0	101	0	1274	0	1173	0.0	0.0
chr13	LINC00448	62742222	62742400	0	179	0	1274	0	1095	0.0	0.0
chr13	PCDH9	66903503	66903605	0	103	0	30951	0	30848	0.0	0.0
chr13	PCDH9	66782713	66782797	0	85	0	30951	0	30866	0.0	0.0
chr13	KLHL1	69975619	69975802	0	184	0	4160	0	3976	0.0	0.0
chr13	DACH1	71630555	71630717	0	163	0	5413	0	5250	0.0	0.0
chr13	DACH1	71573417	71573573	0	157	0	5413	0	5256	0.0	0.0
chr13	DIS3	72770903	72770988	0	86	0	3982	0	3896	0.0	0.0
chr13	DIS3	72780845	72781003	0	159	0	3982	0	3823	0.0	0.0
chr13	DIS3	72781288	72781356	0	69	0	3982	0	3913	0.0	0.0
chr13	LINC00393	73546799	73546841	0	43	2329	5042	2329	4999	0.0	0.46589317863572716
chr13	LINC00393	73564162	73564288	0	127	2329	5042	2329	4915	0.0	0.47385554425228893
chr13	TBC1D4	75320013	75320037	0	25	357	8057	357	8032	0.0	0.04444721115537849
chr13	TBC1D4	75324236	75324401	0	166	357	8057	357	7891	0.0	0.04524141426942086
chr13	COMMD6	75527812	75527851	0	40	0	2499	0	2459	0.0	0.0
chr13	LMO7-AS1	75622259	75622303	0	45	0	2136	0	2091	0.0	0.0
chr13	SCEL-AS1	77604270	77604390	0	121	867	574	867	453	0.0	1.913907284768212
chr13	EDNRB	77900520	77900654	1021	135	1123	4631	102	4496	7.562962962962963	0.022686832740213523
chr13	LINC01069	77990337	77990646	0	310	51	3687	51	3377	0.0	0.015102161681966242
chr13	LINC01069	77987913	77988078	0	166	51	3687	51	3521	0.0	0.014484521442771939
chr13	LINC00331	78787305	78787479	0	175	0	1833	0	1658	0.0	0.0
chr13	LINC00331	78824743	78824856	0	114	0	1833	0	1719	0.0	0.0
chr13	LINC00331	78792353	78792492	0	140	0	1833	0	1693	0.0	0.0
chr13	LINC00331	78790898	78790986	0	89	0	1833	0	1744	0.0	0.0
chr13	LINC00331	78794618	78794650	0	33	0	1833	0	1800	0.0	0.0
chr13	LINC00331	78792160	78792302	0	143	0	1833	0	1690	0.0	0.0
chr13	LINC00331	78795974	78796099	0	126	0	1833	0	1707	0.0	0.0
chr13	RBM26	79353152	79353224	0	73	0	10145	0	10072	0.0	0.0
chr13	AL158064.1	80054731	80054819	0	89	52322	10299	52322	10210	0.0	5.12458374142997
chr13	AL158064.1	80054669	80054819	0	151	52322	10299	52322	10148	0.0	5.155892786756011
chr13	AL158064.1	80070301	80070437	0	137	52322	10299	52322	10162	0.0	5.148789608344814
chr13	AL590807.1	81012052	81012189	0	138	115	10995	115	10857	0.0	0.010592244634797826
chr13	MIR4500HG	87445010	87445130	0	121	0	16086	0	15965	0.0	0.0
chr13	MIR4500HG	87615562	87615755	0	194	0	16086	0	15892	0.0	0.0
chr13	MIR4500HG	87560170	87560417	0	248	0	16086	0	15838	0.0	0.0
chr13	MIR4500HG	87619262	87619393	0	132	0	16086	0	15954	0.0	0.0
chr13	MIR4500HG	87621007	87621158	0	152	0	16086	0	15934	0.0	0.0
chr13	MIR4500HG	87600955	87601060	0	106	0	16086	0	15980	0.0	0.0
chr13	LINC01047	89219570	89219709	0	140	0	952	0	812	0.0	0.0
chr13	LINC01047	89215973	89216141	0	169	0	952	0	783	0.0	0.0
chr13	LINC00559	90068750	90068950	0	201	0	2089	0	1888	0.0	0.0
chr13	LINC00559	90107853	90108661	0	809	0	2089	0	1280	0.0	0.0
chr13	LINC00559	90106582	90108661	0	2080	0	2089	0	9	0.0	0.0
chr13	LINC00379	91130678	91130792	0	115	0	548	0	433	0.0	0.0
chr13	DCT	94452606	94452662	0	57	204	5822	204	5765	0.0	0.03538594969644406
chr13	ABCC4	95164377	95164518	0	142	33188	8667	33188	8525	0.0	3.8930205278592376
chr13	ABCC4	95234609	95234834	704	226	33188	8667	32484	8441	3.1150442477876106	3.8483591991470205
chr13	ABCC4	95266098	95266264	325	167	33188	8667	32863	8500	1.9461077844311376	3.866235294117647
chr13	ABCC4	95055569	95055855	24110	287	33188	8667	9078	8380	84.00696864111498	1.083293556085919
chr13	ABCC4	95161764	95161792	0	29	33188	8667	33188	8638	0.0	3.8420930771011808
chr13	ABCC4	95266111	95266264	301	154	33188	8667	32887	8513	1.9545454545454546	3.8631504757429815
chr13	ABCC4	95269309	95269422	590	114	33188	8667	32598	8553	5.175438596491228	3.811294282707822
chr13	DZIP1	95609456	95609513	0	58	0	8497	0	8439	0.0	0.0
chr13	DZIP1	95630713	95630813	0	101	0	8497	0	8396	0.0	0.0
chr13	UGGT2	95989972	95990073	0	102	1406	7773	1406	7671	0.0	0.18328770694824664
chr13	STK24	98460371	98460440	0	70	0	11532	0	11462	0.0	0.0
chr13	STK24	98482264	98482321	0	58	0	11532	0	11474	0.0	0.0
chr13	DOCK9	98808639	98808675	0	37	4962	10506	4962	10469	0.0	0.47397077084726336
chr13	DOCK9	98796205	98796213	0	9	4962	10506	4962	10497	0.0	0.47270648756787653
chr13	DOCK9	98809122	98809128	0	7	4962	10506	4962	10499	0.0	0.4726164396609201
chr13	DOCK9	98825871	98825940	0	70	4962	10506	4962	10436	0.0	0.4754695285550019
chr13	DOCK9	98846519	98846556	0	38	4962	10506	4962	10468	0.0	0.47401604891096677
chr13	DOCK9	98854533	98854740	0	208	4962	10506	4962	10298	0.0	0.4818411342008157
chr13	DOCK9	98959402	98959534	0	133	4962	10506	4962	10373	0.0	0.478357273691314
chr13	UBAC2-AS1	99182584	99182702	0	119	294	2596	294	2477	0.0	0.11869196608800969
chr13	GPR18	99256327	99256519	0	193	0	2023	0	1830	0.0	0.0
chr13	LINC01232	99497248	99497336	352	89	2238	6199	1886	6110	3.955056179775281	0.30867430441898525
chr13	AL137139.2	99844237	99845970	51	1734	16430	8877	16379	7143	0.029411764705882353	2.2930141397172057
chr13	GGACT	100533562	100533774	0	213	1330	3482	1330	3269	0.0	0.4068522483940043
chr13	GGACT	100533286	100533368	0	83	1330	3482	1330	3399	0.0	0.39129155634010004
chr13	TMTC4	100670359	100670569	102	211	712800	6368	712698	6157	0.4834123222748815	115.7541010232256
chr13	TMTC4	100665968	100666107	0	140	712800	6368	712800	6228	0.0	114.45086705202313
chr13	TMTC4	100670282	100670569	102	288	712800	6368	712698	6080	0.3541666666666667	117.22006578947368
chr13	NALCN	101283932	101284019	0	88	129727	19504	129727	19416	0.0	6.681448290070045
chr13	NALCN	101378569	101378653	0	85	129727	19504	129727	19419	0.0	6.680416087337144
chr13	NALCN	101067509	101067698	0	190	129727	19504	129727	19314	0.0	6.716733975354665
chr13	NALCN	101116919	101117006	0	88	129727	19504	129727	19416	0.0	6.681448290070045
chr13	NALCN	101347487	101347599	0	113	129727	19504	129727	19391	0.0	6.690062400082512
chr13	FGF14-IT1	102354109	102354222	0	114	0	2385	0	2271	0.0	0.0
chr13	TEX30	102767272	102767478	0	207	0	1794	0	1587	0.0	0.0
chr13	TEX30	102770011	102770086	0	76	0	1794	0	1718	0.0	0.0
chr13	POGLUT2	102789011	102789221	0	211	0	2227	0	2016	0.0	0.0
chr13	AL390755.1	110045432	110045629	0	198	0	4212	0	4014	0.0	0.0
chr13	AL390755.1	110045196	110045629	0	434	0	4212	0	3778	0.0	0.0
chr13	CARS2	110644064	110644182	47	119	51	8121	4	8002	0.3949579831932773	0.0004998750312421895
chr13	CARS2	110651033	110651100	0	68	51	8121	51	8053	0.0	0.006333043586241152
chr13	CARS2	110697917	110697967	0	51	51	8121	51	8070	0.0	0.006319702602230483
chr13	CARS2	110688784	110688904	0	121	51	8121	51	8000	0.0	0.006375
chr13	CARS2	110705520	110705571	0	52	51	8121	51	8069	0.0	0.006320485809889701
chr13	CARS2	110707337	110707643	0	307	51	8121	51	7814	0.0	0.006526746864601997
chr13	ANKRD10	110894108	110894202	96	95	504	4241	408	4146	1.0105263157894737	0.09840810419681621
chr13	ANKRD10	110900529	110900661	0	133	504	4241	504	4108	0.0	0.12268743914313535
chr13	TUBGCP3	112521662	112521864	0	203	0	7274	0	7071	0.0	0.0
chr13	PCID2	113185484	113185560	384	77	10874	4056	10490	3979	4.987012987012987	2.636340789143001
chr13	PCID2	113190871	113190975	153	105	10874	4056	10721	3951	1.457142857142857	2.7134902556314855
chr13	DCUN1D2	113462739	113462891	53	153	20872	4355	20819	4202	0.3464052287581699	4.954545454545454
chr13	DCUN1D2	113483839	113484056	612	218	20872	4355	20260	4137	2.8073394495412844	4.897268552090887
chr13	DCUN1D2	113480574	113480743	0	170	20872	4355	20872	4185	0.0	4.987335722819593
chr13	LINC00454	113880698	113880895	7408	198	78300	2845	70892	2647	37.41414141414141	26.78201737816396
chr13	FO681491.1	18417178	18417341	0	164	0	3454	0	3290	0.0	0.0
chr13	LINC00408	18907634	18907802	0	169	0	2363	0	2194	0.0	0.0
chr13	LINC00408	18907634	18907817	0	184	0	2363	0	2179	0.0	0.0
chr13	LINC00408	18906026	18906110	0	85	0	2363	0	2278	0.0	0.0
chr13	LINC00408	18908969	18909086	0	118	0	2363	0	2245	0.0	0.0
chr13	MPHOSPH8	19670839	19670964	0	126	0	4924	0	4798	0.0	0.0
chr13	ZMYM2	19970024	19970071	0	48	70	12671	70	12623	0.0	0.005545432939871663
chr13	ZMYM2	19965219	19965281	0	63	70	12671	70	12608	0.0	0.005552030456852792
chr13	IFT88	20567669	20567997	21918	329	61635	6077	39717	5748	66.62006079027356	6.909707724425887
chr13	IL17D	20717097	20717369	1059	273	1059	3332	0	3059	3.879120879120879	0.0
chr13	SAP18	21146804	21146927	204	124	10688	3381	10484	3257	1.6451612903225807	3.2189131102241326
chr13	LINC00540	22263212	22263311	0	100	51	3107	51	3007	0.0	0.016960425673428665
chr13	LINC00327	23482348	23482499	0	152	0	5213	0	5061	0.0	0.0
chr13	SPATA13	24286764	24286950	0	187	76858	9963	76858	9776	0.0	7.861906710310966
chr13	SPATA13	24249476	24249842	8885	367	76858	9963	67973	9596	24.20980926430518	7.083472280116715
chr13	SPATA13	24222818	24224582	102	1765	76858	9963	76756	8198	0.057790368271954676	9.362771407660405
chr13	SPATA13	24278613	24278821	0	209	76858	9963	76858	9754	0.0	7.8796391224113185
chr13	TPTE2P6	24589255	24589347	0	93	748	1827	748	1734	0.0	0.43137254901960786
chr13	TPTE2P6	24595788	24595859	0	72	748	1827	748	1755	0.0	0.42621082621082623
chr13	TPTE2P6	24586461	24586794	0	334	748	1827	748	1493	0.0	0.5010046885465506
chr13	TPTE2P6	24597101	24597277	0	177	748	1827	748	1650	0.0	0.4533333333333333
chr13	RNF17	24864872	24864998	2810	127	18318	5656	15508	5529	22.125984251968504	2.804847169470067
chr13	NUP58	25302926	25303008	22	83	22	5763	0	5680	0.26506024096385544	0.0
chr13	NUP58	25309959	25310015	0	57	22	5763	22	5706	0.0	0.00385559060637925
chr13	NUP58	25303101	25303155	0	55	22	5763	22	5708	0.0	0.003854239663629993
chr13	NUP58	25309246	25309282	0	37	22	5763	22	5726	0.0	0.0038421236465246244
chr13	NUP58	25320529	25320595	0	67	22	5763	22	5696	0.0	0.0038623595505617976
chr13	ATP8A2	25705162	25705353	0	192	692	10555	692	10363	0.0	0.06677603010711183
chr13	CDK8	26393366	26393510	0	145	0	3551	0	3406	0.0	0.0
chr13	CDK8	26401465	26401624	0	160	0	3551	0	3391	0.0	0.0
chr13	CDK8	26382813	26382871	0	59	0	3551	0	3492	0.0	0.0
chr13	CDK8	26401468	26401624	0	157	0	3551	0	3394	0.0	0.0
chr13	RPL21	27254219	27254281	1480	63	14629	1957	13149	1894	23.49206349206349	6.942449841605069
chr13	GTF3A	27432730	27432804	0	75	167	2790	167	2715	0.0	0.06151012891344383
chr13	POLR1D	27621336	27621437	0	102	19668	9742	19668	9640	0.0	2.0402489626556015
chr13	POLR1D	27650041	27650241	102	201	19668	9742	19566	9541	0.5074626865671642	2.05072843517451
chr13	POLR1D	27646193	27646218	521	26	19668	9742	19147	9716	20.03846153846154	1.9706669411280362
chr13	PAN3	28197184	28197346	161983	163	307706	6372	145723	6209	993.760736196319	23.469640843936222
chr13	POMP	28659821	28659919	0	99	115	1469	115	1370	0.0	0.08394160583941605
chr13	MTUS2	29439982	29440049	0	68	314	8464	314	8396	0.0	0.03739876131491186
chr13	LINC00544	29937201	29937281	0	81	51	1970	51	1889	0.0	0.026998411858125994
chr13	USPL1	30621072	30621239	0	168	0	5134	0	4966	0.0	0.0
chr13	USPL1	30630834	30631474	0	641	0	5134	0	4493	0.0	0.0
chr13	MEDAG	30921560	30921846	0	287	0	2299	0	2012	0.0	0.0
chr13	TEX26	30952659	30952825	0	167	0	1713	0	1546	0.0	0.0
chr13	RXFP2	31782675	31782747	0	73	19995	3354	19995	3281	0.0	6.094178604084121
chr13	FRY	32257963	32257972	0	10	459	17261	459	17251	0.0	0.026607153208509652
chr13	BRCA2	32374961	32375210	0	250	2373	12439	2373	12189	0.0	0.194683731233079
chr13	BRCA2	32375342	32375406	0	65	2373	12439	2373	12374	0.0	0.19177307257152093
chr13	BRCA2	32395990	32396116	0	127	2373	12439	2373	12312	0.0	0.19273879142300196
chr13	BRCA2	32383892	32384031	0	140	2373	12439	2373	12299	0.0	0.192942515651679
chr13	STARD13-AS	33279532	33279656	0	125	11189	3839	11189	3714	0.0	3.012654819601508
chr13	STARD13-AS	33273935	33274058	3431	124	11189	3839	7758	3715	27.669354838709676	2.0882907133243607
chr13	STARD13-AS	33279460	33279656	26	197	11189	3839	11163	3642	0.1319796954314721	3.0650741350906094
chr13	STARD13-AS	33272605	33272894	102	290	11189	3839	11087	3549	0.35172413793103446	3.123978585517047
chr13	STARD13-AS	33275686	33275850	767	165	11189	3839	10422	3674	4.648484848484848	2.8366902558519325
chr13	STARD13-AS	33276670	33276747	306	78	11189	3839	10883	3761	3.923076923076923	2.8936453070991757
chr13	STARD13-AS	33276076	33276189	0	114	11189	3839	11189	3725	0.0	3.003758389261745
chr13	STARD13-AS	33279460	33279570	26	111	11189	3839	11163	3728	0.23423423423423423	2.9943669527896994
chr13	STARD13-AS	33279896	33280076	0	181	11189	3839	11189	3658	0.0	3.0587752870420997
chr13	STARD13-AS	33273935	33273976	1842	42	11189	3839	9347	3797	43.857142857142854	2.4616802739004475
chr13	STARD13-AS	33279532	33279570	0	39	11189	3839	11189	3800	0.0	2.9444736842105264
chr13	STARD13-AS	33275781	33275850	124	70	11189	3839	11065	3769	1.7714285714285714	2.9357919872645266
chr13	STARD13-AS	33278375	33278669	0	295	11189	3839	11189	3544	0.0	3.1571670428893905
chr13	STARD13-AS	33280422	33280583	0	162	11189	3839	11189	3677	0.0	3.042969812347022
chr13	STARD13-AS	33278495	33278669	0	175	11189	3839	11189	3664	0.0	3.0537663755458517
chr13	STARD13-AS	33280789	33280920	0	132	11189	3839	11189	3707	0.0	3.0183436741300245
chr13	STARD13-AS	33279472	33279656	14	185	11189	3839	11175	3654	0.07567567567567568	3.0582922824302137
chr13	STARD13-AS	33280422	33280479	0	58	11189	3839	11189	3781	0.0	2.9592700343824383
chr13	LINC02343	34608475	34608619	0	145	569	2680	569	2535	0.0	0.2244575936883629
chr13	NBEA	35168986	35168995	0	10	91	11830	91	11820	0.0	0.007698815566835871
chr13	NBEA	35645868	35645931	0	64	91	11830	91	11766	0.0	0.007734149243583206
chr13	LINC00445	35697706	35697851	18	146	81	1560	63	1414	0.1232876712328767	0.04455445544554455
chr13	SPART-AS1	36360653	36360740	0	88	932	5035	932	4947	0.0	0.18839700828785122
chr13	EXOSC8	37002272	37002309	33	38	258	1913	225	1875	0.868421052631579	0.12
chr13	LINC02334	37987898	37988042	0	145	51	6006	51	5861	0.0	0.008701586759938576
chr13	LINC00366	38577604	38577710	0	107	0	1529	0	1422	0.0	0.0
chr13	NHLRC3	39042104	39042305	0	202	102	6410	102	6208	0.0	0.01643041237113402
chr13	AL354809.1	39082440	39082528	0	89	0	15941	0	15852	0.0	0.0
chr13	AL354809.1	39081227	39081363	0	137	0	15941	0	15804	0.0	0.0
chr13	AL354809.1	39081259	39081363	0	105	0	15941	0	15836	0.0	0.0
chr13	COG6	39679537	39679620	0	84	1938	8068	1938	7984	0.0	0.24273547094188377
chr13	COG6	39656116	39656275	51	160	1938	8068	1887	7908	0.31875	0.23861911987860396
chr13	COG6	39656825	39656890	0	66	1938	8068	1938	8002	0.0	0.2421894526368408
chr13	SLC25A15	40805117	40805255	0	139	0	4194	0	4055	0.0	0.0
chr13	AL354696.2	41146426	41146507	0	82	2330	2932	2330	2850	0.0	0.8175438596491228
chr13	AL354696.2	41134708	41134762	0	55	2330	2932	2330	2877	0.0	0.8098713938129997
chr13	NAA16	41336649	41336756	0	108	5973	5826	5973	5718	0.0	1.0445960125918152
chr13	NAA16	41362730	41362873	0	144	5973	5826	5973	5682	0.0	1.0512143611404434
chr13	AL354833.1	41554177	41554270	0	94	8159	5902	8159	5808	0.0	1.4047865013774106
chr13	DGKH	42221263	42221394	0	132	1883	19782	1883	19650	0.0	0.09582697201017812
chr13	DGKH	42221161	42221394	0	234	1883	19782	1883	19548	0.0	0.09632698997339881
chr13	DGKH	42225289	42225337	0	49	1883	19782	1883	19733	0.0	0.0954239091876552
chr13	NRAD1	43941591	43941684	0	94	1	3248	1	3154	0.0	0.0003170577045022194
chr13	NRAD1	44027696	44027755	0	60	1	3248	1	3188	0.0	0.0003136762860727729
chr13	NRAD1	43919384	43919433	0	50	1	3248	1	3198	0.0	0.00031269543464665416
chr13	NRAD1	43942422	43942613	0	192	1	3248	1	3056	0.0	0.0003272251308900524
chr13	NRAD1	44026822	44026894	1	73	1	3248	0	3175	0.0136986301369863	0.0
chr13	NRAD1	44026831	44026894	0	64	1	3248	1	3184	0.0	0.000314070351758794
chr13	NRAD1	44027678	44027755	0	78	1	3248	1	3170	0.0	0.0003154574132492114
chr13	SMIM2-AS1	44172698	44172873	0	176	0	5189	0	5013	0.0	0.0
chr13	SERP2	44395783	44396083	408	301	714	1951	306	1650	1.3554817275747508	0.18545454545454546
chr13	SERP2	44390356	44390578	0	223	714	1951	714	1728	0.0	0.4131944444444444
chr13	GPALPP1	45029238	45032107	714	2870	54063	10844	53349	7974	0.24878048780487805	6.690368698269375
chr13	TPT1-AS1	45370079	45370182	51	104	51	8229	0	8125	0.49038461538461536	0.0
chr13	TPT1-AS1	45378529	45378671	0	143	51	8229	51	8086	0.0	0.0063071976255256
chr13	TPT1-AS1	45379194	45379335	0	142	51	8229	51	8087	0.0	0.006306417707431681
chr13	TPT1-AS1	45379925	45380001	0	77	51	8229	51	8152	0.0	0.0062561334641805695
chr13	TPT1-AS1	45369958	45370182	51	225	51	8229	0	8004	0.22666666666666666	0.0
chr13	TPT1-AS1	45381072	45381217	0	146	51	8229	51	8083	0.0	0.006309538537671656
chr13	TPT1-AS1	45383759	45383838	0	80	51	8229	51	8149	0.0	0.006258436617989937
chr13	TPT1-AS1	45390757	45390902	0	146	51	8229	51	8083	0.0	0.006309538537671656
chr13	TPT1-AS1	45381141	45381217	0	77	51	8229	51	8152	0.0	0.0062561334641805695
chr13	TPT1-AS1	45390713	45390902	0	190	51	8229	51	8039	0.0	0.006344072645851474
chr13	TPT1-AS1	45383159	45383235	0	77	51	8229	51	8152	0.0	0.0062561334641805695
chr13	TPT1-AS1	45351896	45352014	0	119	51	8229	51	8110	0.0	0.006288532675709001
chr13	TPT1-AS1	45360140	45360239	0	100	51	8229	51	8129	0.0	0.006273834419977857
chr13	TPT1-AS1	45344328	45344446	0	119	51	8229	51	8110	0.0	0.006288532675709001
chr13	TPT1-AS1	45383090	45383235	0	146	51	8229	51	8083	0.0	0.006309538537671656
chr13	TPT1-AS1	45390713	45390858	0	146	51	8229	51	8083	0.0	0.006309538537671656
chr13	TPT1-AS1	45344304	45344446	0	143	51	8229	51	8086	0.0	0.0063071976255256
chr13	TPT1-AS1	45378529	45380001	0	1473	51	8229	51	6756	0.0	0.007548845470692718
chr13	TPT1-AS1	45379898	45380001	0	104	51	8229	51	8125	0.0	0.006276923076923077
chr13	CBY2	45702774	45702855	0	82	0	2121	0	2039	0.0	0.0
chr13	CPB2-AS1	46097109	46097399	77	291	31164	17234	31087	16943	0.2646048109965636	1.8347990320486336
chr13	CPB2-AS1	46098397	46098781	0	385	31164	17234	31164	16849	0.0	1.8496053178230163
chr13	CPB2-AS1	46098397	46098810	294	414	31164	17234	30870	16820	0.7101449275362319	1.8353151010701545
chr13	CPB2-AS1	46113183	46113507	0	325	31164	17234	31164	16909	0.0	1.8430421668933703
chr13	CPB2-AS1	46098397	46098667	0	271	31164	17234	31164	16963	0.0	1.8371750280021222
chr13	LRRC63	46212875	46213119	0	245	51	5177	51	4932	0.0	0.010340632603406326
chr13	LRRC63	46227511	46228189	0	679	51	5177	51	4498	0.0	0.01133837261004891
chr13	LRRC63	46213001	46213119	0	119	51	5177	51	5058	0.0	0.010083036773428233
chr13	LRRC63	46250354	46250491	0	138	51	5177	51	5039	0.0	0.010121055765032744
chr13	LRRC63	46252999	46253232	0	234	51	5177	51	4943	0.0	0.010317620878009305
chr13	LRRC63	46254332	46254489	0	158	51	5177	51	5019	0.0	0.010161386730424387
chr13	LRRC63	46252028	46252293	0	266	51	5177	51	4911	0.0	0.010384850335980453
chr13	LRRC63	46253899	46254119	0	221	51	5177	51	4956	0.0	0.010290556900726392
chr13	LRCH1	46715559	46715664	0	106	1734	8633	1734	8527	0.0	0.20335405183534655
chr13	HTR2A-AS1	46853938	46854082	0	145	0	606	0	461	0.0	0.0
chr13	ITM2B	48239225	48239332	0	108	102	10168	102	10060	0.0	0.010139165009940358
chr13	ITM2B	48254899	48254970	0	72	102	10168	102	10096	0.0	0.010103011093502378
chr13	CYSLTR2	48694670	48694799	0	130	14009	5116	14009	4986	0.0	2.8096670677898117
chr13	FNDC3A	49201132	49201229	0	98	0	7727	0	7629	0.0	0.0
chr13	CDADC1	49259345	49259523	0	179	0	3874	0	3695	0.0	0.0
chr13	CDADC1	49265878	49266003	0	126	0	3874	0	3748	0.0	0.0
chr13	CDADC1	49259485	49259523	0	39	0	3874	0	3835	0.0	0.0
chr13	SETDB2	49464020	49464056	0	37	51	6696	51	6659	0.0	0.007658807628773089
chr13	PHF11	49506634	49506756	0	123	0	4736	0	4613	0.0	0.0
chr13	PHF11	49497055	49497217	0	163	0	4736	0	4573	0.0	0.0
chr13	PHF11	49525772	49525937	0	166	0	4736	0	4570	0.0	0.0
chr13	TRIM13	50000994	50001108	2293	115	16051	8102	13758	7987	19.93913043478261	1.722549142356329
chr13	TRIM13	50018822	50018920	2495	99	16051	8102	13556	8003	25.2020202020202	1.6938648006997377
chr13	DLEU1	50083141	50083194	476	54	131553	22973	131077	22919	8.814814814814815	5.719141323792487
chr13	DLEU1	50274931	50275046	15645	116	131553	22973	115908	22857	134.8706896551724	5.071006693791836
chr13	DLEU1	50433412	50433550	0	139	131553	22973	131553	22834	0.0	5.761277043006044
chr13	DLEU1	50458002	50458113	12	112	131553	22973	131541	22861	0.10714285714285714	5.753947771313591
chr13	DLEU1	50492650	50492761	0	112	131553	22973	131553	22861	0.0	5.7544726827347885
chr13	DLEU1	50390197	50390291	0	95	131553	22973	131553	22878	0.0	5.750196695515342
chr13	DLEU1	50415088	50415202	0	115	131553	22973	131553	22858	0.0	5.755227928952665
chr13	DLEU1	50527865	50528064	0	200	131553	22973	131553	22773	0.0	5.776709260966935
chr13	DLEU1	50425577	50425729	153	153	131553	22973	131400	22820	1.0	5.758106923751096
chr13	DLEU1	50401464	50401639	0	176	131553	22973	131553	22797	0.0	5.770627714172917
chr13	RNASEH2B	50929474	50929582	0	109	1275	19088	1275	18979	0.0	0.06717951419990516
chr13	RNASEH2B	50930682	50930759	0	78	1275	19088	1275	19010	0.0	0.06706996317727512
chr13	RNASEH2B	50934884	50934999	0	116	1275	19088	1275	18972	0.0	0.06720430107526881
chr13	RNASEH2B	50953904	50953985	0	82	1275	19088	1275	19006	0.0	0.06708407871198568
chr13	RNASEH2B	50915274	50915475	0	202	1275	19088	1275	18886	0.0	0.06751032510854602
chr13	RNASEH2B	50956357	50956421	0	65	1275	19088	1275	19023	0.0	0.06702412868632708
chr13	RNASEH2B	50912994	50913131	0	138	1275	19088	1275	18950	0.0	0.06728232189973615
chr13	RNASEH2B	50929460	50929582	0	123	1275	19088	1275	18965	0.0	0.06722910624835222
chr13	RNASEH2B	50960144	50960171	0	28	1275	19088	1275	19060	0.0	0.06689401888772298
chr13	RNASEH2B	50929515	50929582	0	68	1275	19088	1275	19020	0.0	0.06703470031545741
chr13	RNASEH2B	50949996	50950318	0	323	1275	19088	1275	18765	0.0	0.06794564348521183
chr13	RNASEH2B	50950070	50950318	0	249	1275	19088	1275	18839	0.0	0.0676787515260895
chr13	RNASEH2B	50921177	50921331	0	155	1275	19088	1275	18933	0.0	0.0673427349073047
chr13	RNASEH2B	50960148	50960171	0	24	1275	19088	1275	19064	0.0	0.06687998321443558
chr13	RNASEH2B	50956357	50956441	0	85	1275	19088	1275	19003	0.0	0.06709466926274799
chr13	FAM124A	51245311	51245419	0	109	0	6707	0	6598	0.0	0.0
chr13	INTS6-AS1	51551124	51551188	0	65	31523	14164	31523	14099	0.0	2.2358323285339385
chr13	INTS6-AS1	51468267	51468367	0	101	31523	14164	31523	14063	0.0	2.2415558557917943
chr13	INTS6-AS1	51454149	51454329	0	181	31523	14164	31523	13983	0.0	2.2543803189587357
chr13	INTS6-AS1	51479008	51479064	0	57	31523	14164	31523	14107	0.0	2.2345644006521583
chr13	INTS6-AS1	51549118	51549230	0	113	31523	14164	31523	14051	0.0	2.243470215643015
chr13	INTS6-AS1	51467537	51467684	0	148	31523	14164	31523	14016	0.0	2.249072488584475
chr13	INTS6-AS1	51506542	51506638	30	97	31523	14164	31493	14067	0.30927835051546393	2.2387858107627783
chr13	INTS6-AS1	51454002	51454329	0	328	31523	14164	31523	13836	0.0	2.2783318878288523
chr13	INTS6-AS1	51467508	51467684	0	177	31523	14164	31523	13987	0.0	2.2537356116393794
chr13	INTS6-AS1	51467595	51467684	0	90	31523	14164	31523	14074	0.0	2.239803893704704
chr13	INTS6-AS1	51462265	51462419	0	155	31523	14164	31523	14009	0.0	2.2501963023770433
chr13	INTS6-AS1	51468771	51468894	0	124	31523	14164	31523	14040	0.0	2.2452279202279204
chr13	ALG11	52024005	52024937	40760	933	101123	11770	60363	10837	43.68703108252947	5.570083971578851
chr13	ALG11	52024585	52024937	28495	353	101123	11770	72628	11417	80.72237960339943	6.3613909082946485
chr13	CKAP2	52460898	52460974	0	77	0	4557	0	4480	0.0	0.0
chr13	CKAP2	52460895	52460974	0	80	0	4557	0	4477	0.0	0.0
chr13	AL137058.1	52497561	52497674	0	114	8125	4551	8125	4437	0.0	1.831192247013748
chr13	AL137058.1	52577070	52577176	0	107	8125	4551	8125	4444	0.0	1.8283078307830782
chr13	AL137058.2	52632421	52632494	10	74	10	954	0	880	0.13513513513513514	0.0
chr13	AL137058.2	52621988	52622264	0	277	10	954	10	677	0.0	0.014771048744460856
chr13	AL137058.2	52629218	52629359	0	142	10	954	10	812	0.0	0.012315270935960592
chr13	SUGT1	52661474	52661570	0	97	357	14527	357	14430	0.0	0.02474012474012474
chr13	LINC00558	53870464	53870527	0	64	51	4098	51	4034	0.0	0.01264253842340109
chr13	AL390964.1	54980380	54980424	0	45	0	4150	0	4105	0.0	0.0
chr13	AL390964.1	54952300	54952393	0	94	0	4150	0	4056	0.0	0.0
chr13	AL390964.1	54980380	54980446	0	67	0	4150	0	4083	0.0	0.0
chr13	AL390964.1	54970742	54970897	0	156	0	4150	0	3994	0.0	0.0
chr13	AL390964.1	54953651	54953889	0	239	0	4150	0	3911	0.0	0.0
chr13	AL390964.1	54960587	54960653	0	67	0	4150	0	4083	0.0	0.0
chr13	AL390964.1	54941758	54941799	0	42	0	4150	0	4108	0.0	0.0
chr13	PCDH17	57709668	57709752	0	85	0	8397	0	8312	0.0	0.0
chr13	DIAPH3-AS1	60020920	60021008	0	89	0	972	0	883	0.0	0.0
chr13	TDRD3	60444686	60444748	0	63	20184	7840	20184	7777	0.0	2.5953452488105953
chr13	TDRD3	60484692	60484757	0	66	20184	7840	20184	7774	0.0	2.5963467970156935
chr13	TDRD3	60444682	60444748	0	67	20184	7840	20184	7773	0.0	2.5966808182169046
chr13	LINC00378	60690772	60690864	0	93	0	3415	0	3322	0.0	0.0
chr13	AL354810.1	63052272	63052408	0	137	0	680	0	543	0.0	0.0
chr13	AL359208.1	63441408	63441495	0	88	0	9268	0	9180	0.0	0.0
chr13	LINC00383	69269890	69269951	0	62	0	2347	0	2285	0.0	0.0
chr13	LINC00383	69311953	69312086	0	134	0	2347	0	2213	0.0	0.0
chr13	LINC00348	71041467	71041554	0	88	0	1793	0	1705	0.0	0.0
chr13	LINC00348	71101144	71101273	0	130	0	1793	0	1663	0.0	0.0
chr13	LINC00348	71145195	71145289	0	95	0	1793	0	1698	0.0	0.0
chr13	LINC00348	71143185	71143236	0	52	0	1793	0	1741	0.0	0.0
chr13	LINC00348	71157578	71157764	0	187	0	1793	0	1606	0.0	0.0
chr13	LINC00348	71023488	71023588	0	101	0	1793	0	1692	0.0	0.0
chr13	LINC00348	71157578	71157799	0	222	0	1793	0	1571	0.0	0.0
chr13	LINC00348	71145209	71145289	0	81	0	1793	0	1712	0.0	0.0
chr13	BORA	72731280	72731387	0	108	0	3201	0	3093	0.0	0.0
chr13	BORA	72734959	72735005	0	47	0	3201	0	3154	0.0	0.0
chr13	BORA	72728925	72729093	0	169	0	3201	0	3032	0.0	0.0
chr13	PIBF1	72783422	72783721	0	300	0	4201	0	3901	0.0	0.0
chr13	PIBF1	72827732	72827914	0	183	0	4201	0	4018	0.0	0.0
chr13	AL353660.1	74331951	74332013	0	63	0	3166	0	3103	0.0	0.0
chr13	AL353660.1	74399266	74399305	0	40	0	3166	0	3126	0.0	0.0
chr13	AL353660.1	74399995	74400168	0	174	0	3166	0	2992	0.0	0.0
chr13	AL353660.1	74356146	74356322	0	177	0	3166	0	2989	0.0	0.0
chr13	LINC00381	74419442	74419539	0	98	918	1512	918	1414	0.0	0.6492220650636492
chr13	LINC00347	74553167	74553248	0	82	0	3684	0	3602	0.0	0.0
chr13	UCHL3	75589937	75590129	0	193	0	1913	0	1720	0.0	0.0
chr13	LMO7	75623270	75623320	0	51	98590	12803	98590	12752	0.0	7.73133626097867
chr13	LMO7	75805478	75805760	0	283	98590	12803	98590	12520	0.0	7.874600638977636
chr13	LMO7	75838139	75838196	0	58	98590	12803	98590	12745	0.0	7.735582581404472
chr13	LMO7	75855259	75855368	0	110	98590	12803	98590	12693	0.0	7.767273300244229
chr13	LMO7	75809153	75809183	0	31	98590	12803	98590	12772	0.0	7.719229564672721
chr13	LMO7	75807479	75808199	0	721	98590	12803	98590	12082	0.0	8.160072835623241
chr13	LMO7	75838346	75838388	0	43	98590	12803	98590	12760	0.0	7.726489028213166
chr13	CLN5	76998042	76998085	0	44	204	21845	204	21801	0.0	0.009357368928030824
chr13	CLN5	76995456	76995513	0	58	204	21845	204	21787	0.0	0.009363381833203286
chr13	CLN5	76999929	76999995	0	67	204	21845	204	21778	0.0	0.009367251354578015
chr13	MYCBP2-AS1	77083009	77083112	0	104	0	4097	0	3993	0.0	0.0
chr13	SCEL	77567679	77567748	102	70	14543	3709	14441	3639	1.457142857142857	3.968397911514152
chr13	SCEL	77593513	77593573	245	61	14543	3709	14298	3648	4.016393442622951	3.919407894736842
chr13	SCEL	77599328	77599388	0	61	14543	3709	14543	3648	0.0	3.9865679824561404
chr13	SCEL	77572123	77572189	15	67	14543	3709	14528	3642	0.22388059701492538	3.9890170236133993
chr13	SCEL	77604355	77604415	0	61	14543	3709	14543	3648	0.0	3.9865679824561404
chr13	SLAIN1	77746513	77746855	9	343	392	4111	383	3768	0.026239067055393587	0.10164543524416136
chr13	SLAIN1	77743015	77743165	0	151	392	4111	392	3960	0.0	0.09898989898989899
chr13	LINC00446	78037195	78037250	0	56	0	1059	0	1003	0.0	0.0
chr13	OBI1-AS1	78189607	78189696	0	90	102	8801	102	8711	0.0	0.01170933302720698
chr13	OBI1-AS1	78363571	78363731	0	161	102	8801	102	8640	0.0	0.011805555555555555
chr13	OBI1-AS1	78274252	78274337	0	86	102	8801	102	8715	0.0	0.0117039586919105
chr13	OBI1-AS1	78606971	78607210	0	240	102	8801	102	8561	0.0	0.011914495970096951
chr13	OBI1-AS1	78188308	78188436	0	129	102	8801	102	8672	0.0	0.0117619926199262
chr13	OBI1-AS1	78578476	78578663	0	188	102	8801	102	8613	0.0	0.011842563566701497
chr13	RBM26-AS1	79412681	79412907	0	227	1683	6758	1683	6531	0.0	0.2576940744143317
chr13	RBM26-AS1	79415110	79415364	0	255	1683	6758	1683	6503	0.0	0.2588036290942642
chr13	RBM26-AS1	79415261	79415364	0	104	1683	6758	1683	6654	0.0	0.25293056807935077
chr13	NDFIP2	79543557	79543682	0	126	0	5004	0	4878	0.0	0.0
chr13	NDFIP2	79534391	79534554	0	164	0	5004	0	4840	0.0	0.0
chr13	NDFIP2	79543617	79543682	0	66	0	5004	0	4938	0.0	0.0
chr13	LINC00382	79908811	79908875	28	65	1743	1525	1715	1460	0.4307692307692308	1.1746575342465753
chr13	LINC00382	79914715	79914860	44	146	1743	1525	1699	1379	0.3013698630136986	1.2320522117476431
chr13	LINC00382	79916533	79916622	0	90	1743	1525	1743	1435	0.0	1.2146341463414634
chr13	LINC00382	79903499	79903641	0	143	1743	1525	1743	1382	0.0	1.2612156295224313
chr13	AL355481.1	83886281	83886340	0	60	0	4199	0	4139	0.0	0.0
chr13	LINC00430	86935621	86935770	0	150	0	780	0	630	0.0	0.0
chr13	DNAJC3	95757643	95757796	0	154	2064	5602	2064	5448	0.0	0.3788546255506608
chr13	MBNL2	97365135	97365171	0	37	102	4919	102	4882	0.0	0.020893076607947564
chr13	MBNL2	97356795	97356849	0	55	102	4919	102	4864	0.0	0.020970394736842105
chr13	MBNL2	97366458	97366553	0	96	102	4919	102	4823	0.0	0.02114866265809662
chr13	RAP2A	97441767	97441850	0	84	0	5626	0	5542	0.0	0.0
chr13	IPO5	97982502	97982583	0	82	9322	9701	9322	9619	0.0	0.9691236095228194
chr13	IPO5	97954102	97954198	0	97	9322	9701	9322	9604	0.0	0.970637234485631
chr13	IPO5	97954118	97954198	0	81	9322	9701	9322	9620	0.0	0.969022869022869
chr13	IPO5	97963159	97963282	0	124	9322	9701	9322	9577	0.0	0.9733737078417041
chr13	IPO5	97981241	97981400	0	160	9322	9701	9322	9541	0.0	0.977046431191699
chr13	IPO5	97960346	97960403	0	58	9322	9701	9322	9643	0.0	0.9667116042725293
chr13	IPO5	97975890	97975997	0	108	9322	9701	9322	9593	0.0	0.9717502345460232
chr13	IPO5	97982054	97982143	0	90	9322	9701	9322	9611	0.0	0.9699302882114245
chr13	IPO5	97987989	97988101	0	113	9322	9701	9322	9588	0.0	0.9722569879015436
chr13	FARP1	98377820	98377918	0	99	30	25118	30	25019	0.0	0.0011990886925936288
chr13	FARP1	98437765	98437858	0	94	30	25118	30	25024	0.0	0.001198849104859335
chr13	FARP1	98438803	98438872	0	70	30	25118	30	25048	0.0	0.0011977004152028106
chr13	UBAC2	99201428	99201567	0	140	51	4688	51	4548	0.0	0.011213720316622692
chr13	CLYBL	99862990	99863092	0	103	124663	6129	124663	6026	0.0	20.68752074344507
chr13	CLYBL	99884976	99885105	0	130	124663	6129	124663	5999	0.0	20.780630105017504
chr13	PCCA	100102882	100102960	0	79	5436	7321	5436	7242	0.0	0.7506213753106876
chr13	PCCA	100515426	100515567	660	142	5436	7321	4776	7179	4.647887323943662	0.6652737150020894
chr13	PCCA	100104463	100104560	0	98	5436	7321	5436	7223	0.0	0.752595874290461
chr13	PCCA	100527296	100527344	0	49	5436	7321	5436	7272	0.0	0.7475247524752475
chr13	ITGBL1	101453882	101454100	0	219	0	6189	0	5970	0.0	0.0
chr13	ITGBL1	101567698	101567845	0	148	0	6189	0	6041	0.0	0.0
chr13	TPP2	102651358	102651397	0	40	51	8266	51	8226	0.0	0.006199854121079504
chr13	TPP2	102616955	102617051	0	97	51	8266	51	8169	0.0	0.006243114212265883
chr13	TPP2	102644908	102646390	51	1483	51	8266	0	6783	0.03438975050573163	0.0
chr13	TPP2	102651338	102651397	0	60	51	8266	51	8206	0.0	0.0062149646600048744
chr13	BIVM	102831564	102831697	0	134	0	7930	0	7796	0.0	0.0
chr13	BIVM	102834465	102834552	0	88	0	7930	0	7842	0.0	0.0
chr13	BIVM	102806276	102806350	0	75	0	7930	0	7855	0.0	0.0
chr13	BIVM	102805306	102805390	0	85	0	7930	0	7845	0.0	0.0
chr13	BIVM	102824033	102824094	0	62	0	7930	0	7868	0.0	0.0
chr13	BIVM	102807283	102807745	0	463	0	7930	0	7467	0.0	0.0
chr13	BIVM	102801690	102801767	0	78	0	7930	0	7852	0.0	0.0
chr13	DAOA	105474976	105475070	0	95	0	1584	0	1489	0.0	0.0
chr13	DAOA	105467609	105467722	0	114	0	1584	0	1470	0.0	0.0
chr13	LINC00343	105728589	105728727	0	139	0	12772	0	12633	0.0	0.0
chr13	LINC00343	105758080	105758187	0	108	0	12772	0	12664	0.0	0.0
chr13	LINC00343	105729843	105729959	0	117	0	12772	0	12655	0.0	0.0
chr13	LINC00343	105718647	105718852	0	206	0	12772	0	12566	0.0	0.0
chr13	LINC00343	105730314	105730458	0	145	0	12772	0	12627	0.0	0.0
chr13	LINC00343	105707713	105707837	0	125	0	12772	0	12647	0.0	0.0
chr13	LINC00343	105761262	105761560	0	299	0	12772	0	12473	0.0	0.0
chr13	LINC00343	105729826	105729959	0	134	0	12772	0	12638	0.0	0.0
chr13	LINC00343	105718474	105718852	0	379	0	12772	0	12393	0.0	0.0
chr13	LINC00343	105728650	105728727	0	78	0	12772	0	12694	0.0	0.0
chr13	LINC00343	105718474	105718559	0	86	0	12772	0	12686	0.0	0.0
chr13	LINC00343	105761262	105761437	0	176	0	12772	0	12596	0.0	0.0
chr13	LINC00343	105719046	105719106	0	61	0	12772	0	12711	0.0	0.0
chr13	LINC00343	105761262	105761386	0	125	0	12772	0	12647	0.0	0.0
chr13	LINC00343	105733919	105734205	0	287	0	12772	0	12485	0.0	0.0
chr13	LINC00460	106382090	106382173	0	84	0	4088	0	4004	0.0	0.0
chr13	LINC00551	106628018	106628141	0	124	0	6132	0	6008	0.0	0.0
chr13	LINC00443	106669149	106669268	0	120	80	1500	80	1380	0.0	0.057971014492753624
chr13	TNFSF13B	108286802	108286859	0	58	0	2978	0	2920	0.0	0.0
chr13	TNFSF13B	108303252	108303365	0	114	0	2978	0	2864	0.0	0.0
chr13	LINC00370	109286356	109286417	0	62	0	1341	0	1279	0.0	0.0
chr13	NAXD	110625189	110625278	0	90	0	2858	0	2768	0.0	0.0
chr13	ARHGEF7	111153904	111153991	0	88	559370	11306	559370	11218	0.0	49.86361205205919
chr13	ARHGEF7	111209871	111210002	0	132	559370	11306	559370	11174	0.0	50.05996062287453
chr13	ARHGEF7	111273813	111273952	0	140	559370	11306	559370	11166	0.0	50.095826616514415
chr13	ARHGEF7	111280271	111280350	1148	80	559370	11306	558222	11226	14.35	49.72581507215393
chr13	ARHGEF7	111159026	111159089	0	64	559370	11306	559370	11242	0.0	49.75716064757161
chr13	ARHGEF7	111292117	111292294	84482	178	559370	11306	474888	11128	474.6179775280899	42.675053918044576
chr13	ARHGEF7	111209265	111209346	40	82	559370	11306	559330	11224	0.4878048780487805	49.83339272986458
chr13	TEX29	111339293	111339438	415	146	10896	964	10481	818	2.8424657534246576	12.812958435207824
chr13	LINC00354	111894271	111894952	0	682	400	1978	400	1296	0.0	0.30864197530864196
chr13	SOX1-OT	112088045	112088260	0	216	0	3410	0	3194	0.0	0.0
chr13	SPACA7	112382277	112382507	0	231	0	1087	0	856	0.0	0.0
chr13	SPACA7	112393020	112393077	0	58	0	1087	0	1029	0.0	0.0
chr13	SPACA7	112378642	112378731	0	90	0	1087	0	997	0.0	0.0
chr13	ATP11A	112851036	112851218	0	183	51	12639	51	12456	0.0	0.004094412331406551
chr13	ATP11A	112860286	112860414	0	129	51	12639	51	12510	0.0	0.00407673860911271
chr13	MCF2L	113091120	113091195	0	76	204	16966	204	16890	0.0	0.012078152753108348
chr13	MCF2L	113090067	113090151	0	85	204	16966	204	16881	0.0	0.012084592145015106
chr13	MCF2L	113090067	113090160	0	94	204	16966	204	16872	0.0	0.01209103840682788
chr13	F7	113115659	113115800	0	142	0	3809	0	3667	0.0	0.0
chr13	F7	113106844	113106910	0	67	0	3809	0	3742	0.0	0.0
chr13	PROZ	113159198	113159264	0	67	202	1686	202	1619	0.0	0.12476837554045707
chr13	CUL4A	113260606	113260759	0	154	90040	7698	90040	7544	0.0	11.935312831389183
chr13	CUL4A	113209972	113210088	0	117	90040	7698	90040	7581	0.0	11.877061073736973
chr13	TMCO3	113503495	113503588	0	94	73369	9767	73369	9673	0.0	7.584927116716634
chr13	TMCO3	113534044	113534240	2124	197	73369	9767	71245	9570	10.781725888324873	7.4446185997910135
chr13	TFDP1	113585579	113585677	0	99	0	3759	0	3660	0.0	0.0
chr13	TFDP1	113631622	113631744	0	123	0	3759	0	3636	0.0	0.0
chr13	CFAP97D2	114211911	114212101	0	191	13296	2188	13296	1997	0.0	6.657986980470706
chr13	CDC16	114257077	114257230	654	154	21423	3902	20769	3748	4.246753246753247	5.5413553895410885
chr13	CDC16	114269562	114269620	24	59	21423	3902	21399	3843	0.4067796610169492	5.5683060109289615
chr13	UPF3A	114282020	114282127	1276	108	430496	5735	429220	5627	11.814814814814815	76.27865647769681
chr13	UPF3A	114286301	114286400	408	100	430496	5735	430088	5635	4.08	76.32440106477374
chr13	UPF3A	114298839	114299000	0	162	430496	5735	430496	5573	0.0	77.2467252826126
chr13	UPF3A	114286518	114286629	172	112	430496	5735	430324	5623	1.5357142857142858	76.52925484616753
chr13	CHAMP1	114321109	114321232	0	124	102	4274	102	4150	0.0	0.02457831325301205
chr14	POTEM	18974760	18975016	0	257	0	6984	0	6727	0.0	0.0
chr14	POTEM	18992394	18992443	0	50	0	6984	0	6934	0.0	0.0
chr14	DUXAP9	19064582	19064693	0	112	51	4785	51	4673	0.0	0.01091375989728226
chr14	DUXAP9	19068432	19068568	0	137	51	4785	51	4648	0.0	0.010972461273666093
chr14	DUXAP9	19066000	19066115	0	116	51	4785	51	4669	0.0	0.010923109873634611
chr14	AL512310.11	19653096	19653139	0	44	416	643	416	599	0.0	0.6944908180300501
chr14	OR4K1	19931213	19931359	0	147	0	1528	0	1381	0.0	0.0
chr14	OR4K17	20111909	20112091	0	183	1989	5071	1989	4888	0.0	0.40691489361702127
chr14	PARP2	20357395	20357520	0	126	87	3806	87	3680	0.0	0.023641304347826086
chr14	APEX1	20455577	20455703	0	127	0	1679	0	1552	0.0	0.0
chr14	APEX1	20455577	20455773	0	197	0	1679	0	1482	0.0	0.0
chr14	APEX1	20455737	20455773	0	37	0	1679	0	1642	0.0	0.0
chr14	APEX1	20455734	20455773	0	40	0	1679	0	1639	0.0	0.0
chr14	AL163195.2	20596670	20596819	0	150	0	2755	0	2605	0.0	0.0
chr14	ANG	20693546	20693650	0	105	0	1443	0	1338	0.0	0.0
chr14	AL161668.4	21028445	21028534	0	90	0	596	0	506	0.0	0.0
chr14	TPPP2	21032319	21032380	0	62	0	2314	0	2252	0.0	0.0
chr14	TPPP2	21035793	21036092	0	300	0	2314	0	2014	0.0	0.0
chr14	ARHGEF40	21087319	21087463	0	145	1392	8078	1392	7933	0.0	0.17546955754443463
chr14	TMEM253	21101864	21101975	0	112	0	2166	0	2054	0.0	0.0
chr14	RPGRIP1	21318126	21318201	0	76	79	4850	79	4774	0.0	0.016547968160871385
chr14	RPGRIP1	21324874	21325070	0	197	79	4850	79	4653	0.0	0.016978293574038256
chr14	TOX4	21477495	21477564	0	70	32	6373	32	6303	0.0	0.005076947485324449
chr14	TOX4	21482551	21482611	0	61	32	6373	32	6312	0.0	0.005069708491761723
chr14	TOX4	21477495	21477592	0	98	32	6373	32	6275	0.0	0.005099601593625498
chr14	ABHD4	22603924	22604079	0	156	0	3045	0	2889	0.0	0.0
chr14	OXA1L	22769790	22769934	0	145	0	4326	0	4181	0.0	0.0
chr14	OXA1L	22771267	22771348	0	82	0	4326	0	4244	0.0	0.0
chr14	OXA1L	22769796	22769934	0	139	0	4326	0	4187	0.0	0.0
chr14	MRPL52	22830049	22830110	0	62	0	2769	0	2707	0.0	0.0
chr14	MRPL52	22833417	22833482	0	66	0	2769	0	2703	0.0	0.0
chr14	MRPL52	22830052	22830110	0	59	0	2769	0	2710	0.0	0.0
chr14	MRPL52	22833417	22833489	0	73	0	2769	0	2696	0.0	0.0
chr14	MRPL52	22830963	22831037	0	75	0	2769	0	2694	0.0	0.0
chr14	REM2	22885265	22885339	0	75	0	2244	0	2169	0.0	0.0
chr14	PRMT5-AS1	22923078	22923204	0	127	120	2524	120	2397	0.0	0.05006257822277847
chr14	PRMT5-AS1	22924300	22924441	0	142	120	2524	120	2382	0.0	0.05037783375314862
chr14	PRMT5-AS1	22922968	22923204	0	237	120	2524	120	2287	0.0	0.052470485351989504
chr14	AL132780.1	22933642	22933692	0	51	0	1807	0	1756	0.0	0.0
chr14	RNF212B	23262927	23262970	0	44	25331	1689	25331	1645	0.0	15.398784194528876
chr14	RNF212B	23264173	23264234	0	62	25331	1689	25331	1627	0.0	15.569145666871544
chr14	RNF212B	23264622	23264671	0	50	25331	1689	25331	1639	0.0	15.455155582672361
chr14	RNF212B	23268923	23268963	0	41	25331	1689	25331	1648	0.0	15.370752427184467
chr14	BCL2L2-PABPN1	23319734	23319830	0	97	3905	2380	3905	2283	0.0	1.7104686815593517
chr14	BCL2L2	23308815	23308932	1725	118	479178	2991	477453	2873	14.61864406779661	166.18621649843368
chr14	CMTM5	23378348	23378501	379	154	51374	2586	50995	2432	2.461038961038961	20.968338815789473
chr14	CMTM5	23379030	23379123	203	94	51374	2586	51171	2492	2.1595744680851063	20.53410914927769
chr14	CMTM5	23378668	23378869	42877	202	51374	2586	8497	2384	212.26237623762376	3.564177852348993
chr14	CMTM5	23378462	23378501	268	40	51374	2586	51106	2546	6.7	20.073055773762764
chr14	ZFHX2-AS1	23513216	23513334	0	119	68433	5104	68433	4985	0.0	13.727783350050151
chr14	THTPA	23556742	23557304	408	563	66500	2498	66092	1935	0.7246891651865008	34.15607235142119
chr14	THTPA	23556742	23557039	204	298	66500	2498	66296	2200	0.6845637583892618	30.134545454545453
chr14	THTPA	23556742	23557034	204	293	66500	2498	66296	2205	0.6962457337883959	30.06621315192744
chr14	DHRS4	23965931	23965983	0	53	0	2042	0	1989	0.0	0.0
chr14	DHRS4	23959901	23960003	0	103	0	2042	0	1939	0.0	0.0
chr14	DHRS4	23965761	23965832	0	72	0	2042	0	1970	0.0	0.0
chr14	DHRS4	23966282	23966417	0	136	0	2042	0	1906	0.0	0.0
chr14	DHRS4	23967390	23967455	0	66	0	2042	0	1976	0.0	0.0
chr14	DHRS4L2	23995031	23995133	102	103	7618	2428	7516	2325	0.9902912621359223	3.232688172043011
chr14	DHRS4L2	24001383	24001517	0	135	7618	2428	7618	2293	0.0	3.3222852158744005
chr14	DHRS4L2	24004336	24004392	310	57	7618	2428	7308	2371	5.43859649122807	3.082243778996204
chr14	DHRS4L2	23990774	23990952	4802	179	7618	2428	2816	2249	26.8268156424581	1.252112049799911
chr14	DHRS4L1	24048676	24048811	0	136	8281	1281	8281	1145	0.0	7.232314410480349
chr14	CARMIL3	24065621	24065750	51	130	163	6523	112	6393	0.3923076923076923	0.017519161582981387
chr14	CPNE6	24072932	24073104	0	173	0	3677	0	3504	0.0	0.0
chr14	CPNE6	24074290	24074365	0	76	0	3677	0	3601	0.0	0.0
chr14	CPNE6	24072888	24073104	0	217	0	3677	0	3460	0.0	0.0
chr14	CPNE6	24073498	24073678	0	181	0	3677	0	3496	0.0	0.0
chr14	CPNE6	24072932	24073119	0	188	0	3677	0	3489	0.0	0.0
chr14	PCK2	24099048	24099236	0	189	0	3751	0	3562	0.0	0.0
chr14	PCK2	24094765	24094845	0	81	0	3751	0	3670	0.0	0.0
chr14	PCK2	24096891	24097137	0	247	0	3751	0	3504	0.0	0.0
chr14	PCK2	24103159	24103255	0	97	0	3751	0	3654	0.0	0.0
chr14	PCK2	24095142	24095378	0	237	0	3751	0	3514	0.0	0.0
chr14	PCK2	24099048	24099247	0	200	0	3751	0	3551	0.0	0.0
chr14	DCAF11	24115205	24115293	0	89	1397	5675	1397	5586	0.0	0.25008950948800573
chr14	DCAF11	24115381	24115392	0	12	1397	5675	1397	5663	0.0	0.24668903408087586
chr14	DCAF11	24116916	24117044	750	129	1397	5675	647	5546	5.813953488372093	0.11666065632888568
chr14	DCAF11	24117667	24117732	0	66	1397	5675	1397	5609	0.0	0.24906400427883757
chr14	DCAF11	24116971	24117044	0	74	1397	5675	1397	5601	0.0	0.24941974647384396
chr14	RNF31	24147831	24147890	0	60	0	5009	0	4949	0.0	0.0
chr14	RNF31	24147697	24147890	0	194	0	5009	0	4815	0.0	0.0
chr14	RNF31	24157897	24158011	0	115	0	5009	0	4894	0.0	0.0
chr14	RNF31	24159863	24159960	0	98	0	5009	0	4911	0.0	0.0
chr14	IRF9	24162143	24162324	0	182	0	3101	0	2919	0.0	0.0
chr14	IRF9	24163877	24163959	0	83	0	3101	0	3018	0.0	0.0
chr14	IRF9	24164613	24164955	0	343	0	3101	0	2758	0.0	0.0
chr14	RNF31	24157831	24158011	0	181	0	5009	0	4828	0.0	0.0
chr14	IRF9	24165056	24165183	0	128	0	3101	0	2973	0.0	0.0
chr14	IRF9	24162143	24162280	0	138	0	3101	0	2963	0.0	0.0
chr14	TSSK4	24207115	24207509	0	395	459	1855	459	1460	0.0	0.31438356164383563
chr14	TSSK4	24207145	24207509	0	365	459	1855	459	1490	0.0	0.3080536912751678
chr14	TSSK4	24206508	24206723	306	216	459	1855	153	1639	1.4166666666666667	0.09334960341671751
chr14	GMPR2	24238245	24238405	0	161	51	2910	51	2749	0.0	0.018552200800291015
chr14	GMPR2	24233218	24233340	0	123	51	2910	51	2787	0.0	0.01829924650161464
chr14	GMPR2	24235736	24235820	0	85	51	2910	51	2825	0.0	0.018053097345132742
chr14	GMPR2	24234106	24234241	0	136	51	2910	51	2774	0.0	0.018385003604902667
chr14	GMPR2	24234112	24234241	0	130	51	2910	51	2780	0.0	0.018345323741007193
chr14	NFATC4	24376293	24376554	0	262	518	7075	518	6813	0.0	0.07603111698223984
chr14	NFATC4	24376293	24376878	0	586	518	7075	518	6489	0.0	0.07982740021574973
chr14	LINC02588	26637194	26637333	0	140	0	5137	0	4997	0.0	0.0
chr14	LINC02588	26724747	26724794	0	48	0	5137	0	5089	0.0	0.0
chr14	LINC02588	26797913	26798030	0	118	0	5137	0	5019	0.0	0.0
chr14	LINC02293	26815735	26815842	0	108	0	4217	0	4109	0.0	0.0
chr14	LINC02293	26818703	26818780	0	78	0	4217	0	4139	0.0	0.0
chr14	MIR4307HG	26873396	26873542	0	147	2422	3583	2422	3436	0.0	0.7048894062863795
chr14	MIR4307HG	26880369	26880455	0	87	2422	3583	2422	3496	0.0	0.6927917620137299
chr14	MIR4307HG	26873396	26873471	0	76	2422	3583	2422	3507	0.0	0.6906187624750499
chr14	MIR4307HG	26880369	26880635	0	267	2422	3583	2422	3316	0.0	0.7303980699638118
chr14	AL110292.1	26916820	26916922	1912	103	1362	5264	-550	5161	18.563106796116504	-0.10656849447781437
chr14	MIR4307HG	26873396	26873531	0	136	2422	3583	2422	3447	0.0	0.7026399767914128
chr14	MIR4307HG	26901044	26901177	0	134	2422	3583	2422	3449	0.0	0.7022325311684546
chr14	MIR4307HG	26873396	26874043	0	648	2422	3583	2422	2935	0.0	0.8252129471890971
chr14	MIR4307HG	26873396	26873439	0	44	2422	3583	2422	3539	0.0	0.6843741169821984
chr14	MIR4307HG	26896245	26896380	0	136	2422	3583	2422	3447	0.0	0.7026399767914128
chr14	MIR4307HG	26873396	26873488	0	93	2422	3583	2422	3490	0.0	0.6939828080229227
chr14	LINC00645	27634243	27634344	0	102	102	4537	102	4435	0.0	0.022998872604284102
chr14	LINC00645	27619822	27619873	0	52	102	4537	102	4485	0.0	0.02274247491638796
chr14	LINC01551	28789999	28790041	0	43	0	9600	0	9557	0.0	0.0
chr14	LINC02327	28881090	28881141	0	52	102	5076	102	5024	0.0	0.020302547770700636
chr14	LINC02327	28837252	28837330	0	79	102	5076	102	4997	0.0	0.020412247348409046
chr14	LINC02327	28870302	28870416	0	115	102	5076	102	4961	0.0	0.020560370892965127
chr14	LINC02327	28965203	28965302	0	100	102	5076	102	4976	0.0	0.0204983922829582
chr14	LINC02327	28834796	28834904	0	109	102	5076	102	4967	0.0	0.020535534527884036
chr14	LINC02327	28834796	28834820	0	25	102	5076	102	5051	0.0	0.02019402098594338
chr14	LINC02327	28857995	28858080	0	86	102	5076	102	4990	0.0	0.020440881763527055
chr14	AL135878.1	29007680	29007854	0	175	1084	7946	1084	7771	0.0	0.1394929867455926
chr14	AL135878.1	29061795	29061922	0	128	1084	7946	1084	7818	0.0	0.1386543873113328
chr14	AL158058.1	29408847	29408965	0	119	0	1120	0	1001	0.0	0.0
chr14	G2E3	30580863	30580947	0	85	51	9341	51	9256	0.0	0.005509939498703544
chr14	G2E3	30597419	30597526	0	108	51	9341	51	9233	0.0	0.005523665114264053
chr14	G2E3	30598482	30598599	0	118	51	9341	51	9223	0.0	0.005529654125555676
chr14	G2E3	30605504	30605812	0	309	51	9341	51	9032	0.0	0.005646589902568644
chr14	G2E3	30581075	30581116	0	42	51	9341	51	9299	0.0	0.005484460694698354
chr14	G2E3	30602630	30602889	0	260	51	9341	51	9081	0.0	0.0056161215725140405
chr14	SCFD1	30628208	30628279	0	72	0	20324	0	20252	0.0	0.0
chr14	SCFD1	30630476	30630565	0	90	0	20324	0	20234	0.0	0.0
chr14	SCFD1	30633946	30634037	0	92	0	20324	0	20232	0.0	0.0
chr14	SCFD1	30638124	30638247	0	124	0	20324	0	20200	0.0	0.0
chr14	SCFD1	30639776	30639864	0	89	0	20324	0	20235	0.0	0.0
chr14	SCFD1	30643315	30643405	0	91	0	20324	0	20233	0.0	0.0
chr14	SCFD1	30676783	30676855	0	73	0	20324	0	20251	0.0	0.0
chr14	SCFD1	30702295	30702375	0	81	0	20324	0	20243	0.0	0.0
chr14	SCFD1	30707989	30708065	0	77	0	20324	0	20247	0.0	0.0
chr14	SCFD1	30722493	30722559	0	67	0	20324	0	20257	0.0	0.0
chr14	SCFD1	30707816	30707914	0	99	0	20324	0	20225	0.0	0.0
chr14	SCFD1	30643879	30644018	0	140	0	20324	0	20184	0.0	0.0
chr14	SCFD1	30633929	30634037	0	109	0	20324	0	20215	0.0	0.0
chr14	SCFD1	30707816	30707876	0	61	0	20324	0	20263	0.0	0.0
chr14	SCFD1	30638183	30638247	0	65	0	20324	0	20259	0.0	0.0
chr14	SCFD1	30634794	30635034	0	241	0	20324	0	20083	0.0	0.0
chr14	SCFD1	30638106	30638247	0	142	0	20324	0	20182	0.0	0.0
chr14	SCFD1	30634921	30635034	0	114	0	20324	0	20210	0.0	0.0
chr14	COCH	30875055	30875298	0	244	0	3999	0	3755	0.0	0.0
chr14	COCH	30878810	30878944	0	135	0	3999	0	3864	0.0	0.0
chr14	COCH	30875055	30875103	0	49	0	3999	0	3950	0.0	0.0
chr14	COCH	30877571	30877728	0	158	0	3999	0	3841	0.0	0.0
chr14	COCH	30884984	30885041	0	58	0	3999	0	3941	0.0	0.0
chr14	COCH	30889615	30889793	0	179	0	3999	0	3820	0.0	0.0
chr14	COCH	30879422	30879485	0	64	0	3999	0	3935	0.0	0.0
chr14	COCH	30884909	30885041	0	133	0	3999	0	3866	0.0	0.0
chr14	AP4S1	31032970	31033006	0	37	52900	9348	52900	9311	0.0	5.681452045967136
chr14	AP4S1	31080572	31080644	0	73	52900	9348	52900	9275	0.0	5.703504043126685
chr14	AP4S1	31124828	31124969	0	142	52900	9348	52900	9206	0.0	5.746252444058223
chr14	AP4S1	31083525	31083647	807	123	52900	9348	52093	9225	6.560975609756097	5.646937669376694
chr14	NUBPL	31787779	31787873	0	95	7866	7613	7866	7518	0.0	1.0462889066241021
chr14	NUBPL	31562791	31562885	51	95	7866	7613	7815	7518	0.5368421052631579	1.0395051875498802
chr14	NUBPL	31654069	31654134	0	66	7866	7613	7866	7547	0.0	1.0422684510401483
chr14	ARHGAP5	32117142	32117287	0	146	1479	10287	1479	10141	0.0	0.1458436051671433
chr14	ARHGAP5	32117139	32117287	0	149	1479	10287	1479	10138	0.0	0.14588676267508385
chr14	AKAP6	32821401	32824815	561	3415	3543	19253	2982	15838	0.16427525622254757	0.1882813486551332
chr14	AKAP6	32401997	32402141	0	145	3543	19253	3543	19108	0.0	0.18541971948921918
chr14	NPAS3	33055904	33055994	0	91	128	9801	128	9710	0.0	0.013182286302780639
chr14	NPAS3	33215536	33215587	0	52	128	9801	128	9749	0.0	0.013129551748897322
chr14	SRP54	34999557	34999649	25	93	11261	8450	11236	8357	0.26881720430107525	1.3445016154122293
chr14	SRP54	35000935	35001020	0	86	11261	8450	11261	8364	0.0	1.3463653754184601
chr14	SRP54	35013345	35013494	0	150	11261	8450	11261	8300	0.0	1.3567469879518073
chr14	SRP54	35018691	35018765	0	75	11261	8450	11261	8375	0.0	1.3445970149253732
chr14	SRP54	35022909	35023080	0	172	11261	8450	11261	8278	0.0	1.3603527422082629
chr14	SRP54	34983129	34983215	0	87	11261	8450	11261	8363	0.0	1.3465263661365539
chr14	SRP54	34999557	34999644	20	88	11261	8450	11241	8362	0.22727272727272727	1.344295623056685
chr14	FAM177A1	35050783	35050868	18429	86	66531	8320	48102	8234	214.2906976744186	5.84187515180957
chr14	PRORP	35126734	35126782	0	49	17174	7001	17174	6952	0.0	2.4703682393555813
chr14	PSMA6	35312880	35313059	0	180	1020	2284	1020	2104	0.0	0.4847908745247148
chr14	PSMA6	35314360	35314455	0	96	1020	2284	1020	2188	0.0	0.46617915904936014
chr14	PSMA6	35307993	35308088	0	96	1020	2284	1020	2188	0.0	0.46617915904936014
chr14	PSMA6	35310216	35310299	0	84	1020	2284	1020	2200	0.0	0.4636363636363636
chr14	PSMA6	35312862	35313059	0	198	1020	2284	1020	2086	0.0	0.48897411313518696
chr14	PSMA6	35292952	35293277	0	326	1020	2284	1020	1958	0.0	0.5209397344228804
chr14	PSMA6	35312880	35312921	0	42	1020	2284	1020	2242	0.0	0.45495093666369313
chr14	BRMS1L	35829794	35829907	0	114	376334	3890	376334	3776	0.0	99.66472457627118
chr14	MIPOL1	37219552	37219691	0	140	408	20276	408	20136	0.0	0.02026221692491061
chr14	MIPOL1	37227725	37227838	0	114	408	20276	408	20162	0.0	0.02023608768971332
chr14	MIPOL1	37247102	37247240	0	139	408	20276	408	20137	0.0	0.020261210706659382
chr14	MIPOL1	37265206	37265281	0	76	408	20276	408	20200	0.0	0.0201980198019802
chr14	MIPOL1	37212229	37212356	0	128	408	20276	408	20148	0.0	0.02025014889815366
chr14	TTC6	37837321	37837542	0	222	949	8407	949	8185	0.0	0.11594379963347587
chr14	AL355835.1	38277949	38278046	0	98	0	1874	0	1776	0.0	0.0
chr14	GEMIN2	39124991	39125036	0	46	0	2501	0	2455	0.0	0.0
chr14	GEMIN2	39128279	39128348	0	70	0	2501	0	2431	0.0	0.0
chr14	GEMIN2	39133660	39133719	0	60	0	2501	0	2441	0.0	0.0
chr14	GEMIN2	39121906	39122024	0	119	0	2501	0	2382	0.0	0.0
chr14	GEMIN2	39135930	39136155	0	226	0	2501	0	2275	0.0	0.0
chr14	PNN	39177592	39177687	0	96	0	2497	0	2401	0.0	0.0
chr14	MIA2	39279336	39279358	0	23	153	9868	153	9845	0.0	0.015540883697308279
chr14	MIA2	39291018	39291096	0	79	153	9868	153	9789	0.0	0.01562978853815507
chr14	MIA2	39320927	39321056	0	130	153	9868	153	9738	0.0	0.015711645101663587
chr14	MIA2	39252747	39252966	0	220	153	9868	153	9648	0.0	0.01585820895522388
chr14	MIA2	39292679	39292706	0	28	153	9868	153	9840	0.0	0.015548780487804878
chr14	MIA2	39291018	39291111	0	94	153	9868	153	9774	0.0	0.01565377532228361
chr14	AL049828.1	39433487	39433729	0	243	2549	12973	2549	12730	0.0	0.2002356637863315
chr14	AL049828.1	39485016	39485257	0	242	2549	12973	2549	12731	0.0	0.20021993559029141
chr14	AL049828.1	39436645	39436766	0	122	2549	12973	2549	12851	0.0	0.19835032293206753
chr14	AL049828.1	40371520	40371578	0	59	2549	12973	2549	12914	0.0	0.19738268545764287
chr14	AL049828.1	40262615	40262755	0	141	2549	12973	2549	12832	0.0	0.1986440149625935
chr14	AL390800.1	40889121	40889174	0	54	0	5110	0	5056	0.0	0.0
chr14	LRFN5	41891249	41891962	0	714	0	6151	0	5437	0.0	0.0
chr14	LRFN5	41898916	41898960	0	45	0	6151	0	6106	0.0	0.0
chr14	C14ORF28	44903206	44903296	0	91	0	3053	0	2962	0.0	0.0
chr14	TOGARAM1	45004060	45004366	0	307	22	10314	22	10007	0.0	0.002198461077245928
chr14	TOGARAM1	45008912	45009145	0	234	22	10314	22	10080	0.0	0.0021825396825396826
chr14	TOGARAM1	45046544	45046703	0	160	22	10314	22	10154	0.0	0.002166633838881229
chr14	TOGARAM1	45071711	45071798	0	88	22	10314	22	10226	0.0	0.0021513788382554275
chr14	TOGARAM1	45022909	45022973	22	65	22	10314	0	10249	0.3384615384615385	0.0
chr14	PRPF39	45107450	45107616	0	167	0	4642	0	4475	0.0	0.0
chr14	PRPF39	45096423	45096758	0	336	0	4642	0	4306	0.0	0.0
chr14	PRPF39	45096423	45096492	0	70	0	4642	0	4572	0.0	0.0
chr14	PRPF39	45109893	45109993	0	101	0	4642	0	4541	0.0	0.0
chr14	PRPF39	45096595	45096758	0	164	0	4642	0	4478	0.0	0.0
chr14	FANCM	45140631	45140709	0	79	284	8294	284	8215	0.0	0.03457090687766281
chr14	FANCM	45164358	45164565	0	208	284	8294	284	8086	0.0	0.0351224338362602
chr14	FANCM	45195480	45195585	0	106	284	8294	284	8188	0.0	0.034684904738641914
chr14	LINC00871	46471361	46471511	0	151	0	1761	0	1610	0.0	0.0
chr14	LINC00871	46490191	46490287	0	97	0	1761	0	1664	0.0	0.0
chr14	LRR1	49603551	49603618	0	68	0	2303	0	2235	0.0	0.0
chr14	LRR1	49612471	49612624	0	154	0	2303	0	2149	0.0	0.0
chr14	LRR1	49607399	49608121	0	723	0	2303	0	1580	0.0	0.0
chr14	LRR1	49601541	49601649	0	109	0	2303	0	2194	0.0	0.0
chr14	KLHDC1	49723873	49723952	0	80	0	3019	0	2939	0.0	0.0
chr14	KLHDC1	49725685	49725769	0	85	0	3019	0	2934	0.0	0.0
chr14	KLHDC1	49700049	49700189	0	141	0	3019	0	2878	0.0	0.0
chr14	KLHDC2	49780702	49780775	14	74	116	6332	102	6258	0.1891891891891892	0.016299137104506232
chr14	KLHDC2	49782369	49782457	0	89	116	6332	116	6243	0.0	0.018580810507768702
chr14	KLHDC2	49782541	49782594	0	54	116	6332	116	6278	0.0	0.018477222045237336
chr14	DMAC2L	50323944	50324116	0	173	5585	4575	5585	4402	0.0	1.268741481144934
chr14	DMAC2L	50314590	50314626	0	37	5585	4575	5585	4538	0.0	1.2307183781401498
chr14	ATL1	50587830	50588078	0	249	15445	6261	15445	6012	0.0	2.5690286094477712
chr14	ATL1	50620598	50620726	0	129	15445	6261	15445	6132	0.0	2.5187540769732553
chr14	ATL1	50629994	50630009	0	16	15445	6261	15445	6245	0.0	2.4731785428342676
chr14	ATL1	50630931	50631077	0	147	15445	6261	15445	6114	0.0	2.5261694471704286
chr14	ABHD12B	50877951	50878079	0	129	23295	2623	23295	2494	0.0	9.340417000801924
chr14	ABHD12B	50878744	50878847	102	104	23295	2623	23193	2519	0.9807692307692307	9.20722508932116
chr14	GNG2	51877616	51877657	0	42	542	6394	542	6352	0.0	0.08532745591939547
chr14	GNG2	51841505	51841572	0	68	542	6394	542	6326	0.0	0.08567815365159659
chr14	GNG2	51873881	51874082	0	202	542	6394	542	6192	0.0	0.08753229974160207
chr14	GNG2	51939780	51940091	0	312	542	6394	542	6082	0.0	0.08911542255836896
chr14	GNG2	51913008	51913128	0	121	542	6394	542	6273	0.0	0.08640204049099315
chr14	GNG2	51914109	51914274	0	166	542	6394	542	6228	0.0	0.08702633269107257
chr14	RTRAF	51993722	51993822	0	101	0	8295	0	8194	0.0	0.0
chr14	RTRAF	52004193	52004242	0	50	0	8295	0	8245	0.0	0.0
chr14	RTRAF	52004239	52004242	0	4	0	8295	0	8291	0.0	0.0
chr14	PTGDR	52269450	52269541	0	92	0	3051	0	2959	0.0	0.0
chr14	GPR137C	52613670	52613718	0	49	0	6514	0	6465	0.0	0.0
chr14	GPR137C	52596916	52596982	0	67	0	6514	0	6447	0.0	0.0
chr14	PSMC6	52708308	52708388	0	81	330	7350	330	7269	0.0	0.04539826661163846
chr14	PSMC6	52711100	52711168	0	69	330	7350	330	7281	0.0	0.04532344458178822
chr14	PSMC6	52708482	52708522	0	41	330	7350	330	7309	0.0	0.04514981529621015
chr14	PSMC6	52718976	52719038	0	63	330	7350	330	7287	0.0	0.045286125977768626
chr14	AL139317.5	52921589	52921676	0	88	32562	6856	32562	6768	0.0	4.8111702127659575
chr14	AL139317.5	52832236	52832488	0	253	32562	6856	32562	6603	0.0	4.93139482053612
chr14	AL139317.5	52793640	52793710	0	71	32562	6856	32562	6785	0.0	4.7991156963890935
chr14	AL365295.1	53170433	53170501	0	69	95704	14298	95704	14229	0.0	6.725982149132054
chr14	AL365295.1	53188031	53188153	1128	123	95704	14298	94576	14175	9.170731707317072	6.672028218694885
chr14	AL365295.1	53304807	53305053	0	247	95704	14298	95704	14051	0.0	6.811187815813821
chr14	AL365295.1	53313715	53313790	0	76	95704	14298	95704	14222	0.0	6.729292645197582
chr14	AL365295.1	53318030	53318138	0	109	95704	14298	95704	14189	0.0	6.744943265910212
chr14	AL365295.1	53510724	53510879	1089	156	95704	14298	94615	14142	6.980769230769231	6.690354971008344
chr14	CDKN3	54415898	54415930	0	33	5312	1842	5312	1809	0.0	2.9364289662797125
chr14	CDKN3	54399893	54399976	0	84	5312	1842	5312	1758	0.0	3.0216154721274173
chr14	CDKN3	54418213	54418306	0	94	5312	1842	5312	1748	0.0	3.0389016018306636
chr14	CGRRF1	54522453	54522593	0	141	255	4555	255	4414	0.0	0.05777072949705483
chr14	CGRRF1	54523149	54523245	0	97	255	4555	255	4458	0.0	0.05720053835800808
chr14	SAMD4A	54737023	54737287	0	265	153	12348	153	12083	0.0	0.012662418273607548
chr14	SAMD4A	54784339	54784447	0	109	153	12348	153	12239	0.0	0.012501021325271672
chr14	SAMD4A	54784339	54784381	0	43	153	12348	153	12305	0.0	0.012433969930922389
chr14	SOCS4	55031862	55031991	255	130	20350	7048	20095	6918	1.9615384615384615	2.9047412546978895
chr14	MAPK1IP1L	55061679	55061701	2	23	4746	4079	4744	4056	0.08695652173913043	1.1696252465483234
chr14	LGALS3	55137369	55137391	0	23	918	1442	918	1419	0.0	0.6469344608879493
chr14	KTN1	55629956	55630097	240	142	19648	13937	19408	13795	1.6901408450704225	1.406886553098949
chr14	KTN1	55650568	55650637	0	70	19648	13937	19648	13867	0.0	1.4168890170909354
chr14	KTN1	55663954	55664041	0	88	19648	13937	19648	13849	0.0	1.418730594266734
chr14	KTN1	55673171	55673255	0	85	19648	13937	19648	13852	0.0	1.418423332370777
chr14	KTN1	55607345	55607460	0	116	19648	13937	19648	13821	0.0	1.421604804283337
chr14	KTN1	55601756	55601880	0	125	19648	13937	19648	13812	0.0	1.4225311323486822
chr14	KTN1	55680685	55680741	0	57	19648	13937	19648	13880	0.0	1.4155619596541786
chr14	KTN1	55651286	55651375	0	90	19648	13937	19648	13847	0.0	1.4189355094966418
chr14	KTN1	55680664	55680741	0	78	19648	13937	19648	13859	0.0	1.4177069052601199
chr14	AL163952.1	55957154	55957290	0	137	65	3766	65	3629	0.0	0.017911270322402865
chr14	AL163952.1	55962171	55962277	51	107	65	3766	14	3659	0.4766355140186916	0.0038261820169445205
chr14	LINC02284	56317891	56318086	0	196	0	4445	0	4249	0.0	0.0
chr14	LINC02284	56326179	56326225	0	47	0	4445	0	4398	0.0	0.0
chr14	TMEM260	56603814	56603992	0	179	0	8026	0	7847	0.0	0.0
chr14	TMEM260	56617182	56617297	0	116	0	8026	0	7910	0.0	0.0
chr14	TMEM260	56621530	56621702	0	173	0	8026	0	7853	0.0	0.0
chr14	AP5M1	57274243	57274889	0	647	0	12111	0	11464	0.0	0.0
chr14	AP5M1	57273708	57273750	0	43	0	12111	0	12068	0.0	0.0
chr14	NAA30	57399827	57399883	0	57	0	7303	0	7246	0.0	0.0
chr14	NAA30	57390956	57391728	0	773	0	7303	0	6530	0.0	0.0
chr14	ACTR10	58202854	58202927	0	74	0	3657	0	3583	0.0	0.0
chr14	ACTR10	58223782	58223856	0	75	0	3657	0	3582	0.0	0.0
chr14	ACTR10	58207048	58207183	0	136	0	3657	0	3521	0.0	0.0
chr14	ACTR10	58231079	58231153	0	75	0	3657	0	3582	0.0	0.0
chr14	ACTR10	58230398	58230480	0	83	0	3657	0	3574	0.0	0.0
chr14	PSMA3	58247749	58247832	0	84	99	3041	99	2957	0.0	0.03347987825498817
chr14	PSMA3	58252118	58252242	0	125	99	3041	99	2916	0.0	0.033950617283950615
chr14	PSMA3	58252123	58252242	0	120	99	3041	99	2921	0.0	0.03389250256761383
chr14	ARID4A	58301579	58301690	0	112	0	7475	0	7363	0.0	0.0
chr14	ARID4A	58366023	58366230	0	208	0	7475	0	7267	0.0	0.0
chr14	ARID4A	58366023	58366068	0	46	0	7475	0	7429	0.0	0.0
chr14	ARID4A	58303537	58303761	0	225	0	7475	0	7250	0.0	0.0
chr14	TOMM20L	58402679	58402761	0	83	0	614	0	531	0.0	0.0
chr14	KIAA0586	58428237	58428463	0	227	51	17469	51	17242	0.0	0.00295789351583343
chr14	KIAA0586	58441220	58441343	0	124	51	17469	51	17345	0.0	0.0029403286249639667
chr14	KIAA0586	58448339	58448493	0	155	51	17469	51	17314	0.0	0.002945593161603327
chr14	KIAA0586	58459842	58460070	0	229	51	17469	51	17240	0.0	0.0029582366589327148
chr14	KIAA0586	58472198	58472279	0	82	51	17469	51	17387	0.0	0.0029332259734284236
chr14	KIAA0586	58492143	58492275	0	133	51	17469	51	17336	0.0	0.0029418550992155053
chr14	KIAA0586	58543882	58543967	0	86	51	17469	51	17383	0.0	0.0029339009376977507
chr14	KIAA0586	58428271	58428463	0	193	51	17469	51	17276	0.0	0.0029520722389442
chr14	KIAA0586	58540070	58540136	0	67	51	17469	51	17402	0.0	0.0029306976209631077
chr14	KIAA0586	58440069	58440160	0	92	51	17469	51	17377	0.0	0.0029349139667376417
chr14	KIAA0586	58459842	58459909	0	68	51	17469	51	17401	0.0	0.002930866042181484
chr14	KIAA0586	58476688	58476810	0	123	51	17469	51	17346	0.0	0.002940159114493255
chr14	KIAA0586	58495482	58495614	0	133	51	17469	51	17336	0.0	0.0029418550992155053
chr14	KIAA0586	58520710	58520861	0	152	51	17469	51	17317	0.0	0.0029450828665473234
chr14	KIAA0586	58494454	58494524	0	71	51	17469	51	17398	0.0	0.002931371422002529
chr14	LINC01500	58957007	58957115	0	109	26561	6780	26561	6671	0.0	3.9815619847099386
chr14	LINC01500	58948312	58948341	0	30	26561	6780	26561	6750	0.0	3.9349629629629628
chr14	LINC01500	58890323	58890520	204	198	26561	6780	26357	6582	1.0303030303030303	4.004405955636584
chr14	LINC01500	58888797	58888922	0	126	26561	6780	26561	6654	0.0	3.9917342951608057
chr14	LINC01500	59077030	59077099	0	70	26561	6780	26561	6710	0.0	3.958420268256334
chr14	LINC01500	59094554	59094640	0	87	26561	6780	26561	6693	0.0	3.968474525623786
chr14	LINC01500	59077003	59077099	0	97	26561	6780	26561	6683	0.0	3.974412688912165
chr14	LINC01500	59125171	59125402	51	232	26561	6780	26510	6548	0.21982758620689655	4.048564447159438
chr14	LINC01500	59009030	59009150	0	121	26561	6780	26561	6659	0.0	3.9887370476047455
chr14	LINC01500	58958535	58958619	0	85	26561	6780	26561	6695	0.0	3.9672890216579537
chr14	LINC01500	58912520	58912654	0	135	26561	6780	26561	6645	0.0	3.997140707298721
chr14	LINC01500	58848593	58848742	0	150	26561	6780	26561	6630	0.0	4.006184012066365
chr14	LINC01500	58899707	58899856	0	150	26561	6780	26561	6630	0.0	4.006184012066365
chr14	LINC01500	58989533	58989633	0	101	26561	6780	26561	6679	0.0	3.9767929330738134
chr14	LINC01500	58877608	58877692	22262	85	26561	6780	4299	6695	261.90588235294115	0.6421209858103062
chr14	LINC01500	58913762	58913861	100	100	26561	6780	26461	6680	1.0	3.9612275449101797
chr14	DAAM1	59360801	59360862	0	62	51	10736	51	10674	0.0	0.00477796514896009
chr14	DAAM1	59338384	59338414	0	31	51	10736	51	10705	0.0	0.004764128911723494
chr14	JKAMP	59484989	59485116	0	128	0	4049	0	3921	0.0	0.0
chr14	JKAMP	59486730	59486804	0	75	0	4049	0	3974	0.0	0.0
chr14	JKAMP	59486712	59486804	0	93	0	4049	0	3956	0.0	0.0
chr14	LRRC9	60062010	60062179	0	170	5592	5408	5592	5238	0.0	1.0675830469644902
chr14	LRRC9	60053874	60054019	0	146	5592	5408	5592	5262	0.0	1.0627137970353477
chr14	LRRC9	60059060	60059116	0	57	5592	5408	5592	5351	0.0	1.0450383105961503
chr14	PCNX4	60107585	60108327	0	743	0	9442	0	8699	0.0	0.0
chr14	PCNX4	60133655	60133785	0	131	0	9442	0	9311	0.0	0.0
chr14	PPM1A	60277004	60277091	0	88	75	11920	75	11832	0.0	0.006338742393509128
chr14	PPM1A	60250379	60250481	0	103	75	11920	75	11817	0.0	0.0063467885250063465
chr14	PPM1A	60277312	60277365	0	54	75	11920	75	11866	0.0	0.0063205798078543735
chr14	MNAT1	60818721	60818847	0	127	13688	3886	13688	3759	0.0	3.641393987762703
chr14	MNAT1	60968228	60968397	0	170	13688	3886	13688	3716	0.0	3.683530678148547
chr14	SLC38A6	61037058	61037141	0	84	186	4924	186	4840	0.0	0.0384297520661157
chr14	SLC38A6	61043449	61043503	0	55	186	4924	186	4869	0.0	0.03820086260012323
chr14	SLC38A6	60987051	60987157	0	107	186	4924	186	4817	0.0	0.03861324475814822
chr14	SLC38A6	61034018	61034113	0	96	186	4924	186	4828	0.0	0.03852526926263463
chr14	SLC38A6	61052348	61052985	33	638	186	4924	153	4286	0.05172413793103448	0.03569762015865609
chr14	SLC38A6	61048247	61048297	0	51	186	4924	186	4873	0.0	0.038169505438128463
chr14	SLC38A6	61048150	61048297	0	148	186	4924	186	4776	0.0	0.038944723618090454
chr14	PRKCH	61443110	61443261	518	152	32148	8398	31630	8246	3.4078947368421053	3.8357991753577494
chr14	HIF1A	61720381	61720572	0	192	1581	4883	1581	4691	0.0	0.33702835216371774
chr14	HIF1A	61745690	61745817	215	128	1581	4883	1366	4755	1.6796875	0.2872765509989485
chr14	HIF1A	61720378	61720572	0	195	1581	4883	1581	4688	0.0	0.33724402730375425
chr14	SYT16	62079339	62079428	0	90	102	15193	102	15103	0.0	0.006753625107594518
chr14	LINC00643	62118690	62118814	0	125	0	4644	0	4519	0.0	0.0
chr14	SYNE2	64034493	64034592	0	100	47311	32202	47311	32102	0.0	1.4737711046040745
chr14	SYNE2	64120926	64121061	0	136	47311	32202	47311	32066	0.0	1.475425684525666
chr14	SYNE2	64188859	64189009	0	151	47311	32202	47311	32051	0.0	1.4761161898224704
chr14	SYNE2	64128451	64128553	21	103	47311	32202	47290	32099	0.20388349514563106	1.4732546185239415
chr14	SYNE2	64165284	64165410	19331	127	47311	32202	27980	32075	152.21259842519686	0.8723304754481683
chr14	SYNE2	64186423	64186579	0	157	47311	32202	47311	32045	0.0	1.476392572944297
chr14	SYNE2	64190070	64190237	64	168	47311	32202	47247	32034	0.38095238095238093	1.474901666978835
chr14	SYNE2	64215285	64215354	0	70	47311	32202	47311	32132	0.0	1.472395120129466
chr14	SYNE2	64207957	64208192	0	236	47311	32202	47311	31966	0.0	1.4800412938747418
chr14	SYNE2	64202837	64202963	2652	127	47311	32202	44659	32075	20.881889763779526	1.3923304754481685
chr14	MTHFD1	64411089	64411149	0	61	5247	12243	5247	12182	0.0	0.43071745197832867
chr14	MTHFD1	64417887	64418024	0	138	5247	12243	5247	12105	0.0	0.433457249070632
chr14	MTHFD1	64439095	64439172	0	78	5247	12243	5247	12165	0.0	0.4313193588162762
chr14	MTHFD1	64453753	64453861	0	109	5247	12243	5247	12134	0.0	0.43242129553321246
chr14	MTHFD1	64390336	64390467	0	132	5247	12243	5247	12111	0.0	0.4332425068119891
chr14	MTHFD1	64389000	64389125	0	126	5247	12243	5247	12117	0.0	0.4330279772220847
chr14	MTHFD1	64458213	64458307	0	95	5247	12243	5247	12148	0.0	0.4319229502798815
chr14	MTHFD1	64390336	64390791	0	456	5247	12243	5247	11787	0.0	0.4451514380249427
chr14	MTHFD1	64458428	64458597	0	170	5247	12243	5247	12073	0.0	0.43460614594549823
chr14	ZBTB1	64511248	64511384	13	137	876	4941	863	4804	0.0948905109489051	0.17964196502914237
chr14	ZBTB1	64516599	64516751	0	153	876	4941	876	4788	0.0	0.18295739348370926
chr14	PPP1R36	64561787	64562028	0	242	1369	2373	1369	2131	0.0	0.642421398404505
chr14	PPP1R36	64551633	64551687	570	55	1369	2373	799	2318	10.363636363636363	0.3446937014667817
chr14	PLEKHG3	64730242	64730312	0	71	102	11824	102	11753	0.0	0.008678635242065856
chr14	PLEKHG3	64728995	64729093	0	99	102	11824	102	11725	0.0	0.008699360341151386
chr14	CHURC1	64926009	64926080	401	72	12344	5410	11943	5338	5.569444444444445	2.2373548145372797
chr14	CHURC1	64926006	64926080	405	75	12344	5410	11939	5335	5.4	2.237863167760075
chr14	CHURC1-FNTB	65012316	65012389	4	74	2706	2091	2702	2017	0.05405405405405406	1.3396132870599902
chr14	CHURC1	64932137	64932292	500	156	12344	5410	11844	5254	3.2051282051282053	2.25428245146555
chr14	FUT8	65455620	65455718	259	99	34925	6997	34666	6898	2.6161616161616164	5.025514641925196
chr14	FUT8	65561336	65561766	196	431	34925	6997	34729	6566	0.4547563805104408	5.289217179409077
chr14	FUT8	65430215	65430309	29	95	34925	6997	34896	6902	0.30526315789473685	5.055925818603304
chr14	FUT8	65479706	65479784	444	79	34925	6997	34481	6918	5.620253164556962	4.984244001156403
chr14	FUT8	65516242	65516388	0	147	34925	6997	34925	6850	0.0	5.098540145985401
chr14	FUT8	65617089	65617191	0	103	34925	6997	34925	6894	0.0	5.065999419785321
chr14	LINC02290	66120035	66120292	0	258	408	4521	408	4263	0.0	0.09570724841660802
chr14	LINC02290	66125768	66125889	0	122	408	4521	408	4399	0.0	0.09274835189815868
chr14	LINC02290	66126466	66126509	0	44	408	4521	408	4477	0.0	0.0911324547688184
chr14	LINC02290	66117907	66118054	0	148	408	4521	408	4373	0.0	0.09329979419163045
chr14	LINC02290	66123143	66123313	0	171	408	4521	408	4350	0.0	0.09379310344827586
chr14	LINC02290	66122639	66122878	0	240	408	4521	408	4281	0.0	0.09530483531885074
chr14	LINC02290	66120188	66120292	0	105	408	4521	408	4416	0.0	0.09239130434782608
chr14	LINC02290	66112584	66112725	6	142	408	4521	402	4379	0.04225352112676056	0.091801781228591
chr14	LINC02290	66123143	66123180	0	38	408	4521	408	4483	0.0	0.0910104840508588
chr14	CCDC196	66496826	66496867	0	42	51	2841	51	2799	0.0	0.01822079314040729
chr14	CCDC196	66486656	66486809	0	154	51	2841	51	2687	0.0	0.018980275400074433
chr14	CCDC196	66488986	66489037	0	52	51	2841	51	2789	0.0	0.01828612405880244
chr14	CCDC196	66491020	66491104	0	85	51	2841	51	2756	0.0	0.018505079825834544
chr14	CCDC196	66495661	66495771	0	111	51	2841	51	2730	0.0	0.01868131868131868
chr14	CCDC196	66493772	66493943	51	172	51	2841	0	2669	0.29651162790697677	0.0
chr14	CCDC196	66490741	66490819	0	79	51	2841	51	2762	0.0	0.018464880521361332
chr14	CCDC196	66492811	66492900	0	90	51	2841	51	2751	0.0	0.018538713195201745
chr14	GPHN	66776463	66776521	0	59	561	5667	561	5608	0.0	0.10003566333808844
chr14	GPHN	67159414	67159488	0	75	561	5667	561	5592	0.0	0.10032188841201717
chr14	GPHN	66924193	66924292	0	100	561	5667	561	5567	0.0	0.10077240883779415
chr14	GPHN	66824473	66824566	0	94	561	5667	561	5573	0.0	0.10066391530593935
chr14	GPHN	66842677	66842716	0	40	561	5667	561	5627	0.0	0.09969788519637462
chr14	GPHN	66996176	66996218	0	43	561	5667	561	5624	0.0	0.09975106685633002
chr14	GPHN	66709356	66709458	0	103	561	5667	561	5564	0.0	0.10082674335010784
chr14	GPHN	66551040	66551181	0	142	561	5667	561	5525	0.0	0.10153846153846154
chr14	GPHN	66985681	66985738	0	58	561	5667	561	5609	0.0	0.10001782848992691
chr14	FAM71D	67189697	67189754	0	58	1684	4520	1684	4462	0.0	0.3774092335275661
chr14	FAM71D	67208201	67208449	0	249	1684	4520	1684	4271	0.0	0.3942870522125966
chr14	FAM71D	67196953	67197029	0	77	1684	4520	1684	4443	0.0	0.37902318253432365
chr14	FAM71D	67198971	67199130	0	160	1684	4520	1684	4360	0.0	0.38623853211009174
chr14	FAM71D	67201430	67201747	0	318	1684	4520	1684	4202	0.0	0.4007615421227987
chr14	MPP5	67254203	67254310	0	108	1326	14613	1326	14505	0.0	0.09141675284384695
chr14	MPP5	67269700	67269783	0	84	1326	14613	1326	14529	0.0	0.09126574437332233
chr14	ARG2	67645642	67645802	0	161	7350	2292	7350	2131	0.0	3.4490849366494603
chr14	RAD51B	67864787	67864885	0	99	3994	7510	3994	7411	0.0	0.5389286196194846
chr14	RAD51B	68468171	68468250	0	80	3994	7510	3994	7430	0.0	0.537550471063257
chr14	EXD2	69209423	69209803	0	381	51	6278	51	5897	0.0	0.008648465321349838
chr14	EXD2	69203916	69204000	0	85	51	6278	51	6193	0.0	0.0082351041498466
chr14	EXD2	69210111	69210201	0	91	51	6278	51	6187	0.0	0.008243090350735413
chr14	SLC39A9	69441831	69441972	0	142	306	7148	306	7006	0.0	0.04367684841564373
chr14	SLC39A9	69442068	69442266	0	199	306	7148	306	6949	0.0	0.04403511296589437
chr14	SLC39A9	69453240	69453309	0	70	306	7148	306	7078	0.0	0.043232551568239616
chr14	SLC39A9	69458362	69458729	0	368	306	7148	306	6780	0.0	0.04513274336283186
chr14	AL160191.1	70229301	70229569	0	269	51	1116	51	847	0.0	0.0602125147579693
chr14	AL160191.1	70224006	70224197	51	192	51	1116	0	924	0.265625	0.0
chr14	PCNX1	71057508	71057724	357	217	5327	16758	4970	16541	1.6451612903225807	0.30046550994498517
chr14	SIPA1L1	71528698	71528740	0	43	2814	12451	2814	12408	0.0	0.22678916827853
chr14	SIPA1L1	71529311	71529370	0	60	2814	12451	2814	12391	0.0	0.22710031474457268
chr14	SIPA1L1	71698980	71699127	0	148	2814	12451	2814	12303	0.0	0.22872470129236772
chr14	SIPA1L1	71704720	71704783	0	64	2814	12451	2814	12387	0.0	0.227173649794139
chr14	RGS6	72495151	72495262	0	112	0	8860	0	8748	0.0	0.0
chr14	RGS6	72540040	72540094	0	55	0	8860	0	8805	0.0	0.0
chr14	RGS6	72553289	72553356	0	68	0	8860	0	8792	0.0	0.0
chr14	RGS6	72464693	72464717	0	25	0	8860	0	8835	0.0	0.0
chr14	RGS6	72464690	72464717	0	28	0	8860	0	8832	0.0	0.0
chr14	DCAF4	72937970	72938070	0	101	51	5555	51	5454	0.0	0.00935093509350935
chr14	RBM25	73069852	73069920	0	69	2179	11083	2179	11014	0.0	0.1978391138550935
chr14	RBM25	73083493	73083551	28	59	2179	11083	2151	11024	0.4745762711864407	0.19511973875181424
chr14	RBM25	73064971	73065093	0	123	2179	11083	2179	10960	0.0	0.19881386861313868
chr14	RBM25	73088369	73088474	0	106	2179	11083	2179	10977	0.0	0.198505967021955
chr14	PSEN1	73137124	73137223	4031	100	35813	9942	31782	9842	40.31	3.2292217029059134
chr14	PSEN1	73138106	73138152	329	47	35813	9942	35484	9895	7.0	3.586053562405255
chr14	PSEN1	73211768	73211942	0	175	35813	9942	35813	9767	0.0	3.66673492372274
chr14	PSEN1	73139296	73139398	280	103	35813	9942	35533	9839	2.7184466019417477	3.6114442524646813
chr14	PSEN1	73138111	73138152	329	42	35813	9942	35484	9900	7.833333333333333	3.5842424242424245
chr14	PSEN1	73160008	73160138	0	131	35813	9942	35813	9811	0.0	3.650290490266028
chr14	PSEN1	73146077	73146126	0	50	35813	9942	35813	9892	0.0	3.6204003234937323
chr14	PSEN1	73208823	73208915	0	93	35813	9942	35813	9849	0.0	3.636206721494568
chr14	PAPLN	73262349	73262827	357	479	1546	7427	1189	6948	0.7453027139874739	0.17112838226827864
chr14	PAPLN	73251485	73251566	0	82	1546	7427	1546	7345	0.0	0.21048332198774677
chr14	PAPLN	73264009	73264044	0	36	1546	7427	1546	7391	0.0	0.20917331890136653
chr14	PAPLN	73263941	73264044	0	104	1546	7427	1546	7323	0.0	0.21111566297965315
chr14	PAPLN	73262397	73262827	357	431	1546	7427	1189	6996	0.8283062645011601	0.16995425957690108
chr14	DNAL1	73671541	73671597	0	57	12174	8895	12174	8838	0.0	1.3774609640190087
chr14	DNAL1	73658846	73658956	0	111	12174	8895	12174	8784	0.0	1.385928961748634
chr14	DNAL1	73689374	73689515	7186	142	12174	8895	4988	8753	50.605633802816904	0.5698617616817091
chr14	DNAL1	73653169	73653215	0	47	12174	8895	12174	8848	0.0	1.3759041591320071
chr14	DNAL1	73654846	73654885	0	40	12174	8895	12174	8855	0.0	1.374816487859966
chr14	DNAL1	73651166	73651327	0	162	12174	8895	12174	8733	0.0	1.3940226726210925
chr14	DNAL1	73672944	73673091	0	148	12174	8895	12174	8747	0.0	1.3917914713616097
chr14	PTGR2	73879095	73879305	15	211	2692	6154	2677	5943	0.07109004739336493	0.4504459027427225
chr14	ZNF410	73903959	73904110	0	152	508	5246	508	5094	0.0	0.09972516686297606
chr14	ZNF410	73920979	73921105	0	127	508	5246	508	5119	0.0	0.0992381324477437
chr14	ZNF410	73892026	73892208	0	183	508	5246	508	5063	0.0	0.10033576930673514
chr14	ZNF410	73922065	73922206	0	142	508	5246	508	5104	0.0	0.09952978056426333
chr14	ZNF410	73896315	73896534	51	220	508	5246	457	5026	0.2318181818181818	0.09092717867091127
chr14	ZNF410	73896347	73896534	51	188	508	5246	457	5058	0.2712765957446808	0.09035191775405299
chr14	ZNF410	73892026	73892107	0	82	508	5246	508	5164	0.0	0.0983733539891557
chr14	ZNF410	73894358	73894409	0	52	508	5246	508	5194	0.0	0.09780515979976896
chr14	ZNF410	73924701	73924819	0	119	508	5246	508	5127	0.0	0.09908328457187439
chr14	ZNF410	73927106	73927228	0	123	508	5246	508	5123	0.0	0.09916064805777865
chr14	COQ6	73955450	73955509	0	60	194241	5835	194241	5775	0.0	33.634805194805196
chr14	COQ6	73961736	73961903	51	168	194241	5835	194190	5667	0.30357142857142855	34.266807834833244
chr14	BBOF1	74022915	74023144	0	230	1531	4373	1531	4143	0.0	0.369538981414434
chr14	BBOF1	74034027	74034171	0	145	1531	4373	1531	4228	0.0	0.36210974456007566
chr14	BBOF1	74046059	74046130	0	72	1531	4373	1531	4301	0.0	0.3559637293652639
chr14	LIN52	74101154	74101238	0	85	962	3699	962	3614	0.0	0.26618705035971224
chr14	ISCA2	74494274	74494390	0	117	1646	3028	1646	2911	0.0	0.565441429062178
chr14	YLPM1	74797579	74799697	102	2119	14611	14959	14509	12840	0.04813591316658802	1.1299844236760124
chr14	YLPM1	74824255	74824307	0	53	14611	14959	14611	14906	0.0	0.9802093116865692
chr14	DLST	74882590	74882624	0	35	0	4551	0	4516	0.0	0.0
chr14	DLST	74885585	74885634	0	50	0	4551	0	4501	0.0	0.0
chr14	DLST	74889094	74889147	0	54	0	4551	0	4497	0.0	0.0
chr14	DLST	74889896	74889952	0	57	0	4551	0	4494	0.0	0.0
chr14	DLST	74889877	74889952	0	76	0	4551	0	4475	0.0	0.0
chr14	ZC2HC1C	75070554	75071738	51	1185	31516	7841	31465	6656	0.043037974683544304	4.727313701923077
chr14	ZC2HC1C	75070554	75071396	0	843	31516	7841	31516	6998	0.0	4.50357244927122
chr14	ZC2HC1C	75070554	75071911	51	1358	31516	7841	31465	6483	0.03755522827687776	4.853462902977017
chr14	ZC2HC1C	75073570	75073635	0	66	31516	7841	31516	7775	0.0	4.053504823151125
chr14	FOS	75280559	75280667	9	109	14859	3005	14850	2896	0.08256880733944955	5.127762430939226
chr14	LINC01220	75294676	75294737	204	62	3869	1982	3665	1920	3.2903225806451615	1.9088541666666667
chr14	FLVCR2	75624611	75624752	0	142	4138	4925	4138	4783	0.0	0.865147397031152
chr14	FLVCR2	75633628	75633696	0	69	4138	4925	4138	4856	0.0	0.8521416803953872
chr14	FLVCR2	75634909	75635013	408	105	4138	4925	3730	4820	3.8857142857142857	0.7738589211618258
chr14	TTLL5	75737565	75737607	0	43	1016	12313	1016	12270	0.0	0.08280358598207009
chr14	TTLL5	75757830	75757869	0	40	1016	12313	1016	12273	0.0	0.08278334555528395
chr14	IFT43	75986125	75986308	0	184	51	3897	51	3713	0.0	0.013735523835173714
chr14	IFT43	76076596	76076691	0	96	51	3897	51	3801	0.0	0.013417521704814523
chr14	IFT43	75986125	75986282	0	158	51	3897	51	3739	0.0	0.013640010698047607
chr14	GPATCH2L	76178207	76178322	0	116	15297	20948	15297	20832	0.0	0.7343029953917051
chr14	GPATCH2L	76152535	76152580	0	46	15297	20948	15297	20902	0.0	0.731843842694479
chr14	ESRRB	76498725	76498912	0	188	1764	4153	1764	3965	0.0	0.44489281210592685
chr14	LRRC74A	76837874	76837971	0	98	40	2320	40	2222	0.0	0.018001800180018002
chr14	LRRC74A	76829090	76829163	0	74	40	2320	40	2246	0.0	0.017809439002671415
chr14	CIPC	77109811	77109981	0	171	51	5238	51	5067	0.0	0.010065127294256957
chr14	CIPC	77099883	77099961	0	79	51	5238	51	5159	0.0	0.009885636751308394
chr14	TMEM63C	77212253	77212313	0	61	38084	6216	38084	6155	0.0	6.18748984565394
chr14	GSTZ1	77322546	77322732	0	187	0	5473	0	5286	0.0	0.0
chr14	GSTZ1	77327471	77327552	0	82	0	5473	0	5391	0.0	0.0
chr14	GSTZ1	77327911	77328037	0	127	0	5473	0	5346	0.0	0.0
chr14	GSTZ1	77324869	77324921	0	53	0	5473	0	5420	0.0	0.0
chr14	GSTZ1	77327471	77327510	0	40	0	5473	0	5433	0.0	0.0
chr14	AHSA1	77468456	77468508	0	53	11	2865	11	2812	0.0	0.0039118065433854906
chr14	SLIRP	77715771	77715879	0	109	830	2452	830	2343	0.0	0.3542466922748613
chr14	SLIRP	77710554	77710665	0	112	830	2452	830	2340	0.0	0.3547008547008547
chr14	SLIRP	77733936	77734046	0	111	830	2452	830	2341	0.0	0.3545493378897907
chr14	C14ORF178	77768451	77768465	0	15	878	703	878	688	0.0	1.2761627906976745
chr14	C14ORF178	77768451	77768523	0	73	878	703	878	630	0.0	1.3936507936507936
chr14	ADCK1	77859075	77859279	0	205	322993	4083	322993	3878	0.0	83.28855079938113
chr14	ADCK1	77887090	77887249	0	160	322993	4083	322993	3923	0.0	82.3331633953607
chr14	ADCK1	77907802	77907919	0	118	322993	4083	322993	3965	0.0	81.4610340479193
chr14	ADCK1	77827853	77827971	26	119	322993	4083	322967	3964	0.2184873949579832	81.47502522704339
chr14	ADCK1	77900558	77900674	3884	117	322993	4083	319109	3966	33.1965811965812	80.46116994452849
chr14	NRXN3	78278644	78278662	0	19	255	14947	255	14928	0.0	0.017081993569131832
chr14	NRXN3	78300679	78300691	0	13	255	14947	255	14934	0.0	0.017075130574527923
chr14	NRXN3	78810317	78810344	0	28	255	14947	255	14919	0.0	0.017092298411421677
chr14	NRXN3	79692172	79692262	0	91	255	14947	255	14856	0.0	0.017164781906300483
chr14	NRXN3	79853538	79854217	0	680	255	14947	255	14267	0.0	0.017873414172566063
chr14	NRXN3	78649267	78649291	0	25	255	14947	255	14922	0.0	0.01708886208283072
chr14	NRXN3	78972882	78972909	0	28	255	14947	255	14919	0.0	0.017092298411421677
chr14	NRXN3	79854069	79854217	0	149	255	14947	255	14798	0.0	0.017232058386268415
chr14	AL355838.1	81777757	81777914	0	158	0	2374	0	2216	0.0	0.0
chr14	AL355838.1	81768419	81768548	0	130	0	2374	0	2244	0.0	0.0
chr14	AL355838.1	81795667	81795729	0	63	0	2374	0	2311	0.0	0.0
chr14	LINC02301	82654347	82654400	0	54	0	6218	0	6164	0.0	0.0
chr14	LINC02301	82656425	82656457	0	33	0	6218	0	6185	0.0	0.0
chr14	LINC02301	82685379	82685431	0	53	0	6218	0	6165	0.0	0.0
chr14	LINC02301	82680150	82680368	0	219	0	6218	0	5999	0.0	0.0
chr14	LINC00911	85407902	85408036	0	135	0	1755	0	1620	0.0	0.0
chr14	LINC02328	86035713	86035815	0	103	0	4788	0	4685	0.0	0.0
chr14	LINC02328	86128664	86128773	0	110	0	4788	0	4678	0.0	0.0
chr14	LINC02328	86028368	86028458	0	91	0	4788	0	4697	0.0	0.0
chr14	LINC02328	86041725	86041833	0	109	0	4788	0	4679	0.0	0.0
chr14	LINC02328	86128714	86128773	0	60	0	4788	0	4728	0.0	0.0
chr14	LINC02328	86000860	86000953	0	94	0	4788	0	4694	0.0	0.0
chr14	LINC01146	88025406	88025481	0	76	0	9300	0	9224	0.0	0.0
chr14	LINC01146	88079103	88079368	0	266	0	9300	0	9034	0.0	0.0
chr14	LINC01146	88084036	88084155	0	120	0	9300	0	9180	0.0	0.0
chr14	LINC01146	88044614	88044848	0	235	0	9300	0	9065	0.0	0.0
chr14	LINC01146	88044685	88044848	0	164	0	9300	0	9136	0.0	0.0
chr14	LINC01146	88086827	88087023	0	197	0	9300	0	9103	0.0	0.0
chr14	LINC01146	88090022	88090210	0	189	0	9300	0	9111	0.0	0.0
chr14	LINC01146	88086873	88087037	0	165	0	9300	0	9135	0.0	0.0
chr14	LINC01146	88037350	88037439	0	90	0	9300	0	9210	0.0	0.0
chr14	LINC01146	88086827	88087037	0	211	0	9300	0	9089	0.0	0.0
chr14	LINC01146	88084983	88085036	0	54	0	9300	0	9246	0.0	0.0
chr14	LINC01146	88091335	88091652	0	318	0	9300	0	8982	0.0	0.0
chr14	LINC01146	88091335	88091449	0	115	0	9300	0	9185	0.0	0.0
chr14	LINC01146	88084986	88085036	0	51	0	9300	0	9249	0.0	0.0
chr14	LINC01146	88084036	88084483	0	448	0	9300	0	8852	0.0	0.0
chr14	AL133279.1	88178466	88178601	0	136	0	612	0	476	0.0	0.0
chr14	SPATA7	88391380	88391455	0	76	2237	6106	2237	6030	0.0	0.37097844112769485
chr14	SPATA7	88415204	88415266	51	63	2237	6106	2186	6043	0.8095238095238095	0.3617408571901373
chr14	SPATA7	88393392	88393488	0	97	2237	6106	2237	6009	0.0	0.37227492095190545
chr14	SPATA7	88391597	88391758	0	162	2237	6106	2237	5944	0.0	0.37634589502018845
chr14	SPATA7	88414673	88414732	0	60	2237	6106	2237	6046	0.0	0.36999669202778696
chr14	SPATA7	88406682	88406736	0	55	2237	6106	2237	6051	0.0	0.3696909601718724
chr14	ZC3H14	88563650	88563693	0	44	0	20176	0	20132	0.0	0.0
chr14	ZC3H14	88568038	88568153	0	116	0	20176	0	20060	0.0	0.0
chr14	ZC3H14	88571083	88571124	0	42	0	20176	0	20134	0.0	0.0
chr14	ZC3H14	88567857	88568153	0	297	0	20176	0	19879	0.0	0.0
chr14	ZC3H14	88596733	88596808	0	76	0	20176	0	20100	0.0	0.0
chr14	ZC3H14	88567857	88567916	0	60	0	20176	0	20116	0.0	0.0
chr14	TTC8	88836907	88837066	0	160	0	6251	0	6091	0.0	0.0
chr14	TTC8	88841424	88841514	0	91	0	6251	0	6160	0.0	0.0
chr14	TTC8	88843805	88843850	0	46	0	6251	0	6205	0.0	0.0
chr14	TTC8	88852970	88853056	0	87	0	6251	0	6164	0.0	0.0
chr14	TTC8	88875025	88875109	0	85	0	6251	0	6166	0.0	0.0
chr14	TTC8	88833692	88833722	0	31	0	6251	0	6220	0.0	0.0
chr14	TTC8	88846597	88846675	0	79	0	6251	0	6172	0.0	0.0
chr14	TDP1	89964850	89964938	0	89	204	6245	204	6156	0.0	0.03313840155945419
chr14	TDP1	89975780	89975815	0	36	204	6245	204	6209	0.0	0.03285553229183443
chr14	TDP1	90033105	90033214	0	110	204	6245	204	6135	0.0	0.033251833740831294
chr14	TDP1	89956577	89956800	0	224	204	6245	204	6021	0.0	0.03388141504733433
chr14	TDP1	89963107	89963673	0	567	204	6245	204	5678	0.0	0.03592814371257485
chr14	TDP1	90023031	90023077	0	47	204	6245	204	6198	0.0	0.03291384317521781
chr14	TDP1	89983113	89983276	0	164	204	6245	204	6081	0.0	0.033547113961519485
chr14	TDP1	89986985	89987042	0	58	204	6245	204	6187	0.0	0.03297236140294165
chr14	TDP1	89981462	89981560	0	99	204	6245	204	6146	0.0	0.03319232020826554
chr14	PSMC1	90260114	90260211	0	98	18886	5390	18886	5292	0.0	3.568783068783069
chr14	CALM1	90403861	90403968	0	108	5033	7087	5033	6979	0.0	0.7211634904714143
chr14	CALM1	90398990	90399087	0	98	5033	7087	5033	6989	0.0	0.7201316354270997
chr14	LINC00642	90456441	90456551	102	111	23015	5124	22913	5013	0.918918918918919	4.570716138041093
chr14	LINC00642	90456130	90456254	0	125	23015	5124	23015	4999	0.0	4.6039207841568315
chr14	DGLUCY	91147780	91147858	51	79	10229	7243	10178	7164	0.6455696202531646	1.42071468453378
chr14	DGLUCY	91170002	91170186	0	185	10229	7243	10229	7058	0.0	1.4492774156984982
chr14	DGLUCY	91145220	91145313	0	94	10229	7243	10229	7149	0.0	1.4308294866414883
chr14	DGLUCY	91170002	91170201	0	200	10229	7243	10229	7043	0.0	1.4523640494107624
chr14	DGLUCY	91157638	91157690	0	53	10229	7243	10229	7190	0.0	1.4226703755215577
chr14	DGLUCY	91204705	91204825	51	121	10229	7243	10178	7122	0.4214876033057851	1.429092951418141
chr14	DGLUCY	91158855	91158972	0	118	10229	7243	10229	7125	0.0	1.4356491228070176
chr14	DGLUCY	91185469	91185575	0	107	10229	7243	10229	7136	0.0	1.4334360986547086
chr14	DGLUCY	91165246	91165337	0	92	10229	7243	10229	7151	0.0	1.430429310585932
chr14	DGLUCY	91173663	91173753	0	91	10229	7243	10229	7152	0.0	1.4302293064876956
chr14	DGLUCY	91148573	91148852	0	280	10229	7243	10229	6963	0.0	1.4690506965388481
chr14	DGLUCY	91128777	91128912	0	136	10229	7243	10229	7107	0.0	1.4392852117630506
chr14	DGLUCY	91223678	91223795	0	118	10229	7243	10229	7125	0.0	1.4356491228070176
chr14	DGLUCY	91204705	91204867	51	163	10229	7243	10178	7080	0.3128834355828221	1.4375706214689266
chr14	AL135818.1	91247489	91247659	0	171	0	2091	0	1920	0.0	0.0
chr14	AL135818.1	91243912	91243981	0	70	0	2091	0	2021	0.0	0.0
chr14	CPSF2	92134010	92134170	0	161	51	13579	51	13418	0.0	0.003800864510359219
chr14	CPSF2	92156478	92156631	0	154	51	13579	51	13425	0.0	0.003798882681564246
chr14	SLC24A4	92492826	92492924	19764	99	52562	14801	32798	14702	199.63636363636363	2.230852945177527
chr14	RIN3	92615406	92615479	0	74	7198	5916	7198	5842	0.0	1.2321122903115371
chr14	GOLGA5	92837385	92837449	0	65	51	3218	51	3153	0.0	0.016175071360608945
chr14	CHGA	92924198	92924245	0	48	0	3033	0	2985	0.0	0.0
chr14	CHGA	92926604	92926698	0	95	0	3033	0	2938	0.0	0.0
chr14	CHGA	92931249	92931702	0	454	0	3033	0	2579	0.0	0.0
chr14	UBR7	93212031	93212127	0	97	5623	3520	5623	3423	0.0	1.6427110721589249
chr14	AL110118.1	93186259	93186482	0	224	5541	929	5541	705	0.0	7.859574468085106
chr14	UBR7	93209823	93209957	0	135	5623	3520	5623	3385	0.0	1.661152141802068
chr14	UBR7	93219211	93219361	0	151	5623	3520	5623	3369	0.0	1.6690412585336896
chr14	UNC79	93634520	93634637	0	118	107664	11440	107664	11322	0.0	9.509273979862215
chr14	UNC79	93604895	93604961	0	67	107664	11440	107664	11373	0.0	9.466631495647587
chr14	FAM181A	93925047	93925370	0	324	0	2123	0	1799	0.0	0.0
chr14	CCDC197	93999336	93999460	0	125	0	2717	0	2592	0.0	0.0
chr14	CCDC197	94000830	94000930	0	101	0	2717	0	2616	0.0	0.0
chr14	IFI27L1	94101813	94101975	0	163	0	2366	0	2203	0.0	0.0
chr14	IFI27L1	94097491	94097678	0	188	0	2366	0	2178	0.0	0.0
chr14	IFI27L1	94101813	94102059	0	247	0	2366	0	2119	0.0	0.0
chr14	IFI27L1	94088247	94088303	0	57	0	2366	0	2309	0.0	0.0
chr14	IFI27L1	94097494	94097678	0	185	0	2366	0	2181	0.0	0.0
chr14	IFI27L1	94100738	94100771	0	34	0	2366	0	2332	0.0	0.0
chr14	IFI27L1	94094749	94094899	0	151	0	2366	0	2215	0.0	0.0
chr14	IFI27	94111658	94111773	0	116	0	3825	0	3709	0.0	0.0
chr14	IFI27	94114850	94114880	0	31	0	3825	0	3794	0.0	0.0
chr14	IFI27	94110925	94110978	0	54	0	3825	0	3771	0.0	0.0
chr14	IFI27	94111624	94111773	0	150	0	3825	0	3675	0.0	0.0
chr14	IFI27	94116073	94116294	0	222	0	3825	0	3603	0.0	0.0
chr14	PPP4R4	94227274	94227378	0	105	0	5004	0	4899	0.0	0.0
chr14	SERPINA5	94581614	94581638	50	25	2600	3760	2550	3735	2.0	0.6827309236947792
chr14	SERPINA5	94581614	94581710	68	97	2600	3760	2532	3663	0.7010309278350515	0.6912366912366913
chr14	SERPINA5	94586845	94586983	0	139	2600	3760	2600	3621	0.0	0.7180336923501796
chr14	SERPINA3	94619194	94619468	0	275	102	5005	102	4730	0.0	0.02156448202959831
chr14	SERPINA3	94614433	94615084	0	652	102	5005	102	4353	0.0	0.02343211578221916
chr14	LINC02292	95332644	95332784	0	141	0	3162	0	3021	0.0	0.0
chr14	LINC02292	95321079	95321179	0	101	0	3162	0	3061	0.0	0.0
chr14	LINC02292	95331262	95331517	0	256	0	3162	0	2906	0.0	0.0
chr14	LINC02292	95331262	95331645	0	384	0	3162	0	2778	0.0	0.0
chr14	LINC02318	95577428	95577605	0	178	5164	2840	5164	2662	0.0	1.9398948159278737
chr14	LINC02318	95580469	95580611	0	143	5164	2840	5164	2697	0.0	1.914720059325176
chr14	LINC02318	95580469	95580651	0	183	5164	2840	5164	2657	0.0	1.9435453519006398
chr14	LINC02318	95577428	95577696	327	269	5164	2840	4837	2571	1.2156133828996283	1.8813691170750682
chr14	LINC02318	95577432	95577605	0	174	5164	2840	5164	2666	0.0	1.9369842460615154
chr14	AL133467.2	95639952	95640148	0	197	1989	1929	1989	1732	0.0	1.1483833718244805
chr14	AL133467.2	95626219	95626344	0	126	1989	1929	1989	1803	0.0	1.103161397670549
chr14	TCL6	95662479	95662664	0	186	2040	10388	2040	10202	0.0	0.19996079200156833
chr14	TCL6	95663255	95663635	102	381	2040	10388	1938	10007	0.2677165354330709	0.1936644348955731
chr14	TCL6	95670441	95670577	0	137	2040	10388	2040	10251	0.0	0.19900497512437812
chr14	TCL6	95668125	95668580	0	456	2040	10388	2040	9932	0.0	0.2053966975432944
chr14	TCL6	95669550	95669617	0	68	2040	10388	2040	10320	0.0	0.19767441860465115
chr14	AL133467.3	95688178	95688274	0	97	102	3681	102	3584	0.0	0.028459821428571428
chr14	TUNAR	95895810	95895943	0	134	14529	3636	14529	3502	0.0	4.148772130211308
chr14	C14ORF132	96051123	96051222	0	100	0	1112	0	1012	0.0	0.0
chr14	C14ORF132	96040274	96040367	0	94	0	1112	0	1018	0.0	0.0
chr14	BDKRB2	96239695	96239861	0	167	0	4328	0	4161	0.0	0.0
chr14	GSKIP	96378937	96379059	0	123	0	4558	0	4435	0.0	0.0
chr14	GSKIP	96379687	96379755	0	69	0	4558	0	4489	0.0	0.0
chr14	GSKIP	96379687	96379788	0	102	0	4558	0	4456	0.0	0.0
chr14	PAPOLA	96525309	96525391	0	83	29336	10053	29336	9970	0.0	2.9424272818455366
chr14	PAPOLA	96527429	96527539	0	111	29336	10053	29336	9942	0.0	2.9507141420237377
chr14	PAPOLA	96547796	96547918	0	123	29336	10053	29336	9930	0.0	2.954279959718026
chr14	PAPOLA	96560648	96560711	87	64	29336	10053	29249	9989	1.359375	2.928120933026329
chr14	PAPOLA	96562818	96562893	0	76	29336	10053	29336	9977	0.0	2.9403628345193944
chr14	PAPOLA	96527952	96528006	0	55	29336	10053	29336	9998	0.0	2.9341868373674735
chr14	AL137786.1	96593489	96593699	0	211	102	2863	102	2652	0.0	0.038461538461538464
chr14	AL137786.1	96593120	96593249	0	130	102	2863	102	2733	0.0	0.03732162458836443
chr14	AL137786.1	96593489	96593579	0	91	102	2863	102	2772	0.0	0.0367965367965368
chr14	AL137786.1	96594663	96594881	0	219	102	2863	102	2644	0.0	0.038577912254160365
chr14	AL137786.1	96594663	96594949	0	287	102	2863	102	2576	0.0	0.039596273291925464
chr14	AL137786.1	96593489	96593695	0	207	102	2863	102	2656	0.0	0.038403614457831324
chr14	LINC02299	96781511	96781615	198	105	1218	1611	1020	1506	1.8857142857142857	0.6772908366533864
chr14	LINC02299	96790371	96790460	0	90	1218	1611	1218	1521	0.0	0.8007889546351085
chr14	VRK1	96877501	96877573	0	73	17432	2678	17432	2605	0.0	6.691746641074856
chr14	LINC02325	97525673	97525818	0	146	897	5246	897	5100	0.0	0.17588235294117646
chr14	LINC02325	97580446	97580635	30	190	897	5246	867	5056	0.15789473684210525	0.17147943037974683
chr14	LINC02325	97536637	97536678	0	42	897	5246	897	5204	0.0	0.1723674096848578
chr14	LINC02325	97557416	97557481	0	66	897	5246	897	5180	0.0	0.17316602316602317
chr14	LINC02325	97466495	97466618	0	124	897	5246	897	5122	0.0	0.1751269035532995
chr14	C14ORF177	98712325	98712495	0	171	0	1421	0	1250	0.0	0.0
chr14	C14ORF177	98715000	98715132	0	133	0	1421	0	1288	0.0	0.0
chr14	CCNK	99501355	99501413	0	59	0	5576	0	5517	0.0	0.0
chr14	CCNK	99491945	99492320	0	376	0	5576	0	5200	0.0	0.0
chr14	CYP46A1	99695431	99695474	0	44	55	9376	55	9332	0.0	0.00589369909987141
chr14	EML1	99907637	99907733	0	97	4718	8834	4718	8737	0.0	0.5400022891152569
chr14	EML1	99874930	99874987	264	58	4718	8834	4454	8776	4.551724137931035	0.5075205104831358
chr14	EML1	99850123	99850332	0	210	4718	8834	4718	8624	0.0	0.547077922077922
chr14	EVL	100123538	100123602	0	65	5873	8146	5873	8081	0.0	0.7267664892958792
chr14	EVL	100137739	100137802	0	64	5873	8146	5873	8082	0.0	0.726676565206632
chr14	EVL	100074502	100074615	0	114	5873	8146	5873	8032	0.0	0.7312001992031872
chr14	EVL	100102303	100102379	0	77	5873	8146	5873	8069	0.0	0.7278473168918081
chr14	EVL	100134652	100134867	0	216	5873	8146	5873	7930	0.0	0.7406052963430012
chr14	EVL	100139333	100139369	0	37	5873	8146	5873	8109	0.0	0.724256998396843
chr14	YY1	100274697	100274758	0	62	408	7106	408	7044	0.0	0.05792163543441227
chr14	YY1	100276489	100276648	0	160	408	7106	408	6946	0.0	0.05873884249928016
chr14	YY1	100275942	100276074	0	133	408	7106	408	6973	0.0	0.058511401118600315
chr14	WDR25	100468020	100468168	0	149	25387	4230	25387	4081	0.0	6.220779220779221
chr14	WDR25	100380909	100381746	11366	838	25387	4230	14021	3392	13.563245823389021	4.133549528301887
chr14	LINC00523	100669320	100669446	270	127	4665	3347	4395	3220	2.125984251968504	1.3649068322981366
chr14	LINC00523	100667230	100667531	0	302	4665	3347	4665	3045	0.0	1.5320197044334976
chr14	MEG3	100832511	100832641	262	131	138632	9744	138370	9613	2.0	14.394049724331634
chr14	MEG3	100831420	100831534	510	115	138632	9744	138122	9629	4.434782608695652	14.344376363069893
chr14	MEG3	100859790	100859884	0	95	138632	9744	138632	9649	0.0	14.36749922271738
chr14	MEG3	100831015	100831094	102	80	138632	9744	138530	9664	1.275	14.3346440397351
chr14	MEG3	100857338	100857388	0	51	138632	9744	138632	9693	0.0	14.302279995873311
chr14	MEG3	100835735	100835879	612	145	138632	9744	138020	9599	4.220689655172414	14.378581102198146
chr14	MEG3	100835738	100835879	612	142	138632	9744	138020	9602	4.309859154929577	14.374088731514268
chr14	MEG3	100855890	100856268	0	379	138632	9744	138632	9365	0.0	14.80320341697811
chr14	MEG3	100834631	100834751	765	121	138632	9744	137867	9623	6.322314049586777	14.326821157643147
chr14	MEG3	100836041	100836075	70	35	138632	9744	138562	9709	2.0	14.271500669481924
chr14	MEG3	100832511	100832559	58	49	138632	9744	138574	9695	1.183673469387755	14.29334708612687
chr14	MEG3	100834683	100834751	765	69	138632	9744	137867	9675	11.08695652173913	14.249819121447029
chr14	MEG3	100835369	100835549	46332	181	138632	9744	92300	9563	255.97790055248618	9.651782913311722
chr14	MEG3	100857647	100857797	0	151	138632	9744	138632	9593	0.0	14.451370791201919
chr14	MEG3	100830967	100831094	102	128	138632	9744	138530	9616	0.796875	14.406198003327788
chr14	MEG3	100836044	100836075	64	32	138632	9744	138568	9712	2.0	14.267710049423394
chr14	MEG8	100897592	100897732	0	141	16860	24817	16860	24676	0.0	0.6832549846004214
chr14	MEG8	100936177	100936310	0	134	16860	24817	16860	24683	0.0	0.683061216221691
chr14	MEG8	100977604	100977722	0	119	16860	24817	16860	24698	0.0	0.6826463681269739
chr14	MEG8	100989693	100989780	0	88	16860	24817	16860	24729	0.0	0.6817906102147276
chr14	MEG8	100991490	100991565	0	76	16860	24817	16860	24741	0.0	0.681459924821147
chr14	MEG8	100970735	100970814	0	80	16860	24817	16860	24737	0.0	0.681570117637547
chr14	MEG8	100999026	100999113	0	88	16860	24817	16860	24729	0.0	0.6817906102147276
chr14	MEG8	100977604	100977694	0	91	16860	24817	16860	24726	0.0	0.681873331715603
chr14	MEG9	101071804	101071991	0	188	0	3139	0	2951	0.0	0.0
chr14	PPP2R5C	101883256	101883349	0	94	153	13164	153	13070	0.0	0.0117061973986228
chr14	PPP2R5C	101883431	101883562	0	132	153	13164	153	13032	0.0	0.011740331491712707
chr14	PPP2R5C	101906401	101906529	0	129	153	13164	153	13035	0.0	0.011737629459148446
chr14	PPP2R5C	101917830	101917947	0	118	153	13164	153	13046	0.0	0.011727732638356584
chr14	PPP2R5C	101831700	101831804	0	105	153	13164	153	13059	0.0	0.01171605789110958
chr14	PPP2R5C	101824013	101824169	0	157	153	13164	153	13007	0.0	0.011762896901668332
chr14	PPP2R5C	101909588	101909690	0	103	153	13164	153	13061	0.0	0.01171426383890973
chr14	PPP2R5C	101914174	101914572	0	399	153	13164	153	12765	0.0	0.011985898942420681
chr14	DYNC1H1	102027173	102027288	0	116	44258	31680	44258	31564	0.0	1.40216702572551
chr14	DYNC1H1	102038459	102038606	0	148	44258	31680	44258	31532	0.0	1.4035900038056577
chr14	WDR20	102194937	102195120	0	184	0	7270	0	7086	0.0	0.0
chr14	WDR20	102208602	102209862	0	1261	0	7270	0	6009	0.0	0.0
chr14	WDR20	102197754	102197847	0	94	0	7270	0	7176	0.0	0.0
chr14	WDR20	102193462	102193514	0	53	0	7270	0	7217	0.0	0.0
chr14	WDR20	102193462	102193475	0	14	0	7270	0	7256	0.0	0.0
chr14	ZNF839	102331621	102331846	0	226	1596	5405	1596	5179	0.0	0.308167599922765
chr14	ZNF839	102335688	102335838	0	151	1596	5405	1596	5254	0.0	0.30376855728968405
chr14	ZNF839	102336634	102336719	96	86	1596	5405	1500	5319	1.1162790697674418	0.2820078962210942
chr14	RCOR1	102721319	102721377	765	59	43695	6211	42930	6152	12.966101694915254	6.978218465539662
chr14	TRAF3	102830333	102830472	228	140	27908	8305	27680	8165	1.6285714285714286	3.3900796080832825
chr14	TRAF3	102889559	102889634	0	76	27908	8305	27908	8229	0.0	3.391420585733382
chr14	TRAF3	102886188	102886269	153	82	27908	8305	27755	8223	1.8658536585365855	3.3752888240301595
chr14	TRAF3	102895072	102895199	0	128	27908	8305	27908	8177	0.0	3.412987648281766
chr14	TRAF3	102891324	102891417	3256	94	27908	8305	24652	8211	34.638297872340424	3.002313969065887
chr14	EXOC3L4	103102117	103102772	0	656	868	3142	868	2486	0.0	0.3491552695092518
chr14	EXOC3L4	103104737	103104838	0	102	868	3142	868	3040	0.0	0.2855263157894737
chr14	TNFAIP2	103127004	103127629	0	626	852	3893	852	3267	0.0	0.26078971533516987
chr14	TNFAIP2	103129739	103129854	87	116	852	3893	765	3777	0.75	0.20254169976171565
chr14	TNFAIP2	103133361	103133517	0	157	852	3893	852	3736	0.0	0.22805139186295503
chr14	TNFAIP2	103124374	103124506	0	133	852	3893	852	3760	0.0	0.22659574468085106
chr14	EIF5	103334388	103334597	0	210	58325	6699	58325	6489	0.0	8.988287871783017
chr14	EIF5	103336035	103336117	0	83	58325	6699	58325	6616	0.0	8.81574969770254
chr14	MARK3	103405075	103405267	351	193	68861	15808	68510	15615	1.8186528497409327	4.387447966698687
chr14	MARK3	103428386	103428440	91	55	68861	15808	68770	15753	1.6545454545454545	4.365517679172221
chr14	MARK3	103448918	103448967	150	50	68861	15808	68711	15758	3.0	4.360388374159157
chr14	MARK3	103451917	103451983	0	67	68861	15808	68861	15741	0.0	4.374626770853186
chr14	MARK3	103457141	103457212	247	72	68861	15808	68614	15736	3.4305555555555554	4.360320284697509
chr14	MARK3	103465556	103465793	102	238	68861	15808	68759	15570	0.42857142857142855	4.4161207450224795
chr14	MARK3	103490951	103491107	0	157	68861	15808	68861	15651	0.0	4.3997827614848894
chr14	MARK3	103500155	103500200	0	46	68861	15808	68861	15762	0.0	4.36879837584063
chr14	MARK3	103441469	103441563	0	95	68861	15808	68861	15713	0.0	4.382422198179851
chr14	MARK3	103411644	103411749	1427	106	68861	15808	67434	15702	13.462264150943396	4.2946121513183035
chr14	MARK3	103491776	103492034	0	259	68861	15808	68861	15549	0.0	4.428644928934337
chr14	MARK3	103498501	103498528	0	28	68861	15808	68861	15780	0.0	4.36381495564005
chr14	MARK3	103498826	103498901	25	76	68861	15808	68836	15732	0.32894736842105265	4.375540300025426
chr14	MARK3	103490977	103491107	0	131	68861	15808	68861	15677	0.0	4.392485807233527
chr14	MARK3	103489052	103491107	64	2056	68861	15808	68797	13752	0.0311284046692607	5.002690517742874
chr14	MARK3	103487378	103487707	0	330	68861	15808	68861	15478	0.0	4.448959813929449
chr14	MARK3	103438020	103438333	10755	314	68861	15808	58106	15494	34.2515923566879	3.750225893894411
chr14	MARK3	103386040	103386080	316	41	68861	15808	68545	15767	7.7073170731707314	4.347371091520264
chr14	MARK3	103438024	103438333	10755	310	68861	15808	58106	15498	34.693548387096776	3.7492579687701637
chr14	MARK3	103438184	103438333	10755	150	68861	15808	58106	15658	71.7	3.7109464810320603
chr14	MARK3	103429192	103429373	0	182	68861	15808	68861	15626	0.0	4.406821963394343
chr14	MARK3	103411644	103411765	1466	122	68861	15808	67395	15686	12.01639344262295	4.29650643886268
chr14	MARK3	103458726	103458795	0	70	68861	15808	68861	15738	0.0	4.3754606684458
chr14	MARK3	103398950	103399041	26773	92	68861	15808	42088	15716	291.0108695652174	2.678035123441079
chr14	TRMT61A	103529949	103530309	0	361	51	3221	51	2860	0.0	0.01783216783216783
chr14	COA8	103574106	103574170	0	65	102	3927	102	3862	0.0	0.02641118591403418
chr14	KLC1	103684985	103685036	0	52	153	18950	153	18898	0.0	0.00809609482484919
chr14	COA8	103571622	103571820	0	199	102	3927	102	3728	0.0	0.02736051502145923
chr14	COA8	103581568	103581656	0	89	102	3927	102	3838	0.0	0.026576341844710787
chr14	COA8	103563214	103563379	0	166	102	3927	102	3761	0.0	0.027120446689710184
chr14	COA8	103588233	103588283	0	51	102	3927	102	3876	0.0	0.02631578947368421
chr14	COA8	103579370	103579491	0	122	102	3927	102	3805	0.0	0.026806833114323258
chr14	KLC1	103692358	103692425	0	68	153	18950	153	18882	0.0	0.008102955195424213
chr14	KLC1	103687080	103687211	0	132	153	18950	153	18818	0.0	0.008130513338293123
chr14	KLC1	103693552	103693634	0	83	153	18950	153	18867	0.0	0.008109397360470663
chr14	ZFYVE21	103728907	103728983	0	77	39	5715	39	5638	0.0	0.006917346576800284
chr14	ZFYVE21	103729792	103729846	0	55	39	5715	39	5660	0.0	0.006890459363957597
chr14	AL132712.2	103877394	103877595	0	202	4183	1687	4183	1485	0.0	2.8168350168350167
chr14	AL132712.2	103873877	103873946	110	70	4183	1687	4073	1617	1.5714285714285714	2.5188620902906615
chr14	ASPG	104106798	104106894	0	97	11476	6135	11476	6038	0.0	1.9006293474660483
chr14	ASPG	104111501	104111601	0	101	11476	6135	11476	6034	0.0	1.9018892940006629
chr14	INF2	104689151	104689245	0	95	51	13399	51	13304	0.0	0.0038334335538184007
chr14	INF2	104703104	104703220	0	117	51	13399	51	13282	0.0	0.003839783165185966
chr14	INF2	104703915	104703949	0	35	51	13399	51	13364	0.0	0.0038162226878180184
chr14	INF2	104706909	104707051	0	143	51	13399	51	13256	0.0	0.003847314423657212
chr14	INF2	104707252	104708002	51	751	51	13399	0	12648	0.06790945406125166	0.0
chr14	INF2	104708670	104708732	0	63	51	13399	51	13336	0.0	0.0038242351529694063
chr14	INF2	104710087	104710188	0	102	51	13399	51	13297	0.0	0.003835451605625329
chr14	INF2	104710936	104711007	0	72	51	13399	51	13327	0.0	0.003826817738425752
chr14	INF2	104711078	104711186	0	109	51	13399	51	13290	0.0	0.003837471783295711
chr14	INF2	104715283	104715340	0	58	51	13399	51	13341	0.0	0.0038228018889138746
chr14	INF2	104695989	104696490	0	502	51	13399	51	12897	0.0	0.003954408001860898
chr14	INF2	104711083	104711186	0	104	51	13399	51	13295	0.0	0.0038360285821737493
chr14	INF2	104707847	104708002	0	156	51	13399	51	13243	0.0	0.0038510911424903724
chr14	INF2	104710881	104711007	0	127	51	13399	51	13272	0.0	0.0038426763110307413
chr14	INF2	104710918	104711007	0	90	51	13399	51	13309	0.0	0.0038319933879329775
chr14	INF2	104710936	104711011	0	76	51	13399	51	13323	0.0	0.003827966674172484
chr14	INF2	104717562	104717646	0	85	51	13399	51	13314	0.0	0.0038305543037404238
chr14	INF2	104715832	104716017	0	186	51	13399	51	13213	0.0	0.0038598350109740405
chr14	INF2	104717547	104717646	0	100	51	13399	51	13299	0.0	0.003834874802616738
chr14	SIVA1	104755629	104755824	0	196	0	1662	0	1466	0.0	0.0
chr14	CEP170B	104868423	104868555	0	133	0	7230	0	7097	0.0	0.0
chr14	CLBA1	104989631	104989707	0	77	0	5232	0	5155	0.0	0.0
chr14	PACS2	105352377	105352467	828	91	7767	12388	6939	12297	9.098901098901099	0.5642839717004148
chr14	PACS2	105385684	105385717	0	34	7767	12388	7767	12354	0.0	0.6287032540067994
chr14	MTA1	105445417	105445511	0	95	120151	6787	120151	6692	0.0	17.95442319187089
chr14	MTA1	105449358	105449409	0	52	120151	6787	120151	6735	0.0	17.839792130660726
chr14	MTA1	105463183	105463258	639	76	120151	6787	119512	6711	8.407894736842104	17.80837431083296
chr14	MTA1	105468337	105468349	0	13	120151	6787	120151	6774	0.0	17.73708296427517
chr14	MTA1	105466706	105466742	0	37	120151	6787	120151	6750	0.0	17.80014814814815
chr14	MTA1	105445666	105445852	0	187	120151	6787	120151	6600	0.0	18.20469696969697
chr14	CRIP2	105478265	105478360	3350	96	458841	3532	455491	3436	34.895833333333336	132.56431897555296
chr14	AL928654.3	105488662	105488794	0	133	226	1416	226	1283	0.0	0.17614964925954793
chr14	AL928654.3	105488662	105488947	0	286	226	1416	226	1130	0.0	0.2
chr14	AL928654.3	105489258	105489625	0	368	226	1416	226	1048	0.0	0.21564885496183206
chr14	TEDC1	105492578	105492734	0	157	306	3476	306	3319	0.0	0.09219644471226272
chr14	TEDC1	105493834	105493933	0	100	306	3476	306	3376	0.0	0.09063981042654029
chr14	TEDC1	105495879	105496086	0	208	306	3476	306	3268	0.0	0.09363525091799266
chr14	LINC00221	106490382	106491213	0	832	0	4637	0	3805	0.0	0.0
chr14	MED15P1	18914425	18914579	0	155	0	1190	0	1035	0.0	0.0
chr14	POTEG	19409332	19409381	0	50	291	2522	291	2472	0.0	0.11771844660194175
chr14	POTEG	19426732	19426988	0	257	291	2522	291	2265	0.0	0.12847682119205298
chr14	CCNB1IP1	20329173	20329373	0	201	0	3695	0	3494	0.0	0.0
chr14	CCNB1IP1	20317793	20317974	0	182	0	3695	0	3513	0.0	0.0
chr14	CCNB1IP1	20317794	20317974	0	181	0	3695	0	3514	0.0	0.0
chr14	CCNB1IP1	20318255	20318470	0	216	0	3695	0	3479	0.0	0.0
chr14	CCNB1IP1	20315780	20315850	0	71	0	3695	0	3624	0.0	0.0
chr14	CCNB1IP1	20315484	20315618	0	135	0	3695	0	3560	0.0	0.0
chr14	CCNB1IP1	20320287	20320392	0	106	0	3695	0	3589	0.0	0.0
chr14	TEP1	20372732	20372857	0	126	222	11420	222	11294	0.0	0.01965645475473703
chr14	TEP1	20381552	20381686	0	135	222	11420	222	11285	0.0	0.019672131147540985
chr14	RNASE9	20558539	20558650	0	112	0	2714	0	2602	0.0	0.0
chr14	RNASE9	20560336	20560371	0	36	0	2714	0	2678	0.0	0.0
chr14	RNASE9	20559581	20559633	0	53	0	2714	0	2661	0.0	0.0
chr14	RNASE9	20558614	20558650	0	37	0	2714	0	2677	0.0	0.0
chr14	RNASE11	20585026	20585130	0	105	8	1739	8	1634	0.0	0.004895960832313341
chr14	RNASE1	20802248	20802319	0	72	472	920	472	848	0.0	0.5566037735849056
chr14	RNASE1	20802248	20802331	0	84	472	920	472	836	0.0	0.5645933014354066
chr14	NDRG2	21018456	21018504	0	49	0	5997	0	5948	0.0	0.0
chr14	NDRG2	21020495	21020582	0	88	0	5997	0	5909	0.0	0.0
chr14	NDRG2	21022863	21022905	0	43	0	5997	0	5954	0.0	0.0
chr14	NDRG2	21024029	21024096	0	68	0	5997	0	5929	0.0	0.0
chr14	NDRG2	21022391	21022497	0	107	0	5997	0	5890	0.0	0.0
chr14	NDRG2	21023985	21024096	0	112	0	5997	0	5885	0.0	0.0
chr14	NDRG2	21024029	21024139	0	111	0	5997	0	5886	0.0	0.0
chr14	NDRG2	21018456	21018471	0	16	0	5997	0	5981	0.0	0.0
chr14	NDRG2	21023975	21024096	0	122	0	5997	0	5875	0.0	0.0
chr14	ZNF219	21097327	21097412	0	86	0	5150	0	5064	0.0	0.0
chr14	ZNF219	21093428	21093492	0	65	0	5150	0	5085	0.0	0.0
chr14	HNRNPC	21211405	21211566	0	162	102	5164	102	5002	0.0	0.02039184326269492
chr14	HNRNPC	21263310	21263336	0	27	102	5164	102	5137	0.0	0.019855947050807864
chr14	HNRNPC	21263666	21263829	0	164	102	5164	102	5000	0.0	0.0204
chr14	HNRNPC	21211405	21211563	0	159	102	5164	102	5005	0.0	0.02037962037962038
chr14	HNRNPC	21262600	21262768	0	169	102	5164	102	4995	0.0	0.02042042042042042
chr14	HNRNPC	21268622	21268668	0	47	102	5164	102	5117	0.0	0.019933554817275746
chr14	HNRNPC	21236372	21236460	0	89	102	5164	102	5075	0.0	0.020098522167487684
chr14	HNRNPC	21234768	21234831	0	64	102	5164	102	5100	0.0	0.02
chr14	HNRNPC	21254546	21254593	0	48	102	5164	102	5116	0.0	0.0199374511336982
chr14	HNRNPC	21263310	21263582	0	273	102	5164	102	4891	0.0	0.020854630954814966
chr14	SUPT16H	21372468	21372717	0	250	102	6927	102	6677	0.0	0.015276321701362887
chr14	CHD8	21391462	21391642	0	181	0	13518	0	13337	0.0	0.0
chr14	CHD8	21430800	21431858	0	1059	0	13518	0	12459	0.0	0.0
chr14	CHD8	21436900	21436965	0	66	0	13518	0	13452	0.0	0.0
chr14	CHD8	21430800	21431643	0	844	0	13518	0	12674	0.0	0.0
chr14	CHD8	21431810	21431858	0	49	0	13518	0	13469	0.0	0.0
chr14	CHD8	21430800	21431724	0	925	0	13518	0	12593	0.0	0.0
chr14	METTL3	21501727	21501903	0	177	0	4373	0	4196	0.0	0.0
chr14	METTL3	21499305	21499371	0	67	0	4373	0	4306	0.0	0.0
chr14	METTL3	21500494	21500682	0	189	0	4373	0	4184	0.0	0.0
chr14	METTL3	21501727	21501824	0	98	0	4373	0	4275	0.0	0.0
chr14	SALL2	21522832	21524931	0	2100	0	4770	0	2670	0.0	0.0
chr14	OR10G3	21574825	21574932	0	108	153	2643	153	2535	0.0	0.06035502958579882
chr14	AC244502.1	22381843	22381980	0	138	204	8937	204	8799	0.0	0.023184452778724857
chr14	AC244502.1	22427688	22427822	0	135	204	8937	204	8802	0.0	0.023176550783912748
chr14	AC244502.1	22418663	22418935	0	273	204	8937	204	8664	0.0	0.023545706371191136
chr14	DAD1	22575058	22575233	0	176	0	765	0	589	0.0	0.0
chr14	AL160314.2	22764122	22764242	0	121	0	2810	0	2689	0.0	0.0
chr14	AL160314.2	22706278	22706415	0	138	0	2810	0	2672	0.0	0.0
chr14	AL160314.2	22762024	22762143	0	120	0	2810	0	2690	0.0	0.0
chr14	SLC7A7	22774353	22774503	0	151	255	4786	255	4635	0.0	0.05501618122977346
chr14	SLC7A7	22775832	22775936	0	105	255	4786	255	4681	0.0	0.05447553941465499
chr14	SLC7A7	22815313	22815451	0	139	255	4786	255	4647	0.0	0.05487411233053583
chr14	SLC7A7	22815319	22815451	0	133	255	4786	255	4653	0.0	0.0548033526756931
chr14	SLC7A7	22812899	22813440	0	542	255	4786	255	4244	0.0	0.060084825636192274
chr14	SLC7A7	22814694	22814883	0	190	255	4786	255	4596	0.0	0.05548302872062663
chr14	SLC7A7	22821121	22821232	0	112	255	4786	255	4674	0.0	0.05455712451861361
chr14	SLC7A7	22819637	22819756	0	120	255	4786	255	4666	0.0	0.0546506643806258
chr14	RBM23	22905605	22905659	0	55	0	12458	0	12403	0.0	0.0
chr14	RBM23	22908332	22908380	0	49	0	12458	0	12409	0.0	0.0
chr14	RBM23	22909482	22909595	0	114	0	12458	0	12344	0.0	0.0
chr14	RBM23	22911327	22911403	0	77	0	12458	0	12381	0.0	0.0
chr14	RBM23	22911785	22911903	0	119	0	12458	0	12339	0.0	0.0
chr14	RBM23	22913723	22913845	0	123	0	12458	0	12335	0.0	0.0
chr14	RBM23	22917027	22917166	0	140	0	12458	0	12318	0.0	0.0
chr14	RBM23	22913723	22913821	0	99	0	12458	0	12359	0.0	0.0
chr14	RBM23	22913914	22914016	0	103	0	12458	0	12355	0.0	0.0
chr14	PRMT5	22927525	22927660	0	136	0	3100	0	2964	0.0	0.0
chr14	PRMT5	22928496	22928615	0	120	0	3100	0	2980	0.0	0.0
chr14	HAUS4	22947867	22948013	0	147	0	2413	0	2266	0.0	0.0
chr14	HAUS4	22951554	22951689	0	136	0	2413	0	2277	0.0	0.0
chr14	HAUS4	22952540	22952683	0	144	0	2413	0	2269	0.0	0.0
chr14	HAUS4	22950313	22950410	0	98	0	2413	0	2315	0.0	0.0
chr14	AJUBA	22975706	22975844	0	139	1836	5251	1836	5112	0.0	0.3591549295774648
chr14	C14ORF93	23000958	23001037	0	80	0	3210	0	3130	0.0	0.0
chr14	C14ORF93	23000958	23001031	0	74	0	3210	0	3136	0.0	0.0
chr14	C14ORF93	22999956	23000117	0	162	0	3210	0	3048	0.0	0.0
chr14	C14ORF93	23000958	23001060	0	103	0	3210	0	3107	0.0	0.0
chr14	PSMB5	23033367	23033674	0	308	1168	1347	1168	1039	0.0	1.124157844080847
chr14	PSMB5	23027744	23027829	0	86	1168	1347	1168	1261	0.0	0.9262490087232356
chr14	CDH24	23051969	23052083	51	115	4524	3762	4473	3647	0.4434782608695652	1.2264875239923225
chr14	ACIN1	23067313	23068671	867	1359	57945	7290	57078	5931	0.6379690949227373	9.623672230652504
chr14	ACIN1	23071124	23071186	0	63	57945	7290	57945	7227	0.0	8.017849730178497
chr14	ACIN1	23089981	23090101	0	121	57945	7290	57945	7169	0.0	8.082717254847259
chr14	ACIN1	23076469	23076548	0	80	57945	7290	57945	7210	0.0	8.036754507628293
chr14	LMLN2	23101291	23101564	0	274	0	2784	0	2510	0.0	0.0
chr14	LMLN2	23102925	23103051	0	127	0	2784	0	2657	0.0	0.0
chr14	SLC7A8	23140470	23140624	0	155	0	4274	0	4119	0.0	0.0
chr14	PPP1R3E	23300106	23300325	3891	220	173836	4258	169945	4038	17.686363636363637	42.0864289252105
chr14	PPP1R3E	23300106	23300139	85	34	173836	4258	173751	4224	2.5	41.13423295454545
chr14	SLC22A17	23347890	23347996	4230	107	296834	4288	292604	4181	39.532710280373834	69.98421430279838
chr14	SLC22A17	23351751	23351855	0	105	296834	4288	296834	4183	0.0	70.96198900310782
chr14	EFS	23360554	23360833	0	280	6203	3242	6203	2962	0.0	2.0941931127616473
chr14	AP1G2	23561961	23562066	0	106	402491	5143	402491	5037	0.0	79.9068890212428
chr14	AP1G2	23565815	23565892	204	78	402491	5143	402287	5065	2.6153846153846154	79.4248766041461
chr14	AP1G2	23566561	23566686	6436	126	402491	5143	396055	5017	51.07936507936508	78.94259517640025
chr14	JPH4	23577868	23577994	0	127	7804	5305	7804	5178	0.0	1.50714561606798
chr14	AL160237.1	23729276	23729424	0	149	51	2800	51	2651	0.0	0.01923802338740098
chr14	AL160237.1	23715257	23715436	0	180	51	2800	51	2620	0.0	0.019465648854961833
chr14	DHRS4-AS1	23953773	23954033	0	261	25330	7706	25330	7445	0.0	3.402283411685695
chr14	DHRS4-AS1	23953308	23953419	0	112	25330	7706	25330	7594	0.0	3.33552804845931
chr14	NRL	24084519	24084745	0	227	255	4561	255	4334	0.0	0.05883710198431011
chr14	PSME2	24143974	24144029	0	56	0	2984	0	2928	0.0	0.0
chr14	PSME2	24146207	24146240	0	34	0	2984	0	2950	0.0	0.0
chr14	IPO4	24181512	24181617	0	106	27	4634	27	4528	0.0	0.005962897526501767
chr14	IPO4	24184866	24184980	0	115	27	4634	27	4519	0.0	0.005974773179907059
chr14	IPO4	24187666	24187796	0	131	27	4634	27	4503	0.0	0.005996002664890073
chr14	IPO4	24187666	24187813	0	148	27	4634	27	4486	0.0	0.0060187249219794915
chr14	MDP1	24214309	24214395	0	87	0	1029	0	942	0.0	0.0
chr14	NEDD8	24217185	24217223	0	39	153	3793	153	3754	0.0	0.04075652637187001
chr14	MDP1	24215736	24215797	0	62	0	1029	0	967	0.0	0.0
chr14	TINF2	24241203	24241311	0	109	0	2610	0	2501	0.0	0.0
chr14	TINF2	24241889	24241994	0	106	0	2610	0	2504	0.0	0.0
chr14	TINF2	24241019	24241116	0	98	0	2610	0	2512	0.0	0.0
chr14	TINF2	24241889	24241921	0	33	0	2610	0	2577	0.0	0.0
chr14	TGM1	24263088	24263192	0	105	0	3450	0	3345	0.0	0.0
chr14	RABGGTA	24270836	24270947	0	112	0	3090	0	2978	0.0	0.0
chr14	RABGGTA	24271112	24271169	0	58	0	3090	0	3032	0.0	0.0
chr14	RABGGTA	24266664	24266683	0	20	0	3090	0	3070	0.0	0.0
chr14	RABGGTA	24271112	24271248	0	137	0	3090	0	2953	0.0	0.0
chr14	DHRS1	24291555	24291625	0	71	0	4668	0	4597	0.0	0.0
chr14	DHRS1	24292651	24292784	0	134	0	4668	0	4534	0.0	0.0
chr14	CIDEB	24305946	24306137	446	192	446	3127	0	2935	2.3229166666666665	0.0
chr14	CIDEB	24310406	24310548	0	143	446	3127	446	2984	0.0	0.14946380697050937
chr14	ADCY4	24330167	24330295	0	129	0	7362	0	7233	0.0	0.0
chr14	ADCY4	24334493	24334678	0	186	0	7362	0	7176	0.0	0.0
chr14	ADCY4	24334493	24334682	0	190	0	7362	0	7172	0.0	0.0
chr14	ADCY4	24330167	24330327	0	161	0	7362	0	7201	0.0	0.0
chr14	ADCY4	24334493	24334635	0	143	0	7362	0	7219	0.0	0.0
chr14	SDR39U1	24441673	24441795	0	123	0	2120	0	1997	0.0	0.0
chr14	SDR39U1	24442177	24442260	0	84	0	2120	0	2036	0.0	0.0
chr14	SDR39U1	24442097	24442260	0	164	0	2120	0	1956	0.0	0.0
chr14	SDR39U1	24442108	24442260	0	153	0	2120	0	1967	0.0	0.0
chr14	SDR39U1	24441677	24441795	0	119	0	2120	0	2001	0.0	0.0
chr14	CMA1	24507355	24507506	51	152	1534	942	1483	790	0.3355263157894737	1.8772151898734177
chr14	GZMH	24607148	24607406	92275	259	613740	956	521465	697	356.27413127413126	748.1563845050215
chr14	GZMB	24632323	24632459	4367	137	25570	1418	21203	1281	31.875912408759124	16.55191256830601
chr14	GZMB	24632718	24632719	14	2	25570	1418	25556	1416	7.0	18.048022598870055
chr14	GZMB	24632914	24633062	80	149	25570	1418	25490	1269	0.5369127516778524	20.08668242710796
chr14	GZMB	24633909	24634016	6229	108	25570	1418	19341	1310	57.675925925925924	14.76412213740458
chr14	STXBP6	25010524	25010640	0	117	360	8079	360	7962	0.0	0.0452147701582517
chr14	STXBP6	24994863	24994984	0	122	360	8079	360	7957	0.0	0.04524318210380797
chr14	STXBP6	24878651	24878813	207	163	360	8079	153	7916	1.2699386503067485	0.019327943405760484
chr14	STXBP6	24987885	24987972	0	88	360	8079	360	7991	0.0	0.04505068201726943
chr14	LINC02286	25128208	25128288	0	81	0	1011	0	930	0.0	0.0
chr14	LINC02306	26127481	26127732	0	252	26	3603	26	3351	0.0	0.007758877946881528
chr14	NOVA1	26472319	26472391	0	73	69	10340	69	10267	0.0	0.00672056102074608
chr14	NOVA1	26549679	26549781	0	103	69	10340	69	10237	0.0	0.006740255934355769
chr14	NOVA1	26568419	26568465	0	47	69	10340	69	10293	0.0	0.006703584960652871
chr14	AL133166.1	29307380	29307470	0	91	3673	11324	3673	11233	0.0	0.3269829965280869
chr14	AL133166.1	29346444	29346525	0	82	3673	11324	3673	11242	0.0	0.32672122398149794
chr14	AL133166.1	29379990	29380059	0	70	3673	11324	3673	11254	0.0	0.3263728452105918
chr14	PRKD1	29724469	29724545	0	77	0	5242	0	5165	0.0	0.0
chr14	PRKD1	29656475	29656499	0	25	0	5242	0	5217	0.0	0.0
chr14	PRKD1	29657576	29657697	0	122	0	5242	0	5120	0.0	0.0
chr14	STRN3	30913523	30913657	0	135	0	4985	0	4850	0.0	0.0
chr14	STRN3	30918965	30919106	0	142	0	4985	0	4843	0.0	0.0
chr14	STRN3	30929200	30929311	0	112	0	4985	0	4873	0.0	0.0
chr14	HECTD1	31128611	31129448	102	838	51545	11639	51443	10801	0.12171837708830549	4.762799740764744
chr14	HECTD1	31128611	31129307	102	697	51545	11639	51443	10942	0.14634146341463414	4.701425699140925
chr14	HECTD1	31123515	31123624	0	110	51545	11639	51545	11529	0.0	4.470899470899471
chr14	HEATR5A	31302294	31302519	0	226	86340	10252	86340	10026	0.0	8.611609814482346
chr14	HEATR5A	31340449	31340476	0	28	86340	10252	86340	10224	0.0	8.444835680751174
chr14	HEATR5A	31402849	31403049	504	201	86340	10252	85836	10051	2.5074626865671643	8.540045766590389
chr14	EGLN3	34199486	34199820	0	335	0	4709	0	4374	0.0	0.0
chr14	SNX6	34581560	34581600	0	41	0	4099	0	4058	0.0	0.0
chr14	SNX6	34608029	34608140	0	112	0	4099	0	3987	0.0	0.0
chr14	SNX6	34604134	34604268	0	135	0	4099	0	3964	0.0	0.0
chr14	SNX6	34604134	34604174	0	41	0	4099	0	4058	0.0	0.0
chr14	CFL2	34713673	34713904	0	232	0	4948	0	4716	0.0	0.0
chr14	BAZ1A	34758703	34758846	0	144	12	7728	12	7584	0.0	0.0015822784810126582
chr14	BAZ1A	34786125	34786221	0	97	12	7728	12	7631	0.0	0.001572533088717075
chr14	BAZ1A	34768689	34768780	0	92	12	7728	12	7636	0.0	0.001571503404924044
chr14	BAZ1A	34816714	34816856	0	143	12	7728	12	7585	0.0	0.0015820698747528016
chr14	SRP54-AS1	34965560	34965682	0	123	2321	1535	2321	1412	0.0	1.6437677053824362
chr14	SRP54-AS1	34971941	34972213	0	273	2321	1535	2321	1262	0.0	1.8391442155309032
chr14	PPP2R3C	35107303	35107374	0	72	51580	3757	51580	3685	0.0	13.997286295793758
chr14	PPP2R3C	35109818	35109931	0	114	51580	3757	51580	3643	0.0	14.158660444688444
chr14	PPP2R3C	35091069	35091207	816	139	51580	3757	50764	3618	5.870503597122302	14.030956329463793
chr14	PPP2R3C	35095047	35095184	1287	138	51580	3757	50293	3619	9.326086956521738	13.896932854379664
chr14	PPP2R3C	35116609	35116737	0	129	51580	3757	51580	3628	0.0	14.217199558985667
chr14	PPP2R3C	35109847	35109931	0	85	51580	3757	51580	3672	0.0	14.046840958605664
chr14	PPP2R3C	35109818	35109901	0	84	51580	3757	51580	3673	0.0	14.043016607677648
chr14	PPP2R3C	35109818	35109847	0	30	51580	3757	51580	3727	0.0	13.839549235309901
chr14	PPP2R3C	35117073	35117176	0	104	51580	3757	51580	3653	0.0	14.119901450862304
chr14	NFKBIA	35402770	35402859	0	90	194	2170	194	2080	0.0	0.09326923076923077
chr14	NFKBIA	35403689	35403798	0	110	194	2170	194	2060	0.0	0.0941747572815534
chr14	RALGAPA1	35541739	35541804	0	66	8964	14305	8964	14239	0.0	0.6295385911932018
chr14	RALGAPA1	35548507	35548538	0	32	8964	14305	8964	14273	0.0	0.628038954669656
chr14	RALGAPA1	35542026	35542029	0	4	8964	14305	8964	14301	0.0	0.6268093140339837
chr14	RALGAPA1	35700161	35700302	0	142	8964	14305	8964	14163	0.0	0.632916754924804
chr14	MBIP	36308091	36308189	0	99	63	3431	63	3332	0.0	0.018907563025210083
chr14	MBIP	36316692	36316812	0	121	63	3431	63	3310	0.0	0.019033232628398792
chr14	MBIP	36305088	36305304	0	217	63	3431	63	3214	0.0	0.019601742377100186
chr14	NKX2-1	36519467	36519612	0	146	0	3073	0	2927	0.0	0.0
chr14	FOXA1	37594075	37594176	0	102	102	4217	102	4115	0.0	0.024787363304981776
chr14	LINC00639	38761109	38761253	0	145	0	9470	0	9325	0.0	0.0
chr14	LINC00639	38762101	38762174	0	74	0	9470	0	9396	0.0	0.0
chr14	LINC00639	38762923	38763045	0	123	0	9470	0	9347	0.0	0.0
chr14	LINC00639	38760181	38760248	0	68	0	9470	0	9402	0.0	0.0
chr14	LINC00639	38890740	38890798	0	59	0	9470	0	9411	0.0	0.0
chr14	LINC00639	38916781	38916882	0	102	0	9470	0	9368	0.0	0.0
chr14	LINC00639	38941519	38941695	0	177	0	9470	0	9293	0.0	0.0
chr14	LINC00639	38941353	38941373	0	21	0	9470	0	9449	0.0	0.0
chr14	LINC00639	38946691	38946882	0	192	0	9470	0	9278	0.0	0.0
chr14	SEC23A	39092540	39092627	0	88	51	7049	51	6961	0.0	0.00732653354403103
chr14	SEC23A	39103031	39103228	0	198	51	7049	51	6851	0.0	0.007444168734491315
chr14	TRAPPC6B	39154210	39154294	0	85	0	4538	0	4453	0.0	0.0
chr14	AL121821.2	41597199	41597266	0	68	0	4936	0	4868	0.0	0.0
chr14	KLHL28	44953622	44953709	0	88	60	7833	60	7745	0.0	0.007746933505487412
chr14	KLHL28	44959340	44959514	0	175	60	7833	60	7658	0.0	0.007834943849569079
chr14	FKBP3	45133322	45133439	0	118	0	2272	0	2154	0.0	0.0
chr14	MIS18BP1	45235813	45235944	0	132	204	6270	204	6138	0.0	0.033235581622678395
chr14	MIS18BP1	45232508	45232627	0	120	204	6270	204	6150	0.0	0.033170731707317075
chr14	MIS18BP1	45250030	45250138	0	109	204	6270	204	6161	0.0	0.03311150787209868
chr14	LINC02303	45707835	45707898	0	64	2681	1149	2681	1085	0.0	2.470967741935484
chr14	LINC02303	45714283	45714431	220	149	2681	1149	2461	1000	1.476510067114094	2.461
chr14	LINC02303	45711898	45711953	23	56	2681	1149	2658	1093	0.4107142857142857	2.431838975297347
chr14	MDGA2	46877488	46877509	0	22	0	8746	0	8724	0.0	0.0
chr14	LINC00648	47768830	47768910	0	81	0	1389	0	1308	0.0	0.0
chr14	RPS29	49586284	49586478	22	195	22	8593	0	8398	0.11282051282051282	0.0
chr14	DNAAF2	49628011	49628155	0	145	0	2980	0	2835	0.0	0.0
chr14	POLE2	49647292	49647360	0	69	0	2976	0	2907	0.0	0.0
chr14	POLE2	49654783	49654838	0	56	0	2976	0	2920	0.0	0.0
chr14	POLE2	49674349	49674427	0	79	0	2976	0	2897	0.0	0.0
chr14	NEMF	49813987	49814050	0	64	11781	8972	11781	8908	0.0	1.3225190839694656
chr14	NEMF	49833422	49833496	0	75	11781	8972	11781	8897	0.0	1.3241542092840284
chr14	NEMF	49840717	49840866	11628	150	11781	8972	153	8822	77.52	0.017343006121060985
chr14	NEMF	49846139	49846265	0	127	11781	8972	11781	8845	0.0	1.3319389485585076
chr14	LINC01588	50047466	50047589	0	124	291360	13032	291360	12908	0.0	22.57204834211342
chr14	LINC01588	50002748	50002987	0	240	291360	13032	291360	12792	0.0	22.776735459662287
chr14	LINC01588	49999926	50000058	0	133	291360	13032	291360	12899	0.0	22.587797503682456
chr14	LINC01588	50010605	50010685	0	81	291360	13032	291360	12951	0.0	22.497104470697245
chr14	VCPKMT	50112614	50112719	1562	106	16721	2061	15159	1955	14.735849056603774	7.753964194373402
chr14	SOS2	50174453	50174552	0	100	46002	6973	46002	6873	0.0	6.693147097337407
chr14	SOS2	50188496	50188700	0	205	46002	6973	46002	6768	0.0	6.796985815602837
chr14	SOS2	50215373	50215432	0	60	46002	6973	46002	6913	0.0	6.654419210183712
chr14	L2HGDH	50293204	50293283	0	80	79612	3357	79612	3277	0.0	24.294171498321635
chr14	L2HGDH	50311369	50311433	22	65	79612	3357	79590	3292	0.3384615384615385	24.176792223572296
chr14	CDKL1	50332261	50332432	255	172	119460	6021	119205	5849	1.4825581395348837	20.380406907163618
chr14	SAV1	50640749	50640893	0	145	3500	5612	3500	5467	0.0	0.6402048655569782
chr14	SAV1	50667381	50667500	0	120	3500	5612	3500	5492	0.0	0.6372906045156591
chr14	NIN	50756491	50758630	6987	2140	28389	13565	21402	11425	3.2649532710280376	1.8732603938730854
chr14	NIN	50766306	50766396	28	91	28389	13565	28361	13474	0.3076923076923077	2.1048686358913464
chr14	NIN	50730922	50730983	51	62	28389	13565	28338	13503	0.8225806451612904	2.098644745612086
chr14	NIN	50792459	50792513	1563	55	28389	13565	26826	13510	28.418181818181818	1.985640266469282
chr14	NIN	50806207	50806276	0	70	28389	13565	28389	13495	0.0	2.1036680251945166
chr14	NIN	50794435	50794525	3883	91	28389	13565	24506	13474	42.67032967032967	1.8187620602642125
chr14	PYGL	50937735	50937837	0	103	22935	4567	22935	4464	0.0	5.137768817204301
chr14	NID2	52027200	52027344	0	145	518	6413	518	6268	0.0	0.0826419910657307
chr14	TXNDC16	52462811	52462970	0	160	3817	4755	3817	4595	0.0	0.8306855277475517
chr14	ERO1A	52646153	52646287	0	135	60	7564	60	7429	0.0	0.008076457127473414
chr14	ERO1A	52683787	52683907	0	121	60	7564	60	7443	0.0	0.008061265618702136
chr14	GNPNAT1	52784496	52784664	0	169	87	2721	87	2552	0.0	0.03409090909090909
chr14	GNPNAT1	52784496	52784654	0	159	87	2721	87	2562	0.0	0.03395784543325527
chr14	GNPNAT1	52787832	52787871	0	40	87	2721	87	2681	0.0	0.03245057814248415
chr14	FERMT2	52861013	52861034	0	22	0	6261	0	6239	0.0	0.0
chr14	FERMT2	52881795	52881828	0	34	0	6261	0	6227	0.0	0.0
chr14	FERMT2	52861586	52861610	0	25	0	6261	0	6236	0.0	0.0
chr14	FERMT2	52948561	52948580	0	20	0	6261	0	6241	0.0	0.0
chr14	DDHD1	53051843	53051927	1020	85	25416	16629	24396	16544	12.0	1.4746131528046422
chr14	DDHD1	53058476	53058626	255	151	25416	16629	25161	16478	1.6887417218543046	1.5269450175992232
chr14	DDHD1	53103030	53103051	1038	22	25416	16629	24378	16607	47.18181818181818	1.4679352080448005
chr14	DDHD1	53096116	53096218	0	103	25416	16629	25416	16526	0.0	1.537940215418129
chr14	CNIH1	54430260	54430404	0	145	102	5026	102	4881	0.0	0.02089735709895513
chr14	CNIH1	54432107	54432220	0	114	102	5026	102	4912	0.0	0.020765472312703582
chr14	CNIH1	54436368	54436437	0	70	102	5026	102	4956	0.0	0.020581113801452784
chr14	CNIH1	54436078	54436126	0	49	102	5026	102	4977	0.0	0.020494273658830622
chr14	CNIH1	54436669	54436785	102	117	102	5026	0	4909	0.8717948717948718	0.0
chr14	GMFB	54482152	54482202	0	51	0	5165	0	5114	0.0	0.0
chr14	GCH1	54844000	54844143	0	144	1183	2205	1183	2061	0.0	0.5739932071809801
chr14	GCH1	54843781	54843869	0	89	1183	2205	1183	2116	0.0	0.5590737240075614
chr14	WDHD1	54989027	54989212	1570	186	120186	6411	118616	6225	8.440860215053764	19.054779116465863
chr14	WDHD1	55026710	55026803	0	94	120186	6411	120186	6317	0.0	19.02580338768403
chr14	DLGAP5	55148593	55148684	317	92	2013	3618	1696	3526	3.4456521739130435	0.48099829835507657
chr14	DLGAP5	55191068	55191176	0	109	2013	3618	2013	3509	0.0	0.5736677115987461
chr14	TBPL2	55438794	55438905	0	112	297	2416	297	2304	0.0	0.12890625
chr14	KTN1-AS1	55578605	55578737	0	133	111579	8122	111579	7989	0.0	13.966579046188508
chr14	LINC00520	55794283	55794345	0	63	408	2977	408	2914	0.0	0.1400137268359643
chr14	LINC00520	55793045	55793110	0	66	408	2977	408	2911	0.0	0.14015802129852284
chr14	OTX2	56804187	56804339	0	153	0	2555	0	2402	0.0	0.0
chr14	OTX2	56804187	56804363	0	177	0	2555	0	2378	0.0	0.0
chr14	OTX2	56806703	56806723	0	21	0	2555	0	2534	0.0	0.0
chr14	AL161757.4	56881393	56881455	0	63	0	2256	0	2193	0.0	0.0
chr14	AL137100.3	56967911	56967965	0	55	16	4378	16	4323	0.0	0.0037011334721258385
chr14	EXOC5	57244164	57244359	0	196	102	12071	102	11875	0.0	0.008589473684210527
chr14	CCDC198	57475581	57475704	0	124	0	4116	0	3992	0.0	0.0
chr14	SLC35F4	57580438	57580539	0	102	95	4288	95	4186	0.0	0.022694696607740088
chr14	PSMA3-AS1	58285590	58285756	0	167	0	6704	0	6537	0.0	0.0
chr14	PSMA3-AS1	58293765	58295811	0	2047	0	6704	0	4657	0.0	0.0
chr14	PSMA3-AS1	58293065	58293138	0	74	0	6704	0	6630	0.0	0.0
chr14	PSMA3-AS1	58293313	58293544	0	232	0	6704	0	6472	0.0	0.0
chr14	PSMA3-AS1	58288717	58288813	0	97	0	6704	0	6607	0.0	0.0
chr14	TIMM9	58411906	58411971	0	66	0	1038	0	972	0.0	0.0
chr14	TIMM9	58424007	58424095	0	89	0	1038	0	949	0.0	0.0
chr14	TIMM9	58423827	58423849	0	23	0	1038	0	1015	0.0	0.0
chr14	CCDC175	59545162	59545299	0	138	143	3037	143	2899	0.0	0.04932735426008968
chr14	RTN1	59605367	59605506	0	140	0	4362	0	4222	0.0	0.0
chr14	RTN1	59610121	59610232	0	112	0	4362	0	4250	0.0	0.0
chr14	DHRS7	60152938	60153178	0	241	19	3008	19	2767	0.0	0.0068666425731839535
chr14	DHRS7	60165176	60165605	19	430	19	3008	0	2578	0.044186046511627906	0.0
chr14	C14ORF39	60485029	60485086	0	58	0	3454	0	3396	0.0	0.0
chr14	AL355916.2	61542622	61542717	0	96	14123	4009	14123	3913	0.0	3.6092512139023767
chr14	AL355916.2	61538972	61539187	896	216	14123	4009	13227	3793	4.148148148148148	3.487213287635117
chr14	KCNH5	62779727	62779924	0	198	0	12326	0	12128	0.0	0.0
chr14	PPP2R5E	63453688	63453885	0	198	51	6784	51	6586	0.0	0.00774369875493471
chr14	ESR2	64249545	64249679	0	135	2376	7242	2376	7107	0.0	0.3343182777543267
chr14	ESR2	64257225	64257364	0	140	2376	7242	2376	7102	0.0	0.3345536468600394
chr14	ESR2	64279980	64280153	0	174	2376	7242	2376	7068	0.0	0.3361629881154499
chr14	TEX21P	64353952	64354074	0	123	51	3094	51	2971	0.0	0.01716593739481656
chr14	TEX21P	64354000	64354074	0	75	51	3094	51	3019	0.0	0.01689301093077178
chr14	TEX21P	64358768	64358859	0	92	51	3094	51	3002	0.0	0.01698867421718854
chr14	TEX21P	64375237	64375386	0	150	51	3094	51	2944	0.0	0.017323369565217392
chr14	ZBTB25	64487113	64487196	0	84	1080	3167	1080	3083	0.0	0.3503081414206941
chr14	SPTB	64752210	64752315	0	106	1376	14834	1376	14728	0.0	0.09342748506246605
chr14	GPX2	64939992	64940198	125	207	1976	1444	1851	1237	0.6038647342995169	1.496362166531932
chr14	GPX2	64941316	64941521	0	206	1976	1444	1976	1238	0.0	1.5961227786752827
chr14	RAB15	64957939	64958159	0	221	33925	4909	33925	4688	0.0	7.236561433447099
chr14	RAB15	64971952	64972100	0	149	33925	4909	33925	4760	0.0	7.1271008403361344
chr14	MAX	65101545	65101572	0	28	0	5511	0	5483	0.0	0.0
chr14	MAX	65077327	65077428	0	102	0	5511	0	5409	0.0	0.0
chr14	MAX	65093707	65093815	0	109	0	5511	0	5402	0.0	0.0
chr14	MAX	65077343	65077428	0	86	0	5511	0	5425	0.0	0.0
chr14	MAX	65077562	65077643	0	82	0	5511	0	5429	0.0	0.0
chr14	AL359232.1	66504874	66504990	0	117	357	6071	357	5954	0.0	0.059959690964057774
chr14	ATP6V1D	67343371	67343438	0	68	1026	3686	1026	3618	0.0	0.2835820895522388
chr14	ATP6V1D	67349036	67349104	924	69	1026	3686	102	3617	13.391304347826088	0.028200165883328725
chr14	ATP6V1D	67352922	67353040	0	119	1026	3686	1026	3567	0.0	0.287636669470143
chr14	ATP6V1D	67340439	67340518	0	80	1026	3686	1026	3606	0.0	0.28452579034941766
chr14	ATP6V1D	67353698	67353959	0	262	1026	3686	1026	3424	0.0	0.2996495327102804
chr14	PLEK2	67390662	67390746	0	85	548	1579	548	1494	0.0	0.3668005354752343
chr14	PLEK2	67392325	67392427	0	103	548	1579	548	1476	0.0	0.3712737127371274
chr14	PLEK2	67395401	67395583	0	183	548	1579	548	1396	0.0	0.39255014326647564
chr14	TMEM229B	67503486	67503551	429	66	1653	6390	1224	6324	6.5	0.1935483870967742
chr14	PIGH	67592634	67592718	0	85	0	2424	0	2339	0.0	0.0
chr14	PIGH	67592314	67592436	0	123	0	2424	0	2301	0.0	0.0
chr14	PIGH	67592634	67592715	0	82	0	2424	0	2342	0.0	0.0
chr14	VTI1B	67653436	67653498	0	63	38341	5775	38341	5712	0.0	6.712359943977591
chr14	AL049779.1	67662476	67662535	0	60	0	809	0	749	0.0	0.0
chr14	AL049779.1	67663028	67663190	0	163	0	809	0	646	0.0	0.0
chr14	RDH11	67685014	67685204	0	191	573	3089	573	2898	0.0	0.19772256728778467
chr14	RDH11	67690211	67690421	0	211	573	3089	573	2878	0.0	0.19909659485753997
chr14	RDH11	67692437	67692593	0	157	573	3089	573	2932	0.0	0.19542974079126876
chr14	RDH11	67692933	67693052	51	120	573	3089	522	2969	0.425	0.17581677332435164
chr14	RDH11	67692972	67693052	26	81	573	3089	547	3008	0.32098765432098764	0.18184840425531915
chr14	RDH11	67691139	67691244	0	106	573	3089	573	2983	0.0	0.19208850150854845
chr14	ZFYVE26	67802078	67802282	9157	205	101767	15344	92610	15139	44.66829268292683	6.117312900455777
chr14	ZFYVE26	67805216	67805305	19103	90	101767	15344	82664	15254	212.25555555555556	5.419168742624885
chr14	ZFYVE26	67804100	67804264	1197	165	101767	15344	100570	15179	7.254545454545455	6.625601159496673
chr14	ZFYVE26	67805901	67806018	0	118	101767	15344	101767	15226	0.0	6.6837646131616975
chr14	ZFP36L1	68792881	68793070	51	190	51	4219	0	4029	0.26842105263157895	0.0
chr14	ACTN1	68878457	68878523	225	67	2026	9387	1801	9320	3.3582089552238807	0.19324034334763948
chr14	ACTN1	68878988	68879069	0	82	2026	9387	2026	9305	0.0	0.21773240193444385
chr14	ACTN1	68882872	68883055	0	184	2026	9387	2026	9203	0.0	0.22014560469412148
chr14	DCAF5	69062383	69062511	2995	129	5035	8307	2040	8178	23.217054263565892	0.24944974321349964
chr14	DCAF5	69122216	69122360	0	145	5035	8307	5035	8162	0.0	0.6168831168831169
chr14	ERH	69386962	69387083	0	122	765	1117	765	995	0.0	0.7688442211055276
chr14	ERH	69394824	69394912	0	89	765	1117	765	1028	0.0	0.7441634241245136
chr14	SLC8A3	70060835	70060939	0	105	50	8457	50	8352	0.0	0.0059865900383141765
chr14	SLC8A3	70055795	70055813	0	19	50	8457	50	8438	0.0	0.005925574780753733
chr14	COX16	70342657	70342729	0	73	0	1924	0	1851	0.0	0.0
chr14	SYNJ2BP-COX16	70388469	70388606	0	138	0	1412	0	1274	0.0	0.0
chr14	SYNJ2BP-COX16	70373032	70373131	0	100	0	1412	0	1312	0.0	0.0
chr14	MED6	70591265	70591381	0	117	0	3828	0	3711	0.0	0.0
chr14	MAP3K9	70733756	70733798	0	43	67417	12402	67417	12359	0.0	5.454891172424953
chr14	MAP3K9	70735960	70736029	0	70	67417	12402	67417	12332	0.0	5.466834252351606
chr14	MAP3K9	70765441	70765487	0	47	67417	12402	67417	12355	0.0	5.456657223796034
chr14	DPF3	72879803	72879947	51	145	51	6912	0	6767	0.35172413793103446	0.0
chr14	ZFYVE1	72978136	72978234	0	99	0	5233	0	5134	0.0	0.0
chr14	NUMB	73284080	73284374	0	295	6351	8593	6351	8298	0.0	0.7653651482284888
chr14	NUMB	73323129	73323204	36	76	6351	8593	6315	8517	0.47368421052631576	0.7414582599506868
chr14	NUMB	73366896	73366981	0	86	6351	8593	6351	8507	0.0	0.7465616551075585
chr14	NUMB	73279280	73279424	0	145	6351	8593	6351	8448	0.0	0.7517755681818182
chr14	NUMB	73316389	73316422	0	34	6351	8593	6351	8559	0.0	0.7420259376095338
chr14	NUMB	73457628	73457733	0	106	6351	8593	6351	8487	0.0	0.7483209614704843
chr14	NUMB	73282358	73282505	0	148	6351	8593	6351	8445	0.0	0.7520426287744227
chr14	AC005280.2	73459033	73459305	94	273	2118	1417	2024	1144	0.3443223443223443	1.7692307692307692
chr14	HEATR4	73530165	73530244	828	80	1789	4197	961	4117	10.35	0.2334223949477775
chr14	HEATR4	73527228	73527397	459	170	1789	4197	1330	4027	2.7	0.33027067295753665
chr14	MIDEAS	73730069	73730179	0	111	17281	7346	17281	7235	0.0	2.38852798894264
chr14	ENTPD5	74007695	74007812	0	118	134555	8498	134555	8380	0.0	16.05668257756563
chr14	ALDH6A1	74072536	74072611	0	76	18334	6675	18334	6599	0.0	2.77829974238521
chr14	ABCD4	74290026	74290118	0	93	357	8153	357	8060	0.0	0.044292803970223324
chr14	ABCD4	74293153	74293248	0	96	357	8153	357	8057	0.0	0.044309296264118156
chr14	ABCD4	74295147	74295198	0	52	357	8153	357	8101	0.0	0.04406863350203678
chr14	ABCD4	74295853	74295979	0	127	357	8153	357	8026	0.0	0.04448043857463244
chr14	ABCD4	74297929	74298069	0	141	357	8153	357	8012	0.0	0.0445581627558662
chr14	ABCD4	74299547	74299675	80	129	357	8153	277	8024	0.6201550387596899	0.03452143569292124
chr14	ABCD4	74300149	74300268	0	120	357	8153	357	8033	0.0	0.044441678077928544
chr14	ABCD4	74293153	74293279	0	127	357	8153	357	8026	0.0	0.04448043857463244
chr14	ABCD4	74293153	74293310	0	158	357	8153	357	7995	0.0	0.04465290806754221
chr14	ABCD4	74297638	74298069	51	432	357	8153	306	7721	0.11805555555555555	0.0396321719984458
chr14	NPC2	74484414	74484587	0	174	1734	2591	1734	2417	0.0	0.7174182871328093
chr14	NPC2	74480701	74480779	0	79	1734	2591	1734	2512	0.0	0.6902866242038217
chr14	NPC2	74480710	74480779	0	70	1734	2591	1734	2521	0.0	0.6878222927409758
chr14	NPC2	74480685	74480779	0	95	1734	2591	1734	2496	0.0	0.6947115384615384
chr14	LTBP2	74507178	74507310	81	133	8077	9114	7996	8981	0.6090225563909775	0.8903240173700033
chr14	LTBP2	74507972	74508095	0	124	8077	9114	8077	8990	0.0	0.8984427141268075
chr14	AREL1	74663511	74663822	315	312	11629	7250	11314	6938	1.0096153846153846	1.630729316805996
chr14	AREL1	74670761	74670871	0	111	11629	7250	11629	7139	0.0	1.6289396273987953
chr14	AREL1	74683295	74683533	0	239	11629	7250	11629	7011	0.0	1.658679218371131
chr14	AREL1	74684453	74684680	0	228	11629	7250	11629	7022	0.0	1.6560808886357163
chr14	AREL1	74692040	74692328	0	289	11629	7250	11629	6961	0.0	1.670593305559546
chr14	AREL1	74671968	74672020	0	53	11629	7250	11629	7197	0.0	1.6158121439488675
chr14	AREL1	74678178	74678329	0	152	11629	7250	11629	7098	0.0	1.638348830656523
chr14	PROX2	74865255	74865332	0	78	0	4834	0	4756	0.0	0.0
chr14	RPS6KL1	74907434	74907530	0	97	178	4369	178	4272	0.0	0.041666666666666664
chr14	RPS6KL1	74909542	74910148	0	607	178	4369	178	3762	0.0	0.04731525784157363
chr14	RPS6KL1	74918512	74918605	0	94	178	4369	178	4275	0.0	0.04163742690058479
chr14	RPS6KL1	74921977	74922485	51	509	178	4369	127	3860	0.10019646365422397	0.03290155440414508
chr14	RPS6KL1	74922340	74922485	0	146	178	4369	178	4223	0.0	0.04215013023916647
chr14	RPS6KL1	74921977	74922442	51	466	178	4369	127	3903	0.10944206008583691	0.03253907250832693
chr14	PGF	74946212	74946275	0	64	590448	5487	590448	5423	0.0	108.87848054582335
chr14	PGF	74953903	74953946	0	44	590448	5487	590448	5443	0.0	108.47841264008818
chr14	PGF	74953903	74953943	0	41	590448	5487	590448	5446	0.0	108.4186558942343
chr14	PGF	74946732	74946948	374434	217	590448	5487	216014	5270	1725.5023041474653	40.98937381404175
chr14	MLH3	75038339	75038412	0	74	29983	6620	29983	6546	0.0	4.580354414909869
chr14	MLH3	75039910	75040015	0	106	29983	6620	29983	6514	0.0	4.602855388394228
chr14	MLH3	75042378	75042477	0	100	29983	6620	29983	6520	0.0	4.59861963190184
chr14	MLH3	75033418	75033490	0	73	29983	6620	29983	6547	0.0	4.579654803726898
chr14	MLH3	75041614	75041700	0	87	29983	6620	29983	6533	0.0	4.589468850451554
chr14	MLH3	75036592	75036742	0	151	29983	6620	29983	6469	0.0	4.63487401453084
chr14	MLH3	75050851	75051023	0	173	29983	6620	29983	6447	0.0	4.65069024352412
chr14	ACYP1	75061683	75061762	0	80	3447	1809	3447	1729	0.0	1.993637941006362
chr14	NEK9	75095371	75095431	0	61	4964	13134	4964	13073	0.0	0.37971391417425226
chr14	NEK9	75121118	75121174	38	57	4964	13134	4926	13077	0.6666666666666666	0.3766919018123423
chr14	NEK9	75124045	75124223	0	179	4964	13134	4964	12955	0.0	0.3831725202624469
chr14	NEK9	75086647	75086921	0	275	4964	13134	4964	12859	0.0	0.3860331285480986
chr14	NEK9	75086780	75086921	0	142	4964	13134	4964	12992	0.0	0.3820812807881773
chr14	NEK9	75116191	75116410	255	220	4964	13134	4709	12914	1.1590909090909092	0.36464302307573176
chr14	NEK9	75120871	75121007	0	137	4964	13134	4964	12997	0.0	0.38193429252904515
chr14	TMED10	75139073	75139171	0	99	37935	4963	37935	4864	0.0	7.799136513157895
chr14	VASH1-AS1	76783692	76783851	5	160	5	1846	0	1686	0.03125	0.0
chr14	ANGEL1	76804374	76804415	0	42	2842	6078	2842	6036	0.0	0.4708416169648774
chr14	ANGEL1	76810088	76810254	510	167	2842	6078	2332	5911	3.053892215568862	0.3945186939604128
chr14	LINC02289	77071709	77071772	0	64	0	3491	0	3427	0.0	0.0
chr14	POMT2	77278728	77278869	0	142	865	7097	865	6955	0.0	0.12437095614665708
chr14	POMT2	77311948	77312033	0	86	865	7097	865	7011	0.0	0.12337754956496934
chr14	POMT2	77278728	77278961	0	234	865	7097	865	6863	0.0	0.12603817572490164
chr14	VIPAS39	77457094	77457365	0	272	71	3451	71	3179	0.0	0.02233406731676628
chr14	VIPAS39	77451186	77451333	0	148	71	3451	71	3303	0.0	0.021495610051468363
chr14	VIPAS39	77457094	77457413	0	320	71	3451	71	3131	0.0	0.022676461194506548
chr14	ISM2	77482321	77482667	51	347	153	4104	102	3757	0.14697406340057637	0.027149321266968326
chr14	ISM2	77484322	77484565	0	244	153	4104	153	3860	0.0	0.039637305699481866
chr14	ISM2	77498223	77498328	0	106	153	4104	153	3998	0.0	0.03826913456728364
chr14	ALKBH1	77694737	77694900	0	164	0	2854	0	2690	0.0	0.0
chr14	DIO2	80205601	80205735	0	135	0	2204	0	2069	0.0	0.0
chr14	DIO2	80206230	80206338	0	109	0	2204	0	2095	0.0	0.0
chr14	CEP128	80527168	80527261	0	94	1018	9385	1018	9291	0.0	0.10956839952642342
chr14	CEP128	80939384	80939540	51	157	1018	9385	967	9228	0.3248407643312102	0.10478977026441266
chr14	CEP128	80942283	80942380	0	98	1018	9385	1018	9287	0.0	0.10961559168730484
chr14	AC007262.2	81099398	81099526	0	129	0	5177	0	5048	0.0	0.0
chr14	GTF2A1	81209869	81209936	0	68	255	6833	255	6765	0.0	0.037694013303769404
chr14	STON2	81324016	81324187	0	172	653	7827	653	7655	0.0	0.0853037230568256
chr14	STON2	81427101	81427212	0	112	653	7827	653	7715	0.0	0.0846403110823072
chr14	LINC02311	81734700	81734854	0	155	3054	2521	3054	2366	0.0	1.2907861369399831
chr14	LINC02311	81735936	81735998	0	63	3054	2521	3054	2458	0.0	1.242473555736371
chr14	LINC02316	86054533	86054675	0	143	12	3279	12	3136	0.0	0.003826530612244898
chr14	LINC02316	86054533	86054602	0	70	12	3279	12	3209	0.0	0.00373948270489249
chr14	LINC02316	86060108	86060378	0	271	12	3279	12	3008	0.0	0.003989361702127659
chr14	GALC	87945552	87945733	0	182	0	5661	0	5479	0.0	0.0
chr14	GALC	87988454	87988523	0	70	0	5661	0	5591	0.0	0.0
chr14	GALC	87981413	87981447	0	35	0	5661	0	5626	0.0	0.0
chr14	GALC	87986968	87987056	0	89	0	5661	0	5572	0.0	0.0
chr14	GALC	87992303	87992405	0	103	0	5661	0	5558	0.0	0.0
chr14	PTPN21	88547528	88547651	0	124	6	7692	6	7568	0.0	0.0007928118393234672
chr14	EML5	88622603	88622718	0	116	0	11046	0	10930	0.0	0.0
chr14	EML5	88705719	88705873	0	155	0	11046	0	10891	0.0	0.0
chr14	FOXN3	89190383	89190449	0	67	23	11177	23	11110	0.0	0.0020702070207020704
chr14	FOXN3	89190386	89190449	0	64	23	11177	23	11113	0.0	0.0020696481598128317
chr14	FOXN3	89284427	89284522	0	96	23	11177	23	11081	0.0	0.002075624943597148
chr14	FOXN3	89333113	89333259	0	147	23	11177	23	11030	0.0	0.002085222121486854
chr14	FOXN3	89486568	89486671	0	104	23	11177	23	11073	0.0	0.0020771245371624674
chr14	EFCAB11	89924512	89924677	0	166	1959	7113	1959	6947	0.0	0.28199222686051534
chr14	NRDE2	90302719	90303125	0	407	204	17314	204	16907	0.0	0.012066008162299639
chr14	NRDE2	90301773	90301803	0	31	204	17314	204	17283	0.0	0.011803506335705607
chr14	TTC7B	90578105	90578308	0	204	8850	21297	8850	21093	0.0	0.4195704736168397
chr14	TTC7B	90602005	90602200	0	196	8850	21297	8850	21101	0.0	0.4194114023032084
chr14	TTC7B	90603252	90603303	0	52	8850	21297	8850	21245	0.0	0.4165686043775006
chr14	TTC7B	90605596	90605758	0	163	8850	21297	8850	21134	0.0	0.4187565061039084
chr14	TTC7B	90699157	90699223	0	67	8850	21297	8850	21230	0.0	0.4168629298162977
chr14	RPS6KA5	90947434	90947550	0	117	2478001	28004	2478001	27887	0.0	88.85864381252914
chr14	RPS6KA5	90919279	90919466	0	188	2478001	28004	2478001	27816	0.0	89.08545441472533
chr14	RPS6KA5	90939536	90939599	0	64	2478001	28004	2478001	27940	0.0	88.69008589835362
chr14	RPS6KA5	91052322	91052462	0	141	2478001	28004	2478001	27863	0.0	88.93518285898863
chr14	CCDC88C	91285394	91285836	102	443	4404	11557	4302	11114	0.23024830699774265	0.3870793593665647
chr14	PPP4R3A	91466260	91466416	0	157	0	5929	0	5772	0.0	0.0
chr14	CATSPERB	91659836	91659981	0	146	16636	5666	16636	5520	0.0	3.013768115942029
chr14	CATSPERB	91723048	91723189	315	142	16636	5666	16321	5524	2.2183098591549295	2.9545619116582187
chr14	CATSPERB	91736693	91736849	0	157	16636	5666	16636	5509	0.0	3.019785805046288
chr14	CATSPERB	91778974	91779070	0	97	16636	5666	16636	5569	0.0	2.987250852935895
chr14	TC2N	91792366	91792558	648	193	19899	6166	19251	5973	3.3575129533678756	3.2230035158211954
chr14	TC2N	91797784	91797901	0	118	19899	6166	19899	6048	0.0	3.2901785714285716
chr14	FBLN5	91938329	91938452	0	124	21809	4991	21809	4867	0.0	4.480994452434765
chr14	FBLN5	91939849	91939950	2152	102	21809	4991	19657	4889	21.098039215686274	4.020658621394968
chr14	FBLN5	91942036	91942174	2862	139	21809	4991	18947	4852	20.58992805755396	3.904987633965375
chr14	FBLN5	91942036	91942180	3517	145	21809	4991	18292	4846	24.255172413793105	3.7746595130004126
chr14	TRIP11	92010985	92011072	0	88	2111	10396	2111	10308	0.0	0.20479239425688786
chr14	TRIP11	91977125	91977248	0	124	2111	10396	2111	10272	0.0	0.2055101246105919
chr14	ATXN3	92047895	92048089	0	195	153	9265	153	9070	0.0	0.01686879823594267
chr14	ATXN3	92046274	92046308	0	35	153	9265	153	9230	0.0	0.01657638136511376
chr14	ATXN3	92047895	92047987	0	93	153	9265	153	9172	0.0	0.01668120366332316
chr14	ATXN3	92047895	92047997	0	103	153	9265	153	9162	0.0	0.01669941060903733
chr14	ATXN3	92082299	92082466	51	168	153	9265	102	9097	0.30357142857142855	0.011212487633285698
chr14	ATXN3	92088729	92088817	0	89	153	9265	153	9176	0.0	0.016673931996512643
chr14	ATXN3	92093251	92093318	0	68	153	9265	153	9197	0.0	0.0166358595194085
chr14	ATXN3	92093745	92093831	0	87	153	9265	153	9178	0.0	0.016670298539986927
chr14	ATXN3	92096092	92096137	0	46	153	9265	153	9219	0.0	0.01659616010413277
chr14	ATXN3	92096673	92096838	0	166	153	9265	153	9099	0.0	0.016815034619188922
chr14	ATXN3	92080540	92080567	0	28	153	9265	153	9237	0.0	0.016563819421890225
chr14	ATXN3	92096092	92096134	0	43	153	9265	153	9222	0.0	0.016590761223162005
chr14	ATXN3	92080964	92081061	0	98	153	9265	153	9167	0.0	0.016690302170830153
chr14	ATXN3	92079414	92079468	0	55	153	9265	153	9210	0.0	0.016612377850162865
chr14	ATXN3	92083416	92083503	0	88	153	9265	153	9177	0.0	0.016672115070284408
chr14	ATXN3	92093745	92093850	0	106	153	9265	153	9159	0.0	0.016704880445463477
chr14	NDUFB1	92118848	92118966	0	119	0	2268	0	2149	0.0	0.0
chr14	LGMN	92716135	92716221	0	87	0	3797	0	3710	0.0	0.0
chr14	LGMN	92706482	92706653	0	172	0	3797	0	3625	0.0	0.0
chr14	LGMN	92704639	92704707	0	69	0	3797	0	3728	0.0	0.0
chr14	LGMN	92741061	92741179	0	119	0	3797	0	3678	0.0	0.0
chr14	LGMN	92733681	92733810	0	130	0	3797	0	3667	0.0	0.0
chr14	LGMN	92741717	92741859	0	143	0	3797	0	3654	0.0	0.0
chr14	LGMN	92741704	92741859	0	156	0	3797	0	3641	0.0	0.0
chr14	LGMN	92742908	92743021	0	114	0	3797	0	3683	0.0	0.0
chr14	ITPK1	92993879	92993997	0	119	12	6805	12	6686	0.0	0.0017947950942267424
chr14	ITPK1	93016675	93016801	0	127	12	6805	12	6678	0.0	0.0017969451931716084
chr14	ITPK1	93076594	93076619	0	26	12	6805	12	6779	0.0	0.0017701725918277031
chr14	BTBD7	93261601	93261677	123	77	18997	11346	18874	11269	1.5974025974025974	1.6748602360457894
chr14	BTBD7	93263784	93263993	16936	210	18997	11346	2061	11136	80.64761904761905	0.18507543103448276
chr14	PRIMA1	93725835	93726006	0	172	5751	3902	5751	3730	0.0	1.5418230563002682
chr14	ASB2	93953351	93953507	0	157	0	4762	0	4605	0.0	0.0
chr14	ASB2	93956765	93956870	0	106	0	4762	0	4656	0.0	0.0
chr14	ASB2	93964333	93964612	0	280	0	4762	0	4482	0.0	0.0
chr14	DDX24	94079024	94079747	0	724	51	4993	51	4269	0.0	0.011946591707659873
chr14	DDX24	94079024	94079621	0	598	51	4993	51	4395	0.0	0.011604095563139932
chr14	IFI27L2	94128513	94128675	0	163	0	1313	0	1150	0.0	0.0
chr14	SERPINA1	94388559	94388663	0	105	0	4706	0	4601	0.0	0.0
chr14	SERPINA1	94388818	94389010	0	193	0	4706	0	4513	0.0	0.0
chr14	SERPINA1	94388800	94389010	0	211	0	4706	0	4495	0.0	0.0
chr14	SERPINA1	94388559	94388660	0	102	0	4706	0	4604	0.0	0.0
chr14	DICER1	95091202	95091365	0	164	2499	10278	2499	10114	0.0	0.24708325093929207
chr14	DICER1	95092568	95092694	0	127	2499	10278	2499	10151	0.0	0.2461826421042262
chr14	DICER1	95134360	95134503	0	144	2499	10278	2499	10134	0.0	0.24659561870929544
chr14	DICER1	95141153	95141187	0	35	2499	10278	2499	10243	0.0	0.2439714927267402
chr14	CLMN	95222402	95222599	0	198	191821	5891	191821	5693	0.0	33.69418584226243
chr14	TCL1A	95711748	95711802	0	55	0	1869	0	1814	0.0	0.0
chr14	TCL1A	95711753	95711802	0	50	0	1869	0	1819	0.0	0.0
chr14	TCL1A	95712550	95712774	0	225	0	1869	0	1644	0.0	0.0
chr14	LINC02291	97637482	97637635	0	154	0	1828	0	1674	0.0	0.0
chr14	LINC01550	97969272	97969470	0	199	0	6919	0	6720	0.0	0.0
chr14	LINC01550	97969272	97969547	0	276	0	6919	0	6643	0.0	0.0
chr14	LINC01550	97960262	97960417	0	156	0	6919	0	6763	0.0	0.0
chr14	BCL11B	99257470	99257839	0	370	0	8532	0	8162	0.0	0.0
chr14	BCL11B	99231344	99231557	0	214	0	8532	0	8318	0.0	0.0
chr14	SETD3	99461191	99461340	0	150	0	5201	0	5051	0.0	0.0
chr14	CCDC85C	99517087	99517183	0	97	0	17631	0	17534	0.0	0.0
chr14	DEGS2	100148967	100149710	0	744	781	3952	781	3208	0.0	0.24345386533665836
chr14	SLC25A29	100298841	100298885	0	45	3951	5646	3951	5601	0.0	0.7054097482592394
chr14	SLC25A29	100295625	100295697	0	73	3951	5646	3951	5573	0.0	0.7089538848017226
chr14	SLC25A29	100295625	100295993	430	369	3951	5646	3521	5277	1.165311653116531	0.6672351714989577
chr14	WARS1	100360553	100360662	0	110	38826	6022	38826	5912	0.0	6.567320703653586
chr14	WARS1	100369086	100369258	0	173	38826	6022	38826	5849	0.0	6.63805778765601
chr14	WARS1	100374135	100374265	476	131	38826	6022	38350	5891	3.633587786259542	6.509930402308607
chr14	WARS1	100375282	100375350	0	69	38826	6022	38826	5953	0.0	6.522089702670923
chr14	WARS1	100375282	100375406	0	125	38826	6022	38826	5897	0.0	6.584025775818213
chr14	WARS1	100373979	100374064	12198	86	38826	6022	26628	5936	141.8372093023256	4.485849056603773
chr14	WARS1	100374135	100374179	24	45	38826	6022	38802	5977	0.5333333333333333	6.491885561318387
chr14	WARS1	100374135	100374244	119	110	38826	6022	38707	5912	1.0818181818181818	6.547192151556157
chr14	WARS1	100365474	100365576	0	103	38826	6022	38826	5919	0.0	6.5595539787126205
chr14	WARS1	100365953	100366067	0	115	38826	6022	38826	5907	0.0	6.572879634332148
chr14	WARS1	100375282	100375403	0	122	38826	6022	38826	5900	0.0	6.580677966101695
chr14	WARS1	100374135	100374149	0	15	38826	6022	38826	6007	0.0	6.463459297486266
chr14	WARS1	100368373	100368465	0	93	38826	6022	38826	5929	0.0	6.548490470568392
chr14	WARS1	100374135	100374220	51	86	38826	6022	38775	5936	0.5930232558139535	6.5321765498652296
chr14	WARS1	100375282	100375546	0	265	38826	6022	38826	5757	0.0	6.744137571651902
chr14	BEGAIN	100550419	100550509	0	91	2957	6502	2957	6411	0.0	0.4612384963344252
chr14	AL132709.7	101076054	101076138	0	85	87	2750	87	2665	0.0	0.03264540337711069
chr14	AL132709.7	101074480	101074561	0	82	87	2750	87	2668	0.0	0.03260869565217391
chr14	AL132709.7	101076054	101076333	0	280	87	2750	87	2470	0.0	0.035222672064777326
chr14	DIO3OS	101559799	101560025	0	227	0	4042	0	3815	0.0	0.0
chr14	HSP90AA1	102085757	102086124	0	368	51	4954	51	4586	0.0	0.011120802442215439
chr14	HSP90AA1	102101874	102102085	0	212	51	4954	51	4742	0.0	0.010754955714888232
chr14	HSP90AA1	102085964	102086124	0	161	51	4954	51	4793	0.0	0.010640517421239308
chr14	MOK	102225094	102226408	0	1315	41382	7725	41382	6410	0.0	6.45585023400936
chr14	MOK	102232534	102232708	15318	175	41382	7725	26064	7550	87.53142857142858	3.452185430463576
chr14	MOK	102232534	102232671	13472	138	41382	7725	27910	7587	97.6231884057971	3.678660867272967
chr14	MOK	102231706	102231821	4911	116	41382	7725	36471	7609	42.33620689655172	4.793139702983309
chr14	MOK	102251755	102251804	0	50	41382	7725	41382	7675	0.0	5.391791530944626
chr14	MOK	102238317	102238364	0	48	41382	7725	41382	7677	0.0	5.390386869871043
chr14	MOK	102251443	102251610	0	168	41382	7725	41382	7557	0.0	5.475982532751091
chr14	MOK	102263545	102263616	0	72	41382	7725	41382	7653	0.0	5.4072912583300665
chr14	MOK	102265822	102265912	612	91	41382	7725	40770	7634	6.725274725274725	5.340581608593136
chr14	MOK	102278605	102278694	34	90	41382	7725	41348	7635	0.37777777777777777	5.415586116568435
chr14	CINP	102349918	102350048	255	131	73937	3837	73682	3706	1.9465648854961832	19.881813275769023
chr14	CINP	102352418	102352555	102	138	73937	3837	73835	3699	0.7391304347826086	19.96080021627467
chr14	ANKRD9	102508640	102508846	57196	207	613613	7211	556417	7004	276.30917874396135	79.4427470017133
chr14	CDC42BPB	102954197	102954275	0	79	39824	8038	39824	7959	0.0	5.00364367382837
chr14	CKB	103520468	103520592	0	125	300	2363	300	2238	0.0	0.13404825737265416
chr14	CKB	103520501	103520592	0	92	300	2363	300	2271	0.0	0.13210039630118892
chr14	XRCC3	103712874	103712968	0	95	102	6309	102	6214	0.0	0.016414547795300934
chr14	XRCC3	103712874	103712931	0	58	102	6309	102	6251	0.0	0.016317389217725162
chr14	PPP1R13B	103737693	103737860	0	168	683	8263	683	8095	0.0	0.08437306979617047
chr14	PPP1R13B	103742653	103742823	0	171	683	8263	683	8092	0.0	0.08440434997528423
chr14	PPP1R13B	103784794	103784914	0	121	683	8263	683	8142	0.0	0.08388602309014984
chr14	PPP1R13B	103763862	103764479	0	618	683	8263	683	7645	0.0	0.08933943754087639
chr14	PPP1R13B	103794576	103794663	0	88	683	8263	683	8175	0.0	0.08354740061162079
chr14	ATP5MPL	103915065	103915189	0	125	5159	3421	5159	3296	0.0	1.5652305825242718
chr14	ATP5MPL	103914478	103914633	0	156	5159	3421	5159	3265	0.0	1.580091883614089
chr14	ATP5MPL	103920939	103921208	1181	270	5159	3421	3978	3151	4.374074074074074	1.2624563630593462
chr14	ATP5MPL	103918004	103918124	0	121	5159	3421	5159	3300	0.0	1.5633333333333332
chr14	RD3L	103941396	103941702	36674	307	37059	1457	385	1150	119.45928338762215	0.3347826086956522
chr14	AKT1	104793126	104793304	0	179	51	7131	51	6952	0.0	0.007336018411967779
chr14	AKT1	104793126	104793210	0	85	51	7131	51	7046	0.0	0.007238149304569968
chr14	AKT1	104771721	104771816	0	96	51	7131	51	7035	0.0	0.007249466950959489
chr14	GPR132	105055386	105056166	0	781	0	4200	0	3419	0.0	0.0
chr14	GPR132	105057166	105057280	0	115	0	4200	0	4085	0.0	0.0
chr14	GPR132	105053932	105054165	0	234	0	4200	0	3966	0.0	0.0
chr14	GPR132	105057937	105058027	0	91	0	4200	0	4109	0.0	0.0
chr14	JAG2	105150990	105151104	0	115	50825	6057	50825	5942	0.0	8.553517334230898
chr14	NUDT14	105177122	105177325	2389	204	38929	1924	36540	1720	11.71078431372549	21.24418604651163
chr14	BRF1	105286295	105286376	0	82	432696	12275	432696	12193	0.0	35.487246780939884
chr14	BRF1	105241264	105241414	82984	151	432696	12275	349712	12124	549.5629139072847	28.844605740679643
chr14	AL928654.1	105418681	105418816	26599	136	222005	2368	195406	2232	195.5808823529412	87.54749103942652
chr15	CHEK2P2	20290979	20291018	0	40	0	952	0	912	0.0	0.0
chr15	LINC01193	20942600	20942740	0	141	983	6672	983	6531	0.0	0.15051293829428877
chr15	LINC01193	20990619	20990728	0	110	983	6672	983	6562	0.0	0.1498018896677842
chr15	LINC01193	20996854	20997026	0	173	983	6672	983	6499	0.0	0.15125403908293583
chr15	LINC01193	20981822	20981980	23	159	983	6672	960	6513	0.14465408805031446	0.14739751266697373
chr15	LINC01193	20991290	20991437	0	148	983	6672	983	6524	0.0	0.15067443286327406
chr15	LINC01193	20981822	20981968	23	147	983	6672	960	6525	0.1564625850340136	0.1471264367816092
chr15	LINC01193	20979275	20979357	0	83	983	6672	983	6589	0.0	0.14918804067385036
chr15	LINC01193	20999988	21000032	0	45	983	6672	983	6627	0.0	0.14833257884412254
chr15	AC134980.1	22044436	22044825	0	390	444	2337	444	1947	0.0	0.2280431432973806
chr15	AC134980.1	22051534	22051687	0	154	444	2337	444	2183	0.0	0.2033898305084746
chr15	HERC2P2	22579347	22579477	0	131	1428	7002	1428	6871	0.0	0.2078300101877456
chr15	WHAMMP3	22672306	22672465	0	160	129	5719	129	5559	0.0	0.023205612520237454
chr15	WHAMMP3	22676804	22676934	0	131	129	5719	129	5588	0.0	0.023085182534001433
chr15	NIPA1	22813632	22813714	0	83	0	8696	0	8613	0.0	0.0
chr15	NIPA1	22814082	22814153	0	72	0	8696	0	8624	0.0	0.0
chr15	NIPA2	22839654	22839790	0	137	40305	4741	40305	4604	0.0	8.754344048653344
chr15	NIPA2	22845145	22845267	670	123	40305	4741	39635	4618	5.4471544715447155	8.5827197921178
chr15	NIPA2	22853211	22853268	142	58	40305	4741	40163	4683	2.4482758620689653	8.576339953021566
chr15	NIPA2	22839061	22839174	37	114	40305	4741	40268	4627	0.32456140350877194	8.702831208126216
chr15	MKRN3	23566807	23566984	0	178	204	7026	204	6848	0.0	0.029789719626168224
chr15	PWRN4	24087732	24087830	0	99	42	4181	42	4082	0.0	0.0102890739833415
chr15	PWRN4	23977386	23977491	0	106	42	4181	42	4075	0.0	0.010306748466257669
chr15	PWRN1	24159895	24160045	0	151	51	22178	51	22027	0.0	0.002315340264221183
chr15	PWRN1	24507953	24508140	0	188	51	22178	51	21990	0.0	0.002319236016371078
chr15	PWRN1	24513622	24513737	0	116	51	22178	51	22062	0.0	0.0023116671199347296
chr15	PWRN1	24227202	24227268	0	67	51	22178	51	22111	0.0	0.0023065442539912263
chr15	PWRN1	24225295	24225627	0	333	51	22178	51	21845	0.0	0.0023346303501945525
chr15	PWRN1	24276466	24276658	0	193	51	22178	51	21985	0.0	0.0023197634750966568
chr15	PWRN1	24257116	24257257	0	142	51	22178	51	22036	0.0	0.0023143946269740426
chr15	PWRN1	24287563	24287670	0	108	51	22178	51	22070	0.0	0.002310829179882193
chr15	PWRN1	24287558	24287670	0	113	51	22178	51	22065	0.0	0.0023113528212100613
chr15	PWRN1	24276466	24276710	0	245	51	22178	51	21933	0.0	0.0023252633018738885
chr15	PWRN1	24473052	24473193	0	142	51	22178	51	22036	0.0	0.0023143946269740426
chr15	PWRN1	24493136	24493328	0	193	51	22178	51	21985	0.0	0.0023197634750966568
chr15	PWRN1	24291181	24291279	0	99	51	22178	51	22079	0.0	0.0023098872231532225
chr15	PWRN1	24277378	24277410	0	33	51	22178	51	22145	0.0	0.0023030029351998192
chr15	PWRN1	24280015	24280287	0	273	51	22178	51	21905	0.0	0.0023282355626569277
chr15	PWRN1	24512979	24513173	0	195	51	22178	51	21983	0.0	0.002319974525769913
chr15	PWRN1	24396189	24396304	0	116	51	22178	51	22062	0.0	0.0023116671199347296
chr15	PWRN1	24469151	24469168	0	18	51	22178	51	22160	0.0	0.0023014440433213
chr15	PWRN1	24521631	24521830	0	200	51	22178	51	21978	0.0	0.0023205023205023203
chr15	PWRN1	24535199	24535306	0	108	51	22178	51	22070	0.0	0.002310829179882193
chr15	PWRN1	24568530	24568563	0	34	51	22178	51	22144	0.0	0.002303106936416185
chr15	PWRN1	24567891	24568182	0	292	51	22178	51	21886	0.0	0.002330256785159463
chr15	PWRN1	24587566	24587735	0	170	51	22178	51	22008	0.0	0.002317339149400218
chr15	AC090983.2	24811062	24811218	0	157	0	2917	0	2760	0.0	0.0
chr15	PWRN1	24580226	24580330	0	105	51	22178	51	22073	0.0	0.002310515108956644
chr15	PWRN1	24567896	24568182	0	287	51	22178	51	21891	0.0	0.0023297245443332877
chr15	PWRN1	24569782	24569809	0	28	51	22178	51	22150	0.0	0.0023024830699774268
chr15	PWRN1	24566088	24566212	0	125	51	22178	51	22053	0.0	0.0023126105291797036
chr15	SNRPN	24974310	24974456	0	147	0	3407	0	3260	0.0	0.0
chr15	SNRPN	24829797	24829905	0	109	0	3407	0	3298	0.0	0.0
chr15	SNRPN	24912362	24912530	0	169	0	3407	0	3238	0.0	0.0
chr15	SNRPN	24958737	24958868	0	132	0	3407	0	3275	0.0	0.0
chr15	SNRPN	24942274	24942462	0	189	0	3407	0	3218	0.0	0.0
chr15	SNRPN	24967028	24967240	0	213	0	3407	0	3194	0.0	0.0
chr15	SNRPN	24974386	24974456	0	71	0	3407	0	3336	0.0	0.0
chr15	SNRPN	24967028	24967152	0	125	0	3407	0	3282	0.0	0.0
chr15	SNRPN	24974641	24974957	0	317	0	3407	0	3090	0.0	0.0
chr15	SNRPN	24974397	24974456	0	60	0	3407	0	3347	0.0	0.0
chr15	SNRPN	24974287	24974456	0	170	0	3407	0	3237	0.0	0.0
chr15	AC124312.1	24981774	24982437	0	664	0	1600	0	936	0.0	0.0
chr15	SNHG14	25051101	25051236	0	136	1162	110104	1162	109968	0.0	0.010566710315728213
chr15	SNHG14	25079825	25080079	0	255	1162	110104	1162	109849	0.0	0.010578157288641681
chr15	SNHG14	25085189	25085322	0	134	1162	110104	1162	109970	0.0	0.010566518141311267
chr15	SNHG14	25095626	25095828	0	203	1162	110104	1162	109901	0.0	0.01057315220061692
chr15	SNHG14	25111764	25111894	0	131	1162	110104	1162	109973	0.0	0.010566229892791866
chr15	SNHG14	25115298	25115656	0	359	1162	110104	1162	109745	0.0	0.01058818169392683
chr15	SNHG14	25053265	25053363	0	99	1162	110104	1162	110005	0.0	0.01056315622017181
chr15	SNHG14	25061305	25061413	0	109	1162	110104	1162	109995	0.0	0.010564116550752307
chr15	SNHG14	25091589	25091719	0	131	1162	110104	1162	109973	0.0	0.010566229892791866
chr15	SNHG14	25095718	25095828	0	111	1162	110104	1162	109993	0.0	0.010564308637822407
chr15	SNHG14	25067411	25067531	0	121	1162	110104	1162	109983	0.0	0.010565269177963868
chr15	SNHG14	25100778	25100890	0	113	1162	110104	1162	109991	0.0	0.010564500731878063
chr15	SNHG14	25101822	25101931	0	110	1162	110104	1162	109994	0.0	0.010564212593414186
chr15	SNHG14	25095626	25095728	0	103	1162	110104	1162	110001	0.0	0.010563540331451533
chr15	SNHG14	25067408	25067531	0	124	1162	110104	1162	109980	0.0	0.010565557374068012
chr15	SNHG14	25055073	25055230	0	158	1162	110104	1162	109946	0.0	0.010568824695759737
chr15	SNHG14	25080124	25080229	0	106	1162	110104	1162	109998	0.0	0.010563828433244242
chr15	SNHG14	25077218	25077316	0	99	1162	110104	1162	110005	0.0	0.01056315622017181
chr15	SNHG14	25086509	25086614	0	106	1162	110104	1162	109998	0.0	0.010563828433244242
chr15	SNHG14	25110385	25110536	0	152	1162	110104	1162	109952	0.0	0.010568247962747381
chr15	SNHG14	25115265	25115656	0	392	1162	110104	1162	109712	0.0	0.010591366486801809
chr15	SNHG14	25086330	25086464	0	135	1162	110104	1162	109969	0.0	0.010566614227645973
chr15	SNHG14	25112214	25112336	0	123	1162	110104	1162	109981	0.0	0.010565461306953019
chr15	SNHG14	25105699	25105824	0	126	1162	110104	1162	109978	0.0	0.010565749513539072
chr15	SNHG14	25181809	25181895	0	87	1162	110104	1162	110017	0.0	0.01056200405391894
chr15	SNHG14	25239649	25239781	0	133	1162	110104	1162	109971	0.0	0.010566422056724046
chr15	SNHG14	25244134	25244271	0	138	1162	110104	1162	109966	0.0	0.010566902497135478
chr15	SNHG14	25249013	25249147	0	135	1162	110104	1162	109969	0.0	0.010566614227645973
chr15	SNHG14	25234057	25234203	0	147	1162	110104	1162	109957	0.0	0.01056776739998363
chr15	SNHG14	25232867	25233681	0	815	1162	110104	1162	109289	0.0	0.01063236007283441
chr15	SNHG14	25209731	25209861	0	131	1162	110104	1162	109973	0.0	0.010566229892791866
chr15	SNHG14	25381268	25381389	0	122	1162	110104	1162	109982	0.0	0.010565365241584987
chr15	SNHG14	25391595	25391791	0	197	1162	110104	1162	109907	0.0	0.010572574995223235
chr15	SNHG14	25247866	25248003	0	138	1162	110104	1162	109966	0.0	0.010566902497135478
chr15	SNHG14	25227431	25227476	0	46	1162	110104	1162	110058	0.0	0.010558069381598794
chr15	SNHG14	25233590	25233681	0	92	1162	110104	1162	110012	0.0	0.01056248409264444
chr15	SNHG14	25264642	25264720	0	79	1162	110104	1162	110025	0.0	0.010561236082708475
chr15	LINC02346	26049124	26049242	0	119	158	8364	158	8245	0.0	0.019163129169193452
chr15	LINC02346	26035211	26035342	0	132	158	8364	158	8232	0.0	0.019193391642371233
chr15	LINC02346	26051704	26051783	107	80	158	8364	51	8284	1.3375	0.0061564461612747465
chr15	LINC00929	26125610	26126022	0	413	0	3665	0	3252	0.0	0.0
chr15	LINC00929	26132290	26132360	0	71	0	3665	0	3594	0.0	0.0
chr15	LINC00929	26125208	26125313	0	106	0	3665	0	3559	0.0	0.0
chr15	LINC00929	26132306	26132360	0	55	0	3665	0	3610	0.0	0.0
chr15	LINC00929	26118691	26118828	0	138	0	3665	0	3527	0.0	0.0
chr15	LINC02248	26445556	26445643	0	88	0	2812	0	2724	0.0	0.0
chr15	GABRA5	26869174	26869334	0	161	0	3621	0	3460	0.0	0.0
chr15	GABRA5	26868728	26868793	0	66	0	3621	0	3555	0.0	0.0
chr15	HERC2P9	28655494	28655691	0	198	213	8168	213	7970	0.0	0.026725219573400252
chr15	HERC2P9	28673671	28673781	0	111	213	8168	213	8057	0.0	0.02643663894749907
chr15	HERC2P9	28618218	28618378	0	161	213	8168	213	8007	0.0	0.02660172349194455
chr15	WHAMMP2	28745596	28745755	0	160	51	6666	51	6506	0.0	0.00783891792191823
chr15	APBA2	29094277	29094313	240	37	8992	6889	8752	6852	6.486486486486487	1.2772913018096905
chr15	APBA2	28895519	28895609	0	91	8992	6889	8992	6798	0.0	1.3227419829361577
chr15	APBA2	28893873	28894044	471	172	8992	6889	8521	6717	2.738372093023256	1.2685722792913503
chr15	ULK4P3	30116891	30116938	0	48	969	1460	969	1412	0.0	0.6862606232294618
chr15	AC127502.1	30480741	30480907	0	167	0	2339	0	2172	0.0	0.0
chr15	ULK4P2	30584400	30584574	0	175	0	1570	0	1395	0.0	0.0
chr15	AC091057.1	30748575	30748670	0	96	16781	5642	16781	5546	0.0	3.025784349080418
chr15	FAN1	30910613	30910815	10	203	128408	15722	128398	15519	0.04926108374384237	8.273600103099426
chr15	FAN1	30912443	30913705	178	1263	128408	15722	128230	14459	0.14093428345209819	8.868524794245799
chr15	FAN1	30906370	30906504	0	135	128408	15722	128408	15587	0.0	8.23814717392699
chr15	FAN1	30905724	30905897	0	174	128408	15722	128408	15548	0.0	8.258811422691021
chr15	AC009562.1	31035569	31035656	0	88	1580	2141	1580	2053	0.0	0.7696054554310765
chr15	CHRNA7	32111789	32111899	0	111	102	13012	102	12901	0.0	0.007906363847763739
chr15	CHRNA7	32153906	32153986	0	81	102	13012	102	12931	0.0	0.00788802103472276
chr15	CHRNA7	32159568	32159655	0	88	102	13012	102	12924	0.0	0.007892293407613741
chr15	CHRNA7	32163225	32163335	0	111	102	13012	102	12901	0.0	0.007906363847763739
chr15	CHRNA7	32159577	32159655	0	79	102	13012	102	12933	0.0	0.007886801206216655
chr15	CHRNA7	32112239	32112363	0	125	102	13012	102	12887	0.0	0.007914953053464732
chr15	CHRNA7	32167359	32167556	51	198	102	13012	51	12814	0.25757575757575757	0.003980021851100359
chr15	CHRNA7	32112236	32112363	0	128	102	13012	102	12884	0.0	0.007916796026078858
chr15	CHRNA7	32111799	32111899	0	101	102	13012	102	12911	0.0	0.007900240105336534
chr15	GOLGA8N	32599419	32599527	0	109	1336	6366	1336	6257	0.0	0.21352085664056256
chr15	SCG5	32691709	32691763	0	55	51	2204	51	2149	0.0	0.023731968357375524
chr15	RYR3	33473418	33473538	0	121	14	19804	14	19683	0.0	0.0007112736879540721
chr15	RYR3	33826251	33826269	0	19	14	19804	14	19785	0.0	0.0007076067728076826
chr15	RYR3	33836905	33836987	0	83	14	19804	14	19721	0.0	0.0007099031489275391
chr15	RYR3	33843487	33843574	0	88	14	19804	14	19716	0.0	0.0007100831811726517
chr15	RYR3	33807554	33807569	0	16	14	19804	14	19788	0.0	0.0007074994946432181
chr15	RYR3	33807554	33807800	0	247	14	19804	14	19557	0.0	0.0007158562151659253
chr15	RYR3	33855883	33856051	0	169	14	19804	14	19635	0.0	0.00071301247771836
chr15	CHRM5	34046539	34046871	0	333	102	6045	102	5712	0.0	0.017857142857142856
chr15	EMC4	34225535	34225650	0	116	102	2766	102	2650	0.0	0.038490566037735846
chr15	EMC4	34227692	34227846	0	155	102	2766	102	2611	0.0	0.03906549214860207
chr15	EMC4	34228428	34228589	0	162	102	2766	102	2604	0.0	0.03917050691244239
chr15	EMC4	34225563	34225650	0	88	102	2766	102	2678	0.0	0.038088125466766244
chr15	EMC4	34225514	34225650	0	137	102	2766	102	2629	0.0	0.03879802206162039
chr15	EMC4	34225535	34225658	0	124	102	2766	102	2642	0.0	0.03860711582134747
chr15	EMC4	34228436	34228589	0	154	102	2766	102	2612	0.0	0.03905053598774885
chr15	NUTM1	34345941	34346035	0	95	161	4204	161	4109	0.0	0.039182282793867124
chr15	NUTM1	34345856	34346035	0	180	161	4204	161	4024	0.0	0.04000994035785288
chr15	AC087457.1	34777270	34777431	0	162	1224	4720	1224	4558	0.0	0.2685388328214129
chr15	DPH6-DT	35857121	35857203	0	83	0	2857	0	2774	0.0	0.0
chr15	CDIN1	36644277	36644323	0	47	102	9162	102	9115	0.0	0.011190345584201865
chr15	CDIN1	36709855	36709961	0	107	102	9162	102	9055	0.0	0.011264494754279404
chr15	CDIN1	36709837	36709961	0	125	102	9162	102	9037	0.0	0.011286931503817639
chr15	CDIN1	36645222	36645287	0	66	102	9162	102	9096	0.0	0.011213720316622692
chr15	CDIN1	36591782	36591896	0	115	102	9162	102	9047	0.0	0.011274455620647729
chr15	CDIN1	36658260	36658294	0	35	102	9162	102	9127	0.0	0.01117563273803002
chr15	CDIN1	36668110	36668219	0	110	102	9162	102	9052	0.0	0.011268228015908087
chr15	CDIN1	36640604	36640659	0	56	102	9162	102	9106	0.0	0.011201405666593455
chr15	TMCO5A	37936018	37936193	0	176	51	4376	51	4200	0.0	0.012142857142857143
chr15	LINC02345	38021228	38021272	0	45	0	2302	0	2257	0.0	0.0
chr15	SPRED1	38268173	38268237	0	65	31	7759	31	7694	0.0	0.004029113595009098
chr15	LINC02694	38689237	38689314	0	78	410	8497	410	8419	0.0	0.04869937047155244
chr15	AC113146.1	39168735	39168842	0	108	204	1654	204	1546	0.0	0.13195342820181113
chr15	AC113146.1	39179140	39179294	0	155	204	1654	204	1499	0.0	0.13609072715143428
chr15	AC109630.1	39480331	39480380	0	50	255	3057	255	3007	0.0	0.08480212836714333
chr15	AC109630.1	39477756	39477967	0	212	255	3057	255	2845	0.0	0.08963093145869948
chr15	EIF2AK4	39985804	39985888	0	85	102	8943	102	8858	0.0	0.011515014675999097
chr15	EIF2AK4	40016501	40016672	102	172	102	8943	0	8771	0.5930232558139535	0.0
chr15	SRP14-AS1	40064295	40064601	117	307	4136	5059	4019	4752	0.3811074918566775	0.8457491582491582
chr15	SRP14-AS1	40046861	40047221	0	361	4136	5059	4136	4698	0.0	0.8803746275010643
chr15	SRP14-AS1	40064460	40064601	0	142	4136	5059	4136	4917	0.0	0.8411633109619687
chr15	BUB1B	40165052	40165196	51	145	1491	4281	1440	4136	0.35172413793103446	0.3481624758220503
chr15	BUB1B	40166358	40166482	0	125	1491	4281	1491	4156	0.0	0.3587584215591915
chr15	PAK6	40274141	40274276	42	136	7840	6404	7798	6268	0.3088235294117647	1.2440970006381622
chr15	PAK6	40240598	40240681	0	84	7840	6404	7840	6320	0.0	1.240506329113924
chr15	PAK6	40263798	40263919	0	122	7840	6404	7840	6282	0.0	1.2480101878382681
chr15	PAK6	40263803	40263919	0	117	7840	6404	7840	6287	0.0	1.247017655479561
chr15	PAK6	40256842	40257086	0	245	7840	6404	7840	6159	0.0	1.2729339178438057
chr15	KNSTRN	40391492	40391554	153	63	12011	3389	11858	3326	2.4285714285714284	3.565243535778713
chr15	KNSTRN	40384456	40384519	0	64	12011	3389	12011	3325	0.0	3.612330827067669
chr15	KNSTRN	40389165	40389291	0	127	12011	3389	12011	3262	0.0	3.6820968730839976
chr15	IVD	40414888	40414982	0	95	0	6598	0	6503	0.0	0.0
chr15	IVD	40407635	40407725	0	91	0	6598	0	6507	0.0	0.0
chr15	IVD	40407635	40407812	0	178	0	6598	0	6420	0.0	0.0
chr15	IVD	40424134	40424216	0	83	0	6598	0	6515	0.0	0.0
chr15	KNL1	40605109	40605149	41	41	81423	8770	81382	8729	1.0	9.323175621491579
chr15	KNL1	40610798	40610876	0	79	81423	8770	81423	8691	0.0	9.368657231618917
chr15	KNL1	40618958	40619011	0	54	81423	8770	81423	8716	0.0	9.341785222579166
chr15	KNL1	40629272	40629371	0	100	81423	8770	81423	8670	0.0	9.391349480968858
chr15	RAD51	40706176	40706294	204	119	7900	2952	7696	2833	1.7142857142857142	2.7165548888104483
chr15	RAD51	40718804	40718899	0	96	7900	2952	7900	2856	0.0	2.7661064425770308
chr15	RAD51	40729852	40729974	0	123	7900	2952	7900	2829	0.0	2.7925061859314244
chr15	RAD51	40701805	40701926	1884	122	7900	2952	6016	2830	15.442622950819672	2.1257950530035337
chr15	GCHFR	40765826	40765921	51	96	51616	1485	51565	1389	0.53125	37.12383009359251
chr15	GCHFR	40765859	40765921	19	63	51616	1485	51597	1422	0.30158730158730157	36.28481012658228
chr15	ZFYVE19	40809118	40809240	51	123	1383	3308	1332	3185	0.4146341463414634	0.4182103610675039
chr15	ZFYVE19	40809407	40809458	0	52	1383	3308	1383	3256	0.0	0.42475429975429974
chr15	ZFYVE19	40812698	40812902	510	205	1383	3308	873	3103	2.4878048780487805	0.28134063809216886
chr15	ZFYVE19	40808043	40808075	0	33	1383	3308	1383	3275	0.0	0.42229007633587784
chr15	ZFYVE19	40809155	40809240	38	86	1383	3308	1345	3222	0.4418604651162791	0.4174425822470515
chr15	SPINT1	40854059	40854086	0	28	5450	3461	5450	3433	0.0	1.5875327701718613
chr15	SPINT1	40854396	40854522	408	127	5450	3461	5042	3334	3.2125984251968505	1.5122975404919017
chr15	VPS18	40899143	40901014	102	1872	1756	4035	1654	2163	0.05448717948717949	0.764678687008784
chr15	VPS18	40898657	40898811	0	155	1756	4035	1756	3880	0.0	0.45257731958762887
chr15	AC020661.1	40908418	40908545	0	128	2082	1714	2082	1586	0.0	1.3127364438839848
chr15	CHP1	41264164	41264235	0	72	31500	3959	31500	3887	0.0	8.103936197581682
chr15	CHP1	41278766	41278889	620	124	31500	3959	30880	3835	5.0	8.052151238591916
chr15	CHP1	41270556	41270618	0	63	31500	3959	31500	3896	0.0	8.085215605749486
chr15	CHP1	41243666	41243739	87	74	31500	3959	31413	3885	1.1756756756756757	8.085714285714285
chr15	NUSAP1	41375711	41375828	0	118	1177	3040	1177	2922	0.0	0.4028062970568104
chr15	OIP5-AS1	41290304	41290416	0	113	6336	12683	6336	12570	0.0	0.5040572792362769
chr15	AC087721.2	41332155	41333050	102	896	1228	3467	1126	2571	0.11383928571428571	0.43796188253597823
chr15	NUSAP1	41342385	41342454	55	70	1177	3040	1122	2970	0.7857142857142857	0.37777777777777777
chr15	NUSAP1	41345485	41345602	0	118	1177	3040	1177	2922	0.0	0.4028062970568104
chr15	NUSAP1	41365815	41365863	0	49	1177	3040	1177	2991	0.0	0.39351387495820794
chr15	TYRO3	41568877	41569022	459	146	417225	10012	416766	9866	3.143835616438356	42.242651530508816
chr15	TYRO3	41574655	41574712	0	58	417225	10012	417225	9954	0.0	41.915310427968656
chr15	MGA	41742545	41743172	51	628	371376	16128	371325	15500	0.08121019108280254	23.956451612903226
chr15	MAPKBP1	41799822	41799914	0	93	256313	9752	256313	9659	0.0	26.536183869965836
chr15	MAPKBP1	41814549	41814739	134	191	256313	9752	256179	9561	0.7015706806282722	26.794163790398493
chr15	MAPKBP1	41815258	41815405	0	148	256313	9752	256313	9604	0.0	26.688150770512287
chr15	MAPKBP1	41813329	41813347	1975	19	256313	9752	254338	9733	103.94736842105263	26.13151135312853
chr15	JMJD7-PLA2G4B	41847336	41847523	0	188	1922	7884	1922	7696	0.0	0.24974012474012475
chr15	JMJD7	41828393	41828501	5952	109	27286	1974	21334	1865	54.60550458715596	11.439142091152815
chr15	JMJD7-PLA2G4B	41842553	41842591	0	39	1922	7884	1922	7845	0.0	0.2449968132568515
chr15	AC020659.1	41895226	41895336	0	111	102	4463	102	4352	0.0	0.0234375
chr15	GANC	42280916	42281133	0	218	51	10932	51	10714	0.0	0.004760126936718312
chr15	GANC	42278024	42278088	0	65	51	10932	51	10867	0.0	0.00469310757338732
chr15	CAPN3	42389952	42390096	0	145	102	10244	102	10099	0.0	0.010100009901970491
chr15	CAPN3	42408210	42408324	0	115	102	10244	102	10129	0.0	0.010070095764636192
chr15	CAPN3	42410427	42410496	0	70	102	10244	102	10174	0.0	0.010025555337133871
chr15	CAPN3	42405925	42405943	0	19	102	10244	102	10225	0.0	0.009975550122249389
chr15	CAPN3	42405931	42405943	0	13	102	10244	102	10231	0.0	0.00996969993158049
chr15	CAPN3	42409302	42409380	0	79	102	10244	102	10165	0.0	0.010034431874077718
chr15	CAPN3	42407866	42408324	0	459	102	10244	102	9785	0.0	0.010424118548799183
chr15	CAPN3	42409473	42409617	0	145	102	10244	102	10099	0.0	0.010100009901970491
chr15	CAPN3	42408470	42408774	0	305	102	10244	102	9939	0.0	0.010262601871415635
chr15	CAPN3	42408210	42408437	0	228	102	10244	102	10016	0.0	0.01018370607028754
chr15	CAPN3	42410431	42410496	0	66	102	10244	102	10178	0.0	0.01002161524857536
chr15	CAPN3	42411746	42411979	0	234	102	10244	102	10010	0.0	0.01018981018981019
chr15	SNAP23	42521613	42521708	954	96	45062	5373	44108	5277	9.9375	8.358537047564905
chr15	SNAP23	42528261	42528420	39	160	45062	5373	45023	5213	0.24375	8.636677536926914
chr15	SNAP23	42511832	42511903	3784	72	45062	5373	41278	5301	52.55555555555556	7.786832673080551
chr15	SNAP23	42529674	42529819	12519	146	45062	5373	32543	5227	85.74657534246575	6.225942223072508
chr15	HAUS2	42560781	42560870	0	90	18456	4312	18456	4222	0.0	4.371387967787778
chr15	HAUS2	42561269	42561402	0	134	18456	4312	18456	4178	0.0	4.417424605074198
chr15	HAUS2	42558197	42558290	0	94	18456	4312	18456	4218	0.0	4.375533428165007
chr15	HAUS2	42559338	42559408	0	71	18456	4312	18456	4241	0.0	4.351803819853808
chr15	STARD9	42674826	42674964	0	139	2895	20421	2895	20282	0.0	0.14273740262301549
chr15	STARD9	42717976	42718179	306	204	2895	20421	2589	20217	1.5	0.12806054310728596
chr15	STARD9	42673924	42673963	0	40	2895	20421	2895	20381	0.0	0.1420440606447181
chr15	TMEM62	43138573	43138619	0	47	496	4393	496	4346	0.0	0.11412793373216751
chr15	TMEM62	43146492	43146634	0	143	496	4393	496	4250	0.0	0.11670588235294117
chr15	TMEM62	43134256	43134368	0	113	496	4393	496	4280	0.0	0.11588785046728972
chr15	TMEM62	43178606	43178711	0	106	496	4393	496	4287	0.0	0.11569862374620947
chr15	CCNDBP1	43190054	43190151	0	98	1764	5916	1764	5818	0.0	0.3031969749054658
chr15	CCNDBP1	43186153	43186233	0	81	1764	5916	1764	5835	0.0	0.30231362467866324
chr15	CCNDBP1	43194080	43194137	0	58	1764	5916	1764	5858	0.0	0.301126664390577
chr15	CCNDBP1	43185819	43185879	0	61	1764	5916	1764	5855	0.0	0.30128095644748076
chr15	ADAL	43331899	43332000	153	102	4287	5746	4134	5644	1.5	0.7324592487597449
chr15	ADAL	43334944	43335170	11	227	4287	5746	4276	5519	0.048458149779735685	0.7747780394999094
chr15	ADAL	43336625	43336686	0	62	4287	5746	4287	5684	0.0	0.754222378606615
chr15	ADAL	43347015	43347096	375	82	4287	5746	3912	5664	4.573170731707317	0.690677966101695
chr15	TUBGCP4	43403682	43403799	0	118	117399	9091	117399	8973	0.0	13.083584085590104
chr15	TUBGCP4	43399111	43399174	60	64	117399	9091	117339	9027	0.9375	12.99867065470256
chr15	TUBGCP4	43385367	43385508	0	142	117399	9091	117399	8949	0.0	13.118672477371774
chr15	TUBGCP4	43403682	43403842	0	161	117399	9091	117399	8930	0.0	13.146584546472564
chr15	CKMT1B	43594971	43595170	0	200	0	3278	0	3078	0.0	0.0
chr15	CKMT1B	43594878	43595170	0	293	0	3278	0	2985	0.0	0.0
chr15	PDIA3	43753823	43753902	0	80	24916	4235	24916	4155	0.0	5.996630565583634
chr15	PDIA3	43752801	43752946	51	146	24916	4235	24865	4089	0.3493150684931507	6.080948887258498
chr15	PDIA3	43751583	43751758	0	176	24916	4235	24916	4059	0.0	6.138457748213845
chr15	SERF2	43798943	43799107	0	165	4444	8388	4444	8223	0.0	0.5404353642223033
chr15	HYPK	43801131	43801187	10	57	2509	7451	2499	7394	0.17543859649122806	0.337976737895591
chr15	GOLM2	44322964	44323019	0	56	0	6143	0	6087	0.0	0.0
chr15	GOLM2	44331987	44332078	0	92	0	6143	0	6051	0.0	0.0
chr15	GOLM2	44338236	44338317	0	82	0	6143	0	6061	0.0	0.0
chr15	GOLM2	44402886	44403054	0	169	0	6143	0	5974	0.0	0.0
chr15	GOLM2	44319406	44319553	0	148	0	6143	0	5995	0.0	0.0
chr15	CTDSPL2	44490783	44490999	0	217	588	9295	588	9078	0.0	0.06477197620621282
chr15	CTDSPL2	44501961	44502048	0	88	588	9295	588	9207	0.0	0.06386445096122516
chr15	CTDSPL2	44518653	44518864	0	212	588	9295	588	9083	0.0	0.06473632059892107
chr15	EIF3J	44557488	44557650	0	163	51	3136	51	2973	0.0	0.017154389505549948
chr15	TRIM69	44754899	44755376	170	478	4352	6935	4182	6457	0.35564853556485354	0.6476691962211554
chr15	TRIM69	44758620	44758854	0	235	4352	6935	4352	6700	0.0	0.6495522388059701
chr15	TRIM69	44758612	44758803	0	192	4352	6935	4352	6743	0.0	0.6454100548717189
chr15	TRIM69	44758612	44758854	0	243	4352	6935	4352	6692	0.0	0.6503287507471608
chr15	TERB2	44961522	44961584	0	63	384	1509	384	1446	0.0	0.26556016597510373
chr15	TERB2	44976080	44976173	0	94	384	1509	384	1415	0.0	0.2713780918727915
chr15	SORD	45061066	45061226	0	161	1632	8966	1632	8805	0.0	0.18534923339011924
chr15	SORD	45060981	45061226	0	246	1632	8966	1632	8720	0.0	0.1871559633027523
chr15	DUOX1	45131470	45131662	3025	193	41934	8173	38909	7980	15.67357512953368	4.875814536340852
chr15	DUOX1	45139426	45139599	135	174	41934	8173	41799	7999	0.7758620689655172	5.225528191023878
chr15	DUOX1	45131470	45131647	1547	178	41934	8173	40387	7995	8.691011235955056	5.051532207629768
chr15	SLC28A2	45263880	45264022	0	143	51	4685	51	4542	0.0	0.011228533685601057
chr15	SLC28A2	45253199	45253296	0	98	51	4685	51	4587	0.0	0.011118378024852845
chr15	SPATA5L1	45414570	45414780	0	211	0	3407	0	3196	0.0	0.0
chr15	SPATA5L1	45407028	45407223	0	196	0	3407	0	3211	0.0	0.0
chr15	HMGN2P46	45512372	45512449	0	78	255	3103	255	3025	0.0	0.08429752066115702
chr15	HMGN2P46	45515772	45515892	0	121	255	3103	255	2982	0.0	0.08551307847082495
chr15	BLOC1S6	45603099	45603187	0	89	0	6784	0	6695	0.0	0.0
chr15	BLOC1S6	45605427	45605514	0	88	0	6784	0	6696	0.0	0.0
chr15	BLOC1S6	45597879	45597891	0	13	0	6784	0	6771	0.0	0.0
chr15	BLOC1S6	45603103	45603187	0	85	0	6784	0	6699	0.0	0.0
chr15	BLOC1S6	45597879	45597996	0	118	0	6784	0	6666	0.0	0.0
chr15	BLOC1S6	45592134	45592276	0	143	0	6784	0	6641	0.0	0.0
chr15	BLOC1S6	45591457	45591575	0	119	0	6784	0	6665	0.0	0.0
chr15	BLOC1S6	45602356	45602375	0	20	0	6784	0	6764	0.0	0.0
chr15	BLOC1S6	45601233	45601407	0	175	0	6784	0	6609	0.0	0.0
chr15	SEMA6D	47603374	47603458	0	85	0	8530	0	8445	0.0	0.0
chr15	SEMA6D	47768580	47768615	0	36	0	8530	0	8494	0.0	0.0
chr15	SEMA6D	47767036	47767093	0	58	0	8530	0	8472	0.0	0.0
chr15	SEMA6D	47768580	47768748	0	169	0	8530	0	8361	0.0	0.0
chr15	SLC24A5	48121856	48122036	0	181	0	4769	0	4588	0.0	0.0
chr15	SLC12A1	48207533	48208139	0	607	0	8819	0	8212	0.0	0.0
chr15	SLC12A1	48217831	48217969	0	139	0	8819	0	8680	0.0	0.0
chr15	GALK2	49161763	49161861	0	99	156067	7192	156067	7093	0.0	22.002960665444803
chr15	GALK2	49161739	49161861	0	123	156067	7192	156067	7069	0.0	22.07766303579007
chr15	GALK2	49281986	49282085	6055	100	156067	7192	150012	7092	60.55	21.15228426395939
chr15	GALK2	49158844	49158968	0	125	156067	7192	156067	7067	0.0	22.083911136267158
chr15	GALK2	49195084	49195214	0	131	156067	7192	156067	7061	0.0	22.10267667469197
chr15	GALK2	49225204	49225349	0	146	156067	7192	156067	7046	0.0	22.149730343457282
chr15	GALK2	49185613	49185674	0	62	156067	7192	156067	7130	0.0	21.888779803646564
chr15	GALK2	49235624	49235739	0	116	156067	7192	156067	7076	0.0	22.05582249858677
chr15	GALK2	49318971	49319116	0	146	156067	7192	156067	7046	0.0	22.149730343457282
chr15	GALK2	49327951	49328130	0	180	156067	7192	156067	7012	0.0	22.257130633200227
chr15	DTWD1	49631000	49631058	0	59	5908	14874	5908	14815	0.0	0.39878501518731013
chr15	DTWD1	49623670	49623798	0	129	5908	14874	5908	14745	0.0	0.4006781959986436
chr15	DTWD1	49630955	49631058	0	104	5908	14874	5908	14770	0.0	0.4
chr15	DTWD1	49633519	49633612	0	94	5908	14874	5908	14780	0.0	0.3997293640054127
chr15	SLC27A2	50202486	50202645	0	160	0	2804	0	2644	0.0	0.0
chr15	SLC27A2	50198234	50198482	0	249	0	2804	0	2555	0.0	0.0
chr15	USP8	50432337	50432499	0	163	51	20665	51	20502	0.0	0.0024875621890547263
chr15	USP8	50441348	50441493	0	146	51	20665	51	20519	0.0	0.0024855012427506215
chr15	USP8	50449399	50449485	0	87	51	20665	51	20578	0.0	0.0024783749635533094
chr15	USP8	50458999	50459162	0	164	51	20665	51	20501	0.0	0.002487683527632798
chr15	USP8	50484274	50484361	0	88	51	20665	51	20577	0.0	0.0024784954074938037
chr15	USP8	50439008	50439177	0	170	51	20665	51	20495	0.0	0.0024884118077579897
chr15	USP8	50424595	50424654	0	60	51	20665	51	20605	0.0	0.002475127396263043
chr15	AP4E1	50934623	50934697	0	75	67281	7376	67281	7301	0.0	9.215312970825915
chr15	AP4E1	50934535	50934697	0	163	67281	7376	67281	7213	0.0	9.327741577706918
chr15	AP4E1	50999071	50999262	14681	192	67281	7376	52600	7184	76.46354166666667	7.321826280623608
chr15	GLDN	51377448	51377500	0	53	0	7022	0	6969	0.0	0.0
chr15	GLDN	51383435	51383453	0	19	0	7022	0	7003	0.0	0.0
chr15	AC066613.1	51458719	51458929	0	211	0	3284	0	3073	0.0	0.0
chr15	SCG3	51688259	51688402	0	144	51	3183	51	3039	0.0	0.01678183613030602
chr15	SCG3	51682516	51682569	0	54	51	3183	51	3129	0.0	0.016299137104506232
chr15	TMOD2	51767070	51767152	0	83	9716	11560	9716	11477	0.0	0.8465626905985885
chr15	TMOD2	51782720	51782828	0	109	9716	11560	9716	11451	0.0	0.8484848484848485
chr15	TMOD3	51834993	51835058	0	66	4327	8470	4327	8404	0.0	0.5148738695859115
chr15	TMOD3	51934249	51934354	0	106	4327	8470	4327	8364	0.0	0.5173362027737924
chr15	UNC13C	54236429	54236435	0	7	231	14477	231	14470	0.0	0.015964063579820317
chr15	UNC13C	54512347	54512377	0	31	231	14477	231	14446	0.0	0.01599058562923993
chr15	PIGB	55327530	55327635	0	106	0	3377	0	3271	0.0	0.0
chr15	TEX9	56427604	56427739	0	136	26393	8304	26393	8168	0.0	3.231268364348678
chr15	TCF12	57063749	57063823	0	75	1008	9218	1008	9143	0.0	0.11024827737066609
chr15	TCF12	57232290	57232430	0	141	1008	9218	1008	9077	0.0	0.11104990635672579
chr15	TCF12	57252420	57252492	0	73	1008	9218	1008	9145	0.0	0.11022416621104429
chr15	TCF12	57072652	57072714	0	63	1008	9218	1008	9155	0.0	0.11010376843255051
chr15	LINC01413	57320792	57320959	0	168	0	991	0	823	0.0	0.0
chr15	GCOM1	57621607	57621700	0	94	102	8788	102	8694	0.0	0.011732229123533472
chr15	GCOM1	57661449	57661533	0	85	102	8788	102	8703	0.0	0.011720096518441917
chr15	GCOM1	57674967	57675068	0	102	102	8788	102	8686	0.0	0.011743034768593138
chr15	GCOM1	57711983	57712188	0	206	102	8788	102	8582	0.0	0.011885341412258214
chr15	GCOM1	57708713	57709358	0	646	102	8788	102	8142	0.0	0.012527634487840826
chr15	GCOM1	57625778	57625892	0	115	102	8788	102	8673	0.0	0.01176063645797302
chr15	GCOM1	57684401	57684674	0	274	102	8788	102	8514	0.0	0.011980267794221282
chr15	GCOM1	57701552	57701714	0	163	102	8788	102	8625	0.0	0.01182608695652174
chr15	GCOM1	57691898	57691972	0	75	102	8788	102	8713	0.0	0.011706645242740732
chr15	GCOM1	57646136	57646669	0	534	102	8788	102	8254	0.0	0.012357644778289314
chr15	LIPC	58430826	58431151	0	326	51	5004	51	4678	0.0	0.010902094912355708
chr15	LIPC	58538332	58538517	0	186	51	5004	51	4818	0.0	0.010585305105853052
chr15	LIPC	58541784	58541967	0	184	51	5004	51	4820	0.0	0.01058091286307054
chr15	MINDY2	58831773	58831916	0	144	0	9464	0	9320	0.0	0.0
chr15	RNF111	59004001	59004174	0	174	714	7191	714	7017	0.0	0.10175288584865327
chr15	CCNB2	59117227	59117368	0	142	148	1785	148	1643	0.0	0.09007912355447352
chr15	FAM81A	59439023	59439064	0	42	4880	5589	4880	5547	0.0	0.8797548224265369
chr15	FAM81A	59439954	59440123	0	170	4880	5589	4880	5419	0.0	0.90053515408747
chr15	RORA-AS1	60488523	60488591	0	69	51	2155	51	2086	0.0	0.02444870565675935
chr15	RORA-AS1	60519965	60520269	0	305	51	2155	51	1850	0.0	0.027567567567567567
chr15	RORA-AS1	60528579	60528727	0	149	51	2155	51	2006	0.0	0.025423728813559324
chr15	RORA-AS2	60682358	60682433	1251	76	14088	1032	12837	956	16.460526315789473	13.427824267782427
chr15	LINC02349	61730427	61730478	0	52	0	1102	0	1050	0.0	0.0
chr15	TPM1	63059562	63059680	0	119	15989	12357	15989	12238	0.0	1.3065043307730022
chr15	TPM1	63064063	63064190	0	128	15989	12357	15989	12229	0.0	1.3074658598413607
chr15	TPM1	63061712	63061788	32	77	15989	12357	15957	12280	0.4155844155844156	1.29942996742671
chr15	TPM1	63064063	63064142	0	80	15989	12357	15989	12277	0.0	1.3023539952757188
chr15	TPM1	63043705	63043831	0	127	15989	12357	15989	12230	0.0	1.3073589533932952
chr15	TPM1	63044026	63044152	0	127	15989	12357	15989	12230	0.0	1.3073589533932952
chr15	TPM1	63061197	63061273	0	77	15989	12357	15989	12280	0.0	1.3020358306188926
chr15	TPM1	63056984	63057118	0	135	15989	12357	15989	12222	0.0	1.308214694812633
chr15	TPM1	63065895	63066085	0	191	15989	12357	15989	12166	0.0	1.3142363965148776
chr15	TPM1	63064063	63064982	0	920	15989	12357	15989	11437	0.0	1.3980064702282067
chr15	AC087612.1	63106969	63107033	0	65	0	2049	0	1984	0.0	0.0
chr15	RAB8B	63223041	63223073	0	33	0	5114	0	5081	0.0	0.0
chr15	RAB8B	63251283	63251342	0	60	0	5114	0	5054	0.0	0.0
chr15	RAB8B	63223847	63223979	0	133	0	5114	0	4981	0.0	0.0
chr15	APH1B	63287423	63287546	0	124	0	5418	0	5294	0.0	0.0
chr15	APH1B	63302344	63302472	0	129	0	5418	0	5289	0.0	0.0
chr15	APH1B	63278290	63278354	0	65	0	5418	0	5353	0.0	0.0
chr15	USP3	63537024	63537156	0	133	39125	4757	39125	4624	0.0	8.46128892733564
chr15	USP3	63530497	63530590	0	94	39125	4757	39125	4663	0.0	8.390521123740081
chr15	USP3	63529013	63529166	0	154	39125	4757	39125	4603	0.0	8.499891375190094
chr15	USP3	63533802	63533918	0	117	39125	4757	39125	4640	0.0	8.432112068965518
chr15	USP3	63562894	63563008	0	115	39125	4757	39125	4642	0.0	8.428479103834555
chr15	USP3	63542054	63542192	51	139	39125	4757	39074	4618	0.3669064748201439	8.461238631442182
chr15	FBXL22	63599153	63599196	3681	44	93265	3617	89584	3573	83.6590909090909	25.072488105233695
chr15	SNX1	64115588	64115706	0	119	122	6495	122	6376	0.0	0.019134253450439148
chr15	SNX1	64126078	64126220	30	143	122	6495	92	6352	0.2097902097902098	0.014483627204030227
chr15	SNX1	64123502	64123546	0	45	122	6495	122	6450	0.0	0.01891472868217054
chr15	SNX22	64152242	64152326	0	85	51	4065	51	3980	0.0	0.012814070351758794
chr15	TRIP4	64395397	64395531	0	135	840575	2870	840575	2735	0.0	307.3400365630713
chr15	TRIP4	64406329	64406459	255	131	840575	2870	840320	2739	1.9465648854961832	306.79810149689666
chr15	TRIP4	64414084	64414211	0	128	840575	2870	840575	2742	0.0	306.55543398978847
chr15	PLEKHO2	64848592	64848742	288	151	2686	3727	2398	3576	1.9072847682119205	0.6705816554809844
chr15	ANKDD1A	64944651	64944747	0	97	6625	5051	6625	4954	0.0	1.3373031893419458
chr15	ANKDD1A	64950953	64951233	490	281	6625	5051	6135	4770	1.7437722419928825	1.2861635220125787
chr15	HACD3	65534348	65534434	0	87	14320	7025	14320	6938	0.0	2.063995387719804
chr15	HACD3	65556738	65556903	0	166	14320	7025	14320	6859	0.0	2.0877678961947805
chr15	HACD3	65535720	65535834	0	115	14320	7025	14320	6910	0.0	2.072358900144718
chr15	SLC24A1	65645611	65645703	0	93	126	5844	126	5751	0.0	0.02190923317683881
chr15	SLC24A1	65651669	65651759	0	91	126	5844	126	5753	0.0	0.02190161654788806
chr15	SLC24A1	65638127	65638181	0	55	126	5844	126	5789	0.0	0.02176541717049577
chr15	RAB11A	65879670	65879751	825	82	285083	5691	284258	5609	10.060975609756097	50.67890889641647
chr15	RAB11A	65879724	65879751	440	28	285083	5691	284643	5663	15.714285714285714	50.26364117958679
chr15	DIS3L	66318448	66318618	0	171	7	5320	7	5149	0.0	0.0013594872790833172
chr15	ZWILCH	66508745	66508892	0	148	0	4786	0	4638	0.0	0.0
chr15	ZWILCH	66513987	66514083	0	97	0	4786	0	4689	0.0	0.0
chr15	ZWILCH	66508840	66508892	0	53	0	4786	0	4733	0.0	0.0
chr15	SMAD6	66717008	66717140	0	133	35289	8561	35289	8428	0.0	4.187114380635975
chr15	SMAD6	66717011	66717140	0	130	35289	8561	35289	8431	0.0	4.185624481081722
chr15	SMAD3	67184726	67184864	0	139	7360	7224	7360	7085	0.0	1.0388143966125618
chr15	SMAD3	67187019	67187130	0	112	7360	7224	7360	7112	0.0	1.0348706411698538
chr15	IQCH	67359846	67359885	0	40	55177	7149	55177	7109	0.0	7.761569841046561
chr15	IQCH	67395290	67395563	45	274	55177	7149	55132	6875	0.16423357664233576	8.0192
chr15	IQCH	67490002	67490064	0	63	55177	7149	55177	7086	0.0	7.786762630539092
chr15	IQCH	67261271	67261394	0	124	55177	7149	55177	7025	0.0	7.854377224199288
chr15	IQCH	67344062	67344191	0	130	55177	7149	55177	7019	0.0	7.861091323550363
chr15	IQCH	67371427	67371533	0	107	55177	7149	55177	7042	0.0	7.835416074978699
chr15	MAP2K5	67727915	67727945	0	31	2254	5062	2254	5031	0.0	0.44802226197575035
chr15	MAP2K5	67748230	67748257	0	28	2254	5062	2254	5034	0.0	0.44775526420341677
chr15	PIAS1	68087841	68087890	0	50	306	5997	306	5947	0.0	0.051454514881452834
chr15	PIAS1	68183629	68183667	0	39	306	5997	306	5958	0.0	0.0513595166163142
chr15	NOX5	68974728	68974832	0	105	237	12548	237	12443	0.0	0.019046853652656112
chr15	NOX5	69038856	69038989	0	134	237	12548	237	12414	0.0	0.019091348477525374
chr15	EWSAT1	69089537	69089597	573	61	19156	3583	18583	3522	9.39344262295082	5.276263486655309
chr15	EWSAT1	69081185	69081376	49	192	19156	3583	19107	3391	0.2552083333333333	5.634621055735771
chr15	PAQR5	69359965	69360131	0	167	51	6270	51	6103	0.0	0.008356545961002786
chr15	KIF23	69421991	69422128	0	138	0	6339	0	6201	0.0	0.0
chr15	KIF23	69440767	69441079	0	313	0	6339	0	6026	0.0	0.0
chr15	KIF23	69444789	69445041	0	253	0	6339	0	6086	0.0	0.0
chr15	KIF23	69444810	69445041	0	232	0	6339	0	6107	0.0	0.0
chr15	KIF23	69440307	69440487	0	181	0	6339	0	6158	0.0	0.0
chr15	KIF23	69425281	69425323	0	43	0	6339	0	6296	0.0	0.0
chr15	KIF23	69427369	69427499	0	131	0	6339	0	6208	0.0	0.0
chr15	KIF23	69439903	69440077	0	175	0	6339	0	6164	0.0	0.0
chr15	RPLP1	69455169	69455287	0	119	5340	3254	5340	3135	0.0	1.7033492822966507
chr15	RPLP1	69453646	69453721	0	76	5340	3254	5340	3178	0.0	1.6803020767778476
chr15	DRAIC	69563589	69563804	12168	216	128281	25376	116113	25160	56.333333333333336	4.614984101748807
chr15	DRAIC	69464832	69464891	0	60	128281	25376	128281	25316	0.0	5.0671907094327695
chr15	DRAIC	69467429	69467620	0	192	128281	25376	128281	25184	0.0	5.09375
chr15	DRAIC	69548353	69548631	10393	279	128281	25376	117888	25097	37.25089605734767	4.697294497350281
chr15	DRAIC	69548353	69548485	4226	133	128281	25376	124055	25243	31.774436090225564	4.914431723646159
chr15	DRAIC	69466099	69466235	0	137	128281	25376	128281	25239	0.0	5.082649867268909
chr15	DRAIC	69619508	69619671	0	164	128281	25376	128281	25212	0.0	5.088092971600825
chr15	DRAIC	69684296	69684442	0	147	128281	25376	128281	25229	0.0	5.084664473423441
chr15	DRAIC	69548353	69548627	10145	275	128281	25376	118136	25101	36.89090909090909	4.706426038803235
chr15	DRAIC	69624927	69625192	0	266	128281	25376	128281	25110	0.0	5.108761449621665
chr15	DRAIC	69554228	69554374	306	147	128281	25376	127975	25229	2.0816326530612246	5.072535574140869
chr15	DRAIC	69563601	69563804	11039	204	128281	25376	117242	25172	54.11274509803921	4.657635467980295
chr15	DRAIC	69578325	69578461	0	137	128281	25376	128281	25239	0.0	5.082649867268909
chr15	DRAIC	69671725	69671907	765	183	128281	25376	127516	25193	4.180327868852459	5.06156472035883
chr15	DRAIC	69681146	69681308	510	163	128281	25376	127771	25213	3.128834355828221	5.067663506921033
chr15	LRRC49	70872907	70873223	0	317	4840	9178	4840	8861	0.0	0.5462137456269044
chr15	LRRC49	70900921	70901024	0	104	4840	9178	4840	9074	0.0	0.5333921093233415
chr15	LRRC49	70911531	70911598	0	68	4840	9178	4840	9110	0.0	0.531284302963776
chr15	LRRC49	70963784	70963932	0	149	4840	9178	4840	9029	0.0	0.5360505039317753
chr15	LRRC49	70980100	70980184	291	85	4840	9178	4549	9093	3.4235294117647057	0.5002749367645442
chr15	LRRC49	70898366	70898455	0	90	4840	9178	4840	9088	0.0	0.5325704225352113
chr15	LRRC49	70894571	70894669	0	99	4840	9178	4840	9079	0.0	0.5330983588500936
chr15	LRRC49	70895848	70895936	0	89	4840	9178	4840	9089	0.0	0.5325118274837716
chr15	LRRC49	70894571	70894755	0	185	4840	9178	4840	8993	0.0	0.5381963749583009
chr15	LRRC49	70900456	70900582	0	127	4840	9178	4840	9051	0.0	0.5347475417080986
chr15	LRRC49	70900353	70900582	0	230	4840	9178	4840	8948	0.0	0.5409029950827
chr15	LRRC49	70908603	70908676	0	74	4840	9178	4840	9104	0.0	0.531634446397188
chr15	SENP8	72139311	72139435	0	125	6645	4933	6645	4808	0.0	1.382071547420965
chr15	TMEM202	72405969	72406039	0	71	0	1397	0	1326	0.0	0.0
chr15	TMEM202	72407085	72407217	0	133	0	1397	0	1264	0.0	0.0
chr15	TMEM202	72398652	72398908	0	257	0	1397	0	1140	0.0	0.0
chr15	ARIH1	72544819	72544964	253	146	19942	22087	19689	21941	1.7328767123287672	0.8973611047810036
chr15	ARIH1	72572262	72572380	0	119	19942	22087	19942	21968	0.0	0.9077749453750911
chr15	BBS4	72715290	72715402	0	113	51	4162	51	4049	0.0	0.012595702642627809
chr15	BBS4	72729615	72729684	0	70	51	4162	51	4092	0.0	0.012463343108504398
chr15	BBS4	72695176	72695228	0	53	51	4162	51	4109	0.0	0.01241177902165977
chr15	BBS4	72686461	72686564	0	104	51	4162	51	4058	0.0	0.012567767373090193
chr15	BBS4	72697991	72698037	0	47	51	4162	51	4115	0.0	0.012393681652490888
chr15	BBS4	72704423	72704481	0	59	51	4162	51	4103	0.0	0.012429929320009749
chr15	BBS4	72727939	72727994	0	56	51	4162	51	4106	0.0	0.012420847540185095
chr15	NEO1	73274691	73274724	0	34	34914	8169	34914	8135	0.0	4.291825445605409
chr15	NEO1	73293389	73293548	0	160	34914	8169	34914	8009	0.0	4.359345736046947
chr15	REC114	73540484	73540568	0	85	0	926	0	841	0.0	0.0
chr15	CD276	73699585	73699718	0	134	66	5220	66	5086	0.0	0.012976799056232795
chr15	CD276	73697595	73697702	0	108	66	5220	66	5112	0.0	0.012910798122065728
chr15	CD276	73690670	73690776	15	107	66	5220	51	5113	0.14018691588785046	0.00997457461372971
chr15	TBC1D21	73881398	73881506	110	109	212	1281	102	1172	1.0091743119266054	0.08703071672354949
chr15	TBC1D21	73884780	73884891	0	112	212	1281	212	1169	0.0	0.18135158254918735
chr15	LOXL1	73941874	73942058	0	185	0	3644	0	3459	0.0	0.0
chr15	PML	74032571	74032715	0	145	28830	10347	28830	10202	0.0	2.8259164869633406
chr15	PML	74033155	74033414	0	260	28830	10347	28830	10087	0.0	2.8581342321800336
chr15	PML	74033155	74033422	0	268	28830	10347	28830	10079	0.0	2.860402817739855
chr15	CCDC33	74331202	74331296	153	95	34918	6959	34765	6864	1.6105263157894736	5.064831002331002
chr15	CCDC33	74333220	74333322	592	103	34918	6959	34326	6856	5.747572815533981	5.006709451575262
chr15	PPIAP46	74356282	74356475	0	194	51	3706	51	3512	0.0	0.014521640091116172
chr15	UBL7-AS1	74466035	74466130	51	96	11586	2142	11535	2046	0.53125	5.63782991202346
chr15	UBL7-AS1	74480620	74480914	4065	295	11586	2142	7521	1847	13.779661016949152	4.072008662696264
chr15	CLK3	74606242	74606415	0	174	51	14732	51	14558	0.0	0.0035032284654485505
chr15	CLK3	74622119	74622216	0	98	51	14732	51	14634	0.0	0.0034850348503485036
chr15	CLK3	74627969	74628052	0	84	51	14732	51	14648	0.0	0.0034817039868924086
chr15	CLK3	74622493	74622560	0	68	51	14732	51	14664	0.0	0.0034779050736497546
chr15	CLK3	74619196	74619348	0	153	51	14732	51	14579	0.0	0.0034981823170313463
chr15	CLK3	74626988	74627066	0	79	51	14732	51	14653	0.0	0.003480515935303351
chr15	CSK	74798232	74798312	0	81	2813	4066	2813	3985	0.0	0.7058971141781681
chr15	CSK	74798211	74798312	0	102	2813	4066	2813	3964	0.0	0.7096367305751766
chr15	LMAN1L	74816426	74816534	0	109	952	4050	952	3941	0.0	0.24156305506216696
chr15	LMAN1L	74813419	74813479	0	61	952	4050	952	3989	0.0	0.23865630483830533
chr15	LMAN1L	74813336	74813479	0	144	952	4050	952	3906	0.0	0.24372759856630824
chr15	MPI	74890552	74890654	0	103	11714	7175	11714	7072	0.0	1.6563914027149322
chr15	MPI	74893137	74893320	0	184	11714	7175	11714	6991	0.0	1.6755828922900873
chr15	MPI	74890526	74890654	0	129	11714	7175	11714	7046	0.0	1.6625035481124042
chr15	MPI	74890978	74891035	0	58	11714	7175	11714	7117	0.0	1.6459182239707741
chr15	MPI	74890555	74890654	0	100	11714	7175	11714	7075	0.0	1.6556890459363958
chr15	MPI	74890437	74890654	1593	218	11714	7175	10121	6957	7.307339449541284	1.454793732930861
chr15	MPI	74897010	74897219	0	210	11714	7175	11714	6965	0.0	1.68183776022972
chr15	SCAMP5	75009890	75009940	0	51	8255	4634	8255	4583	0.0	1.8012219070477853
chr15	SCAMP5	75016592	75016749	0	158	8255	4634	8255	4476	0.0	1.8442806076854334
chr15	SCAMP5	75007587	75007728	0	142	8255	4634	8255	4492	0.0	1.8377114870881568
chr15	SCAMP5	75007660	75007728	0	69	8255	4634	8255	4565	0.0	1.8083242059145674
chr15	SCAMP5	74997233	74997316	0	84	8255	4634	8255	4550	0.0	1.8142857142857143
chr15	PPCDC	75028246	75028453	0	208	153	3493	153	3285	0.0	0.04657534246575343
chr15	PPCDC	75043440	75043536	0	97	153	3493	153	3396	0.0	0.045053003533568906
chr15	PPCDC	75044385	75044514	0	130	153	3493	153	3363	0.0	0.045495093666369314
chr15	C15ORF39	75201960	75202059	52	100	23948	5813	23896	5713	0.52	4.182741116751269
chr15	COMMD4	75338354	75338420	72	67	53671	4643	53599	4576	1.0746268656716418	11.713068181818182
chr15	COMMD4	75339701	75339878	1625	178	53671	4643	52046	4465	9.129213483146067	11.656438969764837
chr15	COMMD4	75339263	75339344	974	82	53671	4643	52697	4561	11.878048780487806	11.553825915369437
chr15	NEIL1	75347958	75348026	0	69	11132	6176	11132	6107	0.0	1.82282626494187
chr15	NEIL1	75347958	75347999	0	42	11132	6176	11132	6134	0.0	1.8148027388327355
chr15	NEIL1	75352110	75352230	0	121	11132	6176	11132	6055	0.0	1.8384805945499587
chr15	NEIL1	75353738	75353866	306	129	11132	6176	10826	6047	2.372093023255814	1.7903092442533488
chr15	NEIL1	75351300	75351376	0	77	11132	6176	11132	6099	0.0	1.8252172487293
chr15	NEIL1	75347834	75347999	528	166	11132	6176	10604	6010	3.180722891566265	1.7643926788685524
chr15	NEIL1	75348420	75348646	696	227	11132	6176	10436	5949	3.066079295154185	1.7542444108253488
chr15	AC019294.2	75762022	75762129	0	108	229473	6185	229473	6077	0.0	37.760901760737205
chr15	AC019294.2	75762654	75762749	0	96	229473	6185	229473	6089	0.0	37.686483823287894
chr15	AC019294.2	75762674	75762749	0	76	229473	6185	229473	6109	0.0	37.56310361761336
chr15	AC019294.2	75761168	75761347	33071	180	229473	6185	196402	6005	183.7277777777778	32.70641132389675
chr15	AC019294.2	75761461	75761519	14	59	229473	6185	229459	6126	0.23728813559322035	37.45657851779301
chr15	AC019294.1	75782579	75782659	14933	81	17584	2130	2651	2049	184.35802469135803	1.2938018545632015
chr15	UBE2Q2	75859877	75859982	84	106	71990	3845	71906	3739	0.7924528301886793	19.231345279486494
chr15	UBE2Q2	75896994	75897061	178	68	71990	3845	71812	3777	2.6176470588235294	19.012973259200425
chr15	FBXO22	75904490	75904629	0	140	105301	11121	105301	10981	0.0	9.589381659229579
chr15	FBXO22	75917229	75917394	306	166	105301	11121	104995	10955	1.8433734939759037	9.584208124144226
chr15	TMEM266	76156603	76156652	0	50	46258	5159	46258	5109	0.0	9.05421804658446
chr15	TMEM266	76156603	76156758	0	156	46258	5159	46258	5003	0.0	9.246052368578853
chr15	ISL2	76338251	76338514	0	264	10	2177	10	1913	0.0	0.005227391531625719
chr15	RCN2	76941636	76941690	0	55	1734	8781	1734	8726	0.0	0.1987164794865918
chr15	RCN2	76938725	76938815	51	91	1734	8781	1683	8690	0.5604395604395604	0.19367088607594937
chr15	PSTPIP1	77032861	77032952	0	92	208	4597	208	4505	0.0	0.04617092119866815
chr15	PSTPIP1	77007846	77008065	0	220	208	4597	208	4377	0.0	0.04752113319625314
chr15	PSTPIP1	76999460	76999614	0	155	208	4597	208	4442	0.0	0.04682575416479064
chr15	PSTPIP1	77026115	77026172	0	58	208	4597	208	4539	0.0	0.04582507160167438
chr15	HMG20A	77447718	77447811	0	94	2599	5473	2599	5379	0.0	0.4831753113961703
chr15	LINGO1-AS1	77647838	77647961	0	124	0	2553	0	2429	0.0	0.0
chr15	IDH3A	78164991	78165076	0	86	306	5879	306	5793	0.0	0.05282237182806836
chr15	IDH3A	78157547	78157631	0	85	306	5879	306	5794	0.0	0.052813255091473936
chr15	IDH3A	78156907	78157162	0	256	306	5879	306	5623	0.0	0.0544193491019029
chr15	IDH3A	78160091	78160206	0	116	306	5879	306	5763	0.0	0.05309734513274336
chr15	IDH3A	78151288	78151544	0	257	306	5879	306	5622	0.0	0.054429028815368194
chr15	IDH3A	78157572	78157631	0	60	306	5879	306	5819	0.0	0.05258635504382196
chr15	IDH3A	78154434	78154819	0	386	306	5879	306	5493	0.0	0.05570726379027854
chr15	IDH3A	78150803	78150960	0	158	306	5879	306	5721	0.0	0.053487152595700055
chr15	DNAJA4	78270496	78270677	0	182	438	5692	438	5510	0.0	0.079491833030853
chr15	IREB2	78462921	78463087	47	167	1985	8021	1938	7854	0.281437125748503	0.24675324675324675
chr15	IREB2	78470531	78470601	0	71	1985	8021	1985	7950	0.0	0.24968553459119497
chr15	HYKK	78518587	78518773	0	187	102	5714	102	5527	0.0	0.018454857969965623
chr15	PSMA4	78542575	78542645	0	71	0	5745	0	5674	0.0	0.0
chr15	PSMA4	78544189	78544267	0	79	0	5745	0	5666	0.0	0.0
chr15	PSMA4	78546574	78546698	0	125	0	5745	0	5620	0.0	0.0
chr15	PSMA4	78542176	78542219	0	44	0	5745	0	5701	0.0	0.0
chr15	PSMA4	78542482	78542645	0	164	0	5745	0	5581	0.0	0.0
chr15	MORF4L1	78887268	78887349	1048	82	17564	6570	16516	6488	12.78048780487805	2.5456226880394577
chr15	MORF4L1	78878212	78878259	0	48	17564	6570	17564	6522	0.0	2.6930389451088623
chr15	MORF4L1	78884966	78885083	640	118	17564	6570	16924	6452	5.423728813559322	2.6230626162430255
chr15	MORF4L1	78880511	78880579	0	69	17564	6570	17564	6501	0.0	2.701738194123981
chr15	MORF4L1	78884969	78885083	619	115	17564	6570	16945	6455	5.3826086956521735	2.6250968241673123
chr15	TMED3	79314540	79314655	0	116	0	19420	0	19304	0.0	0.0
chr15	MINAR1	79463694	79463760	0	67	0	6999	0	6932	0.0	0.0
chr15	ZFAND6	80075163	80075242	0	80	120388	3588	120388	3508	0.0	34.31812998859749
chr15	ZFAND6	80131179	80131293	0	115	120388	3588	120388	3473	0.0	34.66397926864382
chr15	ZFAND6	80115026	80115070	0	45	120388	3588	120388	3543	0.0	33.97911374541349
chr15	ZFAND6	80112775	80112854	0	80	120388	3588	120388	3508	0.0	34.31812998859749
chr15	ZFAND6	80098415	80098578	0	164	120388	3588	120388	3424	0.0	35.16004672897196
chr15	ZFAND6	80111427	80111559	0	133	120388	3588	120388	3455	0.0	34.84457308248915
chr15	ZFAND6	80073265	80073330	0	66	120388	3588	120388	3522	0.0	34.181714934696195
chr15	ZFAND6	80075163	80075315	0	153	120388	3588	120388	3435	0.0	35.04745269286754
chr15	ARNT2	80442836	80443025	0	190	1122	7678	1122	7488	0.0	0.14983974358974358
chr15	CEMIP	80941848	80942053	0	206	18923	7651	18923	7445	0.0	2.5417058428475485
chr15	CEMIP	80873537	80873696	3298	160	18923	7651	15625	7491	20.6125	2.0858363369376587
chr15	CEMIP	80873537	80873636	1551	100	18923	7651	17372	7551	15.51	2.3006224341146866
chr15	IL16	81289903	81290045	0	143	47528	11081	47528	10938	0.0	4.3452185042969464
chr15	IL16	81188352	81188403	4335	52	47528	11081	43193	11029	83.36538461538461	3.916311542297579
chr15	IL16	81295331	81295520	17271	190	47528	11081	30257	10891	90.9	2.7781654577173813
chr15	AC103858.3	81319267	81319542	0	276	4317	4001	4317	3725	0.0	1.1589261744966444
chr15	TMC3-AS1	81332344	81332541	204	198	5407	12395	5203	12197	1.0303030303030303	0.42658030663277857
chr15	TMC3-AS1	81341561	81341708	663	148	5407	12395	4744	12247	4.47972972972973	0.3873601698375112
chr15	TMC3-AS1	81380208	81380260	0	53	5407	12395	5407	12342	0.0	0.4380975530708151
chr15	TMC3-AS1	81341149	81341219	0	71	5407	12395	5407	12324	0.0	0.43873742291463813
chr15	TMC3-AS1	81380208	81380254	0	47	5407	12395	5407	12348	0.0	0.437884677680596
chr15	TMC3-AS1	81388864	81388991	0	128	5407	12395	5407	12267	0.0	0.44077606586777535
chr15	SAXO2	82263358	82263438	0	81	0	4166	0	4085	0.0	0.0
chr15	SAXO2	82263138	82263188	0	51	0	4166	0	4115	0.0	0.0
chr15	SAXO2	82265568	82265748	0	181	0	4166	0	3985	0.0	0.0
chr15	UBE2Q2P2	82407130	82407305	0	176	50	1868	50	1692	0.0	0.02955082742316785
chr15	UBE2Q2P6	82446655	82446834	0	180	0	460	0	280	0.0	0.0
chr15	CSPG4P10	82469273	82469472	0	200	281	7192	281	6992	0.0	0.040188787185354694
chr15	CSPG4P10	82465234	82465428	0	195	281	7192	281	6997	0.0	0.04016006860082893
chr15	SNHG21	82756729	82756785	49	57	1026	1055	977	998	0.8596491228070176	0.9789579158316634
chr15	TM6SF1	83121920	83122003	0	84	6419	2508	6419	2424	0.0	2.6481023102310233
chr15	TM6SF1	83126754	83126847	0	94	6419	2508	6419	2414	0.0	2.6590720795360396
chr15	ADAMTSL3	83885100	83885212	0	113	35040	9724	35040	9611	0.0	3.6458224950577462
chr15	EFL1P1	84102874	84103012	0	139	36	1770	36	1631	0.0	0.022072348252605765
chr15	LINC00933	84573021	84573251	0	231	153	3006	153	2775	0.0	0.055135135135135134
chr15	ZSCAN2	84603819	84604200	0	382	0	4531	0	4149	0.0	0.0
chr15	ZSCAN2	84602186	84602250	0	65	0	4531	0	4466	0.0	0.0
chr15	ZSCAN2	84603819	84604333	0	515	0	4531	0	4016	0.0	0.0
chr15	ZSCAN2	84601998	84602250	0	253	0	4531	0	4278	0.0	0.0
chr15	ZSCAN2	84601973	84602250	0	278	0	4531	0	4253	0.0	0.0
chr15	ZSCAN2	84603819	84604330	0	512	0	4531	0	4019	0.0	0.0
chr15	ZSCAN2	84622577	84622714	0	138	0	4531	0	4393	0.0	0.0
chr15	SCAND2P	84635851	84635912	0	62	102	9041	102	8979	0.0	0.011359839625793518
chr15	SLC28A1	84886671	84886787	0	117	1060	3467	1060	3350	0.0	0.3164179104477612
chr15	PDE8A	85089337	85089416	171	80	6403	8029	6232	7949	2.1375	0.7839979871681972
chr15	PDE8A	85091043	85091181	84	139	6403	8029	6319	7890	0.60431654676259	0.8008871989860583
chr15	PDE8A	85090717	85090915	40	199	6403	8029	6363	7830	0.20100502512562815	0.8126436781609195
chr15	PDE8A	85097947	85098036	0	90	6403	8029	6403	7939	0.0	0.8065247512281144
chr15	AKAP13	85658536	85658590	70	55	92711	16938	92641	16883	1.2727272727272727	5.487235680862406
chr15	AKAP13	85662387	85662453	110	67	92711	16938	92601	16871	1.6417910447761195	5.4887677079011326
chr15	AKAP13	85480872	85481026	0	155	92711	16938	92711	16783	0.0	5.524101769647858
chr15	MRPS11	88476988	88477054	0	67	4353	5633	4353	5566	0.0	0.7820697089471793
chr15	MRPS11	88472626	88472725	991	100	4353	5633	3362	5533	9.91	0.6076269654798482
chr15	ACAN	88860325	88860439	0	115	0	10933	0	10818	0.0	0.0
chr15	ACAN	88868215	88868329	0	115	0	10933	0	10818	0.0	0.0
chr15	ACAN	88873841	88874024	0	184	0	10933	0	10749	0.0	0.0
chr15	ACAN	88873841	88874059	0	219	0	10933	0	10714	0.0	0.0
chr15	ABHD2	89102499	89102576	0	78	3911	10080	3911	10002	0.0	0.3910217956408718
chr15	ABHD2	89104181	89104270	0	90	3911	10080	3911	9990	0.0	0.3914914914914915
chr15	ABHD2	89103902	89104044	0	143	3911	10080	3911	9937	0.0	0.393579551172386
chr15	FANCI	89294914	89295094	0	181	51	11868	51	11687	0.0	0.004363823051253529
chr15	FANCI	89306006	89306194	0	189	51	11868	51	11679	0.0	0.004366812227074236
chr15	FANCI	89311646	89311778	0	133	51	11868	51	11735	0.0	0.004345973583297827
chr15	FANCI	89245606	89245708	0	103	51	11868	51	11765	0.0	0.004334891627709307
chr15	FANCI	89294956	89295094	0	139	51	11868	51	11729	0.0	0.004348196777218859
chr15	FANCI	89245755	89245839	0	85	51	11868	51	11783	0.0	0.004328269540863957
chr15	FANCI	89306009	89306194	0	186	51	11868	51	11682	0.0	0.004365690806368772
chr15	MIR9-3HG	89379047	89379269	0	223	0	8103	0	7880	0.0	0.0
chr15	MIR9-3HG	89388503	89388581	0	79	0	8103	0	8024	0.0	0.0
chr15	MIR9-3HG	89388500	89388581	0	82	0	8103	0	8021	0.0	0.0
chr15	MIR9-3HG	89368046	89368235	0	190	0	8103	0	7913	0.0	0.0
chr15	MIR9-3HG	89387430	89387538	0	109	0	8103	0	7994	0.0	0.0
chr15	MIR9-3HG	89387430	89387497	0	68	0	8103	0	8035	0.0	0.0
chr15	MIR9-3HG	89386788	89386902	0	115	0	8103	0	7988	0.0	0.0
chr15	MIR9-3HG	89388041	89388091	0	51	0	8103	0	8052	0.0	0.0
chr15	MIR9-3HG	89379752	89379917	0	166	0	8103	0	7937	0.0	0.0
chr15	MIR9-3HG	89388483	89388581	0	99	0	8103	0	8004	0.0	0.0
chr15	MIR9-3HG	89388503	89388746	0	244	0	8103	0	7859	0.0	0.0
chr15	MESP2	89764799	89764920	0	122	204	1813	204	1691	0.0	0.12063867534003549
chr15	SEMA4B	90201457	90201735	0	279	23624	5402	23624	5123	0.0	4.611360530938903
chr15	SEMA4B	90220981	90221093	6	113	23624	5402	23618	5289	0.05309734513274336	4.465494422386084
chr15	SEMA4B	90214936	90214964	0	29	23624	5402	23624	5373	0.0	4.396798808859111
chr15	GDPGP1	90236062	90236181	0	120	213	5771	213	5651	0.0	0.03769244381525394
chr15	TTLL13P	90262491	90262669	0	179	14	3011	14	2832	0.0	0.0049435028248587575
chr15	ZNF774	90354641	90354764	4342	124	27648	6373	23306	6249	35.016129032258064	3.7295567290766525
chr15	ZNF774	90355350	90355416	1991	67	27648	6373	25657	6306	29.71641791044776	4.068664763717095
chr15	IQGAP1	90390773	90390873	565	101	41670	10694	41105	10593	5.594059405940594	3.880392712168413
chr15	IQGAP1	90482701	90482749	0	49	41670	10694	41670	10645	0.0	3.9145138562705495
chr15	IQGAP1	90431220	90431252	72	33	41670	10694	41598	10661	2.1818181818181817	3.901885376606322
chr15	CRTC3	90614452	90614488	0	37	19428	10839	19428	10802	0.0	1.7985558229957415
chr15	CRTC3	90617882	90617968	672	87	19428	10839	18756	10752	7.724137931034483	1.7444196428571428
chr15	LINC01585	90661392	90661483	0	92	0	1507	0	1415	0.0	0.0
chr15	BLM	90760146	90760279	2186	134	759732	6681	757546	6547	16.313432835820894	115.70887429356958
chr15	BLM	90765295	90765414	0	120	759732	6681	759732	6561	0.0	115.79515317786922
chr15	BLM	90811677	90811800	510	124	759732	6681	759222	6557	4.112903225806452	115.78801281073662
chr15	BLM	90759980	90760279	4167	300	759732	6681	755565	6381	13.89	118.4085566525623
chr15	FES	90893935	90894058	0	124	3613	4121	3613	3997	0.0	0.9039279459594696
chr15	FES	90885411	90885585	0	175	3613	4121	3613	3946	0.0	0.9156107450582869
chr15	FES	90890981	90891191	0	211	3613	4121	3613	3910	0.0	0.9240409207161125
chr15	MAN2A2	90903230	90903734	663	505	5969	9354	5306	8849	1.312871287128713	0.599615775793875
chr15	MAN2A2	90903230	90903432	306	203	5969	9354	5663	9151	1.5073891625615763	0.6188394710960551
chr15	MAN2A2	90910089	90910292	0	204	5969	9354	5969	9150	0.0	0.6523497267759563
chr15	MAN2A2	90912541	90912664	0	124	5969	9354	5969	9230	0.0	0.6466955579631636
chr15	MAN2A2	90913272	90913374	0	103	5969	9354	5969	9251	0.0	0.6452275429683277
chr15	MAN2A2	90912516	90912664	0	149	5969	9354	5969	9205	0.0	0.648451928299837
chr15	MAN2A2	90913272	90913406	0	135	5969	9354	5969	9219	0.0	0.6474671873305131
chr15	MAN2A2	90910215	90910292	0	78	5969	9354	5969	9276	0.0	0.6434885726606295
chr15	MAN2A2	90916585	90916660	0	76	5969	9354	5969	9278	0.0	0.6433498598835956
chr15	UNC45A	90930952	90931052	0	101	22716	7365	22716	7264	0.0	3.127202643171806
chr15	UNC45A	90942436	90942605	0	170	22716	7365	22716	7195	0.0	3.157192494788047
chr15	RCCD1	90957112	90957503	204	392	1099	3739	895	3347	0.5204081632653061	0.26740364505527336
chr15	RCCD1	90955799	90955883	74	85	1099	3739	1025	3654	0.8705882352941177	0.2805145046524357
chr15	SV2B	91225872	91226714	0	843	44429	12490	44429	11647	0.0	3.8146303769210954
chr15	SV2B	91128722	91128810	0	89	44429	12490	44429	12401	0.0	3.5826949439561324
chr15	CRAT37	91584590	91584720	0	131	102716	3408	102716	3277	0.0	31.34452242905096
chr15	SLCO3A1	92162755	92162998	0	244	0	7352	0	7108	0.0	0.0
chr15	ST8SIA2	92430048	92430111	0	64	102	5856	102	5792	0.0	0.01761049723756906
chr15	ST8SIA2	92434246	92434375	0	130	102	5856	102	5726	0.0	0.01781348236115962
chr15	AC091544.2	92599171	92599445	0	275	0	3868	0	3593	0.0	0.0
chr15	CHASERR	92883584	92883778	0	195	50	5803	50	5608	0.0	0.00891583452211127
chr15	CHD2	92937517	92937625	0	109	53276	16852	53276	16743	0.0	3.181986501821657
chr15	CHD2	92901166	92901299	0	134	53276	16852	53276	16718	0.0	3.186744825936117
chr15	CHD2	92945820	92945865	90	46	53276	16852	53186	16806	1.9565217391304348	3.164703082232536
chr15	CHD2	92972264	92972417	0	154	53276	16852	53276	16698	0.0	3.1905617439214278
chr15	CHD2	92991692	92991759	3173	68	53276	16852	50103	16784	46.661764705882355	2.985164442326025
chr15	CHD2	92998148	92998261	51	114	53276	16852	53225	16738	0.4473684210526316	3.1798900704982676
chr15	CHD2	92998137	92998261	51	125	53276	16852	53225	16727	0.408	3.1819812279548034
chr15	AC091078.1	93531421	93531577	80	157	10960	7503	10880	7346	0.5095541401273885	1.4810781377620474
chr15	AC091078.1	93322222	93322346	0	125	10960	7503	10960	7378	0.0	1.4854974247763622
chr15	AC091078.1	93373509	93373585	0	77	10960	7503	10960	7426	0.0	1.475895502289254
chr15	AC091078.1	93532772	93532973	1133	202	10960	7503	9827	7301	5.608910891089109	1.3459800027393507
chr15	AC091078.1	93331266	93331432	109	167	10960	7503	10851	7336	0.6526946107784432	1.479143947655398
chr15	AC091078.1	93483090	93483228	0	139	10960	7503	10960	7364	0.0	1.4883215643671917
chr15	AC091078.1	93496233	93496331	0	99	10960	7503	10960	7404	0.0	1.4802809292274446
chr15	AC091078.1	93323598	93323651	507	54	10960	7503	10453	7449	9.38888888888889	1.403275607464089
chr15	LINC02207	93865373	93865648	0	276	153	7807	153	7531	0.0	0.020316027088036117
chr15	LINC02207	93869690	93869833	0	144	153	7807	153	7663	0.0	0.019966070729479316
chr15	LINC02207	93844225	93844861	0	637	153	7807	153	7170	0.0	0.021338912133891212
chr15	LINC02207	93864929	93865045	0	117	153	7807	153	7690	0.0	0.01989596879063719
chr15	LINC02207	93844225	93844338	0	114	153	7807	153	7693	0.0	0.0198882100610945
chr15	LINC02207	93877227	93877294	0	68	153	7807	153	7739	0.0	0.01976999612353017
chr15	LINC02207	93865342	93865648	0	307	153	7807	153	7500	0.0	0.0204
chr15	LINC02207	93874933	93875110	0	178	153	7807	153	7629	0.0	0.02005505308690523
chr15	LINC02207	93839485	93839660	0	176	153	7807	153	7631	0.0	0.02004979688114271
chr15	LINC02207	93844225	93845206	0	982	153	7807	153	6825	0.0	0.02241758241758242
chr15	LINC02207	93858955	93859332	0	378	153	7807	153	7429	0.0	0.020594965675057208
chr15	LINC01580	93946697	93946755	0	59	0	2674	0	2615	0.0	0.0
chr15	LINC01580	93946642	93946755	0	114	0	2674	0	2560	0.0	0.0
chr15	LINC01580	93899486	93899603	0	118	0	2674	0	2556	0.0	0.0
chr15	LINC01580	93971414	93971436	0	23	0	2674	0	2651	0.0	0.0
chr15	MCTP2	94314726	94314864	0	139	0	13201	0	13062	0.0	0.0
chr15	AC087633.2	94901911	94902120	0	210	64	3304	64	3094	0.0	0.02068519715578539
chr15	AC087633.2	95018795	95018869	0	75	64	3304	64	3229	0.0	0.019820377825952307
chr15	LINC00924	95498392	95498479	0	88	0	4125	0	4037	0.0	0.0
chr15	LINC00924	95497680	95498000	0	321	0	4125	0	3804	0.0	0.0
chr15	AC015574.1	95712576	95712657	0	82	0	7835	0	7753	0.0	0.0
chr15	AC015574.1	95810078	95810116	0	39	0	7835	0	7796	0.0	0.0
chr15	AC015574.1	95810075	95810116	0	42	0	7835	0	7793	0.0	0.0
chr15	AC015574.1	95652847	95652956	0	110	0	7835	0	7725	0.0	0.0
chr15	AC012409.1	96173403	96173501	0	99	0	760	0	661	0.0	0.0
chr15	AC087477.2	96361141	96361289	0	149	51	4301	51	4152	0.0	0.012283236994219654
chr15	AC087477.2	96372408	96372608	0	201	51	4301	51	4100	0.0	0.012439024390243903
chr15	LINC02253	97372327	97372391	0	65	324	1928	324	1863	0.0	0.17391304347826086
chr15	LINC02253	97429769	97429889	0	121	324	1928	324	1807	0.0	0.1793027116768124
chr15	LINC02253	97429048	97429204	0	157	324	1928	324	1771	0.0	0.18294748729531338
chr15	LINC02251	98007043	98007169	0	127	0	2090	0	1963	0.0	0.0
chr15	LINC02251	98003379	98003460	0	82	0	2090	0	2008	0.0	0.0
chr15	IGF1R	98934823	98935053	0	231	51	13877	51	13646	0.0	0.0037373589330206656
chr15	LUNAR1	99027564	99027789	0	226	0	1690	0	1464	0.0	0.0
chr15	LUNAR1	99026483	99026578	0	96	0	1690	0	1594	0.0	0.0
chr15	SYNM	99129366	99131813	0	2448	0	6844	0	4396	0.0	0.0
chr15	LRRC28	99276575	99276616	0	42	5	6078	5	6036	0.0	0.0008283631544068919
chr15	LRRC28	99363105	99363265	0	161	5	6078	5	5917	0.0	0.0008450228156160216
chr15	LRRC28	99285767	99285784	0	18	5	6078	5	6060	0.0	0.0008250825082508251
chr15	MEF2A	99598429	99598511	0	83	37908	5257	37908	5174	0.0	7.326633165829146
chr15	MEF2A	99703361	99703385	0	25	37908	5257	37908	5232	0.0	7.245412844036697
chr15	MEF2A	99645560	99645764	1122	205	37908	5257	36786	5052	5.4731707317073175	7.281472684085511
chr15	MEF2A	99620890	99621080	0	191	37908	5257	37908	5066	0.0	7.482826687722069
chr15	AC090825.1	99812972	99813086	0	115	9042	7652	9042	7537	0.0	1.1996815709168105
chr15	AC090825.1	99839082	99839134	0	53	9042	7652	9042	7599	0.0	1.1898934070272404
chr15	AC090825.1	99880676	99880827	0	152	9042	7652	9042	7500	0.0	1.2056
chr15	ASB7	100629436	100630042	51	607	740	5344	689	4737	0.08401976935749589	0.14545070719864894
chr15	AC015712.1	100850210	100850332	0	123	0	1487	0	1364	0.0	0.0
chr15	AC015712.1	100855230	100855348	0	119	0	1487	0	1368	0.0	0.0
chr15	AC015712.1	100854643	100854787	0	145	0	1487	0	1342	0.0	0.0
chr15	ALDH1A3	100892509	100892639	0	131	183	5350	183	5219	0.0	0.035064188541866256
chr15	LRRK1	100920030	100920255	0	226	357	17485	357	17259	0.0	0.02068486007300539
chr15	LRRK1	101048493	101048657	0	165	357	17485	357	17320	0.0	0.02061200923787529
chr15	LRRK1	101067239	101067387	0	149	357	17485	357	17336	0.0	0.02059298569450854
chr15	WASH3P	101971822	101972049	0	228	0	2365	0	2137	0.0	0.0
chr15	HERC2P3	20461191	20461342	0	152	3097	9444	3097	9292	0.0	0.3332974601808007
chr15	HERC2P3	20466194	20466370	0	177	3097	9444	3097	9267	0.0	0.3341966116326751
chr15	HERC2P3	20483402	20483517	0	116	3097	9444	3097	9328	0.0	0.33201114922813035
chr15	HERC2P3	20501545	20501714	0	170	3097	9444	3097	9274	0.0	0.3339443605779599
chr15	HERC2P3	20476924	20477056	0	133	3097	9444	3097	9311	0.0	0.33261733433573193
chr15	NBEAP1	20669972	20670095	0	124	18110	3699	18110	3575	0.0	5.065734265734266
chr15	POTEB2	20848492	20848563	0	72	51	1698	51	1626	0.0	0.03136531365313653
chr15	POTEB2	20856635	20856773	0	139	51	1698	51	1559	0.0	0.0327132777421424
chr15	POTEB3	21422119	21422190	0	72	0	6321	0	6249	0.0	0.0
chr15	POTEB	21859451	21859522	0	72	0	2308	0	2236	0.0	0.0
chr15	POTEB	21867596	21867734	0	139	0	2308	0	2169	0.0	0.0
chr15	AC011767.1	22773695	22773867	0	173	0	1539	0	1366	0.0	0.0
chr15	AC011767.1	22773695	22773725	0	31	0	1539	0	1508	0.0	0.0
chr15	CYFIP1	22947910	22948029	0	120	202017	10198	202017	10078	0.0	20.04534629886882
chr15	CYFIP1	22946708	22946840	0	133	202017	10198	202017	10065	0.0	20.07123695976155
chr15	TUBGCP5	23008457	23008565	648	109	487529	5528	486881	5419	5.944954128440367	89.84701974534048
chr15	GOLGA6L2	23444470	23444500	0	31	238	3047	238	3016	0.0	0.07891246684350132
chr15	UBE3A	25354527	25354683	0	157	0	16169	0	16012	0.0	0.0
chr15	UBE3A	25355891	25356056	0	166	0	16169	0	16003	0.0	0.0
chr15	UBE3A	25393745	25393858	0	114	0	16169	0	16055	0.0	0.0
chr15	UBE3A	25409087	25409207	0	121	0	16169	0	16048	0.0	0.0
chr15	UBE3A	25411907	25411971	0	65	0	16169	0	16104	0.0	0.0
chr15	UBE3A	25421925	25421961	0	37	0	16169	0	16132	0.0	0.0
chr15	UBE3A	25407066	25407212	0	147	0	16169	0	16022	0.0	0.0
chr15	UBE3A	25405460	25405502	0	43	0	16169	0	16126	0.0	0.0
chr15	UBE3A	25407066	25407228	0	163	0	16169	0	16006	0.0	0.0
chr15	UBE3A	25407066	25407262	0	197	0	16169	0	15972	0.0	0.0
chr15	UBE3A	25408619	25408684	0	66	0	16169	0	16103	0.0	0.0
chr15	UBE3A	25407066	25407137	0	72	0	16169	0	16097	0.0	0.0
chr15	UBE3A	25408571	25408684	0	114	0	16169	0	16055	0.0	0.0
chr15	UBE3A	25415709	25415842	0	134	0	16169	0	16035	0.0	0.0
chr15	LINC02250	25516447	25516645	0	199	51	6453	51	6254	0.0	0.008154780940198274
chr15	GABRB3	26642432	26642528	0	97	0	10481	0	10384	0.0	0.0
chr15	GABRB3	26621313	26621534	0	222	0	10481	0	10259	0.0	0.0
chr15	GABRB3	26553382	26553520	0	139	0	10481	0	10342	0.0	0.0
chr15	GABRG3-AS1	27158947	27159047	0	101	204	2872	204	2771	0.0	0.0736196319018405
chr15	GABRG3-AS1	27159808	27159861	0	54	204	2872	204	2818	0.0	0.0723917672107878
chr15	OCA2	27990575	27990647	0	73	0	3280	0	3207	0.0	0.0
chr15	HERC2	28163093	28163285	0	193	124	20131	124	19938	0.0	0.006219279767278564
chr15	HERC2	28298516	28298629	0	114	124	20131	124	20017	0.0	0.0061947344756956586
chr15	GOLGA8G	28523942	28524034	144	93	10739	6365	10595	6272	1.5483870967741935	1.6892538265306123
chr15	TJP1	29719776	29720016	0	241	51	11348	51	11107	0.0	0.004591698928603584
chr15	CHRFAM7A	30383318	30383382	0	65	123	4049	123	3984	0.0	0.030873493975903613
chr15	CHRFAM7A	30381702	30381876	51	175	123	4049	72	3874	0.2914285714285714	0.01858544140423335
chr15	MTMR10	30967919	30968010	0	92	23178	6396	23178	6304	0.0	3.6767131979695433
chr15	MTMR10	30976818	30976955	0	138	23178	6396	23178	6258	0.0	3.703739213806328
chr15	MTMR10	30965874	30966040	0	167	23178	6396	23178	6229	0.0	3.7209825012040456
chr15	TRPM1	31030982	31031157	408	176	57575	7483	57167	7307	2.3181818181818183	7.823593814150814
chr15	TRPM1	31081352	31081438	0	87	57575	7483	57575	7396	0.0	7.7846133044889125
chr15	OTUD7A	31689358	31689481	0	124	285	14368	285	14244	0.0	0.020008424599831508
chr15	OTUD7A	31649678	31649829	0	152	285	14368	285	14216	0.0	0.020047833427124368
chr15	ULK4P1	32423018	32423202	0	185	0	1694	0	1509	0.0	0.0
chr15	AC135983.2	32524470	32524600	0	131	0	2691	0	2560	0.0	0.0
chr15	AC123768.2	32597638	32597745	0	108	83	1817	83	1709	0.0	0.04856641310708017
chr15	FMN1	33193908	33194060	0	153	62287	20297	62287	20144	0.0	3.0920869737887213
chr15	TMCO5B	33245320	33245438	0	119	0	2056	0	1937	0.0	0.0
chr15	AC055874.1	33306331	33306431	0	101	0	2408	0	2307	0.0	0.0
chr15	EMC7	34095894	34096014	0	121	108	1458	108	1337	0.0	0.08077786088257292
chr15	KATNBL1	34152789	34153069	1233	281	10641	4853	9408	4572	4.387900355871886	2.057742782152231
chr15	KATNBL1	34163559	34163690	23	132	10641	4853	10618	4721	0.17424242424242425	2.2490997669985173
chr15	KATNBL1	34165929	34166115	0	187	10641	4853	10641	4666	0.0	2.280540077153879
chr15	KATNBL1	34177820	34177999	0	180	10641	4853	10641	4673	0.0	2.277123903274128
chr15	KATNBL1	34198259	34198331	0	73	10641	4853	10641	4780	0.0	2.2261506276150627
chr15	SLC12A6	34257641	34257788	0	148	1581	9653	1581	9505	0.0	0.1663335086796423
chr15	SLC12A6	34275344	34275389	0	46	1581	9653	1581	9607	0.0	0.1645675028624961
chr15	LPCAT4	34361399	34361532	0	134	51	3593	51	3459	0.0	0.014744145706851692
chr15	GOLGA8B	34552894	34553091	0	198	51197	7660	51197	7462	0.0	6.861029214687751
chr15	GOLGA8B	34574824	34574914	0	91	51197	7660	51197	7569	0.0	6.764037521469151
chr15	ZNF770	34987556	34987673	0	118	51	5442	51	5324	0.0	0.009579263711495116
chr15	DPH6	35450684	35450803	0	120	2355	8133	2355	8013	0.0	0.29389741669786595
chr15	DPH6	35542412	35542507	0	96	2355	8133	2355	8037	0.0	0.2930197835013065
chr15	MEIS2	36950323	36950400	0	78	25236	10791	25236	10713	0.0	2.3556426771212546
chr15	MEIS2	37096288	37096430	21	143	25236	10791	25215	10648	0.14685314685314685	2.36805033809166
chr15	MEIS2	37099454	37099599	0	146	25236	10791	25236	10645	0.0	2.3706904650070455
chr15	MEIS2	36894716	36894812	0	97	25236	10791	25236	10694	0.0	2.35982794090144
chr15	MEIS2	37096288	37096407	0	120	25236	10791	25236	10671	0.0	2.364914253584481
chr15	AC068875.1	37426663	37426762	0	100	1479	3267	1479	3167	0.0	0.46700347331859804
chr15	AC068875.1	37419439	37419574	51	136	1479	3267	1428	3131	0.375	0.4560843181092303
chr15	RASGRP1	38494381	38494767	0	387	1173	6027	1173	5640	0.0	0.20797872340425533
chr15	RASGRP1	38501142	38501287	0	146	1173	6027	1173	5881	0.0	0.19945587485121577
chr15	RASGRP1	38503271	38503376	0	106	1173	6027	1173	5921	0.0	0.19810842763046782
chr15	RASGRP1	38498793	38498946	0	154	1173	6027	1173	5873	0.0	0.1997275668312617
chr15	RASGRP1	38501374	38501435	0	62	1173	6027	1173	5965	0.0	0.19664710813076278
chr15	AC013652.1	39018501	39018581	0	81	0	7014	0	6933	0.0	0.0
chr15	GPR176	39807005	39807258	0	254	0	4526	0	4272	0.0	0.0
chr15	SRP14	40038875	40038948	0	74	0	1924	0	1850	0.0	0.0
chr15	BMF	40104179	40104340	0	162	84283	5238	84283	5076	0.0	16.604215918045707
chr15	BMF	40104242	40104340	0	99	84283	5238	84283	5139	0.0	16.4006616073166
chr15	BMF	40106357	40106438	0	82	84283	5238	84283	5156	0.0	16.346586501163692
chr15	PLCB2	40290024	40290082	0	59	19600	6493	19600	6434	0.0	3.0463164438918247
chr15	PLCB2	40291017	40291183	605	167	19600	6493	18995	6326	3.622754491017964	3.002687322162504
chr15	PLCB2	40291605	40291650	0	46	19600	6493	19600	6447	0.0	3.040173724212812
chr15	CCDC9B	40336573	40336664	0	92	12764	7410	12764	7318	0.0	1.7441924022957092
chr15	CCDC32	40562771	40563027	0	257	6755	8099	6755	7842	0.0	0.8613874011731701
chr15	CCDC32	40553594	40554127	12	534	6755	8099	6743	7565	0.02247191011235955	0.8913417052214144
chr15	CCDC32	40553436	40554127	12	692	6755	8099	6743	7407	0.017341040462427744	0.9103550695288241
chr15	CCDC32	40562771	40563022	0	252	6755	8099	6755	7847	0.0	0.8608385370205174
chr15	RAD51-AS1	40687798	40687844	1121	47	103667	2763	102546	2716	23.851063829787233	37.75625920471281
chr15	DNAJC17	40776541	40776627	0	87	38598	5641	38598	5554	0.0	6.949585884047534
chr15	DNAJC17	40780092	40780352	0	261	38598	5641	38598	5380	0.0	7.1743494423791825
chr15	PPP1R14D	40817231	40817347	102	117	879	872	777	755	0.8717948717948718	1.0291390728476821
chr15	SPINT1-AS1	40838542	40838686	35	145	3465	1244	3430	1099	0.2413793103448276	3.121019108280255
chr15	SPINT1-AS1	40838032	40838125	553	94	3465	1244	2912	1150	5.882978723404255	2.5321739130434784
chr15	INO80	41016087	41016215	78	129	61412	5943	61334	5814	0.6046511627906976	10.549363605091159
chr15	INO80	41020899	41021125	18990	227	61412	5943	42422	5716	83.65638766519824	7.421623512946116
chr15	INO80	41058638	41058781	0	144	61412	5943	61412	5799	0.0	10.5901017416796
chr15	INO80	41023225	41023346	19695	122	61412	5943	41717	5821	161.4344262295082	7.166638034701942
chr15	EXD1	41219829	41219898	0	70	110467	3674	110467	3604	0.0	30.651220865704772
chr15	EXD1	41226442	41226628	0	187	110467	3674	110467	3487	0.0	31.679667335818756
chr15	OIP5	41319657	41319780	0	124	1532	1206	1532	1082	0.0	1.4158964879852125
chr15	NDUFAF1	41394264	41394358	0	95	14506	3613	14506	3518	0.0	4.123365548607163
chr15	NDUFAF1	41394104	41394358	0	255	14506	3613	14506	3358	0.0	4.3198332340678975
chr15	LTK	41505914	41506005	0	92	202	3509	202	3417	0.0	0.059116183786947614
chr15	LTK	41511163	41511346	0	184	202	3509	202	3325	0.0	0.06075187969924812
chr15	LTK	41507561	41507657	0	97	202	3509	202	3412	0.0	0.05920281359906213
chr15	RPAP1	41520390	41521147	0	758	3842	6765	3842	6007	0.0	0.6395871483269518
chr15	AC016134.1	41612534	41612734	777	201	3635	1392	2858	1191	3.8656716417910446	2.399664147774979
chr15	PLA2G4F	42143977	42144144	0	168	25505	6123	25505	5955	0.0	4.282955499580185
chr15	PLA2G4F	42155516	42155589	0	74	25505	6123	25505	6049	0.0	4.216399404860307
chr15	VPS39	42173722	42173852	0	131	124173	7544	124173	7413	0.0	16.75070821529745
chr15	VPS39	42161473	42161590	0	118	124173	7544	124173	7426	0.0	16.721384325343386
chr15	VPS39	42192065	42192098	7498	34	124173	7544	116675	7510	220.52941176470588	15.535952063914781
chr15	TMEM87A	42272062	42272123	0	62	145172	5620	145172	5558	0.0	26.119467434328897
chr15	TMEM87A	42262122	42262243	0	122	145172	5620	145172	5498	0.0	26.404510731174973
chr15	ZNF106	42449770	42451954	140153	2185	156023	9722	15870	7537	64.14324942791762	2.1056123125912167
chr15	CDAN1	42726096	42726160	255	65	28315	4961	28060	4896	3.923076923076923	5.731209150326797
chr15	CDAN1	42734225	42734346	2779	122	28315	4961	25536	4839	22.778688524590162	5.277123372597644
chr15	TTBK2	42827927	42828032	0	106	75337	12943	75337	12837	0.0	5.868738801900756
chr15	TTBK2	42840359	42840433	9722	75	75337	12943	65615	12868	129.62666666666667	5.099082996580665
chr15	TTBK2	42872610	42872758	0	149	75337	12943	75337	12794	0.0	5.888463342191653
chr15	TTBK2	42840359	42840432	9629	74	75337	12943	65708	12869	130.1216216216216	5.105913435387365
chr15	UBR1	43027775	43027828	4981	54	47020	9976	42039	9922	92.24074074074075	4.236948195928241
chr15	UBR1	43054741	43054899	0	159	47020	9976	47020	9817	0.0	4.789650606091474
chr15	UBR1	43058340	43058429	0	90	47020	9976	47020	9886	0.0	4.756220918470564
chr15	UBR1	43085983	43086240	0	258	47020	9976	47020	9718	0.0	4.838444124305413
chr15	UBR1	43091960	43092080	0	121	47020	9976	47020	9855	0.0	4.771182141045155
chr15	EPB42	43210334	43210439	0	106	449	2855	449	2749	0.0	0.16333212077118953
chr15	EPB42	43215094	43215328	0	235	449	2855	449	2620	0.0	0.1713740458015267
chr15	TGM5	43260051	43260297	28	247	14673	3722	14645	3475	0.11336032388663968	4.214388489208633
chr15	TP53BP1	43421024	43421174	0	151	47370	13009	47370	12858	0.0	3.6840877274848345
chr15	TP53BP1	43432193	43432677	24384	485	47370	13009	22986	12524	50.27628865979381	1.835356116256787
chr15	TP53BP1	43447365	43447485	0	121	47370	13009	47370	12888	0.0	3.675512104283054
chr15	TP53BP1	43446765	43446914	2251	150	47370	13009	45119	12859	15.006666666666666	3.5087487362936463
chr15	TP53BP1	43412671	43412767	51	97	47370	13009	47319	12912	0.5257731958762887	3.6647304832713754
chr15	TP53BP1	43414047	43414116	0	70	47370	13009	47370	12939	0.0	3.66102480871783
chr15	TP53BP1	43446386	43446590	225	205	47370	13009	47145	12804	1.0975609756097562	3.6820524835988753
chr15	TP53BP1	43446765	43446910	1939	146	47370	13009	45431	12863	13.280821917808218	3.5319132395242168
chr15	PPIP5K1	43536134	43536254	0	121	489	7736	489	7615	0.0	0.06421536441234406
chr15	PPIP5K1	43564102	43564165	0	64	489	7736	489	7672	0.0	0.06373826903023984
chr15	PPIP5K1	43584798	43584892	0	95	489	7736	489	7641	0.0	0.06399685904986259
chr15	PPIP5K1	43564866	43564992	0	127	489	7736	489	7609	0.0	0.06426600078853989
chr15	PPIP5K1	43560412	43560595	359	184	489	7736	130	7552	1.951086956521739	0.017213983050847457
chr15	PPIP5K1	43569185	43569335	0	151	489	7736	489	7585	0.0	0.06446934739617667
chr15	STRC	43603241	43603411	0	171	51	6367	51	6196	0.0	0.008231116849580375
chr15	STRC	43605263	43605399	0	137	51	6367	51	6230	0.0	0.008186195826645265
chr15	STRC	43612376	43612509	0	134	51	6367	51	6233	0.0	0.008182255735600835
chr15	STRC	43610311	43610386	49	76	51	6367	2	6291	0.6447368421052632	0.00031791448100460976
chr15	STRC	43604976	43605147	0	172	51	6367	51	6195	0.0	0.008232445520581114
chr15	STRC	43612790	43612906	0	117	51	6367	51	6250	0.0	0.00816
chr15	CATSPER2	43632716	43632934	0	219	643	5336	643	5117	0.0	0.1256595661520422
chr15	CATSPER2	43635726	43635826	0	101	643	5336	643	5235	0.0	0.12282712511938873
chr15	CATSPER2	43632716	43632928	0	213	643	5336	643	5123	0.0	0.12551239508100723
chr15	CATSPER2	43631429	43631538	0	110	643	5336	643	5226	0.0	0.12303865288939916
chr15	CATSPER2	43648628	43648709	0	82	643	5336	643	5254	0.0	0.1223829463266083
chr15	CATSPER2	43635108	43635154	0	47	643	5336	643	5289	0.0	0.12157307619587823
chr15	STRCP1	43704456	43704625	0	170	82340	5725	82340	5555	0.0	14.822682268226822
chr15	STRCP1	43702751	43702921	304	171	82340	5725	82036	5554	1.7777777777777777	14.770615772416276
chr15	STRCP1	43711838	43711971	0	134	82340	5725	82340	5591	0.0	14.727240207476301
chr15	CATSPER2P1	43744150	43744219	0	70	1632	3212	1632	3142	0.0	0.5194143857415658
chr15	SERINC4	43797140	43797356	0	217	459	2886	459	2669	0.0	0.17197452229299362
chr15	SERINC4	43798424	43798504	0	81	459	2886	459	2805	0.0	0.16363636363636364
chr15	SERINC4	43797144	43797356	0	213	459	2886	459	2673	0.0	0.1717171717171717
chr15	FRMD5	43917724	43917829	0	106	25088	6396	25088	6290	0.0	3.9885532591414945
chr15	FRMD5	43891980	43892069	0	90	25088	6396	25088	6306	0.0	3.978433238185855
chr15	FRMD5	43902174	43902262	0	89	25088	6396	25088	6307	0.0	3.9778024417314097
chr15	FRMD5	43918977	43919280	0	304	25088	6396	25088	6092	0.0	4.1181877872619825
chr15	EIF3J-DT	44536042	44536358	0	317	0	3200	0	2883	0.0	0.0
chr15	SPG11	44569397	44569505	0	109	17003	11477	17003	11368	0.0	1.4956896551724137
chr15	SPG11	44572682	44572820	0	139	17003	11477	17003	11338	0.0	1.4996472040924325
chr15	SPG11	44570524	44570658	35	135	17003	11477	16968	11342	0.25925925925925924	1.4960324457767589
chr15	SPG11	44588566	44588638	0	73	17003	11477	17003	11404	0.0	1.4909680813749562
chr15	SPG11	44604104	44604197	612	94	17003	11477	16391	11383	6.51063829787234	1.4399543178423966
chr15	PATL2	44667105	44667203	0	99	3309	4065	3309	3966	0.0	0.8343419062027232
chr15	PATL2	44675485	44675691	153	207	3309	4065	3156	3858	0.7391304347826086	0.8180404354587869
chr15	DUOXA1	45121086	45121221	628	136	145775	3541	145147	3405	4.617647058823529	42.627606461086636
chr15	DUOXA1	45128836	45128904	0	69	145775	3541	145775	3472	0.0	41.98588709677419
chr15	DUOXA1	45129231	45129323	0	93	145775	3541	145775	3448	0.0	42.27813225058004
chr15	SHF	45173575	45173716	0	142	0	4906	0	4764	0.0	0.0
chr15	SHF	45198771	45199120	0	350	0	4906	0	4556	0.0	0.0
chr15	SHF	45171882	45172078	0	197	0	4906	0	4709	0.0	0.0
chr15	AC051619.4	45264626	45264809	21	184	21	4297	0	4113	0.11413043478260869	0.0
chr15	GATM	45376600	45376819	0	220	120212	6854	120212	6634	0.0	18.120590895387398
chr15	GATM	45363604	45363781	4386	178	120212	6854	115826	6676	24.640449438202246	17.34961054523667
chr15	GATM	45373235	45373331	0	97	120212	6854	120212	6757	0.0	17.79073553352079
chr15	AC023905.1	47380456	47380595	0	140	0	1486	0	1346	0.0	0.0
chr15	AC023905.1	47393321	47393485	0	165	0	1486	0	1321	0.0	0.0
chr15	LINC01491	47793677	47793816	0	140	0	1932	0	1792	0.0	0.0
chr15	LINC01491	47814070	47814176	0	107	0	1932	0	1825	0.0	0.0
chr15	LINC01491	47844837	47844965	0	129	0	1932	0	1803	0.0	0.0
chr15	LINC01491	47791106	47791250	0	145	0	1932	0	1787	0.0	0.0
chr15	LINC01491	47803383	47803435	0	53	0	1932	0	1879	0.0	0.0
chr15	LINC01491	47820117	47820157	0	41	0	1932	0	1891	0.0	0.0
chr15	MYEF2	48151099	48151171	0	73	0	6737	0	6664	0.0	0.0
chr15	MYEF2	48152233	48152284	0	52	0	6737	0	6685	0.0	0.0
chr15	MYEF2	48167348	48167401	0	54	0	6737	0	6683	0.0	0.0
chr15	AC066612.1	48190057	48190157	0	101	0	3119	0	3018	0.0	0.0
chr15	AC066612.1	48190039	48190157	0	119	0	3119	0	3000	0.0	0.0
chr15	FBN1	48427881	48427943	743	63	46119	12734	45376	12671	11.793650793650794	3.58109067950438
chr15	FBN1	48434107	48434212	9599	106	46119	12734	36520	12628	90.55660377358491	2.8919860627177703
chr15	CEP152	48748442	48748610	0	169	32119	8196	32119	8027	0.0	4.001370374984427
chr15	CEP152	48797300	48797579	1947	280	32119	8196	30172	7916	6.953571428571428	3.811520970186963
chr15	SHC4	48851187	48851248	0	62	0	6546	0	6484	0.0	0.0
chr15	SECISBP2L	49019417	49019552	0	136	3322	8603	3322	8467	0.0	0.3923467580016535
chr15	FAM227B	49568244	49568346	0	103	24449	5713	24449	5610	0.0	4.358110516934047
chr15	FAM227B	49589775	49590007	0	233	24449	5713	24449	5480	0.0	4.461496350364963
chr15	FAM227B	49620133	49620190	4752	58	24449	5713	19697	5655	81.93103448275862	3.4831122900088416
chr15	FAM227B	49577171	49577305	0	135	24449	5713	24449	5578	0.0	4.383112226604518
chr15	FAM227B	49577628	49577664	0	37	24449	5713	24449	5676	0.0	4.307434813248767
chr15	ATP8B4	49901091	49901239	180	149	3577	10908	3397	10759	1.2080536912751678	0.3157356631657217
chr15	ATP8B4	49931118	49931307	0	190	3577	10908	3577	10718	0.0	0.33373763761895875
chr15	ATP8B4	50018888	50018976	0	89	3577	10908	3577	10819	0.0	0.33062205379425086
chr15	ATP8B4	49922223	49922405	860	183	3577	10908	2717	10725	4.699453551912568	0.25333333333333335
chr15	HDC	50248244	50248343	0	100	51	3906	51	3806	0.0	0.013399894902785077
chr15	HDC	50257424	50257547	0	124	51	3906	51	3782	0.0	0.013484928609201481
chr15	HDC	50258403	50258517	0	115	51	3906	51	3791	0.0	0.013452914798206279
chr15	GABPB1	50302928	50303123	0	196	102	5585	102	5389	0.0	0.01892744479495268
chr15	GABPB1	50309690	50309798	0	109	102	5585	102	5476	0.0	0.01862673484295106
chr15	GABPB1	50282278	50282391	0	114	102	5585	102	5471	0.0	0.018643757996709927
chr15	GABPB1	50346371	50346395	0	25	102	5585	102	5560	0.0	0.018345323741007193
chr15	GABPB1	50314415	50314670	0	256	102	5585	102	5329	0.0	0.01914055169825483
chr15	USP50	50496220	50496312	0	93	0	3645	0	3552	0.0	0.0
chr15	USP50	50541048	50541264	0	217	0	3645	0	3428	0.0	0.0
chr15	USP50	50532011	50532227	0	217	0	3645	0	3428	0.0	0.0
chr15	SPPL2A	50732602	50732684	0	83	141	7904	141	7821	0.0	0.01802838511699271
chr15	SPPL2A	50726072	50726126	0	55	141	7904	141	7849	0.0	0.017964071856287425
chr15	CYP19A1	51222348	51222525	0	178	5463	7380	5463	7202	0.0	0.7585392946403777
chr15	CYP19A1	51323815	51323924	0	110	5463	7380	5463	7270	0.0	0.7514442916093536
chr15	CYP19A1	51255517	51255761	0	245	5463	7380	5463	7135	0.0	0.7656622284512964
chr15	CYP19A1	51255517	51255708	0	192	5463	7380	5463	7188	0.0	0.760016694490818
chr15	CYP19A1	51337817	51337908	0	92	5463	7380	5463	7288	0.0	0.7495883644346871
chr15	CYP19A1	51278007	51278162	0	156	5463	7380	5463	7224	0.0	0.7562292358803987
chr15	DMXL2	51451644	51451697	0	54	0	13771	0	13717	0.0	0.0
chr15	DMXL2	51459597	51459660	0	64	0	13771	0	13707	0.0	0.0
chr15	GNB5	52147458	52147535	0	78	59144	12978	59144	12900	0.0	4.584806201550387
chr15	GNB5	52128643	52128695	0	53	59144	12978	59144	12925	0.0	4.575938104448743
chr15	GNB5	52141139	52141272	0	134	59144	12978	59144	12844	0.0	4.604796013702896
chr15	MYO5C	52213187	52213286	0	100	78500	10094	78500	9994	0.0	7.854712827696618
chr15	MYO5C	52232621	52232685	0	65	78500	10094	78500	10029	0.0	7.82730082759996
chr15	MYO5C	52242047	52242213	7642	167	78500	10094	70858	9927	45.76047904191617	7.137906719049058
chr15	MYO5C	52271762	52271844	80	83	78500	10094	78420	10011	0.963855421686747	7.833383278393767
chr15	MYO5C	52282781	52282892	0	112	78500	10094	78500	9982	0.0	7.864155479863755
chr15	MYO5C	52239732	52239879	0	148	78500	10094	78500	9946	0.0	7.892620148803539
chr15	MYO5C	52265185	52265220	612	36	78500	10094	77888	10058	17.0	7.743885464307019
chr15	MYO5C	52277843	52278027	0	185	78500	10094	78500	9909	0.0	7.922091028358058
chr15	MYO5C	52282781	52282884	0	104	78500	10094	78500	9990	0.0	7.857857857857858
chr15	MYO5A	52337809	52337884	0	76	145888	13013	145888	12937	0.0	11.276802968230657
chr15	MYO5A	52343116	52343197	612	82	145888	13013	145276	12931	7.463414634146342	11.23470729255278
chr15	MYO5A	52348817	52348826	20	10	145888	13013	145868	13003	2.0	11.21802660924402
chr15	MYO5A	52428397	52428569	102	173	145888	13013	145786	12840	0.5895953757225434	11.35404984423676
chr15	ARPP19	52557099	52557222	0	124	0	6840	0	6716	0.0	0.0
chr15	ARPP19	52568847	52568902	0	56	0	6840	0	6784	0.0	0.0
chr15	ARPP19	52568847	52568900	0	54	0	6840	0	6786	0.0	0.0
chr15	ARPP19	52564189	52564246	0	58	0	6840	0	6782	0.0	0.0
chr15	FAM214A	52587150	52587219	0	70	23457	9760	23457	9690	0.0	2.4207430340557274
chr15	FAM214A	52600126	52600235	2682	110	23457	9760	20775	9650	24.381818181818183	2.1528497409326426
chr15	FAM214A	52613672	52613857	923	186	23457	9760	22534	9574	4.962365591397849	2.353666179235429
chr15	FAM214A	52587055	52587219	0	165	23457	9760	23457	9595	0.0	2.4447107868681606
chr15	AC084759.2	53968001	53968150	0	150	51	3596	51	3446	0.0	0.014799767846778875
chr15	AC084759.2	53959795	53959871	0	77	51	3596	51	3519	0.0	0.014492753623188406
chr15	RSL24D1	55194152	55194183	21	32	21	6103	0	6071	0.65625	0.0
chr15	RSL24D1	55193169	55193231	0	63	21	6103	21	6040	0.0	0.00347682119205298
chr15	RSL24D1	55194295	55194359	0	65	21	6103	21	6038	0.0	0.0034779728386883074
chr15	RAB27A	55238402	55238491	0	90	61	5247	61	5157	0.0	0.011828582509210782
chr15	RAB27A	55237315	55237442	0	128	61	5247	61	5119	0.0	0.011916389919906232
chr15	RAB27A	55259920	55260023	0	104	61	5247	61	5143	0.0	0.011860781644954306
chr15	CCPG1	55359538	55360944	51	1407	51	5580	0	4173	0.03624733475479744	0.0
chr15	CCPG1	55365187	55365309	0	123	51	5580	51	5457	0.0	0.009345794392523364
chr15	DNAAF4	55466929	55467161	255	233	13883	2948	13628	2715	1.094420600858369	5.019521178637201
chr15	CCPG1	55374154	55374250	0	97	51	5580	51	5483	0.0	0.009301477293452489
chr15	CCPG1	55399784	55399926	0	143	51	5580	51	5437	0.0	0.0093801728894611
chr15	DNAAF4	55432496	55432602	0	107	13883	2948	13883	2841	0.0	4.886659626891939
chr15	DNAAF4	55495127	55495202	1795	76	13883	2948	12088	2872	23.61842105263158	4.20891364902507
chr15	NEDD4	55872414	55872476	128	63	18454	9157	18326	9094	2.0317460317460316	2.0151748405542116
chr15	NEDD4	55869578	55869681	0	104	18454	9157	18454	9053	0.0	2.0384402960344636
chr15	NEDD4	55873957	55874008	50	52	18454	9157	18404	9105	0.9615384615384616	2.0213069741900056
chr15	NEDD4	55951510	55951589	1326	80	18454	9157	17128	9077	16.575	1.8869670596011898
chr15	NEDD4	55905211	55905281	585	71	18454	9157	17869	9086	8.23943661971831	1.9666519920757208
chr15	RFX7	56087907	56087990	0	84	14850	11124	14850	11040	0.0	1.3451086956521738
chr15	RFX7	56179269	56179303	0	35	14850	11124	14850	11089	0.0	1.3391649382270718
chr15	AC090518.1	56548446	56548601	0	156	51	2657	51	2501	0.0	0.02039184326269492
chr15	AC090518.1	56629385	56629400	0	16	51	2657	51	2641	0.0	0.019310867095797046
chr15	ZNF280D	56654730	56654842	0	113	2916	10430	2916	10317	0.0	0.2826403024134923
chr15	ZNF280D	56707081	56707150	0	70	2916	10430	2916	10360	0.0	0.28146718146718147
chr15	ZNF280D	56707081	56707143	0	63	2916	10430	2916	10367	0.0	0.28127712935275395
chr15	ZNF280D	56667996	56668241	0	246	2916	10430	2916	10184	0.0	0.286331500392773
chr15	ZNF280D	56729753	56729782	0	30	2916	10430	2916	10400	0.0	0.2803846153846154
chr15	AC090517.5	56905747	56905865	0	119	51	6477	51	6358	0.0	0.008021390374331552
chr15	ALDH1A2	57992704	57992818	0	115	765	8160	765	8045	0.0	0.09509011808576756
chr15	ALDH1A2	58010648	58010778	0	131	765	8160	765	8029	0.0	0.09527961140864366
chr15	ALDH1A2	58058011	58058108	714	98	765	8160	51	8062	7.285714285714286	0.006325973703795584
chr15	ADAM10	58679123	58679282	0	160	102	6078	102	5918	0.0	0.01723555255153768
chr15	ADAM10	58682195	58682314	0	120	102	6078	102	5958	0.0	0.017119838872104734
chr15	ADAM10	58676142	58676293	0	152	102	6078	102	5926	0.0	0.01721228484643942
chr15	SLTM	58890280	58890461	172	182	127912	6192	127740	6010	0.945054945054945	21.254575707154743
chr15	SLTM	58899468	58899937	1479	470	127912	6192	126433	5722	3.146808510638298	22.095945473610627
chr15	SLTM	58913498	58913696	6387	199	127912	6192	121525	5993	32.095477386934675	20.277824128149508
chr15	SLTM	58932355	58932443	0	89	127912	6192	127912	6103	0.0	20.958872685564476
chr15	SLTM	58912562	58912610	0	49	127912	6192	127912	6143	0.0	20.82239947908188
chr15	SLTM	58899468	58899883	1479	416	127912	6192	126433	5776	3.5552884615384617	21.889369806094184
chr15	MYO1E	59188117	59188216	0	100	20041	5176	20041	5076	0.0	3.948187549251379
chr15	MYO1E	59236584	59236672	0	89	20041	5176	20041	5087	0.0	3.9396500884607826
chr15	GTF2A2	59642135	59642262	255	128	4335	2929	4080	2801	1.9921875	1.4566226347732953
chr15	GTF2A2	59650668	59650773	10	106	4335	2929	4325	2823	0.09433962264150944	1.5320580942260007
chr15	GTF2A2	59656814	59657033	0	220	4335	2929	4335	2709	0.0	1.6002214839424143
chr15	GTF2A2	59652205	59652326	68	122	4335	2929	4267	2807	0.5573770491803278	1.5201282508015674
chr15	GTF2A2	59650668	59650764	10	97	4335	2929	4325	2832	0.10309278350515463	1.5271892655367232
chr15	BNIP2	59668102	59668138	55	37	6688	7747	6633	7710	1.4864864864864864	0.8603112840466927
chr15	BNIP2	59678747	59678834	0	88	6688	7747	6688	7659	0.0	0.8732210471340907
chr15	BNIP2	59678775	59678834	0	60	6688	7747	6688	7687	0.0	0.8700403278262001
chr15	ANXA2	60349074	60349197	0	124	0	11528	0	11404	0.0	0.0
chr15	ANXA2	60382341	60382441	0	101	0	11528	0	11427	0.0	0.0
chr15	ANXA2	60390212	60390317	0	106	0	11528	0	11422	0.0	0.0
chr15	ANXA2	60393238	60393440	0	203	0	11528	0	11325	0.0	0.0
chr15	ANXA2	60393012	60393440	0	429	0	11528	0	11099	0.0	0.0
chr15	ANXA2	60397257	60397338	0	82	0	11528	0	11446	0.0	0.0
chr15	ANXA2	60396279	60396427	0	149	0	11528	0	11379	0.0	0.0
chr15	ANXA2	60396372	60396427	0	56	0	11528	0	11472	0.0	0.0
chr15	ANXA2	60364428	60364523	0	96	0	11528	0	11432	0.0	0.0
chr15	ANXA2	60386027	60386086	0	60	0	11528	0	11468	0.0	0.0
chr15	ANXA2	60393037	60393440	0	404	0	11528	0	11124	0.0	0.0
chr15	ANXA2	60396150	60396427	0	278	0	11528	0	11250	0.0	0.0
chr15	ANXA2	60374618	60374682	0	65	0	11528	0	11463	0.0	0.0
chr15	ANXA2	60394573	60394695	0	123	0	11528	0	11405	0.0	0.0
chr15	ICE2	60447969	60448145	0	177	102	10708	102	10531	0.0	0.009685689868008737
chr15	ICE2	60477936	60478069	0	134	102	10708	102	10574	0.0	0.00964630225080386
chr15	ICE2	60478567	60478650	0	84	102	10708	102	10624	0.0	0.009600903614457831
chr15	ICE2	60478567	60478637	0	71	102	10708	102	10637	0.0	0.009589169878725205
chr15	ICE2	60478567	60478660	0	94	102	10708	102	10614	0.0	0.009609949123798756
chr15	RORA	60677150	60677232	324	83	80772	17047	80448	16964	3.9036144578313254	4.742277764678142
chr15	VPS13C	61884127	61884269	0	143	40	19787	40	19644	0.0	0.0020362451639177356
chr15	VPS13C	61936596	61936750	0	155	40	19787	40	19632	0.0	0.002037489812550937
chr15	VPS13C	61864640	61864820	0	181	40	19787	40	19606	0.0	0.0020401917780271347
chr15	AC126323.1	62247513	62247608	0	96	1924	3921	1924	3825	0.0	0.5030065359477124
chr15	RPS27L	63156786	63156973	0	188	51	7259	51	7071	0.0	0.007212558336868901
chr15	CA12	63328097	63328130	0	34	14081	7011	14081	6977	0.0	2.0182026659022503
chr15	CA12	63346529	63346709	900	181	14081	7011	13181	6830	4.972375690607735	1.9298682284040996
chr15	USP3-AS1	63551829	63551876	3200	48	53378	2791	50178	2743	66.66666666666667	18.29310973386803
chr15	USP3-AS1	63593748	63593877	58	130	53378	2791	53320	2661	0.4461538461538462	20.037579857196544
chr15	USP3-AS1	63599182	63599303	5267	122	53378	2791	48111	2669	43.17213114754098	18.025852379168228
chr15	HERC1	63632290	63632605	6042	316	31914	16742	25872	16426	19.120253164556964	1.575063923048825
chr15	HERC1	63636987	63637134	0	148	31914	16742	31914	16594	0.0	1.9232252621429433
chr15	HERC1	63780461	63780552	0	92	31914	16742	31914	16650	0.0	1.9167567567567567
chr15	HERC1	63779582	63780009	23	428	31914	16742	31891	16314	0.053738317757009345	1.9548240774794654
chr15	DAPK2	63991227	63991351	0	125	18372	11854	18372	11729	0.0	1.5663739449228409
chr15	CIAO2A	64081101	64081151	0	51	102	2267	102	2216	0.0	0.046028880866425995
chr15	CIAO2A	64090197	64090315	0	119	102	2267	102	2148	0.0	0.04748603351955307
chr15	PPIB	64162040	64162154	0	115	0	1728	0	1613	0.0	0.0
chr15	CSNK1G1	64251511	64251581	0	71	214	9347	214	9276	0.0	0.023070288917636912
chr15	CSNK1G1	64259200	64259241	40	42	214	9347	174	9305	0.9523809523809523	0.018699623858140786
chr15	CSNK1G1	64188374	64188485	0	112	214	9347	214	9235	0.0	0.02317271250676773
chr15	CSNK1G1	64176261	64176285	0	25	214	9347	214	9322	0.0	0.022956447114353143
chr15	CSNK1G1	64189340	64189480	0	141	214	9347	214	9206	0.0	0.02324570932000869
chr15	CSNK1G1	64195015	64195079	0	65	214	9347	214	9282	0.0	0.02305537599655247
chr15	AC087632.2	64376742	64376905	0	164	108400	3306	108400	3142	0.0	34.50031826861871
chr15	AC087632.2	64380957	64381038	84083	82	108400	3306	24317	3224	1025.4024390243903	7.542493796526054
chr15	AC087632.2	64365973	64366075	1243	103	108400	3306	107157	3203	12.067961165048544	33.45519825163909
chr15	AC087632.2	64365985	64366075	1111	91	108400	3306	107289	3215	12.208791208791208	33.371384136858474
chr15	AC087632.2	64373697	64373764	823	68	108400	3306	107577	3238	12.102941176470589	33.223285978999385
chr15	OAZ2	64689083	64689169	0	87	13618	2806	13618	2719	0.0	5.008458992276572
chr15	OAZ2	64691433	64691591	0	159	13618	2806	13618	2647	0.0	5.144692104268984
chr15	OAZ2	64690907	64691009	0	103	13618	2806	13618	2703	0.0	5.03810580836108
chr15	PIF1	64817945	64818091	870	147	173217	3967	172347	3820	5.918367346938775	45.117015706806285
chr15	PIF1	64819846	64819986	51	141	173217	3967	173166	3826	0.3617021276595745	45.260324098274964
chr15	SPG21	64974601	64974747	10963	147	173158	3998	162195	3851	74.578231292517	42.11763178395222
chr15	SPG21	64976474	64976555	10157	82	173158	3998	163001	3916	123.86585365853658	41.624361593462716
chr15	SPG21	64983506	64983593	848	88	173158	3998	172310	3910	9.636363636363637	44.069053708439895
chr15	SPG21	64989168	64989273	2	106	173158	3998	173156	3892	0.018867924528301886	44.49023638232271
chr15	SPG21	64988618	64988816	1806	199	173158	3998	171352	3799	9.075376884422111	45.10450118452224
chr15	SPG21	64987171	64987261	721	91	173158	3998	172437	3907	7.923076923076923	44.13539800358331
chr15	MTFMT	65021513	65021616	39	104	1468	2292	1429	2188	0.375	0.653107861060329
chr15	MTFMT	65023671	65023794	34	124	1468	2292	1434	2168	0.27419354838709675	0.6614391143911439
chr15	RASL12	65065216	65065273	47	58	1660	2687	1613	2629	0.8103448275862069	0.6135412704450361
chr15	PDCD7	65119717	65119954	520	238	2465	3240	1945	3002	2.1848739495798317	0.6479013990672885
chr15	PARP16	65266561	65266768	0	208	13096	3734	13096	3526	0.0	3.7141236528644357
chr15	PARP16	65270934	65271072	222	139	13096	3734	12874	3595	1.5971223021582734	3.5810848400556328
chr15	DPP8	65454262	65454415	143	154	115640	9869	115497	9715	0.9285714285714286	11.888522902727741
chr15	DPP8	65456224	65456371	517	148	115640	9869	115123	9721	3.4932432432432434	11.842711655179508
chr15	DPP8	65463760	65463906	0	147	115640	9869	115640	9722	0.0	11.894671878214359
chr15	DPP8	65500605	65500779	0	175	115640	9869	115640	9694	0.0	11.929028264906128
chr15	DPP8	65515655	65515791	0	137	115640	9869	115640	9732	0.0	11.882449650637074
chr15	DPP8	65455711	65455841	0	131	115640	9869	115640	9738	0.0	11.875128363113575
chr15	INTS14	65605128	65605236	0	109	1689	4223	1689	4114	0.0	0.4105493437044239
chr15	INTS14	65607158	65607442	51	285	1689	4223	1638	3938	0.17894736842105263	0.4159471813103098
chr15	INTS14	65607158	65607425	51	268	1689	4223	1638	3955	0.19029850746268656	0.41415929203539825
chr15	INTS14	65607301	65607442	51	142	1689	4223	1638	4081	0.3591549295774648	0.4013722126929674
chr15	DENND4A	65700543	65700675	0	133	21937	7940	21937	7807	0.0	2.809914179582426
chr15	DENND4A	65665198	65665225	0	28	21937	7940	21937	7912	0.0	2.772623862487361
chr15	DENND4A	65700543	65700672	0	130	21937	7940	21937	7810	0.0	2.808834827144686
chr15	MEGF11	66119085	66119186	0	102	50288	9387	50288	9285	0.0	5.416047388260635
chr15	MEGF11	66128305	66128433	0	129	50288	9387	50288	9258	0.0	5.431842730611363
chr15	MEGF11	66128305	66128411	0	107	50288	9387	50288	9280	0.0	5.4189655172413795
chr15	MEGF11	65912081	65912200	0	120	50288	9387	50288	9267	0.0	5.426567389662242
chr15	MEGF11	65902495	65902537	77	43	50288	9387	50211	9344	1.7906976744186047	5.373608732876712
chr15	MEGF11	65906624	65906670	0	47	50288	9387	50288	9340	0.0	5.384154175588865
chr15	TIPIN	66351524	66351600	0	77	84	2519	84	2442	0.0	0.0343980343980344
chr15	SNAPC5	66495329	66495419	0	91	0	2480	0	2389	0.0	0.0
chr15	SNAPC5	66494902	66495419	0	518	0	2480	0	1962	0.0	0.0
chr15	RPL4	66501787	66501912	0	126	0	5307	0	5181	0.0	0.0
chr15	LCTL	66564675	66564839	0	165	51	3533	51	3368	0.0	0.015142517814726841
chr15	AC087482.1	66989911	66990043	0	133	62199	3790	62199	3657	0.0	17.008203445447087
chr15	AC087482.1	66985441	66985483	0	43	62199	3790	62199	3747	0.0	16.599679743795036
chr15	IQCH-AS1	67421334	67421498	306	165	4576	9116	4270	8951	1.8545454545454545	0.47704167132164005
chr15	IQCH-AS1	67430320	67430400	0	81	4576	9116	4576	9035	0.0	0.5064748201438849
chr15	CLN6	68218535	68218650	0	116	51	7108	51	6992	0.0	0.007294050343249428
chr15	CALML4	68197439	68197628	0	190	0	5043	0	4853	0.0	0.0
chr15	CALML4	68199540	68199681	0	142	0	5043	0	4901	0.0	0.0
chr15	CALML4	68205120	68205151	0	32	0	5043	0	5011	0.0	0.0
chr15	CLN6	68211674	68211863	51	190	51	7108	0	6918	0.26842105263157895	0.0
chr15	CLN6	68214289	68214388	0	100	51	7108	51	7008	0.0	0.007277397260273972
chr15	CLN6	68211555	68211863	51	309	51	7108	0	6799	0.1650485436893204	0.0
chr15	CLN6	68211674	68211921	51	248	51	7108	0	6860	0.2056451612903226	0.0
chr15	CLN6	68211555	68211741	0	187	51	7108	51	6921	0.0	0.007368877329865626
chr15	CLN6	68211555	68211643	0	89	51	7108	51	7019	0.0	0.007265992306596381
chr15	CLN6	68211648	68211863	51	216	51	7108	0	6892	0.2361111111111111	0.0
chr15	CLN6	68248353	68248481	0	129	51	7108	51	6979	0.0	0.007307637197306204
chr15	TLE3	70066617	70066939	0	323	51	9700	51	9377	0.0	0.005438839714194305
chr15	UACA	70677107	70677140	0	34	51	11017	51	10983	0.0	0.004643540016388965
chr15	RPL29P30	70797283	70797392	0	110	0	916	0	806	0.0	0.0
chr15	THSD4-AS1	71185424	71185506	0	83	10409	4037	10409	3954	0.0	2.6325240263024785
chr15	THSD4-AS1	71186497	71187592	49	1096	10409	4037	10360	2941	0.04470802919708029	3.522611356681401
chr15	THSD4-AS1	71185404	71185506	0	103	10409	4037	10409	3934	0.0	2.6459074733096086
chr15	MYO9A	71850035	71850167	0	133	15277	14410	15277	14277	0.0	1.0700427260628984
chr15	MYO9A	71916369	71916492	0	124	15277	14410	15277	14286	0.0	1.0693686126277475
chr15	MYO9A	71951776	71951896	0	121	15277	14410	15277	14289	0.0	1.0691440968577228
chr15	MYO9A	72019038	72019095	0	58	15277	14410	15277	14352	0.0	1.0644509476031214
chr15	MYO9A	72032493	72032588	0	96	15277	14410	15277	14314	0.0	1.0672767919519353
chr15	MYO9A	72045723	72046634	1	912	15277	14410	15276	13498	0.0010964912280701754	1.1317232182545562
chr15	MYO9A	71892964	71893177	0	214	15277	14410	15277	14196	0.0	1.0761482107635953
chr15	MYO9A	71847414	71847468	0	55	15277	14410	15277	14355	0.0	1.0642284918146987
chr15	MYO9A	71951701	71951896	0	196	15277	14410	15277	14214	0.0	1.0747854228225693
chr15	GRAMD2A	72169416	72169563	0	148	49	2853	49	2705	0.0	0.01811460258780037
chr15	PKM	72217408	72217500	0	93	2988	7878	2988	7785	0.0	0.3838150289017341
chr15	PKM	72221167	72221284	0	118	2988	7878	2988	7760	0.0	0.3850515463917526
chr15	PKM	72231323	72231391	0	69	2988	7878	2988	7809	0.0	0.38263542066845946
chr15	PARP6	72249244	72249314	0	71	1644	7059	1644	6988	0.0	0.23526044647967945
chr15	PARP6	72250844	72250954	0	111	1644	7059	1644	6948	0.0	0.23661485319516407
chr15	PARP6	72250844	72250957	0	114	1644	7059	1644	6945	0.0	0.2367170626349892
chr15	PARP6	72253949	72254070	0	122	1644	7059	1644	6937	0.0	0.23699005333717746
chr15	CELF6	72288537	72288618	0	82	787	3631	787	3549	0.0	0.221752606367991
chr15	CELF6	72288867	72288930	0	64	787	3631	787	3567	0.0	0.22063358564620128
chr15	CELF6	72289938	72290018	0	81	787	3631	787	3550	0.0	0.2216901408450704
chr15	CELF6	72304745	72304794	0	50	787	3631	787	3581	0.0	0.2197710136833287
chr15	CELF6	72292197	72292265	155	69	787	3631	632	3562	2.246376811594203	0.17742841100505333
chr15	HEXA	72346526	72346710	0	185	51	12182	51	11997	0.0	0.0042510627656914225
chr15	HEXA	72347685	72347758	0	74	51	12182	51	12108	0.0	0.00421209117938553
chr15	HEXA	72349078	72349259	0	182	51	12182	51	12000	0.0	0.00425
chr15	HEXA	72353690	72353737	0	48	51	12182	51	12134	0.0	0.004203065765617274
chr15	HEXA	72353067	72353178	0	112	51	12182	51	12070	0.0	0.004225352112676056
chr15	HEXA	72362375	72362466	0	92	51	12182	51	12090	0.0	0.004218362282878412
chr15	HEXA	72355909	72355976	0	68	51	12182	51	12114	0.0	0.004210004952947003
chr15	LINC02259	72616129	72616247	10	119	3119	641	3109	522	0.08403361344537816	5.9559386973180075
chr15	ADPGK	72755981	72756161	0	181	6103	5311	6103	5130	0.0	1.1896686159844054
chr15	ADPGK	72756250	72756447	0	198	6103	5311	6103	5113	0.0	1.1936240954429884
chr15	ADPGK	72771782	72771845	0	64	6103	5311	6103	5247	0.0	1.1631408423861254
chr15	ADPGK	72774871	72775097	238	227	6103	5311	5865	5084	1.0484581497797356	1.1536191974822974
chr15	ADPGK	72755555	72755654	0	100	6103	5311	6103	5211	0.0	1.171176357704855
chr15	NPTN	73597021	73597369	0	349	0	3644	0	3295	0.0	0.0
chr15	LOXL1-AS1	73916342	73916447	0	106	9966	4796	9966	4690	0.0	2.124946695095949
chr15	LOXL1-AS1	73925269	73925505	9762	237	9966	4796	204	4559	41.18987341772152	0.04474665496819478
chr15	STOML1	73984658	73984871	612	214	11297	8369	10685	8155	2.8598130841121496	1.3102391171060699
chr15	STOML1	73989107	73989257	0	151	11297	8369	11297	8218	0.0	1.3746653687028474
chr15	STOML1	73984658	73984868	612	211	11297	8369	10685	8158	2.9004739336492893	1.309757293454278
chr15	STOML1	73990814	73990945	0	132	11297	8369	11297	8237	0.0	1.3714944761442274
chr15	GOLGA6A	74080615	74080735	0	121	0	3522	0	3401	0.0	0.0
chr15	STRA6	74183855	74183989	0	135	8425	6568	8425	6433	0.0	1.3096533499145033
chr15	STRA6	74195301	74195468	0	168	8425	6568	8425	6400	0.0	1.31640625
chr15	STRA6	74195651	74195675	0	25	8425	6568	8425	6543	0.0	1.2876356411432064
chr15	STRA6	74183252	74183989	0	738	8425	6568	8425	5830	0.0	1.4451114922813035
chr15	CYP11A1	74339236	74339315	96	80	60571	3410	60475	3330	1.2	18.16066066066066
chr15	CYP11A1	74347899	74348055	0	157	60571	3410	60571	3253	0.0	18.620043037196435
chr15	CYP11A1	74350165	74350254	0	90	60571	3410	60571	3320	0.0	18.244277108433735
chr15	SEMA7A	74418267	74418309	215	43	264	3814	49	3771	5.0	0.012993900822063113
chr15	UBL7	74451435	74451520	0	86	2051	1897	2051	1811	0.0	1.1325234676974048
chr15	UBL7	74459018	74459103	0	86	2051	1897	2051	1811	0.0	1.1325234676974048
chr15	UBL7	74460667	74460778	0	112	2051	1897	2051	1785	0.0	1.1490196078431372
chr15	UBL7	74452295	74452378	0	84	2051	1897	2051	1813	0.0	1.1312741312741312
chr15	EDC3	74655732	74656068	0	337	49	5102	49	4765	0.0	0.010283315844700944
chr15	EDC3	74671454	74671774	0	321	49	5102	49	4781	0.0	0.010248901903367497
chr15	EDC3	74676940	74677022	0	83	49	5102	49	5019	0.0	0.009762900976290097
chr15	EDC3	74687090	74687179	49	90	49	5102	0	5012	0.5444444444444444	0.0
chr15	EDC3	74674960	74675142	0	183	49	5102	49	4919	0.0	0.009961374263061597
chr15	EDC3	74692885	74693018	0	134	49	5102	49	4968	0.0	0.009863123993558777
chr15	EDC3	74679801	74679925	0	125	49	5102	49	4977	0.0	0.009845288326300985
chr15	CYP1A1	74720966	74721053	0	88	102	3368	102	3280	0.0	0.031097560975609756
chr15	ULK3	74838265	74838344	0	80	7655	3361	7655	3281	0.0	2.3331301432490092
chr15	ULK3	74842534	74842674	0	141	7655	3361	7655	3220	0.0	2.377329192546584
chr15	SCAMP2	74854580	74854649	0	70	1479	3262	1479	3192	0.0	0.4633458646616541
chr15	SCAMP2	74853367	74853496	0	130	1479	3262	1479	3132	0.0	0.4722222222222222
chr15	FAM219B	74901168	74901256	0	89	969	3076	969	2987	0.0	0.32440575828590557
chr15	FAM219B	74904663	74904712	0	50	969	3076	969	3026	0.0	0.3202247191011236
chr15	FAM219B	74906277	74906365	0	89	969	3076	969	2987	0.0	0.32440575828590557
chr15	FAM219B	74904981	74905059	0	79	969	3076	969	2997	0.0	0.3233233233233233
chr15	FAM219B	74906323	74906365	0	43	969	3076	969	3033	0.0	0.31948565776458954
chr15	FAM219B	74904981	74905039	0	59	969	3076	969	3017	0.0	0.3211799801126947
chr15	COX5A	74923647	74923770	5390	124	86890	1332	81500	1208	43.46774193548387	67.46688741721854
chr15	COX5A	74929115	74929232	4575	118	86890	1332	82315	1214	38.771186440677965	67.80477759472817
chr15	COX5A	74926765	74926887	1134	123	86890	1332	85756	1209	9.21951219512195	70.9313482216708
chr15	MAN2C1	75363998	75364188	0	191	3097	7504	3097	7313	0.0	0.4234924107753316
chr15	MAN2C1	75368072	75368198	139	127	3097	7504	2958	7377	1.094488188976378	0.40097600650671006
chr15	MAN2C1	75362641	75362748	0	108	3097	7504	3097	7396	0.0	0.41873985938345054
chr15	MAN2C1	75363209	75363290	0	82	3097	7504	3097	7422	0.0	0.41727297224467796
chr15	MAN2C1	75365600	75365698	51	99	3097	7504	3046	7405	0.5151515151515151	0.4113436866981769
chr15	MAN2C1	75368072	75368159	28	88	3097	7504	3069	7416	0.3181818181818182	0.41383495145631066
chr15	MAN2C1	75365961	75366009	0	49	3097	7504	3097	7455	0.0	0.41542588866532526
chr15	SIN3A	75443592	75443707	49	116	4904	12419	4855	12303	0.4224137931034483	0.3946191985694546
chr15	SIN3A	75436345	75436443	0	99	4904	12419	4904	12320	0.0	0.39805194805194805
chr15	SIN3A	75446228	75446395	0	168	4904	12419	4904	12251	0.0	0.4002938535629745
chr15	PTPN9	75470679	75470830	0	152	251	8599	251	8447	0.0	0.02971469160648751
chr15	AC105036.3	75597339	75597480	0	142	0	1101	0	959	0.0	0.0
chr15	AC105036.3	75570229	75570346	0	118	0	1101	0	983	0.0	0.0
chr15	SNUPN	75622341	75622490	0	150	51	3528	51	3378	0.0	0.015097690941385435
chr15	SNUPN	75624714	75624935	0	222	51	3528	51	3306	0.0	0.015426497277676952
chr15	SNUPN	75622341	75622408	0	68	51	3528	51	3460	0.0	0.014739884393063583
chr15	NRG4	75971165	75971248	304	84	15022	3050	14718	2966	3.619047619047619	4.96223870532704
chr15	NRG4	75969128	75969224	6568	97	15022	3050	8454	2953	67.71134020618557	2.8628513376227565
chr15	NRG4	75959021	75959140	888	120	15022	3050	14134	2930	7.4	4.823890784982935
chr15	NRG4	76056953	76057019	0	67	15022	3050	15022	2983	0.0	5.0358699296010725
chr15	NRG4	76053238	76053369	0	132	15022	3050	15022	2918	0.0	5.14804660726525
chr15	ETFA	76283756	76283825	0	70	38163	5050	38163	4980	0.0	7.663253012048193
chr15	ETFA	76292618	76292700	0	83	38163	5050	38163	4967	0.0	7.683309844976847
chr15	ETFA	76295590	76295737	0	148	38163	5050	38163	4902	0.0	7.785189718482252
chr15	ETFA	76227712	76227897	854	186	38163	5050	37309	4864	4.591397849462366	7.6704358552631575
chr15	ETFA	76292430	76292513	0	84	38163	5050	38163	4966	0.0	7.684857027788965
chr15	ETFA	76217585	76217677	0	93	38163	5050	38163	4957	0.0	7.698809763970143
chr15	ETFA	76227712	76227918	1169	207	38163	5050	36994	4843	5.647342995169082	7.638653727028701
chr15	ETFA	76309931	76310064	0	134	38163	5050	38163	4916	0.0	7.7630187144019525
chr15	ETFA	76284364	76284460	0	97	38163	5050	38163	4953	0.0	7.705027256208359
chr15	ETFA	76284804	76284927	0	124	38163	5050	38163	4926	0.0	7.7472594397076735
chr15	SCAPER	76841733	76841931	0	199	411	11270	411	11071	0.0	0.03712401770391112
chr15	SCAPER	76862415	76862533	0	119	411	11270	411	11151	0.0	0.03685768092547754
chr15	SCAPER	76793232	76793391	0	160	411	11270	411	11110	0.0	0.036993699369936996
chr15	SCAPER	76855809	76855876	0	68	411	11270	411	11202	0.0	0.03668987680771291
chr15	SCAPER	76567269	76567405	0	137	411	11270	411	11133	0.0	0.036917272972244675
chr15	SCAPER	76904613	76904791	0	179	411	11270	411	11091	0.0	0.037057073302677844
chr15	SCAPER	76774367	76774409	0	43	411	11270	411	11227	0.0	0.03660817671684333
chr15	TSPAN3	77055788	77055863	0	76	620	6899	620	6823	0.0	0.09086911915579657
chr15	TSPAN3	77056063	77056255	0	193	620	6899	620	6706	0.0	0.09245451834178348
chr15	TSPAN3	77055788	77055829	0	42	620	6899	620	6857	0.0	0.09041855038646639
chr15	PEAK1	77252366	77252526	0	161	113021	23394	113021	23233	0.0	4.864675246416735
chr15	PEAK1	77286422	77286504	0	83	113021	23394	113021	23311	0.0	4.8483977521341854
chr15	PEAK1	77365162	77365225	0	64	113021	23394	113021	23330	0.0	4.844449207029576
chr15	LINGO1	77677088	77677174	0	87	1020	5340	1020	5253	0.0	0.1941747572815534
chr15	CIB2	78105738	78105934	0	197	72	2145	72	1948	0.0	0.03696098562628337
chr15	CIB2	78111164	78111276	0	113	72	2145	72	2032	0.0	0.03543307086614173
chr15	CIB2	78123704	78123739	72	36	72	2145	0	2109	2.0	0.0
chr15	CIB2	78110655	78110733	0	79	72	2145	72	2066	0.0	0.03484995159728945
chr15	CIB2	78120567	78120661	0	95	72	2145	72	2050	0.0	0.0351219512195122
chr15	ACSBG1	78208001	78208102	0	102	2448	8170	2448	8068	0.0	0.3034209221616262
chr15	ACSBG1	78226454	78226605	0	152	2448	8170	2448	8018	0.0	0.3053130456472936
chr15	ACSBG1	78209144	78209249	0	106	2448	8170	2448	8064	0.0	0.30357142857142855
chr15	WDR61	78294945	78294973	58	29	31328	5010	31270	4981	2.0	6.277855852238506
chr15	WDR61	78288842	78288917	4968	76	31328	5010	26360	4934	65.36842105263158	5.342521280907985
chr15	CHRNA3	78593913	78594011	0	99	205	4771	205	4672	0.0	0.04387842465753425
chr15	CHRNB4	78628966	78629945	0	980	0	5003	0	4023	0.0	0.0
chr15	CHRNB4	78634621	78634739	0	119	0	5003	0	4884	0.0	0.0
chr15	CHRNB4	78652577	78652671	0	95	0	5003	0	4908	0.0	0.0
chr15	ADAMTS7	78767378	78767592	0	215	48613	6831	48613	6616	0.0	7.34779322853688
chr15	CTSH	78922992	78923118	0	127	136	11133	136	11006	0.0	0.01235689623841541
chr15	CTSH	78929411	78929493	0	83	136	11133	136	11050	0.0	0.012307692307692308
chr15	CTSH	78931868	78932038	0	171	136	11133	136	10962	0.0	0.012406495165115855
chr15	CTSH	78932371	78932458	0	88	136	11133	136	11045	0.0	0.01231326392032594
chr15	CTSH	78937317	78937423	0	107	136	11133	136	11026	0.0	0.01233448213313985
chr15	CTSH	78926174	78926254	0	81	136	11133	136	11052	0.0	0.012305465074194716
chr15	CTSH	78926781	78926830	0	50	136	11133	136	11083	0.0	0.012271045745736713
chr15	CTSH	78937317	78937496	0	180	136	11133	136	10953	0.0	0.012416689491463526
chr15	CTSH	78937685	78937792	0	108	136	11133	136	11025	0.0	0.012335600907029478
chr15	CTSH	78926781	78926939	0	159	136	11133	136	10974	0.0	0.012392928740659741
chr15	CTSH	78937685	78937823	0	139	136	11133	136	10994	0.0	0.012370383845734037
chr15	CTSH	78931900	78932038	0	139	136	11133	136	10994	0.0	0.012370383845734037
chr15	CTSH	78926562	78926684	0	123	136	11133	136	11010	0.0	0.012352406902815622
chr15	CTSH	78931868	78932041	0	174	136	11133	136	10959	0.0	0.012409891413450133
chr15	CTSH	78944537	78944631	0	95	136	11133	136	11038	0.0	0.012321072658090234
chr15	CTSH	78937034	78937185	0	152	136	11133	136	10981	0.0	0.01238502868591203
chr15	CTSH	78932275	78932458	0	184	136	11133	136	10949	0.0	0.01242122568271075
chr15	CTSH	78942840	78942930	0	91	136	11133	136	11042	0.0	0.012316609309907625
chr15	CTSH	78926781	78926868	0	88	136	11133	136	11045	0.0	0.01231326392032594
chr15	CTSH	78927367	78927436	0	70	136	11133	136	11063	0.0	0.012293229684534033
chr15	RASGRF1	79012488	79012527	0	40	531	9181	531	9141	0.0	0.058089924515917296
chr15	ANKRD34C-AS1	79260704	79260846	0	143	762076	10687	762076	10544	0.0	72.2757966616085
chr15	ANKRD34C-AS1	79213186	79213359	0	174	762076	10687	762076	10513	0.0	72.48891848187958
chr15	ANKRD34C-AS1	79260228	79260301	0	74	762076	10687	762076	10613	0.0	71.80589842645811
chr15	ANKRD34C-AS1	79260224	79260306	0	83	762076	10687	762076	10604	0.0	71.8668427008676
chr15	ANKRD34C-AS1	79260228	79260306	0	79	762076	10687	762076	10608	0.0	71.83974358974359
chr15	ST20-MTHFS	79907628	79907684	0	57	0	987	0	930	0.0	0.0
chr15	BCL2A1	79967636	79967692	0	57	51	839	51	782	0.0	0.06521739130434782
chr15	AC027808.2	80900829	80900965	0	137	51	749	51	612	0.0	0.08333333333333333
chr15	MESD	80952936	80953036	0	101	0	4448	0	4347	0.0	0.0
chr15	STARD5	81322898	81322948	0	51	4437	5447	4437	5396	0.0	0.8222757598220904
chr15	AC104041.1	81797923	81798044	0	122	4798	7188	4798	7066	0.0	0.6790263232380414
chr15	EFL1	82240417	82240555	0	139	714	4691	714	4552	0.0	0.15685413005272408
chr15	EFL1	82252690	82252775	0	86	714	4691	714	4605	0.0	0.15504885993485343
chr15	EFL1	82259087	82259155	0	69	714	4691	714	4622	0.0	0.15447858070099524
chr15	EFL1	82261985	82262348	0	364	714	4691	714	4327	0.0	0.1650103998151144
chr15	GOLGA2P10	82477837	82477926	0	90	94	1291	94	1201	0.0	0.07826810990840966
chr15	GOLGA2P10	82477202	82477298	0	97	94	1291	94	1194	0.0	0.07872696817420435
chr15	RPS17	82537921	82538042	0	122	0	1750	0	1628	0.0	0.0
chr15	RPS17	82539299	82539375	0	77	0	1750	0	1673	0.0	0.0
chr15	CPEB1	82557759	82557986	1670	228	9896	8139	8226	7911	7.324561403508772	1.0398179749715586
chr15	CPEB1	82583370	82583462	0	93	9896	8139	9896	8046	0.0	1.2299279144916728
chr15	AP3B2	82659844	82659983	0	140	1015751	8150	1015751	8010	0.0	126.8103620474407
chr15	AP3B2	82662693	82662922	0	230	1015751	8150	1015751	7920	0.0	128.2513888888889
chr15	AP3B2	82688735	82688831	0	97	1015751	8150	1015751	8053	0.0	126.1332422699615
chr15	AP3B2	82665246	82665303	0	58	1015751	8150	1015751	8092	0.0	125.52533366287692
chr15	AP3B2	82665859	82665984	0	126	1015751	8150	1015751	8024	0.0	126.58910767696909
chr15	AP3B2	82688019	82688096	132	78	1015751	8150	1015619	8072	1.6923076923076923	125.81999504459861
chr15	AP3B2	82689157	82689232	25	76	1015751	8150	1015726	8074	0.32894736842105265	125.80208075303443
chr15	AC105339.1	82711186	82711432	1275	247	5901	1228	4626	981	5.161943319838056	4.715596330275229
chr15	FSD2	82769749	82769884	0	136	23408	6550	23408	6414	0.0	3.6495166822575618
chr15	FSD2	82796249	82796366	21	118	23408	6550	23387	6432	0.17796610169491525	3.63603855721393
chr15	C15ORF40	83008547	83008675	0	129	4452	2219	4452	2090	0.0	2.1301435406698563
chr15	BTBD1	83020674	83020762	0	89	1682	4076	1682	3987	0.0	0.4218710810132932
chr15	BTBD1	83050072	83050178	0	107	1682	4076	1682	3969	0.0	0.4237843285462333
chr15	BTBD1	83028615	83028728	0	114	1682	4076	1682	3962	0.0	0.42453306410903585
chr15	HDGFL3	83192251	83192308	0	58	803456	16068	803456	16010	0.0	50.18463460337289
chr15	HDGFL3	83189360	83189516	18	157	803456	16068	803438	15911	0.11464968152866242	50.49575765193891
chr15	GOLGA2P7	84204599	84204691	0	93	0	3261	0	3168	0.0	0.0
chr15	GOLGA2P7	84204176	84204331	0	156	0	3261	0	3105	0.0	0.0
chr15	GOLGA2P7	84205230	84205319	0	90	0	3261	0	3171	0.0	0.0
chr15	UBE2Q2P1	84534179	84534238	0	60	150	2432	150	2372	0.0	0.06323777403035413
chr15	UBE2Q2P1	84539703	84539788	0	86	150	2432	150	2346	0.0	0.0639386189258312
chr15	AC048382.5	84606361	84606463	0	103	0	3673	0	3570	0.0	0.0
chr15	WDR73	84648536	84648625	0	90	51	8315	51	8225	0.0	0.006200607902735562
chr15	WDR73	84645972	84646085	0	114	51	8315	51	8201	0.0	0.006218753810510913
chr15	WDR73	84646689	84647023	0	335	51	8315	51	7980	0.0	0.006390977443609023
chr15	SEC11A	84670724	84670782	0	59	0	4847	0	4788	0.0	0.0
chr15	SEC11A	84687624	84687774	0	151	0	4847	0	4696	0.0	0.0
chr15	SEC11A	84679931	84679969	0	39	0	4847	0	4808	0.0	0.0
chr15	SEC11A	84680712	84680832	0	121	0	4847	0	4726	0.0	0.0
chr15	SEC11A	84714730	84714866	0	137	0	4847	0	4710	0.0	0.0
chr15	SEC11A	84679225	84679287	0	63	0	4847	0	4784	0.0	0.0
chr15	SEC11A	84691969	84692120	0	152	0	4847	0	4695	0.0	0.0
chr15	AC044860.1	85209829	85209918	0	90	140103	2932	140103	2842	0.0	49.29732582688248
chr15	KLHL25	85768016	85769820	102	1805	1132	7114	1030	5309	0.056509695290858725	0.19401017140704463
chr15	LINC01584	86088303	86088343	0	41	199	3080	199	3039	0.0	0.0654820664692333
chr15	LINC01584	86086249	86086373	0	125	199	3080	199	2955	0.0	0.06734348561759729
chr15	LINC01584	86109772	86109919	64	148	199	3080	135	2932	0.43243243243243246	0.04604365620736699
chr15	LINC01584	86111052	86111250	0	199	199	3080	199	2881	0.0	0.06907323845886845
chr15	LINC01584	86110442	86110539	0	98	199	3080	199	2982	0.0	0.06673373574782025
chr15	LINC01584	86109772	86109861	64	90	199	3080	135	2990	0.7111111111111111	0.0451505016722408
chr15	LINC01584	86087898	86087996	0	99	199	3080	199	2981	0.0	0.06675612210667561
chr15	LINC01584	86109772	86109874	64	103	199	3080	135	2977	0.6213592233009708	0.04534766543500168
chr15	AGBL1-AS1	86299735	86299881	0	147	7327	2445	7327	2298	0.0	3.188424717145344
chr15	AGBL1-AS1	86312131	86312382	5332	252	7327	2445	1995	2193	21.158730158730158	0.9097127222982216
chr15	AC020687.1	87429897	87429992	0	96	0	1553	0	1457	0.0	0.0
chr15	AC020687.1	87487601	87487663	0	63	0	1553	0	1490	0.0	0.0
chr15	AC020687.1	87542920	87542997	0	78	0	1553	0	1475	0.0	0.0
chr15	NTRK3	88126270	88126373	0	104	14586	25769	14586	25665	0.0	0.5683226183518411
chr15	NTRK3	88128710	88128734	0	25	14586	25769	14586	25744	0.0	0.5665786202610317
chr15	NTRK3	87885693	87885735	0	43	14586	25769	14586	25726	0.0	0.566975044701858
chr15	NTRK3	88135100	88135397	0	298	14586	25769	14586	25471	0.0	0.5726512504416787
chr15	NTRK3	87908488	87908563	0	76	14586	25769	14586	25693	0.0	0.5677032654808702
chr15	NTRK3	87925569	87925664	0	96	14586	25769	14586	25673	0.0	0.5681455225334009
chr15	NTRK3	87981225	87981360	0	136	14586	25769	14586	25633	0.0	0.5690321070495065
chr15	MRPL46	88460152	88460382	0	231	510	1223	510	992	0.0	0.5141129032258065
chr15	MRPL46	88465586	88465773	459	188	510	1223	51	1035	2.4414893617021276	0.04927536231884058
chr15	DET1	88527598	88527786	40	189	40	4789	0	4600	0.21164021164021163	0.0
chr15	DET1	88536311	88536381	0	71	40	4789	40	4718	0.0	0.00847816871555744
chr15	HAPLN3	88879417	88880610	0	1194	0	3496	0	2302	0.0	0.0
chr15	HAPLN3	88892973	88893112	0	140	0	3496	0	3356	0.0	0.0
chr15	HAPLN3	88879417	88879452	0	36	0	3496	0	3460	0.0	0.0
chr15	MFGE8	88899655	88899811	0	157	232	4651	232	4494	0.0	0.0516243880729862
chr15	MFGE8	88909791	88909923	0	133	232	4651	232	4518	0.0	0.051350154935812305
chr15	MFGE8	88912123	88912176	0	54	232	4651	232	4597	0.0	0.05046769632368936
chr15	POLG	89322741	89322902	0	162	29	6927	29	6765	0.0	0.004286770140428677
chr15	POLG	89323403	89323552	0	150	29	6927	29	6777	0.0	0.004279179577984358
chr15	POLG	89328455	89328535	0	81	29	6927	29	6846	0.0	0.004236050248320187
chr15	POLG	89332217	89332374	0	158	29	6927	29	6769	0.0	0.004284236962623726
chr15	POLG	89323403	89323511	0	109	29	6927	29	6818	0.0	0.004253446758580229
chr15	POLG	89317938	89318037	0	100	29	6927	29	6827	0.0	0.00424783946096382
chr15	POLG	89317938	89317975	0	38	29	6927	29	6889	0.0	0.004209609522427058
chr15	RHCG	89486270	89486529	0	260	0	2548	0	2288	0.0	0.0
chr15	LINC00928	89517283	89517437	0	155	0	2562	0	2407	0.0	0.0
chr15	LINC00928	89517401	89517437	0	37	0	2562	0	2525	0.0	0.0
chr15	PEX11A	89686430	89686546	0	117	0	1637	0	1520	0.0	0.0
chr15	ANPEP	89814113	89814294	332	182	34696	5070	34364	4888	1.8241758241758241	7.030278232405892
chr15	ARPIN-AP3S2	89903776	89903983	0	208	18717	2684	18717	2476	0.0	7.559369951534733
chr15	AP3S2	89877305	89877424	2461	120	27629	3566	25168	3446	20.508333333333333	7.303540336622171
chr15	AP3S2	89878264	89878300	0	37	27629	3566	27629	3529	0.0	7.829130065174271
chr15	IDH2	90084815	90084908	0	94	0	2799	0	2705	0.0	0.0
chr15	CIB1	90231683	90231788	102	106	1470	1480	1368	1374	0.9622641509433962	0.9956331877729258
chr15	HDDC3	90932428	90932806	699	379	12886	2622	12187	2243	1.8443271767810026	5.433348194382523
chr15	PRC1	90969078	90969120	0	43	15855	5528	15855	5485	0.0	2.8906107566089334
chr15	PRC1	90970403	90970514	0	112	15855	5528	15855	5416	0.0	2.927437223042836
chr15	PRC1	90981498	90981669	486	172	15855	5528	15369	5356	2.8255813953488373	2.86949215832711
chr15	PRC1	90984017	90984140	0	124	15855	5528	15855	5404	0.0	2.933937823834197
chr15	PRC1	90984692	90984825	8731	134	15855	5528	7124	5394	65.15671641791045	1.3207267334074897
chr15	VPS33B	91016962	91017024	3129	63	25854	3572	22725	3509	49.666666666666664	6.476204046736962
chr15	VPS33B	91017804	91017885	7051	82	25854	3572	18803	3490	85.98780487804878	5.387679083094556
chr15	H2AZ2P1	92724161	92724238	0	78	18151	2874	18151	2796	0.0	6.491773962804006
chr15	RGMA	93051992	93052507	0	516	109	12942	109	12426	0.0	0.008771929824561403
chr15	RGMA	93066100	93066255	0	156	109	12942	109	12786	0.0	0.008524949163147192
chr15	RGMA	93065831	93066259	0	429	109	12942	109	12513	0.0	0.008710940621753377
chr15	LINC01579	93801444	93801627	0	184	0	9355	0	9171	0.0	0.0
chr15	LINC01579	93900035	93900135	0	101	0	9355	0	9254	0.0	0.0
chr15	LINC01579	93897422	93897539	0	118	0	9355	0	9237	0.0	0.0
chr15	AC087633.1	95039431	95039523	0	93	0	1474	0	1381	0.0	0.0
chr15	AC087636.1	95147018	95147238	0	221	0	4475	0	4254	0.0	0.0
chr15	LINC01197	95289421	95289554	0	134	0	13078	0	12944	0.0	0.0
chr15	LINC01197	95212680	95212879	0	200	0	13078	0	12878	0.0	0.0
chr15	LINC01197	95307378	95307576	0	199	0	13078	0	12879	0.0	0.0
chr15	LINC01197	95260470	95260574	0	105	0	13078	0	12973	0.0	0.0
chr15	LINC01197	95257025	95257202	0	178	0	13078	0	12900	0.0	0.0
chr15	LINC01197	95278429	95278513	0	85	0	13078	0	12993	0.0	0.0
chr15	AC027013.1	95491498	95491549	0	52	0	1510	0	1458	0.0	0.0
chr15	AC027013.1	95469783	95469878	0	96	0	1510	0	1414	0.0	0.0
chr15	AC024337.1	96062683	96062756	0	74	0	1640	0	1566	0.0	0.0
chr15	NR2F2-AS1	96288663	96288755	0	93	0	6853	0	6760	0.0	0.0
chr15	AC087477.5	96402430	96402626	0	197	0	817	0	620	0.0	0.0
chr15	AC020704.1	97311971	97312050	0	80	0	727	0	647	0.0	0.0
chr15	LINC02254	97427650	97427767	0	118	0	5214	0	5096	0.0	0.0
chr15	LINC02254	97427650	97427770	0	121	0	5214	0	5093	0.0	0.0
chr15	LINC02254	97342146	97342322	0	177	0	5214	0	5037	0.0	0.0
chr15	LINC00923	97808991	97809081	45	91	45	13269	0	13178	0.4945054945054945	0.0
chr15	LINC00923	97758489	97758661	0	173	45	13269	45	13096	0.0	0.003436163714111179
chr15	LINC01582	98083833	98083900	0	68	0	2922	0	2854	0.0	0.0
chr15	FAM169B	98445994	98446128	0	135	61	4244	61	4109	0.0	0.01484546118276953
chr15	PGPEP1L	99001186	99001279	0	94	0	1634	0	1540	0.0	0.0
chr15	PGPEP1L	98998110	98998163	0	54	0	1634	0	1580	0.0	0.0
chr15	TTC23	99241364	99241559	0	196	1481	5136	1481	4940	0.0	0.2997975708502024
chr15	TTC23	99245388	99245510	28	123	1481	5136	1453	5013	0.22764227642276422	0.2898463993616597
chr15	TTC23	99234987	99235080	0	94	1481	5136	1481	5042	0.0	0.2937326457754859
chr15	TTC23	99249621	99249799	0	179	1481	5136	1481	4957	0.0	0.2987694169860803
chr15	TTC23	99249170	99249799	0	630	1481	5136	1481	4506	0.0	0.3286728806036396
chr15	TTC23	99234987	99235078	0	92	1481	5136	1481	5044	0.0	0.2936161776367962
chr15	LYSMD4	99731172	99731198	0	27	79	5573	79	5546	0.0	0.0142445005409304
chr15	LYSMD4	99732928	99733028	0	101	79	5573	79	5472	0.0	0.014437134502923976
chr15	LYSMD4	99731357	99731422	0	66	79	5573	79	5507	0.0	0.014345378609043035
chr15	LYSMD4	99731357	99731407	0	51	79	5573	79	5522	0.0	0.01430641072075335
chr15	DNM1P46	99804799	99804929	0	131	276836	3985	276836	3854	0.0	71.8308251167618
chr15	ADAMTS17	100341038	100341409	612	372	15643	6863	15031	6491	1.6451612903225807	2.3156678477892467
chr15	ADAMTS17	100063678	100063759	0	82	15643	6863	15643	6781	0.0	2.306886889839257
chr15	CERS3	100528812	100529075	0	264	227	5147	227	4883	0.0	0.04648781486790907
chr15	CERS3	100503709	100503848	0	140	227	5147	227	5007	0.0	0.04533652885959656
chr15	LINS1	100586223	100586332	0	110	102	7512	102	7402	0.0	0.013780059443393677
chr15	AC015712.2	100917887	100918213	0	327	0	7703	0	7376	0.0	0.0
chr15	CHSY1	101187992	101188219	0	228	6200	5408	6200	5180	0.0	1.196911196911197
chr15	SNRPA1	101286213	101286293	0	81	0	2337	0	2256	0.0	0.0
chr15	SNRPA1	101287655	101287702	0	48	0	2337	0	2289	0.0	0.0
chr15	SNRPA1	101293292	101293393	0	102	0	2337	0	2235	0.0	0.0
chr15	PCSK6	101313375	101313505	0	131	16240	16686	16240	16555	0.0	0.9809725158562368
chr15	PCSK6	101366195	101366332	0	138	16240	16686	16240	16548	0.0	0.9813874788494078
chr15	PCSK6	101331650	101331689	36	40	16240	16686	16204	16646	0.9	0.9734470743722216
chr15	PCSK6	101305105	101305355	0	251	16240	16686	16240	16435	0.0	0.988135077578339
chr15	PCSK6	101431319	101431463	1662	145	16240	16686	14578	16541	11.462068965517242	0.8813251919472825
chr15	PCSK6	101364998	101365044	0	47	16240	16686	16240	16639	0.0	0.9760201935212452
chr15	TM2D3	101651695	101651773	0	79	1122	11588	1122	11509	0.0	0.09748892171344166
chr15	TARS3	101657784	101657857	0	74	5644	4478	5644	4404	0.0	1.2815622161671207
chr15	TARS3	101699330	101699435	0	106	5644	4478	5644	4372	0.0	1.2909423604757548
chr15	TARS3	101655866	101656020	0	155	5644	4478	5644	4323	0.0	1.3055748322923895
chr16	SNRNP25	56320	56420	0	101	0	1293	0	1192	0.0	0.0
chr16	MPG	79138	79331	438	194	4963	1503	4525	1309	2.2577319587628866	3.4568372803666922
chr16	FAM234A	259482	259599	961	118	45819	5109	44858	4991	8.14406779661017	8.987778000400722
chr16	FAM234A	264015	264171	255	157	45819	5109	45564	4952	1.624203821656051	9.20113085621971
chr16	FAM234A	264810	264908	224	99	45819	5109	45595	5010	2.2626262626262625	9.100798403193613
chr16	FAM234A	253832	253929	0	98	45819	5109	45819	5011	0.0	9.143683895430053
chr16	FAM234A	246956	247069	0	114	45819	5109	45819	4995	0.0	9.172972972972973
chr16	FAM234A	248243	248397	198	155	45819	5109	45621	4954	1.2774193548387096	9.208922083165119
chr16	ARHGDIG	281745	281925	2272	181	22352	1855	20080	1674	12.552486187845304	11.995221027479092
chr16	NME4	399378	399480	675	103	47153	3175	46478	3072	6.553398058252427	15.129557291666666
chr16	NME4	398207	398385	0	179	47153	3175	47153	2996	0.0	15.738651535380507
chr16	NME4	398207	398394	0	188	47153	3175	47153	2987	0.0	15.786072982926013
chr16	DECR2	406684	406777	0	94	459	2636	459	2542	0.0	0.18056648308418569
chr16	NME4	397878	397902	25	25	47153	3175	47128	3150	1.0	14.961269841269841
chr16	DECR2	411360	411578	0	219	459	2636	459	2417	0.0	0.18990484071162597
chr16	DECR2	405512	405665	0	154	459	2636	459	2482	0.0	0.18493150684931506
chr16	DECR2	407424	407560	0	137	459	2636	459	2499	0.0	0.1836734693877551
chr16	DECR2	406684	406952	0	269	459	2636	459	2367	0.0	0.19391634980988592
chr16	RAB11FIP3	491133	491268	0	136	113579	6050	113579	5914	0.0	19.205106526885356
chr16	CAPN15	536028	536142	0	115	103325	8004	103325	7889	0.0	13.097350741538852
chr16	PIGQ	578784	578938	83	155	22332	6456	22249	6301	0.535483870967742	3.5310268211395015
chr16	PIGQ	580182	580263	100	82	22332	6456	22232	6374	1.2195121951219512	3.487919673674302
chr16	PIGQ	580857	580972	40	116	22332	6456	22292	6340	0.3448275862068966	3.5160883280757096
chr16	PIGQ	582247	582309	197	63	22332	6456	22135	6393	3.126984126984127	3.4623807289222586
chr16	PIGQ	570647	570760	7877	114	22332	6456	14455	6342	69.09649122807018	2.2792494481236205
chr16	PIGQ	574527	574763	239	237	22332	6456	22093	6219	1.0084388185654007	3.5525004019938895
chr16	PIGQ	581198	581341	72	144	22332	6456	22260	6312	0.5	3.526615969581749
chr16	RAB40C	618199	618260	0	62	85820	3905	85820	3843	0.0	22.33151183970856
chr16	RAB40C	625036	625242	306	207	85820	3905	85514	3698	1.4782608695652173	23.12439156300703
chr16	RAB40C	596316	596448	2982	133	85820	3905	82838	3772	22.42105263157895	21.961293743372217
chr16	MCRIP2	647416	647544	307	129	11949	2777	11642	2648	2.37984496124031	4.396525679758308
chr16	MCRIP2	646471	646608	0	138	11949	2777	11949	2639	0.0	4.527851458885942
chr16	WDR90	660057	660161	54	105	31625	10446	31571	10341	0.5142857142857142	3.0529929407214
chr16	WDR90	662672	662844	1096	173	31625	10446	30529	10273	6.335260115606936	2.971770660955904
chr16	WDR90	666454	666598	0	145	31625	10446	31625	10301	0.0	3.070090282496845
chr16	WDR90	666904	666989	17	86	31625	10446	31608	10360	0.19767441860465115	3.050965250965251
chr16	WDR90	662678	662844	1036	167	31625	10446	30589	10279	6.203592814371257	2.9758731394104485
chr16	RHOT2	668487	668569	153	83	11678	4192	11525	4109	1.8433734939759037	2.804818690678997
chr16	RHOT2	669552	669606	110	55	11678	4192	11568	4137	2.0	2.7962291515591007
chr16	RHOT2	670674	670773	0	100	11678	4192	11678	4092	0.0	2.85386119257087
chr16	RHOT2	670695	670773	0	79	11678	4192	11678	4113	0.0	2.839290055920253
chr16	RHBDL1	676671	676896	0	226	37030	1727	37030	1501	0.0	24.670219853431046
chr16	ANTKMT	722083	722134	26957	52	233021	1398	206064	1346	518.4038461538462	153.09361069836552
chr16	HAGHL	727964	728029	93	66	218775	4949	218682	4883	1.4090909090909092	44.784353880810976
chr16	HAGHL	728315	728604	0	290	218775	4949	218775	4659	0.0	46.957501609787506
chr16	CHTF18	791850	791948	0	99	11477	4621	11477	4522	0.0	2.5380362671384344
chr16	CHTF18	790006	790081	0	76	11477	4621	11477	4545	0.0	2.525192519251925
chr16	CHTF18	792223	792347	323	125	11477	4621	11154	4496	2.584	2.4808718861209966
chr16	LMF1-AS1	933100	933255	0	156	787	1451	787	1295	0.0	0.6077220077220077
chr16	CACNA1H	1212510	1212528	0	19	0	8655	0	8636	0.0	0.0
chr16	UBE2I	1314292	1314376	0	85	0	8510	0	8425	0.0	0.0
chr16	UBE2I	1312346	1312603	0	258	0	8510	0	8252	0.0	0.0
chr16	UBE2I	1314019	1314096	0	78	0	8510	0	8432	0.0	0.0
chr16	UBE2I	1312346	1312667	0	322	0	8510	0	8188	0.0	0.0
chr16	UBE2I	1312346	1312558	0	213	0	8510	0	8297	0.0	0.0
chr16	UBE2I	1319701	1319862	0	162	0	8510	0	8348	0.0	0.0
chr16	BAIAP3	1342526	1342634	0	109	89	6110	89	6001	0.0	0.014830861523079487
chr16	BAIAP3	1346846	1346955	0	110	89	6110	89	6000	0.0	0.014833333333333334
chr16	BAIAP3	1346933	1346955	0	23	89	6110	89	6087	0.0	0.014621324133399047
chr16	GNPTG	1357699	1357832	0	134	174725	2982	174725	2848	0.0	61.350070224719104
chr16	GNPTG	1361742	1361797	670	56	174725	2982	174055	2926	11.964285714285714	59.485645933014354
chr16	TELO2	1502644	1502761	783	118	147139	4075	146356	3957	6.635593220338983	36.98660601465757
chr16	CRAMP1	1662760	1662835	0	76	26493	8617	26493	8541	0.0	3.101861608710924
chr16	CRAMP1	1666072	1666177	663	106	26493	8617	25830	8511	6.254716981132075	3.034896016919281
chr16	CRAMP1	1667334	1667400	0	67	26493	8617	26493	8550	0.0	3.0985964912280703
chr16	JPT2	1685438	1685587	0	150	9604	3868	9604	3718	0.0	2.5831091984938137
chr16	JPT2	1683508	1683592	0	85	9604	3868	9604	3783	0.0	2.5387258789320644
chr16	JPT2	1691842	1691985	362	144	9604	3868	9242	3724	2.513888888888889	2.4817400644468313
chr16	JPT2	1683508	1683620	0	113	9604	3868	9604	3755	0.0	2.5576564580559253
chr16	MAPK8IP3	1758977	1758995	0	19	14390	7888	14390	7869	0.0	1.8286948786376922
chr16	MAPK8IP3	1740694	1740718	0	25	14390	7888	14390	7863	0.0	1.830090296324558
chr16	NUBP2	1786756	1786955	309	200	14368	3124	14059	2924	1.545	4.808139534883721
chr16	NUBP2	1786737	1786955	729	219	14368	3124	13639	2905	3.328767123287671	4.69500860585198
chr16	NUBP2	1783876	1784066	918	191	14368	3124	13450	2933	4.806282722513089	4.585748380497784
chr16	NUBP2	1785638	1785902	3878	265	14368	3124	10490	2859	14.633962264150943	3.6691150752011192
chr16	FAHD1	1838015	1838134	13297	120	120042	3016	106745	2896	110.80833333333334	36.85946132596685
chr16	GFER	1984746	1984943	0	198	8674	2703	8674	2505	0.0	3.462674650698603
chr16	SYNGR3	1990498	1990672	153	175	22442	2313	22289	2138	0.8742857142857143	10.425163704396633
chr16	TSC2	2048586	2048753	11856	168	112940	14665	101084	14497	70.57142857142857	6.972752983375871
chr16	TSC2	2060952	2061039	0	88	112940	14665	112940	14577	0.0	7.7478219112300195
chr16	TSC2	2062971	2063053	0	83	112940	14665	112940	14582	0.0	7.745165272253463
chr16	TSC2	2053341	2053452	0	112	112940	14665	112940	14553	0.0	7.760599189170618
chr16	TSC2	2077597	2077726	63	130	112940	14665	112877	14535	0.4846153846153846	7.765875472996216
chr16	TSC2	2068557	2068776	0	220	112940	14665	112940	14445	0.0	7.818622360678435
chr16	TSC2	2082435	2082504	0	70	112940	14665	112940	14595	0.0	7.738266529633436
chr16	RAB26	2151129	2151315	51	187	65525	2395	65474	2208	0.2727272727272727	29.653079710144926
chr16	MLST8	2207034	2207110	0	77	52567	3668	52567	3591	0.0	14.638540796435533
chr16	MLST8	2208209	2208334	0	126	52567	3668	52567	3542	0.0	14.841050254093732
chr16	MLST8	2206742	2206929	0	188	52567	3668	52567	3480	0.0	15.105459770114942
chr16	MLST8	2207856	2208024	44	169	52567	3668	52523	3499	0.2603550295857988	15.01086024578451
chr16	AC009065.4	2271675	2271891	0	217	0	984	0	767	0.0	0.0
chr16	ABCA17P	2375342	2375455	0	114	1484	6345	1484	6231	0.0	0.23816401861659445
chr16	ABCA17P	2412277	2412397	0	121	1484	6345	1484	6224	0.0	0.2384318766066838
chr16	ABCA17P	2424158	2424335	51	178	1484	6345	1433	6167	0.28651685393258425	0.23236581806388845
chr16	CCNF	2432960	2433067	0	108	720	5549	720	5441	0.0	0.13232861606322366
chr16	TEDC2	2460282	2460381	0	100	231	2854	231	2754	0.0	0.08387799564270153
chr16	TEDC2	2460815	2461224	0	410	231	2854	231	2444	0.0	0.09451718494271685
chr16	TBC1D24	2499356	2499420	22099	65	734856	11559	712757	11494	339.9846153846154	62.011223246911435
chr16	TBC1D24	2497709	2497727	132	19	734856	11559	734724	11540	6.947368421052632	63.66759098786829
chr16	AMDHD2	2527560	2527615	162	56	8096	3044	7934	2988	2.892857142857143	2.6552878179384205
chr16	AMDHD2	2527772	2527985	247	214	8096	3044	7849	2830	1.1542056074766356	2.773498233215548
chr16	AMDHD2	2520768	2520905	0	138	8096	3044	8096	2906	0.0	2.7859600825877493
chr16	AMDHD2	2528649	2528718	102	70	8096	3044	7994	2974	1.457142857142857	2.6879623402824477
chr16	AMDHD2	2527572	2527615	102	44	8096	3044	7994	3000	2.3181818181818183	2.6646666666666667
chr16	PDPK1	2538501	2538771	0	271	36821	8690	36821	8419	0.0	4.373559805202518
chr16	PDPK1	2538618	2538771	0	154	36821	8690	36821	8536	0.0	4.313612933458295
chr16	AC141586.1	2610461	2611052	10981	592	21486	2755	10505	2163	18.548986486486488	4.8566805362921865
chr16	KCTD5	2697905	2697997	918	93	28068	3381	27150	3288	9.870967741935484	8.257299270072993
chr16	SRRM2	2756333	2756606	0	274	122789	11355	122789	11081	0.0	11.081039617363054
chr16	SRRM2	2768504	2768599	0	96	122789	11355	122789	11259	0.0	10.905853095301536
chr16	FLYWCH2	2895219	2895320	0	102	51	1343	51	1241	0.0	0.0410958904109589
chr16	FLYWCH1	2913005	2913250	0	246	31306	6621	31306	6375	0.0	4.910745098039215
chr16	FLYWCH1	2928823	2928917	0	95	31306	6621	31306	6526	0.0	4.797119215445909
chr16	FLYWCH1	2936331	2936425	0	95	31306	6621	31306	6526	0.0	4.797119215445909
chr16	FLYWCH1	2934614	2934667	0	54	31306	6621	31306	6567	0.0	4.767169179229481
chr16	KREMEN2	2967525	2967604	0	80	7140	2270	7140	2190	0.0	3.26027397260274
chr16	PAQR4	2971273	2971378	0	106	1938	2874	1938	2768	0.0	0.7001445086705202
chr16	PAQR4	2971156	2971378	102	223	1938	2874	1836	2651	0.45739910313901344	0.6925688419464353
chr16	LINC00514	2989973	2990006	250	34	34134	4466	33884	4432	7.352941176470588	7.6453068592057765
chr16	LINC00514	2990454	2990487	0	34	34134	4466	34134	4432	0.0	7.7017148014440435
chr16	TNFRSF12A	3021188	3021319	11692	132	146947	1406	135255	1274	88.57575757575758	106.16562009419152
chr16	TNFRSF12A	3021214	3021319	8964	106	146947	1406	137983	1300	84.56603773584905	106.14076923076924
chr16	THOC6	3027365	3027500	4489	136	99189	1743	94700	1607	33.00735294117647	58.929682638456754
chr16	IL32	3065783	3065826	0	44	459	2993	459	2949	0.0	0.15564598168870802
chr16	IL32	3067553	3067613	0	61	459	2993	459	2932	0.0	0.15654843110504774
chr16	IL32	3067983	3068010	0	28	459	2993	459	2965	0.0	0.1548060708263069
chr16	IL32	3068179	3068239	0	61	459	2993	459	2932	0.0	0.15654843110504774
chr16	IL32	3065780	3065826	0	47	459	2993	459	2946	0.0	0.15580448065173116
chr16	IL32	3065641	3065687	0	47	459	2993	459	2946	0.0	0.15580448065173116
chr16	IL32	3065620	3065687	0	68	459	2993	459	2925	0.0	0.15692307692307692
chr16	ZNF205	3118904	3119015	598	112	9357	2337	8759	2225	5.339285714285714	3.936629213483146
chr16	ZNF213	3138744	3138818	0	75	51	3717	51	3642	0.0	0.01400329489291598
chr16	ZNF213	3138974	3139098	0	125	51	3717	51	3592	0.0	0.014198218262806235
chr16	CASP16P	3144452	3144647	0	196	0	3549	0	3353	0.0	0.0
chr16	ZNF263	3285058	3285239	1747	182	15712	6076	13965	5894	9.598901098901099	2.369358669833729
chr16	ZNF263	3285680	3285754	0	75	15712	6076	15712	6001	0.0	2.6182302949508416
chr16	ZNF263	3288453	3288570	0	118	15712	6076	15712	5958	0.0	2.6371265525344074
chr16	ZNF75A	3308312	3308836	0	525	2883	4348	2883	3823	0.0	0.7541198012032435
chr16	ZNF75A	3313048	3313175	0	128	2883	4348	2883	4220	0.0	0.683175355450237
chr16	NAA60	3476221	3476337	0	117	23096	6190	23096	6073	0.0	3.8030627367034415
chr16	NAA60	3447481	3447620	16723	140	23096	6190	6373	6050	119.45	1.0533884297520661
chr16	NAA60	3479470	3479600	0	131	23096	6190	23096	6059	0.0	3.8118501402871763
chr16	NAA60	3482501	3482598	0	98	23096	6190	23096	6092	0.0	3.7912015758371633
chr16	NAA60	3448470	3448540	714	71	23096	6190	22382	6119	10.056338028169014	3.6577872201340087
chr16	NAA60	3456809	3456916	0	108	23096	6190	23096	6082	0.0	3.7974350542584676
chr16	CLUAP1	3508288	3508468	0	181	69480	4556	69480	4375	0.0	15.881142857142857
chr16	NAA60	3472158	3472385	0	228	23096	6190	23096	5962	0.0	3.873867829587387
chr16	NAA60	3462597	3462683	6	87	23096	6190	23090	6103	0.06896551724137931	3.783385220383418
chr16	CLUAP1	3504719	3504831	0	113	69480	4556	69480	4443	0.0	15.63808237677245
chr16	CLUAP1	3506330	3506415	0	86	69480	4556	69480	4470	0.0	15.543624161073826
chr16	CLUAP1	3526411	3526484	53	74	69480	4556	69427	4482	0.7162162162162162	15.490182954038376
chr16	CLUAP1	3533098	3533155	609	58	69480	4556	68871	4498	10.5	15.31147176522899
chr16	DNASE1	3651316	3651921	18694	606	86877	8622	68183	8016	30.848184818481847	8.505863273453095
chr16	DNASE1	3655848	3655966	0	119	86877	8622	86877	8503	0.0	10.217217452663766
chr16	DNASE1	3656998	3657111	36	114	86877	8622	86841	8508	0.3157894736842105	10.206981664315938
chr16	DNASE1	3655848	3655937	0	90	86877	8622	86877	8532	0.0	10.182489451476794
chr16	DNASE1	3656963	3657111	377	149	86877	8622	86500	8473	2.530201342281879	10.208898855187066
chr16	DNAJA3	4434383	4434517	1280	135	27734	5966	26454	5831	9.481481481481481	4.53678614302864
chr16	DNAJA3	4441374	4441575	0	202	27734	5966	27734	5764	0.0	4.811589174184594
chr16	DNAJA3	4431598	4431672	1392	75	27734	5966	26342	5891	18.56	4.471566796808691
chr16	DNAJA3	4454810	4454927	0	118	27734	5966	27734	5848	0.0	4.742476060191518
chr16	HMOX2	4483636	4483754	13	119	51530	3349	51517	3230	0.1092436974789916	15.94953560371517
chr16	HMOX2	4488643	4488742	0	100	51530	3349	51530	3249	0.0	15.860264696829793
chr16	HMOX2	4505483	4505610	36612	128	51530	3349	14918	3221	286.03125	4.6314809065507605
chr16	HMOX2	4483636	4483738	0	103	51530	3349	51530	3246	0.0	15.874922982131855
chr16	HMOX2	4502743	4502959	204	217	51530	3349	51326	3132	0.9400921658986175	16.387611749680715
chr16	MGRN1	4677462	4677572	0	111	15088	6231	15088	6120	0.0	2.465359477124183
chr16	MGRN1	4680031	4680097	0	67	15088	6231	15088	6164	0.0	2.4477611940298507
chr16	MGRN1	4672399	4672516	0	118	15088	6231	15088	6113	0.0	2.4681825617536397
chr16	MGRN1	4686258	4686303	0	46	15088	6231	15088	6185	0.0	2.439450282942603
chr16	UBN1	4868832	4868903	152	72	107762	7647	107610	7575	2.111111111111111	14.205940594059406
chr16	UBN1	4871154	4871301	8	148	107762	7647	107754	7499	0.05405405405405406	14.369115882117615
chr16	UBN1	4877384	4877474	102	91	107762	7647	107660	7556	1.120879120879121	14.248279512969825
chr16	RBFOX1	7579776	7579920	51	145	51	14371	0	14226	0.35172413793103446	0.0
chr16	RBFOX1	7587246	7587300	0	55	51	14371	51	14316	0.0	0.003562447611064543
chr16	RBFOX1	7595548	7595641	0	94	51	14371	51	14277	0.0	0.0035721790292078167
chr16	RBFOX1	7630602	7630683	0	82	51	14371	51	14289	0.0	0.003569179088809574
chr16	RBFOX1	7664928	7664968	0	41	51	14371	51	14330	0.0	0.003558967201674808
chr16	RBFOX1	7693314	7693367	0	54	51	14371	51	14317	0.0	0.0035621987846615913
chr16	RBFOX1	7579779	7579920	51	142	51	14371	0	14229	0.3591549295774648	0.0
chr16	RBFOX1	6775732	6776011	0	280	51	14371	51	14091	0.0	0.003619331488183947
chr16	RBFOX1	6876661	6876743	0	83	51	14371	51	14288	0.0	0.00356942889137738
chr16	RBFOX1	7671556	7671599	0	44	51	14371	51	14327	0.0	0.0035597124310741955
chr16	METTL22	8623756	8623895	0	140	108	7747	108	7607	0.0	0.014197449717365584
chr16	METTL22	8635038	8635079	6	42	108	7747	102	7705	0.14285714285714285	0.013238157040882544
chr16	METTL22	8623852	8624118	0	267	108	7747	108	7480	0.0	0.014438502673796792
chr16	METTL22	8641402	8641445	0	44	108	7747	108	7703	0.0	0.014020511489030248
chr16	ABAT	8722766	8722842	5073	77	65715	9737	60642	9660	65.88311688311688	6.277639751552795
chr16	ABAT	8746000	8746098	0	99	65715	9737	65715	9638	0.0	6.818323303589956
chr16	ABAT	8738442	8738454	954	13	65715	9737	64761	9724	73.38461538461539	6.659913615795968
chr16	ABAT	8757194	8757310	0	117	65715	9737	65715	9620	0.0	6.831081081081081
chr16	PMM2	8804766	8804843	0	78	0	4133	0	4055	0.0	0.0
chr16	PMM2	8811078	8811178	0	101	0	4133	0	4032	0.0	0.0
chr16	PMM2	8806315	8806407	0	93	0	4133	0	4040	0.0	0.0
chr16	PMM2	8802260	8802389	0	130	0	4133	0	4003	0.0	0.0
chr16	LINC02177	9385373	9385465	0	93	0	5834	0	5741	0.0	0.0
chr16	LINC02177	9389665	9389873	0	209	0	5834	0	5625	0.0	0.0
chr16	LINC02177	9402623	9402746	0	124	0	5834	0	5710	0.0	0.0
chr16	AC012178.1	9501491	9501611	0	121	0	4432	0	4311	0.0	0.0
chr16	AC012178.1	9517455	9517524	0	70	0	4432	0	4362	0.0	0.0
chr16	AC012178.1	9501723	9501787	0	65	0	4432	0	4367	0.0	0.0
chr16	ATF7IP2	10419580	10419623	0	44	51	5287	51	5243	0.0	0.009727255388136563
chr16	ATF7IP2	10457371	10457529	0	159	51	5287	51	5128	0.0	0.009945397815912636
chr16	ATF7IP2	10473922	10473989	0	68	51	5287	51	5219	0.0	0.009771986970684038
chr16	ATF7IP2	10414573	10414612	0	40	51	5287	51	5247	0.0	0.009719839908519153
chr16	ATF7IP2	10428867	10429016	0	150	51	5287	51	5137	0.0	0.009927973525403932
chr16	ATF7IP2	10472109	10472183	0	75	51	5287	51	5212	0.0	0.009785111281657714
chr16	NUBP1	10752609	10752678	0	70	0	1968	0	1898	0.0	0.0
chr16	NUBP1	10755720	10755753	0	34	0	1968	0	1934	0.0	0.0
chr16	NUBP1	10761756	10761859	0	104	0	1968	0	1864	0.0	0.0
chr16	NUBP1	10767948	10768032	0	85	0	1968	0	1883	0.0	0.0
chr16	NUBP1	10756689	10756780	0	92	0	1968	0	1876	0.0	0.0
chr16	CIITA	10902037	10902184	0	148	51	11180	51	11032	0.0	0.00462291515591008
chr16	CIITA	10908982	10909187	0	206	51	11180	51	10974	0.0	0.004647348277747403
chr16	CIITA	10901797	10902184	0	388	51	11180	51	10792	0.0	0.004725722757598221
chr16	CLEC16A	10972553	10972559	0	7	13299	11576	13299	11569	0.0	1.149537557265105
chr16	CLEC16A	11156573	11156682	0	110	13299	11576	13299	11466	0.0	1.1598639455782314
chr16	CLEC16A	11174153	11174277	0	125	13299	11576	13299	11451	0.0	1.1613832853025936
chr16	TNFRSF17	11966194	11966341	11036	148	18483	1019	7447	871	74.56756756756756	8.549942594718715
chr16	TNFRSF17	11967019	11967143	618	125	18483	1019	17865	894	4.944	19.983221476510067
chr16	SNX29	12029612	12029734	0	123	6722	11326	6722	11203	0.0	0.6000178523609747
chr16	SHISA9	13213252	13213300	0	49	51	10188	51	10139	0.0	0.005030081862116579
chr16	U91319.1	13552392	13552550	561	159	561	3219	0	3060	3.5283018867924527	0.0
chr16	U91319.1	13258332	13258435	0	104	561	3219	561	3115	0.0	0.18009630818619582
chr16	ERCC4	13943973	13944095	0	123	89	8348	89	8225	0.0	0.01082066869300912
chr16	MRTFB	14092720	14092882	0	163	1492	15184	1492	15021	0.0	0.09932760801544505
chr16	MIR193BHG	14325550	14325590	0	41	3194	6057	3194	6016	0.0	0.5309175531914894
chr16	MIR193BHG	14323296	14323383	0	88	3194	6057	3194	5969	0.0	0.5350980063662255
chr16	MIR193BHG	14323224	14323383	0	160	3194	6057	3194	5897	0.0	0.5416313379684585
chr16	MIR193BHG	14325554	14325590	0	37	3194	6057	3194	6020	0.0	0.5305647840531561
chr16	MIR193BHG	14322967	14323061	0	95	3194	6057	3194	5962	0.0	0.5357262663535727
chr16	BFAR	14655065	14655210	0	146	72	3298	72	3152	0.0	0.02284263959390863
chr16	BFAR	14648387	14648592	0	206	72	3298	72	3092	0.0	0.02328589909443726
chr16	BFAR	14649803	14649973	0	171	72	3298	72	3127	0.0	0.023025263831148064
chr16	NOMO1	14846576	14846683	0	108	9750	5532	9750	5424	0.0	1.7975663716814159
chr16	NPIPA1	14925100	14925189	0	90	36362	7367	36362	7277	0.0	4.996839356877834
chr16	PDXDC1	15001775	15001856	0	82	88641	9435	88641	9353	0.0	9.47728001710681
chr16	PDXDC1	15008778	15008847	545	70	88641	9435	88096	9365	7.785714285714286	9.406940736785906
chr16	PDXDC1	14974886	14974973	28	88	88641	9435	88613	9347	0.3181818181818182	9.480368032523804
chr16	PDXDC1	15004186	15004333	16	148	88641	9435	88625	9287	0.10810810810810811	9.542909443307849
chr16	PDXDC1	15001775	15001887	0	113	88641	9435	88641	9322	0.0	9.508796395623257
chr16	MPV17L	15400786	15400857	0	72	0	6017	0	5945	0.0	0.0
chr16	MPV17L	15399430	15399548	0	119	0	6017	0	5898	0.0	0.0
chr16	AC140504.1	15434394	15434759	0	366	0	1057	0	691	0.0	0.0
chr16	BMERB1	15447934	15448032	0	99	657	3385	657	3286	0.0	0.19993913572732805
chr16	BMERB1	15532986	15533135	0	150	657	3385	657	3235	0.0	0.20309119010819165
chr16	BMERB1	15583155	15583238	0	84	657	3385	657	3301	0.0	0.19903059678885188
chr16	NDE1	15649347	15649469	0	123	11014	8104	11014	7981	0.0	1.3800275654679866
chr16	NDE1	15687374	15687511	0	138	11014	8104	11014	7966	0.0	1.3826261611850363
chr16	NDE1	15694164	15694256	0	93	11014	8104	11014	8011	0.0	1.3748595680938709
chr16	NDE1	15696708	15696860	408	153	11014	8104	10606	7951	2.6666666666666665	1.3339202616023143
chr16	NDE1	15672689	15672771	0	83	11014	8104	11014	8021	0.0	1.3731454930806632
chr16	NDE1	15651468	15651584	0	117	11014	8104	11014	7987	0.0	1.37899086014774
chr16	NDE1	15651930	15652050	0	121	11014	8104	11014	7983	0.0	1.379681823875736
chr16	NDE1	15695907	15695990	1084	84	11014	8104	9930	8020	12.904761904761905	1.2381546134663342
chr16	NDE1	15699728	15699854	0	127	11014	8104	11014	7977	0.0	1.3807195687601854
chr16	ABCC1	16016495	16016621	0	127	52407	8561	52407	8434	0.0	6.213777566990752
chr16	ABCC1	16083365	16083542	0	178	52407	8561	52407	8383	0.0	6.251580579744721
chr16	ABCC1	16086823	16086991	0	169	52407	8561	52407	8392	0.0	6.244876072449952
chr16	ABCC1	16098872	16098902	0	31	52407	8561	52407	8530	0.0	6.143845252051583
chr16	ABCC1	16138363	16138558	36840	196	52407	8561	15567	8365	187.9591836734694	1.8609683203825462
chr16	ABCC1	16105399	16105460	0	62	52407	8561	52407	8499	0.0	6.166254853512178
chr16	NOMO3	16245067	16245174	0	108	24287	10120	24287	10012	0.0	2.4257890531362367
chr16	NOMO3	16251962	16252100	0	139	24287	10120	24287	9981	0.0	2.4333233142971644
chr16	NOMO3	16287742	16287862	0	121	24287	10120	24287	9999	0.0	2.428942894289429
chr16	NOMO3	16293651	16293744	0	94	24287	10120	24287	10026	0.0	2.4224017554358666
chr16	NOMO3	16254943	16255013	0	71	24287	10120	24287	10049	0.0	2.416857398746144
chr16	NOMO3	16235842	16236020	22234	179	24287	10120	2053	9941	124.2122905027933	0.20651845890755458
chr16	NOMO3	16247394	16247467	0	74	24287	10120	24287	10046	0.0	2.4175791359745173
chr16	NOMO3	16248107	16248363	99	257	24287	10120	24188	9863	0.3852140077821012	2.45239785055257
chr16	NOMO3	16266596	16266655	0	60	24287	10120	24287	10060	0.0	2.414214711729622
chr16	NOMO3	16293959	16294081	0	123	24287	10120	24287	9997	0.0	2.4294288286485948
chr16	AC138969.1	16318513	16318734	0	222	32110	7438	32110	7216	0.0	4.449833702882484
chr16	AC138969.1	16323751	16323848	0	98	32110	7438	32110	7340	0.0	4.374659400544959
chr16	AC138969.1	16318550	16318734	0	185	32110	7438	32110	7253	0.0	4.427133599889701
chr16	AC138969.1	16322527	16322551	0	25	32110	7438	32110	7413	0.0	4.331579657358694
chr16	AC138969.1	16335860	16335992	127	133	32110	7438	31983	7305	0.9548872180451128	4.3782340862422995
chr16	AC138969.1	16349228	16349298	0	71	32110	7438	32110	7367	0.0	4.358626306501968
chr16	NPIPA7	16392592	16392662	40	71	117861	1410	117821	1339	0.5633802816901409	87.99178491411502
chr16	ABCC6P1	18574319	18574435	0	117	40199	3328	40199	3211	0.0	12.519152911865463
chr16	COQ7	19073920	19074035	2467	116	6999	3599	4532	3483	21.267241379310345	1.3011771461383865
chr16	COQ7	19073920	19074097	3726	178	6999	3599	3273	3421	20.93258426966292	0.9567377959660918
chr16	SYT17	19172759	19172777	0	19	867	4839	867	4820	0.0	0.17987551867219917
chr16	CLEC19A	19303871	19303975	0	105	51	3419	51	3314	0.0	0.015389257694628847
chr16	TMC5	19487192	19487326	51	135	2294	6198	2243	6063	0.37777777777777777	0.3699488701962725
chr16	TMC5	19490394	19490568	0	175	2294	6198	2294	6023	0.0	0.3808733189440478
chr16	TMC5	19472087	19472243	0	157	2294	6198	2294	6041	0.0	0.3797384538983612
chr16	TMC5	19462502	19462565	0	64	2294	6198	2294	6134	0.0	0.3739810890120639
chr16	TMC5	19474757	19474874	0	118	2294	6198	2294	6080	0.0	0.3773026315789474
chr16	CCP110	19525718	19525861	0	144	85347	9143	85347	8999	0.0	9.484053783753751
chr16	CCP110	19532415	19532544	0	130	85347	9143	85347	9013	0.0	9.469322090313991
chr16	CCP110	19548514	19548600	3828	87	85347	9143	81519	9056	44.0	9.001656360424029
chr16	CCP110	19524779	19525019	0	241	85347	9143	85347	8902	0.0	9.58739609076612
chr16	VPS35L	19575097	19575122	0	26	31992	9805	31992	9779	0.0	3.2715001533899173
chr16	VPS35L	19578303	19578358	0	56	31992	9805	31992	9749	0.0	3.2815673402400245
chr16	VPS35L	19591789	19591874	23	86	31992	9805	31969	9719	0.26744186046511625	3.289330178001852
chr16	VPS35L	19579051	19579128	0	78	31992	9805	31992	9727	0.0	3.288989410918063
chr16	VPS35L	19650381	19650459	867	79	31992	9805	31125	9726	10.974683544303797	3.2001850709438617
chr16	IQCK	19735352	19735450	0	99	174633	5005	174633	4906	0.0	35.59580105992662
chr16	IQCK	19763847	19764112	0	266	174633	5005	174633	4739	0.0	36.85017936273476
chr16	IQCK	19730429	19730494	0	66	174633	5005	174633	4939	0.0	35.35796719983802
chr16	IQCK	19736111	19736192	38	82	174633	5005	174595	4923	0.4634146341463415	35.46516351817997
chr16	ACSM5	20423915	20424069	0	155	51	3976	51	3821	0.0	0.013347291285003926
chr16	ACSM5	20427787	20427867	0	81	51	3976	51	3895	0.0	0.013093709884467265
chr16	ACSM2A	20452387	20452466	0	80	51	8018	51	7938	0.0	0.006424792139077854
chr16	ACSM2A	20460106	20460291	0	186	51	8018	51	7832	0.0	0.006511746680286006
chr16	ACSM2A	20452380	20452466	0	87	51	8018	51	7931	0.0	0.006430462741142353
chr16	ACSM2A	20452431	20452466	0	36	51	8018	51	7982	0.0	0.0063893760962164875
chr16	ACSM2A	20452084	20452466	0	383	51	8018	51	7635	0.0	0.0066797642436149315
chr16	ACSM2A	20470815	20470958	0	144	51	8018	51	7874	0.0	0.006477012954025908
chr16	ACSM2A	20452338	20452466	0	129	51	8018	51	7889	0.0	0.006464697680314361
chr16	AC141273.1	20585499	20585662	0	164	0	646	0	482	0.0	0.0
chr16	ACSM3	20779796	20779907	0	112	4082	7534	4082	7422	0.0	0.5499865265427109
chr16	REXO5	20806951	20807091	306	141	24784	3857	24478	3716	2.1702127659574466	6.58719052744887
chr16	REXO5	20839754	20839859	9472	106	24784	3857	15312	3751	89.35849056603773	4.0821114369501466
chr16	REXO5	20843933	20844026	0	94	24784	3857	24784	3763	0.0	6.586234387456816
chr16	REXO5	20824438	20824527	1353	90	24784	3857	23431	3767	15.033333333333333	6.220069020440669
chr16	REXO5	20808787	20808880	917	94	24784	3857	23867	3763	9.75531914893617	6.342545841084242
chr16	LYRM1	20915555	20915714	204	160	3501	3603	3297	3443	1.275	0.9575951205344176
chr16	LYRM1	20911182	20911264	0	83	3501	3603	3501	3520	0.0	0.9946022727272728
chr16	LYRM1	20902485	20902717	102	233	3501	3603	3399	3370	0.43776824034334766	1.0086053412462908
chr16	TMEM159	21166839	21166911	14	73	600	2567	586	2494	0.1917808219178082	0.23496391339214115
chr16	TMEM159	21178796	21178932	255	137	600	2567	345	2430	1.8613138686131387	0.1419753086419753
chr16	TMEM159	21174009	21174148	280	140	600	2567	320	2427	2.0	0.13185002060156573
chr16	TMEM159	21160977	21161008	0	32	600	2567	600	2535	0.0	0.23668639053254437
chr16	TMEM159	21177136	21177327	51	192	600	2567	549	2375	0.265625	0.23115789473684212
chr16	METTL9	21617864	21618074	0	211	1836	3443	1836	3232	0.0	0.568069306930693
chr16	METTL9	21612644	21612835	0	192	1836	3443	1836	3251	0.0	0.5647493079052599
chr16	OTOA	21705168	21705292	0	125	162	7574	162	7449	0.0	0.02174788562223117
chr16	UQCRC2	21957234	21957318	0	85	439555	4093	439555	4008	0.0	109.6694111776447
chr16	UQCRC2	21959338	21959555	0	218	439555	4093	439555	3875	0.0	113.43354838709678
chr16	UQCRC2	21980546	21980700	0	155	439555	4093	439555	3938	0.0	111.61884205180294
chr16	UQCRC2	21961327	21961465	0	139	439555	4093	439555	3954	0.0	111.16717248356095
chr16	MOSMO	22064337	22064438	0	102	10367	3362	10367	3260	0.0	3.1800613496932515
chr16	VWA3A	22097571	22097695	153	125	4159	5073	4006	4948	1.224	0.8096200485044462
chr16	VWA3A	22103474	22103529	0	56	4159	5073	4159	5017	0.0	0.8289814630257126
chr16	VWA3A	22109481	22109580	0	100	4159	5073	4159	4973	0.0	0.8363161069776794
chr16	VWA3A	22120967	22121103	0	137	4159	5073	4159	4936	0.0	0.8425850891410048
chr16	VWA3A	22123473	22123536	0	64	4159	5073	4159	5009	0.0	0.8303054501896586
chr16	VWA3A	22141202	22141249	0	48	4159	5073	4159	5025	0.0	0.8276616915422885
chr16	VWA3A	22147570	22147642	0	73	4159	5073	4159	5000	0.0	0.8318
chr16	POLR3E	22332059	22332185	459	127	103930	6743	103471	6616	3.6141732283464565	15.639510278113663
chr16	POLR3E	22302930	22303004	0	75	103930	6743	103930	6668	0.0	15.586382723455309
chr16	POLR3E	22332122	22332185	0	64	103930	6743	103930	6679	0.0	15.560712681539153
chr16	POLR3E	22298952	22299036	3175	85	103930	6743	100755	6658	37.35294117647059	15.132922799639532
chr16	POLR3E	22305378	22305494	51	117	103930	6743	103879	6626	0.4358974358974359	15.677482644129189
chr16	SMG1P1	22451619	22451658	0	40	34678	6698	34678	6658	0.0	5.208471012316011
chr16	SMG1P1	22455449	22455605	0	157	34678	6698	34678	6541	0.0	5.301635835499159
chr16	NPIPB5	22519137	22519269	3871	133	106344	8940	102473	8807	29.105263157894736	11.635403656182582
chr16	NPIPB5	22519328	22519414	2308	87	106344	8940	104036	8853	26.528735632183906	11.751496667796227
chr16	NPIPB5	22519137	22519414	10002	278	106344	8940	96342	8662	35.97841726618705	11.122373585776957
chr16	NPIPB5	22530942	22531044	473	103	106344	8940	105871	8837	4.592233009708738	11.98042322054996
chr16	SCNN1B	23367855	23367959	0	105	164	3900	164	3795	0.0	0.04321475625823452
chr16	SCNN1B	23371775	23371883	0	109	164	3900	164	3791	0.0	0.043260353468741755
chr16	AC008915.2	23455469	23455530	0	62	585	1010	585	948	0.0	0.6170886075949367
chr16	DCTN5	23658506	23658625	102	120	184724	12112	184622	11992	0.85	15.395430286857906
chr16	DCTN5	23657485	23657586	0	102	184724	12112	184724	12010	0.0	15.380849292256453
chr16	RBBP6	24564796	24564865	5768	70	46846	10087	41078	10017	82.4	4.100828591394629
chr16	RBBP6	24567791	24567893	510	103	46846	10087	46336	9984	4.951456310679611	4.641025641025641
chr16	RBBP6	24558420	24558534	210	115	46846	10087	46636	9972	1.826086956521739	4.676694745286803
chr16	TNRC6A	24793472	24793649	0	178	41704	12322	41704	12144	0.0	3.434123847167325
chr16	TNRC6A	24804704	24804851	1918	148	41704	12322	39786	12174	12.95945945945946	3.268112370625924
chr16	TNRC6A	24778343	24778468	0	126	41704	12322	41704	12196	0.0	3.4194817973105938
chr16	SLC5A11	24858619	24858778	0	160	612	3411	612	3251	0.0	0.1882497693017533
chr16	SLC5A11	24869900	24870005	0	106	612	3411	612	3305	0.0	0.18517397881996975
chr16	SLC5A11	24875626	24875731	408	106	612	3411	204	3305	3.849056603773585	0.06172465960665658
chr16	SLC5A11	24890868	24891074	0	207	612	3411	612	3204	0.0	0.19101123595505617
chr16	LINC02175	25070739	25070815	0	77	3343	5566	3343	5489	0.0	0.6090362543268355
chr16	LCMT1	25125963	25126126	0	164	23015	2603	23015	2439	0.0	9.436244362443624
chr16	LCMT1	25151553	25151615	10150	63	23015	2603	12865	2540	161.11111111111111	5.06496062992126
chr16	LCMT1	25170713	25170805	0	93	23015	2603	23015	2510	0.0	9.169322709163346
chr16	LCMT1	25174936	25175034	534	99	23015	2603	22481	2504	5.393939393939394	8.978035143769969
chr16	LCMT1	25170713	25170797	0	85	23015	2603	23015	2518	0.0	9.140190627482129
chr16	AC009158.1	26324036	26324263	0	228	0	2160	0	1932	0.0	0.0
chr16	AC009158.1	26319146	26319355	0	210	0	2160	0	1950	0.0	0.0
chr16	AC009158.1	26324144	26324263	0	120	0	2160	0	2040	0.0	0.0
chr16	AC009158.1	26324008	26324263	0	256	0	2160	0	1904	0.0	0.0
chr16	AC002331.1	26548903	26549038	0	136	0	1862	0	1726	0.0	0.0
chr16	KDM8	27220392	27220485	0	94	10101	3982	10101	3888	0.0	2.5979938271604937
chr16	NSMCE1-DT	27288799	27288953	0	155	28218	3274	28218	3119	0.0	9.047130490541841
chr16	IL4R	27334315	27334417	768	103	28368	5144	27600	5041	7.456310679611651	5.475104146002777
chr16	IL4R	27330065	27330198	250	134	28368	5144	28118	5010	1.8656716417910448	5.612375249500998
chr16	IL4R	27341069	27341313	65	245	28368	5144	28303	4899	0.2653061224489796	5.777301490100021
chr16	IL4R	27346466	27346618	1082	153	28368	5144	27286	4991	7.071895424836601	5.467040673211781
chr16	IL4R	27318634	27318767	0	134	28368	5144	28368	5010	0.0	5.662275449101797
chr16	IL4R	27360939	27361020	51	82	28368	5144	28317	5062	0.6219512195121951	5.59403397866456
chr16	IL21R	27403079	27403220	0	142	102	5467	102	5325	0.0	0.01915492957746479
chr16	KATNIP	27618424	27618501	0	78	49746	9815	49746	9737	0.0	5.108965800554586
chr16	KATNIP	27699533	27699599	0	67	49746	9815	49746	9748	0.0	5.103200656544932
chr16	KATNIP	27740040	27740920	612	881	49746	9815	49134	8934	0.6946651532349603	5.499664204163868
chr16	KATNIP	27654607	27654736	171	130	49746	9815	49575	9685	1.3153846153846154	5.118740320082602
chr16	SGF29	28588609	28588691	236	83	315	2033	79	1950	2.8433734939759034	0.04051282051282051
chr16	NPIPB9	28757997	28758083	149	87	4356	2131	4207	2044	1.7126436781609196	2.058219178082192
chr16	ATXN2L	28832816	28832887	0	72	110970	6097	110970	6025	0.0	18.418257261410787
chr16	ATXN2L	28836325	28836490	834	166	110970	6097	110136	5931	5.024096385542169	18.56954982296409
chr16	SH2B1	28861617	28861747	1000	131	116058	4469	115058	4338	7.633587786259542	26.523282618718305
chr16	SH2B1	28866011	28867033	3621	1023	116058	4469	112437	3446	3.5395894428152492	32.62826465467209
chr16	SH2B1	28873169	28873269	1252	101	116058	4469	114806	4368	12.396039603960396	26.28342490842491
chr16	ATP2A1	28894504	28894607	0	104	39675	4569	39675	4465	0.0	8.885778275475923
chr16	ATP2A1	28903699	28903741	0	43	39675	4569	39675	4526	0.0	8.766018559434379
chr16	ATP2A1	28892314	28892659	102	346	39675	4569	39573	4223	0.2947976878612717	9.370826426710869
chr16	ATP2A1	28892314	28892431	51	118	39675	4569	39624	4451	0.4322033898305085	8.902269152999326
chr16	CD19	28937768	28937825	102	58	4643	2694	4541	2636	1.7586206896551724	1.7226858877086495
chr16	SPNS1	28975491	28975557	36470	67	206718	3805	170248	3738	544.3283582089553	45.54521134296415
chr16	SPNS1	28977907	28978044	12828	138	206718	3805	193890	3667	92.95652173913044	52.87428415598582
chr16	SPNS1	28981900	28982056	0	157	206718	3805	206718	3648	0.0	56.66611842105263
chr16	SPNS1	28983785	28983957	0	173	206718	3805	206718	3632	0.0	56.915748898678416
chr16	LAT	28989932	28990019	4241	88	227206	4040	222965	3952	48.19318181818182	56.41826923076923
chr16	LAT	28986134	28986216	13120	83	227206	4040	214086	3957	158.0722891566265	54.10310841546626
chr16	RRN3P2	29084442	29084532	0	91	2480	2287	2480	2196	0.0	1.1293260473588342
chr16	RRN3P2	29087333	29087403	0	71	2480	2287	2480	2216	0.0	1.1191335740072201
chr16	SLX1B	29455543	29455885	26353	343	145039	1631	118686	1288	76.83090379008746	92.1475155279503
chr16	SULT1A4	29462692	29462785	0	94	40008	1840	40008	1746	0.0	22.914089347079038
chr16	QPRT	29694663	29695199	51	537	2292	2415	2241	1878	0.09497206703910614	1.1932907348242812
chr16	QPRT	29694663	29694755	51	93	2292	2415	2241	2322	0.5483870967741935	0.9651162790697675
chr16	KIF22	29792465	29792514	0	50	1868	3665	1868	3615	0.0	0.5167358229598894
chr16	MAZ	29806977	29807828	789	852	558616	3213	557827	2361	0.926056338028169	236.26725963574756
chr16	MAZ	29809539	29809764	30467	226	558616	3213	528149	2987	134.80973451327435	176.8158687646468
chr16	MAZ	29808229	29808293	19407	65	558616	3213	539209	3148	298.5692307692308	171.28621346886914
chr16	PRRT2	29812989	29813393	21921	405	238274	2305	216353	1900	54.12592592592593	113.87
chr16	PRRT2	29813685	29813933	7789	249	238274	2305	230485	2056	31.281124497991968	112.10359922178988
chr16	MVP	29830877	29831073	134356	197	220929	5786	86573	5589	682.010152284264	15.489890857040615
chr16	MVP	29825941	29826092	5225	152	220929	5786	215704	5634	34.375	38.2861199858005
chr16	ASPHD1	29906078	29906127	0	50	6537	2178	6537	2128	0.0	3.0718984962406015
chr16	TMEM219	29968024	29968254	0	231	390	2382	390	2151	0.0	0.18131101813110181
chr16	TMEM219	29972041	29972140	0	100	390	2382	390	2282	0.0	0.17090271691498685
chr16	INO80E	30001413	30001530	3626	118	316341	5075	312715	4957	30.728813559322035	63.08553560621343
chr16	INO80E	30001211	30001530	9697	320	316341	5075	306644	4755	30.303125	64.48874868559412
chr16	INO80E	30004567	30004657	10778	91	316341	5075	305563	4984	118.43956043956044	61.30878812199037
chr16	INO80E	30001464	30001530	2417	67	316341	5075	313924	5008	36.07462686567164	62.68450479233227
chr16	AC093512.2	30054783	30054927	0	145	2956	3371	2956	3226	0.0	0.9163050216986981
chr16	AC093512.2	30055171	30055327	0	157	2956	3371	2956	3214	0.0	0.9197261978842564
chr16	ALDOA	30069305	30069389	0	85	9775	2724	9775	2639	0.0	3.704054566123532
chr16	AC093512.2	30058940	30059053	0	114	2956	3371	2956	3257	0.0	0.907583665950261
chr16	ALDOA	30066884	30067038	1990	155	9775	2724	7785	2569	12.838709677419354	3.0303620085636434
chr16	ALDOA	30065875	30065927	555	53	9775	2724	9220	2671	10.471698113207546	3.4518906776488207
chr16	PPP4C	30082745	30082847	659	103	2799166	2653	2798507	2550	6.398058252427185	1097.4537254901961
chr16	PPP4C	30081258	30081310	427745	53	2799166	2653	2371421	2600	8070.66037735849	912.085
chr16	PPP4C	30081199	30081310	1334332	112	2799166	2653	1464834	2541	11913.67857142857	576.4793388429752
chr16	PPP4C	30082745	30082963	5100	219	2799166	2653	2794066	2434	23.28767123287671	1147.9317995069844
chr16	CORO1A	30186597	30186720	0	124	68	3668	68	3544	0.0	0.019187358916478554
chr16	CORO1A	30186815	30186945	0	131	68	3668	68	3537	0.0	0.019225332202431437
chr16	CORO1A	30188360	30188576	0	217	68	3668	68	3451	0.0	0.019704433497536946
chr16	CORO1A	30184225	30184343	0	119	68	3668	68	3549	0.0	0.019160326852634545
chr16	SLX1A-SULT1A3	30194885	30195227	204	343	46425	4064	46221	3721	0.5947521865889213	12.421660843859177
chr16	SULT1A3	30201195	30201293	146	99	46157	2001	46011	1902	1.4747474747474747	24.190851735015773
chr16	SLX1A	30196973	30197101	0	129	4024	2134	4024	2005	0.0	2.006982543640898
chr16	SULT1A3	30202037	30202130	0	94	46157	2001	46157	1907	0.0	24.20398531725223
chr16	ZNF48	30395779	30395873	102	95	6893	3730	6791	3635	1.0736842105263158	1.8682255845942228
chr16	ITGAL	30473964	30474083	0	120	102	9594	102	9474	0.0	0.010766307789740342
chr16	ITGAL	30479330	30479461	0	132	102	9594	102	9462	0.0	0.01077996195307546
chr16	ITGAL	30489253	30489386	0	134	102	9594	102	9460	0.0	0.010782241014799155
chr16	ITGAL	30516972	30517086	0	115	102	9594	102	9479	0.0	0.010760628758307838
chr16	ITGAL	30481438	30481584	0	147	102	9594	102	9447	0.0	0.010797078437599238
chr16	ITGAL	30479090	30479208	0	119	102	9594	102	9475	0.0	0.010765171503957784
chr16	ITGAL	30489253	30492069	51	2817	102	9594	51	6777	0.01810436634717785	0.007525453740593183
chr16	AC002310.2	30581723	30582148	2166	426	12910	2132	10744	1706	5.084507042253521	6.297772567409144
chr16	PRR14	30650992	30651127	0	136	357	3517	357	3381	0.0	0.10559006211180125
chr16	SRCAP	30721188	30721476	68237	289	759129	13678	690892	13389	236.11418685121106	51.60146388826649
chr16	SRCAP	30722562	30722748	0	187	759129	13678	759129	13491	0.0	56.269290638203245
chr16	RNF40	30766378	30766558	3719	181	594609	6186	590890	6005	20.54696132596685	98.39966694421315
chr16	RNF40	30766162	30766282	3109	121	594609	6186	591500	6065	25.694214876033058	97.5267930750206
chr16	MIR762HG	30888713	30888958	0	246	1156	1675	1156	1429	0.0	0.8089573128061581
chr16	MIR762HG	30888770	30888958	0	189	1156	1675	1156	1486	0.0	0.7779273216689099
chr16	FBXL19	30927744	30927963	1629	220	23349	4683	21720	4463	7.404545454545454	4.866681604302039
chr16	ORAI3	30949696	30949871	92	176	59013	2322	58921	2146	0.5227272727272727	27.45619757688723
chr16	HSD3B7	30986839	30987002	0	164	3341	2497	3341	2333	0.0	1.4320617231033004
chr16	BCKDK	31110687	31110761	0	75	13011	3416	13011	3341	0.0	3.8943430110745285
chr16	BCKDK	31111299	31111389	0	91	13011	3416	13011	3325	0.0	3.913082706766917
chr16	KAT8	31117061	31117188	0	128	177261	5737	177261	5609	0.0	31.602959529327865
chr16	FUS	31186801	31186836	0	36	238367	5439	238367	5403	0.0	44.117527299648344
chr16	ITGAM	31277966	31278109	0	144	1865	5718	1865	5574	0.0	0.334589163975601
chr16	ITGAX	31372377	31372509	0	133	156	6954	156	6821	0.0	0.022870546840639203
chr16	ITGAX	31373248	31373390	0	143	156	6954	156	6811	0.0	0.0229041256790486
chr16	TGFB1I1	31473681	31473734	822	54	62014	4233	61192	4179	15.222222222222221	14.642737497008854
chr16	TGFB1I1	31473834	31473977	3132	144	62014	4233	58882	4089	21.75	14.40009782342871
chr16	TGFB1I1	31474151	31474239	925	89	62014	4233	61089	4144	10.393258426966293	14.741554054054054
chr16	TGFB1I1	31473440	31473556	4791	117	62014	4233	57223	4116	40.94871794871795	13.902575315840622
chr16	CLUHP3	31701662	31701858	0	197	1091	5837	1091	5640	0.0	0.19343971631205673
chr16	CLUHP3	31702534	31702681	35	148	1091	5837	1056	5689	0.23648648648648649	0.1856213745825277
chr16	ZNF720	31753765	31753900	153	136	3667	6006	3514	5870	1.125	0.5986371379897786
chr16	ZNF720	31733510	31733627	51	118	3667	6006	3616	5888	0.4322033898305085	0.6141304347826086
chr16	ZNF720	31759356	31759466	0	111	3667	6006	3667	5895	0.0	0.6220525869380831
chr16	ZNF267	31890206	31890250	565	45	5385	3669	4820	3624	12.555555555555555	1.3300220750551877
chr16	ZNF267	31875202	31875302	0	101	5385	3669	5385	3568	0.0	1.5092488789237668
chr16	ZNF267	31875151	31875302	0	152	5385	3669	5385	3517	0.0	1.5311344896218368
chr16	TP53TG3D	32254393	32254683	0	291	0	2115	0	1824	0.0	0.0
chr16	HERC2P5	32747016	32747338	0	323	540	6105	540	5782	0.0	0.09339328951919751
chr16	HERC2P5	32769686	32769879	234	194	540	6105	306	5911	1.2061855670103092	0.05176789037387921
chr16	HERC2P5	32765437	32765545	0	109	540	6105	540	5996	0.0	0.09006004002668445
chr16	TP53TG3B	33361940	33362229	0	290	0	1937	0	1647	0.0	0.0
chr16	ORC6	46695561	46695674	17340	114	367956	3973	350616	3859	152.10526315789474	90.8566986265872
chr16	ITFG1-AS1	47153631	47153796	0	166	51	633	51	467	0.0	0.10920770877944326
chr16	PHKB	47463898	47463993	0	96	8053	10959	8053	10863	0.0	0.7413237595507687
chr16	PHKB	47463881	47463993	0	113	8053	10959	8053	10846	0.0	0.7424857090171492
chr16	PHKB	47462340	47462452	0	113	8053	10959	8053	10846	0.0	0.7424857090171492
chr16	PHKB	47562397	47562495	0	99	8053	10959	8053	10860	0.0	0.7415285451197053
chr16	LONP2	48256609	48256741	0	133	966	6169	966	6036	0.0	0.16003976143141152
chr16	LONP2	48262777	48262872	0	96	966	6169	966	6073	0.0	0.15906471266260497
chr16	LONP2	48336392	48336498	0	107	966	6169	966	6062	0.0	0.15935334872979215
chr16	AC007614.1	49285482	49285623	0	142	51	24089	51	23947	0.0	0.0021297030943333195
chr16	AC007614.1	49285520	49285623	0	104	51	24089	51	23985	0.0	0.0021263289555972483
chr16	AC007614.1	49287719	49287989	0	271	51	24089	51	23818	0.0	0.0021412377193719035
chr16	AC007614.1	49287829	49287989	0	161	51	24089	51	23928	0.0	0.002131394182547643
chr16	AC007614.1	49343346	49343497	0	152	51	24089	51	23937	0.0	0.0021305928061160547
chr16	AC007614.1	49342087	49342208	0	122	51	24089	51	23967	0.0	0.0021279258981099012
chr16	AC007614.1	49336660	49336877	0	218	51	24089	51	23871	0.0	0.002136483599346487
chr16	AC007614.1	49285482	49285520	0	39	51	24089	51	24050	0.0	0.0021205821205821204
chr16	AC007614.1	49290728	49291066	0	339	51	24089	51	23750	0.0	0.0021473684210526318
chr16	AC007614.1	49344186	49344349	0	164	51	24089	51	23925	0.0	0.0021316614420062697
chr16	AC007614.1	49289537	49289655	0	119	51	24089	51	23970	0.0	0.002127659574468085
chr16	AC007614.1	49287901	49287989	0	89	51	24089	51	24000	0.0	0.002125
chr16	CNEP1R1	50025650	50025701	0	52	0	4101	0	4049	0.0	0.0
chr16	CNEP1R1	50029724	50029798	0	75	0	4101	0	4026	0.0	0.0
chr16	HEATR3	50066366	50066539	14	174	53517	5056	53503	4882	0.08045977011494253	10.959238017206063
chr16	ADCY7	50289220	50289313	0	94	526	8372	526	8278	0.0	0.06354191833776275
chr16	NOD2	50707854	50707960	0	107	0	6889	0	6782	0.0	0.0
chr16	NOD2	50715608	50715755	0	148	0	6889	0	6741	0.0	0.0
chr16	NOD2	50716890	50716974	0	85	0	6889	0	6804	0.0	0.0
chr16	NOD2	50696339	50696480	0	142	0	6889	0	6747	0.0	0.0
chr16	NOD2	50719924	50720008	0	85	0	6889	0	6804	0.0	0.0
chr16	CYLD	50744729	50744866	0	138	38045	10005	38045	9867	0.0	3.85578189926016
chr16	CYLD	50775165	50775174	0	10	38045	10005	38045	9995	0.0	3.8064032016008005
chr16	CYLD	50742761	50742822	0	62	38045	10005	38045	9943	0.0	3.826309966810822
chr16	CYLD	50742761	50742841	0	81	38045	10005	38045	9924	0.0	3.8336356307940345
chr16	LINC02128	50843529	50843646	0	118	0	5070	0	4952	0.0	0.0
chr16	LINC02128	50881906	50882192	0	287	0	5070	0	4783	0.0	0.0
chr16	LINC02127	51024807	51025059	0	253	0	1918	0	1665	0.0	0.0
chr16	LINC02127	51026790	51026827	0	38	0	1918	0	1880	0.0	0.0
chr16	LINC02127	51024807	51025013	0	207	0	1918	0	1711	0.0	0.0
chr16	LINC02180	52092262	52092338	0	77	0	2068	0	1991	0.0	0.0
chr16	LINC02180	52094958	52095073	0	116	0	2068	0	1952	0.0	0.0
chr16	LINC02180	52092262	52092336	0	75	0	2068	0	1993	0.0	0.0
chr16	LINC02180	52092526	52092649	0	124	0	2068	0	1944	0.0	0.0
chr16	LINC02180	52092262	52092342	0	81	0	2068	0	1987	0.0	0.0
chr16	LINC02180	52093047	52093308	0	262	0	2068	0	1806	0.0	0.0
chr16	LINC02180	52093101	52093308	0	208	0	2068	0	1860	0.0	0.0
chr16	AC007333.1	52243403	52243506	0	104	0	2171	0	2067	0.0	0.0
chr16	AC007333.1	52238341	52238565	0	225	0	2171	0	1946	0.0	0.0
chr16	CASC22	52273064	52273219	0	156	0	2437	0	2281	0.0	0.0
chr16	CASC22	52272618	52272649	0	32	0	2437	0	2405	0.0	0.0
chr16	CASC22	52272618	52273219	0	602	0	2437	0	1835	0.0	0.0
chr16	CASC22	52273111	52273219	0	109	0	2437	0	2328	0.0	0.0
chr16	CASC22	52273701	52274217	0	517	0	2437	0	1920	0.0	0.0
chr16	CASC22	52275468	52275526	0	59	0	2437	0	2378	0.0	0.0
chr16	AC026462.3	52608835	52608914	0	80	0	3107	0	3027	0.0	0.0
chr16	CHD9	53303719	53304625	0	907	7725	15474	7725	14567	0.0	0.5303082309329306
chr16	CHD9	53319812	53319951	690	140	7725	15474	7035	15334	4.928571428571429	0.4587844006782314
chr16	CHD9	53321162	53321217	0	56	7725	15474	7725	15418	0.0	0.5010377480866519
chr16	FTO	53825863	53826491	0	629	2298	14928	2298	14299	0.0	0.16071053919854536
chr16	FTO	54149686	54149762	0	77	2298	14928	2298	14851	0.0	0.1547370547437883
chr16	FTO	54061661	54061720	0	60	2298	14928	2298	14868	0.0	0.15456012913640033
chr16	FTO	53984937	53984954	0	18	2298	14928	2298	14910	0.0	0.15412474849094568
chr16	IRX5	54932053	54932209	33	157	1053	2148	1020	1991	0.21019108280254778	0.5123053741838273
chr16	MMP2	55489650	55489824	0	175	0	4725	0	4550	0.0	0.0
chr16	SLC6A2	55691917	55692052	0	136	0	5213	0	5077	0.0	0.0
chr16	SLC6A2	55700138	55700306	0	169	0	5213	0	5044	0.0	0.0
chr16	SLC6A2	55701862	55701934	0	73	0	5213	0	5140	0.0	0.0
chr16	CES1P1	55764696	55764904	0	209	0	3209	0	3000	0.0	0.0
chr16	GNAO1	56328630	56328791	0	162	122	13840	122	13678	0.0	0.008919432665594385
chr16	GNAO1	56334728	56334857	0	130	122	13840	122	13710	0.0	0.008898614150255288
chr16	GNAO1	56351383	56351537	0	155	122	13840	122	13685	0.0	0.008914870295944465
chr16	GNAO1	56354865	56355081	0	217	122	13840	122	13623	0.0	0.008955443000807459
chr16	GNAO1	56255520	56255591	0	72	122	13840	122	13768	0.0	0.008861127251597907
chr16	GNAO1	56235012	56235384	0	373	122	13840	122	13467	0.0	0.009059181703423182
chr16	GNAO1	56355255	56355328	0	74	122	13840	122	13766	0.0	0.008862414644776986
chr16	GNAO1	56354865	56354987	0	123	122	13840	122	13717	0.0	0.008894073048042576
chr16	OGFOD1	56462533	56462634	459	102	59909	5793	59450	5691	4.5	10.446318748901774
chr16	OGFOD1	56467164	56467293	494	130	59909	5793	59415	5663	3.8	10.491788804520572
chr16	MT3	56589525	56589621	0	97	0	1018	0	921	0.0	0.0
chr16	MT1E	56626465	56626531	0	67	0	1054	0	987	0.0	0.0
chr16	NUP93	56741779	56741817	0	39	182644	11123	182644	11084	0.0	16.478166726813424
chr16	NUP93	56748233	56748426	50	194	182644	11123	182594	10929	0.25773195876288657	16.707292524476163
chr16	NUP93	56805503	56805632	765	130	182644	11123	181879	10993	5.884615384615385	16.54498317110889
chr16	NUP93	56841704	56841833	0	130	182644	11123	182644	10993	0.0	16.614572910033658
chr16	NUP93	56842577	56842695	0	119	182644	11123	182644	11004	0.0	16.59796437659033
chr16	HERPUD1	56935400	56935475	0	76	765	4885	765	4809	0.0	0.15907673112913287
chr16	HERPUD1	56939236	56939359	0	124	765	4885	765	4761	0.0	0.16068052930056712
chr16	HERPUD1	56935403	56935475	0	73	765	4885	765	4812	0.0	0.1589775561097257
chr16	HERPUD1	56939894	56940245	0	352	765	4885	765	4533	0.0	0.1687624090006618
chr16	CETP	56973330	56973510	197	181	149779	3408	149582	3227	1.0883977900552486	46.35326929036257
chr16	NLRC5	57034511	57034946	0	436	18664	12006	18664	11570	0.0	1.6131374243733794
chr16	NLRC5	57041981	57042065	0	85	18664	12006	18664	11921	0.0	1.5656404664038253
chr16	NLRC5	57046551	57046641	0	91	18664	12006	18664	11915	0.0	1.5664288711707932
chr16	NLRC5	57055432	57055519	0	88	18664	12006	18664	11918	0.0	1.5660345695586508
chr16	NLRC5	57058064	57058148	0	85	18664	12006	18664	11921	0.0	1.5656404664038253
chr16	NLRC5	57055435	57055519	0	85	18664	12006	18664	11921	0.0	1.5656404664038253
chr16	NLRC5	57062158	57062173	0	16	18664	12006	18664	11990	0.0	1.556630525437865
chr16	NLRC5	57058971	57059061	0	91	18664	12006	18664	11915	0.0	1.5664288711707932
chr16	NLRC5	57075940	57076056	2019	117	18664	12006	16645	11889	17.256410256410255	1.400033644545378
chr16	CPNE2	57137148	57137282	0	135	1323	4393	1323	4258	0.0	0.3107092531705026
chr16	CPNE2	57093949	57094091	459	143	1323	4393	864	4250	3.2097902097902096	0.20329411764705882
chr16	CPNE2	57125276	57125363	0	88	1323	4393	1323	4305	0.0	0.3073170731707317
chr16	CPNE2	57134774	57134826	0	53	1323	4393	1323	4340	0.0	0.30483870967741933
chr16	RSPRY1	57216106	57216173	1164	68	190126	5008	188962	4940	17.11764705882353	38.251417004048584
chr16	RSPRY1	57207592	57207685	14848	94	190126	5008	175278	4914	157.95744680851064	35.66910866910867
chr16	CX3CL1	57379615	57379754	0	140	0	5963	0	5823	0.0	0.0
chr16	CX3CL1	57379633	57379754	0	122	0	5963	0	5841	0.0	0.0
chr16	COQ9	57458245	57458350	0	106	600	3924	600	3818	0.0	0.1571503404924044
chr16	COQ9	57456930	57457015	0	86	600	3924	600	3838	0.0	0.1563314226159458
chr16	COQ9	57456503	57456646	0	144	600	3924	600	3780	0.0	0.15873015873015872
chr16	COQ9	57456503	57456626	0	124	600	3924	600	3800	0.0	0.15789473684210525
chr16	POLR2C	57463655	57464055	1688	401	136490	3195	134802	2794	4.2094763092269325	48.24695776664281
chr16	ADGRG5	57570417	57570535	874	119	9084	5643	8210	5524	7.34453781512605	1.4862418537291817
chr16	ADGRG1	57641586	57641708	0	123	809	7445	809	7322	0.0	0.11048893744878449
chr16	ADGRG1	57641590	57641708	0	119	809	7445	809	7326	0.0	0.11042861042861044
chr16	ADGRG1	57621690	57621845	0	156	809	7445	809	7289	0.0	0.11098916175058307
chr16	ADGRG1	57628659	57628802	0	144	809	7445	809	7301	0.0	0.11080673880290372
chr16	ADGRG1	57628636	57628802	0	167	809	7445	809	7278	0.0	0.11115691123935147
chr16	ADGRG1	57647966	57648000	0	35	809	7445	809	7410	0.0	0.10917678812415654
chr16	ADGRG1	57647915	57648000	0	86	809	7445	809	7359	0.0	0.1099334148661503
chr16	ADGRG3	57674588	57674649	0	62	13639	3253	13639	3191	0.0	4.274208712002507
chr16	ADGRG3	57676199	57676338	0	140	13639	3253	13639	3113	0.0	4.381304208159332
chr16	ADGRG3	57683931	57684212	4775	282	13639	3253	8864	2971	16.93262411347518	2.9835072366206665
chr16	DRC7	57696402	57696594	0	193	36999	4027	36999	3834	0.0	9.650234741784038
chr16	DRC7	57698849	57699024	18047	176	36999	4027	18952	3851	102.53977272727273	4.921319137886264
chr16	DRC7	57701935	57702130	0	196	36999	4027	36999	3831	0.0	9.657791699295224
chr16	DRC7	57726831	57726942	0	112	36999	4027	36999	3915	0.0	9.450574712643679
chr16	DRC7	57696463	57696594	0	132	36999	4027	36999	3895	0.0	9.499101412066752
chr16	DRC7	57698849	57699033	18047	185	36999	4027	18952	3842	97.55135135135136	4.932847475273295
chr16	KATNB1	57750826	57750927	0	102	157	3360	157	3258	0.0	0.048189073050951506
chr16	TEPP	57977814	57978039	0	226	0	1756	0	1530	0.0	0.0
chr16	USB1	58009928	58010112	0	185	1308	4598	1308	4413	0.0	0.2963970088375255
chr16	USB1	58014272	58014326	0	55	1308	4598	1308	4543	0.0	0.28791547435615233
chr16	USB1	58014272	58014294	0	23	1308	4598	1308	4575	0.0	0.28590163934426227
chr16	AC009107.2	58157066	58157188	0	123	102239	4798	102239	4675	0.0	21.869304812834226
chr16	AC009107.2	58138416	58138509	0	94	102239	4798	102239	4704	0.0	21.734481292517007
chr16	CCDC113	58253997	58254159	0	163	102	5938	102	5775	0.0	0.017662337662337664
chr16	CCDC113	58252726	58252853	0	128	102	5938	102	5810	0.0	0.01755593803786575
chr16	GINS3	58329862	58329949	0	88	102	3687	102	3599	0.0	0.028341205890525144
chr16	GINS3	58395101	58395218	0	118	102	3687	102	3569	0.0	0.02857943401513029
chr16	GINS3	58403097	58403331	0	235	102	3687	102	3452	0.0	0.02954808806488992
chr16	LINC02137	58433809	58433948	402	140	7506	1782	7104	1642	2.8714285714285714	4.326431181485993
chr16	NDRG4	58494963	58495008	0	46	204	7151	204	7105	0.0	0.02871217452498241
chr16	NDRG4	58509153	58509189	0	37	204	7151	204	7114	0.0	0.028675850435760472
chr16	NDRG4	58509300	58509352	0	53	204	7151	204	7098	0.0	0.028740490278951817
chr16	NDRG4	58500987	58501077	0	91	204	7151	204	7060	0.0	0.028895184135977338
chr16	NDRG4	58487755	58487850	0	96	204	7151	204	7055	0.0	0.02891566265060241
chr16	NDRG4	58475611	58475657	0	47	204	7151	204	7104	0.0	0.028716216216216218
chr16	NDRG4	58510644	58510683	0	40	204	7151	204	7111	0.0	0.028687948249191395
chr16	NDRG4	58464821	58465071	0	251	204	7151	204	6900	0.0	0.029565217391304348
chr16	NDRG4	58501972	58502147	0	176	204	7151	204	6975	0.0	0.02924731182795699
chr16	NDRG4	58501947	58502147	0	201	204	7151	204	6950	0.0	0.02935251798561151
chr16	NDRG4	58501944	58502147	0	204	204	7151	204	6947	0.0	0.02936519360875198
chr16	SETD6	58515952	58516097	0	146	177	7506	177	7360	0.0	0.02404891304347826
chr16	AC009081.2	60360479	60360705	0	227	0	2517	0	2290	0.0	0.0
chr16	AC009081.2	60440562	60440617	0	56	0	2517	0	2461	0.0	0.0
chr16	AC009081.2	60496020	60496156	0	137	0	2517	0	2380	0.0	0.0
chr16	LINC02165	63731409	63731489	0	81	0	3243	0	3162	0.0	0.0
chr16	CDH5	66368642	66368752	51	111	102	6002	51	5891	0.4594594594594595	0.00865727380750297
chr16	BEAN1	66437594	66437701	0	108	116	6888	116	6780	0.0	0.01710914454277286
chr16	BEAN1	66482881	66482915	0	35	116	6888	116	6853	0.0	0.016926893331387714
chr16	CKLF	66558189	66558348	0	160	102	1167	102	1007	0.0	0.1012909632571996
chr16	CKLF	66563121	66563217	0	97	102	1167	102	1070	0.0	0.09532710280373832
chr16	CMTM1	66571136	66571270	0	135	2039	1471	2039	1336	0.0	1.526197604790419
chr16	CMTM1	66577103	66577202	0	100	2039	1471	2039	1371	0.0	1.487235594456601
chr16	CMTM1	66569935	66570094	400	160	2039	1471	1639	1311	2.5	1.250190694126621
chr16	CMTM1	66571150	66571270	0	121	2039	1471	2039	1350	0.0	1.5103703703703704
chr16	CMTM1	66574939	66575137	700	199	2039	1471	1339	1272	3.5175879396984926	1.0526729559748427
chr16	CMTM1	66577128	66577202	0	75	2039	1471	2039	1396	0.0	1.4606017191977076
chr16	CMTM2	66580025	66580184	0	160	2680	1143	2680	983	0.0	2.726347914547304
chr16	CMTM3	66609434	66609530	117	97	5477	2917	5360	2820	1.2061855670103092	1.900709219858156
chr16	CMTM3	66604730	66604952	204	223	5477	2917	5273	2694	0.9147982062780269	1.957312546399406
chr16	CA7	66850540	66850659	16100	120	17186	1835	1086	1715	134.16666666666666	0.6332361516034986
chr16	PDP2	66883014	66883102	0	89	306	5160	306	5071	0.0	0.06034312758824689
chr16	CES3	66963065	66963084	0	20	235952	4941	235952	4921	0.0	47.94797805324121
chr16	CES4A	67004792	67004873	0	82	1458	4201	1458	4119	0.0	0.35396941005098326
chr16	CES4A	67006390	67006519	0	130	1458	4201	1458	4071	0.0	0.35814296241709653
chr16	CES4A	67006744	67006817	0	74	1458	4201	1458	4127	0.0	0.3532832566028592
chr16	CES4A	66996059	66996179	663	121	1458	4201	795	4080	5.479338842975206	0.1948529411764706
chr16	CBFB	67036638	67036755	0	118	132925	4534	132925	4416	0.0	30.10076992753623
chr16	CBFB	67093413	67093629	0	217	132925	4534	132925	4317	0.0	30.791058605513086
chr16	C16ORF70	67125958	67126042	70	85	570965	5214	570895	5129	0.8235294117647058	111.30727237278222
chr16	FBXL8	67163511	67163852	0	342	2418	2967	2418	2625	0.0	0.9211428571428572
chr16	FBXL8	67162847	67163852	0	1006	2418	2967	2418	1961	0.0	1.2330443651198368
chr16	AC074143.1	67164440	67164934	204	495	204	1427	0	932	0.4121212121212121	0.0
chr16	HSF4	67165521	67165630	0	110	27639	2898	27639	2788	0.0	9.913558106169297
chr16	HSF4	67167302	67167402	0	101	27639	2898	27639	2797	0.0	9.88165892027172
chr16	HSF4	67167474	67167599	1	126	27639	2898	27638	2772	0.007936507936507936	9.97041847041847
chr16	HSF4	67167823	67167947	0	125	27639	2898	27639	2773	0.0	9.967183555715831
chr16	HSF4	67169278	67169348	0	71	27639	2898	27639	2827	0.0	9.77679518924655
chr16	HSF4	67167719	67167947	153	229	27639	2898	27486	2669	0.6681222707423581	10.298239040839265
chr16	HSF4	67167460	67167599	1	140	27639	2898	27638	2758	0.007142857142857143	10.02102973168963
chr16	NOL3	67174161	67174464	8294	304	52121	2844	43827	2540	27.282894736842106	17.25472440944882
chr16	NOL3	67174161	67174340	0	180	52121	2844	52121	2664	0.0	19.56493993993994
chr16	NOL3	67174161	67174454	7610	294	52121	2844	44511	2550	25.8843537414966	17.45529411764706
chr16	E2F4	67193421	67193515	0	95	53541	3376	53541	3281	0.0	16.31850045717769
chr16	ELMO3	67199950	67200001	166	52	63032	2551	62866	2499	3.1923076923076925	25.156462585034014
chr16	ELMO3	67200191	67200361	9194	171	63032	2551	53838	2380	53.76608187134503	22.621008403361344
chr16	SLC9A5	67257530	67257601	0	72	146220	5438	146220	5366	0.0	27.2493477450615
chr16	SLC9A5	67252541	67252844	0	304	146220	5438	146220	5134	0.0	28.48071679002727
chr16	SLC9A5	67255020	67255184	1450	165	146220	5438	144770	5273	8.787878787878787	27.454959226246917
chr16	PLEKHG4	67288488	67288604	0	117	18388	5721	18388	5604	0.0	3.281227694503926
chr16	PLEKHG4	67288475	67288604	0	130	18388	5721	18388	5591	0.0	3.288857091754606
chr16	LRRC36	67341956	67342084	0	129	102	4036	102	3907	0.0	0.026106987458407987
chr16	LRRC36	67365303	67365355	0	53	102	4036	102	3983	0.0	0.025608837559628422
chr16	LRRC36	67376726	67376872	0	147	102	4036	102	3889	0.0	0.026227822062226794
chr16	LRRC36	67341982	67342084	0	103	102	4036	102	3933	0.0	0.02593440122044241
chr16	LRRC36	67336640	67336730	0	91	102	4036	102	3945	0.0	0.02585551330798479
chr16	LRRC36	67375257	67375412	0	156	102	4036	102	3880	0.0	0.026288659793814433
chr16	LRRC36	67362183	67362305	0	123	102	4036	102	3913	0.0	0.02606695629951444
chr16	LRRC36	67367016	67367457	0	442	102	4036	102	3594	0.0	0.028380634390651086
chr16	LRRC36	67375246	67375412	0	167	102	4036	102	3869	0.0	0.026363401395709484
chr16	RIPOR1	67538671	67538824	2216	154	11665	6172	9449	6018	14.38961038961039	1.5701229644400132
chr16	RIPOR1	67538659	67538824	2216	166	11665	6172	9449	6006	13.349397590361447	1.5732600732600732
chr16	RIPOR1	67544955	67545117	7	163	11665	6172	11658	6009	0.04294478527607362	1.9400898652021967
chr16	RIPOR1	67529636	67529859	409	224	11665	6172	11256	5948	1.8258928571428572	1.8924008069939475
chr16	CTCF	67572482	67572599	647	118	16206	9887	15559	9769	5.483050847457627	1.5926911659330536
chr16	CTCF	67571147	67571264	1032	118	16206	9887	15174	9769	8.745762711864407	1.553280786160303
chr16	CTCF	67635514	67635632	72	119	16206	9887	16134	9768	0.6050420168067226	1.6517199017199018
chr16	CARMIL2	67645539	67645631	1071	93	99983	5782	98912	5689	11.516129032258064	17.386535419230093
chr16	CARMIL2	67656800	67656881	0	82	99983	5782	99983	5700	0.0	17.540877192982457
chr16	CARMIL2	67656833	67656881	0	49	99983	5782	99983	5733	0.0	17.439909297052154
chr16	C16ORF86	67667295	67667525	102	231	1369	1441	1267	1210	0.44155844155844154	1.0471074380165288
chr16	C16ORF86	67667226	67667525	102	300	1369	1441	1267	1141	0.34	1.1104294478527608
chr16	TSNAXIP1	67821098	67821225	0	128	255	3696	255	3568	0.0	0.07146860986547085
chr16	TSNAXIP1	67824582	67824779	0	198	255	3696	255	3498	0.0	0.07289879931389365
chr16	TSNAXIP1	67820838	67820951	0	114	255	3696	255	3582	0.0	0.0711892797319933
chr16	TSNAXIP1	67823625	67823719	0	95	255	3696	255	3601	0.0	0.0708136628714246
chr16	NUTF2	67847277	67847456	0	180	32157	2866	32157	2686	0.0	11.972077438570365
chr16	DUS2	68025414	68025494	0	81	15973	4104	15973	4023	0.0	3.970420084514044
chr16	DUS2	68049504	68049550	0	47	15973	4104	15973	4057	0.0	3.937145674143456
chr16	DUS2	68025380	68025494	0	115	15973	4104	15973	3989	0.0	4.004261719729255
chr16	DUS2	68023847	68024004	0	158	15973	4104	15973	3946	0.0	4.047896604156107
chr16	DUS2	68026959	68027082	0	124	15973	4104	15973	3980	0.0	4.013316582914573
chr16	NFATC3	68166842	68167015	0	174	28113	8798	28113	8624	0.0	3.259856215213358
chr16	NFATC3	68214328	68214432	416	105	28113	8798	27697	8693	3.961904761904762	3.1861267686644426
chr16	NFATC3	68121986	68123121	0	1136	28113	8798	28113	7662	0.0	3.6691464369616287
chr16	NFATC3	68126447	68126610	0	164	28113	8798	28113	8634	0.0	3.2560806115357885
chr16	NFATC3	68221195	68221284	0	90	28113	8798	28113	8708	0.0	3.2284106568672484
chr16	PLA2G15	68249289	68249446	1428	158	131243	3863	129815	3705	9.037974683544304	35.03778677462888
chr16	PLA2G15	68248568	68248692	701	125	131243	3863	130542	3738	5.608	34.92295345104334
chr16	PLA2G15	68253421	68253517	129	97	131243	3863	131114	3766	1.3298969072164948	34.815188528943175
chr16	PLA2G15	68255281	68255380	403	100	131243	3863	130840	3763	4.03	34.770130215253786
chr16	SLC7A6	68287745	68287871	14	127	60272	6338	60258	6211	0.11023622047244094	9.70181935276123
chr16	SLC7A6	68291208	68291332	51	125	60272	6338	60221	6213	0.408	9.692741026879125
chr16	SLC7A6	68273817	68273904	360	88	60272	6338	59912	6250	4.090909090909091	9.58592
chr16	SLC7A6	68287322	68287435	0	114	60272	6338	60272	6224	0.0	9.683804627249357
chr16	SLC7A6	68290395	68290540	51	146	60272	6338	60221	6192	0.3493150684931507	9.72561369509044
chr16	SLC7A6	68273821	68273904	360	84	60272	6338	59912	6254	4.285714285714286	9.579788935081547
chr16	PRMT7	68315896	68316074	4859	179	96056	8534	91197	8355	27.145251396648046	10.915260323159785
chr16	PRMT7	68321425	68321462	650	38	96056	8534	95406	8496	17.105263157894736	11.2295197740113
chr16	PRMT7	68324682	68324832	3466	151	96056	8534	92590	8383	22.95364238410596	11.044971967076226
chr16	PRMT7	68329065	68329174	565	110	96056	8534	95491	8424	5.136363636363637	11.335588793922128
chr16	PRMT7	68312041	68312176	255	136	96056	8534	95801	8398	1.875	11.407597046915932
chr16	PRMT7	68356140	68356215	0	76	96056	8534	96056	8458	0.0	11.35682194372192
chr16	ZFP90	68539757	68539825	0	69	2484	5921	2484	5852	0.0	0.4244702665755297
chr16	CDH3	68645635	68645750	0	116	12025	5982	12025	5866	0.0	2.0499488578247527
chr16	CDH3	68676384	68676470	0	87	12025	5982	12025	5895	0.0	2.039864291772689
chr16	CDH3	68678761	68678906	6956	146	12025	5982	5069	5836	47.64383561643836	0.8685743660041124
chr16	CDH1	68808692	68808848	0	157	64	5466	64	5309	0.0	0.01205500094179695
chr16	CDH1	68810196	68810341	0	146	64	5466	64	5320	0.0	0.012030075187969926
chr16	CDH1	68813312	68813495	0	184	64	5466	64	5282	0.0	0.0121166224914805
chr16	CDH1	68819279	68819425	0	147	64	5466	64	5319	0.0	0.012032336905433353
chr16	CDH1	68813499	68813562	0	64	64	5466	64	5402	0.0	0.011847463902258423
chr16	CDH1	68813312	68813562	0	251	64	5466	64	5215	0.0	0.012272291466922339
chr16	UTP4	69133511	69133618	0	108	458497	3922	458497	3814	0.0	120.21421080230729
chr16	UTP4	69133457	69133618	0	162	458497	3922	458497	3760	0.0	121.9406914893617
chr16	SNTB2	69260049	69260260	0	212	28812	9427	28812	9215	0.0	3.1266413456321214
chr16	SNTB2	69235747	69235833	0	87	28812	9427	28812	9340	0.0	3.084796573875803
chr16	SNTB2	69260049	69260127	0	79	28812	9427	28812	9348	0.0	3.0821566110397947
chr16	SNTB2	69260170	69260260	0	91	28812	9427	28812	9336	0.0	3.0861182519280206
chr16	NIP7	69341179	69341320	25411	142	269165	3074	243754	2932	178.95070422535213	83.13574351978171
chr16	NFAT5	69568494	69568548	51	55	17314	11906	17263	11851	0.9272727272727272	1.4566703231794784
chr16	NFAT5	69646516	69646578	0	63	17314	11906	17314	11843	0.0	1.4619606518618593
chr16	NFAT5	69659726	69659899	264	174	17314	11906	17050	11732	1.5172413793103448	1.453290146607569
chr16	NFAT5	69644796	69644856	0	61	17314	11906	17314	11845	0.0	1.4617138032925285
chr16	WWP2	69783031	69783152	8743	122	33539	8808	24796	8686	71.6639344262295	2.854708726686622
chr16	WWP2	69827893	69828019	0	127	33539	8808	33539	8681	0.0	3.8634949890565604
chr16	CLEC18A	69954333	69954573	513	241	20062	5340	19549	5099	2.128630705394191	3.833888997842714
chr16	CLEC18A	69962739	69962766	0	28	20062	5340	20062	5312	0.0	3.7767319277108435
chr16	PDPR	70114820	70114930	0	111	62796	9700	62796	9589	0.0	6.548753780373344
chr16	PDPR	70131301	70131419	51	119	62796	9700	62745	9581	0.42857142857142855	6.548898862331698
chr16	PDPR	70153390	70153573	14603	184	62796	9700	48193	9516	79.36413043478261	5.064417822614544
chr16	PDPR	70120460	70120719	0	260	62796	9700	62796	9440	0.0	6.652118644067796
chr16	PDPR	70114869	70114930	0	62	62796	9700	62796	9638	0.0	6.515459638929238
chr16	PDPR	70147540	70147673	0	134	62796	9700	62796	9566	0.0	6.564499268241689
chr16	CLEC18C	70177240	70177480	12988	241	54319	4195	41331	3954	53.892116182572614	10.452959028831563
chr16	CLEC18C	70185647	70185674	0	28	54319	4195	54319	4167	0.0	13.035517158627309
chr16	DDX19B	70317495	70317588	320	94	250673	4471	250353	4377	3.404255319148936	57.19739547635367
chr16	DDX19B	70312608	70312657	0	50	250673	4471	250673	4421	0.0	56.700520244288626
chr16	DDX19B	70315968	70316104	51	137	250673	4471	250622	4334	0.3722627737226277	57.82694970004615
chr16	DDX19B	70314901	70314955	0	55	250673	4471	250673	4416	0.0	56.76471920289855
chr16	DDX19A	70361417	70361510	0	94	12443	5294	12443	5200	0.0	2.3928846153846153
chr16	DDX19A	70350556	70350605	0	50	12443	5294	12443	5244	0.0	2.3728070175438596
chr16	DDX19A	70356111	70356247	156	137	12443	5294	12287	5157	1.1386861313868613	2.3825867752569323
chr16	DDX19A	70361417	70361636	0	220	12443	5294	12443	5074	0.0	2.4523058730784393
chr16	DDX19A	70360776	70360894	0	119	12443	5294	12443	5175	0.0	2.4044444444444446
chr16	DDX19A	70347874	70347990	0	117	12443	5294	12443	5177	0.0	2.403515549546069
chr16	DDX19A	70356128	70356247	0	120	12443	5294	12443	5174	0.0	2.4049091611905684
chr16	DDX19A	70364542	70364645	0	104	12443	5294	12443	5190	0.0	2.397495183044316
chr16	FCSK	70462172	70462292	255	121	4898	7256	4643	7135	2.1074380165289255	0.6507358093903294
chr16	FCSK	70465125	70465176	0	52	4898	7256	4898	7204	0.0	0.6799000555247084
chr16	FCSK	70457912	70457975	0	64	4898	7256	4898	7192	0.0	0.6810344827586207
chr16	FCSK	70469151	70469323	0	173	4898	7256	4898	7083	0.0	0.6915148948185798
chr16	FCSK	70465029	70465176	109	148	4898	7256	4789	7108	0.7364864864864865	0.6737478897017445
chr16	FCSK	70476186	70476334	51	149	4898	7256	4847	7107	0.3422818791946309	0.6820036583649922
chr16	SF3B3	70524863	70525017	0	155	168803	8298	168803	8143	0.0	20.72982930124033
chr16	SF3B3	70526586	70526726	51	141	168803	8298	168752	8157	0.3617021276595745	20.687998038494545
chr16	SF3B3	70550649	70550678	0	30	168803	8298	168803	8268	0.0	20.416424770198354
chr16	IL34	70654537	70654671	0	135	172	2241	172	2106	0.0	0.08167141500474834
chr16	CALB2	71374744	71374834	0	91	0	1478	0	1387	0.0	0.0
chr16	CALB2	71385576	71385648	0	73	0	1478	0	1405	0.0	0.0
chr16	IST1	71923287	71923380	0	94	66666	7331	66666	7237	0.0	9.211828105568605
chr16	IST1	71903589	71903676	0	88	66666	7331	66666	7243	0.0	9.204197155874638
chr16	IST1	71920738	71920822	360	85	66666	7331	66306	7246	4.235294117647059	9.150703836599503
chr16	IST1	71903164	71903258	1202	95	66666	7331	65464	7236	12.652631578947368	9.046987285793255
chr16	IST1	71924090	71924281	0	192	66666	7331	66666	7139	0.0	9.338282672643228
chr16	DHODH	72013583	72013770	0	188	91	5708	91	5520	0.0	0.01648550724637681
chr16	DHODH	72015683	72015858	40	176	91	5708	51	5532	0.22727272727272727	0.009219088937093275
chr16	HP	72058564	72058672	2659	109	104142	3591	101483	3482	24.394495412844037	29.145031591039633
chr16	HPR	72064756	72064994	0	239	1530	1930	1530	1691	0.0	0.9047900650502662
chr16	DHX38	72094396	72094454	0	59	357	6143	357	6084	0.0	0.058678500986193295
chr16	AC004943.2	72713946	72713989	0	44	53573	7033	53573	6989	0.0	7.665331234797539
chr16	AC004943.2	72713332	72713416	0	85	53573	7033	53573	6948	0.0	7.710564191134139
chr16	AC004943.2	72781727	72781819	146	93	53573	7033	53427	6940	1.5698924731182795	7.698414985590778
chr16	AC004943.2	72747120	72747182	0	63	53573	7033	53573	6970	0.0	7.68622668579627
chr16	LINC01568	73400138	73400269	0	132	0	6893	0	6761	0.0	0.0
chr16	LINC01568	73420092	73420230	0	139	0	6893	0	6754	0.0	0.0
chr16	LINC01568	73420098	73420230	0	133	0	6893	0	6760	0.0	0.0
chr16	LINC01568	73408186	73408393	0	208	0	6893	0	6685	0.0	0.0
chr16	LINC01568	73404397	73404533	0	137	0	6893	0	6756	0.0	0.0
chr16	LINC01568	73411516	73411562	0	47	0	6893	0	6846	0.0	0.0
chr16	LINC01568	73409680	73409942	0	263	0	6893	0	6630	0.0	0.0
chr16	PSMD7	74299575	74299745	0	171	255	2552	255	2381	0.0	0.10709785804283914
chr16	ZNRF1	75106481	75106571	0	91	10010	6955	10010	6864	0.0	1.4583333333333333
chr16	ZNRF1	75095597	75095750	0	154	10010	6955	10010	6801	0.0	1.4718423761211588
chr16	ZFP1	75152908	75152966	0	59	153	3766	153	3707	0.0	0.04127326679255463
chr16	ZFP1	75166769	75166896	0	128	153	3766	153	3638	0.0	0.04205607476635514
chr16	ZFP1	75166769	75166913	0	145	153	3766	153	3621	0.0	0.04225352112676056
chr16	GABARAPL2	75568036	75568209	0	174	4692	1344	4692	1170	0.0	4.01025641025641
chr16	CNTNAP4	76449714	76449858	0	145	48	6913	48	6768	0.0	0.0070921985815602835
chr16	MON1B	77193450	77193777	0	328	0	6532	0	6204	0.0	0.0
chr16	MON1B	77193436	77193777	0	342	0	6532	0	6190	0.0	0.0
chr16	MON1B	77191475	77191633	0	159	0	6532	0	6373	0.0	0.0
chr16	AC025284.1	77435857	77435920	0	64	0	3386	0	3322	0.0	0.0
chr16	NUDT7	77735393	77735507	0	115	0	1645	0	1530	0.0	0.0
chr16	NUDT7	77736649	77736743	0	95	0	1645	0	1550	0.0	0.0
chr16	NUDT7	77735827	77735986	0	160	0	1645	0	1485	0.0	0.0
chr16	NUDT7	77725430	77725584	0	155	0	1645	0	1490	0.0	0.0
chr16	WWOX	78114975	78115154	0	180	204	4894	204	4714	0.0	0.04327535002121341
chr16	WWOX	78108422	78108487	0	66	204	4894	204	4828	0.0	0.04225352112676056
chr16	WWOX	78164182	78164289	0	108	204	4894	204	4786	0.0	0.04262432093606352
chr16	WWOX	78756939	78757015	0	77	204	4894	204	4817	0.0	0.042350010379904504
chr16	LINC01229	79726356	79726676	0	321	0	9960	0	9639	0.0	0.0
chr16	LINC01229	79796752	79796798	0	47	0	9960	0	9913	0.0	0.0
chr16	LINC01229	79714814	79714887	0	74	0	9960	0	9886	0.0	0.0
chr16	LINC01229	79723528	79723716	0	189	0	9960	0	9771	0.0	0.0
chr16	LINC01229	79687509	79687635	0	127	0	9960	0	9833	0.0	0.0
chr16	LINC01229	79795102	79795297	0	196	0	9960	0	9764	0.0	0.0
chr16	LINC01229	79728888	79728936	0	49	0	9960	0	9911	0.0	0.0
chr16	LINC01229	79747017	79747235	0	219	0	9960	0	9741	0.0	0.0
chr16	LINC01229	79801172	79801326	0	155	0	9960	0	9805	0.0	0.0
chr16	DYNLRB2	80549483	80549651	0	169	0	1486	0	1317	0.0	0.0
chr16	DYNLRB2	80547757	80547847	0	91	0	1486	0	1395	0.0	0.0
chr16	DYNLRB2	80548942	80549651	0	710	0	1486	0	776	0.0	0.0
chr16	CENPN	81017325	81017385	6	61	12013	3581	12007	3520	0.09836065573770492	3.4110795454545455
chr16	CENPN	81022596	81022698	154	103	12013	3581	11859	3478	1.4951456310679612	3.409718228867165
chr16	CENPN	81017757	81017834	1326	78	12013	3581	10687	3503	17.0	3.0508135883528404
chr16	ATMIN	81042280	81042480	0	201	139471	6264	139471	6063	0.0	23.00362856671615
chr16	BCO1	81259675	81259805	0	131	51	2700	51	2569	0.0	0.01985208252238225
chr16	GAN	81354404	81354755	0	352	11589	15711	11589	15359	0.0	0.7545413112832867
chr16	GAN	81351582	81351697	0	116	11589	15711	11589	15595	0.0	0.7431227957678743
chr16	AC099524.1	81740263	81740379	0	117	19551	1867	19551	1750	0.0	11.172
chr16	PLCG2	81858262	81858356	0	95	28325	13417	28325	13322	0.0	2.1261822549166793
chr16	PLCG2	81893708	81893794	0	87	28325	13417	28325	13330	0.0	2.124906226556639
chr16	PLCG2	81900611	81900780	0	170	28325	13417	28325	13247	0.0	2.1382199743338113
chr16	HSD17B2	82068169	82068382	0	214	4	2501	4	2287	0.0	0.0017490161783996502
chr16	CDH13	82639359	82639465	0	107	0	11050	0	10943	0.0	0.0
chr16	CDH13	83032009	83032218	0	210	0	11050	0	10840	0.0	0.0
chr16	CDH13	83125384	83125501	0	118	0	11050	0	10932	0.0	0.0
chr16	CDH13	82705061	82705274	0	214	0	11050	0	10836	0.0	0.0
chr16	CDH13	82719361	82719475	0	115	0	11050	0	10935	0.0	0.0
chr16	CDH13	83023012	83023094	0	83	0	11050	0	10967	0.0	0.0
chr16	MLYCD	83949036	83949107	4936	72	12312	16265	7376	16193	68.55555555555556	0.45550546532452296
chr16	MLYCD	83948210	83948332	257	123	12312	16265	12055	16142	2.089430894308943	0.7468095651096518
chr16	OSGIN1	83953261	83953370	1025	110	35898	5572	34873	5462	9.318181818181818	6.384657634566093
chr16	NECAB2	83980838	83980864	0	27	646	2534	646	2507	0.0	0.25767850019944155
chr16	NECAB2	83997215	83997269	0	55	646	2534	646	2479	0.0	0.26058894715611136
chr16	NECAB2	84000723	84000801	0	79	646	2534	646	2455	0.0	0.26313645621181264
chr16	DNAAF1	84159148	84159211	59	64	6396	3756	6337	3692	0.921875	1.7164138678223184
chr16	DNAAF1	84177513	84177606	0	94	6396	3756	6396	3662	0.0	1.7465865647187329
chr16	ADAD2	84194005	84194221	0	217	102	3985	102	3768	0.0	0.027070063694267517
chr16	ADAD2	84194932	84194980	0	49	102	3985	102	3936	0.0	0.025914634146341462
chr16	ADAD2	84195814	84196044	0	231	102	3985	102	3754	0.0	0.02717101758124667
chr16	ATP2C2	84410703	84410765	0	63	204	6756	204	6693	0.0	0.03047960555804572
chr16	ATP2C2	84459505	84459592	0	88	204	6756	204	6668	0.0	0.03059388122375525
chr16	ATP2C2	84459269	84459386	0	118	204	6756	204	6638	0.0	0.03073214823742091
chr16	ATP2C2	84410679	84410765	0	87	204	6756	204	6669	0.0	0.030589293747188485
chr16	USP10	84733052	84733105	0	54	107200	4768	107200	4714	0.0	22.74077216801018
chr16	USP10	84740308	84740369	0	62	107200	4768	107200	4706	0.0	22.779430514237145
chr16	USP10	84704739	84704860	0	122	107200	4768	107200	4646	0.0	23.073611708996985
chr16	USP10	84772540	84772685	92	146	107200	4768	107108	4622	0.6301369863013698	23.173517957594115
chr16	USP10	84775159	84775225	0	67	107200	4768	107200	4701	0.0	22.80365879600085
chr16	USP10	84744632	84745673	1889	1042	107200	4768	105311	3726	1.8128598848368522	28.2638217928073
chr16	USP10	84732467	84732589	0	123	107200	4768	107200	4645	0.0	23.078579117330463
chr16	CRISPLD2	84836176	84836435	31	260	30599	7982	30568	7722	0.11923076923076924	3.9585599585599587
chr16	KIAA0513	85082563	85082593	0	31	3578	8851	3578	8820	0.0	0.4056689342403628
chr16	KIAA0513	85081314	85081392	0	79	3578	8851	3578	8772	0.0	0.40788873689010485
chr16	GSE1	85665014	85665128	44	115	4008	12710	3964	12595	0.3826086956521739	0.3147280666931322
chr16	GSE1	85633913	85634132	0	220	4008	12710	4008	12490	0.0	0.32089671737389913
chr16	GSE1	85672181	85672309	22	129	4008	12710	3986	12581	0.17054263565891473	0.3168269612908354
chr16	COX4I1	85801204	85801278	0	75	9255	1997	9255	1922	0.0	4.815296566077003
chr16	COX4I1	85804539	85804661	259	123	9255	1997	8996	1874	2.105691056910569	4.80042689434365
chr16	COX4I1	85801183	85801278	0	96	9255	1997	9255	1901	0.0	4.868490268279853
chr16	IRF8	85900927	85901246	0	320	51	4561	51	4241	0.0	0.01202546569205376
chr16	LINC02188	86736507	86736764	0	258	0	5791	0	5533	0.0	0.0
chr16	LINC02188	86727867	86727967	0	101	0	5791	0	5690	0.0	0.0
chr16	MAP1LC3B	87399597	87399686	70	90	13541	5043	13471	4953	0.7777777777777778	2.719765798505956
chr16	AC092720.3	87495518	87495713	0	196	2903	2669	2903	2473	0.0	1.1738778811160533
chr16	BANP	87975047	87975185	0	139	20852	7681	20852	7542	0.0	2.7647838769557147
chr16	BANP	88004294	88004411	187	118	20852	7681	20665	7563	1.5847457627118644	2.7323813301599893
chr16	BANP	88065266	88065332	0	67	20852	7681	20852	7614	0.0	2.7386393485684266
chr16	BANP	87978439	87978692	0	254	20852	7681	20852	7427	0.0	2.807593914097213
chr16	BANP	87952180	87952273	0	94	20852	7681	20852	7587	0.0	2.7483853960722286
chr16	BANP	88003481	88003563	78	83	20852	7681	20774	7598	0.9397590361445783	2.7341405633061333
chr16	ZFPM1	88489030	88489153	0	124	0	5882	0	5758	0.0	0.0
chr16	ZC3H18	88587541	88587613	0	73	5836	7150	5836	7077	0.0	0.824643210399887
chr16	SNAI3-AS1	88671565	88671693	0	129	72147	5297	72147	5168	0.0	13.960332817337461
chr16	CTU2	88715047	88715106	985	60	564993	3247	564008	3187	16.416666666666668	176.97144650141198
chr16	CTU2	88709937	88710016	41538	80	564993	3247	523455	3167	519.225	165.2841806125671
chr16	TRAPPC2L	88859344	88859443	77	100	2271	3018	2194	2918	0.77	0.7518848526387937
chr16	TRAPPC2L	88859344	88859750	969	407	2271	3018	1302	2611	2.380835380835381	0.49865951742627346
chr16	TRAPPC2L	88859572	88859750	561	179	2271	3018	1710	2839	3.1340782122905027	0.6023247622402255
chr16	ACSF3	89098590	89098763	0	174	182	8565	182	8391	0.0	0.021689905851507568
chr16	ACSF3	89114338	89114487	0	150	182	8565	182	8415	0.0	0.02162804515745692
chr16	ACSF3	89100661	89101347	0	687	182	8565	182	7878	0.0	0.0231023102310231
chr16	ACSF3	89095194	89095303	0	110	182	8565	182	8455	0.0	0.021525724423418095
chr16	ZNF778	89222091	89222183	306	93	5739	11351	5433	11258	3.2903225806451615	0.4825901581097886
chr16	ZNF778	89223156	89223283	1	128	5739	11351	5738	11223	0.0078125	0.5112714960349283
chr16	ZNF778	89224718	89224802	0	85	5739	11351	5739	11266	0.0	0.5094088407598083
chr16	AC137932.2	89323765	89323920	0	156	2717	1364	2717	1208	0.0	2.2491721854304636
chr16	SPG7	89529476	89529579	51	104	25176	18796	25125	18692	0.49038461538461536	1.3441579285255725
chr16	SPG7	89531903	89532066	358	164	25176	18796	24818	18632	2.182926829268293	1.332009446114212
chr16	SPG7	89544647	89544772	752	126	25176	18796	24424	18670	5.968253968253968	1.3081949651847884
chr16	SPG7	89548002	89548113	75	112	25176	18796	25101	18684	0.6696428571428571	1.3434489402697496
chr16	SPG7	89510489	89510592	99	104	25176	18796	25077	18692	0.9519230769230769	1.3415899850203294
chr16	SPG7	89546657	89546760	51	104	25176	18796	25125	18692	0.49038461538461536	1.3441579285255725
chr16	SPG7	89524005	89524247	575	243	25176	18796	24601	18553	2.366255144032922	1.3259850159003934
chr16	SPG7	89531924	89532066	292	143	25176	18796	24884	18653	2.041958041958042	1.3340481423899642
chr16	SPG7	89526757	89527023	81	267	25176	18796	25095	18529	0.30337078651685395	1.354363430298451
chr16	SPG7	89545871	89546030	0	160	25176	18796	25176	18636	0.0	1.3509336767546685
chr16	SPG7	89526328	89526468	0	141	25176	18796	25176	18655	0.0	1.3495577593138568
chr16	SPG7	89529134	89529524	30	391	25176	18796	25146	18405	0.07672634271099744	1.3662591687041565
chr16	SPG7	89528631	89529524	816	894	25176	18796	24360	17902	0.912751677852349	1.3607418165568093
chr16	SPG7	89540943	89541384	769	442	25176	18796	24407	18354	1.739819004524887	1.3297918709818024
chr16	SPG7	89545871	89546181	0	311	25176	18796	25176	18485	0.0	1.3619691641871787
chr16	SPG7	89555877	89556085	0	209	25176	18796	25176	18587	0.0	1.3544950772044977
chr16	SPG7	89536764	89536948	0	185	25176	18796	25176	18611	0.0	1.3527483746171618
chr16	SPG7	89545871	89545979	0	109	25176	18796	25176	18687	0.0	1.3472467490768985
chr16	SPG7	89546131	89546181	0	51	25176	18796	25176	18745	0.0	1.3430781541744465
chr16	SPG7	89528631	89529579	867	949	25176	18796	24309	17847	0.9135932560590094	1.362077660110943
chr16	SPG7	89519977	89520255	444	279	25176	18796	24732	18517	1.5913978494623655	1.3356375222768266
chr16	SPG7	89540943	89542279	769	1337	25176	18796	24407	17459	0.575168287210172	1.397960937052523
chr16	SPG7	89540943	89541346	769	404	25176	18796	24407	18392	1.9034653465346534	1.3270443671161374
chr16	SPG7	89548979	89549336	164	358	25176	18796	25012	18438	0.4581005586592179	1.3565462631521856
chr16	SPG7	89545871	89545995	0	125	25176	18796	25176	18671	0.0	1.3484012639922875
chr16	SPG7	89546131	89546187	0	57	25176	18796	25176	18739	0.0	1.3435081914723304
chr16	SPG7	89549499	89549713	153	215	25176	18796	25023	18581	0.7116279069767442	1.3466982401377752
chr16	SPG7	89555920	89556085	0	166	25176	18796	25176	18630	0.0	1.3513687600644122
chr16	SPG7	89548426	89549713	1479	1288	25176	18796	23697	17508	1.1482919254658386	1.353495544893763
chr16	SPG7	89549080	89549336	102	257	25176	18796	25074	18539	0.3968871595330739	1.352500134850855
chr16	SPG7	89555958	89556085	0	128	25176	18796	25176	18668	0.0	1.3486179558602958
chr16	RPL13	89560939	89561063	202	125	8832	3088	8630	2963	1.616	2.912588592642592
chr16	RPL13	89560953	89561063	119	111	8832	3088	8713	2977	1.072072072072072	2.9267719180382934
chr16	CPNE7	89591126	89591260	0	135	150901	3078	150901	2943	0.0	51.27454977913693
chr16	CPNE7	89578856	89578996	0	141	150901	3078	150901	2937	0.0	51.379298604017706
chr16	CPNE7	89583443	89583528	3554	86	150901	3078	147347	2992	41.325581395348834	49.24699197860963
chr16	CPNE7	89587555	89587582	1814	28	150901	3078	149087	3050	64.78571428571429	48.88098360655738
chr16	CPNE7	89595830	89595924	18922	95	150901	3078	131979	2983	199.17894736842106	44.24371438149514
chr16	DPEP1	89630304	89630514	19211	211	31531	2727	12320	2516	91.04739336492891	4.896661367249602
chr16	CDK10	89694664	89694788	31	125	189	5398	158	5273	0.248	0.029963967380997533
chr16	CDK10	89687588	89687815	0	228	189	5398	189	5170	0.0	0.03655705996131528
chr16	CDK10	89689251	89689324	0	74	189	5398	189	5324	0.0	0.035499624342599546
chr16	CDK10	89687448	89687548	0	101	189	5398	189	5297	0.0	0.03568057390976024
chr16	CDK10	89694568	89694788	31	221	189	5398	158	5177	0.14027149321266968	0.03051960594939154
chr16	SPIRE2	89868188	89868216	33	29	224721	7580	224688	7551	1.1379310344827587	29.756058800158918
chr16	SPIRE2	89836214	89836433	90042	220	224721	7580	134679	7360	409.2818181818182	18.298777173913045
chr16	SPIRE2	89869566	89869682	6781	117	224721	7580	217940	7463	57.957264957264954	29.202733485193622
chr16	TCF25	89887651	89887717	0	67	41425	6664	41425	6597	0.0	6.279369410338033
chr16	TCF25	89893727	89893858	0	132	41425	6664	41425	6532	0.0	6.341855480710349
chr16	TCF25	89907242	89907322	0	81	41425	6664	41425	6583	0.0	6.292723682211758
chr16	TCF25	89908965	89909083	408	119	41425	6664	41017	6545	3.4285714285714284	6.266921313980138
chr16	TCF25	89887651	89887681	0	31	41425	6664	41425	6633	0.0	6.245288707975275
chr16	TCF25	89878460	89878627	108	168	41425	6664	41317	6496	0.6428571428571429	6.360375615763547
chr16	TUBB3	89931800	89931939	3980	140	45431	4255	41451	4115	28.428571428571427	10.07314702308627
chr16	TUBB3	89934329	89934575	2978	247	45431	4255	42453	4008	12.05668016194332	10.592065868263473
chr16	TUBB3	89933138	89933367	691	230	45431	4255	44740	4025	3.0043478260869567	11.11552795031056
chr16	TUBB3	89933114	89933367	775	254	45431	4255	44656	4001	3.0511811023622046	11.161209697575606
chr16	DEF8	89954242	89954376	1071	135	142694	5553	141623	5418	7.933333333333334	26.13935031376892
chr16	DEF8	89950066	89950306	390	241	142694	5553	142304	5312	1.6182572614107884	26.789156626506024
chr16	DEF8	89949419	89949513	745	95	142694	5553	141949	5458	7.842105263157895	26.007511909124222
chr16	DEF8	89954288	89954376	621	89	142694	5553	142073	5464	6.977528089887641	26.001647144948755
chr16	DEF8	89949416	89949513	748	98	142694	5553	141946	5455	7.63265306122449	26.021264894592118
chr16	DEF8	89949564	89949638	112	75	142694	5553	142582	5478	1.4933333333333334	26.028112449799195
chr16	DEF8	89949416	89949638	1229	223	142694	5553	141465	5330	5.511210762331839	26.54127579737336
chr16	DEF8	89950066	89950328	561	263	142694	5553	142133	5290	2.1330798479087454	26.868241965973535
chr16	DEF8	89952557	89952682	51	126	142694	5553	142643	5427	0.40476190476190477	26.28395061728395
chr16	DEF8	89952561	89952682	51	122	142694	5553	142643	5431	0.4180327868852459	26.264592156140672
chr16	AFG3L1P	89977638	89977802	8632	165	4130458	8480	4121826	8315	52.31515151515151	495.7096812988575
chr16	AFG3L1P	89977677	89977802	7143	126	4130458	8480	4123315	8354	56.69047619047619	493.5737371319129
chr16	AFG3L1P	89978809	89978878	296	70	4130458	8480	4130162	8410	4.228571428571429	491.1013079667063
chr16	AFG3L1P	89977604	89977802	9929	199	4130458	8480	4120529	8281	49.89447236180904	497.5883347421809
chr16	AFG3L1P	89988851	89988951	360	101	4130458	8480	4130098	8379	3.5643564356435644	492.9106098579783
chr16	AFG3L1P	89991228	89991383	0	156	4130458	8480	4130458	8324	0.0	496.21071600192215
chr16	GAS8	90035632	90035687	70	56	247839	5447	247769	5391	1.25	45.95974772769431
chr16	GAS8	90031175	90031189	150	15	247839	5447	247689	5432	10.0	45.59812223858616
chr16	GAS8	90027635	90027722	0	88	247839	5447	247839	5359	0.0	46.24724762082478
chr16	FAM157C	90111375	90111485	596	111	35161	7152	34565	7041	5.36936936936937	4.909103820480046
chr16	FAM157C	90111371	90111485	648	115	35161	7152	34513	7037	5.6347826086956525	4.904504760551371
chr16	LINC02193	90194120	90194225	81	106	5807	4443	5726	4337	0.7641509433962265	1.320267465990316
chr16	LINC02193	90222243	90222292	16	50	5807	4443	5791	4393	0.32	1.318233553380378
chr16	LINC02193	90222243	90222296	16	54	5807	4443	5791	4389	0.2962962962962963	1.3194349510138983
chr16	RHBDF1	64332	64437	2381	106	5493	4192	3112	4086	22.462264150943398	0.7616250611845325
chr16	NPRL3	110524	110606	4044	83	35931	5493	31887	5410	48.72289156626506	5.894085027726432
chr16	NPRL3	117300	117375	133	76	35931	5493	35798	5417	1.75	6.608454864316042
chr16	NPRL3	119125	119255	0	131	35931	5493	35931	5362	0.0	6.701044386422977
chr16	NPRL3	130521	130591	171	71	35931	5493	35760	5422	2.408450704225352	6.595352268535596
chr16	NPRL3	138149	138334	0	186	35931	5493	35931	5307	0.0	6.770491803278689
chr16	NPRL3	123506	123545	0	40	35931	5493	35931	5453	0.0	6.589216944801027
chr16	NPRL3	124936	125073	49	138	35931	5493	35882	5355	0.35507246376811596	6.700653594771242
chr16	LUC7L	199061	199238	0	178	5993	6101	5993	5923	0.0	1.0118183353030559
chr16	LUC7L	228332	228402	0	71	5993	6101	5993	6030	0.0	0.9938640132669984
chr16	LUC7L	208600	208664	0	65	5993	6101	5993	6036	0.0	0.9928760768721008
chr16	RGS11	272862	272931	0	70	26270	4272	26270	4202	0.0	6.251784864350309
chr16	RGS11	274975	275082	0	108	26270	4272	26270	4164	0.0	6.308837656099904
chr16	AXIN1	291189	291297	0	109	77635	3776	77635	3667	0.0	21.17125715844014
chr16	AXIN1	346147	347106	8357	960	77635	3776	69278	2816	8.705208333333333	24.6015625
chr16	PGAP6	372610	372727	47	118	1703	4443	1656	4325	0.3983050847457627	0.3828901734104046
chr16	PGAP6	377670	377848	0	179	1703	4443	1703	4264	0.0	0.39939024390243905
chr16	METTL26	634888	634956	0	69	3671	1123	3671	1054	0.0	3.48292220113852
chr16	METTL26	635280	635340	0	61	3671	1123	3671	1062	0.0	3.4566854990583806
chr16	METTL26	635611	635774	1275	164	3671	1123	2396	959	7.774390243902439	2.4984358706986445
chr16	METTL26	634888	635063	0	176	3671	1123	3671	947	0.0	3.8764519535374866
chr16	METTL26	635517	635774	1425	258	3671	1123	2246	865	5.523255813953488	2.5965317919075144
chr16	JMJD8	682952	683087	0	136	7250	2400	7250	2264	0.0	3.202296819787986
chr16	JMJD8	684065	684155	0	91	7250	2400	7250	2309	0.0	3.13988739714162
chr16	JMJD8	682957	683087	0	131	7250	2400	7250	2269	0.0	3.1952401939180257
chr16	WDR24	687826	688048	0	223	218198	3327	218198	3104	0.0	70.2957474226804
chr16	CCDC78	725412	725580	139	169	249184	2919	249045	2750	0.8224852071005917	90.56181818181818
chr16	CCDC78	725445	725580	106	136	249184	2919	249078	2783	0.7794117647058824	89.499820337765
chr16	CIAO3	736265	736398	53	134	487970	6627	487917	6493	0.39552238805970147	75.14507931618667
chr16	CIAO3	740021	740103	1423	83	487970	6627	486547	6544	17.14457831325301	74.35009168704157
chr16	CIAO3	737497	737695	4898	199	487970	6627	483072	6428	24.613065326633166	75.15121344119477
chr16	RPUSD1	787076	787179	0	104	15436	2764	15436	2660	0.0	5.803007518796992
chr16	RPUSD1	787555	787744	1369	190	15436	2764	14067	2574	7.205263157894737	5.465034965034965
chr16	RPUSD1	787067	787179	0	113	15436	2764	15436	2651	0.0	5.82270841192003
chr16	RPUSD1	787555	787645	465	91	15436	2764	14971	2673	5.1098901098901095	5.600823045267489
chr16	LMF1	931641	931793	0	153	1722	8238	1722	8085	0.0	0.21298701298701297
chr16	LMF1	855106	856055	0	950	1722	8238	1722	7288	0.0	0.2362788144895719
chr16	LMF1	933990	934145	0	156	1722	8238	1722	8082	0.0	0.21306607275426875
chr16	CEROX1	976326	976400	0	75	1435	2975	1435	2900	0.0	0.49482758620689654
chr16	CEROX1	979600	979758	0	159	1435	2975	1435	2816	0.0	0.5095880681818182
chr16	CEROX1	979600	979763	0	164	1435	2975	1435	2811	0.0	0.5104944859480612
chr16	TSR3	1349888	1349952	0	65	0	1216	0	1151	0.0	0.0
chr16	UNKL	1371518	1371611	444	94	261720	4550	261276	4456	4.723404255319149	58.63464991023339
chr16	CCDC154	1435968	1436086	1404	119	10122	2440	8718	2321	11.798319327731093	3.7561395950021543
chr16	CLCN7	1465266	1465338	0	73	6721	7637	6721	7564	0.0	0.888551031200423
chr16	HAGH	1819114	1819223	926	110	348055	5851	347129	5741	8.418181818181818	60.464901585089706
chr16	HAGH	1826506	1826602	1477	97	348055	5851	346578	5754	15.22680412371134	60.23253388946819
chr16	MEIOB	1837783	1837870	9475	88	51188	2319	41713	2231	107.67045454545455	18.696996862393547
chr16	MEIOB	1865777	1865835	1005	59	51188	2319	50183	2260	17.033898305084747	22.20486725663717
chr16	MEIOB	1868106	1868184	0	79	51188	2319	51188	2240	0.0	22.851785714285715
chr16	LINC00254	1879660	1879709	724	50	124186	717	123462	667	14.48	185.10044977511245
chr16	MSRB1	1940777	1940892	0	116	51	2025	51	1909	0.0	0.02671555788370875
chr16	MSRB1	1941028	1941167	0	140	51	2025	51	1885	0.0	0.027055702917771884
chr16	RPS2	1962496	1962656	0	161	51	1934	51	1773	0.0	0.028764805414551606
chr16	RPS2	1962735	1962909	0	175	51	1934	51	1759	0.0	0.028993746446844798
chr16	RPS2	1963148	1963256	0	109	51	1934	51	1825	0.0	0.027945205479452055
chr16	RPS2	1964275	1964365	0	91	51	1934	51	1843	0.0	0.027672273467173086
chr16	RPS2	1964448	1964628	0	181	51	1934	51	1753	0.0	0.029092983456930975
chr16	RPS2	1963652	1963839	0	188	51	1934	51	1746	0.0	0.029209621993127148
chr16	AC005606.2	1988957	1989112	36902	156	38709	2294	1807	2138	236.55128205128204	0.8451824134705332
chr16	ZNF598	1998964	1999121	0	158	223414	4333	223414	4175	0.0	53.51233532934132
chr16	NTHL1	2044629	2044800	6	172	54124	1666	54118	1494	0.03488372093023256	36.223560910307896
chr16	NTHL1	2042001	2042146	1072	146	54124	1666	53052	1520	7.342465753424658	34.90263157894737
chr16	PKD1	2091422	2091597	969	176	208723	16200	207754	16024	5.505681818181818	12.965177234148777
chr16	PKD1	2092953	2093093	324	141	208723	16200	208399	16059	2.297872340425532	12.97708450090292
chr16	PKD1	2099643	2099770	0	128	208723	16200	208723	16072	0.0	12.986747137879542
chr16	PKD1	2116832	2117053	0	222	208723	16200	208723	15978	0.0	13.063149330329203
chr16	PKD1	2116832	2117016	0	185	208723	16200	208723	16015	0.0	13.03296909147674
chr16	PKD1	2111815	2111871	132	57	208723	16200	208591	16143	2.3157894736842106	12.921452022548474
chr16	RNPS1	2255584	2255726	0	143	525759	7319	525759	7176	0.0	73.2663043478261
chr16	RNPS1	2264572	2264760	5566	189	525759	7319	520193	7130	29.44973544973545	72.95834502103787
chr16	RNPS1	2267174	2267237	0	64	525759	7319	525759	7255	0.0	72.46850447966919
chr16	RNPS1	2266109	2266216	0	108	525759	7319	525759	7211	0.0	72.91069199833588
chr16	RNPS1	2267174	2267218	0	45	525759	7319	525759	7274	0.0	72.27921363761342
chr16	RNPS1	2267188	2267237	0	50	525759	7319	525759	7269	0.0	72.32893107717706
chr16	ABCA3	2308449	2308623	2498	175	221510	7825	219012	7650	14.274285714285714	28.629019607843137
chr16	ERVK13-1	2671344	2672570	5944	1227	42024	6668	36080	5441	4.844335778321108	6.631133982723764
chr16	ERVK13-1	2663083	2663407	612	325	42024	6668	41412	6343	1.883076923076923	6.528771874507331
chr16	ERVK13-1	2670863	2670974	112	112	42024	6668	41912	6556	1.0	6.392922513727883
chr16	ERVK13-1	2669410	2669561	1894	152	42024	6668	40130	6516	12.460526315789474	6.158686310620013
chr16	ERVK13-1	2672706	2672859	3619	154	42024	6668	38405	6514	23.5	5.8957629720601785
chr16	ERVK13-1	2669410	2672570	12467	3161	42024	6668	29557	3507	3.9440050616893387	8.42800114057599
chr16	ERVK13-1	2671023	2671231	380	209	42024	6668	41644	6459	1.8181818181818181	6.447437683851989
chr16	ERVK13-1	2672706	2672976	4213	271	42024	6668	37811	6397	15.546125461254613	5.9107394090980145
chr16	ERVK13-1	2671344	2671735	4242	392	42024	6668	37782	6276	10.821428571428571	6.020076481835564
chr16	ERVK13-1	2667962	2668040	44	79	42024	6668	41980	6589	0.5569620253164557	6.37122476855365
chr16	ERVK13-1	2663083	2663430	612	348	42024	6668	41412	6320	1.7586206896551724	6.55253164556962
chr16	ERVK13-1	2671594	2672570	2438	977	42024	6668	39586	5691	2.49539406345957	6.955895273238447
chr16	ERVK13-1	2670809	2670974	257	166	42024	6668	41767	6502	1.5481927710843373	6.423715779760074
chr16	ERVK13-1	2671103	2671231	220	129	42024	6668	41804	6539	1.7054263565891472	6.393026456644747
chr16	PRSS27	2715717	2715880	1931	164	57939	5155	56008	4991	11.774390243902438	11.221799238629533
chr16	SRRM2-AS1	2740957	2741341	305	385	61299	5093	60994	4708	0.7922077922077922	12.955395072217502
chr16	SRRM2-AS1	2738441	2738500	0	60	61299	5093	61299	5033	0.0	12.179415855354659
chr16	ELOB	2775450	2775556	0	107	102	1115	102	1008	0.0	0.10119047619047619
chr16	ELOB	2775450	2775625	0	176	102	1115	102	939	0.0	0.10862619808306709
chr16	PRSS33	2785374	2785646	0	273	0	2118	0	1845	0.0	0.0
chr16	PRSS33	2786088	2786121	0	34	0	2118	0	2084	0.0	0.0
chr16	PRSS30P	2841572	2841599	0	28	51	1785	51	1757	0.0	0.02902675014228799
chr16	PKMYT1	2975981	2976089	0	109	33913	4989	33913	4880	0.0	6.949385245901639
chr16	HCFC1R1	3023473	3023530	1234	58	198078	1068	196844	1010	21.275862068965516	194.8950495049505
chr16	HCFC1R1	3023846	3023968	465	123	198078	1068	197613	945	3.7804878048780486	209.11428571428573
chr16	BICDL2	3031409	3031508	0	100	122490	4458	122490	4358	0.0	28.106929784304725
chr16	MMP25-AS1	3058539	3058702	300	164	14381	4858	14081	4694	1.829268292682927	2.99978696207925
chr16	ZSCAN10	3092048	3092316	0	269	34	3080	34	2811	0.0	0.012095339736748489
chr16	ZSCAN10	3092541	3093004	0	464	34	3080	34	2616	0.0	0.012996941896024464
chr16	ZSCAN10	3092676	3093004	0	329	34	3080	34	2751	0.0	0.012359142130134497
chr16	ZSCAN10	3093267	3093358	34	92	34	3080	0	2988	0.3695652173913043	0.0
chr16	ZNF213-AS1	3124486	3124898	0	413	6634	9872	6634	9459	0.0	0.7013426366423512
chr16	ZNF213-AS1	3129247	3129310	0	64	6634	9872	6634	9808	0.0	0.6763866231647635
chr16	ZNF213-AS1	3132849	3133194	0	346	6634	9872	6634	9526	0.0	0.6964098257400798
chr16	ZNF213-AS1	3132849	3132945	0	97	6634	9872	6634	9775	0.0	0.6786700767263427
chr16	MEFV	3244472	3244588	0	117	2408	4838	2408	4721	0.0	0.5100614276636306
chr16	MEFV	3254157	3254790	0	634	2408	4838	2408	4204	0.0	0.5727878211227403
chr16	MEFV	3251956	3252049	306	94	2408	4838	2102	4744	3.25531914893617	0.4430860033726813
chr16	MEFV	3248464	3248562	357	99	2408	4838	2051	4739	3.606060606060606	0.4327917282127031
chr16	MEFV	3247015	3247246	0	232	2408	4838	2408	4606	0.0	0.5227963525835866
chr16	MEFV	3244253	3244286	0	34	2408	4838	2408	4804	0.0	0.5012489592006661
chr16	ZSCAN32	3397191	3397744	0	554	52	3334	52	2780	0.0	0.01870503597122302
chr16	ZSCAN32	3393648	3393814	0	167	52	3334	52	3167	0.0	0.016419324281654563
chr16	ZSCAN32	3390009	3390183	0	175	52	3334	52	3159	0.0	0.01646090534979424
chr16	ZSCAN32	3390422	3390517	0	96	52	3334	52	3238	0.0	0.01605929586164299
chr16	NLRC3	3548669	3548753	49	85	2372	6710	2323	6625	0.5764705882352941	0.3506415094339623
chr16	NLRC3	3555780	3555916	0	137	2372	6710	2372	6573	0.0	0.3608702266849232
chr16	TRAP1	3672699	3672820	0	122	32424	5144	32424	5022	0.0	6.456391875746714
chr16	TRAP1	3690826	3690985	2668	160	32424	5144	29756	4984	16.675	5.970304975922954
chr16	TRAP1	3710384	3710453	3947	70	32424	5144	28477	5074	56.385714285714286	5.612337406385494
chr16	TRAP1	3689714	3689811	0	98	32424	5144	32424	5046	0.0	6.425683709869204
chr16	TRAP1	3704219	3704334	1859	116	32424	5144	30565	5028	16.025862068965516	6.07895783611774
chr16	CREBBP	3738558	3738672	0	115	1051949	15252	1051949	15137	0.0	69.49521041157429
chr16	CREBBP	3777612	3777657	2595	46	1051949	15252	1049354	15206	56.41304347826087	69.00920689201631
chr16	CREBBP	3791980	3792094	0	115	1051949	15252	1051949	15137	0.0	69.49521041157429
chr16	CREBBP	3739577	3739724	0	148	1051949	15252	1051949	15104	0.0	69.6470471398305
chr16	ADCY9	3992145	3992363	0	219	8669	9168	8669	8949	0.0	0.9687115878869147
chr16	ADCY9	4007367	4007558	0	192	8669	9168	8669	8976	0.0	0.9657976827094474
chr16	ADCY9	3992145	3992270	0	126	8669	9168	8669	9042	0.0	0.9587480645874806
chr16	SRL	4206726	4208104	102	1379	147	5710	45	4331	0.07396664249456128	0.010390210113137843
chr16	LINC01569	4251321	4252034	0	714	51	2431	51	1717	0.0	0.0297029702970297
chr16	TFAP4	4268047	4268081	0	35	153	6909	153	6874	0.0	0.022257782950247308
chr16	PAM16	4343206	4343291	0	86	21	2128	21	2042	0.0	0.01028403525954946
chr16	CORO7	4357967	4358103	0	137	13299	7153	13299	7016	0.0	1.8955245153933866
chr16	CORO7	4413307	4413404	0	98	13299	7153	13299	7055	0.0	1.8850460666194189
chr16	CORO7	4361748	4361803	0	56	13299	7153	13299	7097	0.0	1.8738903762153023
chr16	CORO7	4415714	4415852	0	139	13299	7153	13299	7014	0.0	1.89606501283148
chr16	CORO7	4416458	4416600	0	143	13299	7153	13299	7010	0.0	1.8971469329529245
chr16	CORO7	4397317	4397450	200	134	13299	7153	13099	7019	1.492537313432836	1.866220259296196
chr16	CORO7	4412355	4412430	0	76	13299	7153	13299	7077	0.0	1.8791860958033064
chr16	NMRAL1	4463419	4463512	0	94	5841	3199	5841	3105	0.0	1.8811594202898552
chr16	NMRAL1	4471313	4471449	101	137	5841	3199	5740	3062	0.7372262773722628	1.8745917700849117
chr16	NMRAL1	4471356	4471449	101	94	5841	3199	5740	3105	1.074468085106383	1.8486312399355878
chr16	CDIP1	4512790	4513064	2798	275	190098	2499	187300	2224	10.174545454545454	84.21762589928058
chr16	CDIP1	4514045	4514144	604	100	190098	2499	189494	2399	6.04	78.98874531054607
chr16	CDIP1	4512790	4512947	2596	158	190098	2499	187502	2341	16.430379746835442	80.0948312686886
chr16	CDIP1	4512790	4512998	2606	209	190098	2499	187492	2290	12.4688995215311	81.87423580786026
chr16	CDIP1	4536439	4536768	1143	330	190098	2499	188955	2169	3.463636363636364	87.11618257261411
chr16	UBALD1	4610492	4610656	0	165	255	2587	255	2422	0.0	0.10528488852188274
chr16	UBALD1	4610492	4610555	0	64	255	2587	255	2523	0.0	0.10107015457788347
chr16	ANKS3	4726658	4726780	999	123	48341	6948	47342	6825	8.121951219512194	6.936556776556777
chr16	ANKS3	4726978	4727177	468	200	48341	6948	47873	6748	2.34	7.094398340248962
chr16	ANKS3	4724749	4724831	20	83	48341	6948	48321	6865	0.24096385542168675	7.038747268754552
chr16	ANKS3	4729979	4730151	9475	173	48341	6948	38866	6775	54.76878612716763	5.736678966789668
chr16	ANKS3	4731511	4731579	2845	69	48341	6948	45496	6879	41.231884057971016	6.61375199883704
chr16	ANKS3	4726658	4726854	1067	197	48341	6948	47274	6751	5.416243654822335	7.0025181454599315
chr16	ANKS3	4717442	4717547	0	106	48341	6948	48341	6842	0.0	7.0653317743349895
chr16	ANKS3	4726658	4726776	999	119	48341	6948	47342	6829	8.394957983193278	6.932493776541222
chr16	SEPTIN12	4783930	4784068	738	139	3786	1954	3048	1815	5.309352517985611	1.6793388429752065
chr16	ROGDI	4797937	4797987	0	51	53447	2850	53447	2799	0.0	19.095033940693106
chr16	ROGDI	4798568	4798667	0	100	53447	2850	53447	2750	0.0	19.43527272727273
chr16	ROGDI	4801266	4801321	971	56	53447	2850	52476	2794	17.339285714285715	18.78167501789549
chr16	ROGDI	4802381	4802453	1685	73	53447	2850	51762	2777	23.08219178082192	18.639539070939865
chr16	ROGDI	4798568	4798801	103	234	53447	2850	53344	2616	0.44017094017094016	20.3914373088685
chr16	ROGDI	4801049	4801321	12545	273	53447	2850	40902	2577	45.95238095238095	15.871944121071012
chr16	GLYR1	4831978	4832221	0	244	14989	5290	14989	5046	0.0	2.9704716607213633
chr16	GLYR1	4821546	4821597	0	52	14989	5290	14989	5238	0.0	2.8615883925162278
chr16	GLYR1	4843403	4843602	0	200	14989	5290	14989	5090	0.0	2.944793713163065
chr16	NAGPA	5031744	5031884	0	141	204	4883	204	4742	0.0	0.04301982285955293
chr16	NAGPA	5027277	5027379	5	103	204	4883	199	4780	0.04854368932038835	0.04163179916317992
chr16	NAGPA	5028296	5028398	51	103	204	4883	153	4780	0.49514563106796117	0.03200836820083682
chr16	NAGPA	5028296	5028365	41	70	204	4883	163	4813	0.5857142857142857	0.03386661126116767
chr16	NAGPA	5032990	5033155	0	166	204	4883	204	4717	0.0	0.043247827008691966
chr16	C16ORF89	5055686	5055782	0	97	0	2076	0	1979	0.0	0.0
chr16	EEF2KMT	5090083	5090349	0	267	51	2853	51	2586	0.0	0.019721577726218097
chr16	EEF2KMT	5091793	5091895	0	103	51	2853	51	2750	0.0	0.018545454545454546
chr16	EEF2KMT	5093483	5093564	0	82	51	2853	51	2771	0.0	0.018404907975460124
chr16	EEF2KMT	5090431	5090565	0	135	51	2853	51	2718	0.0	0.018763796909492272
chr16	EEF2KMT	5097279	5097353	0	75	51	2853	51	2778	0.0	0.0183585313174946
chr16	LINC01570	5613399	5613506	0	108	0	3791	0	3683	0.0	0.0
chr16	AC093515.1	7977828	7977898	0	71	0	2683	0	2612	0.0	0.0
chr16	TMEM114	8572086	8572224	0	139	0	1425	0	1286	0.0	0.0
chr16	CARHSP1	8860104	8860218	0	115	51	4936	51	4821	0.0	0.010578718108276292
chr16	USP7	8900989	8901057	908	69	86953	8661	86045	8592	13.159420289855072	10.014548417132216
chr16	USP7	8929368	8929543	482	176	86953	8661	86471	8485	2.7386363636363638	10.191043017088981
chr16	USP7	8900529	8900630	3812	102	86953	8661	83141	8559	37.372549019607845	9.713868442575068
chr16	GRIN2A	9768850	9769089	0	240	2073	11177	2073	10937	0.0	0.18954009326140622
chr16	TVP23A	10771669	10771798	0	130	0	5785	0	5655	0.0	0.0
chr16	TVP23A	10774951	10775547	0	597	0	5785	0	5188	0.0	0.0
chr16	TVP23A	10808536	10808606	0	71	0	5785	0	5714	0.0	0.0
chr16	TVP23A	10766037	10766153	0	117	0	5785	0	5668	0.0	0.0
chr16	TVP23A	10774951	10775096	0	146	0	5785	0	5639	0.0	0.0
chr16	TVP23A	10770271	10770331	0	61	0	5785	0	5724	0.0	0.0
chr16	DEXI	10933843	10934004	0	162	0	1682	0	1520	0.0	0.0
chr16	AC099489.1	11487261	11487386	0	126	8414	12096	8414	11970	0.0	0.7029239766081872
chr16	AC099489.1	11467151	11467258	0	108	8414	12096	8414	11988	0.0	0.7018685352018685
chr16	LITAF	11553532	11553689	0	158	561	4952	561	4794	0.0	0.11702127659574468
chr16	LITAF	11551706	11551804	0	99	561	4952	561	4853	0.0	0.11559859880486296
chr16	LITAF	11553532	11553748	0	217	561	4952	561	4735	0.0	0.11847940865892291
chr16	LITAF	11556510	11556735	0	226	561	4952	561	4726	0.0	0.11870503597122302
chr16	LITAF	11575405	11575586	0	182	561	4952	561	4770	0.0	0.11761006289308176
chr16	LITAF	11584189	11584332	0	144	561	4952	561	4808	0.0	0.11668053244592345
chr16	LITAF	11561145	11561574	0	430	561	4952	561	4522	0.0	0.12406015037593984
chr16	TXNDC11	11703669	11703750	0	82	580	3727	580	3645	0.0	0.15912208504801098
chr16	TXNDC11	11730644	11730774	0	131	580	3727	580	3596	0.0	0.16129032258064516
chr16	TXNDC11	11700451	11700564	0	114	580	3727	580	3613	0.0	0.16053141433711596
chr16	TXNDC11	11733981	11734079	0	99	580	3727	580	3628	0.0	0.15986769570011025
chr16	TXNDC11	11721313	11721435	0	123	580	3727	580	3604	0.0	0.1609322974472808
chr16	ZC3H7A	11769030	11769095	0	66	24930	7094	24930	7028	0.0	3.547239612976665
chr16	ZC3H7A	11776319	11776358	0	40	24930	7094	24930	7054	0.0	3.5341650127587183
chr16	ZC3H7A	11770782	11770987	16020	206	24930	7094	8910	6888	77.76699029126213	1.293554006968641
chr16	ZC3H7A	11796218	11796415	0	198	24930	7094	24930	6896	0.0	3.6151392111368907
chr16	BCAR4	11828321	11828391	0	71	22353	1241	22353	1170	0.0	19.105128205128207
chr16	BCAR4	11828321	11828606	204	286	22353	1241	22149	955	0.7132867132867133	23.19267015706806
chr16	BCAR4	11821637	11821755	0	119	22353	1241	22353	1122	0.0	19.922459893048128
chr16	BCAR4	11824526	11824739	21808	214	22353	1241	545	1027	101.90654205607477	0.5306718597857838
chr16	RSL1D1	11846500	11846602	12238	103	21873	5881	9635	5778	118.81553398058253	1.6675320179993076
chr16	RSL1D1	11850278	11850418	153	141	21873	5881	21720	5740	1.0851063829787233	3.78397212543554
chr16	RSL1D1	11849257	11849385	51	129	21873	5881	21822	5752	0.3953488372093023	3.793810848400556
chr16	GSPT1	11876085	11876175	3534	91	78305	8072	74771	7981	38.83516483516483	9.36862548552813
chr16	NPIPB2	11930449	11930551	2113	103	220490	2700	218377	2597	20.514563106796118	84.0881786676935
chr16	CPPED1	12704623	12705049	0	427	22251	2670	22251	2243	0.0	9.920196165849308
chr16	U95743.1	13767036	13767366	0	331	0	2505	0	2174	0.0	0.0
chr16	LINC02185	14009967	14010145	0	179	3939	5100	3939	4921	0.0	0.8004470636049583
chr16	PARN	14554064	14554151	0	88	31291	8816	31291	8728	0.0	3.58512832263978
chr16	PARN	14588097	14588172	0	76	31291	8816	31291	8740	0.0	3.5802059496567504
chr16	PARN	14604145	14604226	14	82	31291	8816	31277	8734	0.17073170731707318	3.5810625143118844
chr16	PARN	14606483	14606526	0	44	31291	8816	31291	8772	0.0	3.5671454628362973
chr16	PARN	14617589	14617650	0	62	31291	8816	31291	8754	0.0	3.574480237605666
chr16	PARN	14627268	14627336	0	69	31291	8816	31291	8747	0.0	3.577340802560878
chr16	PARN	14591912	14592033	0	122	31291	8816	31291	8694	0.0	3.599148838279273
chr16	PARN	14578530	14578628	0	99	31291	8816	31291	8717	0.0	3.5896524033497763
chr16	PARN	14627105	14627187	15	83	31291	8816	31276	8733	0.18072289156626506	3.5813580671017977
chr16	PARN	14531053	14531174	36	122	31291	8816	31255	8694	0.29508196721311475	3.5950080515297906
chr16	PARN	14627727	14627819	0	93	31291	8816	31291	8723	0.0	3.587183308494784
chr16	PARN	14558372	14558489	0	118	31291	8816	31291	8698	0.0	3.597493676707289
chr16	PARN	14482269	14482388	0	120	31291	8816	31291	8696	0.0	3.598321067157314
chr16	PARN	14604145	14604223	11	79	31291	8816	31280	8737	0.13924050632911392	3.580176261874785
chr16	PARN	14623923	14623953	0	31	31291	8816	31291	8785	0.0	3.5618668184405236
chr16	PLA2G10	14678644	14678760	1972	117	1972	757	0	640	16.854700854700855	0.0
chr16	NTAN1	15044333	15044407	2425	75	103989	3324	101564	3249	32.333333333333336	31.26008002462296
chr16	NTAN1	15047854	15047920	0	67	103989	3324	103989	3257	0.0	31.927847712618973
chr16	NTAN1	15047996	15048099	0	104	103989	3324	103989	3220	0.0	32.29472049689441
chr16	NTAN1	15048077	15048099	0	23	103989	3324	103989	3301	0.0	31.502272038776127
chr16	RRN3	15086364	15086454	20	91	8130	4156	8110	4065	0.21978021978021978	1.995079950799508
chr16	NPIPP1	15105548	15105818	0	271	12645	1447	12645	1176	0.0	10.752551020408163
chr16	MARF1	15615829	15616005	0	177	3543	10846	3543	10669	0.0	0.332083606711032
chr16	MARF1	15625371	15625800	0	430	3543	10846	3543	10416	0.0	0.34014976958525345
chr16	MARF1	15625371	15625797	0	427	3543	10846	3543	10419	0.0	0.3400518283904405
chr16	MYH11	15708802	15708841	0	40	73175	16806	73175	16766	0.0	4.364487653584636
chr16	MYH11	15784697	15784718	22	22	73175	16806	73153	16784	1.0	4.358496186844614
chr16	MYH11	15750418	15750509	0	92	73175	16806	73175	16714	0.0	4.378066291731483
chr16	CEP20	15873490	15873627	0	138	51	2398	51	2260	0.0	0.02256637168141593
chr16	CEP20	15879803	15879888	0	86	51	2398	51	2312	0.0	0.022058823529411766
chr16	CEP20	15884007	15884205	0	199	51	2398	51	2199	0.0	0.023192360163710776
chr16	CEP20	15882948	15883020	0	73	51	2398	51	2325	0.0	0.02193548387096774
chr16	CEP20	15882948	15883048	0	101	51	2398	51	2297	0.0	0.02220287331301698
chr16	CEP20	15884007	15884124	0	118	51	2398	51	2280	0.0	0.02236842105263158
chr16	ABCC6	16162992	16163192	514	201	76212	6965	75698	6764	2.557213930348259	11.19130691898285
chr16	ABCC6	16177451	16177626	0	176	76212	6965	76212	6789	0.0	11.225806451612904
chr16	ABCC6	16220272	16220388	0	117	76212	6965	76212	6848	0.0	11.12908878504673
chr16	PKD1P4	18344820	18344915	0	96	102	6833	102	6737	0.0	0.015140270149918362
chr16	NPIPA9	18359381	18359451	0	71	0	2981	0	2910	0.0	0.0
chr16	NPIPA9	18372722	18372854	0	133	0	2981	0	2848	0.0	0.0
chr16	NOMO2	18549520	18549627	0	108	261804	6838	261804	6730	0.0	38.901040118870725
chr16	NOMO2	18528012	18528071	307	60	261804	6838	261497	6778	5.116666666666666	38.58025966361759
chr16	NOMO2	18558676	18558854	0	179	261804	6838	261804	6659	0.0	39.31581318516294
chr16	RPS15A	18788062	18788142	232	81	870	4037	638	3956	2.8641975308641974	0.16127401415571285
chr16	RPS15A	18786239	18786336	102	98	870	4037	768	3939	1.0408163265306123	0.19497334348819498
chr16	RPS15A	18788062	18788105	232	44	870	4037	638	3993	5.2727272727272725	0.15977961432506887
chr16	RPS15A	18788062	18788159	232	98	870	4037	638	3939	2.36734693877551	0.16197004315816196
chr16	RPS15A	18783640	18783714	0	75	870	4037	870	3962	0.0	0.21958606764260474
chr16	ARL6IP1	18795463	18795581	75	119	48766	3352	48691	3233	0.6302521008403361	15.060624806681101
chr16	SMG1	18896051	18896207	1249	157	521065	22455	519816	22298	7.955414012738854	23.312225311687147
chr16	SMG1	18899986	18900044	0	59	521065	22455	521065	22396	0.0	23.26598499732095
chr16	KNOP1	19711371	19711440	204	70	246253	7765	246049	7695	2.914285714285714	31.97517868745939
chr16	GPRC5B	19880969	19880993	0	25	2118	5349	2118	5324	0.0	0.39782118707738545
chr16	GPRC5B	19874731	19874798	0	68	2118	5349	2118	5281	0.0	0.4010604052262829
chr16	GPRC5B	19882131	19882301	153	171	2118	5349	1965	5178	0.8947368421052632	0.37949015063731173
chr16	GPR139	20070923	20071022	0	100	102	4934	102	4834	0.0	0.021100537856847332
chr16	GP2	20323815	20324256	0	442	0	4061	0	3619	0.0	0.0
chr16	GP2	20323380	20323389	0	10	0	4061	0	4051	0.0	0.0
chr16	GP2	20323815	20324061	0	247	0	4061	0	3814	0.0	0.0
chr16	UMOD	20349770	20349869	0	100	0	3277	0	3177	0.0	0.0
chr16	UMOD	20349800	20349869	0	70	0	3277	0	3207	0.0	0.0
chr16	UMOD	20349707	20349869	0	163	0	3277	0	3114	0.0	0.0
chr16	UMOD	20351019	20351171	0	153	0	3277	0	3124	0.0	0.0
chr16	PDILT	20388786	20388909	0	124	0	2284	0	2160	0.0	0.0
chr16	ACSM2B	20564668	20564853	0	186	51	7431	51	7245	0.0	0.007039337474120083
chr16	ACSM2B	20575421	20575803	0	383	51	7431	51	7048	0.0	0.007236095346197503
chr16	ACSM2B	20575421	20575456	0	36	51	7431	51	7395	0.0	0.006896551724137931
chr16	ACSM2B	20554034	20554177	0	144	51	7431	51	7287	0.0	0.00699876492383697
chr16	ACSM2B	20575421	20575500	0	80	51	7431	51	7351	0.0	0.0069378315875391105
chr16	ACSM2B	20575421	20575549	0	129	51	7431	51	7302	0.0	0.006984387838948234
chr16	ACSM2B	20575421	20575507	0	87	51	7431	51	7344	0.0	0.006944444444444444
chr16	ACSM1	20640460	20640584	0	125	0	2887	0	2762	0.0	0.0
chr16	ACSM1	20636738	20636840	0	103	0	2887	0	2784	0.0	0.0
chr16	ACSM1	20674043	20674100	0	58	0	2887	0	2829	0.0	0.0
chr16	THUMPD1	20738087	20738269	0	183	816	6379	816	6196	0.0	0.131697869593286
chr16	ERI2	20800301	20800402	0	102	0	5706	0	5604	0.0	0.0
chr16	ERI2	20805714	20805945	0	232	0	5706	0	5474	0.0	0.0
chr16	DNAH3	21021970	21022100	0	131	15927	14456	15927	14325	0.0	1.1118324607329844
chr16	CRYM	21268546	21268684	0	139	486	3607	486	3468	0.0	0.14013840830449828
chr16	CRYM	21258788	21258845	0	58	486	3607	486	3549	0.0	0.13693998309382924
chr16	NPIPB3	21419489	21419575	299	87	47286	4575	46987	4488	3.4367816091954024	10.469474153297682
chr16	NPIPB3	21419634	21419766	1500	133	47286	4575	45786	4442	11.278195488721805	10.307519135524538
chr16	SMG1P3	21483631	21483787	376	157	109741	7138	109365	6981	2.394904458598726	15.66609368285346
chr16	SMG1P3	21487577	21487616	0	40	109741	7138	109741	7098	0.0	15.460834037757115
chr16	RRN3P1	21819301	21819481	0	181	1133	5269	1133	5088	0.0	0.2226808176100629
chr16	NPIPB4	21851769	21851855	617	87	47981	7314	47364	7227	7.091954022988506	6.553756745537568
chr16	NPIPB4	21851914	21852046	939	133	47981	7314	47042	7181	7.06015037593985	6.550898203592815
chr16	NPIPB4	21851769	21852046	3161	278	47981	7314	44820	7036	11.370503597122303	6.37009664582149
chr16	SMG1P4	21915120	21915276	0	157	67557	5968	67557	5811	0.0	11.62570986060919
chr16	PDZD9	21995237	21995308	47	72	3584	1342	3537	1270	0.6527777777777778	2.7850393700787404
chr16	PDZD9	21996321	21996501	250	181	3584	1342	3334	1161	1.3812154696132597	2.871662360034453
chr16	CDR2	22364901	22365014	24	114	17833	3964	17809	3850	0.21052631578947367	4.6257142857142854
chr16	CDR2	22422160	22422214	37	55	17833	3964	17796	3909	0.6727272727272727	4.552570990023024
chr16	COG7	23391961	23392234	0	274	43170	4252	43170	3978	0.0	10.852187028657617
chr16	EARS2	23553043	23553123	0	81	166472	4213	166472	4132	0.0	40.288480154888674
chr16	EARS2	23556889	23556927	0	39	166472	4213	166472	4174	0.0	39.88308576904648
chr16	EARS2	23553006	23553123	0	118	166472	4213	166472	4095	0.0	40.65250305250305
chr16	NDUFAB1	23587196	23587319	0	124	147329	1555	147329	1431	0.0	102.95527603074773
chr16	NDUFAB1	23595428	23595638	564	211	147329	1555	146765	1344	2.6729857819905214	109.20014880952381
chr16	PALB2	23607863	23608012	0	150	34414	4745	34414	4595	0.0	7.489445048966267
chr16	ERN2	23692183	23692331	224452	149	1506656	4763	1282204	4614	1506.3892617449665	277.8942349371478
chr16	ERN2	23695018	23695118	427	101	1506656	4763	1506229	4662	4.227722772277228	323.0864435864436
chr16	ERN2	23700958	23701114	40502	157	1506656	4763	1466154	4606	257.97452229299364	318.313938341294
chr16	ERN2	23709170	23709270	0	101	1506656	4763	1506656	4662	0.0	323.1780351780352
chr16	ERN2	23711995	23712078	0	84	1506656	4763	1506656	4679	0.0	322.0038469758495
chr16	ARHGAP17	24939363	24939597	3495	235	357245	9674	353750	9439	14.872340425531915	37.47748702193029
chr16	ARHGAP17	24959670	24959752	679	83	357245	9674	356566	9591	8.180722891566266	37.17714524032947
chr16	ARHGAP17	24927683	24927732	32	50	357245	9674	357213	9624	0.64	37.116895261845386
chr16	ARHGAP17	24929612	24929660	120	49	357245	9674	357125	9625	2.4489795918367347	37.103896103896105
chr16	ARHGAP17	25013862	25013956	0	95	357245	9674	357245	9579	0.0	37.294602776907816
chr16	ARHGAP17	24972595	24972633	0	39	357245	9674	357245	9635	0.0	37.077841203943954
chr16	NSMCE1	27225725	27225846	1156	122	15363	2869	14207	2747	9.475409836065573	5.171823807790317
chr16	NSMCE1	27241352	27241889	51	538	15363	2869	15312	2331	0.09479553903345725	6.568854568854569
chr16	NSMCE1	27268162	27268374	0	213	15363	2869	15363	2656	0.0	5.784262048192771
chr16	NSMCE1	27241352	27241484	51	133	15363	2869	15312	2736	0.38345864661654133	5.5964912280701755
chr16	NSMCE1	27241798	27241889	0	92	15363	2869	15363	2777	0.0	5.532229024126756
chr16	GTF3C1	27482510	27482585	0	76	317883	10137	317883	10061	0.0	31.5955670410496
chr16	GSG1L	27884485	27884638	0	154	176806	5435	176806	5281	0.0	33.47964400681689
chr16	GSG1L	27823861	27823915	0	55	176806	5435	176806	5380	0.0	32.8635687732342
chr16	GSG1L	27850478	27850623	0	146	176806	5435	176806	5289	0.0	33.429003592361504
chr16	XPO6	28117317	28117462	180291	146	337695	7020	157404	6874	1234.8698630136987	22.898457957521092
chr16	XPO6	28166507	28166585	3051	79	337695	7020	334644	6941	38.620253164556964	48.21264947413917
chr16	XPO6	28180940	28181031	1253	92	337695	7020	336442	6928	13.619565217391305	48.56264434180139
chr16	XPO6	28208986	28209122	51	137	337695	7020	337644	6883	0.3722627737226277	49.054772628214444
chr16	XPO6	28152929	28152964	0	36	337695	7020	337695	6984	0.0	48.35266323024055
chr16	XPO6	28208986	28209055	18	70	337695	7020	337677	6950	0.2571428571428571	48.586618705035974
chr16	AC138894.1	28476250	28476375	0	126	35427	4138	35427	4012	0.0	8.830259222333002
chr16	CLN3	28486346	28486490	561	145	183736	5985	183175	5840	3.8689655172413793	31.36558219178082
chr16	CLN3	28486577	28486650	561	74	183736	5985	183175	5911	7.581081081081081	30.988834376586027
chr16	CLN3	28487661	28487741	0	81	183736	5985	183736	5904	0.0	31.12059620596206
chr16	CLN3	28488590	28488662	30808	73	183736	5985	152928	5912	422.027397260274	25.867388362652232
chr16	CLN3	28491481	28491560	816	80	183736	5985	182920	5905	10.2	30.97713801862828
chr16	AC138894.1	28466719	28466902	0	184	35427	4138	35427	3954	0.0	8.9597875569044
chr16	CLN3	28479643	28479765	171	123	183736	5985	183565	5862	1.3902439024390243	31.3143978164449
chr16	AC138894.1	28470372	28470460	39	89	35427	4138	35388	4049	0.43820224719101125	8.739935786613978
chr16	AC138894.1	28469687	28469817	34	131	35427	4138	35393	4007	0.2595419847328244	8.832792612927378
chr16	AC138894.1	28477011	28477128	0	118	35427	4138	35427	4020	0.0	8.81268656716418
chr16	CLN3	28491481	28491513	448	33	183736	5985	183288	5952	13.575757575757576	30.794354838709676
chr16	CLN3	28479643	28479741	151	99	183736	5985	183585	5886	1.5252525252525253	31.190112130479104
chr16	CLN3	28489289	28489386	0	98	183736	5985	183736	5887	0.0	31.210463733650418
chr16	CLN3	28484005	28484118	0	114	183736	5985	183736	5871	0.0	31.295520354283767
chr16	CLN3	28479461	28479586	0	126	183736	5985	183736	5859	0.0	31.359617682198326
chr16	CLN3	28487455	28487541	0	87	183736	5985	183736	5898	0.0	31.15225500169549
chr16	CLN3	28490318	28490416	0	99	183736	5985	183736	5886	0.0	31.215766224940538
chr16	CLN3	28493785	28493809	2587	25	183736	5985	181149	5960	103.48	30.394127516778525
chr16	NUPR1	28538525	28538654	0	130	102	5512	102	5382	0.0	0.0189520624303233
chr16	SULT1A1	28608477	28608603	0	127	5030	7829	5030	7702	0.0	0.6530771228252402
chr16	SULT1A1	28609362	28609435	0	74	5030	7829	5030	7755	0.0	0.6486137975499677
chr16	SULT1A1	28609930	28610191	0	262	5030	7829	5030	7567	0.0	0.664728426060526
chr16	TUFM	28845313	28845480	125675	168	558677	2220	433002	2052	748.0654761904761	211.01461988304092
chr16	RABEP2	28924402	28924615	28	214	32104	4517	32076	4303	0.1308411214953271	7.45433418545201
chr16	RABEP2	28905866	28905878	41	13	32104	4517	32063	4504	3.1538461538461537	7.118783303730018
chr16	RABEP2	28911083	28911179	0	97	32104	4517	32104	4420	0.0	7.263348416289593
chr16	RABEP2	28921062	28921213	0	152	32104	4517	32104	4365	0.0	7.3548682703321875
chr16	AC009093.1	29218427	29218514	0	88	51	4775	51	4687	0.0	0.01088116065713676
chr16	NPIPB12	29488408	29488510	0	103	48626	4334	48626	4231	0.0	11.492791302292602
chr16	NPIPB12	29499997	29500083	586	87	48626	4334	48040	4247	6.735632183908046	11.311514009889335
chr16	NPIPB12	29488022	29488091	51	70	48626	4334	48575	4264	0.7285714285714285	11.39188555347092
chr16	NPIPB12	29499997	29500274	3364	278	48626	4334	45262	4056	12.100719424460431	11.159270216962526
chr16	NPIPB12	29500142	29500274	2001	133	48626	4334	46625	4201	15.045112781954888	11.098547964770292
chr16	CDIPT	29859441	29859523	0	83	163824	2826	163824	2743	0.0	59.72438935472111
chr16	CDIPT	29862585	29862720	0	136	163824	2826	163824	2690	0.0	60.90111524163569
chr16	CDIPT	29862585	29862635	0	51	163824	2826	163824	2775	0.0	59.03567567567568
chr16	SEZ6L2	29872704	29872743	310	40	162324	4128	162014	4088	7.75	39.63160469667319
chr16	SEZ6L2	29879863	29880064	0	202	162324	4128	162324	3926	0.0	41.345899133978605
chr16	SEZ6L2	29897852	29897984	153	133	162324	4128	162171	3995	1.150375939849624	40.59349186483104
chr16	SEZ6L2	29895720	29895860	0	141	162324	4128	162324	3987	0.0	40.71331828442438
chr16	SEZ6L2	29895258	29895460	329	203	162324	4128	161995	3925	1.6206896551724137	41.27261146496815
chr16	KCTD13	29925538	29925581	260	44	85834	5191	85574	5147	5.909090909090909	16.625995725665437
chr16	HIRIP3	29993905	29994843	90968	939	222691	3487	131723	2548	96.87752928647497	51.69662480376766
chr16	HIRIP3	29994647	29994843	4593	197	222691	3487	218098	3290	23.314720812182742	66.29118541033435
chr16	DOC2A	30006412	30006509	12454	98	455469	6385	443015	6287	127.08163265306122	70.46524574518848
chr16	DOC2A	30010902	30010989	816	88	455469	6385	454653	6297	9.272727272727273	72.20152453549309
chr16	DOC2A	30010272	30010340	0	69	455469	6385	455469	6316	0.0	72.11352121595947
chr16	TLCD3B	30036154	30036214	279	61	4184	4932	3905	4871	4.573770491803279	0.8016834325600493
chr16	TLCD3B	30046565	30046631	0	67	4184	4932	4184	4865	0.0	0.8600205549845837
chr16	YPEL3	30094384	30094475	4875	92	546687	2150	541812	2058	52.98913043478261	263.27113702623905
chr16	YPEL3	30094788	30094897	102232	110	546687	2150	444455	2040	929.3818181818182	217.8700980392157
chr16	GDPD3	30108212	30108264	64	53	3403	1473	3339	1420	1.2075471698113207	2.351408450704225
chr16	GDPD3	30108120	30108264	969	145	3403	1473	2434	1328	6.682758620689655	1.8328313253012047
chr16	MAPK3	30117153	30117285	0	133	4953	3678	4953	3545	0.0	1.3971791255289139
chr16	MAPK3	30118046	30118163	0	118	4953	3678	4953	3560	0.0	1.3912921348314606
chr16	MAPK3	30117136	30117285	0	150	4953	3678	4953	3528	0.0	1.4039115646258504
chr16	MAPK3	30115594	30115645	0	52	4953	3678	4953	3626	0.0	1.3659680088251518
chr16	MAPK3	30118098	30118163	0	66	4953	3678	4953	3612	0.0	1.3712624584717608
chr16	AC012645.3	30184148	30184331	0	184	10	728	10	544	0.0	0.01838235294117647
chr16	NPIPB13	30228378	30228480	0	103	24224	5013	24224	4910	0.0	4.933604887983707
chr16	NPIPB13	30239965	30240051	801	87	24224	5013	23423	4926	9.206896551724139	4.754973609419407
chr16	NPIPB13	30239965	30240242	3562	278	24224	5013	20662	4735	12.81294964028777	4.363674762407603
chr16	TBC1D10B	30359171	30359361	69	191	596192	6408	596123	6217	0.3612565445026178	95.88595785748754
chr16	TBC1D10B	30364899	30365006	48121	108	596192	6408	548071	6300	445.56481481481484	86.99539682539682
chr16	SEPTIN1	30381759	30381883	51	125	51648	3136	51597	3011	0.408	17.136167386250417
chr16	SEPTIN1	30382524	30382598	0	75	51648	3136	51648	3061	0.0	16.872917347272132
chr16	ZNF688	30571009	30571123	0	115	3809	2926	3809	2811	0.0	1.3550337958022056
chr16	ZNF689	30610587	30610782	15	196	1239	3804	1224	3608	0.07653061224489796	0.3392461197339246
chr16	CCDC189	30759011	30759101	457	91	8621	2142	8164	2051	5.021978021978022	3.9804973183812775
chr16	CCDC189	30759653	30759724	491	72	8621	2142	8130	2070	6.819444444444445	3.927536231884058
chr16	ZNF668	31064571	31064685	0	115	38689	3757	38689	3642	0.0	10.623009335529929
chr16	VKORC1	31091091	31091342	12850	252	105712	2196	92862	1944	50.992063492063494	47.76851851851852
chr16	VKORC1	31093311	31093421	648	111	105712	2196	105064	2085	5.837837837837838	50.39040767386091
chr16	VKORC1	31093311	31093482	2346	172	105712	2196	103366	2024	13.63953488372093	51.0701581027668
chr16	VKORC1	31092782	31092864	10554	83	105712	2196	95158	2113	127.1566265060241	45.034548035967816
chr16	PRSS8	31135153	31135171	5356	19	338629	2981	333273	2962	281.89473684210526	112.51620526671168
chr16	PRSS36	31140293	31140415	102	123	61253	3373	61151	3250	0.8292682926829268	18.81569230769231
chr16	PYCARD	31202146	31202203	952	58	1020305	1662	1019353	1604	16.413793103448278	635.5068578553615
chr16	RUSF1	31507763	31507878	0	116	19122	3175	19122	3059	0.0	6.25106243870546
chr16	HERC2P4	32152448	32152645	0	198	438	5885	438	5687	0.0	0.07701775980305961
chr16	TP53TG3	32675463	32675630	0	168	0	3008	0	2840	0.0	0.0
chr16	TP53TG3	32674776	32675065	0	290	0	3008	0	2718	0.0	0.0
chr16	SLC6A10P	32883066	32883157	0	92	5206	4120	5206	4028	0.0	1.2924528301886793
chr16	HERC2P8	33123069	33123391	459	323	1211	5145	752	4822	1.4210526315789473	0.15595188718374117
chr16	BMS1P8	33697736	33697795	0	60	0	2182	0	2122	0.0	0.0
chr16	FRG2DP	35478921	35478991	0	71	0	1277	0	1206	0.0	0.0
chr16	AC018558.1	35505627	35505918	0	292	0	1199	0	907	0.0	0.0
chr16	AC018558.1	35505761	35505918	0	158	0	1199	0	1041	0.0	0.0
chr16	AC018558.1	35505761	35505890	0	130	0	1199	0	1069	0.0	0.0
chr16	ANKRD26P1	46475765	46475994	0	230	23	6109	23	5879	0.0	0.003912229971083518
chr16	ANKRD26P1	46487997	46488123	23	127	23	6109	0	5982	0.18110236220472442	0.0
chr16	ANKRD26P1	46514841	46514880	0	40	23	6109	23	6069	0.0	0.003789751194595485
chr16	SHCBP1	46604227	46604461	0	235	15301	6187	15301	5952	0.0	2.5707325268817205
chr16	VPS35	46674313	46674462	0	150	173190	9751	173190	9601	0.0	18.038745963962086
chr16	VPS35	46682477	46682684	0	208	173190	9751	173190	9543	0.0	18.148381012260295
chr16	VPS35	46682477	46682666	0	190	173190	9751	173190	9561	0.0	18.114213994352056
chr16	MYLK3	46737710	46738143	0	434	328181	10660	328181	10226	0.0	32.092802659886566
chr16	C16ORF87	46809602	46809785	0	184	1422	7223	1422	7039	0.0	0.20201733200738742
chr16	C16ORF87	46807968	46808134	0	167	1422	7223	1422	7056	0.0	0.20153061224489796
chr16	NETO2	47086225	47086339	0	115	24546	7390	24546	7275	0.0	3.374020618556701
chr16	ABCC12	48086740	48086819	0	80	153	8731	153	8651	0.0	0.017685816668593226
chr16	ABCC12	48104141	48104368	0	228	153	8731	153	8503	0.0	0.01799364930024697
chr16	ABCC12	48111435	48111507	0	73	153	8731	153	8658	0.0	0.017671517671517672
chr16	ABCC12	48117260	48117333	0	74	153	8731	153	8657	0.0	0.01767355896961996
chr16	ABCC12	48139162	48139336	0	175	153	8731	153	8556	0.0	0.01788218793828892
chr16	ABCC12	48153615	48153884	0	270	153	8731	153	8461	0.0	0.01808296891620376
chr16	ABCC12	48139187	48139336	0	150	153	8731	153	8581	0.0	0.017830089733131337
chr16	ABCC11	48170104	48170218	0	115	0	8503	0	8388	0.0	0.0
chr16	SIAH1	48392756	48392892	1001	137	12742	5767	11741	5630	7.306569343065694	2.085435168738899
chr16	N4BP1	48546146	48546254	0	109	694	7819	694	7710	0.0	0.09001297016861219
chr16	N4BP1	48551385	48551482	0	98	694	7819	694	7721	0.0	0.08988472995725942
chr16	SALL1	51138687	51142145	38	3459	38	5665	0	2206	0.010985834056085574	0.0
chr16	LINC00919	52084712	52084824	0	113	0	1662	0	1549	0.0	0.0
chr16	TOX3	52475530	52475640	0	111	0	6765	0	6654	0.0	0.0
chr16	CASC16	52562813	52562862	0	50	0	1651	0	1601	0.0	0.0
chr16	CASC16	52573180	52573344	0	165	0	1651	0	1486	0.0	0.0
chr16	AKTIP	53501520	53501570	0	51	36041	4978	36041	4927	0.0	7.314998985183681
chr16	AKTIP	53494838	53494955	0	118	36041	4978	36041	4860	0.0	7.415843621399177
chr16	AKTIP	53502699	53503044	0	346	36041	4978	36041	4632	0.0	7.78087219343696
chr16	RPGRIP1L	53622218	53622356	0	139	11018	12304	11018	12165	0.0	0.9057131113851212
chr16	RPGRIP1L	53638309	53638411	0	103	11018	12304	11018	12201	0.0	0.9030407343660356
chr16	RPGRIP1L	53703227	53703261	0	35	11018	12304	11018	12269	0.0	0.8980356997310294
chr16	LINC02169	54258349	54258440	0	92	0	858	0	766	0.0	0.0
chr16	IRX3	54284496	54285613	0	1118	0	1990	0	872	0.0	0.0
chr16	CRNDE	54924600	54924687	306	88	2295	12295	1989	12207	3.477272727272727	0.16293929712460065
chr16	CES1	55806332	55806464	0	133	51	2953	51	2820	0.0	0.018085106382978722
chr16	CES1	55828766	55828974	0	209	51	2953	51	2744	0.0	0.01858600583090379
chr16	CES1	55828766	55828971	0	206	51	2953	51	2747	0.0	0.018565708045140152
chr16	CES1	55812335	55812430	0	96	51	2953	51	2857	0.0	0.017850892544627232
chr16	CES1	55826150	55826295	51	146	51	2953	0	2807	0.3493150684931507	0.0
chr16	CES5A	55849623	55849773	0	151	0	3225	0	3074	0.0	0.0
chr16	CES5A	55856376	55856445	0	70	0	3225	0	3155	0.0	0.0
chr16	CES5A	55861411	55861516	0	106	0	3225	0	3119	0.0	0.0
chr16	CES5A	55865962	55866116	0	155	0	3225	0	3070	0.0	0.0
chr16	CES5A	55856376	55856442	0	67	0	3225	0	3158	0.0	0.0
chr16	AC040168.1	56187602	56187700	0	99	153	8683	153	8584	0.0	0.01782385834109972
chr16	AC040168.1	56161887	56162106	0	220	153	8683	153	8463	0.0	0.018078695498050336
chr16	AMFR	56389184	56389375	0	192	9595	5506	9595	5314	0.0	1.8056078283778698
chr16	AMFR	56388757	56388853	0	97	9595	5506	9595	5409	0.0	1.7738953595858753
chr16	BBS2	56497742	56497880	0	139	294140	5825	294140	5686	0.0	51.730566303200845
chr16	MT1G	56667311	56667380	51	70	1250	753	1199	683	0.7285714285714285	1.7554904831625182
chr16	MT1G	56667311	56667377	51	67	1250	753	1199	686	0.7611940298507462	1.7478134110787171
chr16	PSME3IP1	57175538	57175590	972	53	71894	3087	70922	3034	18.339622641509433	23.37574159525379
chr16	PSME3IP1	57174168	57174286	0	119	71894	3087	71894	2968	0.0	24.223045822102424
chr16	PSME3IP1	57178501	57178852	293	352	71894	3087	71601	2735	0.8323863636363636	26.179524680073126
chr16	PSME3IP1	57174619	57174688	261	70	71894	3087	71633	3017	3.7285714285714286	23.74312230692741
chr16	PSME3IP1	57178805	57178852	188	48	71894	3087	71706	3039	3.9166666666666665	23.595261599210268
chr16	PLLP	57261896	57262070	0	175	66986	5318	66986	5143	0.0	13.024693758506707
chr16	CIAPIN1	57431150	57431266	0	117	0	3392	0	3275	0.0	0.0
chr16	CIAPIN1	57432486	57432560	0	75	0	3392	0	3317	0.0	0.0
chr16	CIAPIN1	57436655	57436732	0	78	0	3392	0	3314	0.0	0.0
chr16	CIAPIN1	57440771	57440983	0	213	0	3392	0	3179	0.0	0.0
chr16	CIAPIN1	57430257	57430339	0	83	0	3392	0	3309	0.0	0.0
chr16	DOK4	57475505	57475620	2274	116	184052	4617	181778	4501	19.603448275862068	40.38613641413019
chr16	KIFC3	57759124	57759153	0	30	120266	7697	120266	7667	0.0	15.686187557062736
chr16	KIFC3	57788574	57788713	0	140	120266	7697	120266	7557	0.0	15.91451634246394
chr16	KIFC3	57794998	57795141	40310	144	120266	7697	79956	7553	279.93055555555554	10.58599232093208
chr16	KIFC3	57776485	57776690	0	206	120266	7697	120266	7491	0.0	16.054732345481245
chr16	KIFC3	57779876	57779951	431	76	120266	7697	119835	7621	5.671052631578948	15.724314394436426
chr16	KIFC3	57785463	57785666	18101	204	120266	7697	102165	7493	88.73039215686275	13.63472574402776
chr16	KIFC3	57779360	57779450	52	91	120266	7697	120214	7606	0.5714285714285714	15.805153825926899
chr16	CNGB1	57887854	57888074	0	221	51	7346	51	7125	0.0	0.007157894736842105
chr16	CNGB1	57931715	57931878	0	164	51	7346	51	7182	0.0	0.007101086048454469
chr16	CNGB1	57937091	57937359	0	269	51	7346	51	7077	0.0	0.0072064434082238235
chr16	PRSS54	58290958	58291136	0	179	197	2120	197	1941	0.0	0.1014940752189593
chr16	CNOT1	58547565	58547682	2131	118	51765	10398	49634	10280	18.059322033898304	4.828210116731517
chr16	CNOT1	58553781	58553860	4075	80	51765	10398	47690	10318	50.9375	4.622019771273503
chr16	CNOT1	58527922	58528105	0	184	51765	10398	51765	10214	0.0	5.068043861366752
chr16	CNOT1	58543168	58543292	348	125	51765	10398	51417	10273	2.784	5.005061812518251
chr16	CNOT1	58624672	58624794	0	123	51765	10398	51765	10275	0.0	5.0379562043795625
chr16	CNOT1	58623281	58623409	0	129	51765	10398	51765	10269	0.0	5.040899795501023
chr16	CNOT1	58624652	58624794	0	143	51765	10398	51765	10255	0.0	5.047781569965871
chr16	SLC38A7	58671044	58671244	0	201	1520	6005	1520	5804	0.0	0.2618883528600965
chr16	SLC38A7	58683954	58684178	0	225	1520	6005	1520	5780	0.0	0.2629757785467128
chr16	SLC38A7	58675212	58675342	0	131	1520	6005	1520	5874	0.0	0.2587674497786857
chr16	SLC38A7	58683954	58684083	0	130	1520	6005	1520	5875	0.0	0.25872340425531914
chr16	GOT2	58716662	58716813	0	152	4464	3760	4464	3608	0.0	1.237250554323725
chr16	GOT2	58722149	58722278	0	130	4464	3760	4464	3630	0.0	1.2297520661157024
chr16	GOT2	58723745	58723902	0	158	4464	3760	4464	3602	0.0	1.2393114936146585
chr16	CDH8	61727093	61727215	0	123	255	13549	255	13426	0.0	0.018992998659317743
chr16	AC138305.1	63532816	63532931	0	116	0	2383	0	2267	0.0	0.0
chr16	CDH11	64948608	64948787	0	180	67466	13237	67466	13057	0.0	5.167036838477445
chr16	CDH11	65004641	65005041	0	401	67466	13237	67466	12836	0.0	5.255998753505765
chr16	CDH11	65053803	65053928	0	126	67466	13237	67466	13111	0.0	5.145755472504004
chr16	CDH11	65123673	65123820	0	148	67466	13237	67466	13089	0.0	5.154404461761785
chr16	LINC00922	65311413	65311695	1173	283	1173	2337	0	2054	4.144876325088339	0.0
chr16	LINC00922	65356430	65356489	0	60	1173	2337	1173	2277	0.0	0.5151515151515151
chr16	LINC00922	65311413	65311547	0	135	1173	2337	1173	2202	0.0	0.5326975476839237
chr16	LINC00922	65363380	65363503	0	124	1173	2337	1173	2213	0.0	0.5300497062810664
chr16	LINC00922	65356394	65356489	0	96	1173	2337	1173	2241	0.0	0.5234270414993306
chr16	AC010542.3	66477943	66478117	0	175	0	1350	0	1175	0.0	0.0
chr16	BEAN1-AS1	66471376	66471564	0	189	0	1739	0	1550	0.0	0.0
chr16	BEAN1-AS1	66473989	66474173	0	185	0	1739	0	1554	0.0	0.0
chr16	BEAN1-AS1	66471514	66471564	0	51	0	1739	0	1688	0.0	0.0
chr16	BEAN1-AS1	66479007	66479131	0	125	0	1739	0	1614	0.0	0.0
chr16	BEAN1-AS1	66479652	66479755	0	104	0	1739	0	1635	0.0	0.0
chr16	BEAN1-AS1	66480248	66480419	0	172	0	1739	0	1567	0.0	0.0
chr16	TK2	66513730	66513811	0	82	23401	8924	23401	8842	0.0	2.6465731734901605
chr16	TK2	66517135	66517215	0	81	23401	8924	23401	8843	0.0	2.646273888951713
chr16	TK2	66528993	66529067	0	75	23401	8924	23401	8849	0.0	2.6444796022149397
chr16	TK2	66531379	66531469	153	91	23401	8924	23248	8833	1.6813186813186813	2.631948375410393
chr16	TK2	66536963	66537017	0	55	23401	8924	23401	8869	0.0	2.638516179952644
chr16	TK2	66541878	66541953	468	76	23401	8924	22933	8848	6.157894736842105	2.591885171790235
chr16	TK2	66547970	66548065	112	96	23401	8924	23289	8828	1.1666666666666667	2.63808337109198
chr16	TK2	66513730	66513862	0	133	23401	8924	23401	8791	0.0	2.6619269707655557
chr16	TK2	66513285	66513351	0	67	23401	8924	23401	8857	0.0	2.6420910014677657
chr16	TK2	66550252	66550327	276	76	23401	8924	23125	8848	3.6315789473684212	2.6135849909584086
chr16	TK2	66536078	66536199	0	122	23401	8924	23401	8802	0.0	2.6586003181095204
chr16	TK2	66546146	66546226	0	81	23401	8924	23401	8843	0.0	2.646273888951713
chr16	TK2	66546104	66546221	0	118	23401	8924	23401	8806	0.0	2.6573926868044517
chr16	TK2	66546146	66546221	0	76	23401	8924	23401	8848	0.0	2.6447784810126582
chr16	TK2	66548742	66548784	46	43	23401	8924	23355	8881	1.069767441860465	2.629771422137147
chr16	DYNC1LI2	66728200	66728242	0	43	3080	6030	3080	5987	0.0	0.5144479706029731
chr16	DYNC1LI2	66742437	66742668	0	232	3080	6030	3080	5798	0.0	0.5312176612625044
chr16	DYNC1LI2	66749196	66749313	0	118	3080	6030	3080	5912	0.0	0.5209742895805142
chr16	DYNC1LI2	66724661	66724748	0	88	3080	6030	3080	5942	0.0	0.5183439919219118
chr16	DYNC1LI2	66742437	66742554	0	118	3080	6030	3080	5912	0.0	0.5209742895805142
chr16	TERB1	66768103	66768168	21450	66	229202	3451	207752	3385	325.0	61.37429837518464
chr16	TERB1	66775117	66775243	120	127	229202	3451	229082	3324	0.9448818897637795	68.91756919374248
chr16	TERB1	66800976	66801053	0	78	229202	3451	229202	3373	0.0	67.95197153868959
chr16	TERB1	66796767	66796830	0	64	229202	3451	229202	3387	0.0	67.67109536462947
chr16	TERB1	66800047	66800196	0	150	229202	3451	229202	3301	0.0	69.43411087549228
chr16	NAE1	66805776	66805862	0	87	153	4416	153	4329	0.0	0.035343035343035345
chr16	NAE1	66805776	66805826	0	51	153	4416	153	4365	0.0	0.03505154639175258
chr16	NAE1	66824854	66824885	0	32	153	4416	153	4384	0.0	0.03489963503649635
chr16	NAE1	66826667	66826780	0	114	153	4416	153	4302	0.0	0.03556485355648536
chr16	NAE1	66826676	66826780	0	105	153	4416	153	4311	0.0	0.03549060542797495
chr16	NAE1	66827979	66828077	0	99	153	4416	153	4317	0.0	0.035441278665740095
chr16	NAE1	66823226	66823306	0	81	153	4416	153	4335	0.0	0.03529411764705882
chr16	NAE1	66827979	66828142	0	164	153	4416	153	4252	0.0	0.03598306679209784
chr16	NAE1	66827459	66827564	0	106	153	4416	153	4310	0.0	0.035498839907192575
chr16	NAE1	66827934	66828077	0	144	153	4416	153	4272	0.0	0.03581460674157303
chr16	CDH16	66913490	66913613	0	124	7071	3606	7071	3482	0.0	2.0307294658242387
chr16	CDH16	66918020	66918078	0	59	7071	3606	7071	3547	0.0	1.9935156470256554
chr16	CIAO2B	66932480	66932550	0	71	0	1010	0	939	0.0	0.0
chr16	KIAA0895L	67178009	67178107	3689	99	188263	3439	184574	3340	37.26262626262626	55.26167664670659
chr16	KIAA0895L	67178009	67178097	3293	89	188263	3439	184970	3350	37.0	55.21492537313433
chr16	KIAA0895L	67181557	67181697	15127	141	188263	3439	173136	3298	107.28368794326241	52.4972710733778
chr16	KIAA0895L	67181605	67181697	9075	93	188263	3439	179188	3346	97.58064516129032	53.552898983861326
chr16	EXOC3L1	67184685	67184810	175	126	36657	3057	36482	2931	1.3888888888888888	12.446946434663937
chr16	EXOC3L1	67186758	67186884	273	127	36657	3057	36384	2930	2.1496062992125986	12.417747440273038
chr16	LRRC29	67208311	67208455	3307	145	176738	2814	173431	2669	22.806896551724137	64.97976770325965
chr16	FHOD1	67231187	67231349	797	163	272992	5039	272195	4876	4.889570552147239	55.82342083675144
chr16	FHOD1	67236410	67236434	465	25	272992	5039	272527	5014	18.6	54.35321100917431
chr16	KCTD19	67304420	67304571	102	152	87576	7397	87474	7245	0.6710526315789473	12.073706004140787
chr16	TPPP3	67392946	67393037	120	92	120	2263	0	2171	1.3043478260869565	0.0
chr16	ZDHHC1	67398572	67398731	0	160	224	3245	224	3085	0.0	0.07260940032414911
chr16	ATP6V0D1	67444527	67444706	125	180	13854	6487	13729	6307	0.6944444444444444	2.17678769621056
chr16	ATP6V0D1	67453543	67453715	0	173	13854	6487	13854	6314	0.0	2.19417168197656
chr16	ATP6V0D1	67457563	67457651	76	89	13854	6487	13778	6398	0.8539325842696629	2.1534854642075647
chr16	ATP6V0D1	67452237	67452360	0	124	13854	6487	13854	6363	0.0	2.1772748703441773
chr16	ATP6V0D1	67445811	67445965	51	155	13854	6487	13803	6332	0.32903225806451614	2.1798799747315223
chr16	ACD	67659902	67660045	133	144	43330	2398	43197	2254	0.9236111111111112	19.164596273291924
chr16	ACD	67659902	67660036	133	135	43330	2398	43197	2263	0.9851851851851852	19.0883782589483
chr16	ENKD1	67663656	67663820	0	165	17307	2573	17307	2408	0.0	7.187292358803987
chr16	ENKD1	67663936	67664062	500	127	17307	2573	16807	2446	3.937007874015748	6.871218315617335
chr16	ENKD1	67664995	67665168	0	174	17307	2573	17307	2399	0.0	7.21425593997499
chr16	GFOD2	67677765	67677857	0	93	6963	4622	6963	4529	0.0	1.5374254802384633
chr16	RANBP10	67744287	67744455	51	169	42106	6474	42055	6305	0.30177514792899407	6.670103092783505
chr16	RANBP10	67772033	67772086	0	54	42106	6474	42106	6420	0.0	6.558566978193147
chr16	RANBP10	67805427	67805539	0	113	42106	6474	42106	6361	0.0	6.619399465492847
chr16	CENPT	67832227	67832315	0	89	1224	5102	1224	5013	0.0	0.24416517055655296
chr16	CENPT	67831840	67831890	0	51	1224	5102	1224	5051	0.0	0.24232825183132053
chr16	CENPT	67832227	67832350	0	124	1224	5102	1224	4978	0.0	0.2458818802732021
chr16	CENPT	67832227	67832354	0	128	1224	5102	1224	4974	0.0	0.24607961399276237
chr16	CENPT	67835537	67835586	0	50	1224	5102	1224	5052	0.0	0.24228028503562946
chr16	CENPT	67835537	67835658	0	122	1224	5102	1224	4980	0.0	0.2457831325301205
chr16	CTRL	67931097	67931201	377	105	2791	2174	2414	2069	3.5904761904761906	1.166747220879652
chr16	LCAT	67940736	67940831	0	96	93837	2295	93837	2199	0.0	42.672578444747614
chr16	SLC12A4	67946437	67946633	0	197	171469	8217	171469	8020	0.0	21.380174563591023
chr16	SLC12A4	67963464	67963559	3243	96	171469	8217	168226	8121	33.78125	20.714936584164512
chr16	DPEP3	67979638	67979765	26787	128	104617	1748	77830	1620	209.2734375	48.04320987654321
chr16	DPEP2	67992509	67992636	55	128	26474	3207	26419	3079	0.4296875	8.580383241312115
chr16	DPEP2	67999266	67999748	603	483	26474	3207	25871	2724	1.2484472049689441	9.497430249632894
chr16	ESRP2	68232370	68232503	459	134	10496	5121	10037	4987	3.425373134328358	2.012632845398035
chr16	ESRP2	68235847	68235879	68	33	10496	5121	10428	5088	2.0606060606060606	2.0495283018867925
chr16	SMPD3	68386597	68386659	2377	63	110548	6995	108171	6932	37.73015873015873	15.604587420657818
chr16	CHTF8	69121052	69121170	1380	119	15221	1694	13841	1575	11.596638655462185	8.787936507936507
chr16	CHTF8	69121435	69121493	0	59	15221	1694	15221	1635	0.0	9.309480122324159
chr16	CHTF8	69120106	69120208	972	103	15221	1694	14249	1591	9.436893203883495	8.95600251414205
chr16	AC026464.1	69347787	69347936	141	150	33713	752	33572	602	0.94	55.76744186046512
chr16	TERF2	69357517	69357561	2240	45	422022	3724	419782	3679	49.77777777777778	114.10220168524056
chr16	TERF2	69368586	69368595	3709	10	422022	3724	418313	3714	370.9	112.63139472267098
chr16	NQO1	69713027	69713129	0	103	18444	2978	18444	2875	0.0	6.415304347826087
chr16	NQO1	69714963	69715077	0	115	18444	2978	18444	2863	0.0	6.442193503318197
chr16	NOB1	69752240	69752371	1041944	132	3327707	2054	2285763	1922	7893.515151515152	1189.2627471383976
chr16	NOB1	69749558	69749630	0	73	3327707	2054	3327707	1981	0.0	1679.811711256941
chr16	PDXDC2P-NPIPB14P	69976810	69978003	0	1194	19107	6094	19107	4900	0.0	3.899387755102041
chr16	PDXDC2P-NPIPB14P	69989955	69990208	0	254	19107	6094	19107	5840	0.0	3.271746575342466
chr16	NPIPB14P	69978221	69978282	0	62	153	1595	153	1533	0.0	0.09980430528375733
chr16	PDXDC2P-NPIPB14P	69990596	69990683	0	88	19107	6094	19107	6006	0.0	3.181318681318681
chr16	PDXDC2P-NPIPB14P	69992910	69993248	0	339	19107	6094	19107	5755	0.0	3.3200695047784534
chr16	PDXDC2P	70064670	70064776	0	107	17415	2726	17415	2619	0.0	6.649484536082475
chr16	AC009060.1	70161443	70161893	51	451	7074	3435	7023	2984	0.1130820399113082	2.3535522788203753
chr16	AARS1	70258032	70258217	208	186	146049	9918	145841	9732	1.118279569892473	14.985717221537197
chr16	AARS1	70262345	70262524	523	180	146049	9918	145526	9738	2.9055555555555554	14.944136372971863
chr16	AARS1	70270195	70270340	1479	146	146049	9918	144570	9772	10.13013698630137	14.794310274252968
chr16	AARS1	70278899	70279045	102	147	146049	9918	145947	9771	0.6938775510204082	14.936751611912802
chr16	AARS1	70262345	70262484	483	140	146049	9918	145566	9778	3.45	14.887093475148292
chr16	AARS1	70262366	70262524	313	159	146049	9918	145736	9759	1.9685534591194969	14.933497284557845
chr16	AARS1	70262372	70262524	263	153	146049	9918	145786	9765	1.7189542483660132	14.929441884280594
chr16	AARS1	70258052	70258217	208	166	146049	9918	145841	9752	1.2530120481927711	14.954983593109105
chr16	AARS1	70258032	70258244	237	213	146049	9918	145812	9705	1.1126760563380282	15.024420401854714
chr16	AARS1	70254390	70254483	0	94	146049	9918	146049	9824	0.0	14.866551302931596
chr16	AARS1	70264957	70265102	1870	146	146049	9918	144179	9772	12.808219178082192	14.754297994269342
chr16	AC012184.3	70317255	70317373	184	119	14501	1770	14317	1651	1.546218487394958	8.671714112658995
chr16	COG4	70482091	70482175	0	85	47623	4424	47623	4339	0.0	10.975570407928094
chr16	COG4	70490329	70490392	0	64	47623	4424	47623	4360	0.0	10.922706422018349
chr16	COG4	70515867	70516040	20533	174	47623	4424	27090	4250	118.00574712643679	6.374117647058823
chr16	COG4	70519648	70519731	0	84	47623	4424	47623	4340	0.0	10.973041474654378
chr16	COG4	70517625	70517740	1169	116	47623	4424	46454	4308	10.077586206896552	10.783194057567316
chr16	COG4	70508665	70508824	933	160	47623	4424	46690	4264	5.83125	10.949812382739212
chr16	COG4	70519676	70519731	0	56	47623	4424	47623	4368	0.0	10.902701465201465
chr16	MTSS2	70679314	70679323	0	10	396	4987	396	4977	0.0	0.07956600361663653
chr16	VAC14	70692820	70692971	0	152	92611	7702	92611	7550	0.0	12.266357615894039
chr16	VAC14	70786214	70786365	380	152	92611	7702	92231	7550	2.5	12.216026490066225
chr16	HYDIN	70862047	70862255	0	209	44577	28693	44577	28484	0.0	1.5649838505827833
chr16	HYDIN	70918210	70918429	0	220	44577	28693	44577	28473	0.0	1.5655884522178907
chr16	HYDIN	70991317	70991396	0	80	44577	28693	44577	28613	0.0	1.5579282144479782
chr16	HYDIN	71025382	71025526	0	145	44577	28693	44577	28548	0.0	1.5614754098360655
chr16	HYDIN	71162530	71162730	0	201	44577	28693	44577	28492	0.0	1.5645444335252001
chr16	HYDIN	70811311	70811435	0	125	44577	28693	44577	28568	0.0	1.5603822458695042
chr16	HYDIN	70865117	70865363	0	247	44577	28693	44577	28446	0.0	1.56707445686564
chr16	HYDIN	71027601	71027875	0	275	44577	28693	44577	28418	0.0	1.5686184812442818
chr16	HYDIN	71066782	71066933	0	152	44577	28693	44577	28541	0.0	1.56185837917382
chr16	HYDIN	71075943	71075988	0	46	44577	28693	44577	28647	0.0	1.5560791705937795
chr16	HYDIN	71203724	71204057	0	334	44577	28693	44577	28359	0.0	1.5718819422405585
chr16	CMTR2	71288877	71288937	0	61	0	5440	0	5379	0.0	0.0
chr16	ZNF23	71456071	71456121	0	51	51	6589	51	6538	0.0	0.00780055062710309
chr16	ZNF23	71450589	71450715	0	127	51	6589	51	6462	0.0	0.007892293407613741
chr16	ZNF19	71478878	71479005	0	128	11609	8775	11609	8647	0.0	1.3425465479357002
chr16	ZNF19	71482081	71482143	2338	63	11609	8775	9271	8712	37.111111111111114	1.0641643709825528
chr16	ZNF23	71461658	71462004	0	347	51	6589	51	6242	0.0	0.008170458186478692
chr16	ZNF19	71478878	71479100	0	223	11609	8775	11609	8552	0.0	1.3574602432179608
chr16	ZNF19	71478434	71478507	0	74	11609	8775	11609	8701	0.0	1.3342144581082633
chr16	ZNF19	71487079	71487410	369	332	11609	8775	11240	8443	1.1114457831325302	1.3312803505862845
chr16	PHLPP2	71663898	71664099	0	202	40909	12515	40909	12313	0.0	3.322423454885081
chr16	PHLPP2	71644750	71644855	0	106	40909	12515	40909	12409	0.0	3.29672012249174
chr16	AP1G1	71761511	71761567	39	57	93793	10941	93754	10884	0.6842105263157895	8.613928702682838
chr16	AP1G1	71806685	71806728	0	44	93793	10941	93793	10897	0.0	8.607231348077452
chr16	AP1G1	71808504	71808677	5	174	93793	10941	93788	10767	0.028735632183908046	8.710690071514813
chr16	AP1G1	71767876	71767885	0	10	93793	10941	93793	10931	0.0	8.580459244350928
chr16	AP1G1	71772959	71773053	10763	95	93793	10941	83030	10846	113.29473684210527	7.6553568135718235
chr16	AP1G1	71808014	71808150	51	137	93793	10941	93742	10804	0.3722627737226277	8.67660125879304
chr16	AP1G1	71807800	71807838	0	39	93793	10941	93793	10902	0.0	8.603283801137406
chr16	ZNF821	71861775	71861942	306	168	64247	3268	63941	3100	1.8214285714285714	20.626129032258063
chr16	ZNF821	71881316	71881434	1473	119	64247	3268	62774	3149	12.378151260504202	19.934582407113368
chr16	ZNF821	71864902	71865048	0	147	64247	3268	64247	3121	0.0	20.585389298301827
chr16	ZNF821	71867911	71868037	0	127	64247	3268	64247	3141	0.0	20.454313912766636
chr16	ZNF821	71867892	71868037	0	146	64247	3268	64247	3122	0.0	20.578795643818065
chr16	TXNL4B	72090088	72090177	0	90	0	3150	0	3060	0.0	0.0
chr16	PMFBP1	72164370	72164486	0	117	224526	5619	224526	5502	0.0	40.80806979280262
chr16	PMFBP1	72128376	72128569	72	194	224526	5619	224454	5425	0.3711340206185567	41.37400921658986
chr16	LINC01572	72522552	72522623	0	72	2036	12582	2036	12510	0.0	0.16274980015987212
chr16	LINC01572	72540577	72540611	0	35	2036	12582	2036	12547	0.0	0.16226986530644777
chr16	LINC01572	72561972	72562086	0	115	2036	12582	2036	12467	0.0	0.1633111414133312
chr16	ZFHX3	72957426	72960194	0	2769	31016	22271	31016	19502	0.0	1.5904009845144087
chr16	AC009053.1	74349741	74349859	2280	119	82994	3342	80714	3223	19.159663865546218	25.04312752094322
chr16	CLEC18B	74418058	74418298	69	241	3247	2892	3178	2651	0.2863070539419087	1.1987929083364768
chr16	CLEC18B	74409851	74409878	19	28	3247	2892	3228	2864	0.6785714285714286	1.1270949720670391
chr16	GLG1	74532120	74532153	0	34	60559	12730	60559	12696	0.0	4.769927536231884
chr16	GLG1	74472525	74472634	51	110	60559	12730	60508	12620	0.4636363636363636	4.7946117274167985
chr16	RFWD3	74660931	74661451	1602	521	98553	6472	96951	5951	3.074856046065259	16.29154763905226
chr16	RFWD3	74664623	74664745	28170	123	98553	6472	70383	6349	229.02439024390245	11.085682784690503
chr16	RFWD3	74664689	74664745	22116	57	98553	6472	76437	6415	388.0	11.9153546375682
chr16	RFWD3	74665232	74665280	0	49	98553	6472	98553	6423	0.0	15.343764595983185
chr16	MLKL	74675612	74675764	68	153	110520	4745	110452	4592	0.4444444444444444	24.053135888501743
chr16	MLKL	74676300	74676425	1108	126	110520	4745	109412	4619	8.793650793650794	23.687378220394024
chr16	WDR59	74908907	74908977	0	71	35443	9092	35443	9021	0.0	3.9289435761002105
chr16	WDR59	74942737	74942826	1670	90	35443	9092	33773	9002	18.555555555555557	3.7517218395912018
chr16	WDR59	74899697	74899754	51	58	35443	9092	35392	9034	0.8793103448275862	3.917644454283817
chr16	WDR59	74959349	74959592	0	244	35443	9092	35443	8848	0.0	4.005764014466546
chr16	CTRB2	75204796	75204906	1839	111	28421	2319	26582	2208	16.56756756756757	12.038949275362318
chr16	CTRB2	75204772	75204906	2190	135	28421	2319	26231	2184	16.22222222222222	12.010531135531135
chr16	CTRB2	75204741	75204906	2489	166	28421	2319	25932	2153	14.993975903614459	12.044588945657223
chr16	BCAR1	75236881	75236998	0	118	7240	8469	7240	8351	0.0	0.8669620404741947
chr16	BCAR1	75252234	75252398	0	165	7240	8469	7240	8304	0.0	0.871868978805395
chr16	BCAR1	75264350	75264601	1091	252	7240	8469	6149	8217	4.329365079365079	0.7483266398929049
chr16	BCAR1	75236827	75236998	0	172	7240	8469	7240	8297	0.0	0.8726045558635651
chr16	CFDP1	75414577	75414695	0	119	3067	2941	3067	2822	0.0	1.0868178596739901
chr16	CFDP1	75391379	75391508	51	130	3067	2941	3016	2811	0.3923076923076923	1.0729277837068658
chr16	TMEM170A	75451737	75451839	0	103	171706	5151	171706	5048	0.0	34.014659270998415
chr16	CFDP1	75419017	75419193	51	177	3067	2941	3016	2764	0.288135593220339	1.0911722141823443
chr16	CHST6	75490613	75490769	216	157	156615	7315	156399	7158	1.375796178343949	21.84953897736798
chr16	TMEM231	75545351	75545495	0	145	15467	5614	15467	5469	0.0	2.828122142987749
chr16	TMEM231	75545825	75545954	0	130	15467	5614	15467	5484	0.0	2.8203865791393143
chr16	ADAT1	75618585	75618698	0	114	180100	4501	180100	4387	0.0	41.053111465694094
chr16	ADAT1	75618585	75618640	0	56	180100	4501	180100	4445	0.0	40.51743532058493
chr16	ADAT1	75622402	75622464	0	63	180100	4501	180100	4438	0.0	40.58134294727355
chr16	KARS1	75640183	75640349	0	167	211095	3670	211095	3503	0.0	60.2612046817014
chr16	KARS1	75644282	75644462	0	181	211095	3670	211095	3489	0.0	60.503009458297505
chr16	KARS1	75636453	75636547	1923	95	211095	3670	209172	3575	20.242105263157896	58.50965034965035
chr16	KARS1	75642752	75642835	12311	84	211095	3670	198784	3586	146.5595238095238	55.43335192414947
chr16	AC105430.1	75839897	75839995	0	99	0	737	0	638	0.0	0.0
chr16	ADAMTS18	77362104	77362264	0	161	2534	6624	2534	6463	0.0	0.3920779823611326
chr16	MAFTRR	79721474	79721621	0	148	102	3915	102	3767	0.0	0.027077249800902575
chr16	MAFTRR	79751213	79751276	0	64	102	3915	102	3851	0.0	0.02648662685016879
chr16	MAFTRR	79757650	79757715	0	66	102	3915	102	3849	0.0	0.026500389711613406
chr16	MAFTRR	79740146	79740237	0	92	102	3915	102	3823	0.0	0.02668061731624379
chr16	AC105411.1	80157613	80157682	0	70	0	7114	0	7044	0.0	0.0
chr16	CDYL2	80662744	80662747	0	4	0	8838	0	8834	0.0	0.0
chr16	CDYL2	80679733	80679736	0	4	0	8838	0	8834	0.0	0.0
chr16	CDYL2	80670943	80670946	0	4	0	8838	0	8834	0.0	0.0
chr16	ARLNC1	80841061	80841152	0	92	0	5783	0	5691	0.0	0.0
chr16	ARLNC1	80837931	80838045	0	115	0	5783	0	5668	0.0	0.0
chr16	ARLNC1	80840899	80840964	0	66	0	5783	0	5717	0.0	0.0
chr16	ARLNC1	80840118	80840222	0	105	0	5783	0	5678	0.0	0.0
chr16	CMC2	81001247	81001334	49	88	876	11900	827	11812	0.5568181818181818	0.07001354554690145
chr16	ARLNC1	80841061	80841129	0	69	0	5783	0	5714	0.0	0.0
chr16	ARLNC1	80841894	80842042	0	149	0	5783	0	5634	0.0	0.0
chr16	ARLNC1	80841297	80841320	0	24	0	5783	0	5759	0.0	0.0
chr16	CMC2	80997313	80997429	0	117	876	11900	876	11783	0.0	0.07434439446660443
chr16	ARLNC1	80841979	80842042	0	64	0	5783	0	5719	0.0	0.0
chr16	ARLNC1	80837910	80838045	0	136	0	5783	0	5647	0.0	0.0
chr16	ARLNC1	80830740	80830757	0	18	0	5783	0	5765	0.0	0.0
chr16	ARLNC1	80837931	80837987	0	57	0	5783	0	5726	0.0	0.0
chr16	ARLNC1	80831692	80831876	0	185	0	5783	0	5598	0.0	0.0
chr16	ARLNC1	80837910	80837987	0	78	0	5783	0	5705	0.0	0.0
chr16	CMC2	80981805	80981877	0	73	876	11900	876	11827	0.0	0.07406781094106706
chr16	CMC2	80978241	80978415	0	175	876	11900	876	11725	0.0	0.07471215351812367
chr16	CMC2	80980769	80980879	0	111	876	11900	876	11789	0.0	0.07430655695987785
chr16	CMC2	80988539	80988596	0	58	876	11900	876	11842	0.0	0.07397399087991893
chr16	CMC2	80996922	80997020	0	99	876	11900	876	11801	0.0	0.07423099737310397
chr16	CMC2	80998284	80998354	0	71	876	11900	876	11829	0.0	0.07405528785188942
chr16	CMC2	80991753	80991957	0	205	876	11900	876	11695	0.0	0.07490380504489098
chr16	CMC2	80998284	80998351	0	68	876	11900	876	11832	0.0	0.07403651115618662
chr16	CMC2	80998284	80998473	0	190	876	11900	876	11710	0.0	0.07480785653287789
chr16	GCSH	81087600	81087664	6408	65	8547	2011	2139	1946	98.58461538461539	1.0991778006166495
chr16	GCSH	81090600	81090680	52	81	8547	2011	8495	1930	0.6419753086419753	4.401554404145077
chr16	C16ORF46	81063745	81063993	24398	249	292586	2382	268188	2133	97.9839357429719	125.73277074542898
chr16	C16ORF46	81066192	81066281	0	90	292586	2382	292586	2292	0.0	127.65532286212914
chr16	GCSH	81084462	81084594	0	133	8547	2011	8547	1878	0.0	4.55111821086262
chr16	GCSH	81090996	81091107	0	112	8547	2011	8547	1899	0.0	4.500789889415482
chr16	PKD1L2	81139507	81139712	0	206	17821	15813	17821	15607	0.0	1.1418594220542064
chr16	PKD1L2	81156858	81157089	306	232	17821	15813	17515	15581	1.3189655172413792	1.1241255375136383
chr16	PKD1L2	81177806	81177983	0	178	17821	15813	17821	15635	0.0	1.1398145187080269
chr16	PKD1L2	81179644	81179786	0	143	17821	15813	17821	15670	0.0	1.1372686662412252
chr16	SDR42E1	82000300	82000417	0	118	867	11909	867	11791	0.0	0.07353065897718598
chr16	MPHOSPH6	82164651	82164741	0	91	69	2011	69	1920	0.0	0.0359375
chr16	MPHOSPH6	82151237	82151352	0	116	69	2011	69	1895	0.0	0.03641160949868074
chr16	AC009119.1	83803668	83803715	0	48	0	5039	0	4991	0.0	0.0
chr16	MBTPS1	84074596	84074741	24	146	132591	9094	132567	8948	0.1643835616438356	14.815265981224854
chr16	MBTPS1	84084982	84085134	0	153	132591	9094	132591	8941	0.0	14.829549267419752
chr16	MBTPS1	84110712	84110825	0	114	132591	9094	132591	8980	0.0	14.765144766146994
chr16	HSDL1	84139222	84139306	322	85	89000	3850	88678	3765	3.788235294117647	23.553253652058434
chr16	TAF1C	84179945	84180083	0	139	2163	4997	2163	4858	0.0	0.4452449567723343
chr16	TAF1C	84179945	84180080	0	136	2163	4997	2163	4861	0.0	0.44497017074675993
chr16	TAF1C	84183075	84183149	0	75	2163	4997	2163	4922	0.0	0.43945550589191384
chr16	TAF1C	84183696	84183778	0	83	2163	4997	2163	4914	0.0	0.44017094017094016
chr16	TAF1C	84184850	84184899	0	50	2163	4997	2163	4947	0.0	0.4372346876895088
chr16	TAF1C	84184850	84185060	0	211	2163	4997	2163	4786	0.0	0.45194316757208525
chr16	TAF1C	84183071	84183149	0	79	2163	4997	2163	4918	0.0	0.4398129320862139
chr16	TAF1C	84184850	84184989	0	140	2163	4997	2163	4857	0.0	0.44533662754786907
chr16	AC009123.1	84195260	84195441	0	182	51	1255	51	1073	0.0	0.047530288909599254
chr16	MEAK7	84503957	84504147	2303	191	31091	7544	28788	7353	12.057591623036648	3.9151366789065687
chr16	MEAK7	84497418	84497647	1492	230	31091	7544	29599	7314	6.48695652173913	4.046896363139185
chr16	MEAK7	84502720	84502862	3738	143	31091	7544	27353	7401	26.13986013986014	3.6958519119037967
chr16	MEAK7	84499915	84500035	1177	121	31091	7544	29914	7423	9.727272727272727	4.029907045668867
chr16	COTL1	84617500	84617583	1261	84	5768	6513	4507	6429	15.011904761904763	0.7010421527453725
chr16	ZDHHC7	84981869	84981994	0	126	6596	3678	6596	3552	0.0	1.856981981981982
chr16	ZDHHC7	84988762	84988873	0	112	6596	3678	6596	3566	0.0	1.8496915311273134
chr16	C16ORF74	85710163	85710285	1054	123	67091	2085	66037	1962	8.56910569105691	33.65800203873599
chr16	C16ORF74	85710163	85710307	1155	145	67091	2085	65936	1940	7.9655172413793105	33.98762886597938
chr16	C16ORF74	85710409	85710473	20	65	67091	2085	67071	2020	0.3076923076923077	33.20346534653466
chr16	EMC8	85780378	85780473	0	96	6925	3516	6925	3420	0.0	2.0248538011695905
chr16	LINC00917	86332958	86333044	0	87	0	5647	0	5560	0.0	0.0
chr16	LINC00917	86335677	86335872	0	196	0	5647	0	5451	0.0	0.0
chr16	LINC00917	86349017	86349148	0	132	0	5647	0	5515	0.0	0.0
chr16	LINC00917	86334903	86334994	0	92	0	5647	0	5555	0.0	0.0
chr16	LINC00917	86335677	86335853	0	177	0	5647	0	5470	0.0	0.0
chr16	LINC00917	86337681	86338661	0	981	0	5647	0	4666	0.0	0.0
chr16	LINC00917	86349017	86349155	0	139	0	5647	0	5508	0.0	0.0
chr16	FENDRR	86478700	86478756	0	57	0	6492	0	6435	0.0	0.0
chr16	FENDRR	86490852	86491004	0	153	0	6492	0	6339	0.0	0.0
chr16	FENDRR	86477885	86478132	0	248	0	6492	0	6244	0.0	0.0
chr16	MTHFSD	86552032	86552146	0	115	3209	6866	3209	6751	0.0	0.4753369871130203
chr16	MTHFSD	86554644	86554751	0	108	3209	6866	3209	6758	0.0	0.47484462858833976
chr16	MTHFSD	86548034	86548111	0	78	3209	6866	3209	6788	0.0	0.4727460223924573
chr16	MTHFSD	86552178	86552292	0	115	3209	6866	3209	6751	0.0	0.4753369871130203
chr16	MTHFSD	86551972	86552146	0	175	3209	6866	3209	6691	0.0	0.479599461963832
chr16	MTHFSD	86554644	86554748	0	105	3209	6866	3209	6761	0.0	0.4746339298920278
chr16	AC010531.4	87290718	87290797	0	80	0	2102	0	2022	0.0	0.0
chr16	FBXO31	87358410	87358497	677	88	26291	6926	25614	6838	7.693181818181818	3.7458321146534073
chr16	KLHDC4	87709264	87709667	0	404	38175	8827	38175	8423	0.0	4.532233171079188
chr16	KLHDC4	87730551	87730644	588	94	38175	8827	37587	8733	6.25531914893617	4.304019237375472
chr16	KLHDC4	87748672	87748809	835	138	38175	8827	37340	8689	6.050724637681159	4.2973875014386005
chr16	KLHDC4	87756398	87756477	0	80	38175	8827	38175	8747	0.0	4.364353492626043
chr16	KLHDC4	87755193	87755292	480	100	38175	8827	37695	8727	4.8	4.319353729804057
chr16	KLHDC4	87761948	87762040	2075	93	38175	8827	36100	8734	22.311827956989248	4.13327226929242
chr16	KLHDC4	87756421	87756477	0	57	38175	8827	38175	8770	0.0	4.35290763968073
chr16	KLHDC4	87765065	87765206	4687	142	38175	8827	33488	8685	33.00704225352113	3.8558434081750144
chr16	KLHDC4	87757342	87757463	306	122	38175	8827	37869	8705	2.5081967213114753	4.350258472142447
chr16	KLHDC4	87765065	87765340	13913	276	38175	8827	24262	8551	50.40942028985507	2.8373289673722373
chr16	CA5A	87901911	87901974	160	64	66227	2077	66067	2013	2.5	32.82016890213612
chr16	CA5A	87904785	87904904	0	120	66227	2077	66227	1957	0.0	33.84108329075115
chr16	CA5A	87893618	87893726	82	109	66227	2077	66145	1968	0.7522935779816514	33.610264227642276
chr16	AC134312.5	88178783	88178952	0	170	0	2379	0	2209	0.0	0.0
chr16	CYBA	88646519	88646603	0	85	23005	2788	23005	2703	0.0	8.510913799482058
chr16	MVD	88657145	88657247	0	103	11030	4212	11030	4109	0.0	2.684351423704064
chr16	MVD	88662711	88662781	42	71	11030	4212	10988	4141	0.5915492957746479	2.6534653465346536
chr16	MVD	88660747	88660841	196	95	11030	4212	10834	4117	2.0631578947368423	2.6315278115132377
chr16	PIEZO1	88725008	88725080	1707	73	220564	10919	218857	10846	23.383561643835616	20.17859118569058
chr16	PIEZO1	88717536	88717615	0	80	220564	10919	220564	10839	0.0	20.349109696466464
chr16	APRT	88810422	88810556	50	135	1087	1728	1037	1593	0.37037037037037035	0.6509730069052103
chr16	GALNS	88837621	88837765	0	145	6435	7488	6435	7343	0.0	0.8763448181941985
chr16	GALNS	88842705	88842829	0	125	6435	7488	6435	7363	0.0	0.8739644166779845
chr16	GALNS	88843029	88843199	0	171	6435	7488	6435	7317	0.0	0.8794587945879458
chr16	PABPN1L	88864852	88864940	0	89	102	1321	102	1232	0.0	0.08279220779220779
chr16	PABPN1L	88865021	88865128	0	108	102	1321	102	1213	0.0	0.08408903544929926
chr16	CBFA2T3	88898077	88898152	0	76	497789	5793	497789	5717	0.0	87.07171593493091
chr16	CBFA2T3	88880987	88881148	5464	162	497789	5793	492325	5631	33.72839506172839	87.43118451429586
chr16	ANKRD11	89316932	89317078	816	147	29810	12643	28994	12496	5.551020408163265	2.3202624839948784
chr16	ANKRD11	89431255	89431326	105	72	29810	12643	29705	12571	1.4583333333333333	2.362978283350569
chr16	ANKRD11	89291680	89291777	0	98	29810	12643	29810	12545	0.0	2.376245516141889
chr16	ANKRD11	89316932	89317075	816	144	29810	12643	28994	12499	5.666666666666667	2.3197055764461156
chr16	ANKRD11	89288527	89288670	640	144	29810	12643	29170	12499	4.444444444444445	2.333786702936235
chr16	ANKRD11	89313316	89313589	0	274	29810	12643	29810	12369	0.0	2.4100574015684373
chr16	ANKRD11	89291680	89291799	0	120	29810	12643	29810	12523	0.0	2.380420027150044
chr16	ANKRD11	89305205	89305344	0	140	29810	12643	29810	12503	0.0	2.3842277853315204
chr16	CHMP1A	89649350	89649497	1310	148	197850	5318	196540	5170	8.85135135135135	38.015473887814316
chr16	CHMP1A	89649350	89649520	1611	171	197850	5318	196239	5147	9.421052631578947	38.12687002137167
chr16	CHMP1A	89653903	89653923	550	21	197850	5318	197300	5297	26.19047619047619	37.24749858410421
chr16	CHMP1A	89647034	89647121	5725	88	197850	5318	192125	5230	65.05681818181819	36.735181644359464
chr16	CHMP1A	89656632	89656734	51	103	197850	5318	197799	5215	0.49514563106796117	37.92885906040269
chr16	CHMP1A	89653903	89654020	1913	118	197850	5318	195937	5200	16.21186440677966	37.68019230769231
chr16	CHMP1A	89649350	89649552	1870	203	197850	5318	195980	5115	9.211822660098521	38.31476050830889
chr16	CHMP1A	89651261	89651343	2493	83	197850	5318	195357	5235	30.03614457831325	37.31747851002865
chr16	CHMP1A	89649377	89649497	992	121	197850	5318	196858	5197	8.198347107438016	37.87916105445449
chr16	FANCA	89740803	89740866	617	64	192118	7815	191501	7751	9.640625	24.7066185008386
chr16	FANCA	89742799	89742938	95	140	192118	7815	192023	7675	0.6785714285714286	25.01928338762215
chr16	FANCA	89749729	89749902	0	174	192118	7815	192118	7641	0.0	25.143044104174844
chr16	FANCA	89752137	89752222	1317	86	192118	7815	190801	7729	15.313953488372093	24.686375986544185
chr16	FANCA	89758576	89758705	673	130	192118	7815	191445	7685	5.176923076923077	24.911515940143136
chr16	FANCA	89795905	89796018	1348	114	192118	7815	190770	7701	11.824561403508772	24.77210751850409
chr16	FANCA	89803258	89803341	557	84	192118	7815	191561	7731	6.630952380952381	24.7782951752684
chr16	FANCA	89810706	89810802	255	97	192118	7815	191863	7718	2.6288659793814433	24.859160404249806
chr16	FANCA	89762637	89762793	4246	157	192118	7815	187872	7658	27.044585987261147	24.532776181770696
chr16	FANCA	89778340	89778462	2181	123	192118	7815	189937	7692	17.73170731707317	24.692797711908476
chr16	DBNDD1	90011583	90011696	0	114	7248	3943	7248	3829	0.0	1.8929224340558892
chr16	URAHP	90044113	90044233	17417	121	106698	2347	89281	2226	143.94214876033058	40.10826594788859
chr16	PRDM7	90060340	90060623	3066	284	151098	4282	148032	3998	10.795774647887324	37.02651325662831
chr16	PRDM7	90075350	90075474	153	125	151098	4282	150945	4157	1.224	36.3110416165504
chr17	RPH3AL	281767	281854	0	88	2238	6091	2238	6003	0.0	0.3728135932033983
chr17	RPH3AL	333758	333934	0	177	2238	6091	2238	5914	0.0	0.3784240784578965
chr17	VPS53	628087	628231	0	145	142813	10943	142813	10798	0.0	13.22587516206705
chr17	VPS53	661808	661895	1329	88	142813	10943	141484	10855	15.102272727272727	13.03399355135882
chr17	VPS53	632743	632841	50	99	142813	10943	142763	10844	0.5050505050505051	13.165160457395794
chr17	GEMIN4	749813	749909	146	97	1908	3543	1762	3446	1.5051546391752577	0.5113174695298898
chr17	GLOD4	770420	770507	92	88	979	3270	887	3182	1.0454545454545454	0.27875549968573227
chr17	GLOD4	780683	780738	0	56	979	3270	979	3214	0.0	0.3046048537647791
chr17	GLOD4	781862	782043	0	182	979	3270	979	3088	0.0	0.3170336787564767
chr17	NXN	805067	805247	0	181	63781	5509	63781	5328	0.0	11.970908408408409
chr17	ABR	1056034	1056109	291	76	28766	9793	28475	9717	3.8289473684210527	2.930431203046208
chr17	ABR	1100636	1100735	0	100	28766	9793	28766	9693	0.0	2.96770865573094
chr17	ABR	1012473	1012557	0	85	28766	9793	28766	9708	0.0	2.9631231973629997
chr17	ABR	1177916	1178059	15	144	28766	9793	28751	9649	0.10416666666666667	2.9796870141983627
chr17	YWHAE	1361929	1362008	51	80	54092	2966	54041	2886	0.6375	18.725225225225227
chr17	YWHAE	1369708	1369741	60	34	54092	2966	54032	2932	1.7647058823529411	18.42837653478854
chr17	YWHAE	1347961	1348008	38	48	54092	2966	54054	2918	0.7916666666666666	18.52433173406443
chr17	YWHAE	1354210	1354347	101	138	54092	2966	53991	2828	0.7318840579710145	19.09158415841584
chr17	YWHAE	1364858	1365058	51	201	54092	2966	54041	2765	0.2537313432835821	19.544665461121156
chr17	MYO1C	1486951	1487098	1495	148	39641	7816	38146	7668	10.10135135135135	4.974700052164841
chr17	INPP5K	1513452	1513561	0	110	55804	5034	55804	4924	0.0	11.33306255077173
chr17	INPP5K	1515426	1515585	0	160	55804	5034	55804	4874	0.0	11.449322938038572
chr17	INPP5K	1515887	1516118	0	232	55804	5034	55804	4802	0.0	11.620991253644315
chr17	INPP5K	1513871	1513979	0	109	55804	5034	55804	4925	0.0	11.330761421319798
chr17	INPP5K	1513452	1513554	0	103	55804	5034	55804	4931	0.0	11.316974244575137
chr17	INPP5K	1515568	1515585	0	18	55804	5034	55804	5016	0.0	11.125199362041467
chr17	PITPNA	1543019	1543027	25	9	432790	4776	432765	4767	2.7777777777777777	90.78351164254248
chr17	PITPNA	1558528	1558559	125	32	432790	4776	432665	4744	3.90625	91.20257166947724
chr17	PITPNA	1541641	1541649	0	9	432790	4776	432790	4767	0.0	90.78875603104677
chr17	PITPNA	1535784	1535841	0	58	432790	4776	432790	4718	0.0	91.73166596015261
chr17	PITPNA	1541565	1541640	0	76	432790	4776	432790	4700	0.0	92.08297872340425
chr17	PITPNA	1561198	1561281	0	84	432790	4776	432790	4692	0.0	92.23998294970161
chr17	SLC43A2	1616561	1616769	20874	209	1006389	10395	985515	10186	99.8755980861244	96.75191439230316
chr17	SLC43A2	1586948	1586960	14079	13	1006389	10395	992310	10382	1083.0	95.5798497399345
chr17	SLC43A2	1603104	1603207	102	104	1006389	10395	1006287	10291	0.9807692307692307	97.78320862889903
chr17	RILP	1646905	1646989	0	85	328	1899	328	1814	0.0	0.18081587651598677
chr17	PRPF8	1661610	1661790	0	181	238733	11016	238733	10835	0.0	22.033502538071065
chr17	PRPF8	1682128	1682293	1530	166	238733	11016	237203	10850	9.216867469879517	21.862027649769587
chr17	MIR22HG	1714370	1714453	30	84	6531	2975	6501	2891	0.35714285714285715	2.2487028709789
chr17	SMYD4	1814565	1814795	0	231	1481528	6812	1481528	6581	0.0	225.12201793040572
chr17	TSR1	2329342	2329475	1154	134	324113	4816	322959	4682	8.611940298507463	68.9788551900897
chr17	TSR1	2336036	2336140	0	105	324113	4816	324113	4711	0.0	68.79919337720229
chr17	METTL16	2467760	2467876	0	117	6529	5522	6529	5405	0.0	1.2079555966697502
chr17	METTL16	2473523	2473664	0	142	6529	5522	6529	5380	0.0	1.2135687732342006
chr17	METTL16	2502203	2502331	306	129	6529	5522	6223	5393	2.372093023255814	1.1539032078620435
chr17	METTL16	2436673	2436840	0	168	6529	5522	6529	5354	0.0	1.2194620844228614
chr17	METTL16	2475240	2475299	0	60	6529	5522	6529	5462	0.0	1.1953496887586965
chr17	CLUH	2695373	2695526	0	154	89	6845	89	6691	0.0	0.013301449708563742
chr17	OR3A2	3383803	3383899	0	97	0	2424	0	2327	0.0	0.0
chr17	SPATA22	3443173	3443271	0	99	54004	2625	54004	2526	0.0	21.37925574030087
chr17	SPATA22	3467425	3467554	104	130	54004	2625	53900	2495	0.8	21.603206412825653
chr17	SPATA22	3469282	3469398	5793	117	54004	2625	48211	2508	49.51282051282051	19.222886762360446
chr17	SPATA22	3467473	3467554	51	82	54004	2625	53953	2543	0.6219512195121951	21.216279984270546
chr17	SPATA22	3467473	3467525	49	53	54004	2625	53955	2572	0.9245283018867925	20.97783825816485
chr17	SPATA22	3468834	3468897	3428	64	54004	2625	50576	2561	53.5625	19.74853572823116
chr17	TRPV3	3546644	3546804	0	161	322103	9617	322103	9456	0.0	34.063346023688666
chr17	TRPV3	3539568	3539645	1	78	322103	9617	322102	9539	0.01282051282051282	33.76685187126533
chr17	TRPV1	3588187	3588367	0	181	1427330	5538	1427330	5357	0.0	266.4420384543588
chr17	TRPV1	3608426	3608565	0	140	1427330	5538	1427330	5398	0.0	264.41830307521303
chr17	TRPV1	3588931	3588964	0	34	1427330	5538	1427330	5504	0.0	259.32594476744185
chr17	TRPV1	3588217	3588367	0	151	1427330	5538	1427330	5387	0.0	264.95823278262486
chr17	TAX1BP3	3664194	3664272	0	79	26	1385	26	1306	0.0	0.019908116385911178
chr17	P2RX5	3681895	3681978	0	84	121	4040	121	3956	0.0	0.03058645096056623
chr17	P2RX5	3690955	3691027	0	73	121	4040	121	3967	0.0	0.030501638517771615
chr17	ITGAE	3723287	3723383	180	97	124854	6636	124674	6539	1.8556701030927836	19.066218076158435
chr17	ITGAE	3729477	3729555	5243	79	124854	6636	119611	6557	66.36708860759494	18.241726399267957
chr17	ITGAE	3732367	3732466	160	100	124854	6636	124694	6536	1.6	19.078029375764995
chr17	NCBP3	3824059	3824092	27	34	27	3296	0	3262	0.7941176470588235	0.0
chr17	CAMKK1	3882256	3882370	0	115	120	6843	120	6728	0.0	0.0178359096313912
chr17	P2RX1	3915345	3915978	4068	634	6463	3958	2395	3324	6.416403785488959	0.720517448856799
chr17	ATP2A3	3928226	3928327	8347	102	87282	6298	78935	6196	81.83333333333333	12.739670755326017
chr17	ATP2A3	3927980	3928038	0	59	87282	6298	87282	6239	0.0	13.989741945824651
chr17	ATP2A3	3928239	3928327	7629	89	87282	6298	79653	6209	85.71910112359551	12.828635851183765
chr17	ZZEF1	4056215	4056345	0	131	263654	14559	263654	14428	0.0	18.273773218741336
chr17	ZZEF1	4016632	4016774	0	143	263654	14559	263654	14416	0.0	18.288984461709212
chr17	ZZEF1	4071338	4071446	1823	109	263654	14559	261831	14450	16.724770642201836	18.119792387543253
chr17	ANKFY1	4235771	4235890	0	120	168910	12045	168910	11925	0.0	14.164360587002097
chr17	UBE2G1	4296716	4296814	0	99	134098	4548	134098	4449	0.0	30.141155315801303
chr17	UBE2G1	4331773	4331888	0	116	134098	4548	134098	4432	0.0	30.25676895306859
chr17	UBE2G1	4289229	4289408	0	180	134098	4548	134098	4368	0.0	30.700091575091577
chr17	MYBBP1A	4540347	4540484	714	138	722	5295	8	5157	5.173913043478261	0.0015512895094046927
chr17	GGT6	4559342	4559456	0	115	153	1724	153	1609	0.0	0.09509011808576756
chr17	GGT6	4559342	4559438	0	97	153	1724	153	1627	0.0	0.0940381069452981
chr17	ALOX15	4638580	4638684	1887	105	14346	3401	12459	3296	17.97142857142857	3.7800364077669903
chr17	PELP1	4683029	4683111	0	83	1173	6512	1173	6429	0.0	0.18245450303313113
chr17	VMO1	4785936	4786052	126	117	794	806	668	689	1.0769230769230769	0.969521044992743
chr17	VMO1	4785900	4786052	662	153	794	806	132	653	4.326797385620915	0.20214395099540583
chr17	VMO1	4785956	4786052	126	97	794	806	668	709	1.2989690721649485	0.9421720733427362
chr17	SLC25A11	4939059	4939212	0	154	287	1758	287	1604	0.0	0.178927680798005
chr17	CAMTA2	4973584	4973769	0	186	4143	5975	4143	5789	0.0	0.7156676455346347
chr17	CAMTA2	4982088	4982227	234	140	4143	5975	3909	5835	1.6714285714285715	0.6699228791773779
chr17	CAMTA2	4969499	4969520	0	22	4143	5975	4143	5953	0.0	0.6959516210314127
chr17	CAMTA2	4982088	4982160	176	73	4143	5975	3967	5902	2.410958904109589	0.6721450355811589
chr17	CAMTA2	4982088	4982175	204	88	4143	5975	3939	5887	2.3181818181818183	0.6691014098861899
chr17	CAMTA2	4986191	4986286	0	96	4143	5975	4143	5879	0.0	0.7047116856608266
chr17	INCA1	4995805	4995930	6230	126	20310	1562	14080	1436	49.44444444444444	9.805013927576601
chr17	SLC52A1	5033260	5033384	0	125	630	3938	630	3813	0.0	0.16522423288749016
chr17	ZNF232	5111075	5111219	0	145	1045	2800	1045	2655	0.0	0.3935969868173258
chr17	NUP88	5418014	5418116	92	103	64076	4290	63984	4187	0.8932038834951457	15.281585860998328
chr17	NUP88	5418014	5418141	192	128	64076	4290	63884	4162	1.5	15.349351273426237
chr17	DHX33	5455159	5455271	306	113	877	5801	571	5688	2.7079646017699117	0.10038677918424754
chr17	DHX33	5463528	5463689	0	162	877	5801	877	5639	0.0	0.15552402908317078
chr17	DERL2	5481295	5481389	0	95	1154	5129	1154	5034	0.0	0.22924116011124354
chr17	DERL2	5480386	5480459	0	74	1154	5129	1154	5055	0.0	0.22828882294757666
chr17	DERL2	5480386	5480543	0	158	1154	5129	1154	4971	0.0	0.23214644940655804
chr17	NLRP1	5520880	5521012	0	133	867	11515	867	11382	0.0	0.07617290458618872
chr17	NLRP1	5536850	5536940	0	91	867	11515	867	11424	0.0	0.07589285714285714
chr17	AIPL1	6428317	6428506	0	190	102	3150	102	2960	0.0	0.03445945945945946
chr17	AIPL1	6433918	6434098	0	181	102	3150	102	2969	0.0	0.03435500168406871
chr17	AIPL1	6433918	6434062	0	145	102	3150	102	3005	0.0	0.03394342762063228
chr17	AIPL1	6433918	6434032	0	115	102	3150	102	3035	0.0	0.03360790774299835
chr17	PITPNM3	6525355	6525463	0	109	23205	10693	23205	10584	0.0	2.1924603174603177
chr17	KIAA0753	6611918	6612148	0	231	204	5573	204	5342	0.0	0.038187944590041184
chr17	KIAA0753	6624754	6624861	0	108	204	5573	204	5465	0.0	0.037328453796889295
chr17	KIAA0753	6635010	6635171	0	162	204	5573	204	5411	0.0	0.03770097948623175
chr17	KIAA0753	6635400	6635634	0	235	204	5573	204	5338	0.0	0.03821656050955414
chr17	MED31	6649981	6650078	0	98	0	2018	0	1920	0.0	0.0
chr17	SLC13A5	6687528	6687666	0	139	36	5209	36	5070	0.0	0.007100591715976331
chr17	SLC13A5	6707027	6707156	36	130	36	5209	0	5079	0.27692307692307694	0.0
chr17	SLC13A5	6707031	6707156	32	126	36	5209	4	5083	0.25396825396825395	0.0007869368483179224
chr17	SLC13A5	6707027	6707045	19	19	36	5209	17	5190	1.0	0.0032755298651252407
chr17	SLC13A5	6707027	6707148	36	122	36	5209	0	5087	0.29508196721311475	0.0
chr17	TEKT1	6800746	6800943	0	198	1071	3628	1071	3430	0.0	0.3122448979591837
chr17	TEKT1	6819192	6819358	357	167	1071	3628	714	3461	2.1377245508982035	0.20629875758451316
chr17	ALOX12-AS1	7009795	7009889	0	95	255	5591	255	5496	0.0	0.04639737991266375
chr17	ALOX12-AS1	7010058	7010137	0	80	255	5591	255	5511	0.0	0.04627109417528579
chr17	SLC16A11	7041995	7042763	0	769	21	1985	21	1216	0.0	0.017269736842105265
chr17	CLEC10A	7075359	7075466	28	108	2548	2340	2520	2232	0.25925925925925924	1.1290322580645162
chr17	ASGR1	7176829	7176901	0	73	199	2880	199	2807	0.0	0.0708941930887068
chr17	ASGR1	7177209	7177326	46	118	199	2880	153	2762	0.3898305084745763	0.055394641564083996
chr17	DLG4	7191892	7192002	579	111	295145	9775	294566	9664	5.216216216216216	30.48075331125828
chr17	DLG4	7208173	7208239	0	67	295145	9775	295145	9708	0.0	30.40224557066337
chr17	DLG4	7208074	7208239	0	166	295145	9775	295145	9609	0.0	30.715475075450097
chr17	PHF23	7237628	7237660	0	33	437	2660	437	2627	0.0	0.16634944803958887
chr17	GABARAP	7241600	7241679	0	80	0	1609	0	1529	0.0	0.0
chr17	CTDNEP1	7246790	7246862	0	73	804	2647	804	2574	0.0	0.3123543123543124
chr17	CTDNEP1	7251194	7251601	714	408	804	2647	90	2239	1.75	0.0401965163019205
chr17	CLDN7	7260641	7260726	0	86	51	2285	51	2199	0.0	0.023192360163710776
chr17	GPS2	7313905	7313988	1631	84	43701	2507	42070	2423	19.416666666666668	17.362773421378456
chr17	NEURL4	7327164	7327230	63	67	684454	6057	684391	5990	0.9402985074626866	114.25559265442404
chr17	PLSCR3	7393143	7393364	0	222	1303	2551	1303	2329	0.0	0.5594675826534994
chr17	PLSCR3	7393600	7393836	27	237	1303	2551	1276	2314	0.11392405063291139	0.5514261019878998
chr17	TMEM256-PLSCR3	7403309	7403390	60	82	68600	2568	68540	2486	0.7317073170731707	27.570394207562348
chr17	SAT2	7626942	7627044	0	103	0	1405	0	1302	0.0	0.0
chr17	SAT2	7627142	7627226	0	85	0	1405	0	1320	0.0	0.0
chr17	TP53	7674858	7674971	0	114	204	5536	204	5422	0.0	0.03762449280708226
chr17	TP53	7675993	7676272	0	280	204	5536	204	5256	0.0	0.03881278538812785
chr17	TP53	7673206	7673266	0	61	204	5536	204	5475	0.0	0.03726027397260274
chr17	TP53	7670608	7670715	0	108	204	5536	204	5428	0.0	0.03758290346352248
chr17	TP53	7673206	7673339	0	134	204	5536	204	5402	0.0	0.03776379118844872
chr17	TP53	7677324	7677427	0	104	204	5536	204	5432	0.0	0.03755522827687776
chr17	KCNAB3	7925096	7925183	0	88	17880	4331	17880	4243	0.0	4.2139995286354
chr17	KCNAB3	7925309	7925501	0	193	17880	4331	17880	4138	0.0	4.320927984533591
chr17	TRAPPC1	7931505	7931576	0	72	0	1175	0	1103	0.0	0.0
chr17	ALOX12B	8079395	8079539	5887	145	49772	2762	43885	2617	40.6	16.76920137562094
chr17	HES7	8123319	8123505	956	187	2110	906	1154	719	5.112299465240642	1.6050069541029208
chr17	PER1	8143265	8143876	543	612	43786	6344	43243	5732	0.8872549019607843	7.5441381716678295
chr17	PER1	8145957	8146137	114	181	43786	6344	43672	6163	0.6298342541436464	7.086159337984748
chr17	PER1	8146896	8147002	0	107	43786	6344	43786	6237	0.0	7.020362353695687
chr17	PER1	8150218	8150317	51	100	43786	6344	43735	6244	0.51	7.004324151185138
chr17	PER1	8153929	8153980	443	52	43786	6344	43343	6292	8.51923076923077	6.8885886840432295
chr17	TMEM107	8175958	8176026	799	69	862526	3772	861727	3703	11.579710144927537	232.71050499594924
chr17	AURKB	8210176	8210249	0	74	818	2119	818	2045	0.0	0.4
chr17	AURKB	8206749	8206934	0	186	818	2119	818	1933	0.0	0.4231764097258148
chr17	AURKB	8210176	8210225	0	50	818	2119	818	2069	0.0	0.3953600773320445
chr17	AURKB	8209953	8210055	0	103	818	2119	818	2016	0.0	0.40575396825396826
chr17	CTC1	8229141	8229206	0	66	570	8044	570	7978	0.0	0.07144647781398847
chr17	CTC1	8231275	8231469	0	195	570	8044	570	7849	0.0	0.07262071601477896
chr17	CTC1	8242984	8243148	0	165	570	8044	570	7879	0.0	0.0723442061175276
chr17	CTC1	8228726	8228892	0	167	570	8044	570	7877	0.0	0.07236257458423258
chr17	CTC1	8233362	8233456	0	95	570	8044	570	7949	0.0	0.07170713297270097
chr17	SLC25A35	8290602	8290678	0	77	807	3447	807	3370	0.0	0.23946587537091987
chr17	SLC25A35	8290614	8290678	0	65	807	3447	807	3382	0.0	0.23861620342992312
chr17	KRBA2	8371308	8372081	63030	774	330757	13409	267727	12635	81.43410852713178	21.189315393747528
chr17	RPL26	8380586	8380703	614	118	57869	2188	57255	2070	5.203389830508475	27.659420289855074
chr17	MYH10	8576642	8576669	0	28	6163	9053	6163	9025	0.0	0.6828808864265928
chr17	MYH10	8530622	8530685	112	64	6163	9053	6051	8989	1.75	0.6731560796529091
chr17	MYH10	8576642	8576672	0	31	6163	9053	6163	9022	0.0	0.6831079583240967
chr17	MYH10	8623423	8623497	0	75	6163	9053	6163	8978	0.0	0.686455780797505
chr17	CCDC42	8735389	8735611	0	223	0	1716	0	1493	0.0	0.0
chr17	PIK3R6	8832888	8833045	0	158	0	3586	0	3428	0.0	0.0
chr17	PIK3R6	8803661	8803802	0	142	0	3586	0	3444	0.0	0.0
chr17	PIK3R5	8911391	8911507	0	117	56	7453	56	7336	0.0	0.007633587786259542
chr17	PIK3R5	8889972	8890126	0	155	56	7453	56	7298	0.0	0.007673335160317895
chr17	PIK3R5	8890737	8890912	0	176	56	7453	56	7277	0.0	0.007695478906142641
chr17	STX8	9568370	9568470	0	101	1700	2932	1700	2831	0.0	0.6004945249028611
chr17	STX8	9505037	9505162	0	126	1700	2932	1700	2806	0.0	0.6058446186742694
chr17	DHRS7C	9772766	9772922	0	157	0	1307	0	1150	0.0	0.0
chr17	GAS7	9969676	9969762	102	87	131	3981	29	3894	1.1724137931034482	0.007447354904982024
chr17	GAS7	10027019	10027099	0	81	131	3981	131	3900	0.0	0.03358974358974359
chr17	MYH13	10371208	10371259	0	52	0	6161	0	6109	0.0	0.0
chr17	SCO1	10691589	10691649	0	61	51	10307	51	10246	0.0	0.004977552215498731
chr17	TMEM220	10723269	10723329	0	61	0	3223	0	3162	0.0	0.0
chr17	TMEM220	10729030	10729060	0	31	0	3223	0	3192	0.0	0.0
chr17	TMEM220	10724454	10724502	0	49	0	3223	0	3174	0.0	0.0
chr17	ZNF18	11983296	11983407	0	112	2530	2988	2530	2876	0.0	0.8796940194714882
chr17	ZNF18	11983296	11983404	0	109	2530	2988	2530	2879	0.0	0.8787773532476555
chr17	ZNF18	11993501	11993654	51	154	2530	2988	2479	2834	0.33116883116883117	0.8747353563867325
chr17	ELAC2	13011662	13011782	0	121	408	6704	408	6583	0.0	0.061977821661856294
chr17	ELAC2	13014438	13014496	0	59	408	6704	408	6645	0.0	0.06139954853273138
chr17	LINC02093	13303151	13303270	0	120	0	621	0	501	0.0	0.0
chr17	COX10-AS1	14033551	14033661	0	111	0	11234	0	11123	0.0	0.0
chr17	AC005863.1	14776732	14776885	0	154	0	3446	0	3292	0.0	0.0
chr17	PMP22	15239470	15239611	0	142	0	6135	0	5993	0.0	0.0
chr17	PMP22	15260649	15260761	0	113	0	6135	0	6022	0.0	0.0
chr17	PMP22	15233188	15233355	0	168	0	6135	0	5967	0.0	0.0
chr17	PMP22	15253452	15253554	0	103	0	6135	0	6032	0.0	0.0
chr17	PMP22	15232368	15232613	0	246	0	6135	0	5889	0.0	0.0
chr17	PMP22	15259093	15259193	0	101	0	6135	0	6034	0.0	0.0
chr17	PMP22	15239470	15239600	0	131	0	6135	0	6004	0.0	0.0
chr17	PMP22	15260649	15260757	0	109	0	6135	0	6026	0.0	0.0
chr17	PMP22	15260649	15260983	0	335	0	6135	0	5800	0.0	0.0
chr17	PMP22	15235218	15235284	0	67	0	6135	0	6068	0.0	0.0
chr17	TEKT3	15340027	15340061	2597	35	6939	2613	4342	2578	74.2	1.6842513576415825
chr17	TEKT3	15310872	15311012	0	141	6939	2613	6939	2472	0.0	2.8070388349514563
chr17	TEKT3	15340421	15340519	1031	99	6939	2613	5908	2514	10.414141414141413	2.3500397772474146
chr17	TVP23C	15553684	15553829	352	146	44612	5447	44260	5301	2.410958904109589	8.349368043765327
chr17	TVP23C	15540432	15540561	0	130	44612	5447	44612	5317	0.0	8.390445740078992
chr17	TVP23C	15553764	15553829	0	66	44612	5447	44612	5381	0.0	8.290652295112432
chr17	CDRT4	15440207	15440285	681	79	15943	3262	15262	3183	8.620253164556962	4.794847628023877
chr17	TRIM16	15632508	15632674	0	167	5359	4831	5359	4664	0.0	1.1490137221269296
chr17	TRIM16	15651090	15651946	1020	857	5359	4831	4339	3974	1.1901983663943991	1.091847005535984
chr17	TRIM16	15682853	15682951	0	99	5359	4831	5359	4732	0.0	1.132502113271344
chr17	TRIM16	15677574	15677721	0	148	5359	4831	5359	4683	0.0	1.1443519111680547
chr17	TRIM16	15631618	15631714	0	97	5359	4831	5359	4734	0.0	1.1320236586396282
chr17	TRIM16	15658801	15658876	0	76	5359	4831	5359	4755	0.0	1.1270241850683491
chr17	TRIM16	15682860	15682951	0	92	5359	4831	5359	4739	0.0	1.1308292888795104
chr17	ZSWIM7	15993756	15993778	0	23	6388	2082	6388	2059	0.0	3.1024769305488102
chr17	ZSWIM7	15977578	15977913	0	336	6388	2082	6388	1746	0.0	3.65864833906071
chr17	ZSWIM7	15981039	15981144	22	106	6388	2082	6366	1976	0.20754716981132076	3.22165991902834
chr17	ZSWIM7	15986799	15986886	0	88	6388	2082	6388	1994	0.0	3.2036108324974926
chr17	ZSWIM7	15990864	15991104	765	241	6388	2082	5623	1841	3.1742738589211617	3.054318305268876
chr17	ZSWIM7	15986799	15986892	0	94	6388	2082	6388	1988	0.0	3.2132796780684103
chr17	NCOR1	16087171	16087345	0	175	77691	14501	77691	14326	0.0	5.423076923076923
chr17	NCOR1	16151589	16151616	0	28	77691	14501	77691	14473	0.0	5.367995577972777
chr17	NCOR1	16198600	16198719	0	120	77691	14501	77691	14381	0.0	5.402336416104583
chr17	CENPV	16349139	16349333	645	195	1160209	1849	1159564	1654	3.3076923076923075	701.0665054413543
chr17	LRRC75A	16447844	16447960	0	117	969	3740	969	3623	0.0	0.2674579078112062
chr17	ZNF287	16568042	16568117	0	76	1967	7922	1967	7846	0.0	0.2507009941371399
chr17	KRT17P4	16848999	16849077	0	79	0	2302	0	2223	0.0	0.0
chr17	TBC1D27P	16928791	16928876	0	86	51	4955	51	4869	0.0	0.010474430067775724
chr17	TNFRSF13B	16952445	16952583	0	139	3570	3037	3570	2898	0.0	1.2318840579710144
chr17	COPS3	17247479	17247560	0	82	0	2898	0	2816	0.0	0.0
chr17	COPS3	17260300	17260474	0	175	0	2898	0	2723	0.0	0.0
chr17	COPS3	17264801	17264981	0	181	0	2898	0	2717	0.0	0.0
chr17	COPS3	17270757	17270807	0	51	0	2898	0	2847	0.0	0.0
chr17	COPS3	17276034	17276164	0	131	0	2898	0	2767	0.0	0.0
chr17	COPS3	17276034	17276183	0	150	0	2898	0	2748	0.0	0.0
chr17	COPS3	17261599	17261692	0	94	0	2898	0	2804	0.0	0.0
chr17	PEMT	17522279	17522395	0	117	302	1735	302	1618	0.0	0.18665018541409148
chr17	PEMT	17507168	17507202	33	35	302	1735	269	1700	0.9428571428571428	0.15823529411764706
chr17	PEMT	17507168	17507199	33	32	302	1735	269	1703	1.03125	0.15795654726952438
chr17	PEMT	17512508	17512654	14	147	302	1735	288	1588	0.09523809523809523	0.181360201511335
chr17	PEMT	17565250	17565306	0	57	302	1735	302	1678	0.0	0.1799761620977354
chr17	SREBF1	17813367	17813479	357	113	14378	6629	14021	6516	3.15929203539823	2.151780233271946
chr17	SREBF1	17814614	17814747	0	134	14378	6629	14378	6495	0.0	2.2137028483448806
chr17	SREBF1	17817547	17817591	220	45	14378	6629	14158	6584	4.888888888888889	2.1503645200486026
chr17	SREBF1	17823517	17823607	0	91	14378	6629	14378	6538	0.0	2.1991434689507496
chr17	TOM1L2	17850892	17850952	0	61	12598	7882	12598	7821	0.0	1.6107914588927248
chr17	TOM1L2	17882704	17882863	0	160	12598	7882	12598	7722	0.0	1.6314426314426314
chr17	TOM1L2	17884633	17884768	35	136	12598	7882	12563	7746	0.25735294117647056	1.6218693519235734
chr17	TOM1L2	17893660	17893810	0	151	12598	7882	12598	7731	0.0	1.6295433967145259
chr17	TOM1L2	17857768	17857855	0	88	12598	7882	12598	7794	0.0	1.6163715678727226
chr17	ATPAF2	18021122	18021238	0	117	51	5022	51	4905	0.0	0.010397553516819572
chr17	ATPAF2	18021744	18021857	0	114	51	5022	51	4908	0.0	0.01039119804400978
chr17	ATPAF2	18028231	18028377	0	147	51	5022	51	4875	0.0	0.010461538461538461
chr17	FLII	18245743	18245850	0	108	143447	5686	143447	5578	0.0	25.71656507708856
chr17	FLII	18253543	18253719	0	177	143447	5686	143447	5509	0.0	26.03866400435651
chr17	FLII	18254520	18254682	0	163	143447	5686	143447	5523	0.0	25.972659786348
chr17	FLII	18254520	18254619	0	100	143447	5686	143447	5586	0.0	25.679735051915504
chr17	FLII	18253598	18253719	0	122	143447	5686	143447	5564	0.0	25.781272465851906
chr17	TOP3A	18292644	18292852	35	209	800	5240	765	5031	0.1674641148325359	0.1520572450805009
chr17	TOP3A	18305111	18305220	0	110	800	5240	800	5130	0.0	0.15594541910331383
chr17	TOP3A	18308350	18308424	0	75	800	5240	800	5165	0.0	0.15488867376573087
chr17	TOP3A	18308881	18308941	0	61	800	5240	800	5179	0.0	0.15446997489862907
chr17	TOP3A	18308312	18308424	0	113	800	5240	800	5127	0.0	0.15603666861712503
chr17	SHMT1	18335558	18335675	0	118	0	4817	0	4699	0.0	0.0
chr17	SHMT1	18348324	18348440	0	117	0	4817	0	4700	0.0	0.0
chr17	SHMT1	18360413	18360552	0	140	0	4817	0	4677	0.0	0.0
chr17	NOS2P2	18499195	18499388	32	194	389	1981	357	1787	0.16494845360824742	0.19977616116396194
chr17	NOS2P2	18500914	18501036	0	123	389	1981	389	1858	0.0	0.2093649085037675
chr17	FAM106A	18532711	18532902	0	192	4864	8673	4864	8481	0.0	0.573517273906379
chr17	FAM106A	18521078	18521145	78	68	4864	8673	4786	8605	1.1470588235294117	0.5561882626380011
chr17	FAM106A	18523776	18523877	216	102	4864	8673	4648	8571	2.1176470588235294	0.5422937813557345
chr17	USP32P2	18516524	18516617	0	94	4447	5285	4447	5191	0.0	0.8566750144480832
chr17	FAM106A	18527569	18527760	51	192	4864	8673	4813	8481	0.265625	0.5675038320952718
chr17	FAM106A	18528572	18528747	919	176	4864	8673	3945	8497	5.221590909090909	0.46428151112157234
chr17	FAM106A	18542868	18542987	0	120	4864	8673	4864	8553	0.0	0.5686893487665147
chr17	FAM106A	18532505	18532597	0	93	4864	8673	4864	8580	0.0	0.566899766899767
chr17	FAM106A	18523650	18523877	357	228	4864	8673	4507	8445	1.5657894736842106	0.5336885731201895
chr17	FAM106A	18524142	18524400	0	259	4864	8673	4864	8414	0.0	0.5780841454718326
chr17	FAM106A	18542987	18543094	0	108	4864	8673	4864	8565	0.0	0.5678925861062464
chr17	CCDC144B	18577939	18578077	1173	139	155553	9924	154380	9785	8.43884892086331	15.777210015329587
chr17	TBC1D28	18642585	18642632	0	48	157945	4165	157945	4117	0.0	38.364100072868595
chr17	GRAP	19024214	19024383	153	170	367	2505	214	2335	0.9	0.09164882226980728
chr17	GRAP	19030375	19030443	0	69	367	2505	367	2436	0.0	0.1506568144499179
chr17	B9D1	19343789	19343857	0	69	785	6772	785	6703	0.0	0.1171117410114874
chr17	B9D1	19357571	19357634	0	64	785	6772	785	6708	0.0	0.11702444841979726
chr17	B9D1	19340104	19340109	0	6	785	6772	785	6766	0.0	0.1160212828850133
chr17	AC004448.2	19453584	19453660	46	77	6818	4848	6772	4771	0.5974025974025974	1.4194089289457137
chr17	AC004448.2	19455867	19456005	0	139	6818	4848	6818	4709	0.0	1.4478657889148439
chr17	SLC47A2	19703091	19703167	0	77	44087	5723	44087	5646	0.0	7.808537017357422
chr17	SLC47A2	19704652	19704694	0	43	44087	5723	44087	5680	0.0	7.761795774647887
chr17	ALDH3A1	19738995	19739095	0	101	995	3484	995	3383	0.0	0.29411764705882354
chr17	ALDH3A1	19744967	19745134	0	168	995	3484	995	3316	0.0	0.3000603136308806
chr17	ULK2	19785936	19786086	147	151	24975	9898	24828	9747	0.9735099337748344	2.5472453062480764
chr17	ULK2	19816748	19816920	0	173	24975	9898	24975	9725	0.0	2.5681233933161955
chr17	ULK2	19826138	19826186	0	49	24975	9898	24975	9849	0.0	2.535790435577216
chr17	ULK2	19785936	19786005	0	70	24975	9898	24975	9828	0.0	2.541208791208791
chr17	ULK2	19848254	19848344	0	91	24975	9898	24975	9807	0.0	2.546650351789538
chr17	ULK2	19860940	19861055	0	116	24975	9898	24975	9782	0.0	2.553158863218156
chr17	AKAP10	19924407	19924517	0	111	6188	4590	6188	4479	0.0	1.3815583835677607
chr17	AKAP10	19931804	19931978	0	175	6188	4590	6188	4415	0.0	1.40158550396376
chr17	AKAP10	19940886	19941010	0	125	6188	4590	6188	4465	0.0	1.3858902575587906
chr17	AKAP10	19924407	19924512	0	106	6188	4590	6188	4484	0.0	1.3800178412132025
chr17	AKAP10	19967918	19968034	0	117	6188	4590	6188	4473	0.0	1.3834115805946792
chr17	LGALS9B	20460351	20460443	0	93	51	2682	51	2589	0.0	0.019698725376593278
chr17	LGALS9B	20457377	20457563	0	187	51	2682	51	2495	0.0	0.020440881763527055
chr17	LINC02693	21573225	21573735	0	511	3181	11034	3181	10523	0.0	0.3022902214197472
chr17	LINC02693	21533391	21533510	0	120	3181	11034	3181	10914	0.0	0.2914605094374198
chr17	LINC02693	21550995	21551116	0	122	3181	11034	3181	10912	0.0	0.2915139296187683
chr17	LINC02693	21546705	21546799	0	95	3181	11034	3181	10939	0.0	0.2907944053386964
chr17	LINC02002	22241265	22241508	280	244	520	1721	240	1477	1.1475409836065573	0.16249153689911983
chr17	LINC02002	22245825	22245930	0	106	520	1721	520	1615	0.0	0.3219814241486068
chr17	LINC02002	22241265	22241505	280	241	520	1721	240	1480	1.161825726141079	0.16216216216216217
chr17	LINC02002	22254345	22254489	0	145	520	1721	520	1576	0.0	0.3299492385786802
chr17	LINC02002	22240991	22241162	240	172	520	1721	280	1549	1.3953488372093024	0.18076178179470626
chr17	LYRM9	27880120	27880183	0	64	58107	3560	58107	3496	0.0	16.62099542334096
chr17	LINC01992	27988764	27988870	0	107	26628	3413	26628	3306	0.0	8.054446460980037
chr17	IFT20	28332145	28332181	0	37	0	2307	0	2270	0.0	0.0
chr17	IFT20	28329172	28329276	0	105	0	2307	0	2202	0.0	0.0
chr17	IFT20	28330110	28330228	0	119	0	2307	0	2188	0.0	0.0
chr17	IFT20	28332145	28332382	0	238	0	2307	0	2069	0.0	0.0
chr17	IFT20	28332689	28332723	0	35	0	2307	0	2272	0.0	0.0
chr17	SLC46A1	28402237	28402321	0	85	78795	7870	78795	7785	0.0	10.121387283236995
chr17	SLC46A1	28400609	28400766	0	158	78795	7870	78795	7712	0.0	10.21719398340249
chr17	SLC46A1	28405886	28405997	0	112	78795	7870	78795	7758	0.0	10.15661252900232
chr17	PIGS	28561421	28561629	0	209	306	4809	306	4600	0.0	0.06652173913043478
chr17	PIGS	28570851	28570963	0	113	306	4809	306	4696	0.0	0.0651618398637138
chr17	PIGS	28571048	28571188	39	141	306	4809	267	4668	0.2765957446808511	0.05719794344473008
chr17	ALDOC	28574493	28574577	0	85	153368	2363	153368	2278	0.0	67.32572431957858
chr17	ALDOC	28575964	28576020	9596	57	153368	2363	143772	2306	168.35087719298247	62.346921075455334
chr17	ALDOC	28575964	28576017	8934	54	153368	2363	144434	2309	165.44444444444446	62.55262018189693
chr17	SPAG5	28584651	28584745	0	95	4663	4721	4663	4626	0.0	1.007998270644185
chr17	SPAG5	28585533	28585653	364	121	4663	4721	4299	4600	3.0082644628099175	0.9345652173913044
chr17	SPAG5	28582726	28582819	0	94	4663	4721	4663	4627	0.0	1.00778041927815
chr17	KIAA0100	28616888	28616999	0	112	120173	9105	120173	8993	0.0	13.362948960302457
chr17	KIAA0100	28643609	28643659	0	51	120173	9105	120173	9054	0.0	13.272918047271924
chr17	SDF2	28655286	28655483	0	198	0	2825	0	2627	0.0	0.0
chr17	SDF2	28651485	28651542	0	58	0	2825	0	2767	0.0	0.0
chr17	SDF2	28651485	28651577	0	93	0	2825	0	2732	0.0	0.0
chr17	PROCA1	28706679	28706763	9477	85	9951	3553	474	3468	111.49411764705883	0.13667820069204153
chr17	RAB34	28715992	28716061	0	70	816	3005	816	2935	0.0	0.2780238500851789
chr17	RAB34	28715992	28716058	0	67	816	3005	816	2938	0.0	0.27773995915588834
chr17	RAB34	28716902	28716994	0	93	816	3005	816	2912	0.0	0.2802197802197802
chr17	FAM222B	28790377	28790425	0	49	14290	5523	14290	5474	0.0	2.610522469857508
chr17	FAM222B	28834292	28834326	0	35	14290	5523	14290	5488	0.0	2.603862973760933
chr17	FAM222B	28777047	28777149	0	103	14290	5523	14290	5420	0.0	2.6365313653136533
chr17	FAM222B	28761985	28762156	0	172	14290	5523	14290	5351	0.0	2.6705288731078305
chr17	FLOT2	28885611	28885685	0	75	0	3397	0	3322	0.0	0.0
chr17	FLOT2	28888944	28889026	0	83	0	3397	0	3314	0.0	0.0
chr17	FLOT2	28884224	28884315	0	92	0	3397	0	3305	0.0	0.0
chr17	FLOT2	28885856	28885947	0	92	0	3397	0	3305	0.0	0.0
chr17	PHF12	28919142	28919275	0	134	4355	6230	4355	6096	0.0	0.7144028871391076
chr17	PHF12	28923908	28924302	387	395	4355	6230	3968	5835	0.979746835443038	0.6800342759211654
chr17	PHF12	28911329	28911384	0	56	4355	6230	4355	6174	0.0	0.7053773890508584
chr17	SEZ6	28956718	28956757	310	40	69647	4750	69337	4710	7.75	14.721231422505308
chr17	MYO18A	29085603	29085648	197	46	136437	15087	136240	15041	4.282608695652174	9.05790838375108
chr17	MYO18A	29093979	29094090	198	112	136437	15087	136239	14975	1.7678571428571428	9.097762938230384
chr17	MYO18A	29086437	29086577	10226	141	136437	15087	126211	14946	72.52482269503547	8.444466746955706
chr17	MYO18A	29137015	29137084	0	70	136437	15087	136437	15017	0.0	9.085503096490644
chr17	MYO18A	29079726	29081000	3072	1275	136437	15087	133365	13812	2.409411764705882	9.655734144222416
chr17	MYO18A	29124652	29124688	32	37	136437	15087	136405	15050	0.8648648648648649	9.063455149501662
chr17	NUFIP2	29285991	29287716	0	1726	816	10881	816	9155	0.0	0.08913162206444566
chr17	GIT1	29578961	29578988	316	28	5346	5400	5030	5372	11.285714285714286	0.9363365599404319
chr17	CORO6	29617499	29617619	0	121	261	4103	261	3982	0.0	0.06554495228528377
chr17	CORO6	29621223	29621423	0	201	261	4103	261	3902	0.0	0.06688877498718605
chr17	CORO6	29617241	29617340	0	100	261	4103	261	4003	0.0	0.06520109917561828
chr17	CORO6	29618047	29618167	0	121	261	4103	261	3982	0.0	0.06554495228528377
chr17	CORO6	29621223	29621484	0	262	261	4103	261	3841	0.0	0.0679510544129133
chr17	SSH2	29848848	29848929	51	82	11776	7664	11725	7582	0.6219512195121951	1.5464257451859669
chr17	SLC6A4	30209142	30209242	0	101	99059	6998	99059	6897	0.0	14.362621429607076
chr17	SLC6A4	30222818	30222915	60	98	99059	6998	98999	6900	0.6122448979591837	14.34768115942029
chr17	BLMH	30289372	30289482	0	111	4080	5133	4080	5022	0.0	0.8124253285543608
chr17	TMIGD1	30318809	30318913	0	105	2364	1235	2364	1130	0.0	2.0920353982300885
chr17	CRLF3	30803900	30804108	1853	209	74157	2781	72304	2572	8.866028708133971	28.111975116640746
chr17	AC134669.1	31307886	31307959	0	74	0	1247	0	1173	0.0	0.0
chr17	AC134669.1	31313978	31314044	0	67	0	1247	0	1180	0.0	0.0
chr17	EVI2A	31320372	31320513	0	142	102	3090	102	2948	0.0	0.03459972862957938
chr17	COPRS	31856798	31856865	0	68	0	1318	0	1250	0.0	0.0
chr17	COPRS	31856564	31856711	0	148	0	1318	0	1170	0.0	0.0
chr17	UTP6	31865365	31865438	0	74	51	6216	51	6142	0.0	0.008303484207098664
chr17	UTP6	31866654	31866715	0	62	51	6216	51	6154	0.0	0.008287292817679558
chr17	C17ORF75	32333416	32333520	0	105	0	5756	0	5651	0.0	0.0
chr17	MYO1D	32745521	32745689	0	169	0	8223	0	8054	0.0	0.0
chr17	CCT6B	34958559	34958694	13987	136	124395	4148	110408	4012	102.84558823529412	27.519441674975074
chr17	CCT6B	34942795	34942906	4183	112	124395	4148	120212	4036	37.348214285714285	29.784935579781962
chr17	RFFL	35014739	35014763	0	25	255	6708	255	6683	0.0	0.038156516534490495
chr17	RFFL	35017522	35017606	0	85	255	6708	255	6623	0.0	0.03850218934017817
chr17	RFFL	35021370	35021781	0	412	255	6708	255	6296	0.0	0.04050190597204574
chr17	RFFL	35069293	35069658	0	366	255	6708	255	6342	0.0	0.0402081362346263
chr17	RFFL	35036337	35036518	0	182	255	6708	255	6526	0.0	0.03907447134538768
chr17	RAD51D	35107365	35107447	0	83	153	11317	153	11234	0.0	0.01361936977034004
chr17	RFFL	35025182	35025340	0	159	255	6708	255	6549	0.0	0.03893724232707284
chr17	RAD51D	35106987	35107122	0	136	153	11317	153	11181	0.0	0.013683928092299437
chr17	RAD51D	35118500	35118619	0	120	153	11317	153	11197	0.0	0.013664374385996249
chr17	RAD51D	35106127	35106249	0	123	153	11317	153	11194	0.0	0.013668036448097194
chr17	RAD51D	35116858	35117037	0	180	153	11317	153	11137	0.0	0.013737990482176528
chr17	RAD51D	35106987	35107061	0	75	153	11317	153	11242	0.0	0.013609677993239637
chr17	NLE1	35137542	35137640	0	99	0	5488	0	5389	0.0	0.0
chr17	NLE1	35139848	35140066	0	219	0	5488	0	5269	0.0	0.0
chr17	NLE1	35134942	35135059	0	118	0	5488	0	5370	0.0	0.0
chr17	NLE1	35139819	35140066	0	248	0	5488	0	5240	0.0	0.0
chr17	SLFN11	35366946	35367043	0	98	2457	4258	2457	4160	0.0	0.590625
chr17	SLFN11	35367602	35367700	102	99	2457	4258	2355	4159	1.0303030303030303	0.5662418850685261
chr17	SLFN11	35366946	35367063	0	118	2457	4258	2457	4140	0.0	0.5934782608695652
chr17	SLFN11	35367649	35367700	82	52	2457	4258	2375	4206	1.5769230769230769	0.5646695197337137
chr17	SLFN11	35367540	35367700	102	161	2457	4258	2355	4097	0.6335403726708074	0.5748108371979497
chr17	SLFN12	35430470	35430592	0	123	1071	3433	1071	3310	0.0	0.32356495468277946
chr17	SLFN12	35432187	35432257	0	71	1071	3433	1071	3362	0.0	0.3185603807257585
chr17	SLFN12	35430470	35430613	0	144	1071	3433	1071	3289	0.0	0.3256308908482822
chr17	SLFN13	35446716	35446753	532	38	63464	9056	62932	9018	14.0	6.978487469505434
chr17	SLFN13	35445372	35445693	0	322	63464	9056	63464	8734	0.0	7.266315548431417
chr17	SLFN13	35445655	35445693	0	39	63464	9056	63464	9017	0.0	7.038261062437618
chr17	SLFN13	35446839	35446932	467	94	63464	9056	62997	8962	4.968085106382978	7.029346128096407
chr17	MMP28	35766196	35766894	18176	699	24315	3200	6139	2501	26.002861230329042	2.4546181527389046
chr17	MMP28	35773179	35773404	0	226	24315	3200	24315	2974	0.0	8.175857431069266
chr17	MMP28	35766972	35767035	2574	64	24315	3200	21741	3136	40.21875	6.932716836734694
chr17	CCL5	35875560	35875642	0	83	103597	1504	103597	1421	0.0	72.9042927515834
chr17	RDM1	35924603	35924772	102	170	1556	1650	1454	1480	0.6	0.9824324324324324
chr17	RDM1	35930075	35930255	0	181	1556	1650	1556	1469	0.0	1.059223961878829
chr17	RDM1	35922576	35922675	0	100	1556	1650	1556	1550	0.0	1.0038709677419355
chr17	RDM1	35920186	35920272	0	87	1556	1650	1556	1563	0.0	0.9955214331413947
chr17	CCL14	35985747	35985795	0	49	14964	1206	14964	1157	0.0	12.933448573898012
chr17	TBC1D3B	36174406	36174629	0	224	118	2860	118	2636	0.0	0.044764795144157814
chr17	MYO19	36515112	36515182	0	71	10987	11489	10987	11418	0.0	0.9622525836398669
chr17	MYO19	36501851	36501961	0	111	10987	11489	10987	11378	0.0	0.9656354368078749
chr17	MYO19	36501851	36501901	0	51	10987	11489	10987	11438	0.0	0.9605700297254764
chr17	MYO19	36512657	36512779	940	123	10987	11489	10047	11366	7.642276422764228	0.8839521379553053
chr17	MYO19	36533159	36533423	0	265	10987	11489	10987	11224	0.0	0.9788845331432644
chr17	ACACA	37151300	37151421	0	122	394158	11022	394158	10900	0.0	36.161284403669725
chr17	ACACA	37179259	37179406	0	148	394158	11022	394158	10874	0.0	36.24774691925694
chr17	ACACA	37210466	37210490	0	25	394158	11022	394158	10997	0.0	35.842320632899884
chr17	ACACA	37289417	37289528	57	112	394158	11022	394101	10910	0.5089285714285714	36.12291475710357
chr17	ACACA	37345252	37345382	102	131	394158	11022	394056	10891	0.7786259541984732	36.181801487466714
chr17	SYNRG	37520178	37520214	0	37	13477	8725	13477	8688	0.0	1.551220073664825
chr17	SYNRG	37570636	37570885	0	250	13477	8725	13477	8475	0.0	1.5902064896755161
chr17	SYNRG	37577379	37577613	0	235	13477	8725	13477	8490	0.0	1.587396937573616
chr17	SYNRG	37529782	37529851	0	70	13477	8725	13477	8655	0.0	1.5571346042749856
chr17	SYNRG	37577446	37577613	0	168	13477	8725	13477	8557	0.0	1.5749678625686572
chr17	DDX52	37633287	37633418	85	132	5309	8334	5224	8202	0.6439393939393939	0.636917824920751
chr17	DDX52	37639453	37639568	0	116	5309	8334	5309	8218	0.0	0.6460209296665855
chr17	DDX52	37635550	37635604	0	55	5309	8334	5309	8279	0.0	0.6412610218625437
chr17	HNF1B	37699075	37699194	0	120	21633	2777	21633	2657	0.0	8.141889348889725
chr17	HNF1B	37700982	37701177	0	196	21633	2777	21633	2581	0.0	8.381635025184037
chr17	AC244153.1	38451305	38451393	0	89	47485	1252	47485	1163	0.0	40.82975064488392
chr17	SRCIN1	38568210	38568234	0	25	297261	11692	297261	11667	0.0	25.478786320390846
chr17	SRCIN1	38547758	38547881	35385	124	297261	11692	261876	11568	285.36290322580646	22.637966804979254
chr17	CWC25	38815624	38815741	0	118	340	3726	340	3608	0.0	0.0942350332594235
chr17	CWC25	38810275	38810400	0	126	340	3726	340	3600	0.0	0.09444444444444444
chr17	PLXDC1	39072449	39072485	0	37	51	9280	51	9243	0.0	0.00551768906199286
chr17	PLXDC1	39083458	39083540	0	83	51	9280	51	9197	0.0	0.005545286506469501
chr17	PLXDC1	39081249	39081449	0	201	51	9280	51	9079	0.0	0.005617358739949334
chr17	PLXDC1	39079501	39079528	0	28	51	9280	51	9252	0.0	0.005512321660181583
chr17	PLXDC1	39126904	39127004	0	101	51	9280	51	9179	0.0	0.005556160801830265
chr17	PLXDC1	39139653	39139832	0	180	51	9280	51	9100	0.0	0.005604395604395605
chr17	CACNB1	39185130	39185150	0	21	51	5588	51	5567	0.0	0.009161128076163105
chr17	CACNB1	39185949	39186104	0	156	51	5588	51	5432	0.0	0.00938880706921944
chr17	FBXL20	39285477	39285573	0	97	204	4602	204	4505	0.0	0.045283018867924525
chr17	MED1	39440385	39440518	0	134	0	8626	0	8492	0.0	0.0
chr17	MED1	39445410	39445569	0	160	0	8626	0	8466	0.0	0.0
chr17	PGAP3	39673513	39673650	624	138	1076	3628	452	3490	4.521739130434782	0.12951289398280802
chr17	PGAP3	39674616	39674679	78	64	1076	3628	998	3564	1.21875	0.28002244668911336
chr17	PGAP3	39684596	39684749	0	154	1076	3628	1076	3474	0.0	0.3097294185377087
chr17	PGAP3	39685921	39686019	0	99	1076	3628	1076	3529	0.0	0.3049022385945027
chr17	PGAP3	39676613	39676755	0	143	1076	3628	1076	3485	0.0	0.30875179340028697
chr17	IKZF3	39777650	39777767	0	118	0	10138	0	10020	0.0	0.0
chr17	IKZF3	39788257	39788374	0	118	0	10138	0	10020	0.0	0.0
chr17	IKZF3	39791415	39791583	0	169	0	10138	0	9969	0.0	0.0
chr17	IKZF3	39792672	39792933	0	262	0	10138	0	9876	0.0	0.0
chr17	IKZF3	39829386	39829488	0	103	0	10138	0	10035	0.0	0.0
chr17	IKZF3	39777884	39778010	0	127	0	10138	0	10011	0.0	0.0
chr17	GSDMB	39906960	39906987	0	28	25530	4922	25530	4894	0.0	5.21659174499387
chr17	GSDMB	39908175	39908214	0	40	25530	4922	25530	4882	0.0	5.22941417451864
chr17	GSDMB	39908957	39909042	0	86	25530	4922	25530	4836	0.0	5.279156327543424
chr17	GSDMB	39909755	39909924	0	170	25530	4922	25530	4752	0.0	5.372474747474747
chr17	MED24	40027382	40027465	814	84	702805	6850	701991	6766	9.69047619047619	103.75273425953296
chr17	MED24	40035721	40035795	0	75	702805	6850	702805	6775	0.0	103.73505535055351
chr17	MED24	40036115	40036154	0	40	702805	6850	702805	6810	0.0	103.20190895741557
chr17	MED24	40053468	40053635	2317	168	702805	6850	700488	6682	13.791666666666666	104.832086201736
chr17	MED24	40053468	40053657	3386	190	702805	6850	699419	6660	17.821052631578947	105.01786786786786
chr17	MED24	40034915	40034972	0	58	702805	6850	702805	6792	0.0	103.47541224970554
chr17	MED24	40053297	40053380	932	84	702805	6850	701873	6766	11.095238095238095	103.73529411764706
chr17	MED24	40053468	40053679	4240	212	702805	6850	698565	6638	20.0	105.23727026212714
chr17	MED24	40053468	40053768	5049	301	702805	6850	697756	6549	16.774086378737543	106.54389983203542
chr17	TNS4	40479673	40479842	2307	170	241101	4886	238794	4716	13.570588235294117	50.63486005089059
chr17	CCR7	40558892	40558942	267	51	3272383	2512	3272116	2461	5.235294117647059	1329.5879723689557
chr17	SMARCE1	40632194	40632367	3156	174	93994	10517	90838	10343	18.137931034482758	8.782558251957846
chr17	SMARCE1	40642454	40642559	21053	106	93994	10517	72941	10411	198.61320754716982	7.00614734415522
chr17	SMARCE1	40645575	40645619	0	45	93994	10517	93994	10472	0.0	8.975744843391903
chr17	SMARCE1	40645795	40645847	0	53	93994	10517	93994	10464	0.0	8.982607033639145
chr17	SMARCE1	40630207	40630286	12	80	93994	10517	93982	10437	0.15	9.004694835680752
chr17	SMARCE1	40639980	40640078	0	99	93994	10517	93994	10418	0.0	9.022269149548858
chr17	SMARCE1	40644384	40644459	0	76	93994	10517	93994	10441	0.0	9.002394406666028
chr17	SMARCE1	40642117	40642559	21053	443	93994	10517	72941	10074	47.52370203160271	7.240520150883462
chr17	KRT23	40929939	40930096	736	158	102686	2919	101950	2761	4.658227848101266	36.92502716407099
chr17	KRT23	40937127	40937259	122	133	102686	2919	102564	2786	0.9172932330827067	36.814070351758794
chr17	KRT39	40964128	40964172	135	45	150781	2000	150646	1955	3.0	77.05677749360613
chr17	KRT13	41501718	41501744	0	27	51	2923	51	2896	0.0	0.01761049723756906
chr17	KRT15	41517082	41517165	0	84	51	5117	51	5033	0.0	0.01013312139876813
chr17	KRT15	41519664	41519872	0	209	51	5117	51	4908	0.0	0.01039119804400978
chr17	KRT15	41517336	41517609	0	274	51	5117	51	4843	0.0	0.010530662812306421
chr17	HAP1	41727761	41727836	0	76	251	2283	251	2207	0.0	0.1137290439510648
chr17	HAP1	41727297	41727453	0	157	251	2283	251	2126	0.0	0.1180620884289746
chr17	JUP	41772817	41772926	0	110	51	4876	51	4766	0.0	0.010700797314309694
chr17	P3H4	41809705	41809834	0	130	0	3317	0	3187	0.0	0.0
chr17	NT5C3B	41827425	41827626	0	202	0	2859	0	2657	0.0	0.0
chr17	NT5C3B	41828789	41828952	0	164	0	2859	0	2695	0.0	0.0
chr17	NT5C3B	41830800	41830890	0	91	0	2859	0	2768	0.0	0.0
chr17	NT5C3B	41835858	41835957	0	100	0	2859	0	2759	0.0	0.0
chr17	NT5C3B	41835587	41835682	0	96	0	2859	0	2763	0.0	0.0
chr17	NT5C3B	41835587	41835642	0	56	0	2859	0	2803	0.0	0.0
chr17	ACLY	41896619	41896649	0	31	8769	5239	8769	5208	0.0	1.6837557603686637
chr17	DNAJC7	41981854	41982007	13	154	408	9268	395	9114	0.08441558441558442	0.043339916611806015
chr17	DNAJC7	41996310	41996424	0	115	408	9268	408	9153	0.0	0.044575549000327765
chr17	DNAJC7	42000481	42000570	0	90	408	9268	408	9178	0.0	0.044454129439965136
chr17	DNAJC7	41987594	41987694	0	101	408	9268	408	9167	0.0	0.04450747245554707
chr17	DNAJC7	42003358	42003557	0	200	408	9268	408	9068	0.0	0.044993383325981476
chr17	DNAJC7	41992798	41992867	0	70	408	9268	408	9198	0.0	0.04435746901500326
chr17	DNAJC7	42000955	42001066	0	112	408	9268	408	9156	0.0	0.04456094364351245
chr17	DHX58	42103607	42103798	0	192	98558	3749	98558	3557	0.0	27.70818105144785
chr17	DHX58	42105735	42105989	2227	255	98558	3749	96331	3494	8.733333333333333	27.57040641099027
chr17	DHX58	42111724	42111893	1197	170	98558	3749	97361	3579	7.041176470588235	27.20340877340039
chr17	DHX58	42111745	42111893	1197	149	98558	3749	97361	3600	8.033557046979865	27.044722222222223
chr17	AC099811.2	42120029	42120119	0	91	1326	1208	1326	1117	0.0	1.1871083258728738
chr17	AC099811.2	42120705	42120829	0	125	1326	1208	1326	1083	0.0	1.2243767313019391
chr17	RAB5C	42131606	42131822	0	217	2001	2590	2001	2373	0.0	0.843236409608091
chr17	RAB5C	42137761	42137878	41	118	2001	2590	1960	2472	0.3474576271186441	0.7928802588996764
chr17	GHDC	42193766	42193850	0	85	969	3702	969	3617	0.0	0.2679015758916229
chr17	STAT3	42326115	42326199	0	85	684	9674	684	9589	0.0	0.07133173427886119
chr17	STAT3	42339313	42339409	0	97	684	9674	684	9577	0.0	0.07142111308342905
chr17	STAT3	42348388	42348539	0	152	684	9674	684	9522	0.0	0.07183364839319471
chr17	STAT3	42374058	42374206	0	149	684	9674	684	9525	0.0	0.07181102362204725
chr17	STAT3	42348388	42348520	0	133	684	9674	684	9541	0.0	0.07169059846976208
chr17	STAT3	42348388	42348517	0	130	684	9674	684	9544	0.0	0.07166806370494551
chr17	STAT3	42317181	42317224	0	44	684	9674	684	9630	0.0	0.07102803738317758
chr17	PSMC3IP	42574315	42574334	0	20	703	2585	703	2565	0.0	0.2740740740740741
chr17	RETREG3	42586764	42586891	0	128	2779	4732	2779	4604	0.0	0.6036055603822763
chr17	RETREG3	42587833	42587864	0	32	2779	4732	2779	4700	0.0	0.5912765957446808
chr17	RETREG3	42596532	42596627	0	96	2779	4732	2779	4636	0.0	0.5994391716997411
chr17	RETREG3	42609497	42609727	0	231	2779	4732	2779	4501	0.0	0.6174183514774495
chr17	PLEKHH3	42674740	42674875	0	136	102	3655	102	3519	0.0	0.028985507246376812
chr17	EZH1	42718453	42718617	0	165	482	6587	482	6422	0.0	0.07505450015571473
chr17	EZH1	42719104	42719207	0	104	482	6587	482	6483	0.0	0.07434829554218726
chr17	EZH1	42722794	42722915	0	122	482	6587	482	6465	0.0	0.0745552977571539
chr17	EZH1	42724304	42724424	0	121	482	6587	482	6466	0.0	0.0745437673987009
chr17	EZH1	42728824	42728952	0	129	482	6587	482	6458	0.0	0.07463611025085165
chr17	EZH1	42730827	42730918	0	92	482	6587	482	6495	0.0	0.07421093148575827
chr17	EZH1	42727634	42727763	0	130	482	6587	482	6457	0.0	0.07464766919622115
chr17	EZH1	42727661	42727763	0	103	482	6587	482	6484	0.0	0.0743368291178285
chr17	EZH1	42731774	42731893	0	120	482	6587	482	6467	0.0	0.07453224060615432
chr17	EZH1	42729146	42729239	0	94	482	6587	482	6493	0.0	0.07423379023563838
chr17	BECN1	42811654	42811797	1179	144	38488	5109	37309	4965	8.1875	7.514400805639476
chr17	BECN1	42813947	42814008	28	62	38488	5109	38460	5047	0.45161290322580644	7.62036853576382
chr17	BECN1	42815907	42816054	714	148	38488	5109	37774	4961	4.824324324324325	7.614190687361419
chr17	BECN1	42812230	42812356	0	127	38488	5109	38488	4982	0.0	7.725411481332798
chr17	BECN1	42827250	42827341	4505	92	38488	5109	33983	5017	48.96739130434783	6.77356986246761
chr17	BECN1	42824154	42824379	510	226	38488	5109	37978	4883	2.256637168141593	7.777595740323571
chr17	LINC00671	42897686	42897918	340	233	119978	2175	119638	1942	1.4592274678111588	61.605561277033985
chr17	LINC00671	42884594	42884686	0	93	119978	2175	119978	2082	0.0	57.62632084534102
chr17	LINC00671	42895376	42895493	0	118	119978	2175	119978	2057	0.0	58.32668935342732
chr17	AARSD1	42951799	42951894	589	96	100248	2950	99659	2854	6.135416666666667	34.91906096706377
chr17	AARSD1	42953723	42953778	351	56	100248	2950	99897	2894	6.267857142857143	34.51865929509329
chr17	PTGES3L-AARSD1	42971606	42971696	765	91	33710	2312	32945	2221	8.406593406593407	14.833408374606034
chr17	PTGES3L-AARSD1	42979169	42979268	0	100	33710	2312	33710	2212	0.0	15.239602169981916
chr17	PTGES3L-AARSD1	42979549	42979663	0	115	33710	2312	33710	2197	0.0	15.343650432407829
chr17	AARSD1	42962174	42962272	0	99	100248	2950	100248	2851	0.0	35.162399158190105
chr17	AARSD1	42962174	42962295	0	122	100248	2950	100248	2828	0.0	35.44837340876945
chr17	PTGES3L-AARSD1	42979549	42979773	1036	225	33710	2312	32674	2087	4.604444444444445	15.655965500718734
chr17	VAT1	43021935	43022350	20819	416	85476	3313	64657	2897	50.04567307692308	22.318605453917847
chr17	BRCA1	43049120	43049194	0	75	26109	8555	26109	8480	0.0	3.078891509433962
chr17	BRCA1	43091434	43094860	510	3427	26109	8555	25599	5128	0.14881820834549167	4.9920046801872076
chr17	BRCA1	43106455	43106533	402	79	26109	8555	25707	8476	5.0886075949367084	3.0329164700330344
chr17	BRCA1	43115725	43115779	372	55	26109	8555	25737	8500	6.763636363636364	3.0278823529411767
chr17	BRCA1	43079333	43079399	0	67	26109	8555	26109	8488	0.0	3.0759896324222433
chr17	BRCA1	43094743	43094860	0	118	26109	8555	26109	8437	0.0	3.094583382718976
chr17	BRCA1	43106477	43106533	244	57	26109	8555	25865	8498	4.280701754385965	3.043657331136738
chr17	BRCA1	43121557	43121676	0	120	26109	8555	26109	8435	0.0	3.0953171310017784
chr17	BRCA1	43110464	43110580	0	117	26109	8555	26109	8438	0.0	3.0942166390139842
chr17	BRCA1	43112486	43112606	372	121	26109	8555	25737	8434	3.074380165289256	3.0515769504387005
chr17	BRCA1	43119120	43119265	51	146	26109	8555	26058	8409	0.3493150684931507	3.0988226899750266
chr17	AC060780.1	43167733	43167849	40	117	58621	6052	58581	5935	0.3418803418803419	9.870429654591407
chr17	CCDC200	43223740	43223835	0	96	96869	3210	96869	3114	0.0	31.10757867694284
chr17	CCDC200	43223900	43224026	0	127	96869	3210	96869	3083	0.0	31.420369769704834
chr17	LINC00910	43356391	43356530	585	140	248238	8593	247653	8453	4.178571428571429	29.297645806222643
chr17	LINC00910	43379122	43379262	1196	141	248238	8593	247042	8452	8.4822695035461	29.228821580690962
chr17	LINC00910	43381272	43381660	1340	389	248238	8593	246898	8204	3.4447300771208225	30.09483178937104
chr17	LINC00910	43387935	43388057	255	123	248238	8593	247983	8470	2.073170731707317	29.27780401416765
chr17	ETV4	43533186	43533348	0	163	20832	3530	20832	3367	0.0	6.1871101871101875
chr17	ETV4	43545557	43545668	643	112	20832	3530	20189	3418	5.741071428571429	5.906670567583382
chr17	MEOX1	43643487	43643660	0	174	6826	2677	6826	2503	0.0	2.727127447063524
chr17	DUSP3	43774034	43774109	0	76	0	4997	0	4921	0.0	0.0
chr17	DUSP3	43773973	43774109	0	137	0	4997	0	4860	0.0	0.0
chr17	DUSP3	43777528	43777813	0	286	0	4997	0	4711	0.0	0.0
chr17	MPP3	43816676	43816697	0	22	0	4513	0	4491	0.0	0.0
chr17	MPP3	43818999	43819081	0	83	0	4513	0	4430	0.0	0.0
chr17	MPP2	43898261	43898380	0	120	67	6133	67	6013	0.0	0.0111425245301846
chr17	MPP2	43904429	43904493	0	65	67	6133	67	6068	0.0	0.011041529334212262
chr17	MPP2	43906079	43906151	0	73	67	6133	67	6060	0.0	0.011056105610561057
chr17	MPP2	43884083	43884155	0	73	67	6133	67	6060	0.0	0.011056105610561057
chr17	MPP2	43898243	43898380	0	138	67	6133	67	5995	0.0	0.011175979983319434
chr17	TMEM101	44021321	44021435	0	115	0	3037	0	2922	0.0	0.0
chr17	LSM12	44036861	44037102	0	242	51	3123	51	2881	0.0	0.01770218674071503
chr17	HDAC5	44092171	44092284	0	114	3691	7417	3691	7303	0.0	0.5054087361358346
chr17	HDAC5	44092380	44092527	0	148	3691	7417	3691	7269	0.0	0.507772733525932
chr17	HDAC5	44117493	44117704	125	212	3691	7417	3566	7205	0.589622641509434	0.4949340735600278
chr17	ASB16-AS1	44182929	44183093	0	165	1836	2476	1836	2311	0.0	0.7944612721765469
chr17	ASB16-AS1	44178183	44178363	918	181	1836	2476	918	2295	5.071823204419889	0.4
chr17	UBTF	44215905	44215989	0	85	5940	6885	5940	6800	0.0	0.8735294117647059
chr17	UBTF	44212343	44212454	646	112	5940	6885	5294	6773	5.767857142857143	0.7816329543776761
chr17	UBTF	44208618	44209001	561	384	5940	6885	5379	6501	1.4609375	0.8274111675126904
chr17	RUNDC3A-AS1	44304980	44305043	0	64	6878	5515	6878	5451	0.0	1.261786828104935
chr17	SLC25A39	44322807	44322852	0	46	8997	3162	8997	3116	0.0	2.8873555840821568
chr17	FAM171A2	44359061	44359143	0	83	357	3579	357	3496	0.0	0.102116704805492
chr17	FAM171A2	44358944	44359143	0	200	357	3579	357	3379	0.0	0.10565255992897307
chr17	ITGA2B	44384947	44385076	51	130	3173	4794	3122	4664	0.3923076923076923	0.6693825042881647
chr17	ITGA2B	44374353	44374470	415	118	3173	4794	2758	4676	3.516949152542373	0.5898203592814372
chr17	GPATCH8	44474828	44474903	0	76	6831	9750	6831	9674	0.0	0.7061194955550961
chr17	GPATCH8	44438670	44438715	0	46	6831	9750	6831	9704	0.0	0.7039365210222589
chr17	GPATCH8	44467096	44467114	0	19	6831	9750	6831	9731	0.0	0.7019833521734662
chr17	GPATCH8	44467096	44467202	0	107	6831	9750	6831	9643	0.0	0.7083895053406616
chr17	GPATCH8	44473724	44473759	0	36	6831	9750	6831	9714	0.0	0.7032118591723286
chr17	CCDC43	44680584	44680643	0	60	1326	2861	1326	2801	0.0	0.47340235630132094
chr17	CCDC43	44680584	44680652	0	69	1326	2861	1326	2792	0.0	0.47492836676217765
chr17	GJC1	44807393	44807469	0	77	711184	5154	711184	5077	0.0	140.07957455190072
chr17	EFTUD2	44853295	44853390	0	96	2	9782	2	9686	0.0	0.00020648358455502787
chr17	EFTUD2	44886584	44886750	0	167	2	9782	2	9615	0.0	0.0002080083203328133
chr17	EFTUD2	44894416	44894525	0	110	2	9782	2	9672	0.0	0.00020678246484698098
chr17	EFTUD2	44852408	44852562	0	155	2	9782	2	9627	0.0	0.00020774903916069389
chr17	EFTUD2	44898974	44899041	0	68	2	9782	2	9714	0.0	0.00020588840848260242
chr17	EFTUD2	44895825	44895989	0	165	2	9782	2	9617	0.0	0.0002079650618696059
chr17	GFAP	44913727	44913823	0	97	51	7492	51	7395	0.0	0.006896551724137931
chr17	GFAP	44914027	44914088	0	62	51	7492	51	7430	0.0	0.006864064602960969
chr17	GFAP	44904765	44905149	0	385	51	7492	51	7107	0.0	0.007176023638666104
chr17	GFAP	44903958	44904233	0	276	51	7492	51	7216	0.0	0.007067627494456763
chr17	GFAP	44910225	44910260	0	36	51	7492	51	7456	0.0	0.006840128755364807
chr17	GFAP	44910140	44910260	0	121	51	7492	51	7371	0.0	0.006919006919006919
chr17	GFAP	44910091	44910260	0	170	51	7492	51	7322	0.0	0.006965310024583447
chr17	GFAP	44914027	44914109	0	83	51	7492	51	7409	0.0	0.006883520043190714
chr17	PLCD3	45112862	45113012	1392	151	25902	6647	24510	6496	9.218543046357615	3.773091133004926
chr17	AC008105.3	45220867	45220914	392	48	62068	3429	61676	3381	8.166666666666666	18.241940254362614
chr17	MAP3K14	45312284	45312437	0	154	9208	5684	9208	5530	0.0	1.6650994575045208
chr17	ARHGAP27	45404600	45404681	0	82	3970	10105	3970	10023	0.0	0.3960889953107852
chr17	ARHGAP27	45404268	45404334	0	67	3970	10105	3970	10038	0.0	0.39549711097828255
chr17	PLEKHM1	45468208	45468593	0	386	30369	9251	30369	8865	0.0	3.425719120135364
chr17	PLEKHM1	45477899	45478147	0	249	30369	9251	30369	9002	0.0	3.373583648078205
chr17	PLEKHM1	45475099	45475726	153	628	30369	9251	30216	8623	0.24363057324840764	3.504116896671692
chr17	PLEKHM1	45482436	45482525	0	90	30369	9251	30369	9161	0.0	3.3150311101408145
chr17	PLEKHM1	45478100	45478147	0	48	30369	9251	30369	9203	0.0	3.299902205802456
chr17	PLEKHM1	45477804	45478147	0	344	30369	9251	30369	8907	0.0	3.4095655102728193
chr17	MAPT-AS1	45847510	45847698	0	189	3836	7365	3836	7176	0.0	0.5345596432552955
chr17	KANSL1	46039026	46039215	0	190	63460	16946	63460	16756	0.0	3.7873000716161376
chr17	KANSL1	46082440	46082542	0	103	63460	16946	63460	16843	0.0	3.767737338953868
chr17	KANSL1	46170854	46172232	1500	1379	63460	16946	61960	15567	1.0877447425670776	3.980214556433481
chr17	ARL17B	46339508	46339774	0	267	0	7947	0	7680	0.0	0.0
chr17	ARL17A	46538350	46538426	15	77	66	6519	51	6442	0.19480519480519481	0.007916796026078858
chr17	AC005670.3	46998699	46998817	51	119	436388	10495	436337	10376	0.42857142857142855	42.052525057825754
chr17	AC005670.3	47033319	47033381	0	63	436388	10495	436388	10432	0.0	41.831671779141104
chr17	AC005670.3	47007839	47007884	8863	46	436388	10495	427525	10449	192.67391304347825	40.915398602737106
chr17	AC005670.3	47033277	47033381	0	105	436388	10495	436388	10390	0.0	42.00076997112608
chr17	AC005670.3	47035043	47035126	0	84	436388	10495	436388	10411	0.0	41.91605033138027
chr17	AC005670.3	47054117	47054213	0	97	436388	10495	436388	10398	0.0	41.968455472206195
chr17	CDC27	47142228	47142436	0	209	198	6557	198	6348	0.0	0.031190926275992438
chr17	CDC27	47158205	47158303	0	99	198	6557	198	6458	0.0	0.030659646949519975
chr17	CDC27	47171916	47172064	0	149	198	6557	198	6408	0.0	0.03089887640449438
chr17	CDC27	47169916	47170042	0	127	198	6557	198	6430	0.0	0.030793157076205287
chr17	CDC27	47139770	47139973	0	204	198	6557	198	6353	0.0	0.031166378089091767
chr17	MRPL45P2	47486762	47486884	138726	123	138870	1844	144	1721	1127.8536585365853	0.08367228355607205
chr17	AC025682.1	47626546	47626627	0	82	629	1247	629	1165	0.0	0.5399141630901287
chr17	MRPL10	47829138	47829236	0	99	731	2777	731	2678	0.0	0.2729648991784914
chr17	SCRN2	47840190	47840372	0	183	861	3004	861	2821	0.0	0.3052109181141439
chr17	AC018521.5	47893899	47893958	60	60	60	525	0	465	1.0	0.0
chr17	COPZ2	48027675	48027789	0	115	170	1877	170	1762	0.0	0.09648127128263337
chr17	COPZ2	48028471	48028510	0	40	170	1877	170	1837	0.0	0.09254218835057158
chr17	COPZ2	48033210	48033302	76	93	170	1877	94	1784	0.8172043010752689	0.052690582959641255
chr17	COPZ2	48032155	48032233	0	79	170	1877	170	1798	0.0	0.09454949944382647
chr17	COPZ2	48032685	48032741	0	57	170	1877	170	1820	0.0	0.09340659340659341
chr17	CBX1	48088165	48088307	0	143	1124	3053	1124	2910	0.0	0.38625429553264606
chr17	SKAP1	48184722	48184847	0	126	19044	2371	19044	2245	0.0	8.482850779510022
chr17	SKAP1	48231826	48231902	0	77	19044	2371	19044	2294	0.0	8.301656495204883
chr17	SKAP1	48136474	48136560	561	87	19044	2371	18483	2284	6.448275862068965	8.092381786339756
chr17	SKAP1	48248886	48249029	66	144	19044	2371	18978	2227	0.4583333333333333	8.521778176919623
chr17	HOXB3	48573836	48574014	0	179	17922	6082	17922	5903	0.0	3.036083347450449
chr17	HOXB3	48575042	48575208	0	167	17922	6082	17922	5915	0.0	3.0299239222316143
chr17	AC103702.2	48636867	48636993	0	127	236	1600	236	1473	0.0	0.16021724372029872
chr17	TTLL6	48791377	48791603	0	227	38468	5118	38468	4891	0.0	7.865058270292374
chr17	TTLL6	48815333	48815398	721	66	38468	5118	37747	5052	10.924242424242424	7.471694378463975
chr17	SNF8	48940923	48941062	27105	140	27396	4805	291	4665	193.60714285714286	0.062379421221864954
chr17	SNF8	48934478	48934576	36	99	27396	4805	27360	4706	0.36363636363636365	5.813854653633659
chr17	SNF8	48936854	48936933	0	80	27396	4805	27396	4725	0.0	5.798095238095238
chr17	SNF8	48937280	48937291	0	12	27396	4805	27396	4793	0.0	5.715835593573962
chr17	PHOSPHO1	49225655	49225777	0	123	83	2397	83	2274	0.0	0.036499560246262094
chr17	ZNF652	49322384	49322508	51	125	14546	11753	14495	11628	0.408	1.24656002751978
chr17	PHB	49411677	49411839	0	163	255	5014	255	4851	0.0	0.05256648113790971
chr17	PHB	49413176	49413291	0	116	255	5014	255	4898	0.0	0.052062066149448756
chr17	PHB	49414241	49414333	0	93	255	5014	255	4921	0.0	0.05181873602926235
chr17	SPOP	49675894	49676016	0	123	8	6342	8	6219	0.0	0.0012863804470172053
chr17	SPOP	49636758	49636809	0	52	8	6342	8	6290	0.0	0.0012718600953895071
chr17	SPOP	49646925	49647122	0	198	8	6342	8	6144	0.0	0.0013020833333333333
chr17	SPOP	49668026	49668078	0	53	8	6342	8	6289	0.0	0.0012720623310542216
chr17	SPOP	49618503	49618563	0	61	8	6342	8	6281	0.0	0.001273682534628244
chr17	SPOP	49620620	49620670	8	51	8	6342	0	6291	0.1568627450980392	0.0
chr17	SPOP	49612778	49612941	0	164	8	6342	8	6178	0.0	0.0012949174490126255
chr17	SPOP	49622205	49622283	0	79	8	6342	8	6263	0.0	0.0012773431262973016
chr17	SPOP	49636196	49636313	0	118	8	6342	8	6224	0.0	0.0012853470437017994
chr17	SLC35B1	49706203	49706334	0	132	340	5087	340	4955	0.0	0.06861755802219979
chr17	SLC35B1	49707342	49707444	0	103	340	5087	340	4984	0.0	0.06821829855537721
chr17	SLC35B1	49706203	49706309	0	107	340	5087	340	4980	0.0	0.06827309236947791
chr17	SLC35B1	49706964	49707068	0	105	340	5087	340	4982	0.0	0.06824568446407066
chr17	FAM117A	49722498	49722594	0	97	0	3816	0	3719	0.0	0.0
chr17	FAM117A	49732550	49732720	0	171	0	3816	0	3645	0.0	0.0
chr17	FAM117A	49717967	49718044	0	78	0	3816	0	3738	0.0	0.0
chr17	TAC4	49841551	49841584	0	34	0	1002	0	968	0.0	0.0
chr17	TAC4	49839849	49839909	0	61	0	1002	0	941	0.0	0.0
chr17	SAMD14	50114356	50114440	0	85	0	6250	0	6165	0.0	0.0
chr17	SAMD14	50125090	50125360	0	271	0	6250	0	5979	0.0	0.0
chr17	MRPL27	50368837	50368867	0	31	51	2282	51	2251	0.0	0.02265659706796979
chr17	ANKRD40CL	50764164	50764248	0	85	0	2403	0	2318	0.0	0.0
chr17	SPAG9	51031680	51031722	0	43	21	9106	21	9063	0.0	0.0023171135385633896
chr17	SPAG9	50975862	50975901	0	40	21	9106	21	9066	0.0	0.002316346790205162
chr17	SPAG9	50999475	50999487	0	13	21	9106	21	9093	0.0	0.0023094688221709007
chr17	MBTD1	51195213	51195361	0	149	0	6681	0	6532	0.0	0.0
chr17	MBTD1	51209313	51209430	0	118	0	6681	0	6563	0.0	0.0
chr17	CA10	52157725	52158369	0	645	0	4452	0	3807	0.0	0.0
chr17	CA10	52134878	52135049	0	172	0	4452	0	4280	0.0	0.0
chr17	CA10	52157725	52158372	0	648	0	4452	0	3804	0.0	0.0
chr17	MMD	55407745	55407820	0	76	918	3202	918	3126	0.0	0.29366602687140114
chr17	MMD	55404454	55404547	0	94	918	3202	918	3108	0.0	0.2953667953667954
chr17	SMIM36	55479459	55479580	0	122	3673	3515	3673	3393	0.0	1.0825228411435308
chr17	TRIM25	56912104	56912165	0	62	435	6852	435	6790	0.0	0.06406480117820323
chr17	AC015845.2	57832641	57832748	0	108	51289	615	51289	507	0.0	101.16173570019724
chr17	CUEDC1	57885228	57885879	0	652	1962	5297	1962	4645	0.0	0.4223896663078579
chr17	VEZF1	57985984	57986144	51	161	5253	4921	5202	4760	0.3167701863354037	1.0928571428571427
chr17	SRSF1	58003650	58004001	9658	352	9305	2405	-353	2053	27.4375	-0.17194349732099368
chr17	MKS1	58206464	58207218	2244	755	30663	8985	28419	8230	2.972185430463576	3.4530984204131228
chr17	MKS1	58207084	58207218	0	135	30663	8985	30663	8850	0.0	3.4647457627118645
chr17	MKS1	58210979	58211022	0	44	30663	8985	30663	8941	0.0	3.4294821608321215
chr17	MKS1	58214258	58214387	0	130	30663	8985	30663	8855	0.0	3.462789384528515
chr17	MKS1	58214740	58214838	0	99	30663	8985	30663	8886	0.0	3.450708980418636
chr17	MKS1	58218619	58218729	0	111	30663	8985	30663	8874	0.0	3.4553752535496955
chr17	MKS1	58206464	58206547	0	84	30663	8985	30663	8901	0.0	3.4448938321536904
chr17	MKS1	58214740	58214898	0	159	30663	8985	30663	8826	0.0	3.474167233174711
chr17	MKS1	58216087	58216243	0	157	30663	8985	30663	8828	0.0	3.4733801540552784
chr17	MKS1	58215300	58215444	0	145	30663	8985	30663	8840	0.0	3.468665158371041
chr17	TSPOAP1	58304337	58304399	27	63	2552	8979	2525	8916	0.42857142857142855	0.2831987438313145
chr17	TSPOAP1	58308540	58309380	924	841	2552	8979	1628	8138	1.098692033293698	0.20004915212582944
chr17	TSPOAP1	58325533	58325713	0	181	2552	8979	2552	8798	0.0	0.2900659240736531
chr17	SUPT4H1	58347528	58347584	0	57	1	2085	1	2028	0.0	0.0004930966469428008
chr17	RNF43	58370910	58371033	0	124	408	5286	408	5162	0.0	0.0790391321193336
chr17	RNF43	58415325	58415962	51	638	408	5286	357	4648	0.07993730407523511	0.07680722891566265
chr17	RNF43	58415325	58415759	0	435	408	5286	408	4851	0.0	0.08410636982065553
chr17	MTMR4	58508680	58508841	0	162	121380	7498	121380	7336	0.0	16.545801526717558
chr17	MTMR4	58504049	58504220	0	172	121380	7498	121380	7326	0.0	16.56838656838657
chr17	MTMR4	58514991	58515083	0	93	121380	7498	121380	7405	0.0	16.39162727886563
chr17	SEPTIN4	58526681	58526978	0	298	59483	6797	59483	6499	0.0	9.15263886751808
chr17	SEPTIN4	58526766	58526978	0	213	59483	6797	59483	6584	0.0	9.03447752126367
chr17	SEPTIN4	58539111	58539208	4625	98	59483	6797	54858	6699	47.19387755102041	8.188983430362741
chr17	SEPTIN4	58531479	58531551	0	73	59483	6797	59483	6724	0.0	8.846371207614515
chr17	SEPTIN4	58526931	58526978	0	48	59483	6797	59483	6749	0.0	8.81360201511335
chr17	TEX14	58557798	58557850	0	53	5319	5361	5319	5308	0.0	1.0020723436322532
chr17	TEX14	58617537	58617619	0	83	5319	5361	5319	5278	0.0	1.0077680939749905
chr17	TEX14	58581610	58581730	0	121	5319	5361	5319	5240	0.0	1.0150763358778625
chr17	TEX14	58647991	58648112	0	122	5319	5361	5319	5239	0.0	1.015270089711777
chr17	TEX14	58567754	58567911	0	158	5319	5361	5319	5203	0.0	1.0222948299058237
chr17	TRIM37	59001597	59001741	0	145	452	5509	452	5364	0.0	0.0842654735272185
chr17	TRIM37	59001597	59001714	0	118	452	5509	452	5391	0.0	0.08384344277499536
chr17	TRIM37	59084001	59084089	0	89	452	5509	452	5420	0.0	0.08339483394833948
chr17	TRIM37	59104292	59104394	0	103	452	5509	452	5406	0.0	0.08361080281169071
chr17	TRIM37	59090016	59090092	0	77	452	5509	452	5432	0.0	0.08321060382916053
chr17	TRIM37	59073093	59073141	0	49	452	5509	452	5460	0.0	0.08278388278388278
chr17	SKA2	59119318	59119495	0	178	2668	3064	2668	2886	0.0	0.9244629244629244
chr17	SKA2	59131280	59131367	0	88	2668	3064	2668	2976	0.0	0.896505376344086
chr17	SKA2	59124306	59124428	0	123	2668	3064	2668	2941	0.0	0.9071744304658279
chr17	SKA2	59119298	59119495	0	198	2668	3064	2668	2866	0.0	0.9309141660851361
chr17	LINC01476	59433653	59433765	0	113	612	6515	612	6402	0.0	0.09559512652296158
chr17	LINC01476	59502978	59503094	0	117	612	6515	612	6398	0.0	0.09565489215379806
chr17	LINC01476	59434416	59434521	0	106	612	6515	612	6409	0.0	0.09549071618037135
chr17	LINC01476	59449741	59449776	0	36	612	6515	612	6479	0.0	0.09445902145392808
chr17	PTRH2	59698870	59700189	0	1320	0	3306	0	1986	0.0	0.0
chr17	TUBD1	59874538	59874703	0	166	6604	3345	6604	3179	0.0	2.077382824787669
chr17	TUBD1	59880893	59881110	663	218	6604	3345	5941	3127	3.041284403669725	1.8999040614007034
chr17	TUBD1	59890830	59891041	0	212	6604	3345	6604	3133	0.0	2.107883817427386
chr17	TUBD1	59866608	59866749	978	142	6604	3345	5626	3203	6.887323943661972	1.7564783015922572
chr17	TUBD1	59884660	59884756	0	97	6604	3345	6604	3248	0.0	2.0332512315270934
chr17	TUBD1	59891813	59891960	0	148	6604	3345	6604	3197	0.0	2.065686581169847
chr17	RNFT1	59960067	59960168	10	102	9788	3189	9778	3087	0.09803921568627451	3.16747651441529
chr17	RNFT1	59962539	59962616	111	78	9788	3189	9677	3111	1.4230769230769231	3.1105753776920606
chr17	RNFT1	59958623	59958701	381	79	9788	3189	9407	3110	4.822784810126582	3.0247588424437297
chr17	TBC1D3P1-DHX40P1	59995631	59995814	0	184	3145	1855	3145	1671	0.0	1.8821065230400957
chr17	TBC1D3P1-DHX40P1	60000030	60000162	0	133	3145	1855	3145	1722	0.0	1.8263646922183507
chr17	HEATR6	60073745	60073886	188	142	24598	7067	24410	6925	1.323943661971831	3.5249097472924187
chr17	HEATR6	60073745	60074159	300	415	24598	7067	24298	6652	0.7228915662650602	3.652736019242333
chr17	HEATR6	60075704	60075833	2571	130	24598	7067	22027	6937	19.776923076923076	3.175291912930662
chr17	HEATR6	60073961	60074159	102	199	24598	7067	24496	6868	0.5125628140703518	3.5666860803727434
chr17	WFDC21P	60085931	60086126	594	196	10833	1104	10239	908	3.0306122448979593	11.276431718061675
chr17	WFDC21P	60085931	60086079	594	149	10833	1104	10239	955	3.9865771812080535	10.721465968586388
chr17	WFDC21P	60085931	60085985	399	55	10833	1104	10434	1049	7.254545454545455	9.946615824594852
chr17	AC025048.2	60132435	60132512	0	78	204	3106	204	3028	0.0	0.06737120211360634
chr17	AC025048.2	60128540	60128659	0	120	204	3106	204	2986	0.0	0.06831882116543872
chr17	AC025048.2	60128955	60129090	0	136	204	3106	204	2970	0.0	0.06868686868686869
chr17	AC025048.2	60128535	60128659	0	125	204	3106	204	2981	0.0	0.06843341160684334
chr17	USP32	60180544	60180637	0	94	16691	9563	16691	9469	0.0	1.7626993346710318
chr17	USP32	60223410	60223586	0	177	16691	9563	16691	9386	0.0	1.7782868101427658
chr17	APPBP2	60500398	60500487	0	90	94917	7651	94917	7561	0.0	12.55349821452189
chr17	APPBP2	60496412	60496441	0	30	94917	7651	94917	7621	0.0	12.454664742159821
chr17	TBX2-AS1	61394621	61394738	0	118	0	1010	0	892	0.0	0.0
chr17	BRIP1	61783818	61783907	731	90	362553	10149	361822	10059	8.122222222222222	35.96997713490406
chr17	BRIP1	61861909	61862075	0	167	362553	10149	362553	9982	0.0	36.32067721899419
chr17	INTS2	61921221	61921342	0	122	722087	8387	722087	8265	0.0	87.36684815486993
chr17	MARCHF10	62705538	62705581	0	44	75218	4528	75218	4484	0.0	16.774754683318466
chr17	MARCHF10	62746864	62746978	35709	115	75218	4528	39509	4413	310.5130434782609	8.952866530704735
chr17	MARCHF10	62804899	62805047	255	149	75218	4528	74963	4379	1.7114093959731544	17.1187485727335
chr17	AC005972.3	62920405	62920608	0	204	7676	3000	7676	2796	0.0	2.7453505007153076
chr17	CYB561	63435085	63435243	0	159	51	4066	51	3907	0.0	0.013053493729203993
chr17	CYB561	63437345	63437560	0	216	51	4066	51	3850	0.0	0.013246753246753246
chr17	CYB561	63437345	63437484	0	140	51	4066	51	3926	0.0	0.012990320937340805
chr17	CYB561	63439111	63439290	0	180	51	4066	51	3886	0.0	0.01312403499742666
chr17	STRADA	63717074	63717154	0	81	1296	9568	1296	9487	0.0	0.13660798988088965
chr17	STRADA	63704004	63704047	0	44	1296	9568	1296	9524	0.0	0.1360772784544309
chr17	STRADA	63707246	63707418	0	173	1296	9568	1296	9395	0.0	0.13794571580627993
chr17	STRADA	63710490	63710614	0	125	1296	9568	1296	9443	0.0	0.13724451975007942
chr17	STRADA	63714005	63714108	0	104	1296	9568	1296	9464	0.0	0.13693998309382924
chr17	STRADA	63723297	63723326	0	30	1296	9568	1296	9538	0.0	0.13587754246173203
chr17	STRADA	63726637	63726695	0	59	1296	9568	1296	9509	0.0	0.1362919339573036
chr17	STRADA	63704340	63704582	0	243	1296	9568	1296	9325	0.0	0.13898123324396783
chr17	STRADA	63741167	63741253	0	87	1296	9568	1296	9481	0.0	0.13669444151460816
chr17	STRADA	63737395	63737436	0	42	1296	9568	1296	9526	0.0	0.1360487087969767
chr17	STRADA	63741453	63741663	0	211	1296	9568	1296	9357	0.0	0.13850593138826547
chr17	CCDC47	63772776	63772863	0	88	1375	4370	1375	4282	0.0	0.32111163007940213
chr17	FTSJ3	63821983	63822168	0	186	51	4818	51	4632	0.0	0.011010362694300517
chr17	SMARCD2	63833297	63833420	0	124	115	3571	115	3447	0.0	0.0333623440673049
chr17	SMARCD2	63837440	63837625	0	186	115	3571	115	3385	0.0	0.033973412112259974
chr17	CSH2	63873178	63873339	0	162	0	1177	0	1015	0.0	0.0
chr17	GH2	63881028	63881148	51	121	51	1160	0	1039	0.4214876033057851	0.0
chr17	GH2	63881028	63881103	35	76	51	1160	16	1084	0.4605263157894737	0.014760147601476014
chr17	CSH1	63896074	63896235	0	162	0	1397	0	1235	0.0	0.0
chr17	CSHL1	63910861	63910924	0	64	0	1724	0	1660	0.0	0.0
chr17	GH1	63917759	63917924	0	166	84	993	84	827	0.0	0.10157194679564692
chr17	GH1	63918016	63918091	0	76	84	993	84	917	0.0	0.0916030534351145
chr17	GH1	63918345	63918506	0	162	84	993	84	831	0.0	0.10108303249097472
chr17	GH1	63918016	63918136	0	121	84	993	84	872	0.0	0.0963302752293578
chr17	CD79B	63930073	63930385	0	313	0	1764	0	1451	0.0	0.0
chr17	ICAM2	64007740	64007822	0	83	51	1706	51	1623	0.0	0.031423290203327174
chr17	TEX2	64160800	64160933	0	134	16986	8923	16986	8789	0.0	1.932643076572989
chr17	POLG2	64480288	64480389	0	102	174	4433	174	4331	0.0	0.040175479104132994
chr17	POLG2	64483389	64483506	0	118	174	4433	174	4315	0.0	0.040324449594438004
chr17	POLG2	64488842	64488937	0	96	174	4433	174	4337	0.0	0.04011989854738298
chr17	DDX5	64504221	64504318	518	98	9763	7977	9245	7879	5.285714285714286	1.1733722553623556
chr17	DDX5	64504676	64504842	765	167	9763	7977	8998	7810	4.580838323353293	1.152112676056338
chr17	DDX5	64500986	64501143	418	158	9763	7977	9345	7819	2.6455696202531644	1.1951656222023277
chr17	DDX5	64506075	64506262	51	188	9763	7977	9712	7789	0.2712765957446808	1.2468866349980743
chr17	DDX5	64506075	64506259	51	185	9763	7977	9712	7792	0.2756756756756757	1.2464065708418892
chr17	DDX5	64501056	64501143	130	88	9763	7977	9633	7889	1.4772727272727273	1.2210673089111421
chr17	DDX5	64504676	64504880	765	205	9763	7977	8998	7772	3.731707317073171	1.1577457539886773
chr17	SMURF2	64586085	64586170	0	86	8629	7235	8629	7149	0.0	1.2070219611134425
chr17	SMURF2	64606601	64606640	0	40	8629	7235	8629	7195	0.0	1.1993050729673385
chr17	SMURF2	64593990	64594104	0	115	8629	7235	8629	7120	0.0	1.211938202247191
chr17	ARHGAP27P1-BPTFP1-KPNA2P3	64750593	64750723	0	131	2260	3051	2260	2920	0.0	0.773972602739726
chr17	ARHGAP27P1-BPTFP1-KPNA2P3	64779980	64780205	118	226	2260	3051	2142	2825	0.5221238938053098	0.7582300884955753
chr17	PLEKHM1P1	64824624	64824872	0	249	238141	8489	238141	8240	0.0	28.900606796116506
chr17	PLEKHM1P1	64814862	64815245	243	384	238141	8489	237898	8105	0.6328125	29.35200493522517
chr17	LRRC37A3	64858778	64858883	0	106	29	7658	29	7552	0.0	0.003840042372881356
chr17	LRRC37A3	64889680	64889752	0	73	29	7658	29	7585	0.0	0.0038233355306526036
chr17	LRRC37A3	64918749	64918870	0	122	29	7658	29	7536	0.0	0.003848195329087049
chr17	LRRC37A3	64894648	64897654	0	3007	29	7658	29	4651	0.0	0.006235218232638142
chr17	AMZ2P1	64969314	64969425	0	112	3775	3863	3775	3751	0.0	1.0063982937883231
chr17	AXIN2	65536868	65537063	0	196	3471	5238	3471	5042	0.0	0.6884172947243158
chr17	CEP112	65661735	65661814	0	80	16459	7937	16459	7857	0.0	2.0948199058164696
chr17	APOH	66214452	66214650	0	199	523	1342	523	1143	0.0	0.4575678040244969
chr17	HELZ	67179595	67179736	0	142	2766	15615	2766	15473	0.0	0.17876300652749952
chr17	PSMD12	67357518	67357578	0	61	64	5355	64	5294	0.0	0.012089157536834151
chr17	PSMD12	67362775	67362892	0	118	64	5355	64	5237	0.0	0.012220737063204125
chr17	PSMD12	67361094	67361261	0	168	64	5355	64	5187	0.0	0.012338538654328128
chr17	AC145343.1	68100551	68100708	0	158	0	675	0	517	0.0	0.0
chr17	LRRC37A16P	68134098	68134149	0	52	102	3794	102	3742	0.0	0.027258150721539285
chr17	SLC16A6	68273926	68274070	0	145	51	4068	51	3923	0.0	0.01300025490695896
chr17	SLC16A6	68282996	68283123	0	128	51	4068	51	3940	0.0	0.012944162436548223
chr17	SLC16A6	68285544	68285642	0	99	51	4068	51	3969	0.0	0.012849584278155708
chr17	WIPI1	68434555	68434626	0	72	153	3414	153	3342	0.0	0.04578096947935368
chr17	WIPI1	68452909	68452992	0	84	153	3414	153	3330	0.0	0.04594594594594595
chr17	FAM20A	68590123	68590349	0	227	117	6194	117	5967	0.0	0.0196078431372549
chr17	ABCA8	68918426	68918546	0	121	71	10965	71	10844	0.0	0.006547399483585393
chr17	ABCA8	68949311	68949472	0	162	71	10965	71	10803	0.0	0.006572248449504767
chr17	ABCA8	68941938	68942039	0	102	71	10965	71	10863	0.0	0.006535947712418301
chr17	ABCA9	69007758	69007872	0	115	0	9065	0	8950	0.0	0.0
chr17	ABCA9	69051539	69051755	0	217	0	9065	0	8848	0.0	0.0
chr17	ABCA10	69153470	69153546	0	77	477	8379	477	8302	0.0	0.05745603469043604
chr17	ABCA10	69174606	69174777	0	172	477	8379	477	8207	0.0	0.058121116120385036
chr17	ABCA10	69201499	69201668	0	170	477	8379	477	8209	0.0	0.0581069557802412
chr17	ABCA10	69221791	69221895	0	105	477	8379	477	8274	0.0	0.05765047135605511
chr17	ABCA10	69178919	69179008	0	90	477	8379	477	8289	0.0	0.05754614549402823
chr17	ABCA10	69196285	69196483	0	199	477	8379	477	8180	0.0	0.058312958435207826
chr17	ABCA10	69196245	69196483	0	239	477	8379	477	8140	0.0	0.0585995085995086
chr17	ABCA5	69251746	69251866	0	121	0	13202	0	13081	0.0	0.0
chr17	ABCA5	69285387	69285420	0	34	0	13202	0	13168	0.0	0.0
chr17	ABCA5	69325698	69325817	0	120	0	13202	0	13082	0.0	0.0
chr17	ABCA5	69317704	69317823	0	120	0	13202	0	13082	0.0	0.0
chr17	CASC17	71132361	71132470	0	110	2762	2897	2762	2787	0.0	0.9910297811266595
chr17	CASC17	71132389	71132470	0	82	2762	2897	2762	2815	0.0	0.9811722912966252
chr17	CASC17	71131135	71131322	0	188	2762	2897	2762	2709	0.0	1.0195644149132521
chr17	CASC17	71180109	71180212	0	104	2762	2897	2762	2793	0.0	0.9889008234872897
chr17	CASC17	71168613	71168687	0	75	2762	2897	2762	2822	0.0	0.9787384833451452
chr17	CASC17	71185595	71185655	0	61	2762	2897	2762	2836	0.0	0.9739069111424542
chr17	CASC17	71134616	71134814	0	199	2762	2897	2762	2698	0.0	1.0237212750185323
chr17	CASC17	71200593	71200658	636	66	2762	2897	2126	2831	9.636363636363637	0.7509713882020488
chr17	CASC17	71136876	71137010	0	135	2762	2897	2762	2762	0.0	1.0
chr17	CASC17	71168603	71168687	0	85	2762	2897	2762	2812	0.0	0.9822190611664295
chr17	ROCR	72024152	72024304	0	153	102	3480	102	3327	0.0	0.030658250676284943
chr17	ROCR	72040515	72040582	0	68	102	3480	102	3412	0.0	0.029894490035169988
chr17	ROCR	72025897	72025977	0	81	102	3480	102	3399	0.0	0.03000882612533098
chr17	ROCR	72040689	72040849	0	161	102	3480	102	3319	0.0	0.03073214823742091
chr17	SOX9-AS1	72082121	72082415	0	295	102	11672	102	11377	0.0	0.008965456623011339
chr17	SOX9-AS1	72071062	72071231	0	170	102	11672	102	11502	0.0	0.008868022952529996
chr17	SOX9-AS1	72084989	72085045	0	57	102	11672	102	11615	0.0	0.00878174773999139
chr17	SOX9-AS1	72074548	72076733	0	2186	102	11672	102	9486	0.0	0.010752688172043012
chr17	SOX9-AS1	72081359	72081401	0	43	102	11672	102	11629	0.0	0.008771175509502106
chr17	SOX9-AS1	72114205	72114400	0	196	102	11672	102	11476	0.0	0.008888114325548972
chr17	SOX9-AS1	72081372	72081401	0	30	102	11672	102	11642	0.0	0.008761381205978355
chr17	SOX9-AS1	72090726	72091104	0	379	102	11672	102	11293	0.0	0.00903214380589746
chr17	SOX9-AS1	72086492	72086545	0	54	102	11672	102	11618	0.0	0.008779480117059734
chr17	LINC00511	72431127	72431224	0	98	344	21819	344	21721	0.0	0.01583720823166521
chr17	LINC00511	72324431	72324651	0	221	344	21819	344	21598	0.0	0.015927400685248633
chr17	LINC00511	72326307	72326430	0	124	344	21819	344	21695	0.0	0.015856188061765385
chr17	LINC00511	72325388	72325517	0	130	344	21819	344	21689	0.0	0.01586057448476186
chr17	LINC00511	72428235	72428298	29	64	344	21819	315	21755	0.453125	0.014479430016088255
chr17	LINC00511	72324021	72324150	0	130	344	21819	344	21689	0.0	0.01586057448476186
chr17	LINC00511	72325388	72325562	0	175	344	21819	344	21644	0.0	0.01589355017556829
chr17	LINC00511	72327995	72328096	0	102	344	21819	344	21717	0.0	0.015840125247501956
chr17	LINC00511	72326307	72326377	0	71	344	21819	344	21748	0.0	0.01581754644105205
chr17	LINC00511	72323742	72324150	0	409	344	21819	344	21410	0.0	0.01606725829051845
chr17	LINC00511	72325792	72325946	0	155	344	21819	344	21664	0.0	0.01587887740029542
chr17	LINC00511	72324539	72324651	0	113	344	21819	344	21706	0.0	0.015848152584538838
chr17	LINC00511	72339501	72339569	0	69	344	21819	344	21750	0.0	0.01581609195402299
chr17	LINC00511	72420699	72420964	0	266	344	21819	344	21553	0.0	0.01596065512921635
chr17	LINC00511	72420699	72421066	0	368	344	21819	344	21451	0.0	0.016036548412661413
chr17	LINC00511	72469574	72469656	0	83	344	21819	344	21736	0.0	0.01582627898417372
chr17	LINC00511	72533309	72533371	0	63	344	21819	344	21756	0.0	0.015811730097444382
chr17	LINC00511	72586653	72586825	0	173	344	21819	344	21646	0.0	0.01589208167790816
chr17	LINC00511	72507173	72507278	0	106	344	21819	344	21713	0.0	0.01584304333809239
chr17	LINC00511	72583043	72583138	0	96	344	21819	344	21723	0.0	0.015835750126593932
chr17	LINC00511	72599088	72599144	0	57	344	21819	344	21762	0.0	0.015807370646080322
chr17	LINC00511	72533974	72534077	0	104	344	21819	344	21715	0.0	0.015841584158415842
chr17	SLC39A11	73084807	73084846	26	40	3171	5564	3145	5524	0.65	0.5693338160753078
chr17	SLC39A11	72817869	72817935	0	67	3171	5564	3171	5497	0.0	0.5768601055120975
chr17	SLC39A11	73091823	73092116	0	294	3171	5564	3171	5270	0.0	0.601707779886148
chr17	FAM104A	73227164	73227264	578	101	92731	3169	92153	3068	5.7227722772277225	30.036831812255542
chr17	FAM104A	73212677	73212740	1438	64	92731	3169	91293	3105	22.46875	29.401932367149758
chr17	FAM104A	73227164	73227182	19	19	92731	3169	92712	3150	1.0	29.432380952380953
chr17	CDC42EP4	73286713	73286853	0	141	3709	3030	3709	2889	0.0	1.2838352371062651
chr17	SDK2	73380893	73380950	0	58	22918	12010	22918	11952	0.0	1.9175033467202143
chr17	LINC02074	74106879	74106981	0	103	253	2190	253	2087	0.0	0.12122664111164351
chr17	LINC02074	74096632	74096728	100	97	253	2190	153	2093	1.0309278350515463	0.07310081223124701
chr17	CD300H	74562833	74562897	0	65	83855	610	83855	545	0.0	153.86238532110093
chr17	AC064805.2	74676277	74676468	106647	192	180806	3376	74159	3184	555.453125	23.291143216080403
chr17	AC064805.2	74676277	74676465	106047	189	180806	3376	74759	3187	561.0952380952381	23.457483526827737
chr17	CD300LF	74696194	74696217	0	24	3440	2170	3440	2146	0.0	1.602982292637465
chr17	CD300LF	74698368	74698481	478	114	3440	2170	2962	2056	4.192982456140351	1.4406614785992218
chr17	CD300LF	74705203	74705377	657	175	3440	2170	2783	1995	3.7542857142857144	1.3949874686716792
chr17	CD300LF	74698575	74698621	0	47	3440	2170	3440	2123	0.0	1.6203485633537447
chr17	NAT9	74775621	74775707	0	87	16833	2692	16833	2605	0.0	6.461804222648753
chr17	NAT9	74775621	74775852	24	232	16833	2692	16809	2460	0.10344827586206896	6.832926829268293
chr17	NAT9	74772482	74772576	6908	95	16833	2692	9925	2597	72.71578947368421	3.8217173661917596
chr17	NAT9	74773865	74774055	94	191	16833	2692	16739	2501	0.49214659685863876	6.692922830867653
chr17	NAT9	74773865	74773939	45	75	16833	2692	16788	2617	0.6	6.414978983568972
chr17	NAT9	74773992	74774055	43	64	16833	2692	16790	2628	0.671875	6.388888888888889
chr17	FDXR	74863895	74864067	0	173	37	3392	37	3219	0.0	0.011494252873563218
chr17	FDXR	74864479	74864564	0	86	37	3392	37	3306	0.0	0.01119177253478524
chr17	FDXR	74866445	74866568	0	124	37	3392	37	3268	0.0	0.011321909424724603
chr17	FDXR	74866445	74866544	0	100	37	3392	37	3292	0.0	0.011239368165249088
chr17	FDXR	74869949	74870102	0	154	37	3392	37	3238	0.0	0.011426806670784434
chr17	FDXR	74872197	74872316	0	120	37	3392	37	3272	0.0	0.011308068459657702
chr17	FADS6	74881067	74881255	288	189	2675	2811	2387	2622	1.5238095238095237	0.910373760488177
chr17	FADS6	74892522	74892689	0	168	2675	2811	2675	2643	0.0	1.012107453651154
chr17	HID1	74964482	74964632	0	151	102	5791	102	5640	0.0	0.018085106382978722
chr17	HID1	74963739	74963910	0	172	102	5791	102	5619	0.0	0.018152696209289908
chr17	ATP5PD	75040091	75040163	0	73	0	2588	0	2515	0.0	0.0
chr17	ATP5PD	75039871	75040041	0	171	0	2588	0	2417	0.0	0.0
chr17	NT5C	75130752	75130867	0	116	0	1396	0	1280	0.0	0.0
chr17	JPT1	75146665	75146684	686	20	4669	2939	3983	2919	34.3	1.3645083932853717
chr17	JPT1	75149090	75149185	0	96	4669	2939	4669	2843	0.0	1.6422792824481183
chr17	SUMO2	75174751	75174823	0	73	423	3353	423	3280	0.0	0.12896341463414634
chr17	GGA3	75238913	75239083	0	171	5	4272	5	4101	0.0	0.00121921482565228
chr17	GGA3	75243062	75243166	0	105	5	4272	5	4167	0.0	0.0011999040076793857
chr17	GGA3	75244618	75244717	0	100	5	4272	5	4172	0.0	0.0011984659635666348
chr17	GGA3	75248839	75249008	0	170	5	4272	5	4102	0.0	0.0012189176011701609
chr17	GGA3	75237981	75238090	0	110	5	4272	5	4162	0.0	0.001201345506967804
chr17	GGA3	75238913	75239018	0	106	5	4272	5	4166	0.0	0.001200192030724916
chr17	GGA3	75243062	75243258	0	197	5	4272	5	4075	0.0	0.001226993865030675
chr17	GGA3	75244401	75244490	0	90	5	4272	5	4182	0.0	0.0011956001912960307
chr17	MIF4GD	75267745	75267901	102	157	102	3393	0	3236	0.6496815286624203	0.0
chr17	MIF4GD	75269346	75269448	0	103	102	3393	102	3290	0.0	0.03100303951367781
chr17	MIF4GD	75269346	75269469	0	124	102	3393	102	3269	0.0	0.03120220250841236
chr17	MIF4GD	75268082	75268192	0	111	102	3393	102	3282	0.0	0.031078610603290677
chr17	SLC25A19	75288501	75288591	0	91	204	2966	204	2875	0.0	0.07095652173913043
chr17	SLC25A19	75283422	75283593	0	172	204	2966	204	2794	0.0	0.07301360057265568
chr17	SLC25A19	75286632	75286802	0	171	204	2966	204	2795	0.0	0.07298747763864043
chr17	SLC25A19	75288553	75288591	0	39	204	2966	204	2927	0.0	0.06969593440382645
chr17	SLC25A19	75288387	75288461	0	75	204	2966	204	2891	0.0	0.07056381874783813
chr17	SLC25A19	75288387	75288591	0	205	204	2966	204	2761	0.0	0.07388627308946034
chr17	GRB2	75321658	75321827	914	170	4842	3442	3928	3272	5.376470588235295	1.2004889975550121
chr17	GRB2	75325897	75326020	0	124	4842	3442	4842	3318	0.0	1.4593128390596746
chr17	RECQL5	75650516	75650718	0	203	357	7229	357	7026	0.0	0.05081127241673783
chr17	GALK1	75763580	75763667	0	88	0	1926	0	1838	0.0	0.0
chr17	UNC13D	75830027	75830151	0	125	0	6820	0	6695	0.0	0.0
chr17	WBP2	75846907	75846984	0	78	0	4661	0	4583	0.0	0.0
chr17	WBP2	75847795	75847930	0	136	0	4661	0	4525	0.0	0.0
chr17	WBP2	75848569	75848662	0	94	0	4661	0	4567	0.0	0.0
chr17	WBP2	75851567	75851676	0	110	0	4661	0	4551	0.0	0.0
chr17	WBP2	75852655	75852820	0	166	0	4661	0	4495	0.0	0.0
chr17	TRIM65	75891812	75891878	0	67	153	3908	153	3841	0.0	0.03983337672481125
chr17	TRIM65	75892010	75892185	0	176	153	3908	153	3732	0.0	0.0409967845659164
chr17	MRPL38	75904539	75904719	0	181	0	3049	0	2868	0.0	0.0
chr17	MRPL38	75904539	75904673	0	135	0	3049	0	2914	0.0	0.0
chr17	FBF1	75910692	75910806	0	115	153	6205	153	6090	0.0	0.025123152709359605
chr17	FBF1	75935631	75935673	0	43	153	6205	153	6162	0.0	0.024829600778967866
chr17	ACOX1	75960214	75960375	0	162	711	6842	711	6680	0.0	0.10643712574850299
chr17	ACOX1	75973624	75973785	0	162	711	6842	711	6680	0.0	0.10643712574850299
chr17	ACOX1	75957458	75957566	0	109	711	6842	711	6733	0.0	0.10559928709342047
chr17	SRP68	76067216	76067330	351	115	14134	7056	13783	6941	3.0521739130434784	1.9857369255150554
chr17	EXOC7	76084247	76084289	15	43	22545	5674	22530	5631	0.3488372093023256	4.001065530101226
chr17	EXOC7	76086079	76086145	0	67	22545	5674	22545	5607	0.0	4.020866773675762
chr17	EXOC7	76091142	76091235	0	94	22545	5674	22545	5580	0.0	4.040322580645161
chr17	EXOC7	76089174	76089320	364	147	22545	5674	22181	5527	2.4761904761904763	4.013207888547132
chr17	EXOC7	76090328	76090481	0	154	22545	5674	22545	5520	0.0	4.084239130434782
chr17	EXOC7	76086853	76086892	0	40	22545	5674	22545	5634	0.0	4.001597444089457
chr17	EXOC7	76090328	76090397	0	70	22545	5674	22545	5604	0.0	4.023019271948608
chr17	EXOC7	76101678	76101863	5608	186	22545	5674	16937	5488	30.150537634408604	3.0861880466472305
chr17	RNF157	76155251	76155317	0	67	158165	5950	158165	5883	0.0	26.88509263980962
chr17	RNF157	76147268	76147309	0	42	158165	5950	158165	5908	0.0	26.77132701421801
chr17	QRICH2	76277162	76277310	0	149	124	5795	124	5646	0.0	0.021962451292950762
chr17	RHBDF2	76479732	76479941	0	210	255	6598	255	6388	0.0	0.03991859737006888
chr17	RHBDF2	76479732	76479854	0	123	255	6598	255	6475	0.0	0.039382239382239385
chr17	RHBDF2	76487973	76488132	0	160	255	6598	255	6438	0.0	0.03960857409133271
chr17	RHBDF2	76488014	76488132	0	119	255	6598	255	6479	0.0	0.03935792560580337
chr17	CYGB	76530978	76531142	0	165	0	2760	0	2595	0.0	0.0
chr17	AC015802.4	76557171	76557297	0	127	0	1500	0	1373	0.0	0.0
chr17	ST6GALNAC2	76568712	76568796	0	85	0	2785	0	2700	0.0	0.0
chr17	ST6GALNAC2	76578755	76578816	0	62	0	2785	0	2723	0.0	0.0
chr17	ST6GALNAC2	76568712	76568913	0	202	0	2785	0	2583	0.0	0.0
chr17	ST6GALNAC2	76580970	76581052	0	83	0	2785	0	2702	0.0	0.0
chr17	ST6GALNAC1	76626288	76626392	0	105	0	3207	0	3102	0.0	0.0
chr17	ST6GALNAC1	76626650	76626789	0	140	0	3207	0	3067	0.0	0.0
chr17	ST6GALNAC1	76637599	76637736	0	138	0	3207	0	3069	0.0	0.0
chr17	ST6GALNAC1	76641807	76641904	0	98	0	3207	0	3109	0.0	0.0
chr17	MXRA7	76683846	76683927	0	82	92528	8772	92528	8690	0.0	10.647640966628309
chr17	JMJD6	76720359	76720498	0	140	3315	5977	3315	5837	0.0	0.5679287305122495
chr17	JMJD6	76721262	76721356	0	95	3315	5977	3315	5882	0.0	0.5635838150289018
chr17	JMJD6	76721262	76721351	0	90	3315	5977	3315	5887	0.0	0.5631051469339222
chr17	SRSF2	76735771	76735875	0	105	816	2637	816	2532	0.0	0.3222748815165877
chr17	TMC6	78120652	78120832	90209	181	1002723	11377	912514	11196	498.3922651933702	81.50357270453733
chr17	TMC6	78124888	78124985	0	98	1002723	11377	1002723	11279	0.0	88.90176434081036
chr17	TMC6	78126776	78126906	0	131	1002723	11377	1002723	11246	0.0	89.16263560377023
chr17	TMC6	78120408	78120555	0	148	1002723	11377	1002723	11229	0.0	89.29762222815923
chr17	TMC6	78126776	78126974	0	199	1002723	11377	1002723	11178	0.0	89.70504562533549
chr17	TK1	78182588	78182682	99	95	13832	1240	13733	1145	1.0421052631578946	11.993886462882097
chr17	TK1	78183753	78183777	3370	25	13832	1240	10462	1215	134.8	8.610699588477367
chr17	DNAH17	78428524	78428707	51	184	93256	16192	93205	16008	0.27717391304347827	5.822401299350325
chr17	DNAH17	78441050	78441199	37764	150	93256	16192	55492	16042	251.76	3.4591696795910734
chr17	SCAT1	78627917	78628035	0	119	20317	4114	20317	3995	0.0	5.0856070087609515
chr17	SCAT1	78628317	78628438	270	122	20317	4114	20047	3992	2.2131147540983607	5.021793587174349
chr17	SCAT1	78621666	78621733	0	68	20317	4114	20317	4046	0.0	5.021502718734553
chr17	SCAT1	78630031	78630141	0	111	20317	4114	20317	4003	0.0	5.075443417436922
chr17	SCAT1	78618029	78618208	0	180	20317	4114	20317	3934	0.0	5.164463650228774
chr17	SCAT1	78629620	78629822	32	203	20317	4114	20285	3911	0.15763546798029557	5.186653029915623
chr17	SCAT1	78623553	78623750	0	198	20317	4114	20317	3916	0.0	5.188202247191011
chr17	CYTH1	78696006	78696009	0	4	20511	6766	20511	6762	0.0	3.033274179236912
chr17	CYTH1	78702537	78702604	408	68	20511	6766	20103	6698	6.0	3.0013436846819945
chr17	CYTH1	78709649	78709732	0	84	20511	6766	20511	6682	0.0	3.0695899431307994
chr17	USP36	78797785	78797879	0	95	34927	7560	34927	7465	0.0	4.678767582049565
chr17	USP36	78796316	78796494	0	179	34927	7560	34927	7381	0.0	4.732014632163663
chr17	USP36	78797785	78797902	0	118	34927	7560	34927	7442	0.0	4.693227626981994
chr17	USP36	78823112	78823183	0	72	34927	7560	34927	7488	0.0	4.664396367521367
chr17	LGALS3BP	78975964	78976156	1432	193	38996	2991	37564	2798	7.419689119170984	13.425303788420301
chr17	LGALS3BP	78972969	78973222	21421	254	38996	2991	17575	2737	84.33464566929133	6.421264157837048
chr17	LGALS3BP	78972969	78973343	32472	375	38996	2991	6524	2616	86.592	2.49388379204893
chr17	LGALS3BP	78979445	78979586	101	142	38996	2991	38895	2849	0.7112676056338029	13.652158652158652
chr17	LGALS3BP	78976942	78977000	0	59	38996	2991	38996	2932	0.0	13.300136425648022
chr17	LGALS3BP	78977403	78977473	25	71	38996	2991	38971	2920	0.352112676056338	13.346232876712328
chr17	CANT1	78997839	78997963	0	125	8954	4029	8954	3904	0.0	2.293545081967213
chr17	CANT1	78998147	78998286	0	140	8954	4029	8954	3889	0.0	2.30239136024685
chr17	CANT1	79000099	79000270	31	172	8954	4029	8923	3857	0.18023255813953487	2.3134560539279234
chr17	CANT1	79005371	79005481	1340	111	8954	4029	7614	3918	12.072072072072071	1.9433384379785605
chr17	RBFOX3	79103161	79103254	0	94	83309	9894	83309	9800	0.0	8.500918367346939
chr17	CBX8	79796496	79796540	0	45	1327920	4132	1327920	4087	0.0	324.9131392219232
chr17	TBC1D16	79951985	79952195	0	211	48775	11595	48775	11384	0.0	4.284522136331693
chr17	EIF4A3	80141318	80141381	14	64	17235	4553	17221	4489	0.21875	3.836266429048786
chr17	AC087741.1	80204498	80204596	1823	99	186661	2062	184838	1963	18.414141414141415	94.16097809475293
chr17	SGSH	80214614	80214765	1679	152	297589	3964	295910	3812	11.046052631578947	77.62591815320042
chr17	SGSH	80215032	80215138	847	107	297589	3964	296742	3857	7.91588785046729	76.93596059113301
chr17	SGSH	80211868	80211923	1180	56	297589	3964	296409	3908	21.071428571428573	75.84672466734902
chr17	SGSH	80214614	80214679	1631	66	297589	3964	295958	3898	24.71212121212121	75.92560287326835
chr17	SGSH	80214614	80214783	1793	170	297589	3964	295796	3794	10.547058823529412	77.96415392725356
chr17	AATK	81126657	81126817	0	161	51	5255	51	5094	0.0	0.010011778563015312
chr17	CEP131	81192735	81192843	116	109	855	3992	739	3883	1.0642201834862386	0.1903167653875869
chr17	TEPSIN	81232314	81232518	0	205	0	4141	0	3936	0.0	0.0
chr17	TEPSIN	81237550	81237660	0	111	0	4141	0	4030	0.0	0.0
chr17	SLC38A10	81272515	81272627	0	113	0	6833	0	6720	0.0	0.0
chr17	SLC38A10	81250069	81250093	0	25	0	6833	0	6808	0.0	0.0
chr17	AC110285.1	81381876	81381940	0	65	0	2396	0	2331	0.0	0.0
chr17	AC110285.1	81384945	81385032	0	88	0	2396	0	2308	0.0	0.0
chr17	ACTG1	81511762	81511803	0	42	0	2143	0	2101	0.0	0.0
chr17	FAAP100	81546400	81546540	0	141	0	5365	0	5224	0.0	0.0
chr17	FAAP100	81551927	81552052	0	126	0	5365	0	5239	0.0	0.0
chr17	NPLOC4	81608727	81608822	0	96	0	7339	0	7243	0.0	0.0
chr17	NPLOC4	81610209	81610258	0	50	0	7339	0	7289	0.0	0.0
chr17	NPLOC4	81563920	81563979	0	60	0	7339	0	7279	0.0	0.0
chr17	NPLOC4	81560561	81560629	0	69	0	7339	0	7270	0.0	0.0
chr17	NPLOC4	81567953	81568075	0	123	0	7339	0	7216	0.0	0.0
chr17	NPLOC4	81563412	81563568	0	157	0	7339	0	7182	0.0	0.0
chr17	PDE6G	81653159	81653364	0	206	0	1101	0	895	0.0	0.0
chr17	ARL16	81683012	81683126	0	115	0	2599	0	2484	0.0	0.0
chr17	ARL16	81682490	81682675	0	186	0	2599	0	2413	0.0	0.0
chr17	ARL16	81682442	81682675	0	234	0	2599	0	2365	0.0	0.0
chr17	MCRIP1	81823411	81823513	0	103	0	3547	0	3444	0.0	0.0
chr17	MCRIP1	81826379	81826515	0	137	0	3547	0	3410	0.0	0.0
chr17	P4HB	81855452	81855586	0	135	0	4717	0	4582	0.0	0.0
chr17	P4HB	81859180	81859387	0	208	0	4717	0	4509	0.0	0.0
chr17	P4HB	81855141	81855279	0	139	0	4717	0	4578	0.0	0.0
chr17	P4HB	81855452	81855505	0	54	0	4717	0	4663	0.0	0.0
chr17	ARHGDIA	81869329	81869406	0	78	0	2533	0	2455	0.0	0.0
chr17	ARHGDIA	81869055	81869075	0	21	0	2533	0	2512	0.0	0.0
chr17	PCYT2	81905381	81905447	0	67	0	6666	0	6599	0.0	0.0
chr17	PCYT2	81906099	81906177	0	79	0	6666	0	6587	0.0	0.0
chr17	PCYT2	81907553	81907598	0	46	0	6666	0	6620	0.0	0.0
chr17	PCYT2	81908875	81909037	0	163	0	6666	0	6503	0.0	0.0
chr17	PCYT2	81908875	81909321	0	447	0	6666	0	6219	0.0	0.0
chr17	PCYT2	81907203	81907257	0	55	0	6666	0	6611	0.0	0.0
chr17	PCYT2	81910900	81911015	0	116	0	6666	0	6550	0.0	0.0
chr17	PCYT2	81909161	81909321	0	161	0	6666	0	6505	0.0	0.0
chr17	SIRT7	81917614	81917719	0	106	0	5292	0	5186	0.0	0.0
chr17	SIRT7	81917829	81917967	0	139	0	5292	0	5153	0.0	0.0
chr17	SIRT7	81916057	81916139	0	83	0	5292	0	5209	0.0	0.0
chr17	MAFG	81923352	81923416	0	65	0	5245	0	5180	0.0	0.0
chr17	PYCR1	81934325	81934489	0	165	0	2584	0	2419	0.0	0.0
chr17	PYCR1	81934652	81934745	0	94	0	2584	0	2490	0.0	0.0
chr17	CENPX	82019640	82019694	0	55	0	1407	0	1352	0.0	0.0
chr17	CENPX	82019509	82019694	0	186	0	1407	0	1221	0.0	0.0
chr17	DCXR	82037449	82037547	0	99	0	1446	0	1347	0.0	0.0
chr17	DCXR	82037449	82037541	0	93	0	1446	0	1353	0.0	0.0
chr17	RFNG	82049917	82050006	0	90	0	2763	0	2673	0.0	0.0
chr17	DUS1L	82063467	82063518	0	52	0	3907	0	3855	0.0	0.0
chr17	CCDC57	82179026	82179189	0	164	0	9455	0	9291	0.0	0.0
chr17	CCDC57	82207846	82208048	0	203	0	9455	0	9252	0.0	0.0
chr17	CCDC57	82107401	82107621	0	221	0	9455	0	9234	0.0	0.0
chr17	CCDC57	82108767	82108954	0	188	0	9455	0	9267	0.0	0.0
chr17	CCDC57	82207730	82208048	0	319	0	9455	0	9136	0.0	0.0
chr17	CSNK1D	82253015	82253244	0	230	0	8237	0	8007	0.0	0.0
chr17	CSNK1D	82255428	82255577	0	150	0	8237	0	8087	0.0	0.0
chr17	CSNK1D	82265685	82265796	0	112	0	8237	0	8125	0.0	0.0
chr17	CSNK1D	82245975	82246039	0	65	0	8237	0	8172	0.0	0.0
chr17	CSNK1D	82249697	82250179	0	483	0	8237	0	7754	0.0	0.0
chr17	CSNK1D	82266724	82266894	0	171	0	8237	0	8066	0.0	0.0
chr17	SECTM1	82323256	82323316	0	61	0	2913	0	2852	0.0	0.0
chr17	SECTM1	82329258	82329466	0	209	0	2913	0	2704	0.0	0.0
chr17	OGFOD3	82409367	82409410	0	44	0	3642	0	3598	0.0	0.0
chr17	OGFOD3	82394330	82394543	0	214	0	3642	0	3428	0.0	0.0
chr17	CYBC1	82446622	82446696	0	75	0	3566	0	3491	0.0	0.0
chr17	CYBC1	82447579	82447621	0	43	0	3566	0	3523	0.0	0.0
chr17	CYBC1	82449169	82449292	0	124	0	3566	0	3442	0.0	0.0
chr17	CYBC1	82449430	82449480	0	51	0	3566	0	3515	0.0	0.0
chr17	CYBC1	82447579	82447646	0	68	0	3566	0	3498	0.0	0.0
chr17	CYBC1	82446622	82446692	0	71	0	3566	0	3495	0.0	0.0
chr17	CYBC1	82450198	82450254	0	57	0	3566	0	3509	0.0	0.0
chr17	CYBC1	82447850	82447927	0	78	0	3566	0	3488	0.0	0.0
chr17	CYBC1	82449173	82449292	0	120	0	3566	0	3446	0.0	0.0
chr17	WDR45B	82630920	82631022	0	103	0	3536	0	3433	0.0	0.0
chr17	WDR45B	82629530	82629628	0	99	0	3536	0	3437	0.0	0.0
chr17	RAB40B	82658490	82658713	0	224	0	4927	0	4703	0.0	0.0
chr17	RAB40B	82696388	82696853	0	466	0	4927	0	4461	0.0	0.0
chr17	RAB40B	82658490	82658562	0	73	0	4927	0	4854	0.0	0.0
chr17	B3GNTL1	83005574	83005671	0	98	0	6597	0	6499	0.0	0.0
chr17	TLCD3A	737845	738047	0	203	628	2606	628	2403	0.0	0.26133999167707034
chr17	TLCD3A	740504	740600	16	97	628	2606	612	2509	0.16494845360824742	0.2439218812275807
chr17	MRM3	783082	783327	62	246	1400	1989	1338	1743	0.25203252032520324	0.7676419965576592
chr17	WDR81	1731067	1731258	12942	192	31994	8095	19052	7903	67.40625	2.410730102492724
chr17	WDR81	1727989	1728626	2901	638	31994	8095	29093	7457	4.547021943573668	3.901434893388762
chr17	WDR81	1730379	1730487	0	109	31994	8095	31994	7986	0.0	4.00626095667418
chr17	SERPINF1	1766902	1766994	424	93	4818	2082	4394	1989	4.559139784946237	2.2091503267973858
chr17	RPA1	1888674	1888851	51	178	6771	5478	6720	5300	0.28651685393258425	1.2679245283018867
chr17	DPH1	2035969	2036091	260	123	9361	4551	9101	4428	2.113821138211382	2.0553297199638663
chr17	SRR	2309776	2309990	2539	215	174865	3263	172326	3048	11.809302325581395	56.53740157480315
chr17	SRR	2315556	2315728	0	173	174865	3263	174865	3090	0.0	56.590614886731395
chr17	SGSM2	2343544	2343620	0	77	19905	7230	19905	7153	0.0	2.7827484971340697
chr17	SGSM2	2362837	2362905	0	69	19905	7230	19905	7161	0.0	2.779639715123586
chr17	SGSM2	2367270	2367405	0	136	19905	7230	19905	7094	0.0	2.805892303354948
chr17	SGSM2	2379431	2379493	76	63	19905	7230	19829	7167	1.2063492063492063	2.766708525184875
chr17	PAFAH1B1	2665371	2665456	0	86	113619	9736	113619	9650	0.0	11.7739896373057
chr17	PAFAH1B1	2666015	2666090	0	76	113619	9736	113619	9660	0.0	11.761801242236025
chr17	PAFAH1B1	2638098	2638320	62	223	113619	9736	113557	9513	0.27802690582959644	11.937033533060022
chr17	PAFAH1B1	2672654	2672757	0	104	113619	9736	113619	9632	0.0	11.795992524916944
chr17	PAFAH1B1	2676504	2676606	0	103	113619	9736	113619	9633	0.0	11.794767985051386
chr17	PAFAH1B1	2613657	2613862	1336	206	113619	9736	112283	9530	6.485436893203883	11.782056663168941
chr17	PAFAH1B1	2653853	2653951	0	99	113619	9736	113619	9637	0.0	11.789872366919166
chr17	PAFAH1B1	2662780	2662834	0	55	113619	9736	113619	9681	0.0	11.73628757359777
chr17	PAFAH1B1	2605760	2605837	115	78	113619	9736	113504	9658	1.4743589743589745	11.752329674880928
chr17	PAFAH1B1	2635382	2635510	0	129	113619	9736	113619	9607	0.0	11.826688872696991
chr17	RAP1GAP2	2962669	2962714	0	46	162	6883	162	6837	0.0	0.02369460289600702
chr17	CTNS	3640187	3640267	0	81	153	4697	153	4616	0.0	0.033145580589254764
chr17	CTNS	3648846	3648931	0	86	153	4697	153	4611	0.0	0.03318152244632401
chr17	CTNS	3647443	3647522	0	80	153	4697	153	4617	0.0	0.03313840155945419
chr17	SPNS3	4445031	4445168	71408	138	104668	2445	33260	2307	517.4492753623189	14.416991764195926
chr17	SPNS3	4449234	4449387	2630	154	104668	2445	102038	2291	17.07792207792208	44.53862941946748
chr17	SPNS2	4536262	4536426	0	165	102	4080	102	3915	0.0	0.026053639846743294
chr17	SMTNL2	4592928	4593171	502	244	400537	2410	400035	2166	2.057377049180328	184.68836565096953
chr17	ARRB2	4715012	4715043	144	32	109835	3784	109691	3752	4.5	29.235341151385928
chr17	ARRB2	4715972	4716033	319	62	109835	3784	109516	3722	5.145161290322581	29.42396560988716
chr17	ARRB2	4716146	4716191	292	46	109835	3784	109543	3738	6.3478260869565215	29.305243445692884
chr17	ARRB2	4718260	4718345	648	86	109835	3784	109187	3698	7.534883720930233	29.525959978366686
chr17	ARRB2	4716411	4716608	1096	198	109835	3784	108739	3586	5.5353535353535355	30.323201338538762
chr17	ARRB2	4715199	4715336	51	138	109835	3784	109784	3646	0.3695652173913043	30.110806363137684
chr17	MED11	4731775	4731906	0	132	1322	1478	1322	1346	0.0	0.9821693907875185
chr17	ZMYND15	4743990	4744107	0	118	15725	3339	15725	3221	0.0	4.8820242160819625
chr17	PLD2	4818001	4818106	0	106	384	4796	384	4690	0.0	0.08187633262260129
chr17	MINK1	4892401	4892512	7609	112	214859	6924	207250	6812	67.9375	30.424251321197886
chr17	MINK1	4893285	4893309	962	25	214859	6924	213897	6899	38.48	31.00405855921148
chr17	MINK1	4859212	4859328	402	117	214859	6924	214457	6807	3.4358974358974357	31.50536212722198
chr17	MINK1	4890221	4890308	1388	88	214859	6924	213471	6836	15.772727272727273	31.227472205968404
chr17	RNF167	4940486	4940726	0	241	102	2282	102	2041	0.0	0.04997550220480157
chr17	RNF167	4941076	4941157	0	82	102	2282	102	2200	0.0	0.046363636363636364
chr17	RNF167	4940872	4940993	0	122	102	2282	102	2160	0.0	0.04722222222222222
chr17	RNF167	4940486	4940642	0	157	102	2282	102	2125	0.0	0.048
chr17	RNF167	4940486	4940993	0	508	102	2282	102	1774	0.0	0.05749718151071026
chr17	RNF167	4944557	4944638	0	82	102	2282	102	2200	0.0	0.046363636363636364
chr17	ENO3	4952024	4952147	0	124	77	4037	77	3913	0.0	0.01967799642218247
chr17	KIF1C	4999012	4999046	2621	35	56370	8604	53749	8569	74.88571428571429	6.272493873264091
chr17	USP6	5147082	5147194	6	113	55132	11312	55126	11199	0.05309734513274336	4.922403786052326
chr17	USP6	5138970	5139181	102	212	55132	11312	55030	11100	0.4811320754716981	4.957657657657657
chr17	RABEP1	5283883	5284069	1364	187	948130	7080	946766	6893	7.294117647058823	137.3518061801828
chr17	RABEP1	5308693	5308822	646	130	948130	7080	947484	6950	4.969230769230769	136.32863309352518
chr17	RABEP1	5380363	5380462	765	100	948130	7080	947365	6980	7.65	135.7256446991404
chr17	RABEP1	5356507	5356573	420	67	948130	7080	947710	7013	6.268656716417911	135.13617567374874
chr17	RPAIN	5425970	5426082	0	113	0	7435	0	7322	0.0	0.0
chr17	RPAIN	5426235	5426299	0	65	0	7435	0	7370	0.0	0.0
chr17	RPAIN	5428070	5428211	0	142	0	7435	0	7293	0.0	0.0
chr17	MIS12	5487556	5487694	1758	139	3538	3162	1780	3023	12.647482014388489	0.588819053919947
chr17	MIS12	5488195	5488589	0	395	3538	3162	3538	2767	0.0	1.278641127574991
chr17	WSCD1	6087989	6088104	0	116	0	7099	0	6983	0.0	0.0
chr17	PIMREG	6450027	6450072	0	46	51	2570	51	2524	0.0	0.020206022187004756
chr17	PIMREG	6449703	6449778	0	76	51	2570	51	2494	0.0	0.02044907778668805
chr17	PIMREG	6446094	6446187	0	94	51	2570	51	2476	0.0	0.02059773828756058
chr17	TXNDC17	6642248	6642324	0	77	0	2558	0	2481	0.0	0.0
chr17	ALOX15P1	6658481	6658554	0	74	3886	4096	3886	4022	0.0	0.966185977125808
chr17	XAF1	6759255	6759718	0	464	102	6341	102	5877	0.0	0.017355793772332824
chr17	XAF1	6762154	6762240	0	87	102	6341	102	6254	0.0	0.016309561880396548
chr17	XAF1	6759661	6759718	0	58	102	6341	102	6283	0.0	0.01623428298583479
chr17	XAF1	6760405	6760601	0	197	102	6341	102	6144	0.0	0.0166015625
chr17	XAF1	6761885	6762037	0	153	102	6341	102	6188	0.0	0.016483516483516484
chr17	XAF1	6759840	6759881	0	42	102	6341	102	6299	0.0	0.016193046515319894
chr17	XAF1	6758861	6758959	0	99	102	6341	102	6242	0.0	0.016340916372957384
chr17	XAF1	6759255	6759519	0	265	102	6341	102	6076	0.0	0.016787360105332456
chr17	FBXO39	6789700	6789760	0	61	2193	2933	2193	2872	0.0	0.7635793871866295
chr17	ALOX12P2	6894317	6894513	0	197	57285	5629	57285	5432	0.0	10.545839469808541
chr17	ALOX12P2	6894317	6894519	0	203	57285	5629	57285	5426	0.0	10.557500921489126
chr17	ALOX12P2	6894738	6894793	0	56	57285	5629	57285	5573	0.0	10.2790238650637
chr17	ALOX12P2	6898203	6898290	1523	88	57285	5629	55762	5541	17.306818181818183	10.06352643927089
chr17	RNASEK	7013318	7013516	0	199	0	1124	0	925	0.0	0.0
chr17	C17ORF49	7015773	7015875	0	103	0	1569	0	1466	0.0	0.0
chr17	RNASEK	7013318	7013535	0	218	0	1124	0	906	0.0	0.0
chr17	C17ORF49	7016909	7017014	0	106	0	1569	0	1463	0.0	0.0
chr17	C17ORF49	7016949	7017014	0	66	0	1569	0	1503	0.0	0.0
chr17	ACADVL	7220463	7220529	672	67	162847	3886	162175	3819	10.029850746268657	42.465305053678975
chr17	ACADVL	7220923	7221058	7899	136	162847	3886	154948	3750	58.080882352941174	41.31946666666666
chr17	ACADVL	7221537	7221682	20198	146	162847	3886	142649	3740	138.34246575342465	38.14144385026738
chr17	ACADVL	7224145	7224243	9581	99	162847	3886	153266	3787	96.77777777777777	40.471613414312124
chr17	ACADVL	7220603	7220676	6718	74	162847	3886	156129	3812	90.78378378378379	40.95724029380902
chr17	ACADVL	7221518	7221682	21752	165	162847	3886	141095	3721	131.83030303030304	37.91857027680731
chr17	ELP5	7256856	7257038	7049	183	10281	2734	3232	2551	38.51912568306011	1.2669541356330851
chr17	ELP5	7258825	7258926	0	102	10281	2734	10281	2632	0.0	3.9061550151975686
chr17	SLC2A4	7283973	7284089	846	117	14378	4007	13532	3890	7.230769230769231	3.47866323907455
chr17	EIF5A	7308480	7308575	4909	96	139926	2599	135017	2503	51.135416666666664	53.942069516580105
chr17	ACAP1	7337311	7337369	0	59	41257	3412	41257	3353	0.0	12.30450342976439
chr17	ACAP1	7337262	7337369	43	108	41257	3412	41214	3304	0.39814814814814814	12.473970944309928
chr17	NLGN2	7412156	7412207	47	52	1431442	5110	1431395	5058	0.9038461538461539	282.9962435745354
chr17	CHRNB1	7448578	7448788	0	211	9362	3862	9362	3651	0.0	2.5642289783620926
chr17	CHRNB1	7446397	7446472	0	76	9362	3862	9362	3786	0.0	2.4727945060750134
chr17	TNFSF12	7553586	7553825	0	240	306	1920	306	1680	0.0	0.18214285714285713
chr17	TNFSF13	7559845	7559893	420	49	831	2282	411	2233	8.571428571428571	0.18405732198835648
chr17	SENP3	7566926	7567004	0	79	430228	3150	430228	3071	0.0	140.09378052751546
chr17	SENP3	7570882	7570933	782	52	430228	3150	429446	3098	15.038461538461538	138.62040025823111
chr17	EIF4A1	7574259	7574308	1214	50	1389251	4446	1388037	4396	24.28	315.75
chr17	EIF4A1	7575118	7575258	4692	141	1389251	4446	1384559	4305	33.276595744680854	321.6164924506388
chr17	EIF4A1	7576523	7576692	11387	170	1389251	4446	1377864	4276	66.98235294117647	322.23199251637044
chr17	EIF4A1	7578164	7578244	125586	81	1389251	4446	1263665	4365	1550.4444444444443	289.4994272623139
chr17	SENP3	7570680	7570764	1674	85	430228	3150	428554	3065	19.694117647058825	139.82185970636215
chr17	EIF4A1	7573399	7573547	1287	149	1389251	4446	1387964	4297	8.63758389261745	323.0076797765883
chr17	EIF4A1	7576529	7576692	10971	164	1389251	4446	1378280	4282	66.89634146341463	321.8776272769734
chr17	EIF4A1	7574545	7574678	145	134	1389251	4446	1389106	4312	1.0820895522388059	322.1488868274583
chr17	EIF4A1	7574265	7574308	955	44	1389251	4446	1388296	4402	21.704545454545453	315.37846433439347
chr17	EIF4A1	7578226	7578244	32651	19	1389251	4446	1356600	4427	1718.4736842105262	306.43776824034336
chr17	EIF4A1	7578119	7578244	125825	126	1389251	4446	1263426	4320	998.6111111111111	292.45972222222224
chr17	MPDU1	7586655	7586777	12	123	51333	2956	51321	2833	0.0975609756097561	18.115425344158137
chr17	MPDU1	7586898	7587017	525	120	51333	2956	50808	2836	4.375	17.915373765867418
chr17	MPDU1	7585950	7586078	705	129	51333	2956	50628	2827	5.465116279069767	17.908737177219667
chr17	MPDU1	7586691	7586777	12	87	51333	2956	51321	2869	0.13793103448275862	17.888114325548973
chr17	MPDU1	7585945	7586078	725	134	51333	2956	50608	2822	5.41044776119403	17.93338058114812
chr17	MPDU1	7586691	7586838	51	148	51333	2956	51282	2808	0.34459459459459457	18.262820512820515
chr17	MPDU1	7585731	7585797	192	67	51333	2956	51141	2889	2.8656716417910446	17.70197300103842
chr17	SHBG	7631199	7631361	0	163	79573	1850	79573	1687	0.0	47.16834617664493
chr17	SHBG	7632751	7632959	51	209	79573	1850	79522	1641	0.24401913875598086	48.459475929311395
chr17	SHBG	7631878	7632015	0	138	79573	1850	79573	1712	0.0	46.47955607476636
chr17	SHBG	7631588	7631748	0	161	79573	1850	79573	1689	0.0	47.112492599171105
chr17	WRAP53	7689223	7689322	0	100	0	3629	0	3529	0.0	0.0
chr17	WRAP53	7702343	7702552	0	210	0	3629	0	3419	0.0	0.0
chr17	DNAH2	7766317	7766481	2360	165	556145	16910	553785	16745	14.303030303030303	33.07166318303971
chr17	DNAH2	7804957	7805074	0	118	556145	16910	556145	16792	0.0	33.1196403049071
chr17	KDM6B	7846818	7847016	6285	199	341652	7166	335367	6967	31.582914572864322	48.13650064590211
chr17	CHD3	7907600	7907702	0	103	26	10249	26	10146	0.0	0.002562586240883107
chr17	CHD3	7910427	7910591	0	165	26	10249	26	10084	0.0	0.002578341927806426
chr17	CHD3	7910438	7910591	0	154	26	10249	26	10095	0.0	0.0025755324418028727
chr17	CNTROB	7944475	7944638	0	164	342	5814	342	5650	0.0	0.060530973451327436
chr17	ALOX15B	8046667	8046754	1350	88	7600	3024	6250	2936	15.340909090909092	2.1287465940054497
chr17	PFAS	8263774	8263936	1069	163	21714	6403	20645	6240	6.558282208588957	3.30849358974359
chr17	PFAS	8255501	8255691	0	191	21714	6403	21714	6212	0.0	3.495492594977463
chr17	RANGRF	8289502	8289588	0	87	102	1335	102	1248	0.0	0.08173076923076923
chr17	ARHGEF15	8310827	8310863	0	37	0	4978	0	4941	0.0	0.0
chr17	ODF4	8344872	8345042	585	171	3762	1326	3177	1155	3.4210526315789473	2.7506493506493506
chr17	NDEL1	8444623	8444742	0	120	32489	5059	32489	4939	0.0	6.578052237294999
chr17	NDEL1	8460008	8460160	0	153	32489	5059	32489	4906	0.0	6.622299225438239
chr17	NDEL1	8463319	8463354	0	36	32489	5059	32489	5023	0.0	6.468046983874179
chr17	NDEL1	8443926	8444176	128	251	32489	5059	32361	4808	0.5099601593625498	6.730657237936772
chr17	CFAP52	9641723	9641835	0	113	3053	3084	3053	2971	0.0	1.0276001346348032
chr17	CFAP52	9597511	9597621	0	111	3053	3084	3053	2973	0.0	1.0269088462832157
chr17	CFAP52	9585772	9585972	0	201	3053	3084	3053	2883	0.0	1.0589663544918488
chr17	CFAP52	9610290	9610342	0	53	3053	3084	3053	3031	0.0	1.0072583305839657
chr17	CFAP52	9584181	9584371	0	191	3053	3084	3053	2893	0.0	1.0553059108192189
chr17	USP43	9666647	9666751	0	105	0	4991	0	4886	0.0	0.0
chr17	GLP2R	9834537	9834783	0	247	0	5712	0	5465	0.0	0.0
chr17	AC005323.1	10621574	10621749	559	176	31758	1481	31199	1305	3.1761363636363638	23.90727969348659
chr17	TMEM220-AS1	10736604	10736638	0	35	0	2726	0	2691	0.0	0.0
chr17	TMEM220-AS1	10766678	10766856	0	179	0	2726	0	2547	0.0	0.0
chr17	SHISA6	11551895	11551952	0	58	51	8583	51	8525	0.0	0.005982404692082111
chr17	SHISA6	11379413	11379509	0	97	51	8583	51	8486	0.0	0.0060098986566108886
chr17	DNAH9	11871597	11871786	110	190	26756	17017	26646	16827	0.5789473684210527	1.5835264753075415
chr17	DNAH9	11929865	11930093	612	229	26756	17017	26144	16788	2.6724890829694323	1.5573028353585894
chr17	MAP2K4	12107789	12107909	0	121	234	4535	234	4414	0.0	0.05301314000906208
chr17	MAP2K4	12032265	12032298	30	34	234	4535	204	4501	0.8823529411764706	0.04532326149744501
chr17	MAP2K4	12081355	12081530	0	176	234	4535	234	4359	0.0	0.053682037164487266
chr17	MAP2K4	12129138	12129287	0	150	234	4535	234	4385	0.0	0.053363740022805015
chr17	MAP2K4	12054888	12054991	0	104	234	4535	234	4431	0.0	0.052809749492213946
chr17	LINC00670	12584559	12584721	0	163	0	4762	0	4599	0.0	0.0
chr17	MYOCD	12710494	12710538	0	45	120	8891	120	8846	0.0	0.013565453312231517
chr17	MYOCD	12756413	12756557	0	145	120	8891	120	8746	0.0	0.01372055796935742
chr17	MYOCD	12758084	12758213	6	130	120	8891	114	8761	0.046153846153846156	0.013012213217669216
chr17	ARHGAP44	12928928	12929046	0	119	7690	7135	7690	7016	0.0	1.096066134549601
chr17	ARHGAP44	12973301	12973319	0	19	7690	7135	7690	7116	0.0	1.080663293985385
chr17	ARHGAP44	12987100	12987152	0	53	7690	7135	7690	7082	0.0	1.0858514543914148
chr17	AC005303.1	13096847	13097019	0	173	0	1139	0	966	0.0	0.0
chr17	COX10	14076734	14077056	0	323	9661	6769	9661	6446	0.0	1.4987589202606268
chr17	COX10	14102117	14102242	0	126	9661	6769	9661	6643	0.0	1.454312810477194
chr17	COX10	14215809	14215937	0	129	9661	6769	9661	6640	0.0	1.4549698795180723
chr17	AC022816.1	14377283	14377421	0	139	0	1255	0	1116	0.0	0.0
chr17	LINC02096	14837940	14838216	0	277	102	3329	102	3052	0.0	0.033420707732634336
chr17	ZNF286A	15700134	15700366	51	233	215	3177	164	2944	0.21888412017167383	0.05570652173913043
chr17	ZNF286A	15700047	15700366	51	320	215	3177	164	2857	0.159375	0.05740287014350717
chr17	ZNF286A	15706386	15706501	0	116	215	3177	215	3061	0.0	0.07023848415550474
chr17	ZNF286A	15716058	15717313	0	1256	215	3177	215	1921	0.0	0.11192087454450807
chr17	TBC1D26	15735347	15735423	0	77	357	5061	357	4984	0.0	0.07162921348314606
chr17	ZNF286A	15700272	15700366	0	95	215	3177	215	3082	0.0	0.06975989617131732
chr17	ZNF286A	15700047	15700168	2	122	215	3177	213	3055	0.01639344262295082	0.06972176759410802
chr17	ZNF286A	15700207	15700366	11	160	215	3177	204	3017	0.06875	0.06761683791846204
chr17	TBC1D26	15734041	15734088	0	48	357	5061	357	5013	0.0	0.07121484141232795
chr17	PIGL	16233970	16234070	113	101	975318	6013	975205	5912	1.118811881188119	164.9534844384303
chr17	PIGL	16316680	16316712	0	33	975318	6013	975318	5980	0.0	163.09665551839464
chr17	UBB	16381901	16382130	0	230	1887	1438	1887	1208	0.0	1.5620860927152318
chr17	TRPV2	16431783	16431850	0	68	51	3397	51	3329	0.0	0.015319915890657855
chr17	TRPV2	16433573	16433698	0	126	51	3397	51	3271	0.0	0.0155915622133904
chr17	TRPV2	16434889	16434969	0	81	51	3397	51	3316	0.0	0.015379975874547648
chr17	TRPV2	16434858	16434969	0	112	51	3397	51	3285	0.0	0.015525114155251141
chr17	SNHG29	16439326	16439414	0	89	42991	5724	42991	5635	0.0	7.629281277728483
chr17	SNHG29	16441073	16441130	0	58	42991	5724	42991	5666	0.0	7.587539710554183
chr17	SNHG29	16439580	16439703	0	124	42991	5724	42991	5600	0.0	7.676964285714286
chr17	SNHG29	16439527	16439703	0	177	42991	5724	42991	5547	0.0	7.750315485848207
chr17	SNHG29	16439659	16439703	0	45	42991	5724	42991	5679	0.0	7.57017080471914
chr17	SNHG29	16439326	16439393	0	68	42991	5724	42991	5656	0.0	7.600954738330976
chr17	SNHG29	16439326	16439703	0	378	42991	5724	42991	5346	0.0	8.04171343060232
chr17	SNHG29	16439531	16439703	0	173	42991	5724	42991	5551	0.0	7.744730679156909
chr17	SNHG29	16460892	16461245	0	354	42991	5724	42991	5370	0.0	8.005772811918064
chr17	CCDC144A	16707471	16707542	5035	72	115260	15009	110225	14937	69.93055555555556	7.379326504652876
chr17	CCDC144A	16708795	16709635	0	841	115260	15009	115260	14168	0.0	8.135234330886504
chr17	CCDC144A	16707468	16707542	5117	75	115260	15009	110143	14934	68.22666666666667	7.375318066157761
chr17	USP32P1	16787934	16788135	0	202	50	5336	50	5134	0.0	0.009738994935722634
chr17	CCDC144A	16737537	16737675	0	139	115260	15009	115260	14870	0.0	7.751176866173504
chr17	CCDC144A	16772599	16772709	0	111	115260	15009	115260	14898	0.0	7.736608940797423
chr17	USP32P1	16791826	16792053	0	228	50	5336	50	5108	0.0	0.009788566953797965
chr17	USP32P1	16799101	16799194	0	94	50	5336	50	5242	0.0	0.009538344143456695
chr17	MPRIP	17143555	17143669	277	115	369333	14685	369056	14570	2.408695652173913	25.329855868222374
chr17	MPRIP	17164108	17167915	111992	3808	369333	14685	257341	10877	29.409663865546218	23.65918911464558
chr17	MPRIP	17175292	17175412	0	121	369333	14685	369333	14564	0.0	25.35931062894809
chr17	MPRIP	17180606	17180669	66	64	369333	14685	369267	14621	1.03125	25.255933246699954
chr17	MPRIP	17173915	17174075	4978	161	369333	14685	364355	14524	30.919254658385093	25.086408702836685
chr17	NT5M	17304363	17304481	0	119	23	1969	23	1850	0.0	0.012432432432432432
chr17	NT5M	17304363	17304477	0	115	23	1969	23	1854	0.0	0.012405609492988134
chr17	MED9	17485299	17485433	102	135	2993	5710	2891	5575	0.7555555555555555	0.5185650224215247
chr17	DRC3	17973851	17973962	78	112	26994	4609	26916	4497	0.6964285714285714	5.985323549032689
chr17	DRC3	17981231	17981291	0	61	26994	4609	26994	4548	0.0	5.935356200527704
chr17	DRC3	17973925	17973962	25	38	26994	4609	26969	4571	0.6578947368421053	5.900021877050974
chr17	DRC3	17973664	17973962	102	299	26994	4609	26892	4310	0.3411371237458194	6.239443155452436
chr17	DRC3	17973664	17973753	0	90	26994	4609	26994	4519	0.0	5.973445452533746
chr17	DRC3	17973664	17973751	0	88	26994	4609	26994	4521	0.0	5.970802919708029
chr17	GID4	18056702	18056759	32	58	470	2891	438	2833	0.5517241379310345	0.15460642428521001
chr17	DRG2	18099016	18099093	34	78	321194	6021	321160	5943	0.4358974358974359	54.04004711425206
chr17	DRG2	18099016	18099077	34	62	321194	6021	321160	5959	0.5483870967741935	53.89494881691559
chr17	DRG2	18095420	18095489	125	70	321194	6021	321069	5951	1.7857142857142858	53.952108889262306
chr17	DRG2	18091917	18092074	559	158	321194	6021	320635	5863	3.537974683544304	54.68787310250725
chr17	MYO15A	18148495	18148568	82650	74	1750422	16458	1667772	16384	1116.8918918918919	101.792724609375
chr17	MYO15A	18154679	18154755	40124	77	1750422	16458	1710298	16381	521.0909090909091	104.40742323423478
chr17	MYO15A	18159605	18159679	152	75	1750422	16458	1750270	16383	2.026666666666667	106.8345235915278
chr17	MYO15A	18166360	18166521	4602	162	1750422	16458	1745820	16296	28.40740740740741	107.13181148748158
chr17	MYO15A	18173780	18173921	8472	142	1750422	16458	1741950	16316	59.66197183098591	106.76329982838931
chr17	MYO15A	18167589	18167723	6362	135	1750422	16458	1744060	16323	47.12592592592593	106.84678061630828
chr17	MYO15A	18169481	18169621	648	141	1750422	16458	1749774	16317	4.595744680851064	107.23625666482809
chr17	MYO15A	18158522	18158638	46682	117	1750422	16458	1703740	16341	398.991452991453	104.26167309222201
chr17	MYO15A	18158924	18158997	258	74	1750422	16458	1750164	16384	3.4864864864864864	106.821533203125
chr17	KRT17P5	18423656	18423734	671	79	11470	3166	10799	3087	8.49367088607595	3.498218334953029
chr17	LGALS9C	18483874	18483966	102	93	4186	4399	4084	4306	1.096774193548387	0.9484440315838365
chr17	LGALS9C	18490732	18490768	0	37	4186	4399	4186	4362	0.0	0.959651535992664
chr17	LGALS9C	18488940	18489036	0	97	4186	4399	4186	4302	0.0	0.9730357973035797
chr17	LGALS9C	18492696	18492859	0	164	4186	4399	4186	4235	0.0	0.9884297520661157
chr17	LGALS9C	18486754	18486940	347	187	4186	4399	3839	4212	1.8556149732620322	0.9114434947768281
chr17	TRIM16L	18699359	18699457	672	99	8856	3780	8184	3681	6.787878787878788	2.2233088834555828
chr17	TRIM16L	18731069	18731235	0	167	8856	3780	8856	3613	0.0	2.4511486299474123
chr17	TRIM16L	18732038	18732134	0	97	8856	3780	8856	3683	0.0	2.40456149877817
chr17	FBXW10	18769926	18770085	7	160	1130	3798	1123	3638	0.04375	0.3086860912589335
chr17	TVP23B	18790895	18790960	0	66	23565	5755	23565	5689	0.0	4.142204253823167
chr17	TVP23B	18790895	18791040	0	146	23565	5755	23565	5609	0.0	4.201283651274737
chr17	PRPSAP2	18867281	18867334	0	54	5997	4727	5997	4673	0.0	1.2833297667451316
chr17	PRPSAP2	18872582	18872649	3606	68	5997	4727	2391	4659	53.029411764705884	0.5132002575660013
chr17	PRPSAP2	18882567	18882683	0	117	5997	4727	5997	4610	0.0	1.3008676789587852
chr17	PRPSAP2	18928810	18928957	0	148	5997	4727	5997	4579	0.0	1.3096746014413627
chr17	PRPSAP2	18857783	18857853	0	71	5997	4727	5997	4656	0.0	1.2880154639175259
chr17	PRPSAP2	18867256	18867334	0	79	5997	4727	5997	4648	0.0	1.2902323580034423
chr17	PRPSAP2	18865468	18865564	0	97	5997	4727	5997	4630	0.0	1.2952483801295895
chr17	PRPSAP2	18859339	18859475	0	137	5997	4727	5997	4590	0.0	1.3065359477124183
chr17	PRPSAP2	18864867	18864941	0	75	5997	4727	5997	4652	0.0	1.2891229578675838
chr17	PRPSAP2	18860565	18860691	0	127	5997	4727	5997	4600	0.0	1.3036956521739131
chr17	PRPSAP2	18917431	18917536	0	106	5997	4727	5997	4621	0.0	1.2977710452283056
chr17	SLC5A10	19013361	19013517	0	157	2841	6468	2841	6311	0.0	0.4501663761685945
chr17	SLC5A10	19017283	19017394	0	112	2841	6468	2841	6356	0.0	0.44697923222152297
chr17	SLC5A10	18969341	18969422	0	82	2841	6468	2841	6386	0.0	0.44487942373943
chr17	SLC5A10	19013409	19013517	0	109	2841	6468	2841	6359	0.0	0.4467683598050008
chr17	GRAPL	19144102	19144170	77	69	740	1979	663	1910	1.1159420289855073	0.3471204188481675
chr17	EPN2	19281954	19282077	427	124	107116	7670	106689	7546	3.443548387096774	14.138483965014577
chr17	EPN2	19285619	19285790	19831	172	107116	7670	87285	7498	115.29651162790698	11.641104294478527
chr17	EPN2	19276396	19276538	0	143	107116	7670	107116	7527	0.0	14.230902085824365
chr17	EPN2	19249370	19249526	1155	157	107116	7670	105961	7513	7.356687898089172	14.10368694263277
chr17	EPN2	19279861	19279980	0	120	107116	7670	107116	7550	0.0	14.187549668874173
chr17	MAPK7	19380607	19381686	0	1080	655	4017	655	2937	0.0	0.223016683690841
chr17	MAPK7	19379592	19379605	0	14	655	4017	655	4003	0.0	0.16362727954034473
chr17	MAPK7	19380483	19380501	0	19	655	4017	655	3998	0.0	0.163831915957979
chr17	RNF112	19412937	19413144	0	208	102	3532	102	3324	0.0	0.030685920577617327
chr17	SLC47A1	19546434	19546503	0	70	112372	5036	112372	4966	0.0	22.6282722513089
chr17	SLC47A1	19555795	19555909	15640	115	112372	5036	96732	4921	136.0	19.656980288559236
chr17	SLC47A1	19572779	19572861	0	83	112372	5036	112372	4953	0.0	22.68766404199475
chr17	SLC47A1	19571477	19571572	0	96	112372	5036	112372	4940	0.0	22.74736842105263
chr17	SLC47A1	19578027	19578128	0	102	112372	5036	112372	4934	0.0	22.775030401297123
chr17	ALDH3A2	19651546	19651778	0	233	9762	10618	9762	10385	0.0	0.9400096292729899
chr17	ALDH3A2	19657744	19657862	0	119	9762	10618	9762	10499	0.0	0.9298028383655587
chr17	ALDH3A2	19664947	19665047	0	101	9762	10618	9762	10517	0.0	0.9282114671484264
chr17	ALDH3A2	19671720	19671956	0	237	9762	10618	9762	10381	0.0	0.9403718331567287
chr17	ALDH3A2	19673150	19673275	0	126	9762	10618	9762	10492	0.0	0.9304231795653831
chr17	ALDH3A2	19656365	19656574	0	210	9762	10618	9762	10408	0.0	0.9379323597232898
chr17	ALDH3A2	19655280	19655387	0	108	9762	10618	9762	10510	0.0	0.9288296860133206
chr17	ALDH3A2	19657720	19657862	0	143	9762	10618	9762	10475	0.0	0.9319331742243436
chr17	ALDH3A2	19673199	19673275	0	77	9762	10618	9762	10541	0.0	0.9260980931600418
chr17	ALDH3A2	19673206	19673275	0	70	9762	10618	9762	10548	0.0	0.9254835039817975
chr17	SPECC1	20204332	20205912	2161	1581	67459	19316	65298	17735	1.3668564199873499	3.681872004510854
chr17	SPECC1	20296960	20297077	0	118	67459	19316	67459	19198	0.0	3.513855609959371
chr17	SPECC1	20306022	20306082	337	61	67459	19316	67122	19255	5.524590163934426	3.48595170085692
chr17	SPECC1	20017986	20018102	255	117	67459	19316	67204	19199	2.1794871794871793	3.500390645346112
chr17	SPECC1	20124899	20124997	0	99	67459	19316	67459	19217	0.0	3.510381433106104
chr17	SPECC1	20067193	20067378	0	186	67459	19316	67459	19130	0.0	3.5263460533193935
chr17	SPECC1	20057676	20057817	81	142	67459	19316	67378	19174	0.5704225352112676	3.514029414832586
chr17	USP32P3	20419855	20420113	0	259	1841	7899	1841	7640	0.0	0.24096858638743454
chr17	NOS2P3	20443273	20443395	0	123	612	3650	612	3527	0.0	0.17351857102353274
chr17	USP32P3	20418182	20418391	0	210	1841	7899	1841	7689	0.0	0.2394329561711536
chr17	NOS2P3	20444950	20445143	0	194	612	3650	612	3456	0.0	0.17708333333333334
chr17	AC087499.2	20721210	20721467	0	258	0	1512	0	1254	0.0	0.0
chr17	CCDC144NL-AS1	20887591	20887849	337	259	3990549	10522	3990212	10263	1.3011583011583012	388.79586865438955
chr17	CCDC144NL-AS1	20981486	20981624	0	139	3990549	10522	3990549	10383	0.0	384.33487431378217
chr17	CCDC144NL-AS1	20924358	20924833	301095	476	3990549	10522	3689454	10046	632.5525210084033	367.2560222974318
chr17	CCDC144NL-AS1	20949102	20949441	0	340	3990549	10522	3990549	10182	0.0	391.9219210371243
chr17	CCDC144NL-AS1	20956193	20956353	0	161	3990549	10522	3990549	10361	0.0	385.15095068043627
chr17	CCDC144NL-AS1	20955965	20956353	0	389	3990549	10522	3990549	10133	0.0	393.8171321425047
chr17	LINC01563	21084770	21084884	255	115	31038	3155	30783	3040	2.217391304347826	10.125986842105263
chr17	LINC01563	21084760	21084884	255	125	31038	3155	30783	3030	2.04	10.159405940594059
chr17	LINC01563	21084751	21084884	255	134	31038	3155	30783	3021	1.9029850746268657	10.189672293942403
chr17	DHRS7B	21178232	21178342	18	111	5877	5554	5859	5443	0.16216216216216217	1.0764284401984199
chr17	DHRS7B	21188710	21188863	255	154	5877	5554	5622	5400	1.655844155844156	1.041111111111111
chr17	MAP2K3	21296085	21296210	0	126	918	3685	918	3559	0.0	0.2579376229277887
chr17	MAP2K3	21303182	21303234	0	53	918	3685	918	3632	0.0	0.2527533039647577
chr17	MAP2K3	21287990	21288091	0	102	918	3685	918	3583	0.0	0.25620987998883615
chr17	MAP2K3	21295674	21295769	0	96	918	3685	918	3589	0.0	0.2557815547506269
chr17	AC138761.1	22285004	22285128	0	125	0	2159	0	2034	0.0	0.0
chr17	WSB1	27301766	27301956	0	191	153	7403	153	7212	0.0	0.021214642262895173
chr17	WSB1	27303366	27303635	0	270	153	7403	153	7133	0.0	0.021449600448619096
chr17	WSB1	27301817	27301956	0	140	153	7403	153	7263	0.0	0.021065675340768277
chr17	WSB1	27301787	27301956	0	170	153	7403	153	7233	0.0	0.021153048527581916
chr17	WSB1	27304779	27304911	0	133	153	7403	153	7270	0.0	0.021045392022008252
chr17	WSB1	27301880	27301956	0	77	153	7403	153	7326	0.0	0.020884520884520884
chr17	AC026254.2	27334259	27334377	0	119	472633	990	472633	871	0.0	542.6326061997704
chr17	TBC1D3P5	27421627	27422248	20342	622	34006	4122	13664	3500	32.70418006430868	3.904
chr17	TBC1D3P5	27426459	27426559	0	101	34006	4122	34006	4021	0.0	8.45710022382492
chr17	TBC1D3P5	27424538	27424659	0	122	34006	4122	34006	4000	0.0	8.5015
chr17	KSR1	27577491	27577639	0	149	75022	11040	75022	10891	0.0	6.888439996327243
chr17	KSR1	27601359	27601401	387	43	75022	11040	74635	10997	9.0	6.786850959352551
chr17	KSR1	27621192	27621273	0	82	75022	11040	75022	10958	0.0	6.846322321591531
chr17	KSR1	27558045	27558187	0	143	75022	11040	75022	10897	0.0	6.884647150591906
chr17	KSR1	27601892	27601958	635	67	75022	11040	74387	10973	9.477611940298507	6.779094140162217
chr17	LGALS9	27638262	27638354	0	93	153	5110	153	5017	0.0	0.030496312537372932
chr17	LGALS9	27645313	27645349	0	37	153	5110	153	5073	0.0	0.03015966883500887
chr17	LGALS9	27647269	27647432	0	164	153	5110	153	4946	0.0	0.030934088152042055
chr17	LGALS9	27643524	27643620	0	97	153	5110	153	5013	0.0	0.03052064631956912
chr17	TMEM97	28325502	28325647	0	146	153	2932	153	2786	0.0	0.054917444364680545
chr17	TNFAIP1	28340308	28340478	0	171	380	3846	380	3675	0.0	0.10340136054421768
chr17	TNFAIP1	28339407	28339726	23	320	380	3846	357	3526	0.071875	0.10124787294384571
chr17	TMEM199	28360150	28360238	0	89	153	4566	153	4477	0.0	0.0341746705383069
chr17	SARM1	28386607	28386681	0	75	52574	9683	52574	9608	0.0	5.471898417985012
chr17	SLC13A2	28489213	28489342	46	130	4761	3238	4715	3108	0.35384615384615387	1.5170527670527671
chr17	SLC13A2	28487409	28487550	0	142	4761	3238	4761	3096	0.0	1.5377906976744187
chr17	SLC13A2	28490306	28490368	0	63	4761	3238	4761	3175	0.0	1.499527559055118
chr17	SPAG5-AS1	28606295	28606460	25	166	135276	2896	135251	2730	0.15060240963855423	49.54249084249084
chr17	SUPT6H	28672756	28672858	0	103	91	9640	91	9537	0.0	0.009541784628289819
chr17	RPL23A	28720413	28720430	0	18	357	2219	357	2201	0.0	0.16219900045433894
chr17	ERAL1	28857938	28857985	0	48	4638	2084	4638	2036	0.0	2.2779960707269153
chr17	ERAL1	28858575	28858824	102	250	4638	2084	4536	1834	0.408	2.4732824427480917
chr17	ERAL1	28858575	28858633	0	59	4638	2084	4638	2025	0.0	2.29037037037037
chr17	PIPOX	28953363	28953408	2	46	19446	3797	19444	3751	0.043478260869565216	5.183684350839776
chr17	PIPOX	29040682	29040790	10	109	19446	3797	19436	3688	0.09174311926605505	5.2700650759219085
chr17	PIPOX	29010959	29011146	0	188	19446	3797	19446	3609	0.0	5.388196176226101
chr17	CRYBA1	29252063	29252205	51	143	51	804	0	661	0.35664335664335667	0.0
chr17	EFCAB5	29968790	29969367	0	578	1228	6957	1228	6379	0.0	0.19250666248628312
chr17	EFCAB5	30090420	30090674	0	255	1228	6957	1228	6702	0.0	0.183228886899433
chr17	EFCAB5	30059544	30059701	0	158	1228	6957	1228	6799	0.0	0.18061479629357258
chr17	NSRP1	30118079	30118173	0	95	353030	4823	353030	4728	0.0	74.66793570219966
chr17	NSRP1	30168813	30168925	0	113	353030	4823	353030	4710	0.0	74.95329087048832
chr17	NSRP1	30163066	30163162	0	97	353030	4823	353030	4726	0.0	74.69953449005502
chr17	NSRP1	30156539	30156662	0	124	353030	4823	353030	4699	0.0	75.12875079804213
chr17	NSRP1	30117301	30117332	0	32	353030	4823	353030	4791	0.0	73.68607806303486
chr17	CPD	30449552	30449748	31	197	45425	9203	45394	9006	0.15736040609137056	5.040417499444815
chr17	GOSR1	30510879	30510909	24	31	43549	9580	43525	9549	0.7741935483870968	4.55806890773903
chr17	GOSR1	30495425	30495582	0	158	43549	9580	43549	9422	0.0	4.622054765442581
chr17	GOSR1	30482899	30483056	1326	158	43549	9580	42223	9422	8.39240506329114	4.481320314158353
chr17	TBC1D29P	30562868	30562917	0	50	586	2944	586	2894	0.0	0.20248790601243952
chr17	AC005562.1	30615895	30615980	0	86	46098	8636	46098	8550	0.0	5.391578947368421
chr17	AC005562.1	30631754	30631979	0	226	46098	8636	46098	8410	0.0	5.4813317479191435
chr17	AC005562.1	30631754	30631895	0	142	46098	8636	46098	8494	0.0	5.427125029432541
chr17	SUZ12P1	30759490	30759539	0	50	1678	3792	1678	3742	0.0	0.4484233030464992
chr17	SUZ12P1	30732485	30732608	0	124	1678	3792	1678	3668	0.0	0.4574700109051254
chr17	ADAP2	30949286	30949370	0	85	51	3738	51	3653	0.0	0.013961127840131399
chr17	ADAP2	30953287	30953350	0	64	51	3738	51	3674	0.0	0.013881328252585737
chr17	ADAP2	30926808	30926918	51	111	51	3738	0	3627	0.4594594594594595	0.0
chr17	ADAP2	30931888	30931968	0	81	51	3738	51	3657	0.0	0.01394585726004922
chr17	ADAP2	30926826	30926918	51	93	51	3738	0	3645	0.5483870967741935	0.0
chr17	ADAP2	30922939	30923070	0	132	51	3738	51	3606	0.0	0.014143094841930116
chr17	RNF135	30984616	30984760	0	145	0	2253	0	2108	0.0	0.0
chr17	RNF135	30987943	30988106	0	164	0	2253	0	2089	0.0	0.0
chr17	RNF135	30993839	30993904	0	66	0	2253	0	2187	0.0	0.0
chr17	NF1	31169890	31169997	0	108	102	20076	102	19968	0.0	0.005108173076923077
chr17	NF1	31352256	31352414	0	159	102	20076	102	19917	0.0	0.00512125320078325
chr17	NF1	31252937	31253000	0	64	102	20076	102	20012	0.0	0.00509694183489906
chr17	NF1	31299509	31299606	0	98	102	20076	102	19978	0.0	0.0051056161777955755
chr17	NF1	31367224	31367278	0	55	102	20076	102	20021	0.0	0.005094650616852305
chr17	NF1	31257686	31257726	0	41	102	20076	102	20035	0.0	0.005091090591464936
chr17	NF1	31334663	31334730	0	68	102	20076	102	20008	0.0	0.00509796081567373
chr17	NF1	31379105	31379357	0	253	102	20076	102	19823	0.0	0.005145538011400898
chr17	RAB11FIP4	31509076	31509481	0	406	0	12597	0	12191	0.0	0.0
chr17	SUZ12	31947616	31947685	0	70	0	6115	0	6045	0.0	0.0
chr17	LRRC37B	32020696	32020803	0	108	0	5911	0	5803	0.0	0.0
chr17	LRRC37B	32017971	32018054	0	84	0	5911	0	5827	0.0	0.0
chr17	LRRC37B	32045699	32045818	0	120	0	5911	0	5791	0.0	0.0
chr17	LRRC37B	32027768	32027840	0	73	0	5911	0	5838	0.0	0.0
chr17	RHOT1	32209349	32209445	0	97	102	5502	102	5405	0.0	0.01887141535615171
chr17	RHOT1	32211115	32211238	0	124	102	5502	102	5378	0.0	0.01896615842320565
chr17	RHOT1	32172936	32173060	0	125	102	5502	102	5377	0.0	0.018969685698344802
chr17	RHOT1	32221048	32221186	0	139	102	5502	102	5363	0.0	0.019019205668469142
chr17	RHOT1	32207511	32207563	0	53	102	5502	102	5449	0.0	0.018719031014865113
chr17	RHOT1	32222758	32222902	0	145	102	5502	102	5357	0.0	0.01904050774687325
chr17	RHOT1	32222828	32222902	0	75	102	5502	102	5427	0.0	0.018794914317302378
chr17	RHBDL3	32267901	32267925	0	25	0	5756	0	5731	0.0	0.0
chr17	RHBDL3	32284658	32284817	0	160	0	5756	0	5596	0.0	0.0
chr17	RHBDL3	32305340	32305441	0	102	0	5756	0	5654	0.0	0.0
chr17	RHBDL3	32288231	32288369	0	139	0	5756	0	5617	0.0	0.0
chr17	ZNF207	32366664	32366757	17004	94	46386	8928	29382	8834	180.89361702127658	3.3260131310844465
chr17	ZNF207	32361467	32361515	0	49	46386	8928	46386	8879	0.0	5.22423696362203
chr17	ZNF207	32351464	32351629	0	166	46386	8928	46386	8762	0.0	5.293996804382561
chr17	PSMD11	32454751	32454877	0	127	0	6502	0	6375	0.0	0.0
chr17	TMEM98	32939476	32939536	0	61	0	4903	0	4842	0.0	0.0
chr17	TMEM98	32931326	32931402	0	77	0	4903	0	4826	0.0	0.0
chr17	TMEM98	32930899	32930971	0	73	0	4903	0	4830	0.0	0.0
chr17	SPACA3	32995408	32995717	0	310	0	1260	0	950	0.0	0.0
chr17	CCL7	34271145	34271263	0	119	0	866	0	747	0.0	0.0
chr17	CCL7	34271092	34271263	0	172	0	866	0	694	0.0	0.0
chr17	AC011193.1	34479803	34479895	0	93	0	1763	0	1670	0.0	0.0
chr17	LIG3	34983001	34983552	0	552	317	10453	317	9901	0.0	0.03201696798303202
chr17	LIG3	34983231	34983552	0	322	317	10453	317	10131	0.0	0.03129009969400849
chr17	SLFN5	35264182	35264903	0	722	0	10679	0	9957	0.0	0.0
chr17	AC022706.1	35321734	35321865	0	132	102	1393	102	1261	0.0	0.08088818398096749
chr17	AC022706.1	35321736	35321865	0	130	102	1393	102	1263	0.0	0.08076009501187649
chr17	AC022706.1	35316355	35316409	0	55	102	1393	102	1338	0.0	0.07623318385650224
chr17	SNHG30	35573579	35573723	189	145	2367	1597	2178	1452	1.303448275862069	1.5
chr17	AP2B1	35670856	35670898	0	43	11180	7621	11180	7578	0.0	1.4753233043019267
chr17	AP2B1	35600985	35601071	0	87	11180	7621	11180	7534	0.0	1.483939474382798
chr17	AP2B1	35605704	35605840	0	137	11180	7621	11180	7484	0.0	1.4938535542490647
chr17	AP2B1	35600936	35601071	0	136	11180	7621	11180	7485	0.0	1.4936539746158985
chr17	AP2B1	35588624	35588733	0	110	11180	7621	11180	7511	0.0	1.4884835574490747
chr17	AP2B1	35650913	35651005	0	93	11180	7621	11180	7528	0.0	1.4851222104144528
chr17	TAF15	35820163	35820239	76	77	15459	5459	15383	5382	0.987012987012987	2.8582311408398366
chr17	TAF15	35833906	35833941	0	36	15459	5459	15459	5423	0.0	2.850636179236585
chr17	TAF15	35809971	35810063	51	93	15459	5459	15408	5366	0.5483870967741935	2.871412597838241
chr17	TAF15	35820163	35820248	153	86	15459	5459	15306	5373	1.7790697674418605	2.8486878838637635
chr17	TAF15	35817239	35817317	14	79	15459	5459	15445	5380	0.17721518987341772	2.870817843866171
chr17	AC243829.4	36073655	36073671	0	17	102	1508	102	1491	0.0	0.06841046277665996
chr17	CCL4	36104527	36104642	0	116	0	1251	0	1135	0.0	0.0
chr17	CCL4L2	36211775	36211890	0	116	0	988	0	872	0.0	0.0
chr17	ZNHIT3	36486934	36486966	0	33	255	3627	255	3594	0.0	0.0709515859766277
chr17	DHRS11	36599670	36599763	0	94	408	2104	408	2010	0.0	0.20298507462686566
chr17	AATF	37031613	37031685	22	73	52253	2875	52231	2802	0.3013698630136986	18.640613847251963
chr17	TADA2A	37423508	37423615	0	108	3218	5170	3218	5062	0.0	0.6357171078625049
chr17	TADA2A	37426949	37427009	19	61	3218	5170	3199	5109	0.3114754098360656	0.6261499314934429
chr17	TADA2A	37442563	37442652	0	90	3218	5170	3218	5080	0.0	0.6334645669291339
chr17	MRPL45	38320617	38320767	186	151	33235	1712	33049	1561	1.2317880794701987	21.171684817424726
chr17	SOCS7	38365307	38365409	0	103	1798	9016	1798	8913	0.0	0.20172781330640638
chr17	SOCS7	38364751	38364856	0	106	1798	9016	1798	8910	0.0	0.20179573512906845
chr17	ARHGAP23	38498413	38498510	0	98	115817	8109	115817	8011	0.0	14.457246286356261
chr17	ARHGAP23	38498931	38498954	0	24	115817	8109	115817	8085	0.0	14.324922696351267
chr17	ARHGAP23	38477578	38477705	0	128	115817	8109	115817	7981	0.0	14.511590026312492
chr17	ARHGAP23	38489757	38489917	36	161	115817	8109	115781	7948	0.2236024844720497	14.567312531454453
chr17	PSMB3	38760430	38760608	0	179	0	1122	0	943	0.0	0.0
chr17	PSMB3	38760507	38760608	0	102	0	1122	0	1020	0.0	0.0
chr17	LASP1	38890419	38890504	0	86	0	6747	0	6661	0.0	0.0
chr17	LASP1	38896901	38897071	0	171	0	6747	0	6576	0.0	0.0
chr17	LRRC37A11P	39043198	39043279	0	82	60	5878	60	5796	0.0	0.010351966873706004
chr17	RDM1P5	39061096	39061188	0	93	0	3938	0	3845	0.0	0.0
chr17	CDK12	39490556	39490733	0	178	0	10968	0	10790	0.0	0.0
chr17	CDK12	39556863	39557058	0	196	0	10968	0	10772	0.0	0.0
chr17	PPP1R1B	39629971	39630047	0	77	0	2807	0	2730	0.0	0.0
chr17	STARD3	39657007	39657085	0	79	0	4382	0	4303	0.0	0.0
chr17	STARD3	39657972	39658026	0	55	0	4382	0	4327	0.0	0.0
chr17	STARD3	39658721	39658820	0	100	0	4382	0	4282	0.0	0.0
chr17	STARD3	39658708	39658820	0	113	0	4382	0	4269	0.0	0.0
chr17	STARD3	39662250	39662344	0	95	0	4382	0	4287	0.0	0.0
chr17	STARD3	39651751	39651845	0	95	0	4382	0	4287	0.0	0.0
chr17	STARD3	39651754	39651845	0	92	0	4382	0	4290	0.0	0.0
chr17	STARD3	39662250	39662367	0	118	0	4382	0	4264	0.0	0.0
chr17	ERBB2	39699536	39699587	0	52	0	8554	0	8502	0.0	0.0
chr17	ERBB2	39719786	39719834	0	49	0	8554	0	8505	0.0	0.0
chr17	ERBB2	39727294	39727547	0	254	0	8554	0	8300	0.0	0.0
chr17	ERBB2	39706989	39707141	0	153	0	8554	0	8401	0.0	0.0
chr17	ERBB2	39713152	39713269	0	118	0	8554	0	8436	0.0	0.0
chr17	GRB7	39742897	39743054	0	158	204	3325	204	3167	0.0	0.06441427218187559
chr17	GRB7	39745912	39746000	0	89	204	3325	204	3236	0.0	0.0630407911001236
chr17	ZPBP2	39868548	39868614	0	67	51	2265	51	2198	0.0	0.023202911737943584
chr17	ZPBP2	39872269	39872488	0	220	51	2265	51	2045	0.0	0.02493887530562347
chr17	PSMD3	39996700	39996793	0	94	37032	4755	37032	4661	0.0	7.945076163913323
chr17	CSF3	40015690	40015845	51	156	204	2223	153	2067	0.3269230769230769	0.07402031930333818
chr17	CSF3	40016232	40016340	0	109	204	2223	204	2114	0.0	0.09649952696310313
chr17	CSF3	40015690	40015854	51	165	204	2223	153	2058	0.3090909090909091	0.07434402332361516
chr17	MSL1	40131536	40131584	23	49	453484	6837	453461	6788	0.46938775510204084	66.80332940483206
chr17	MSL1	40131219	40131345	0	127	453484	6837	453484	6710	0.0	67.5833084947839
chr17	RAPGEFL1	40181298	40181486	0	189	56248	5363	56248	5174	0.0	10.87127947429455
chr17	RAPGEFL1	40181298	40181373	0	76	56248	5363	56248	5287	0.0	10.638925666729714
chr17	WIPF2	40256390	40256522	65	133	887700	8133	887635	8000	0.48872180451127817	110.954375
chr17	WIPF2	40260534	40260667	0	134	887700	8133	887700	7999	0.0	110.97637204650582
chr17	WIPF2	40220414	40220538	0	125	887700	8133	887700	8008	0.0	110.85164835164835
chr17	RARA	40326474	40326551	0	78	144729	4723	144729	4645	0.0	31.158019375672765
chr17	TMEM99	40828056	40828296	408	241	43040	3058	42632	2817	1.6929460580912863	15.133830315938942
chr17	TMEM99	40828103	40828296	408	194	43040	3058	42632	2864	2.1030927835051547	14.885474860335195
chr17	EIF1	41689777	41689941	0	165	714	3114	714	2949	0.0	0.24211597151576805
chr17	FKBP10	41817057	41817203	0	147	102	4057	102	3910	0.0	0.02608695652173913
chr17	FKBP10	41819840	41820023	51	184	102	4057	51	3873	0.27717391304347827	0.013168086754453912
chr17	CNP	41968067	41968740	0	674	10574	6383	10574	5709	0.0	1.8521632510071817
chr17	CNP	41968072	41968740	0	669	10574	6383	10574	5714	0.0	1.8505425271263563
chr17	NKIRAS2	42022398	42022640	0	243	41	4020	41	3777	0.0	0.010855176065660577
chr17	NKIRAS2	42021563	42021671	0	109	41	4020	41	3911	0.0	0.01048325236512401
chr17	NKIRAS2	42022569	42022640	0	72	41	4020	41	3948	0.0	0.01038500506585613
chr17	NKIRAS2	42022564	42022640	0	77	41	4020	41	3943	0.0	0.010398173979203652
chr17	NKIRAS2	42021544	42021671	0	128	41	4020	41	3892	0.0	0.0105344295991778
chr17	NKIRAS2	42022375	42022640	0	266	41	4020	41	3754	0.0	0.010921683537559936
chr17	NKIRAS2	42022398	42022472	0	75	41	4020	41	3945	0.0	0.010392902408111533
chr17	NKIRAS2	42023027	42023141	0	115	41	4020	41	3905	0.0	0.010499359795134442
chr17	STAT5A	42289401	42289539	0	139	292155	5445	292155	5306	0.0	55.061251413494155
chr17	STAT5A	42291971	42292061	766	91	292155	5445	291389	5354	8.417582417582418	54.424542398206945
chr17	STAT5A	42305609	42305702	0	94	292155	5445	292155	5351	0.0	54.598205942814424
chr17	STAT5A	42289429	42289539	0	111	292155	5445	292155	5334	0.0	54.77221597300338
chr17	STAT5A	42289369	42289539	4982	171	292155	5445	287173	5274	29.13450292397661	54.45070155479712
chr17	ATP6V0A1	42468009	42468107	0	99	42688	7310	42688	7211	0.0	5.919844681736237
chr17	ATP6V0A1	42470089	42470218	0	130	42688	7310	42688	7180	0.0	5.945403899721448
chr17	ATP6V0A1	42514288	42514460	579	173	42688	7310	42109	7137	3.346820809248555	5.900098080425949
chr17	ATP6V0A1	42466428	42466507	0	80	42688	7310	42688	7230	0.0	5.904287690179807
chr17	ATP6V0A1	42508571	42508589	0	19	42688	7310	42688	7291	0.0	5.854889589905363
chr17	ATP6V0A1	42478926	42479049	663	124	42688	7310	42025	7186	5.346774193548387	5.848177010854439
chr17	ATP6V0A1	42510058	42510183	0	126	42688	7310	42688	7184	0.0	5.942093541202673
chr17	ATP6V0A1	42502793	42502868	0	76	42688	7310	42688	7234	0.0	5.901022947193807
chr17	NAGLU	42537397	42537545	497	149	12902	2885	12405	2736	3.335570469798658	4.5339912280701755
chr17	NAGLU	42540949	42541206	161	258	12902	2885	12741	2627	0.624031007751938	4.850019033117625
chr17	HSD17B1	42553793	42553887	0	95	0	1635	0	1540	0.0	0.0
chr17	COASY	42562295	42562487	0	193	1069	3038	1069	2845	0.0	0.3757469244288225
chr17	COASY	42562355	42562487	0	133	1069	3038	1069	2905	0.0	0.36798623063683306
chr17	MLX	42568469	42568559	396	91	3738	3476	3342	3385	4.351648351648351	0.9872968980797636
chr17	MLX	42569203	42569303	234	101	3738	3476	3504	3375	2.3168316831683167	1.0382222222222222
chr17	TUBG1	42610107	42610220	0	114	1865	2419	1865	2305	0.0	0.8091106290672451
chr17	TUBG1	42612426	42612506	0	81	1865	2419	1865	2338	0.0	0.7976903336184773
chr17	TUBG2	42662972	42663052	0	81	0	2803	0	2722	0.0	0.0
chr17	RAMP2	42762354	42762463	0	110	18124	1121	18124	1011	0.0	17.926805143422353
chr17	RAMP2	42762339	42762463	0	125	18124	1121	18124	996	0.0	18.196787148594378
chr17	WNK4	42785096	42785185	0	90	7255	5306	7255	5216	0.0	1.3909125766871167
chr17	WNK4	42787777	42787899	105	123	7255	5306	7150	5183	0.8536585365853658	1.3795099363303107
chr17	CNTD1	42803619	42803695	0	77	63263	3323	63263	3246	0.0	19.489525569932223
chr17	PSME3	42838092	42838205	0	114	67484	4720	67484	4606	0.0	14.651324359531046
chr17	PSME3	42838730	42838799	0	70	67484	4720	67484	4650	0.0	14.51268817204301
chr17	PSME3	42833775	42833939	0	165	67484	4720	67484	4555	0.0	14.81536772777168
chr17	PSME3	42834093	42834256	91	164	67484	4720	67393	4556	0.5548780487804879	14.79214223002634
chr17	PSME3	42838691	42838799	0	109	67484	4720	67484	4611	0.0	14.635436998481891
chr17	AOC3	42855443	42855573	192	131	13803	4529	13611	4398	1.465648854961832	3.0948158253751705
chr17	G6PC	42909302	42909418	0	117	1856	4370	1856	4253	0.0	0.4363978368210675
chr17	RUNDC1	42989340	42989539	0	200	9884	4762	9884	4562	0.0	2.166593599298553
chr17	RPL27	42999932	43000102	0	171	23538	2030	23538	1859	0.0	12.661646046261431
chr17	RPL27	42999185	42999292	0	108	23538	2030	23538	1922	0.0	12.246618106139438
chr17	NBR2	43131207	43131270	0	64	32866	3057	32866	2993	0.0	10.980955562980288
chr17	NBR1	43177935	43177998	119	64	117813	7964	117694	7900	1.859375	14.897974683544303
chr17	TMEM106A	43212314	43212394	0	81	25325	3586	25325	3505	0.0	7.225392296718973
chr17	TMEM106A	43216448	43216589	1342	142	25325	3586	23983	3444	9.450704225352112	6.963704994192799
chr17	TMEM106A	43212204	43212394	0	191	25325	3586	25325	3395	0.0	7.459499263622975
chr17	TMEM106A	43212226	43212394	0	169	25325	3586	25325	3417	0.0	7.41147205150717
chr17	DHX8	43489448	43489534	0	87	36465	10358	36465	10271	0.0	3.5502872164346218
chr17	DHX8	43523627	43524185	1530	559	36465	10358	34935	9799	2.737030411449016	3.5651597101745076
chr17	CD300LG	43852911	43853013	0	103	0	4765	0	4662	0.0	0.0
chr17	G6PC3	44074968	44075087	0	120	220	4172	220	4052	0.0	0.054294175715695954
chr17	G6PC3	44071627	44071811	0	185	220	4172	220	3987	0.0	0.05517933283170304
chr17	G6PC3	44071627	44071821	0	195	220	4172	220	3977	0.0	0.05531807895398542
chr17	HROB	44150960	44151044	0	85	1263	3015	1263	2930	0.0	0.4310580204778157
chr17	HROB	44157832	44157941	57	110	1263	3015	1206	2905	0.5181818181818182	0.4151462994836489
chr17	TMUB2	44187906	44188009	0	104	204	3574	204	3470	0.0	0.058789625360230545
chr17	TMUB2	44189410	44189588	0	179	204	3574	204	3395	0.0	0.06008836524300442
chr17	TMUB2	44187675	44187743	0	69	204	3574	204	3505	0.0	0.05820256776034237
chr17	TMUB2	44187616	44187743	0	128	204	3574	204	3446	0.0	0.0591990713871155
chr17	TMUB2	44189423	44189588	0	166	204	3574	204	3408	0.0	0.05985915492957746
chr17	GRN	44345609	44345741	0	133	821	3085	821	2952	0.0	0.27811653116531165
chr17	GRN	44345565	44345605	0	41	821	3085	821	3044	0.0	0.2697109067017083
chr17	GRN	44346088	44346228	107	141	821	3085	714	2944	0.7588652482269503	0.2425271739130435
chr17	GRN	44345530	44345605	0	76	821	3085	821	3009	0.0	0.27284812229976735
chr17	MEIOC	44665383	44665488	0	106	2669	8627	2669	8521	0.0	0.3132261471658256
chr17	DBF4B	44709303	44709366	0	64	12038	5975	12038	5911	0.0	2.0365420402639147
chr17	DBF4B	44732177	44732265	0	89	12038	5975	12038	5886	0.0	2.0451919809717976
chr17	HIGD1B	44849253	44849388	0	136	1672	861	1672	725	0.0	2.306206896551724
chr17	HIGD1B	44849105	44849388	0	284	1672	861	1672	577	0.0	2.897746967071057
chr17	NMT1	45093684	45093803	508	120	6475	7711	5967	7591	4.233333333333333	0.7860624423659597
chr17	NMT1	45097127	45097244	0	118	6475	7711	6475	7593	0.0	0.8527591202423285
chr17	NMT1	45081643	45081752	0	110	6475	7711	6475	7601	0.0	0.8518615971582687
chr17	NMT1	45104120	45104224	0	105	6475	7711	6475	7606	0.0	0.8513016039968446
chr17	NMT1	45078082	45078149	0	68	6475	7711	6475	7643	0.0	0.8471804265340834
chr17	NMT1	45083657	45083755	0	99	6475	7711	6475	7612	0.0	0.8506305832895428
chr17	ACBD4	45136499	45136620	436	122	14226	3521	13790	3399	3.5737704918032787	4.057075610473669
chr17	ACBD4	45139020	45139160	0	141	14226	3521	14226	3380	0.0	4.20887573964497
chr17	HEXIM2	45162487	45162635	0	149	1422	1994	1422	1845	0.0	0.7707317073170732
chr17	FMNL1	45245631	45245733	57	103	66880	6173	66823	6070	0.5533980582524272	11.008731466227347
chr17	FMNL1	45246504	45246604	0	101	66880	6173	66880	6072	0.0	11.014492753623188
chr17	FMNL1	45245618	45245733	96	116	66880	6173	66784	6057	0.8275862068965517	11.025920422651478
chr17	MAP3K14-AS1	45255137	45255218	0	82	11521	4874	11521	4792	0.0	2.4042153589315527
chr17	MAP3K14-AS1	45255134	45255218	0	85	11521	4874	11521	4789	0.0	2.4057214449780746
chr17	MAP3K14-AS1	45249533	45249632	525	100	11521	4874	10996	4774	5.25	2.303309593632174
chr17	MAP3K14-AS1	45266249	45266518	680	270	11521	4874	10841	4604	2.5185185185185186	2.3546915725456126
chr17	MAP3K14-AS1	45266249	45266699	10741	451	11521	4874	780	4423	23.815964523281597	0.17635089305900972
chr17	CRHR1	45816462	45816582	0	121	1017	3298	1017	3177	0.0	0.32011331444759206
chr17	CRHR1	45821354	45821440	0	87	1017	3298	1017	3211	0.0	0.3167237620678916
chr17	CRHR1	45830416	45830570	0	155	1017	3298	1017	3143	0.0	0.323576201081769
chr17	CRHR1	45833451	45833537	0	87	1017	3298	1017	3211	0.0	0.3167237620678916
chr17	CRHR1	45833713	45833849	0	137	1017	3298	1017	3161	0.0	0.32173362859854476
chr17	CRHR1	45834006	45834048	0	43	1017	3298	1017	3255	0.0	0.31244239631336407
chr17	LINC02210	45635300	45635398	51	99	27368	14607	27317	14508	0.5151515151515151	1.8828921974083264
chr17	LINC02210	45627375	45627682	102	308	27368	14607	27266	14299	0.33116883116883117	1.9068466326316527
chr17	LINC02210	45640388	45640455	38	68	27368	14607	27330	14539	0.5588235294117647	1.879771648669097
chr17	CRHR1	45829560	45829647	0	88	1017	3298	1017	3210	0.0	0.3168224299065421
chr17	CRHR1	45825485	45825595	0	111	1017	3298	1017	3187	0.0	0.31910887982428615
chr17	MAPT	45971858	45971945	245	88	437080	9263	436835	9175	2.784090909090909	47.611444141689375
chr17	MAPT	46014242	46014324	0	83	437080	9263	437080	9180	0.0	47.61220043572985
chr17	MAPT	45982865	45983930	1615	1066	437080	9263	435465	8197	1.5150093808630394	53.12492375259241
chr17	MAPT	45989877	45990075	268	199	437080	9263	436812	9064	1.3467336683417086	48.191968225948806
chr17	MAPT	46010309	46010402	0	94	437080	9263	437080	9169	0.0	47.66932053659069
chr17	MAPT	45974384	45974471	1044	88	437080	9263	436036	9175	11.863636363636363	47.52435967302452
chr17	MAPT	45969164	45969299	212	136	437080	9263	436868	9127	1.5588235294117647	47.86545414703627
chr17	MAPT	45983177	45983930	1215	754	437080	9263	435865	8509	1.6114058355437666	51.22399811963803
chr17	MAPT	45993923	45993977	1724	55	437080	9263	435356	9208	31.345454545454544	47.28019113814075
chr17	NSF	46630410	46630450	2584	41	69556	5030	66972	4989	63.02439024390244	13.423932651834035
chr17	NSF	46755498	46755597	0	100	69556	5030	69556	4930	0.0	14.108722109533469
chr17	GOSR2	46931098	46931207	0	110	187163	11566	187163	11456	0.0	16.337552374301676
chr17	GOSR2	46935028	46935169	0	142	187163	11566	187163	11424	0.0	16.38331582633053
chr17	GOSR2	46963696	46965039	87	1344	187163	11566	187076	10222	0.06473214285714286	18.301310898063
chr17	GOSR2	46931101	46931207	0	107	187163	11566	187163	11459	0.0	16.33327515490008
chr17	GOSR2	46963834	46965039	51	1206	187163	11566	187112	10360	0.04228855721393035	18.06100386100386
chr17	GOSR2	46935028	46935225	0	198	187163	11566	187163	11368	0.0	16.4640218156228
chr17	GOSR2	46931104	46931207	0	104	187163	11566	187163	11462	0.0	16.329000174489618
chr17	GOSR2	46964343	46965039	0	697	187163	11566	187163	10869	0.0	17.219891434354587
chr17	GOSR2	46963696	46963779	36	84	187163	11566	187127	11482	0.42857142857142855	16.297422051907333
chr17	GOSR2	46955500	46955712	0	213	187163	11566	187163	11353	0.0	16.48577468510526
chr17	GOSR2	46923816	46923865	559	50	187163	11566	186604	11516	11.18	16.20389023966655
chr17	GOSR2	46932066	46932199	510	134	187163	11566	186653	11432	3.8059701492537314	16.32723932820154
chr17	GOSR2	46924260	46924468	1503	209	187163	11566	185660	11357	7.1913875598086126	16.34762701417628
chr17	GOSR2	46923508	46923632	51	125	187163	11566	187112	11441	0.408	16.354514465518747
chr17	GOSR2	46964001	46965039	0	1039	187163	11566	187163	10527	0.0	17.779329343592668
chr17	GOSR2	46937892	46938010	0	119	187163	11566	187163	11447	0.0	16.35039748405696
chr17	MYL4	47213798	47213826	0	29	0	1645	0	1616	0.0	0.0
chr17	MYL4	47213798	47213919	0	122	0	1645	0	1523	0.0	0.0
chr17	EFCAB13	47335195	47335356	0	162	8913	6489	8913	6327	0.0	1.4087245139876718
chr17	EFCAB13	47328792	47329038	51	247	8913	6489	8862	6242	0.20647773279352227	1.419737263697533
chr17	EFCAB13	47347807	47347951	0	145	8913	6489	8913	6344	0.0	1.4049495586380831
chr17	EFCAB13	47361377	47361521	0	145	8913	6489	8913	6344	0.0	1.4049495586380831
chr17	NPEPPS	47531416	47531555	0	140	4931	9467	4931	9327	0.0	0.5286801758336014
chr17	NPEPPS	47545908	47545993	0	86	4931	9467	4931	9381	0.0	0.5256369257008847
chr17	NPEPPS	47577044	47577160	0	117	4931	9467	4931	9350	0.0	0.527379679144385
chr17	NPEPPS	47531389	47531555	0	167	4931	9467	4931	9300	0.0	0.5302150537634409
chr17	NPEPPS	47577080	47577160	0	81	4931	9467	4931	9386	0.0	0.5253569145535905
chr17	NPEPPS	47559611	47559687	0	77	4931	9467	4931	9390	0.0	0.5251331203407881
chr17	NPEPPS	47619277	47619372	0	96	4931	9467	4931	9371	0.0	0.5261978444136165
chr17	NPEPPS	47619277	47619495	0	219	4931	9467	4931	9248	0.0	0.5331963667820069
chr17	NPEPPS	47586147	47586244	48	98	4931	9467	4883	9369	0.4897959183673469	0.521186892944818
chr17	NPEPPS	47619277	47619322	0	46	4931	9467	4931	9421	0.0	0.5234051586880374
chr17	KPNB1	47671709	47671862	561	154	112129	8415	111568	8261	3.642857142857143	13.505386757051204
chr17	LRRC46	47833968	47834047	0	80	255	2544	255	2464	0.0	0.10349025974025974
chr17	LRRC46	47834817	47834940	0	124	255	2544	255	2420	0.0	0.10537190082644628
chr17	SP2	47897814	47897927	102	114	3139	3654	3037	3540	0.8947368421052632	0.857909604519774
chr17	SP2	47914725	47914861	196	137	3139	3654	2943	3517	1.4306569343065694	0.836792721069093
chr17	PNPO	47945558	47945612	0	55	0	4987	0	4932	0.0	0.0
chr17	PNPO	47945860	47945989	0	130	0	4987	0	4857	0.0	0.0
chr17	PNPO	47943342	47943430	0	89	0	4987	0	4898	0.0	0.0
chr17	PNPO	47943305	47943430	0	126	0	4987	0	4861	0.0	0.0
chr17	PNPO	47945597	47945612	0	16	0	4987	0	4971	0.0	0.0
chr17	NFE2L1	48057031	48057121	0	91	1339	5475	1339	5384	0.0	0.2486998514115899
chr17	NFE2L1	48054929	48055150	0	222	1339	5475	1339	5253	0.0	0.2549019607843137
chr17	SNX11	48113300	48113401	0	102	0	4144	0	4042	0.0	0.0
chr17	SNX11	48112750	48112873	0	124	0	4144	0	4020	0.0	0.0
chr17	SNX11	48110707	48110767	0	61	0	4144	0	4083	0.0	0.0
chr17	THRA1/BTR	48295545	48295605	0	61	0	1575	0	1514	0.0	0.0
chr17	HOXB-AS3	48601427	48601663	0	237	1534	1897	1534	1660	0.0	0.9240963855421687
chr17	HOXB-AS3	48600446	48600545	0	100	1534	1897	1534	1797	0.0	0.8536449638286032
chr17	LINC02086	48687496	48687710	0	215	24	3504	24	3289	0.0	0.007297050775311645
chr17	LINC02086	48700611	48700696	0	86	24	3504	24	3418	0.0	0.007021650087770626
chr17	CALCOCO2	48841697	48841887	0	191	17632	7200	17632	7009	0.0	2.515622770723356
chr17	CALCOCO2	48846033	48846096	0	64	17632	7200	17632	7136	0.0	2.4708520179372195
chr17	CALCOCO2	48849251	48849377	0	127	17632	7200	17632	7073	0.0	2.492860172486922
chr17	CALCOCO2	48860313	48860449	39	137	17632	7200	17593	7063	0.2846715328467153	2.4908679031572984
chr17	CALCOCO2	48846442	48846514	0	73	17632	7200	17632	7127	0.0	2.473972218324681
chr17	CALCOCO2	48843902	48844026	0	125	17632	7200	17632	7075	0.0	2.492155477031802
chr17	CALCOCO2	48839375	48839511	0	137	17632	7200	17632	7063	0.0	2.4963896361319553
chr17	CALCOCO2	48841773	48841887	0	115	17632	7200	17632	7085	0.0	2.4886379675370502
chr17	CALCOCO2	48848800	48848827	0	28	17632	7200	17632	7172	0.0	2.4584495259341885
chr17	CALCOCO2	48856578	48856616	0	39	17632	7200	17632	7161	0.0	2.462225946096914
chr17	ATP5MC1	48894371	48894449	0	79	0	1499	0	1420	0.0	0.0
chr17	UBE2Z	48912833	48913021	0	189	0	3711	0	3522	0.0	0.0
chr17	UBE2Z	48912833	48912965	0	133	0	3711	0	3578	0.0	0.0
chr17	FLJ40194	49252853	49252918	0	66	61955	4893	61955	4827	0.0	12.835094261446033
chr17	FLJ40194	49253040	49253133	0	94	61955	4893	61955	4799	0.0	12.909981246092936
chr17	FLJ40194	49288905	49289046	0	142	61955	4893	61955	4751	0.0	13.040412544727426
chr17	KAT7	49798318	49798558	0	241	161	11487	161	11246	0.0	0.014316201316023475
chr17	KAT7	49809118	49809208	8	91	161	11487	153	11396	0.08791208791208792	0.013425763425763427
chr17	KAT7	49817819	49818011	0	193	161	11487	161	11294	0.0	0.01425535682663361
chr17	KAT7	49796749	49796926	0	178	161	11487	161	11309	0.0	0.014236448846051818
chr17	ITGA3	50068055	50068305	0	251	0	8655	0	8404	0.0	0.0
chr17	ITGA3	50088224	50088366	0	143	0	8655	0	8512	0.0	0.0
chr17	ITGA3	50081096	50081193	0	98	0	8655	0	8557	0.0	0.0
chr17	PDK2	50096131	50096286	0	156	0	4742	0	4586	0.0	0.0
chr17	SGCA	50167581	50167736	0	156	0	2358	0	2202	0.0	0.0
chr17	SGCA	50169091	50169254	0	164	0	2358	0	2194	0.0	0.0
chr17	SGCA	50170142	50170351	0	210	0	2358	0	2148	0.0	0.0
chr17	SGCA	50167367	50167487	0	121	0	2358	0	2237	0.0	0.0
chr17	AC015909.1	50211945	50212121	0	177	0	2615	0	2438	0.0	0.0
chr17	AC015909.1	50214100	50214174	0	75	0	2615	0	2540	0.0	0.0
chr17	AC015909.1	50210620	50210802	0	183	0	2615	0	2432	0.0	0.0
chr17	AC015909.1	50210467	50210802	0	336	0	2615	0	2279	0.0	0.0
chr17	AC015909.1	50214100	50214530	0	431	0	2615	0	2184	0.0	0.0
chr17	XYLT2	50357056	50357252	0	197	0	5479	0	5282	0.0	0.0
chr17	XYLT2	50357117	50357252	0	136	0	5479	0	5343	0.0	0.0
chr17	EME1	50378594	50378681	0	88	0	3178	0	3090	0.0	0.0
chr17	EME1	50375796	50375983	0	188	0	3178	0	2990	0.0	0.0
chr17	EME1	50378599	50378681	0	83	0	3178	0	3095	0.0	0.0
chr17	ACSF2	50463817	50463909	0	93	0	5152	0	5059	0.0	0.0
chr17	ACSF2	50472427	50472579	0	153	0	5152	0	4999	0.0	0.0
chr17	ACSF2	50460201	50460363	0	163	0	5152	0	4989	0.0	0.0
chr17	ACSF2	50461241	50461287	0	47	0	5152	0	5105	0.0	0.0
chr17	ACSF2	50460676	50460872	0	197	0	5152	0	4955	0.0	0.0
chr17	ACSF2	50461241	50461370	0	130	0	5152	0	5022	0.0	0.0
chr17	ACSF2	50426904	50426979	0	76	0	5152	0	5076	0.0	0.0
chr17	ACSF2	50464525	50464599	0	75	0	5152	0	5077	0.0	0.0
chr17	RSAD1	50479879	50480084	0	206	306	4146	306	3940	0.0	0.07766497461928934
chr17	RSAD1	50482642	50482706	0	65	306	4146	306	4081	0.0	0.07498162215143347
chr17	RSAD1	50483705	50483760	0	56	306	4146	306	4090	0.0	0.07481662591687041
chr17	RSAD1	50479628	50479762	0	135	306	4146	306	4011	0.0	0.0762902019446522
chr17	MYCBPAP	50514844	50514949	0	106	51	6482	51	6376	0.0	0.007998745294855709
chr17	EPN3	50536028	50536199	0	172	102	4499	102	4327	0.0	0.023572914259302056
chr17	EPN3	50538883	50538964	0	82	102	4499	102	4417	0.0	0.02309259678514829
chr17	EPN3	50540246	50540334	0	89	102	4499	102	4410	0.0	0.02312925170068027
chr17	EPN3	50536048	50536199	0	152	102	4499	102	4347	0.0	0.023464458247066944
chr17	EPN3	50536028	50536278	0	251	102	4499	102	4248	0.0	0.02401129943502825
chr17	EPN3	50540203	50540334	0	132	102	4499	102	4367	0.0	0.023356995649187084
chr17	SPATA20	50547664	50547767	328	104	1700	4742	1372	4638	3.1538461538461537	0.2958171625700733
chr17	SPATA20	50548553	50548618	168	66	1700	4742	1532	4676	2.5454545454545454	0.32763045337895635
chr17	SPATA20	50549285	50549487	0	203	1700	4742	1700	4539	0.0	0.37453183520599254
chr17	SPATA20	50550997	50551190	0	194	1700	4742	1700	4548	0.0	0.3737906772207564
chr17	SPATA20	50547719	50547954	408	236	1700	4742	1292	4506	1.728813559322034	0.2867288060363959
chr17	SPATA20	50548042	50548161	0	120	1700	4742	1700	4622	0.0	0.36780614452617916
chr17	SPATA20	50547719	50547767	328	49	1700	4742	1372	4693	6.6938775510204085	0.2923503089708076
chr17	SPATA20	50547664	50547954	408	291	1700	4742	1292	4451	1.402061855670103	0.29027184902269154
chr17	SPATA20	50550997	50551222	0	226	1700	4742	1700	4516	0.0	0.37643932683790965
chr17	CACNA1G	50594992	50595061	0	70	356	10101	356	10031	0.0	0.03548998105871797
chr17	CACNA1G	50609881	50609935	0	55	356	10101	356	10046	0.0	0.03543698984670516
chr17	CACNA1G	50619682	50619826	0	145	356	10101	356	9956	0.0	0.035757332261952594
chr17	CACNA1G	50621659	50621794	0	136	356	10101	356	9965	0.0	0.03572503763171099
chr17	ABCC3	50643548	50643661	0	114	459	8868	459	8754	0.0	0.05243317340644277
chr17	ABCC3	50660922	50661114	0	193	459	8868	459	8675	0.0	0.05291066282420749
chr17	ABCC3	50668852	50668919	0	68	459	8868	459	8800	0.0	0.05215909090909091
chr17	LUC7L3	50738136	50738199	0	64	1581	7501	1581	7437	0.0	0.21258572004840662
chr17	LUC7L3	50736959	50737026	0	68	1581	7501	1581	7433	0.0	0.21270012108166286
chr17	LUC7L3	50737286	50737479	0	194	1581	7501	1581	7307	0.0	0.21636786642945122
chr17	LUC7L3	50750500	50750641	0	142	1581	7501	1581	7359	0.0	0.2148389726865063
chr17	LUC7L3	50723818	50723965	0	148	1581	7501	1581	7353	0.0	0.2150142798857609
chr17	LUC7L3	50722663	50722745	0	83	1581	7501	1581	7418	0.0	0.2131302237799946
chr17	LUC7L3	50738140	50738199	0	60	1581	7501	1581	7441	0.0	0.21247144201048246
chr17	LUC7L3	50749218	50749344	51	127	1581	7501	1530	7374	0.4015748031496063	0.20748576078112285
chr17	LUC7L3	50749223	50749344	51	122	1581	7501	1530	7379	0.4180327868852459	0.20734516872204906
chr17	LUC7L3	50751296	50751362	0	67	1581	7501	1581	7434	0.0	0.21267150928167877
chr17	TOB1-AS1	50893767	50893858	0	92	0	3034	0	2942	0.0	0.0
chr17	NME1	51154224	51154444	0	221	0	3281	0	3060	0.0	0.0
chr17	NME2	51169936	51170049	0	114	0	2502	0	2388	0.0	0.0
chr17	UTP18	51277129	51277304	0	176	7	2719	7	2543	0.0	0.0027526543452615023
chr17	UTP18	51293902	51294045	0	144	7	2719	7	2575	0.0	0.0027184466019417475
chr17	UTP18	51286482	51286552	0	71	7	2719	7	2648	0.0	0.0026435045317220545
chr17	UTP18	51288547	51288591	0	45	7	2719	7	2674	0.0	0.002617801047120419
chr17	TOM1L1	54903707	54903792	36	86	13392	7265	13356	7179	0.4186046511627907	1.8604262432093606
chr17	TOM1L1	54905488	54905567	0	80	13392	7265	13392	7185	0.0	1.8638830897703549
chr17	TOM1L1	54912665	54912815	282	151	13392	7265	13110	7114	1.8675496688741722	1.8428450941804893
chr17	TOM1L1	54914638	54914743	255	106	13392	7265	13137	7159	2.4056603773584904	1.8350328258136612
chr17	TOM1L1	54903679	54903792	120	114	13392	7265	13272	7151	1.0526315789473684	1.8559642008110753
chr17	TOM1L1	54903712	54903792	21	81	13392	7265	13371	7184	0.25925925925925924	1.8612193763919822
chr17	TOM1L1	54942288	54942491	2550	204	13392	7265	10842	7061	12.5	1.5354765613935704
chr17	TOM1L1	54912686	54912815	219	130	13392	7265	13173	7135	1.6846153846153846	1.8462508759635599
chr17	TOM1L1	54906778	54906786	358	9	13392	7265	13034	7256	39.77777777777778	1.7963065049614113
chr17	STXBP4	54985613	54985691	1008	79	190561	18075	189553	17996	12.759493670886076	10.533062902867304
chr17	STXBP4	54990824	54990957	29312	134	190561	18075	161249	17941	218.7462686567164	8.987737584304108
chr17	STXBP4	55007505	55007597	0	93	190561	18075	190561	17982	0.0	10.597319541763985
chr17	STXBP4	55047088	55047154	0	67	190561	18075	190561	18008	0.0	10.582019102621057
chr17	PCTP	55787565	55787654	0	90	924	5817	924	5727	0.0	0.1613410162388685
chr17	SCPEP1	56981116	56981230	0	115	1603	2897	1603	2782	0.0	0.5762041696621136
chr17	SCPEP1	56985377	56985467	0	91	1603	2897	1603	2806	0.0	0.5712758374910906
chr17	SCPEP1	56998384	56998498	0	115	1603	2897	1603	2782	0.0	0.5762041696621136
chr17	SCPEP1	56981081	56981230	0	150	1603	2897	1603	2747	0.0	0.5835456862031307
chr17	SCPEP1	56998373	56998498	0	126	1603	2897	1603	2771	0.0	0.5784915193071093
chr17	AKAP1	57116110	57116261	0	152	34241	5359	34241	5207	0.0	6.575955444593816
chr17	AKAP1	57086372	57086537	517	166	34241	5359	33724	5193	3.1144578313253013	6.494126709031389
chr17	AKAP1	57096590	57096763	0	174	34241	5359	34241	5185	0.0	6.603857280617165
chr17	AKAP1	57107945	57108048	0	104	34241	5359	34241	5255	0.0	6.515889628924834
chr17	AKAP1	57101593	57101730	0	138	34241	5359	34241	5221	0.0	6.55832216050565
chr17	AKAP1	57120249	57120293	0	45	34241	5359	34241	5314	0.0	6.44354535190064
chr17	MSI2	57676986	57677059	51	74	109986	16085	109935	16011	0.6891891891891891	6.866216975829118
chr17	MSI2	57259976	57260054	0	79	109986	16085	109986	16006	0.0	6.871548169436461
chr17	MSI2	57370948	57370991	0	44	109986	16085	109986	16041	0.0	6.856555077613615
chr17	MSI2	57650649	57650673	68	25	109986	16085	109918	16060	2.72	6.844209215442092
chr17	MSI2	57263487	57263569	147	83	109986	16085	109839	16002	1.7710843373493976	6.864079490063742
chr17	MSI2	57310130	57310326	0	197	109986	16085	109986	15888	0.0	6.9225830815709966
chr17	MSI2	57556989	57557131	0	143	109986	16085	109986	15942	0.0	6.899134362062476
chr17	MSI2	57655694	57655744	0	51	109986	16085	109986	16034	0.0	6.859548459523513
chr17	LPO	58243993	58244081	0	89	8227	6060	8227	5971	0.0	1.3778261597722326
chr17	LPO	58247477	58247638	0	162	8227	6060	8227	5898	0.0	1.3948796202102407
chr17	LPO	58254552	58254611	0	60	8227	6060	8227	6000	0.0	1.3711666666666666
chr17	TSPOAP1-AS1	58325918	58326036	31	119	781	3888	750	3769	0.2605042016806723	0.19899177500663306
chr17	TSPOAP1-AS1	58346279	58346343	0	65	781	3888	781	3823	0.0	0.20428982474496468
chr17	TSPOAP1-AS1	58339242	58339447	255	206	781	3888	526	3682	1.2378640776699028	0.14285714285714285
chr17	RAD51C	58696692	58696859	0	168	7456	5705	7456	5537	0.0	1.3465775690807296
chr17	RAD51C	58694930	58695189	765	260	7456	5705	6691	5445	2.9423076923076925	1.228833792470156
chr17	RAD51C	58720745	58720812	0	68	7456	5705	7456	5637	0.0	1.3226893737803795
chr17	RAD51C	58724039	58724100	0	62	7456	5705	7456	5643	0.0	1.3212830054935318
chr17	RAD51C	58705877	58706022	0	146	7456	5705	7456	5559	0.0	1.341248425975895
chr17	RAD51C	58706488	58706608	0	121	7456	5705	7456	5584	0.0	1.335243553008596
chr17	RAD51C	58732483	58732544	0	62	7456	5705	7456	5643	0.0	1.3212830054935318
chr17	PRR11	59160758	59160876	0	119	3968	4818	3968	4699	0.0	0.8444349861672696
chr17	PRR11	59163598	59163664	0	67	3968	4818	3968	4751	0.0	0.8351925910334667
chr17	GDPD1	59267040	59267174	0	135	9	2336	9	2201	0.0	0.00408905043162199
chr17	GDPD1	59257121	59257240	0	120	9	2336	9	2216	0.0	0.004061371841155234
chr17	YPEL2	59353214	59353526	0	313	153	8707	153	8394	0.0	0.018227305218012867
chr17	DHX40	59566626	59566794	0	169	248	5857	248	5688	0.0	0.04360056258790436
chr17	DHX40	59570517	59570663	0	147	248	5857	248	5710	0.0	0.043432574430823115
chr17	DHX40	59586152	59586233	0	82	248	5857	248	5775	0.0	0.042943722943722944
chr17	DHX40	59566626	59566709	0	84	248	5857	248	5773	0.0	0.04295860038108436
chr17	CLTC	59647397	59647666	0	270	2427	11871	2427	11601	0.0	0.20920610292216188
chr17	CLTC	59658661	59658804	0	144	2427	11871	2427	11727	0.0	0.20695830135584548
chr17	CLTC	59687000	59687021	0	22	2427	11871	2427	11849	0.0	0.20482741159591528
chr17	VMP1	59731420	59731522	0	103	118	5500	118	5397	0.0	0.021863998517695014
chr17	VMP1	59738836	59738947	0	112	118	5500	118	5388	0.0	0.02190051967334818
chr17	VMP1	59735337	59735473	0	137	118	5500	118	5363	0.0	0.022002610479209397
chr17	VMP1	59737452	59737543	0	92	118	5500	118	5408	0.0	0.021819526627218935
chr17	VMP1	59834011	59834050	0	40	118	5500	118	5460	0.0	0.02161172161172161
chr17	RPS6KB1	59893795	59893924	0	130	26686	5329	26686	5199	0.0	5.13291017503366
chr17	RPS6KB1	59914634	59914703	510	70	26686	5329	26176	5259	7.285714285714286	4.9773721239779425
chr17	RPS6KB1	59930799	59931052	0	254	26686	5329	26686	5075	0.0	5.2583251231527095
chr17	RPS6KB1	59930357	59930432	0	76	26686	5329	26686	5253	0.0	5.080144679230916
chr17	CA4	60151441	60151529	0	89	0	2428	0	2339	0.0	0.0
chr17	PPM1D	60656931	60657042	204	112	4525	5052	4321	4940	1.8214285714285714	0.8746963562753036
chr17	BCAS3	60688931	60689046	0	116	10553	8054	10553	7938	0.0	1.3294280675233057
chr17	BCAS3	61388617	61388708	0	92	10553	8054	10553	7962	0.0	1.3254207485556393
chr17	BCAS3	60688019	60688195	0	177	10553	8054	10553	7877	0.0	1.3397232448901866
chr17	BCAS3	61026865	61026910	0	46	10553	8054	10553	8008	0.0	1.3178071928071928
chr17	BCAS3	61380505	61380571	0	67	10553	8054	10553	7987	0.0	1.3212720671090523
chr17	BCAS3	61356848	61356986	0	139	10553	8054	10553	7915	0.0	1.333291219204043
chr17	METTL2A	62424218	62424310	0	93	0	6390	0	6297	0.0	0.0
chr17	TLK2	62508407	62508553	471	147	48680	8314	48209	8167	3.204081632653061	5.902901922370516
chr17	TLK2	62524235	62524331	306	97	48680	8314	48374	8217	3.154639175257732	5.887063405135694
chr17	TLK2	62552301	62552397	306	97	48680	8314	48374	8217	3.154639175257732	5.887063405135694
chr17	TLK2	62553662	62553755	7640	94	48680	8314	41040	8220	81.27659574468085	4.992700729927007
chr17	TLK2	62477495	62477697	2969	203	48680	8314	45711	8111	14.625615763546797	5.635679940821107
chr17	TLK2	62507380	62507449	90	70	48680	8314	48590	8244	1.2857142857142858	5.893983503153809
chr17	TLK2	62574344	62574410	0	67	48680	8314	48680	8247	0.0	5.902752516066449
chr17	MRC2	62689521	62689760	714	240	6658	6443	5944	6203	2.975	0.9582460099951636
chr17	AC005821.1	62707431	62707607	0	177	33490	3916	33490	3739	0.0	8.956940358384594
chr17	AC005821.1	62726255	62726600	0	346	33490	3916	33490	3570	0.0	9.380952380952381
chr17	TANC2	63418306	63418407	0	102	7841	19851	7841	19749	0.0	0.39703276115246344
chr17	TANC2	63412679	63412709	0	31	7841	19851	7841	19820	0.0	0.3956104944500505
chr17	TANC2	63151269	63151380	0	112	7841	19851	7841	19739	0.0	0.397233902426668
chr17	ACE	63479006	63479100	0	95	4513	8236	4513	8141	0.0	0.554354501903943
chr17	ACE	63483028	63483173	0	146	4513	8236	4513	8090	0.0	0.5578491965389369
chr17	ACE	63488940	63489132	0	193	4513	8236	4513	8043	0.0	0.5611090389158274
chr17	ACE	63496393	63496516	0	124	4513	8236	4513	8112	0.0	0.556336291913215
chr17	ACE	63486358	63486371	0	14	4513	8236	4513	8222	0.0	0.54889321333009
chr17	AC113554.1	63507240	63507369	0	130	4008	4893	4008	4763	0.0	0.8414864581146336
chr17	AC113554.1	63508638	63508827	0	190	4008	4893	4008	4703	0.0	0.8522219859664044
chr17	ACE	63486291	63486371	0	81	4513	8236	4513	8155	0.0	0.5534028203556101
chr17	KCNH6	63544011	63544119	0	109	12821	4226	12821	4117	0.0	3.114160796696624
chr17	DCAF7	63578469	63578628	0	160	0	2259	0	2099	0.0	0.0
chr17	DCAF7	63590990	63591084	0	95	0	2259	0	2164	0.0	0.0
chr17	MAP3K3	63634708	63634801	0	94	157	5824	157	5730	0.0	0.027399650959860383
chr17	DDX42	63775107	63775178	0	72	233	6612	233	6540	0.0	0.03562691131498471
chr17	DDX42	63799588	63799625	0	38	233	6612	233	6574	0.0	0.03544265287496197
chr17	DDX42	63787033	63787270	0	238	233	6612	233	6374	0.0	0.03655475368685284
chr17	DDX42	63799479	63799523	0	45	233	6612	233	6567	0.0	0.035480432465357085
chr17	PSMC5	63829493	63829563	0	71	51	2629	51	2558	0.0	0.0199374511336982
chr17	PSMC5	63830132	63830189	0	58	51	2629	51	2571	0.0	0.019836639439906652
chr17	PSMC5	63830808	63830935	0	128	51	2629	51	2501	0.0	0.02039184326269492
chr17	PSMC5	63827828	63827923	0	96	51	2629	51	2533	0.0	0.020134228187919462
chr17	PSMC5	63827850	63827923	0	74	51	2629	51	2555	0.0	0.019960861056751468
chr17	PSMC5	63827673	63827923	0	251	51	2629	51	2378	0.0	0.02144659377628259
chr17	TCAM1P	63860687	63860954	0	268	51	3554	51	3286	0.0	0.0155203895313451
chr17	PRR29	63998706	63998782	0	77	459	3570	459	3493	0.0	0.13140566847981677
chr17	PRR29	64001083	64001310	0	228	459	3570	459	3342	0.0	0.13734290843806105
chr17	PRR29	63998727	63998782	0	56	459	3570	459	3514	0.0	0.13062037564029597
chr17	MILR1	64452596	64452866	1020	271	1207	1826	187	1555	3.763837638376384	0.1202572347266881
chr17	MILR1	64457399	64457684	0	286	1207	1826	1207	1540	0.0	0.7837662337662338
chr17	CEP95	64516722	64516828	0	107	4076	6734	4076	6627	0.0	0.6150596046476535
chr17	CEP95	64530925	64531018	41	94	4076	6734	4035	6640	0.43617021276595747	0.6076807228915663
chr17	CEP95	64530925	64531022	45	98	4076	6734	4031	6636	0.45918367346938777	0.6074442435201929
chr17	CEP95	64520485	64520576	0	92	4076	6734	4076	6642	0.0	0.613670581150256
chr17	PRKCA	66554518	66554579	0	62	1638	11196	1638	11134	0.0	0.1471169391054428
chr17	PITPNC1	67553609	67553617	0	9	0	7830	0	7821	0.0	0.0
chr17	PITPNC1	67687065	67687184	0	120	0	7830	0	7710	0.0	0.0
chr17	NOL11	67719110	67719167	0	58	131	4480	131	4422	0.0	0.029624604251469924
chr17	NOL11	67722579	67722637	0	59	131	4480	131	4421	0.0	0.029631305134584937
chr17	BPTF	67975771	67975958	0	188	51	14493	51	14305	0.0	0.003565186997553303
chr17	BPTF	67875555	67875744	0	190	51	14493	51	14303	0.0	0.0035656855205201707
chr17	BPTF	67886127	67886316	0	190	51	14493	51	14303	0.0	0.0035656855205201707
chr17	BPTF	67963332	67963506	0	175	51	14493	51	14318	0.0	0.003561949993015784
chr17	BPTF	67928958	67929120	0	163	51	14493	51	14330	0.0	0.003558967201674808
chr17	AMZ2	68250793	68250967	0	175	0	3654	0	3479	0.0	0.0
chr17	AMZ2	68249010	68249096	0	87	0	3654	0	3567	0.0	0.0
chr17	ARSG	68306942	68307711	0	770	44	6604	44	5834	0.0	0.0075419952005485085
chr17	PRKAR1A	68514986	68515119	0	134	51	6098	51	5964	0.0	0.008551307847082495
chr17	PRKAR1A	68512909	68512978	0	70	51	6098	51	6028	0.0	0.008460517584605176
chr17	PRKAR1A	68528630	68528719	0	90	51	6098	51	6008	0.0	0.008488681757656458
chr17	MAP2K6	69504458	69504579	0	122	153	15176	153	15054	0.0	0.010163411717815863
chr17	LINC01497	69964381	69964552	0	172	0	1827	0	1655	0.0	0.0
chr17	LINC01028	70062210	70062328	0	119	611	1166	611	1047	0.0	0.5835721107927412
chr17	KCNJ16	70108300	70108381	28	82	622	6349	594	6267	0.34146341463414637	0.09478219243657253
chr17	KCNJ16	70131352	70131480	0	129	622	6349	622	6220	0.0	0.1
chr17	LINC01152	72036238	72036311	0	74	0	4169	0	4095	0.0	0.0
chr17	LINC02003	72347920	72348061	0	142	0	2500	0	2358	0.0	0.0
chr17	COG1	73207701	73207739	97	39	12922	4290	12825	4251	2.4871794871794872	3.016937191249118
chr17	C17ORF80	73235475	73236995	74041	1521	168752	4671	94711	3150	48.67915844838922	30.066984126984128
chr17	C17ORF80	73242243	73242351	30	109	168752	4671	168722	4562	0.27522935779816515	36.984217448487506
chr17	AC125421.1	73748124	73748308	410	185	854	2465	444	2280	2.2162162162162162	0.19473684210526315
chr17	LINC02092	73790562	73790710	0	149	23798	3086	23798	2937	0.0	8.102826012938372
chr17	LINC02092	73791712	73791802	96	91	23798	3086	23702	2995	1.054945054945055	7.913856427378965
chr17	LINC02092	73799229	73799668	1677	440	23798	3086	22121	2646	3.8113636363636365	8.360166288737718
chr17	TTYH2	74251868	74252014	0	147	58119	5335	58119	5188	0.0	11.202582883577486
chr17	DNAI2	74286976	74287098	172	123	3120	2878	2948	2755	1.3983739837398375	1.07005444646098
chr17	KIF19	74344222	74344348	0	127	31575	5660	31575	5533	0.0	5.706669076450389
chr17	CD300A	74481725	74481833	509	109	19985	2709	19476	2600	4.669724770642202	7.490769230769231
chr17	CD300A	74473535	74473874	8744	340	19985	2709	11241	2369	25.71764705882353	4.745040101308569
chr17	RAB37	74745007	74745084	391	78	26395	4785	26004	4707	5.012820512820513	5.524537922243467
chr17	RAB37	74740767	74740878	345	112	26395	4785	26050	4673	3.080357142857143	5.574577359298096
chr17	SLC9A3R1	74766935	74766976	0	42	9324	2345	9324	2303	0.0	4.048632218844984
chr17	MRPL58	75018585	75018694	0	110	0	1094	0	984	0.0	0.0
chr17	SLC16A5	75089150	75089304	3817	155	11412	2997	7595	2842	24.625806451612902	2.6724137931034484
chr17	SLC16A5	75089113	75089304	3896	192	11412	2997	7516	2805	20.291666666666668	2.6795008912655973
chr17	NUP85	75208503	75208620	504	118	35616	4297	35112	4179	4.271186440677966	8.402010050251256
chr17	NUP85	75208526	75208620	280	95	35616	4297	35336	4202	2.9473684210526314	8.409328891004284
chr17	NUP85	75218184	75218306	0	123	35616	4297	35616	4174	0.0	8.53282223287015
chr17	NUP85	75225102	75225237	0	136	35616	4297	35616	4161	0.0	8.559480894015861
chr17	NUP85	75225697	75225829	0	133	35616	4297	35616	4164	0.0	8.553314121037465
chr17	NUP85	75231339	75231423	0	85	35616	4297	35616	4212	0.0	8.455840455840455
chr17	NUP85	75208536	75208620	240	85	35616	4297	35376	4212	2.823529411764706	8.398860398860398
chr17	NUP85	75225341	75225464	0	124	35616	4297	35616	4173	0.0	8.534867002156721
chr17	NUP85	75225123	75225237	0	115	35616	4297	35616	4182	0.0	8.516499282639884
chr17	NUP85	75228997	75229131	0	135	35616	4297	35616	4162	0.0	8.55742431523306
chr17	NUP85	75235421	75235480	0	60	35616	4297	35616	4237	0.0	8.405947604437102
chr17	TMEM94	75496729	75496807	0	79	345606	7638	345606	7559	0.0	45.72112713321868
chr17	TMEM94	75457293	75457477	0	185	345606	7638	345606	7453	0.0	46.371394069502216
chr17	TMEM94	75487277	75487380	314	104	345606	7638	345292	7534	3.019230769230769	45.831165383594374
chr17	TMEM94	75492238	75492337	1360	100	345606	7638	344246	7538	13.6	45.668081719288935
chr17	TSEN54	75516745	75516910	0	166	0	2942	0	2776	0.0	0.0
chr17	LLGL2	75574452	75574495	0	44	51	6610	51	6566	0.0	0.007767286018885166
chr17	LLGL2	75533641	75533705	0	65	51	6610	51	6545	0.0	0.007792207792207792
chr17	LLGL2	75538530	75538636	0	107	51	6610	51	6503	0.0	0.007842534214977702
chr17	MYO15B	75592463	75592541	0	79	29	12656	29	12577	0.0	0.002305796294823885
chr17	MYO15B	75610899	75610959	0	61	29	12656	29	12595	0.0	0.0023025009924573245
chr17	MYO15B	75613980	75614033	0	54	29	12656	29	12602	0.0	0.0023012220282494843
chr17	MYO15B	75592427	75592541	0	115	29	12656	29	12541	0.0	0.0023124152778885255
chr17	MYO15B	75600605	75600680	0	76	29	12656	29	12580	0.0	0.002305246422893482
chr17	MYO15B	75620466	75620636	0	171	29	12656	29	12485	0.0	0.0023227873448137767
chr17	MYO15B	75590906	75591016	0	111	29	12656	29	12545	0.0	0.002311677959346353
chr17	MYO15B	75600630	75600680	0	51	29	12656	29	12605	0.0	0.0023006743355811184
chr17	MYO15B	75624369	75624447	0	79	29	12656	29	12577	0.0	0.002305796294823885
chr17	MYO15B	75606932	75607003	0	72	29	12656	29	12584	0.0	0.0023045136681500316
chr17	SAP30BP	75668048	75668169	0	122	51	7603	51	7481	0.0	0.006817270418393263
chr17	SAP30BP	75668515	75668625	0	111	51	7603	51	7492	0.0	0.006807261078483716
chr17	SAP30BP	75671815	75671863	0	49	51	7603	51	7554	0.0	0.006751389992057188
chr17	SAP30BP	75703310	75703371	0	62	51	7603	51	7541	0.0	0.0067630287760244
chr17	SAP30BP	75705610	75705693	0	84	51	7603	51	7519	0.0	0.006782816863944673
chr17	SAP30BP	75703807	75703859	0	53	51	7603	51	7550	0.0	0.006754966887417219
chr17	SAP30BP	75690670	75690772	0	103	51	7603	51	7500	0.0	0.0068
chr17	ITGB4	75737537	75737644	0	108	0	6607	0	6499	0.0	0.0
chr17	ITGB4	75755700	75755850	0	151	0	6607	0	6456	0.0	0.0
chr17	ITGB4	75753764	75753974	0	211	0	6607	0	6396	0.0	0.0
chr17	ITGB4	75755054	75755213	0	160	0	6607	0	6447	0.0	0.0
chr17	UNK	75791759	75792019	0	261	34	5560	34	5299	0.0	0.006416304963200604
chr17	UNK	75808947	75809039	0	93	34	5560	34	5467	0.0	0.00621913297969636
chr17	TEN1	75984580	75984718	0	139	2283	1289	2283	1150	0.0	1.9852173913043478
chr17	TEN1	75984891	75985012	0	122	2283	1289	2283	1167	0.0	1.9562982005141387
chr17	PRCD	76542552	76542633	0	82	51	5045	51	4963	0.0	0.010276042716099134
chr17	PRCD	76544231	76544370	0	140	51	5045	51	4905	0.0	0.010397553516819572
chr17	PRCD	76545895	76546131	0	237	51	5045	51	4808	0.0	0.010607321131447587
chr17	SNHG16	76558944	76559043	0	100	0	5256	0	5156	0.0	0.0
chr17	SNHG16	76557969	76558279	0	311	0	5256	0	4945	0.0	0.0
chr17	SNHG16	76557969	76558600	0	632	0	5256	0	4624	0.0	0.0
chr17	SNHG16	76558373	76558600	0	228	0	5256	0	5028	0.0	0.0
chr17	SNHG16	76558373	76559043	0	671	0	5256	0	4585	0.0	0.0
chr17	METTL23	76729689	76729794	0	106	450	1838	450	1732	0.0	0.25981524249422633
chr17	METTL23	76726969	76727213	56	245	450	1838	394	1593	0.22857142857142856	0.24733207784055242
chr17	METTL23	76726969	76727178	0	210	450	1838	450	1628	0.0	0.2764127764127764
chr17	METTL23	76732977	76733215	0	239	450	1838	450	1599	0.0	0.28142589118198874
chr17	MFSD11	76743397	76743456	0	60	7254	5442	7254	5382	0.0	1.3478260869565217
chr17	MFSD11	76742176	76742273	0	98	7254	5442	7254	5344	0.0	1.3574101796407185
chr17	MFSD11	76745392	76745439	0	48	7254	5442	7254	5394	0.0	1.3448275862068966
chr17	LINC00868	76856169	76856264	51	96	1278257	1387	1278206	1291	0.53125	990.0898528272656
chr17	LINC00868	76858266	76858355	777	90	1278257	1387	1277480	1297	8.633333333333333	984.9498843484965
chr17	MGAT5B	76933291	76933297	0	7	3051	6459	3051	6452	0.0	0.47287662740235586
chr17	MGAT5B	76932644	76932775	0	132	3051	6459	3051	6327	0.0	0.4822190611664296
chr17	SNHG20	77093243	77093347	0	105	10	4357	10	4252	0.0	0.0023518344308560675
chr17	SEPTIN9	77294773	77294903	0	131	0	13488	0	13357	0.0	0.0
chr17	SEPTIN9	77307140	77307197	0	58	0	13488	0	13430	0.0	0.0
chr17	SEPTIN9	77322788	77322948	0	161	0	13488	0	13327	0.0	0.0
chr17	SEPTIN9	77451366	77451528	0	163	0	13488	0	13325	0.0	0.0
chr17	SEPTIN9	77496213	77496389	0	177	0	13488	0	13311	0.0	0.0
chr17	AC021683.3	77533177	77533266	0	90	0	5420	0	5330	0.0	0.0
chr17	AC021683.3	77530460	77530939	0	480	0	5420	0	4940	0.0	0.0
chr17	AC021683.3	77533180	77533266	0	87	0	5420	0	5333	0.0	0.0
chr17	AC021683.3	77530601	77530939	0	339	0	5420	0	5081	0.0	0.0
chr17	TNRC6C	78097744	78097861	0	118	25733	11136	25733	11018	0.0	2.335541840624433
chr17	TNRC6C	78012002	78012060	0	59	25733	11136	25733	11077	0.0	2.323101922903313
chr17	SYNGR2	78170816	78171054	0	239	51	2669	51	2430	0.0	0.020987654320987655
chr17	SYNGR2	78171509	78171649	0	141	51	2669	51	2528	0.0	0.020174050632911392
chr17	AFMID	78202498	78202603	0	106	19354	4061	19354	3955	0.0	4.893552465233881
chr17	AFMID	78204655	78204741	181	87	19354	4061	19173	3974	2.0804597701149423	4.824609964771011
chr17	AFMID	78205602	78205738	252	137	19354	4061	19102	3924	1.8394160583941606	4.867991845056065
chr17	AFMID	78192636	78192785	0	150	19354	4061	19354	3911	0.0	4.948606494502685
chr17	AFMID	78205439	78205518	117	80	19354	4061	19237	3981	1.4625	4.832202964079377
chr17	AFMID	78205602	78205753	342	152	19354	4061	19012	3909	2.25	4.863647991813763
chr17	AFMID	78204827	78204900	0	74	19354	4061	19354	3987	0.0	4.854276398294457
chr17	BIRC5	78215965	78216034	0	70	19594	3820	19594	3750	0.0	5.225066666666667
chr17	BIRC5	78216663	78216781	0	119	19594	3820	19594	3701	0.0	5.294244798703053
chr17	BIRC5	78222827	78222992	2154	166	19594	3820	17440	3654	12.975903614457831	4.772851669403393
chr17	BIRC5	78215965	78216066	0	102	19594	3820	19594	3718	0.0	5.27003765465304
chr17	TMEM235	78234592	78234730	492	139	1131	2609	639	2470	3.539568345323741	0.25870445344129556
chr17	TMEM235	78233894	78233975	0	82	1131	2609	1131	2527	0.0	0.4475662841313811
chr17	TMEM235	78234233	78234344	0	112	1131	2609	1131	2497	0.0	0.45294353223868644
chr17	PGS1	78382663	78382785	0	123	7166	4741	7166	4618	0.0	1.5517540060632309
chr17	PGS1	78396307	78396385	0	79	7166	4741	7166	4662	0.0	1.5371085371085371
chr17	PGS1	78414878	78415027	0	150	7166	4741	7166	4591	0.0	1.5608799825746025
chr17	PGS1	78392475	78392665	2748	191	7166	4741	4418	4550	14.387434554973822	0.970989010989011
chr17	PGS1	78414951	78415027	0	77	7166	4741	7166	4664	0.0	1.5364493996569468
chr17	PGS1	78392513	78392665	1563	153	7166	4741	5603	4588	10.215686274509803	1.221229293809939
chr17	C1QTNF1	79024235	79024494	413	260	2050	4765	1637	4505	1.5884615384615384	0.36337402885682574
chr17	C1QTNF1	79043954	79044123	51	170	2050	4765	1999	4595	0.3	0.435038084874864
chr17	C1QTNF1	79034316	79034533	0	218	2050	4765	2050	4547	0.0	0.4508467121178799
chr17	ENGASE	79079488	79079637	0	150	38216	6011	38216	5861	0.0	6.520389012113974
chr17	CCDC40	80037951	80038028	4572	78	131490	8392	126918	8314	58.61538461538461	15.265576136636998
chr17	CCDC40	80038122	80038186	51	65	131490	8392	131439	8327	0.7846153846153846	15.784676354029061
chr17	GAA	80101810	80101925	0	116	39243	5083	39243	4967	0.0	7.90074491644856
chr17	GAA	80101810	80101890	0	81	39243	5083	39243	5002	0.0	7.84546181527389
chr17	CARD14	80179103	80179301	0	199	379763	9239	379763	9040	0.0	42.009181415929206
chr17	CARD14	80198098	80198162	116	65	379763	9239	379647	9174	1.7846153846153847	41.382930019620666
chr17	CARD14	80201743	80201870	36718	128	379763	9239	343045	9111	286.859375	37.65173965536165
chr17	CARD14	80172905	80173228	612	324	379763	9239	379151	8915	1.8888888888888888	42.52955692652832
chr17	CARD14	80201468	80201592	40716	125	379763	9239	339047	9114	325.728	37.20068027210884
chr17	CARD14	80198098	80198173	171	76	379763	9239	379592	9163	2.25	41.42660700643894
chr17	CARD14	80187501	80187659	275	159	379763	9239	379488	9080	1.729559748427673	41.79383259911894
chr17	SLC26A11	80222654	80222847	319	194	10325	4397	10006	4203	1.6443298969072164	2.380680466333571
chr17	SLC26A11	80220915	80221115	0	201	10325	4397	10325	4196	0.0	2.4606768350810295
chr17	SLC26A11	80249153	80249287	540	135	10325	4397	9785	4262	4.0	2.2958704833411545
chr17	SLC26A11	80220918	80221115	0	198	10325	4397	10325	4199	0.0	2.45891879018814
chr17	SLC26A11	80237307	80237439	0	133	10325	4397	10325	4264	0.0	2.421435272045028
chr17	RNF213	80278763	80278910	80	148	84754	28383	84674	28235	0.5405405405405406	2.998902071896582
chr17	ENDOV	80425031	80425100	99	70	105383	6269	105284	6199	1.4142857142857144	16.984029682206806
chr17	ENDOV	80425491	80425620	0	130	105383	6269	105383	6139	0.0	17.166150838898844
chr17	ENDOV	80415649	80415821	3254	173	105383	6269	102129	6096	18.809248554913296	16.753444881889763
chr17	ENDOV	80422205	80422245	15854	41	105383	6269	89529	6228	386.6829268292683	14.3752408477842
chr17	ENDOV	80421827	80421962	0	136	105383	6269	105383	6133	0.0	17.182944725256807
chr17	ENDOV	80422139	80422245	34369	107	105383	6269	71014	6162	321.2056074766355	11.524505030834145
chr17	ENDOV	80419585	80419720	433	136	105383	6269	104950	6133	3.1838235294117645	17.112343062122942
chr17	ENDOV	80417780	80417945	16278	166	105383	6269	89105	6103	98.06024096385542	14.600196624610847
chr17	ENDOV	80417810	80417945	16278	136	105383	6269	89105	6133	119.69117647058823	14.52877873797489
chr17	ENDOV	80425458	80425620	0	163	105383	6269	105383	6106	0.0	17.258925646904682
chr17	ENDOV	80427667	80427850	407	184	105383	6269	104976	6085	2.2119565217391304	17.251602300739524
chr17	RPTOR	80643727	80643810	0	84	142019	10341	142019	10257	0.0	13.846056351759774
chr17	BAIAP2	81036862	81036961	0	100	0	8058	0	7958	0.0	0.0
chr17	BAIAP2	81110913	81110955	0	43	0	8058	0	8015	0.0	0.0
chr17	BAIAP2	81110913	81110959	0	47	0	8058	0	8011	0.0	0.0
chr17	BAHCC1	81446737	81446830	0	94	0	13175	0	13081	0.0	0.0
chr17	TSPAN10	81647456	81647724	0	269	0	4751	0	4482	0.0	0.0
chr17	CCDC137	81670001	81670028	0	28	0	2396	0	2368	0.0	0.0
chr17	HGS	81690181	81690234	0	54	0	8542	0	8488	0.0	0.0
chr17	HGS	81693502	81693581	0	80	0	8542	0	8462	0.0	0.0
chr17	HGS	81693869	81693965	0	97	0	8542	0	8445	0.0	0.0
chr17	HGS	81694814	81694853	0	40	0	8542	0	8502	0.0	0.0
chr17	HGS	81700694	81700814	0	121	0	8542	0	8421	0.0	0.0
chr17	HGS	81685604	81685689	0	86	0	8542	0	8456	0.0	0.0
chr17	HGS	81694923	81695067	0	145	0	8542	0	8397	0.0	0.0
chr17	HGS	81695163	81695223	0	61	0	8542	0	8481	0.0	0.0
chr17	HGS	81695785	81695999	0	215	0	8542	0	8327	0.0	0.0
chr17	HGS	81684970	81685069	0	100	0	8542	0	8442	0.0	0.0
chr17	HGS	81694959	81695067	0	109	0	8542	0	8433	0.0	0.0
chr17	HGS	81693484	81693581	0	98	0	8542	0	8444	0.0	0.0
chr17	HGS	81684812	81684891	0	80	0	8542	0	8462	0.0	0.0
chr17	HGS	81686667	81686717	0	51	0	8542	0	8491	0.0	0.0
chr17	HGS	81684812	81685069	0	258	0	8542	0	8284	0.0	0.0
chr17	HGS	81695785	81696041	0	257	0	8542	0	8285	0.0	0.0
chr17	HGS	81685604	81685693	0	90	0	8542	0	8452	0.0	0.0
chr17	HGS	81692422	81692553	0	132	0	8542	0	8410	0.0	0.0
chr17	HGS	81692384	81692553	0	170	0	8542	0	8372	0.0	0.0
chr17	HGS	81694255	81694326	0	72	0	8542	0	8470	0.0	0.0
chr17	HGS	81695938	81695999	0	62	0	8542	0	8480	0.0	0.0
chr17	HGS	81695766	81695999	0	234	0	8542	0	8308	0.0	0.0
chr17	HGS	81697865	81698116	0	252	0	8542	0	8290	0.0	0.0
chr17	HGS	81699741	81699837	0	97	0	8542	0	8445	0.0	0.0
chr17	HGS	81701243	81701422	0	180	0	8542	0	8362	0.0	0.0
chr17	HGS	81701214	81701422	0	209	0	8542	0	8333	0.0	0.0
chr17	SLC25A10	81713261	81713506	0	246	0	2543	0	2297	0.0	0.0
chr17	ANAPC11	81893551	81893614	0	64	0	2490	0	2426	0.0	0.0
chr17	ANAPC11	81899241	81899542	0	302	0	2490	0	2188	0.0	0.0
chr17	ANAPC11	81893103	81893187	0	85	0	2490	0	2405	0.0	0.0
chr17	ANAPC11	81899241	81899327	0	87	0	2490	0	2403	0.0	0.0
chr17	ASPSCR1	81979183	81979239	0	57	0	8568	0	8511	0.0	0.0
chr17	ASPSCR1	82015074	82015356	0	283	0	8568	0	8285	0.0	0.0
chr17	ASPSCR1	81982613	81982676	0	64	0	8568	0	8504	0.0	0.0
chr17	ASPSCR1	82009931	82010052	0	122	0	8568	0	8446	0.0	0.0
chr17	LRRC45	82024277	82024339	0	63	0	3563	0	3500	0.0	0.0
chr17	LRRC45	82029542	82029635	0	94	0	3563	0	3469	0.0	0.0
chr17	GPS1	82052255	82052459	0	205	0	3905	0	3700	0.0	0.0
chr17	GPS1	82056469	82056550	0	82	0	3905	0	3823	0.0	0.0
chr17	GPS1	82056839	82056974	0	136	0	3905	0	3769	0.0	0.0
chr17	GPS1	82052374	82052459	0	86	0	3905	0	3819	0.0	0.0
chr17	GPS1	82052377	82052459	0	83	0	3905	0	3822	0.0	0.0
chr17	GPS1	82052258	82052459	0	202	0	3905	0	3703	0.0	0.0
chr17	GPS1	82052255	82052442	0	188	0	3905	0	3717	0.0	0.0
chr17	SLC16A3	82236728	82236872	0	145	0	5874	0	5729	0.0	0.0
chr17	SLC16A3	82236728	82236844	0	117	0	5874	0	5757	0.0	0.0
chr17	AC132872.5	82274891	82275073	0	183	0	4275	0	4092	0.0	0.0
chr17	HEXD	82424393	82424503	0	111	0	4126	0	4015	0.0	0.0
chr17	HEXD	82428029	82428127	0	99	0	4126	0	4027	0.0	0.0
chr17	HEXD	82440262	82440334	0	73	0	4126	0	4053	0.0	0.0
chr17	HEXD	82424418	82424503	0	86	0	4126	0	4040	0.0	0.0
chr17	HEXD	82440472	82440613	0	142	0	4126	0	3984	0.0	0.0
chr17	NARF	82464286	82464430	0	145	0	6641	0	6496	0.0	0.0
chr17	NARF	82472563	82472698	0	136	0	6641	0	6505	0.0	0.0
chr17	NARF	82484812	82484950	0	139	0	6641	0	6502	0.0	0.0
chr17	NARF	82459274	82459448	0	175	0	6641	0	6466	0.0	0.0
chr17	NARF	82480406	82480544	0	139	0	6641	0	6502	0.0	0.0
chr17	NARF	82478570	82478667	0	98	0	6641	0	6543	0.0	0.0
chr17	FOXK2	82568053	82568201	0	149	0	7313	0	7164	0.0	0.0
chr17	FOXK2	82595781	82596191	0	411	0	7313	0	6902	0.0	0.0
chr17	FN3KRP	82718443	82718571	0	129	0	2954	0	2825	0.0	0.0
chr17	FN3KRP	82720760	82720965	0	206	0	2954	0	2748	0.0	0.0
chr17	FN3KRP	82720760	82720841	0	82	0	2954	0	2872	0.0	0.0
chr17	TBCD	82900650	82900731	0	82	0	11720	0	11638	0.0	0.0
chr17	TBCD	82932657	82932735	0	79	0	11720	0	11641	0.0	0.0
chr17	TBCD	82937845	82937959	0	115	0	11720	0	11605	0.0	0.0
chr18	LINC02564	13151	13354	0	204	0	1435	0	1231	0.0	0.0
chr18	USP14	166786	166819	33684	34	1599935	6004	1566251	5970	990.7058823529412	262.3536013400335
chr18	USP14	192841	192900	19688	60	1599935	6004	1580247	5944	328.1333333333333	265.8558209959623
chr18	USP14	178932	179037	81781	106	1599935	6004	1518154	5898	771.5188679245283	257.401492031197
chr18	USP14	162982	163174	1785	193	1599935	6004	1598150	5811	9.248704663212436	275.0215109275512
chr18	USP14	178900	179037	82242	138	1599935	6004	1517693	5866	595.9565217391304	258.7270712580975
chr18	CLUL1	598499	598582	0	84	6705	3861	6705	3777	0.0	1.7752184273232725
chr18	CLUL1	606977	607099	0	123	6705	3861	6705	3738	0.0	1.7937399678972712
chr18	CLUL1	644909	645097	0	189	6705	3861	6705	3672	0.0	1.8259803921568627
chr18	CLUL1	613158	613281	0	124	6705	3861	6705	3737	0.0	1.7942199625367943
chr18	TYMS	669071	669173	453219	103	3759180	2430	3305961	2327	4400.184466019417	1420.6966050709068
chr18	AP000829.1	1137813	1137864	0	52	51	2283	51	2231	0.0	0.02285970416853429
chr18	AP000829.1	1061462	1061535	0	74	51	2283	51	2209	0.0	0.023087369850611137
chr18	AP000829.1	1133842	1133952	0	111	51	2283	51	2172	0.0	0.023480662983425413
chr18	AP000829.1	1165093	1165185	0	93	51	2283	51	2190	0.0	0.023287671232876714
chr18	AP000829.1	1133842	1133894	0	53	51	2283	51	2230	0.0	0.022869955156950672
chr18	AP005262.1	1626238	1626367	0	130	51	9198	51	9068	0.0	0.0056241729157476845
chr18	AP005262.1	1649685	1649793	0	109	51	9198	51	9089	0.0	0.005611178347452965
chr18	AP005262.1	1587583	1587654	0	72	51	9198	51	9126	0.0	0.005588428665351742
chr18	AP005262.1	1531497	1531557	0	61	51	9198	51	9137	0.0	0.005581700777060304
chr18	AP005262.1	1690602	1690676	0	75	51	9198	51	9123	0.0	0.005590266359750082
chr18	AP005262.1	1824777	1824852	0	76	51	9198	51	9122	0.0	0.005590879193159395
chr18	AP005262.1	2020036	2020145	0	110	51	9198	51	9088	0.0	0.005611795774647888
chr18	AP005262.1	1562773	1562861	0	89	51	9198	51	9109	0.0	0.005598858272038643
chr18	NDC80	2577235	2577357	0	123	592828	3574	592828	3451	0.0	171.78441031585047
chr18	SMCHD1	2722518	2722663	3099	146	608750	12458	605651	12312	21.226027397260275	49.1919265756985
chr18	SMCHD1	2778168	2778239	6076	72	608750	12458	602674	12386	84.38888888888889	48.657678023575
chr18	SMCHD1	2784844	2784987	16	144	608750	12458	608734	12314	0.1111111111111111	49.43430242000974
chr18	SMCHD1	2796767	2796860	0	94	608750	12458	608750	12364	0.0	49.235684244581044
chr18	MYL12A	3249360	3249443	8218	84	4590647	2866	4582429	2782	97.83333333333333	1647.1707404744789
chr18	MYL12A	3249561	3249723	10031	163	4590647	2866	4580616	2703	61.5398773006135	1694.6415094339623
chr18	TGIF1	3450321	3450505	16286	185	290076	7818	273790	7633	88.03243243243243	35.8692519323988
chr18	TGIF1	3450324	3450505	16167	182	290076	7818	273909	7636	88.82967032967034	35.870743844945
chr18	GAPLINC	3473953	3474142	0	190	0	1056	0	866	0.0	0.0
chr18	DLGAP1-AS1	3594419	3594484	986	66	10733	1621	9747	1555	14.93939393939394	6.268167202572347
chr18	DLGAP1-AS1	3596578	3596675	1123	98	10733	1621	9610	1523	11.459183673469388	6.309914642153644
chr18	DLGAP1-AS4	3998455	3998536	0	82	0	2553	0	2471	0.0	0.0
chr18	DLGAP1-AS4	3998482	3998536	0	55	0	2553	0	2498	0.0	0.0
chr18	DLGAP1-AS5	4280729	4280766	0	38	0	2882	0	2844	0.0	0.0
chr18	DLGAP1-AS5	4275300	4275379	0	80	0	2882	0	2802	0.0	0.0
chr18	LINC01892	5084996	5085228	0	233	0	2813	0	2580	0.0	0.0
chr18	LINC01892	5084996	5085962	0	967	0	2813	0	1846	0.0	0.0
chr18	LINC00667	5241698	5241889	2565	192	190677	9559	188112	9367	13.359375	20.082416995836446
chr18	LINC00667	5240647	5240708	663	62	190677	9559	190014	9497	10.693548387096774	20.00779193429504
chr18	LINC00667	5241698	5241812	2462	115	190677	9559	188215	9444	21.408695652173915	19.92958492164337
chr18	LINC00667	5240186	5240277	376	92	190677	9559	190301	9467	4.086956521739131	20.101510510193304
chr18	LINC00667	5240647	5241255	3166	609	190677	9559	187511	8950	5.198686371100164	20.95094972067039
chr18	LINC00667	5240647	5240819	1690	173	190677	9559	188987	9386	9.76878612716763	20.134988280417645
chr18	LINC00667	5240183	5240277	415	95	190677	9559	190262	9464	4.368421052631579	20.10376162299239
chr18	LINC00667	5240542	5240615	165	74	190677	9559	190512	9485	2.22972972972973	20.085608856088562
chr18	LINC00667	5240647	5240964	2140	318	190677	9559	188537	9241	6.729559748427673	20.40222919597446
chr18	MIR3976HG	5738362	5739327	0	966	0	12474	0	11508	0.0	0.0
chr18	MIR3976HG	5769762	5769866	0	105	0	12474	0	12369	0.0	0.0
chr18	MIR3976HG	5750779	5750904	0	126	0	12474	0	12348	0.0	0.0
chr18	MIR3976HG	5760987	5761047	0	61	0	12474	0	12413	0.0	0.0
chr18	MIR3976HG	5789017	5789220	0	204	0	12474	0	12270	0.0	0.0
chr18	MIR3976HG	5759975	5760081	0	107	0	12474	0	12367	0.0	0.0
chr18	MIR3976HG	5847219	5847452	0	234	0	12474	0	12240	0.0	0.0
chr18	MIR3976HG	5784482	5784575	0	94	0	12474	0	12380	0.0	0.0
chr18	MIR3976HG	5758118	5758321	0	204	0	12474	0	12270	0.0	0.0
chr18	MIR3976HG	5751334	5751594	0	261	0	12474	0	12213	0.0	0.0
chr18	MIR3976HG	5779944	5780024	0	81	0	12474	0	12393	0.0	0.0
chr18	MIR3976HG	5750779	5750832	0	54	0	12474	0	12420	0.0	0.0
chr18	MIR3976HG	5758263	5758321	0	59	0	12474	0	12415	0.0	0.0
chr18	MIR3976HG	5810863	5811222	0	360	0	12474	0	12114	0.0	0.0
chr18	MIR3976HG	5769743	5769866	0	124	0	12474	0	12350	0.0	0.0
chr18	ARHGAP28	6876130	6876208	0	79	102	11935	102	11856	0.0	0.00860323886639676
chr18	ARHGAP28	6836097	6836175	0	79	102	11935	102	11856	0.0	0.00860323886639676
chr18	PTPRM	8253226	8253414	0	189	51	9910	51	9721	0.0	0.005246373829852896
chr18	PTPRM	8122241	8122316	0	76	51	9910	51	9834	0.0	0.005186089078706529
chr18	PTPRM	8248149	8248176	0	28	51	9910	51	9882	0.0	0.0051608986035215545
chr18	PTPRM	8371759	8371810	0	52	51	9910	51	9858	0.0	0.005173463177115033
chr18	MTCL1	8828907	8828964	1020	58	1776107	10872	1775087	10814	17.586206896551722	164.14712409839098
chr18	MTCL1	8717903	8717962	220	60	1776107	10872	1775887	10812	3.6666666666666665	164.25147983721791
chr18	MTCL1	8792997	8793120	2996	124	1776107	10872	1773111	10748	24.161290322580644	164.97125046520281
chr18	MTCL1	8785689	8785726	88	38	1776107	10872	1776019	10834	2.3157894736842106	163.93012737677682
chr18	MTCL1	8809447	8809561	19907	115	1776107	10872	1756200	10757	173.10434782608695	163.26113228595332
chr18	ANKRD12	9204475	9204544	0	70	75494	12266	75494	12196	0.0	6.190062315513283
chr18	ANKRD12	9200513	9200644	216	132	75494	12266	75278	12134	1.6363636363636365	6.203889896159552
chr18	ANKRD12	9195550	9195698	3069	149	75494	12266	72425	12117	20.59731543624161	5.977139555995708
chr18	ANKRD12	9239476	9239556	0	81	75494	12266	75494	12185	0.0	6.1956503898235535
chr18	RALBP1	9479343	9479437	92	95	1666735	8055	1666643	7960	0.968421052631579	209.37726130653266
chr18	RALBP1	9476968	9477253	1173	286	1666735	8055	1665562	7769	4.101398601398602	214.38563521688764
chr18	RAB31	9775277	9775357	20466	81	1357433	5492	1336967	5411	252.66666666666666	247.0831639253373
chr18	RAB31	9845581	9845691	38787	111	1357433	5492	1318646	5381	349.43243243243245	245.0559375580747
chr18	VAPA	9944923	9945058	10027	136	2106314	9075	2096287	8939	73.7279411764706	234.51023604430026
chr18	VAPA	9924902	9924995	459	94	2106314	9075	2105855	8981	4.882978723404255	234.47889989978844
chr18	APCDD1	10468468	10468652	0	185	170	5944	170	5759	0.0	0.029519013717659318
chr18	APCDD1	10471529	10472061	24	533	170	5944	146	5411	0.0450281425891182	0.026982073553871742
chr18	APCDD1	10474105	10474247	19	143	170	5944	151	5801	0.13286713286713286	0.02602999482847785
chr18	NAPG	10530769	10530837	7555	69	478612	5602	471057	5533	109.4927536231884	85.13591180191578
chr18	LINC01255	11505781	11505924	0	144	0	8070	0	7926	0.0	0.0
chr18	LINC01255	11503733	11503884	0	152	0	8070	0	7918	0.0	0.0
chr18	LINC01255	11506531	11506636	0	106	0	8070	0	7964	0.0	0.0
chr18	LINC01255	11513196	11513335	0	140	0	8070	0	7930	0.0	0.0
chr18	LINC01255	11505781	11505956	0	176	0	8070	0	7894	0.0	0.0
chr18	LINC01255	11504827	11505057	0	231	0	8070	0	7839	0.0	0.0
chr18	LINC01255	11490379	11490647	0	269	0	8070	0	7801	0.0	0.0
chr18	LINC01255	11505486	11505956	0	471	0	8070	0	7599	0.0	0.0
chr18	LINC01255	11506479	11506636	0	158	0	8070	0	7912	0.0	0.0
chr18	LINC01255	11503740	11503884	0	145	0	8070	0	7925	0.0	0.0
chr18	LINC01255	11503133	11503299	0	167	0	8070	0	7903	0.0	0.0
chr18	IMPA2	12012169	12012215	5132	47	268401	3420	263269	3373	109.19148936170212	78.05188259709458
chr18	IMPA2	12012169	12012349	5749	181	268401	3420	262652	3239	31.76243093922652	81.09046001852424
chr18	IMPA2	12008332	12008591	2943	260	268401	3420	265458	3160	11.319230769230769	84.00569620253165
chr18	IMPA2	12021701	12021822	0	122	268401	3420	268401	3298	0.0	81.38295936931473
chr18	CIDEA	12263599	12263866	0	268	0	1816	0	1548	0.0	0.0
chr18	CIDEA	12274092	12274274	0	183	0	1816	0	1633	0.0	0.0
chr18	TUBB6	12308686	12308795	128672	110	3872549	3691	3743877	3581	1169.7454545454545	1045.4836637810668
chr18	TUBB6	12310942	12311053	281164	112	3872549	3691	3591385	3579	2510.3928571428573	1003.4604638167086
chr18	TUBB6	12320628	12320744	3595	117	3872549	3691	3868954	3574	30.726495726495727	1082.5277000559597
chr18	TUBB6	12320535	12320744	7024	210	3872549	3691	3865525	3481	33.44761904761905	1110.463947141626
chr18	PRELID3A	12420324	12420493	3934	170	99411	2584	95477	2414	23.141176470588235	39.55136702568351
chr18	PRELID3A	12410717	12410858	1288	142	99411	2584	98123	2442	9.070422535211268	40.18140868140868
chr18	PRELID3A	12422247	12422341	0	95	99411	2584	99411	2489	0.0	39.9401366010446
chr18	SEH1L	12951854	12951905	22435	52	1101064	8031	1078629	7979	431.4423076923077	135.18348163930318
chr18	SEH1L	12955462	12955609	58742	148	1101064	8031	1042322	7883	396.9054054054054	132.2240263858937
chr18	SEH1L	12964435	12964495	396	61	1101064	8031	1100668	7970	6.491803278688525	138.10138017565873
chr18	CEP192	13038369	13038579	2303	211	258342	8599	256039	8388	10.914691943127963	30.52443967572723
chr18	CEP192	13071038	13071212	5653	175	258342	8599	252689	8424	32.30285714285714	29.996320037986706
chr18	CEP192	13087530	13087646	9135	117	258342	8599	249207	8482	78.07692307692308	29.38068851685923
chr18	CEP192	13114129	13114251	5877	123	258342	8599	252465	8476	47.78048780487805	29.78586597451628
chr18	CEP192	13037236	13037301	0	66	258342	8599	258342	8533	0.0	30.27563576702215
chr18	CEP192	13000311	13000486	0	176	258342	8599	258342	8423	0.0	30.671019826665084
chr18	CEP192	13103874	13103967	51	94	258342	8599	258291	8505	0.5425531914893617	30.36931216931217
chr18	CEP192	13058293	13058435	0	143	258342	8599	258342	8456	0.0	30.551324503311257
chr18	LDLRAD4	13643358	13643412	0	55	918	29113	918	29058	0.0	0.031591988436919266
chr18	LDLRAD4	13438243	13438384	0	142	918	29113	918	28971	0.0	0.03168685927306617
chr18	LDLRAD4	13464990	13465111	0	122	918	29113	918	28991	0.0	0.03166499948259805
chr18	LDLRAD4	13583828	13584049	0	222	918	29113	918	28891	0.0	0.03177460108684366
chr18	LDLRAD4	13484036	13484119	0	84	918	29113	918	29029	0.0	0.03162354886492817
chr18	LDLRAD4	13491231	13491469	0	239	918	29113	918	28874	0.0	0.03179330885918127
chr18	LDLRAD4	13644644	13644925	0	282	918	29113	918	28831	0.0	0.03184072699524817
chr18	LDLRAD4	13615760	13615912	0	153	918	29113	918	28960	0.0	0.03169889502762431
chr18	RNMT	13731475	13731934	22359	460	266502	5239	244143	4779	48.606521739130436	51.08662900188324
chr18	RNMT	13759941	13760208	8786	268	266502	5239	257716	4971	32.78358208955224	51.84389458861396
chr18	RNMT	13730626	13730755	4816	130	266502	5239	261686	5109	37.04615384615385	51.220591113720886
chr18	ANKRD20A5P	14183651	14183766	0	116	153	6268	153	6152	0.0	0.02486996098829649
chr18	ANKRD20A5P	14242139	14242419	0	281	153	6268	153	5987	0.0	0.025555369968264574
chr18	ANKRD20A5P	14211308	14211416	0	109	153	6268	153	6159	0.0	0.02484169508037019
chr18	ANKRD30B	14796220	14796249	0	30	1581	6256	1581	6226	0.0	0.2539351108255702
chr18	GREB1L	21449509	21449836	0	328	13083	10608	13083	10280	0.0	1.2726653696498054
chr18	GREB1L	21473030	21473211	0	182	13083	10608	13083	10426	0.0	1.254843660080568
chr18	GREB1L	21434946	21435075	51	130	13083	10608	13032	10478	0.3923076923076923	1.2437488070242413
chr18	SNRPD1	21622724	21622801	0	78	153	4209	153	4131	0.0	0.037037037037037035
chr18	RBBP8	22929382	22929437	0	56	150	5107	150	5051	0.0	0.02969708968521085
chr18	RBBP8	22916940	22917026	0	87	150	5107	150	5020	0.0	0.029880478087649404
chr18	RBBP8	22915419	22915485	0	67	150	5107	150	5040	0.0	0.02976190476190476
chr18	RBBP8	23006362	23006432	0	71	150	5107	150	5036	0.0	0.029785544082605243
chr18	RBBP8	23016827	23016924	0	98	150	5107	150	5009	0.0	0.029946097025354362
chr18	RBBP8	22977789	22977887	0	99	150	5107	150	5008	0.0	0.029952076677316294
chr18	RIOK3	23467398	23467526	0	129	153	4777	153	4648	0.0	0.03291738382099828
chr18	RMC1	23506969	23507054	0	86	95	3000	95	2914	0.0	0.03260123541523679
chr18	RMC1	23507984	23508041	0	58	95	3000	95	2942	0.0	0.032290958531611146
chr18	RMC1	23508654	23508776	0	123	95	3000	95	2877	0.0	0.03302050747306222
chr18	LAMA3	23899287	23899455	0	169	276578	14351	276578	14182	0.0	19.502044845578904
chr18	LAMA3	23952989	23953109	0	121	276578	14351	276578	14230	0.0	19.43626141953619
chr18	TTC39C	24069156	24069271	0	116	33823	6969	33823	6853	0.0	4.935502699547643
chr18	CABYR	24143090	24143259	0	170	0	3482	0	3312	0.0	0.0
chr18	CABYR	24159471	24160069	0	599	0	3482	0	2883	0.0	0.0
chr18	CABYR	24143359	24143413	0	55	0	3482	0	3427	0.0	0.0
chr18	CABYR	24159945	24160069	0	125	0	3482	0	3357	0.0	0.0
chr18	CABYR	24150537	24150624	0	88	0	3482	0	3394	0.0	0.0
chr18	CABYR	24150537	24150631	0	95	0	3482	0	3387	0.0	0.0
chr18	CABYR	24148574	24148725	0	152	0	3482	0	3330	0.0	0.0
chr18	CABYR	24159942	24160069	0	128	0	3482	0	3354	0.0	0.0
chr18	LINC01915	24630046	24630171	0	126	0	10136	0	10010	0.0	0.0
chr18	LINC01915	24674274	24674459	0	186	0	10136	0	9950	0.0	0.0
chr18	AC018697.1	24726674	24726757	0	84	0	8294	0	8210	0.0	0.0
chr18	AC018697.1	24766480	24766734	0	255	0	8294	0	8039	0.0	0.0
chr18	AC018697.1	24939973	24940575	0	603	0	8294	0	7691	0.0	0.0
chr18	AC018697.1	24726674	24726761	0	88	0	8294	0	8206	0.0	0.0
chr18	PSMA8	26140044	26140109	0	66	0	1902	0	1836	0.0	0.0
chr18	TAF4B	26295194	26295314	0	121	5551	4902	5551	4781	0.0	1.1610541727672035
chr18	AQP4-AS1	26925816	26925862	0	47	0	9052	0	9005	0.0	0.0
chr18	AQP4-AS1	26892870	26892992	0	123	0	9052	0	8929	0.0	0.0
chr18	AQP4-AS1	26928244	26928398	0	155	0	9052	0	8897	0.0	0.0
chr18	AQP4-AS1	26930680	26930823	0	144	0	9052	0	8908	0.0	0.0
chr18	AC068408.1	27396705	27396726	0	22	0	1112	0	1090	0.0	0.0
chr18	AC068408.1	27396758	27396832	0	75	0	1112	0	1037	0.0	0.0
chr18	AC117569.1	29537362	29537500	0	139	102	994	102	855	0.0	0.11929824561403508
chr18	RNF125	32042178	32042273	0	96	0	6067	0	5971	0.0	0.0
chr18	RNF125	32065901	32066009	0	109	0	6067	0	5958	0.0	0.0
chr18	RNF138	32092699	32092886	0	188	0	3785	0	3597	0.0	0.0
chr18	RNF138	32111753	32111919	0	167	0	3785	0	3618	0.0	0.0
chr18	RNF138	32123517	32123574	0	58	0	3785	0	3727	0.0	0.0
chr18	ASXL3	33671746	33671866	0	121	323536	13548	323536	13427	0.0	24.095926119013928
chr18	ASXL3	33641820	33641823	0	4	323536	13548	323536	13544	0.0	23.88777318369758
chr18	ASXL3	33690241	33690319	123	79	323536	13548	323413	13469	1.5569620253164558	24.01165639616898
chr18	ASXL3	33626872	33627070	471	199	323536	13548	323065	13349	2.3668341708542715	24.201438309985768
chr18	ASXL3	33626861	33627070	537	210	323536	13548	322999	13338	2.557142857142857	24.216449242765034
chr18	DTNA	34825266	34825275	0	10	1234	10501	1234	10491	0.0	0.11762463063578306
chr18	DTNA	34708173	34708226	0	54	1234	10501	1234	10447	0.0	0.1181200344596535
chr18	DTNA	34662853	34662980	0	128	1234	10501	1234	10373	0.0	0.11896269160320062
chr18	DTNA	34683481	34683694	0	214	1234	10501	1234	10287	0.0	0.11995722756877612
chr18	DTNA	34866110	34866131	0	22	1234	10501	1234	10479	0.0	0.11775932818016986
chr18	DTNA	34838744	34838837	0	94	1234	10501	1234	10407	0.0	0.11857403670606323
chr18	DTNA	34757157	34757288	0	132	1234	10501	1234	10369	0.0	0.1190085832770759
chr18	DTNA	34829399	34829489	0	91	1234	10501	1234	10410	0.0	0.11853986551392891
chr18	DTNA	34838093	34838171	0	79	1234	10501	1234	10422	0.0	0.11840337747073498
chr18	DTNA	34884727	34884776	0	50	1234	10501	1234	10451	0.0	0.11807482537556215
chr18	MAPRE2	34988592	34988848	0	257	0	6148	0	5891	0.0	0.0
chr18	MAPRE2	35070194	35070322	0	129	0	6148	0	6019	0.0	0.0
chr18	ZNF397	35242390	35242884	0	495	0	8716	0	8221	0.0	0.0
chr18	ZNF397	35245261	35245351	0	91	0	8716	0	8625	0.0	0.0
chr18	ZNF397	35254231	35254402	0	172	0	8716	0	8544	0.0	0.0
chr18	ZNF271P	35291009	35291232	0	224	0	7454	0	7230	0.0	0.0
chr18	GALNT1	35659857	35659930	0	74	0	5141	0	5067	0.0	0.0
chr18	C18ORF21	35977409	35977600	0	192	0	1621	0	1429	0.0	0.0
chr18	ELP2	36138794	36138872	0	79	0	11088	0	11009	0.0	0.0
chr18	ELP2	36133237	36133316	0	80	0	11088	0	11008	0.0	0.0
chr18	ELP2	36146249	36146381	0	133	0	11088	0	10955	0.0	0.0
chr18	ELP2	36159957	36160015	0	59	0	11088	0	11029	0.0	0.0
chr18	ELP2	36139418	36139613	0	196	0	11088	0	10892	0.0	0.0
chr18	FHOD3	36658074	36658188	0	115	6	7995	6	7880	0.0	0.0007614213197969543
chr18	FHOD3	36687127	36687178	0	52	6	7995	6	7943	0.0	0.0007553820974442906
chr18	FHOD3	36760607	36760782	0	176	6	7995	6	7819	0.0	0.0007673615551860852
chr18	FHOD3	36759117	36759141	0	25	6	7995	6	7970	0.0	0.000752823086574655
chr18	KIAA1328	36844207	36844302	0	96	610	9612	610	9516	0.0	0.0641025641025641
chr18	KIAA1328	37084124	37084232	0	109	610	9612	610	9503	0.0	0.06419025570872357
chr18	KIAA1328	36946248	36946517	0	270	610	9612	610	9342	0.0	0.06529651038321559
chr18	KIAA1328	37193590	37193694	0	105	610	9612	610	9507	0.0	0.06416324813295467
chr18	AC090386.1	37275812	37275981	0	170	125	816	125	646	0.0	0.19349845201238391
chr18	AC011139.1	39317817	39317931	0	115	0	613	0	498	0.0	0.0
chr18	LINC01902	39867128	39867374	0	247	0	12838	0	12591	0.0	0.0
chr18	LINC01902	39875464	39875941	0	478	0	12838	0	12360	0.0	0.0
chr18	LINC01902	39865239	39865400	0	162	0	12838	0	12676	0.0	0.0
chr18	PIK3C3	41957569	41957758	0	190	204	14565	204	14375	0.0	0.014191304347826087
chr18	PIK3C3	42057882	42058051	0	170	204	14565	204	14395	0.0	0.014171587356721084
chr18	PIK3C3	41984879	41985107	0	229	204	14565	204	14336	0.0	0.014229910714285714
chr18	LINC00907	42212363	42212526	0	164	4239	10985	4239	10821	0.0	0.3917382866648184
chr18	LINC00907	42289503	42289594	0	92	4239	10985	4239	10893	0.0	0.38914899476728176
chr18	LINC00907	42335083	42335303	0	221	4239	10985	4239	10764	0.0	0.39381270903010035
chr18	SETBP1	45038484	45038655	0	172	6825	14355	6825	14183	0.0	0.48120989917506873
chr18	AC021517.1	45492061	45492129	0	69	0	2775	0	2706	0.0	0.0
chr18	AC021517.1	45489906	45489945	0	40	0	2775	0	2735	0.0	0.0
chr18	SLC14A1	45730299	45730471	0	173	0	6081	0	5908	0.0	0.0
chr18	SLC14A1	45739527	45739662	0	136	0	6081	0	5945	0.0	0.0
chr18	SLC14A1	45729985	45730120	0	136	0	6081	0	5945	0.0	0.0
chr18	SLC14A1	45727260	45727418	0	159	0	6081	0	5922	0.0	0.0
chr18	SLC14A1	45736455	45736648	0	194	0	6081	0	5887	0.0	0.0
chr18	SLC14A1	45739162	45739310	0	149	0	6081	0	5932	0.0	0.0
chr18	SLC14A1	45727331	45727418	0	88	0	6081	0	5993	0.0	0.0
chr18	SLC14A1	45724949	45725013	0	65	0	6081	0	6016	0.0	0.0
chr18	SLC14A1	45731014	45731204	0	191	0	6081	0	5890	0.0	0.0
chr18	SIGLEC15	45837512	45837896	0	385	0	3457	0	3072	0.0	0.0
chr18	SIGLEC15	45837512	45837885	0	374	0	3457	0	3083	0.0	0.0
chr18	HAUS1	46123298	46123364	0	67	51	2132	51	2065	0.0	0.024697336561743343
chr18	HAUS1	46124821	46124893	0	73	51	2132	51	2059	0.0	0.02476930548810102
chr18	HAUS1	46106704	46106833	0	130	51	2132	51	2002	0.0	0.025474525474525476
chr18	HAUS1	46122466	46122590	0	125	51	2132	51	2007	0.0	0.025411061285500747
chr18	HAUS1	46109646	46109784	0	139	51	2132	51	1993	0.0	0.025589563472152535
chr18	C18ORF25	46240004	46240187	0	184	714	9585	714	9401	0.0	0.0759493670886076
chr18	KATNAL2	47084331	47084442	0	112	0	4800	0	4688	0.0	0.0
chr18	KATNAL2	47046390	47046527	0	138	0	4800	0	4662	0.0	0.0
chr18	KATNAL2	47067020	47067119	0	100	0	4800	0	4700	0.0	0.0
chr18	KATNAL2	47046456	47046527	0	72	0	4800	0	4728	0.0	0.0
chr18	CTIF	48539757	48539831	0	75	1884	6386	1884	6311	0.0	0.2985263825067343
chr18	CTIF	48625188	48625236	24	49	1884	6386	1860	6337	0.4897959183673469	0.2935142812056178
chr18	LIPG	49575368	49575590	0	223	0	11485	0	11262	0.0	0.0
chr18	SKA1	50380125	50380250	0	126	0	2904	0	2778	0.0	0.0
chr18	SKA1	50385215	50385353	0	139	0	2904	0	2765	0.0	0.0
chr18	MAPK4	50663088	50664504	0	1417	0	7604	0	6187	0.0	0.0
chr18	ME2	50895808	50895928	0	121	102	15460	102	15339	0.0	0.006649716409153139
chr18	ME2	50912800	50912950	0	151	102	15460	102	15309	0.0	0.006662747403488144
chr18	ME2	50921073	50921187	0	115	102	15460	102	15345	0.0	0.006647116324535679
chr18	ME2	50939569	50939640	0	72	102	15460	102	15388	0.0	0.006628541720821419
chr18	ME2	50916167	50916243	0	77	102	15460	102	15383	0.0	0.006630696223103426
chr18	ME2	50917346	50917508	0	163	102	15460	102	15297	0.0	0.006667974112571092
chr18	ME2	50940287	50940386	0	100	102	15460	102	15360	0.0	0.006640625
chr18	ME2	50945137	50945260	0	124	102	15460	102	15336	0.0	0.006651017214397496
chr18	ME2	50942699	50942736	0	38	102	15460	102	15422	0.0	0.00661392815458436
chr18	ELAC1	50984486	50984563	0	78	204	3975	204	3897	0.0	0.05234795996920708
chr18	SMAD4	51046919	51047295	0	377	0	10684	0	10307	0.0	0.0
chr18	SMAD4	51077306	51077419	0	114	0	10684	0	10570	0.0	0.0
chr18	LINC01630	51387171	51387301	0	131	153	17204	153	17073	0.0	0.008961518186610437
chr18	LINC01630	51532111	51532277	0	167	153	17204	153	17037	0.0	0.008980454305335447
chr18	LINC01630	51427732	51427814	0	83	153	17204	153	17121	0.0	0.008936393902225337
chr18	LINC01630	51524961	51525082	0	122	153	17204	153	17082	0.0	0.008956796628029505
chr18	LINC01630	51530364	51530395	0	32	153	17204	153	17172	0.0	0.00890985324947589
chr18	LINC01630	51569011	51569059	0	49	153	17204	153	17155	0.0	0.008918682599825124
chr18	LINC01630	51561180	51561341	0	162	153	17204	153	17042	0.0	0.008977819504752963
chr18	DCC	53391654	53391887	0	234	4935	13013	4935	12779	0.0	0.38618045230456216
chr18	DCC	52809298	52809422	0	125	4935	13013	4935	12888	0.0	0.3829143389199255
chr18	DCC	52892407	52892532	4323	126	4935	13013	612	12887	34.30952380952381	0.04748971832078839
chr18	DCC	52965030	52965126	0	97	4935	13013	4935	12916	0.0	0.3820842366057603
chr18	DCC	53391714	53391887	0	174	4935	13013	4935	12839	0.0	0.38437573019705584
chr18	DCC	53530346	53530416	0	71	4935	13013	4935	12942	0.0	0.3813166434863236
chr18	LINC01919	53577418	53577962	0	545	0	3770	0	3225	0.0	0.0
chr18	LINC01919	53582593	53582706	0	114	0	3770	0	3656	0.0	0.0
chr18	LINC01919	53578072	53578121	0	50	0	3770	0	3720	0.0	0.0
chr18	LINC01919	53609257	53609359	0	103	0	3770	0	3667	0.0	0.0
chr18	LINC01919	53594804	53594883	0	80	0	3770	0	3690	0.0	0.0
chr18	LINC01919	53571259	53571295	0	37	0	3770	0	3733	0.0	0.0
chr18	POLI	54271359	54271485	2396	127	630654	9485	628258	9358	18.866141732283463	67.1359264800171
chr18	POLI	54280666	54280903	538	238	630654	9485	630116	9247	2.2605042016806722	68.14274899967558
chr18	POLI	54283742	54283815	0	74	630654	9485	630654	9411	0.0	67.01243226012113
chr18	DYNAP	54594938	54595103	0	166	2009	2141	2009	1975	0.0	1.0172151898734176
chr18	RAB27B	54884332	54884436	0	105	51	3304	51	3199	0.0	0.01594248202563301
chr18	LINC01905	56088410	56088583	0	174	1497	3707	1497	3533	0.0	0.42371921879422586
chr18	LINC01905	56050079	56050177	0	99	1497	3707	1497	3608	0.0	0.41491130820399114
chr18	LINC01905	56079436	56079621	0	186	1497	3707	1497	3521	0.0	0.42516330587901163
chr18	LINC01905	56091947	56092057	0	111	1497	3707	1497	3596	0.0	0.4162958843159066
chr18	LINC01905	56088414	56088583	0	170	1497	3707	1497	3537	0.0	0.42324003392705684
chr18	LINC01905	56078707	56078794	0	88	1497	3707	1497	3619	0.0	0.4136501796076264
chr18	LINC01905	56077521	56077728	0	208	1497	3707	1497	3499	0.0	0.427836524721349
chr18	LINC01905	56077043	56077115	0	73	1497	3707	1497	3634	0.0	0.41194276279581726
chr18	LINC01905	56078108	56078232	0	125	1497	3707	1497	3582	0.0	0.41792294807370184
chr18	LINC01905	56095920	56095990	0	71	1497	3707	1497	3636	0.0	0.41171617161716173
chr18	LINC01905	56102766	56102835	0	70	1497	3707	1497	3637	0.0	0.4116029694803409
chr18	LINC01905	56078700	56078794	0	95	1497	3707	1497	3612	0.0	0.41445182724252494
chr18	AC006305.3	56146567	56146731	459	165	10853	1531	10394	1366	2.7818181818181817	7.609077598828697
chr18	AC006305.3	56139787	56140094	0	308	10853	1531	10853	1223	0.0	8.874080130825838
chr18	AC006305.3	56139841	56140094	0	254	10853	1531	10853	1277	0.0	8.498825371965545
chr18	WDR7	56776781	56776880	0	100	102031	8897	102031	8797	0.0	11.598385813345459
chr18	WDR7	56936180	56936229	0	50	102031	8897	102031	8847	0.0	11.532835989600995
chr18	AC027097.2	57737035	57737091	0	57	51	5460	51	5403	0.0	0.009439200444197668
chr18	NEDD4L	58248898	58248937	0	40	51	30352	51	30312	0.0	0.0016825019794140933
chr18	NEDD4L	58315981	58316032	0	52	51	30352	51	30300	0.0	0.0016831683168316831
chr18	NEDD4L	58335477	58335537	0	61	51	30352	51	30291	0.0	0.0016836684163612954
chr18	NEDD4L	58341677	58341797	0	121	51	30352	51	30231	0.0	0.0016870100228242532
chr18	NEDD4L	58054226	58054876	0	651	51	30352	51	29701	0.0	0.0017171139018888253
chr18	NEDD4L	58341037	58341169	0	133	51	30352	51	30219	0.0	0.0016876799364638141
chr18	NEDD4L	58342905	58343103	0	199	51	30352	51	30153	0.0	0.0016913739926375485
chr18	NEDD4L	58227829	58227888	0	60	51	30352	51	30292	0.0	0.0016836128350719661
chr18	NEDD4L	58099932	58100159	0	228	51	30352	51	30124	0.0	0.001693002257336343
chr18	NEDD4L	58165787	58165861	0	75	51	30352	51	30277	0.0	0.0016844469399213925
chr18	NEDD4L	58227829	58227907	0	79	51	30352	51	30273	0.0	0.0016846695074819145
chr18	NEDD4L	58245426	58245508	0	83	51	30352	51	30269	0.0	0.001684892133866332
chr18	MALT1	58709377	58709556	0	180	0	10585	0	10405	0.0	0.0
chr18	MALT1	58710920	58710953	0	34	0	10585	0	10551	0.0	0.0
chr18	MALT1	58733881	58733980	0	100	0	10585	0	10485	0.0	0.0
chr18	MALT1	58720379	58720422	0	44	0	10585	0	10541	0.0	0.0
chr18	ZNF532	58865303	58865385	0	83	0	9593	0	9510	0.0	0.0
chr18	ZNF532	58865469	58865579	0	111	0	9593	0	9482	0.0	0.0
chr18	ZNF532	58896424	58896622	0	199	0	9593	0	9394	0.0	0.0
chr18	ZNF532	58931645	58931755	0	111	0	9593	0	9482	0.0	0.0
chr18	ZNF532	58954233	58954334	0	102	0	9593	0	9491	0.0	0.0
chr18	SEC11C	59157607	59157665	0	59	102	3813	102	3754	0.0	0.02717101758124667
chr18	PMAIP1	59900427	59900578	0	152	922	2189	922	2037	0.0	0.452626411389298
chr18	AC091576.1	60535632	60535755	0	124	153	2317	153	2193	0.0	0.06976744186046512
chr18	RELCH	62269410	62269512	0	103	100	10758	100	10655	0.0	0.009385265133740028
chr18	RELCH	62280359	62280442	0	84	100	10758	100	10674	0.0	0.00936855911560802
chr18	TNFRSF11A	62366707	62366760	0	54	51	9007	51	8953	0.0	0.005696414609628058
chr18	TNFRSF11A	62361679	62361793	0	115	51	9007	51	8892	0.0	0.005735492577597841
chr18	TNFRSF11A	62368700	62369484	0	785	51	9007	51	8222	0.0	0.006202870347847239
chr18	ZCCHC2	62544801	62544873	0	73	0	9142	0	9069	0.0	0.0
chr18	PHLPP1	62941717	62941918	0	202	0	7967	0	7765	0.0	0.0
chr18	SERPINB13	63594025	63594238	0	214	0	4545	0	4331	0.0	0.0
chr18	SERPINB11	63716034	63716152	0	119	0	3707	0	3588	0.0	0.0
chr18	SERPINB11	63720012	63720155	0	144	0	3707	0	3563	0.0	0.0
chr18	SERPINB7	63792392	63792443	0	52	0	2648	0	2596	0.0	0.0
chr18	SERPINB2	63889837	63890095	0	259	0	2753	0	2494	0.0	0.0
chr18	SERPINB10	63907959	63908040	0	82	0	2715	0	2633	0.0	0.0
chr18	HMSD	63953353	63953527	0	175	0	2929	0	2754	0.0	0.0
chr18	SERPINB8	63978298	63978476	0	179	0	5687	0	5508	0.0	0.0
chr18	CCDC102B	68823365	68823416	0	52	36	5794	36	5742	0.0	0.006269592476489028
chr18	CCDC102B	68734733	68734766	0	34	36	5794	36	5760	0.0	0.00625
chr18	LINC02582	73327087	73327188	0	102	51	2498	51	2396	0.0	0.021285475792988316
chr18	LINC02582	73327030	73327188	0	159	51	2498	51	2339	0.0	0.021804189824711415
chr18	LINC02582	73326901	73327188	0	288	51	2498	51	2210	0.0	0.023076923076923078
chr18	CNDP2	74501101	74501238	0	138	37641	7642	37641	7504	0.0	5.01612473347548
chr18	CNDP2	74497508	74497595	0	88	37641	7642	37641	7554	0.0	4.982922954725973
chr18	CNDP2	74497508	74497726	0	219	37641	7642	37641	7423	0.0	5.070860837936144
chr18	CNDP1	74556337	74556466	0	130	5346	6780	5346	6650	0.0	0.8039097744360902
chr18	CNDP1	74560855	74561018	1400	164	5346	6780	3946	6616	8.536585365853659	0.5964328899637243
chr18	AC116003.1	75418006	75418093	0	88	0	2764	0	2676	0.0	0.0
chr18	LINC01893	76212026	76212419	0	394	0	1662	0	1268	0.0	0.0
chr18	AC103808.4	76249665	76249817	0	153	0	1823	0	1670	0.0	0.0
chr18	AC103808.4	76236463	76236614	0	152	0	1823	0	1671	0.0	0.0
chr18	AC018413.1	76492175	76492333	0	159	0	1577	0	1418	0.0	0.0
chr18	LINC00683	76530383	76530464	0	82	102	14982	102	14900	0.0	0.006845637583892617
chr18	LINC00683	76621973	76622336	0	364	102	14982	102	14618	0.0	0.0069776987275961145
chr18	LINC00683	76570910	76571178	0	269	102	14982	102	14713	0.0	0.0069326446000135935
chr18	LINC00683	76610844	76610974	0	131	102	14982	102	14851	0.0	0.006868224361995825
chr18	LINC00683	76622213	76622336	0	124	102	14982	102	14858	0.0	0.006864988558352402
chr18	LINC00683	76620487	76621194	0	708	102	14982	102	14274	0.0	0.007145859604875998
chr18	ZNF236	76871700	76871825	0	126	48	11185	48	11059	0.0	0.004340356270910571
chr18	ZNF236	76935979	76936061	0	83	48	11185	48	11102	0.0	0.0043235453071518645
chr18	ZNF236	76931066	76931228	0	163	48	11185	48	11022	0.0	0.004354926510615134
chr18	ATP9B	79077981	79078157	0	177	0	11884	0	11707	0.0	0.0
chr18	ATP9B	79096475	79096649	0	175	0	11884	0	11709	0.0	0.0
chr18	ATP9B	79176812	79176907	0	96	0	11884	0	11788	0.0	0.0
chr18	ATP9B	79213961	79214038	0	78	0	11884	0	11806	0.0	0.0
chr18	ATP9B	79348131	79348196	0	66	0	11884	0	11818	0.0	0.0
chr18	ATP9B	79375393	79375426	0	34	0	11884	0	11850	0.0	0.0
chr18	ATP9B	79372558	79372685	0	128	0	11884	0	11756	0.0	0.0
chr18	ATP9B	79361738	79361992	0	255	0	11884	0	11629	0.0	0.0
chr18	NFATC1	79410402	79411501	0	1100	0	9083	0	7983	0.0	0.0
chr18	NFATC1	79486247	79486630	0	384	0	9083	0	8699	0.0	0.0
chr18	NFATC1	79486247	79486937	0	691	0	9083	0	8392	0.0	0.0
chr18	CTDP1	79728906	79729069	0	164	0	5318	0	5154	0.0	0.0
chr18	CTDP1	79736354	79736521	0	168	0	5318	0	5150	0.0	0.0
chr18	AC090360.1	80079686	80079808	0	123	0	3912	0	3789	0.0	0.0
chr18	ADNP2	80133691	80133806	0	116	0	5664	0	5548	0.0	0.0
chr18	PARD6G-AS1	80162515	80162603	0	89	0	6002	0	5913	0.0	0.0
chr18	THOC1	264025	264092	7515	68	409694	7360	402179	7292	110.51470588235294	55.15345584201865
chr18	THOC1	260717	260759	761	43	409694	7360	408933	7317	17.697674418604652	55.888068880688806
chr18	ENOSF1	678695	678737	8493	43	2531416	9343	2522923	9300	197.51162790697674	271.2820430107527
chr18	ENOSF1	691203	691276	8088	74	2531416	9343	2523328	9269	109.29729729729729	272.2330348473406
chr18	ENOSF1	697239	697355	8810	117	2531416	9343	2522606	9226	75.2991452991453	273.42358551918494
chr18	ENOSF1	706469	706578	12936	110	2531416	9343	2518480	9233	117.6	272.76941405826926
chr18	ENOSF1	691067	691106	7438	40	2531416	9343	2523978	9303	185.95	271.307965172525
chr18	LINC00470	1278567	1278633	0	67	0	7735	0	7668	0.0	0.0
chr18	LINC00470	1275965	1276077	0	113	0	7735	0	7622	0.0	0.0
chr18	LINC00470	1361142	1361221	0	80	0	7735	0	7655	0.0	0.0
chr18	LINC00470	1358725	1358760	0	36	0	7735	0	7699	0.0	0.0
chr18	LINC00470	1275965	1276087	0	123	0	7735	0	7612	0.0	0.0
chr18	LINC00470	1273360	1273533	0	174	0	7735	0	7561	0.0	0.0
chr18	LINC00470	1267496	1267548	0	53	0	7735	0	7682	0.0	0.0
chr18	LINC00470	1271610	1271819	0	210	0	7735	0	7525	0.0	0.0
chr18	LINC00470	1361176	1361221	0	46	0	7735	0	7689	0.0	0.0
chr18	LINC00470	1278567	1278651	0	85	0	7735	0	7650	0.0	0.0
chr18	LINC00470	1361735	1361834	0	100	0	7735	0	7635	0.0	0.0
chr18	LINC00470	1353406	1353462	0	57	0	7735	0	7678	0.0	0.0
chr18	LINC00470	1365916	1366225	0	310	0	7735	0	7425	0.0	0.0
chr18	AP005230.1	1906363	1906430	0	68	9078	6672	9078	6604	0.0	1.3746214415505753
chr18	AP005230.1	2111643	2111736	0	94	9078	6672	9078	6578	0.0	1.3800547278808148
chr18	AP005230.1	2126199	2126377	816	179	9078	6672	8262	6493	4.558659217877095	1.272447250885569
chr18	AP005230.1	2131496	2131540	0	45	9078	6672	9078	6627	0.0	1.3698506111362607
chr18	METTL4	2544652	2544759	8695	108	212012	3516	203317	3408	80.50925925925925	59.6587441314554
chr18	METTL4	2544194	2544286	3495	93	212012	3516	208517	3423	37.58064516129032	60.91644756061934
chr18	MYOM1	3085044	3085132	0	89	2142	6472	2142	6383	0.0	0.33557888140372866
chr18	MYOM1	3129231	3129519	0	289	2142	6472	2142	6183	0.0	0.34643377001455605
chr18	LINC01895	3348132	3348250	0	119	0	2092	0	1973	0.0	0.0
chr18	LINC01895	3374763	3374959	0	197	0	2092	0	1895	0.0	0.0
chr18	LINC01895	3368560	3368688	0	129	0	2092	0	1963	0.0	0.0
chr18	DLGAP1	3656083	3656113	0	31	102	12099	102	12068	0.0	0.008452104739807755
chr18	ZBTB14	5293971	5294001	38	31	149139	4151	149101	4120	1.2258064516129032	36.189563106796115
chr18	EPB41L3	5398020	5398143	0	124	204	9610	204	9486	0.0	0.021505376344086023
chr18	EPB41L3	5407700	5407736	0	37	204	9610	204	9573	0.0	0.02130993418990912
chr18	EPB41L3	5394676	5394793	0	118	204	9610	204	9492	0.0	0.021491782553729456
chr18	EPB41L3	5415817	5416378	0	562	204	9610	204	9048	0.0	0.022546419098143235
chr18	EPB41L3	5410565	5410619	0	55	204	9610	204	9555	0.0	0.021350078492935635
chr18	EPB41L3	5398650	5399385	0	736	204	9610	204	8874	0.0	0.022988505747126436
chr18	EPB41L3	5398020	5401043	0	3024	204	9610	204	6586	0.0	0.03097479501973884
chr18	EPB41L3	5400968	5401043	0	76	204	9610	204	9534	0.0	0.021397105097545627
chr18	EPB41L3	5400496	5400595	0	100	204	9610	204	9510	0.0	0.02145110410094637
chr18	EPB41L3	5539620	5539698	0	79	204	9610	204	9531	0.0	0.021403840100723954
chr18	EPB41L3	5508164	5508278	0	115	204	9610	204	9495	0.0	0.021484992101105844
chr18	EPB41L3	5518524	5518607	0	84	204	9610	204	9526	0.0	0.02141507453285744
chr18	L3MBTL4	6046727	6046754	0	28	0	7987	0	7959	0.0	0.0
chr18	LINC00668	6926071	6926225	0	155	0	3701	0	3546	0.0	0.0
chr18	LINC00668	6926656	6927584	0	929	0	3701	0	2772	0.0	0.0
chr18	LINC00668	6929496	6929560	0	65	0	3701	0	3636	0.0	0.0
chr18	PPP4R1	9583116	9583275	49237	160	1387250	7841	1338013	7681	307.73125	174.1977607082411
chr18	PPP4R1	9593767	9593874	57467	108	1387250	7841	1329783	7733	532.1018518518518	171.96211043579464
chr18	PPP4R1	9562921	9563046	4548	126	1387250	7841	1382702	7715	36.095238095238095	179.22255346727155
chr18	PPP4R1	9594178	9594234	304	57	1387250	7841	1386946	7784	5.333333333333333	178.179085303186
chr18	PPP4R1	9612456	9612690	102	235	1387250	7841	1387148	7606	0.4340425531914894	182.37549303181697
chr18	AP005209.1	10323533	10323694	0	162	0	2106	0	1944	0.0	0.0
chr18	PIEZO2	10801389	10801428	0	40	0	15683	0	15643	0.0	0.0
chr18	PIEZO2	10682103	10682292	0	190	0	15683	0	15493	0.0	0.0
chr18	PIEZO2	10708274	10708439	0	166	0	15683	0	15517	0.0	0.0
chr18	PIEZO2	10735231	10735330	0	100	0	15683	0	15583	0.0	0.0
chr18	PIEZO2	10774005	10774038	0	34	0	15683	0	15649	0.0	0.0
chr18	PIEZO2	10780324	10780366	0	43	0	15683	0	15640	0.0	0.0
chr18	MPPE1	11886712	11886778	6852	67	385619	5862	378767	5795	102.26865671641791	65.36100086281277
chr18	MPPE1	11888668	11888743	7962	76	385619	5862	377657	5786	104.76315789473684	65.27082613204286
chr18	MPPE1	11906202	11906309	3803	108	385619	5862	381816	5754	35.21296296296296	66.35662148070907
chr18	MPPE1	11884878	11885043	13488	166	385619	5862	372131	5696	81.25301204819277	65.33198735955057
chr18	MPPE1	11895184	11895277	50	94	385619	5862	385569	5768	0.5319148936170213	66.84622052704577
chr18	MPPE1	11886498	11886621	11479	124	385619	5862	374140	5738	92.5725806451613	65.20390379923319
chr18	MPPE1	11886712	11886781	6978	70	385619	5862	378641	5792	99.68571428571428	65.37310082872928
chr18	MPPE1	11905737	11905953	17425	217	385619	5862	368194	5645	80.29953917050692	65.22480070859167
chr18	MPPE1	11897525	11897620	7329	96	385619	5862	378290	5766	76.34375	65.60700659035727
chr18	MPPE1	11905911	11905953	2815	43	385619	5862	382804	5819	65.46511627906976	65.78518645815433
chr18	MPPE1	11902266	11902358	3331	93	385619	5862	382288	5769	35.81720430107527	66.26590396949211
chr18	SPIRE1	12485958	12486000	717	43	886274	6556	885557	6513	16.674418604651162	135.9676032550284
chr18	SPIRE1	12546673	12546904	36995	232	886274	6556	849279	6324	159.46120689655172	134.29459203036052
chr18	SPIRE1	12588375	12588419	0	45	886274	6556	886274	6511	0.0	136.1194900936876
chr18	SPIRE1	12653383	12653440	75	58	886274	6556	886199	6498	1.293103448275862	136.38027085257002
chr18	CEP76	12691358	12691487	13301	130	232172	5989	218871	5859	102.31538461538462	37.35637480798771
chr18	CEP76	12698978	12699203	31180	226	232172	5989	200992	5763	137.9646017699115	34.876279715425994
chr18	CEP76	12692167	12692312	44	146	232172	5989	232128	5843	0.3013698630136986	39.72753722402875
chr18	CEP76	12698978	12699165	29501	188	232172	5989	202671	5801	156.92021276595744	34.93725219789692
chr18	LINC01882	12749293	12749533	0	241	51	1336	51	1095	0.0	0.04657534246575343
chr18	LINC01882	12765276	12765455	0	180	51	1336	51	1156	0.0	0.04411764705882353
chr18	PTPN2	12794383	12794485	38617	103	338938	7407	300321	7304	374.92233009708735	41.11733296823658
chr18	PTPN2	12825809	12825944	8272	136	338938	7407	330666	7271	60.8235294117647	45.477375876770736
chr18	PTPN2	12859163	12859254	7613	92	338938	7407	331325	7315	82.75	45.29391660970608
chr18	PTPN2	12793481	12793574	4395	94	338938	7407	334543	7313	46.755319148936174	45.74634213045262
chr18	PTPN2	12819213	12819282	42	70	338938	7407	338896	7337	0.6	46.18999591113534
chr18	PTPN2	12788064	12788150	384	87	338938	7407	338554	7320	4.413793103448276	46.250546448087434
chr18	PTPN2	12821335	12821425	763	91	338938	7407	338175	7316	8.384615384615385	46.224029524330234
chr18	FAM210A	13671861	13671973	26281	113	465396	4688	439115	4575	232.57522123893804	95.98142076502732
chr18	FAM210A	13697546	13697674	0	129	465396	4688	465396	4559	0.0	102.08291291949989
chr18	FAM210A	13681604	13682105	76512	502	465396	4688	388884	4186	152.41434262948206	92.9010989010989
chr18	FAM210A	13670870	13670968	1470	99	465396	4688	463926	4589	14.848484848484848	101.09522771845718
chr18	FAM210A	13687742	13687882	1836	141	465396	4688	463560	4547	13.02127659574468	101.94853749725094
chr18	ZNF519	14124349	14124476	4067	128	208235	15799	204168	15671	31.7734375	13.028396400995469
chr18	POTEC	14524912	14524983	0	72	0	7131	0	7059	0.0	0.0
chr18	AP005901.1	15322152	15322291	0	140	153	1803	153	1663	0.0	0.09200240529164161
chr18	ROCK1	20960662	20960711	0	50	134599	11109	134599	11059	0.0	12.170991952256081
chr18	ESCO1	21540576	21540700	0	125	4274	5300	4274	5175	0.0	0.8258937198067633
chr18	ABHD3	21683919	21683965	0	47	3125	4348	3125	4301	0.0	0.7265752150662637
chr18	GATA6-AS1	22168043	22168162	0	120	0	2648	0	2528	0.0	0.0
chr18	GATA6-AS1	22168085	22168162	0	78	0	2648	0	2570	0.0	0.0
chr18	TMEM241	23368714	23368750	0	37	60	3480	60	3443	0.0	0.017426662794074933
chr18	TMEM241	23370215	23370261	0	47	60	3480	60	3433	0.0	0.01747742499271774
chr18	TMEM241	23371421	23371470	60	50	60	3480	0	3430	1.2	0.0
chr18	TMEM241	23376826	23376941	0	116	60	3480	60	3364	0.0	0.0178359096313912
chr18	TMEM241	23421366	23421444	0	79	60	3480	60	3401	0.0	0.017641870038224053
chr18	TMEM241	23430630	23430677	0	48	60	3480	60	3432	0.0	0.017482517482517484
chr18	TMEM241	23399565	23399647	0	83	60	3480	60	3397	0.0	0.01766264350897851
chr18	ANKRD29	23612091	23612190	0	100	32401	6292	32401	6192	0.0	5.232719638242894
chr18	ANKRD29	23638848	23638947	128	100	32401	6292	32273	6192	1.28	5.212047803617571
chr18	ANKRD29	23609223	23609291	90	69	32401	6292	32311	6223	1.3043478260869565	5.192190261931544
chr18	OSBPL1A	24178012	24178195	0	184	35137	7984	35137	7800	0.0	4.5047435897435895
chr18	OSBPL1A	24341546	24341658	0	113	35137	7984	35137	7871	0.0	4.464108753652649
chr18	OSBPL1A	24301292	24301324	0	33	35137	7984	35137	7951	0.0	4.419192554395673
chr18	OSBPL1A	24368366	24368372	0	7	35137	7984	35137	7977	0.0	4.404788767707158
chr18	LINC01894	24946245	24946374	0	130	0	1736	0	1606	0.0	0.0
chr18	LINC01894	24977115	24977200	0	86	0	1736	0	1650	0.0	0.0
chr18	ZNF521	25350906	25350947	0	42	51	6243	51	6201	0.0	0.00822447992259313
chr18	ZNF521	25224035	25224115	0	81	51	6243	51	6162	0.0	0.008276533592989289
chr18	ZNF521	25350906	25350993	0	88	51	6243	51	6155	0.0	0.008285946385052803
chr18	SS18	26035830	26035923	0	94	51	6099	51	6005	0.0	0.008492922564529558
chr18	SS18	26078075	26078160	0	86	51	6099	51	6013	0.0	0.00848162314984201
chr18	SS18	26087500	26087577	0	78	51	6099	51	6021	0.0	0.008470353761833582
chr18	SS18	26082362	26082528	0	167	51	6099	51	5932	0.0	0.008597437626432907
chr18	SS18	26080304	26080423	0	120	51	6099	51	5979	0.0	0.008529854490717512
chr18	SS18	26068493	26068557	0	65	51	6099	51	6034	0.0	0.008452104739807755
chr18	SS18	26084051	26084175	0	125	51	6099	51	5974	0.0	0.008536993639102779
chr18	SS18	26079010	26079125	0	116	51	6099	51	5983	0.0	0.008524151763329433
chr18	SS18	26081224	26081365	0	142	51	6099	51	5957	0.0	0.008561356387443344
chr18	SS18	26079010	26079146	0	137	51	6099	51	5962	0.0	0.008554176450855417
chr18	KCTD1	26476514	26476659	0	146	51	8856	51	8710	0.0	0.005855338691159587
chr18	AQP4	26860771	26860852	0	82	51	5950	51	5868	0.0	0.008691206543967281
chr18	CHST9	26944328	26944366	0	39	0	11518	0	11479	0.0	0.0
chr18	AC090403.1	27340496	27341131	0	636	0	3255	0	2619	0.0	0.0
chr18	AC090403.1	27592707	27592874	0	168	0	3255	0	3087	0.0	0.0
chr18	CDH2	28097062	28097254	0	193	0	7955	0	7762	0.0	0.0
chr18	CDH2	28159148	28159295	0	148	0	7955	0	7807	0.0	0.0
chr18	DSC3	30994453	30994496	0	44	0	7716	0	7672	0.0	0.0
chr18	DSC2	31068298	31068344	0	47	102	12520	102	12473	0.0	0.00817766375370801
chr18	DSC2	31091530	31091567	0	38	102	12520	102	12482	0.0	0.008171767344976766
chr18	DSC1	31130792	31130838	0	47	0	4288	0	4241	0.0	0.0
chr18	DSG1-AS1	31364148	31364285	0	138	36	1157	36	1019	0.0	0.03532875368007851
chr18	B4GALT6	31638643	31638760	0	118	0	5316	0	5198	0.0	0.0
chr18	B4GALT6	31666255	31666372	0	118	0	5316	0	5198	0.0	0.0
chr18	B4GALT6	31645354	31645479	0	126	0	5316	0	5190	0.0	0.0
chr18	CCDC178	33092760	33092910	0	151	18547	4504	18547	4353	0.0	4.260739719733517
chr18	CCDC178	33223105	33223219	0	115	18547	4504	18547	4389	0.0	4.225791752107542
chr18	CCDC178	32983280	32983352	0	73	18547	4504	18547	4431	0.0	4.1857368539832995
chr18	NOL4	33957325	33957517	0	193	809	5584	809	5391	0.0	0.1500649230198479
chr18	NOL4	34105048	34105160	0	113	809	5584	809	5471	0.0	0.1478705903856699
chr18	NOL4	33943064	33943178	0	115	809	5584	809	5469	0.0	0.1479246663009691
chr18	NOL4	34128848	34128889	0	42	809	5584	809	5542	0.0	0.14597618188379646
chr18	NOL4	34121233	34121316	0	84	809	5584	809	5500	0.0	0.14709090909090908
chr18	NOL4	34183517	34183626	0	110	809	5584	809	5474	0.0	0.14778955060284985
chr18	AC068506.1	34893159	34893644	0	486	0	1656	0	1170	0.0	0.0
chr18	ZSCAN30	35267475	35267679	0	205	51	5878	51	5673	0.0	0.008989952406134321
chr18	ZNF396	35376126	35376270	0	145	0	4789	0	4644	0.0	0.0
chr18	ZNF396	35374469	35374823	0	355	0	4789	0	4434	0.0	0.0
chr18	AC007998.3	35447484	35447542	0	59	0	921	0	862	0.0	0.0
chr18	INO80C	35478281	35478349	0	69	0	5014	0	4945	0.0	0.0
chr18	INO80C	35496774	35496882	0	109	0	5014	0	4905	0.0	0.0
chr18	AC118757.1	35952677	35952799	0	123	0	734	0	611	0.0	0.0
chr18	RPRD1A	35988731	35988835	0	105	0	5239	0	5134	0.0	0.0
chr18	RPRD1A	36040806	36040865	0	60	0	5239	0	5179	0.0	0.0
chr18	RPRD1A	36062977	36063075	0	99	0	5239	0	5140	0.0	0.0
chr18	SLC39A6	36126218	36127016	0	799	0	3680	0	2881	0.0	0.0
chr18	TPGS2	36781798	36781922	0	125	5074	9685	5074	9560	0.0	0.5307531380753138
chr18	TPGS2	36805373	36805502	0	130	5074	9685	5074	9555	0.0	0.5310308738880167
chr18	TPGS2	36805373	36805397	0	25	5074	9685	5074	9660	0.0	0.5252587991718427
chr18	TPGS2	36823802	36823871	0	70	5074	9685	5074	9615	0.0	0.5277171086843474
chr18	TPGS2	36820967	36821129	0	163	5074	9685	5074	9522	0.0	0.532871245536652
chr18	TPGS2	36817594	36817771	0	178	5074	9685	5074	9507	0.0	0.5337120016829704
chr18	CELF4	37259180	37259264	0	85	2099	4935	2099	4850	0.0	0.43278350515463915
chr18	CELF4	37264673	37264757	0	85	2099	4935	2099	4850	0.0	0.43278350515463915
chr18	CELF4	37247185	37247270	0	86	2099	4935	2099	4849	0.0	0.4328727572695401
chr18	CELF4	37264673	37264754	0	82	2099	4935	2099	4853	0.0	0.43251596950339993
chr18	CELF4	37259120	37259264	15	145	2099	4935	2084	4790	0.10344827586206896	0.4350730688935282
chr18	MIR924HG	39233108	39233530	0	423	416	11691	416	11268	0.0	0.03691870784522542
chr18	MIR924HG	39699548	39699635	0	88	416	11691	416	11603	0.0	0.03585279669051108
chr18	MIR924HG	39208598	39208789	0	192	416	11691	416	11499	0.0	0.03617705887468475
chr18	MIR924HG	39388428	39388527	0	100	416	11691	416	11591	0.0	0.035889914588905183
chr18	MIR924HG	39535457	39535615	176	159	416	11691	240	11532	1.1069182389937107	0.02081165452653486
chr18	MIR924HG	39293185	39293304	0	120	416	11691	416	11571	0.0	0.03595194883761127
chr18	MIR924HG	39214127	39214269	21	143	416	11691	395	11548	0.14685314685314685	0.03420505715275372
chr18	MIR924HG	39751328	39751360	0	33	416	11691	416	11658	0.0	0.035683650711957456
chr18	MIR924HG	39233402	39233530	0	129	416	11691	416	11562	0.0	0.03597993426742778
chr18	MIR924HG	39327765	39327951	0	187	416	11691	416	11504	0.0	0.03616133518776078
chr18	MIR924HG	39712655	39712803	0	149	416	11691	416	11542	0.0	0.03604228036735401
chr18	MIR924HG	39291014	39291114	0	101	416	11691	416	11590	0.0	0.035893011216566004
chr18	MIR924HG	39293185	39293406	0	222	416	11691	416	11469	0.0	0.03627168890051443
chr18	MIR924HG	39784074	39784242	0	169	416	11691	416	11522	0.0	0.03610484290921715
chr18	MIR924HG	39435437	39435533	0	97	416	11691	416	11594	0.0	0.03588062791098844
chr18	MIR924HG	39784099	39784242	0	144	416	11691	416	11547	0.0	0.036026673594873125
chr18	KC6	41521376	41521496	0	121	0	4708	0	4587	0.0	0.0
chr18	KC6	41564798	41564898	0	101	0	4708	0	4607	0.0	0.0
chr18	RIT2	42920696	42920760	0	65	0	2054	0	1989	0.0	0.0
chr18	RIT2	42948986	42949048	0	63	0	2054	0	1991	0.0	0.0
chr18	LINC01478	44325151	44325428	51	278	2643	4614	2592	4336	0.18345323741007194	0.5977859778597786
chr18	LINC01478	44423932	44423973	0	42	2643	4614	2643	4572	0.0	0.5780839895013123
chr18	LINC01478	44383295	44383428	394	134	2643	4614	2249	4480	2.9402985074626864	0.5020089285714285
chr18	LINC01478	44393822	44393889	276	68	2643	4614	2367	4546	4.0588235294117645	0.5206775186977562
chr18	LINC01478	44518224	44518368	258	145	2643	4614	2385	4469	1.7793103448275862	0.5336764376818081
chr18	LINC01478	44518224	44518363	243	140	2643	4614	2400	4474	1.7357142857142858	0.5364327223960662
chr18	LINC01478	44291699	44291787	0	89	2643	4614	2643	4525	0.0	0.5840883977900553
chr18	LINC01478	44518224	44518404	306	181	2643	4614	2337	4433	1.6906077348066297	0.5271824949244304
chr18	LINC01478	44419854	44419892	0	39	2643	4614	2643	4575	0.0	0.5777049180327869
chr18	LINC01478	44373284	44373483	153	200	2643	4614	2490	4414	0.765	0.5641141821477118
chr18	SLC14A2-AS1	45440376	45440472	0	97	163	1399	163	1302	0.0	0.1251920122887865
chr18	EPG5	45876235	45876342	0	108	51	13775	51	13667	0.0	0.0037316163020414137
chr18	EPG5	45907163	45907289	0	127	51	13775	51	13648	0.0	0.0037368112543962485
chr18	EPG5	45870566	45870742	0	177	51	13775	51	13598	0.0	0.003750551551698779
chr18	PSTPIP2	45992105	45992202	0	98	459	3439	459	3341	0.0	0.13738401676144868
chr18	ATP5F1A	46098171	46098279	0	109	1187	7373	1187	7264	0.0	0.16340859030837004
chr18	ATP5F1A	46093179	46093365	612	187	1187	7373	575	7186	3.272727272727273	0.08001669913721124
chr18	ATP5F1A	46093179	46093362	612	184	1187	7373	575	7189	3.3260869565217392	0.0799833078314091
chr18	LOXHD1	46521096	46521282	0	187	91845	8983	91845	8796	0.0	10.441678035470668
chr18	LOXHD1	46557901	46558055	0	155	91845	8983	91845	8828	0.0	10.403828726778432
chr18	LOXHD1	46533705	46533759	0	55	91845	8983	91845	8928	0.0	10.287298387096774
chr18	ST8SIA5	46721361	46721469	0	109	2264	15684	2264	15575	0.0	0.14536115569823435
chr18	ST8SIA5	46704571	46704664	0	94	2264	15684	2264	15590	0.0	0.14522129570237333
chr18	PIAS2	46864163	46864248	0	86	26488	17092	26488	17006	0.0	1.5575679172056922
chr18	PIAS2	46890579	46891054	0	476	26488	17092	26488	16616	0.0	1.5941261434761675
chr18	PIAS2	46903526	46903633	0	108	26488	17092	26488	16984	0.0	1.5595854922279793
chr18	PIAS2	46904101	46904206	0	106	26488	17092	26488	16986	0.0	1.559401860355587
chr18	PIAS2	46906226	46906315	0	90	26488	17092	26488	17002	0.0	1.5579343606634513
chr18	HDHD2	47130243	47130328	0	86	0	4612	0	4526	0.0	0.0
chr18	HDHD2	47137234	47137338	0	105	0	4612	0	4507	0.0	0.0
chr18	HDHD2	47137234	47137296	0	63	0	4612	0	4549	0.0	0.0
chr18	HDHD2	47149048	47149108	0	61	0	4612	0	4551	0.0	0.0
chr18	SMAD2	47870474	47870564	51	91	785738	36439	785687	36348	0.5604395604395604	21.61568724551557
chr18	SMAD2	47920071	47920169	38140	99	785738	36439	747598	36340	385.25252525252523	20.572317006053936
chr18	SMAD2	47930360	47930446	0	87	785738	36439	785738	36352	0.0	21.61471170774648
chr18	ZBTB7C	48338173	48338398	0	226	0	7629	0	7403	0.0	0.0
chr18	ZBTB7C	48162347	48162397	0	51	0	7629	0	7578	0.0	0.0
chr18	ZBTB7C	48087669	48087798	0	130	0	7629	0	7499	0.0	0.0
chr18	ZBTB7C	48088255	48088355	0	101	0	7629	0	7528	0.0	0.0
chr18	ZBTB7C	48076935	48077003	0	69	0	7629	0	7560	0.0	0.0
chr18	ZBTB7C	48180386	48180477	0	92	0	7629	0	7537	0.0	0.0
chr18	ZBTB7C	48185323	48185455	0	133	0	7629	0	7496	0.0	0.0
chr18	ZBTB7C	48165130	48165257	0	128	0	7629	0	7501	0.0	0.0
chr18	ZBTB7C	48072459	48072610	0	152	0	7629	0	7477	0.0	0.0
chr18	ZBTB7C	48180329	48180477	0	149	0	7629	0	7480	0.0	0.0
chr18	ZBTB7C	48408357	48408655	0	299	0	7629	0	7330	0.0	0.0
chr18	ZBTB7C	48364153	48364214	0	62	0	7629	0	7567	0.0	0.0
chr18	ZBTB7C	48374221	48374313	0	93	0	7629	0	7536	0.0	0.0
chr18	ZBTB7C	48252160	48252298	0	139	0	7629	0	7490	0.0	0.0
chr18	ZBTB7C	48165130	48165253	0	124	0	7629	0	7505	0.0	0.0
chr18	DYM	49209550	49209715	0	166	161	12141	161	11975	0.0	0.013444676409185804
chr18	DYM	49093216	49093311	0	96	161	12141	161	12045	0.0	0.013366542133665421
chr18	DYM	49329572	49329707	0	136	161	12141	161	12005	0.0	0.013411078717201166
chr18	DYM	49375647	49375724	0	78	161	12141	161	12063	0.0	0.013346597032247368
chr18	DYM	49393644	49393742	0	99	161	12141	161	12042	0.0	0.013369872114266733
chr18	DYM	49417934	49418057	0	124	161	12141	161	12017	0.0	0.013397686610634934
chr18	RPL17	49491404	49491445	0	42	0	2096	0	2054	0.0	0.0
chr18	RPL17	49488499	49488566	0	68	0	2096	0	2028	0.0	0.0
chr18	RPL17	49491745	49491833	0	89	0	2096	0	2007	0.0	0.0
chr18	RPL17	49491735	49491833	0	99	0	2096	0	1997	0.0	0.0
chr18	MYO5B	49856812	49856890	0	79	0	10608	0	10529	0.0	0.0
chr18	MBD1	50273333	50273471	0	139	0	5812	0	5673	0.0	0.0
chr18	MBD1	50274185	50274350	0	166	0	5812	0	5646	0.0	0.0
chr18	MBD1	50274976	50275045	0	70	0	5812	0	5742	0.0	0.0
chr18	MBD1	50275369	50275444	0	76	0	5812	0	5736	0.0	0.0
chr18	MBD1	50271468	50271540	0	73	0	5812	0	5739	0.0	0.0
chr18	MBD1	50274185	50274353	0	169	0	5812	0	5643	0.0	0.0
chr18	MBD1	50275834	50275981	0	148	0	5812	0	5664	0.0	0.0
chr18	MBD1	50273333	50273426	0	94	0	5812	0	5718	0.0	0.0
chr18	CXXC1	50285324	50285351	0	28	0	3854	0	3826	0.0	0.0
chr18	CXXC1	50287422	50287508	0	87	0	3854	0	3767	0.0	0.0
chr18	MRO	50801348	50801504	0	157	0	5535	0	5378	0.0	0.0
chr18	MRO	50809301	50809404	0	104	0	5535	0	5431	0.0	0.0
chr18	MRO	50819580	50819702	0	123	0	5535	0	5412	0.0	0.0
chr18	MRO	50816123	50816162	0	40	0	5535	0	5495	0.0	0.0
chr18	MRO	50806703	50806850	0	148	0	5535	0	5387	0.0	0.0
chr18	MBD2	54187713	54187837	0	125	34	5695	34	5570	0.0	0.006104129263913824
chr18	STARD6	54357054	54357167	0	114	3812	1745	3812	1631	0.0	2.3372164316370325
chr18	STARD6	54355770	54355850	0	81	3812	1745	3812	1664	0.0	2.2908653846153846
chr18	TCF4	55259948	55260027	0	80	106663	22459	106663	22379	0.0	4.76620939273426
chr18	TCF4	55275618	55275752	0	135	106663	22459	106663	22324	0.0	4.7779519799319115
chr18	TCF4	55587044	55587136	0	93	106663	22459	106663	22366	0.0	4.76897970133238
chr18	TCF4	55586920	55587136	0	217	106663	22459	106663	22242	0.0	4.795566945418577
chr18	TCF4	55284286	55284408	0	123	106663	22459	106663	22336	0.0	4.775385028653295
chr18	TCF4	55518981	55519024	0	44	106663	22459	106663	22415	0.0	4.758554539370957
chr18	TCF4	55401688	55401777	0	90	106663	22459	106663	22369	0.0	4.7683401135500025
chr18	TCF4	55403453	55403518	507	66	106663	22459	106156	22393	7.681818181818182	4.740588576787389
chr18	TCF4	55631297	55631388	0	92	106663	22459	106663	22367	0.0	4.768766486341486
chr18	TCF4	55482149	55482256	0	108	106663	22459	106663	22351	0.0	4.772180215650306
chr18	TCF4	55596105	55596226	0	122	106663	22459	106663	22337	0.0	4.775171240542598
chr18	AC006305.1	56037040	56037222	102	183	33543	3205	33441	3022	0.5573770491803278	11.06585043017869
chr18	LINC01539	56087638	56087760	0	123	147	4888	147	4765	0.0	0.030849947534102834
chr18	LINC01539	56090184	56090303	0	120	147	4888	147	4768	0.0	0.03083053691275168
chr18	LINC01539	56122292	56122529	45	238	147	4888	102	4650	0.18907563025210083	0.02193548387096774
chr18	LINC01539	56121277	56121446	0	170	147	4888	147	4718	0.0	0.03115727002967359
chr18	LINC01539	56095829	56096096	0	268	147	4888	147	4620	0.0	0.031818181818181815
chr18	LINC01539	56122292	56122488	45	197	147	4888	102	4691	0.22842639593908629	0.021743764655723728
chr18	LINC01539	56129800	56129973	0	174	147	4888	147	4714	0.0	0.031183708103521425
chr18	LINC01539	56121622	56121957	0	336	147	4888	147	4552	0.0	0.032293497363796136
chr18	LINC01539	56092751	56092959	0	209	147	4888	147	4679	0.0	0.03141696943791408
chr18	LINC01539	56102690	56102829	0	140	147	4888	147	4748	0.0	0.030960404380791912
chr18	LINC01539	56096006	56096096	0	91	147	4888	147	4797	0.0	0.030644152595372107
chr18	LINC01539	56121622	56121722	0	101	147	4888	147	4787	0.0	0.030708167954877793
chr18	TXNL1	56626161	56626266	266	106	189035	9274	188769	9168	2.509433962264151	20.589986910994764
chr18	TXNL1	56638342	56639039	2244	698	189035	9274	186791	8576	3.2148997134670485	21.78066697761194
chr18	TXNL1	56638961	56639039	0	79	189035	9274	189035	9195	0.0	20.558455682436108
chr18	TXNL1	56647448	56647535	529	88	189035	9274	188506	9186	6.011363636363637	20.521010232963206
chr18	LINC-ROR	57060352	57060516	0	165	90	3868	90	3703	0.0	0.024304617877396704
chr18	LINC-ROR	57058886	57059243	0	358	90	3868	90	3510	0.0	0.02564102564102564
chr18	LINC-ROR	57059202	57059243	0	42	90	3868	90	3826	0.0	0.023523261892315735
chr18	FECH	57559144	57559243	0	100	2338	8798	2338	8698	0.0	0.26879742469533224
chr18	FECH	57580072	57580199	0	128	2338	8798	2338	8670	0.0	0.2696655132641292
chr18	FECH	57580054	57580199	0	146	2338	8798	2338	8652	0.0	0.2702265372168285
chr18	FECH	57585863	57585973	0	111	2338	8798	2338	8687	0.0	0.26913779210314265
chr18	NARS1	57611636	57611707	0	72	252	3990	252	3918	0.0	0.06431852986217458
chr18	NARS1	57615640	57615730	33	91	252	3990	219	3899	0.3626373626373626	0.05616824826878687
chr18	NARS1	57620568	57620651	0	84	252	3990	252	3906	0.0	0.06451612903225806
chr18	ATP8B1	57704554	57704668	0	115	9495	7060	9495	6945	0.0	1.367170626349892
chr18	ATP8B1	57706489	57706587	0	99	9495	7060	9495	6961	0.0	1.3640281568740125
chr18	ATP8B1	57659742	57659815	0	74	9495	7060	9495	6986	0.0	1.3591468651588892
chr18	LINC01897	57961505	57961624	0	120	0	409	0	289	0.0	0.0
chr18	LINC01897	57961501	57961624	0	124	0	409	0	285	0.0	0.0
chr18	RAX	59272360	59272614	816	255	7850	3726	7034	3471	3.2	2.0265053298761164
chr18	AC113137.1	60827741	60827794	0	54	2596	1770	2596	1716	0.0	1.5128205128205128
chr18	AC090409.2	61573221	61573337	0	117	0	615	0	498	0.0	0.0
chr18	PIGN	62090475	62090578	0	104	0	17779	0	17675	0.0	0.0
chr18	PIGN	62113133	62113316	0	184	0	17779	0	17595	0.0	0.0
chr18	PIGN	62140419	62140479	0	61	0	17779	0	17718	0.0	0.0
chr18	PIGN	62162252	62162329	0	78	0	17779	0	17701	0.0	0.0
chr18	PIGN	62163530	62163656	0	127	0	17779	0	17652	0.0	0.0
chr18	PIGN	62154544	62154651	0	108	0	17779	0	17671	0.0	0.0
chr18	PIGN	62070389	62070506	0	118	0	17779	0	17661	0.0	0.0
chr18	PIGN	62103588	62103599	0	12	0	17779	0	17767	0.0	0.0
chr18	PIGN	62103718	62103799	0	82	0	17779	0	17697	0.0	0.0
chr18	BCL2	63301661	63301865	0	205	51	8671	51	8466	0.0	0.006024096385542169
chr18	BCL2	63280886	63281214	0	329	51	8671	51	8342	0.0	0.0061136418125149845
chr18	KDSR	63335256	63335358	0	103	0	8861	0	8758	0.0	0.0
chr18	KDSR	63350887	63351079	0	193	0	8861	0	8668	0.0	0.0
chr18	KDSR	63366404	63366674	0	271	0	8861	0	8590	0.0	0.0
chr18	KDSR	63366249	63366308	0	60	0	8861	0	8801	0.0	0.0
chr18	KDSR	63350887	63351077	0	191	0	8861	0	8670	0.0	0.0
chr18	VPS4B	63399241	63399323	0	83	0	3635	0	3552	0.0	0.0
chr18	VPS4B	63407431	63407499	0	69	0	3635	0	3566	0.0	0.0
chr18	SERPINB4	63641759	63641888	0	130	0	1979	0	1849	0.0	0.0
chr18	SERPINB3	63656830	63656986	0	157	0	1715	0	1558	0.0	0.0
chr18	LINC00305	64110854	64111107	0	254	0	2884	0	2630	0.0	0.0
chr18	LINC00305	64111663	64111810	0	148	0	2884	0	2736	0.0	0.0
chr18	LINC00305	64082830	64082901	0	72	0	2884	0	2812	0.0	0.0
chr18	CDH19	66596158	66596303	0	146	5847	6878	5847	6732	0.0	0.8685383244206774
chr18	AC022655.1	67675054	67675302	51	249	255	634	204	385	0.20481927710843373	0.5298701298701298
chr18	TMX3	68700404	68700485	0	82	1531	7188	1531	7106	0.0	0.2154517309316071
chr18	TMX3	68701744	68701790	0	47	1531	7188	1531	7141	0.0	0.21439574289315222
chr18	TMX3	68710020	68710144	0	125	1531	7188	1531	7063	0.0	0.2167634149794705
chr18	TMX3	68701615	68701667	0	53	1531	7188	1531	7135	0.0	0.2145760336370007
chr18	CD226	69944483	69944568	0	86	199	13672	199	13586	0.0	0.014647431179155013
chr18	RTTN	70053294	70053514	0	221	582	18645	582	18424	0.0	0.031589231437255755
chr18	RTTN	70065828	70065922	0	95	582	18645	582	18550	0.0	0.03137466307277628
chr18	RTTN	70127501	70127741	0	241	582	18645	582	18404	0.0	0.03162356009563139
chr18	RTTN	70140099	70140188	0	90	582	18645	582	18555	0.0	0.031366208569118835
chr18	RTTN	70022203	70022248	0	46	582	18645	582	18599	0.0	0.0312920049465025
chr18	RTTN	70056318	70056387	0	70	582	18645	582	18575	0.0	0.03133243606998654
chr18	RTTN	70078608	70078738	0	131	582	18645	582	18514	0.0	0.03143567030355407
chr18	RTTN	70061311	70061400	0	90	582	18645	582	18555	0.0	0.031366208569118835
chr18	RTTN	70128357	70128546	0	190	582	18645	582	18455	0.0	0.03153616905987537
chr18	RTTN	70128053	70128098	0	46	582	18645	582	18599	0.0	0.0312920049465025
chr18	CBLN2	72541803	72542326	0	524	153	5468	153	4944	0.0	0.030946601941747573
chr18	LINC02864	73200652	73200789	0	138	0	8810	0	8672	0.0	0.0
chr18	FBXO15	74147493	74147579	0	87	2651	6149	2651	6062	0.0	0.4373144176839327
chr18	FBXO15	74140201	74140312	0	112	2651	6149	2651	6037	0.0	0.43912539340732154
chr18	FBXO15	74140723	74140773	0	51	2651	6149	2651	6098	0.0	0.43473269924565433
chr18	CYB5A	74260914	74260944	0	31	51	8119	51	8088	0.0	0.006305637982195846
chr18	CYB5A	74256829	74256853	0	25	51	8119	51	8094	0.0	0.006300963676797628
chr18	SMIM21	75418785	75418916	0	132	0	4013	0	3881	0.0	0.0
chr18	ZNF516	76370527	76370595	0	69	0	7584	0	7515	0.0	0.0
chr18	ZNF516	76371466	76371571	0	106	0	7584	0	7478	0.0	0.0
chr18	LINC01927	76638207	76638276	0	70	0	1701	0	1631	0.0	0.0
chr18	LINC01927	76638548	76638688	0	141	0	1701	0	1560	0.0	0.0
chr18	MBP	76988494	76988527	0	34	0	6992	0	6958	0.0	0.0
chr18	MBP	77009848	77009926	0	79	0	6992	0	6913	0.0	0.0
chr18	MBP	77016831	77017268	0	438	0	6992	0	6554	0.0	0.0
chr18	MBP	76984774	76984894	0	121	0	6992	0	6871	0.0	0.0
chr18	MBP	76988299	76988527	0	229	0	6992	0	6763	0.0	0.0
chr18	MBP	76985203	76985210	0	8	0	6992	0	6984	0.0	0.0
chr18	MBP	77016831	77016846	0	16	0	6992	0	6976	0.0	0.0
chr18	MBP	76982580	76982623	0	44	0	6992	0	6948	0.0	0.0
chr18	MBP	76986905	76986983	0	79	0	6992	0	6913	0.0	0.0
chr18	MBP	76990826	76990914	0	89	0	6992	0	6903	0.0	0.0
chr18	LINC01029	77990092	77990174	0	83	765	4456	765	4373	0.0	0.17493711410930712
chr18	LINC01029	77979494	77979629	0	136	765	4456	765	4320	0.0	0.17708333333333334
chr18	SLC66A2	79919183	79919400	0	218	0	4902	0	4684	0.0	0.0
chr18	SLC66A2	79933968	79934022	0	55	0	4902	0	4847	0.0	0.0
chr18	SLC66A2	79949686	79949838	0	153	0	4902	0	4749	0.0	0.0
chr18	SLC66A2	79930227	79930311	0	85	0	4902	0	4817	0.0	0.0
chr18	SLC66A2	79949518	79949655	0	138	0	4902	0	4764	0.0	0.0
chr18	SLC66A2	79949518	79949636	0	119	0	4902	0	4783	0.0	0.0
chr18	SLC66A2	79947266	79947341	0	76	0	4902	0	4826	0.0	0.0
chr18	TXNL4A	79977597	79977701	0	105	0	5227	0	5122	0.0	0.0
chr18	TXNL4A	80030520	80030577	0	58	0	5227	0	5169	0.0	0.0
chr18	TXNL4A	79976717	79976787	0	71	0	5227	0	5156	0.0	0.0
chr18	TXNL4A	79986601	79986750	0	150	0	5227	0	5077	0.0	0.0
chr18	TXNL4A	79985796	79985866	0	71	0	5227	0	5156	0.0	0.0
chr18	TXNL4A	79979332	79979640	0	309	0	5227	0	4918	0.0	0.0
chr18	PARD6G	80201963	80202018	0	56	0	4197	0	4141	0.0	0.0
chr19	LINC01002	201755	201813	2	59	54808	7755	54806	7696	0.03389830508474576	7.121361746361746
chr19	LINC01002	204833	205076	1679	244	54808	7755	53129	7511	6.881147540983607	7.073492211423246
chr19	LINC01002	204817	205076	1679	260	54808	7755	53129	7495	6.457692307692308	7.088592394929953
chr19	LINC01002	204843	205076	1679	234	54808	7755	53129	7521	7.1752136752136755	7.064087222443824
chr19	LINC01002	208957	209014	9	58	54808	7755	54799	7697	0.15517241379310345	7.11952708847603
chr19	LINC01002	205169	205227	616	59	54808	7755	54192	7696	10.440677966101696	7.041580041580041
chr19	LINC01002	223966	224048	1464	83	54808	7755	53344	7672	17.63855421686747	6.953076120959333
chr19	LINC01002	229635	230164	5487	530	54808	7755	49321	7225	10.352830188679246	6.8264359861591695
chr19	MIER2	336082	336173	3847	92	188073	7934	184226	7842	41.81521739130435	23.492221372098953
chr19	THEG	373939	374011	0	73	51	2094	51	2021	0.0	0.025235032162295893
chr19	SHC2	439232	439491	0	260	11469	4146	11469	3886	0.0	2.951363870303654
chr19	ODF3L2	472393	472501	0	109	0	1722	0	1613	0.0	0.0
chr19	MED16	871925	872118	16169	194	271794	3907	255625	3713	83.34536082474227	68.84594667384864
chr19	MED16	876973	877180	16474	208	271794	3907	255320	3699	79.20192307692308	69.02406055690727
chr19	MED16	885769	886201	48601	433	271794	3907	223193	3474	112.24249422632795	64.24668969487622
chr19	MED16	889637	889807	6973	171	271794	3907	264821	3736	40.77777777777778	70.8835653104925
chr19	MED16	871605	871662	0	58	271794	3907	271794	3849	0.0	70.61418550272798
chr19	MED16	872912	873009	0	98	271794	3907	271794	3809	0.0	71.35573641375689
chr19	R3HDM4	901421	901546	18909	126	295331	2427	276422	2301	150.07142857142858	120.13124728378966
chr19	R3HDM4	901419	901546	18909	128	295331	2427	276422	2299	147.7265625	120.23575467594607
chr19	TMEM259	1010990	1011095	1688	106	949744	3940	948056	3834	15.924528301886792	247.27595200834637
chr19	TMEM259	1011095	1011195	56564	101	949744	3940	893180	3839	560.039603960396	232.65954675696796
chr19	POLR2E	1090907	1090988	82996	82	762390	2591	679394	2509	1012.1463414634146	270.7827819848545
chr19	POLR2E	1093903	1094078	119767	176	762390	2591	642623	2415	680.4943181818181	266.09648033126297
chr19	POLR2E	1093755	1093903	984	149	762390	2591	761406	2442	6.604026845637584	311.7960687960688
chr19	CBARP	1235336	1235390	747	55	29341	2939	28594	2884	13.581818181818182	9.914701803051317
chr19	PCSK4	1482895	1483020	688	126	16392	3654	15704	3528	5.4603174603174605	4.45124716553288
chr19	PCSK4	1487602	1487691	244	90	16392	3654	16148	3564	2.7111111111111112	4.530864197530864
chr19	PCSK4	1489792	1489897	399	106	16392	3654	15993	3548	3.7641509433962264	4.5076099210823
chr19	ADAMTSL5	1511624	1511727	0	104	6861	2885	6861	2781	0.0	2.4670981661272924
chr19	ADAMTSL5	1511624	1511772	0	149	6861	2885	6861	2736	0.0	2.5076754385964914
chr19	MBD3	1583252	1583380	0	129	744850	7530	744850	7401	0.0	100.64180516146466
chr19	TCF3	1619315	1619474	61521	160	1381814	5864	1320293	5704	384.50625	231.4679172510519
chr19	TCF3	1612206	1612433	68701	228	1381814	5864	1313113	5636	301.3201754385965	232.98669268985097
chr19	TCF3	1615284	1615485	63380	202	1381814	5864	1318434	5662	313.76237623762376	232.85658777817025
chr19	TCF3	1615284	1615520	71993	237	1381814	5864	1309821	5627	303.7679324894515	232.7743024702328
chr19	TCF3	1615284	1615515	70788	232	1381814	5864	1311026	5632	305.12068965517244	232.78160511363637
chr19	TCF3	1619315	1619471	60897	157	1381814	5864	1320917	5707	387.8789808917197	231.45558086560365
chr19	ATP8B3	1789889	1789989	0	101	182370	7043	182370	6942	0.0	26.270527225583404
chr19	ABHD17A	1884468	1884543	918	76	244868	4179	243950	4103	12.078947368421053	59.45649524737997
chr19	ABHD17A	1880895	1881048	0	154	244868	4179	244868	4025	0.0	60.83677018633541
chr19	ABHD17A	1878663	1878904	11370	242	244868	4179	233498	3937	46.98347107438016	59.308610617221234
chr19	BTBD2	1991876	1992056	3472	181	542084	5031	538612	4850	19.18232044198895	111.0540206185567
chr19	BTBD2	2013546	2013880	1320	335	542084	5031	540764	4696	3.9402985074626864	115.1541737649063
chr19	BTBD2	2028707	2028834	0	128	542084	5031	542084	4903	0.0	110.56169692025291
chr19	BTBD2	2017044	2017094	0	51	542084	5031	542084	4980	0.0	108.85220883534137
chr19	MKNK2	2039630	2039856	22576	227	415667	5232	393091	5005	99.45374449339207	78.53966033966034
chr19	MKNK2	2046185	2046283	11836	99	415667	5232	403831	5133	119.55555555555556	78.67348529125267
chr19	MOB3A	2095240	2095323	663	84	419848	4154	419185	4070	7.892857142857143	102.99385749385749
chr19	AP3D1	2127151	2127201	54989	51	2313831	8084	2258842	8033	1078.2156862745098	281.1953193078551
chr19	AP3D1	2133396	2133484	789	89	2313831	8084	2313042	7995	8.865168539325843	289.31106941838647
chr19	PLEKHJ1	2234149	2234240	39670	92	317968	3179	278298	3087	431.19565217391306	90.15160349854227
chr19	LSM7	2325979	2326139	3483	161	268543	1691	265060	1530	21.633540372670808	173.24183006535947
chr19	GNG7	2516941	2517082	0	142	14835	4553	14835	4411	0.0	3.36318295171163
chr19	DIRAS1	2719151	2719182	0	32	219888	3442	219888	3410	0.0	64.483284457478
chr19	SGTA	2759256	2759294	32810	39	1468669	7950	1435859	7911	841.2820512820513	181.5015800783719
chr19	SGTA	2767579	2767686	125011	108	1468669	7950	1343658	7842	1157.5092592592594	171.34123947972455
chr19	SGTA	2782569	2782658	1080	90	1468669	7950	1467589	7860	12.0	186.71615776081424
chr19	TLE2	3000646	3000723	2821	78	89672	4108	86851	4030	36.166666666666664	21.551116625310172
chr19	TLE2	3019698	3019773	2374	76	89672	4108	87298	4032	31.236842105263158	21.651289682539684
chr19	TLE2	3017839	3017859	0	21	89672	4108	89672	4087	0.0	21.940787863958896
chr19	TLE2	3025019	3025082	109	64	89672	4108	89563	4044	1.703125	22.1471315529179
chr19	TLE2	3028880	3028905	1160	26	89672	4108	88512	4082	44.61538461538461	21.683488486036257
chr19	MFSD12	3546254	3546425	56274	172	623954	4683	567680	4511	327.1744186046512	125.84349368211039
chr19	MFSD12	3542775	3542977	23919	203	623954	4683	600035	4480	117.82758620689656	133.93638392857142
chr19	MFSD12	3548122	3548267	35230	146	623954	4683	588724	4537	241.3013698630137	129.7606347806921
chr19	MFSD12	3572860	3573021	1611	162	623954	4683	622343	4521	9.944444444444445	137.6560495465605
chr19	CACTIN	3611228	3611364	4437	137	244619	5168	240182	5031	32.386861313868614	47.740409461339695
chr19	PIP5K1C	3633436	3633520	858	85	471267	6975	470409	6890	10.094117647058823	68.27416545718432
chr19	MATK	3785063	3785286	0	224	66	4160	66	3936	0.0	0.01676829268292683
chr19	MATK	3789272	3789404	0	133	66	4160	66	4027	0.0	0.016389371740749937
chr19	MATK	3782817	3782937	15	121	66	4160	51	4039	0.12396694214876033	0.012626887843525626
chr19	ZFR2	3825229	3825407	0	179	12472	6111	12472	5932	0.0	2.1024949426837494
chr19	ZFR2	3855401	3855559	1899	159	12472	6111	10573	5952	11.943396226415095	1.776377688172043
chr19	ZFR2	3853391	3853423	33	33	12472	6111	12439	6078	1.0	2.0465613688713393
chr19	ZFR2	3856959	3857021	0	63	12472	6111	12472	6048	0.0	2.062169312169312
chr19	MAP2K2	4099200	4099414	200583	215	944465	4765	743882	4550	932.9441860465116	163.49054945054945
chr19	MAP2K2	4097278	4097343	101919	66	944465	4765	842546	4699	1544.2272727272727	179.30325601191743
chr19	SIRT6	4179103	4179286	42443	184	181126	2675	138683	2491	230.66847826086956	55.673625050180654
chr19	SIRT6	4180781	4180909	21115	129	181126	2675	160011	2546	163.68217054263565	62.847996857816185
chr19	SIRT6	4175679	4175760	10980	82	181126	2675	170146	2593	133.90243902439025	65.61743154647127
chr19	TMIGD2	4297985	4298345	0	361	51	1267	51	906	0.0	0.056291390728476824
chr19	STAP2	4325395	4325545	1348	151	18999	2781	17651	2630	8.927152317880795	6.711406844106464
chr19	STAP2	4324454	4324667	1990	214	18999	2781	17009	2567	9.299065420560748	6.6260225944682505
chr19	STAP2	4328674	4328809	1155	136	18999	2781	17844	2645	8.492647058823529	6.7463137996219285
chr19	STAP2	4324454	4324529	989	76	18999	2781	18010	2705	13.013157894736842	6.658040665434381
chr19	STAP2	4324454	4324664	1989	211	18999	2781	17010	2570	9.42654028436019	6.618677042801556
chr19	STAP2	4338214	4338264	0	51	18999	2781	18999	2730	0.0	6.9593406593406595
chr19	SH3GL1	4365481	4365625	55765	145	973919	3698	918154	3553	384.58620689655174	258.41654939487756
chr19	UBXN6	4446282	4446413	9974	132	461528	4117	451554	3985	75.56060606060606	113.31342534504391
chr19	UBXN6	4452363	4452492	66251	130	461528	4117	395277	3987	509.62307692307695	99.14145974416854
chr19	SEMA6B	4554155	4554263	350	109	27647	4408	27297	4299	3.2110091743119265	6.349616189811584
chr19	DPP9	4682695	4682838	81256	144	1361843	6781	1280587	6637	564.2777777777778	192.9466626487871
chr19	DPP9	4695377	4695555	83598	179	1361843	6781	1278245	6602	467.02793296089385	193.61481369282035
chr19	DPP9	4722498	4722551	13466	54	1361843	6781	1348377	6727	249.37037037037038	200.44254496803924
chr19	DPP9	4683189	4683324	1948	136	1361843	6781	1359895	6645	14.323529411764707	204.64936042136944
chr19	DPP9	4715528	4715726	1934	199	1361843	6781	1359909	6582	9.71859296482412	206.61030082041933
chr19	DPP9	4719202	4719324	0	123	1361843	6781	1361843	6658	0.0	204.54235506158005
chr19	DPP9	4722194	4722304	2601	111	1361843	6781	1359242	6670	23.43243243243243	203.78440779610196
chr19	PLIN3	4861328	4861411	53012	84	1286622	1780	1233610	1696	631.0952380952381	727.3643867924528
chr19	PLIN3	4866879	4866994	465	116	1286622	1780	1286157	1664	4.008620689655173	772.9308894230769
chr19	PTPRS	5216719	5216767	140	49	2450872	7856	2450732	7807	2.857142857142857	313.91469194312793
chr19	PTPRS	5229315	5229342	204	28	2450872	7856	2450668	7828	7.285714285714286	313.0643842616249
chr19	PTPRS	5256107	5256119	95	13	2450872	7856	2450777	7843	7.3076923076923075	312.47953589187813
chr19	SAFB2	5611119	5611630	152386	512	1061989	5607	909603	5095	297.62890625	178.52855740922473
chr19	SAFB2	5616421	5616486	8942	66	1061989	5607	1053047	5541	135.4848484848485	190.0463815195813
chr19	LONP1	5707059	5707143	62135	85	2189766	5053	2127631	4968	731.0	428.26710950080513
chr19	LONP1	5711770	5712002	149236	233	2189766	5053	2040530	4820	640.4978540772532	423.3464730290456
chr19	LONP1	5711770	5712070	158818	301	2189766	5053	2030948	4752	527.6345514950166	427.3880471380471
chr19	LONP1	5711818	5712002	121885	185	2189766	5053	2067881	4868	658.8378378378378	424.7906737880033
chr19	DUS3L	5786748	5786845	27864	98	430724	2948	402860	2850	284.3265306122449	141.35438596491227
chr19	DUS3L	5786748	5786919	32196	172	430724	2948	398528	2776	187.1860465116279	143.56195965417868
chr19	FUT6	5834949	5835077	0	129	0	2530	0	2401	0.0	0.0
chr19	FUT6	5832860	5832905	0	46	0	2530	0	2484	0.0	0.0
chr19	FUT6	5834839	5835077	0	239	0	2530	0	2291	0.0	0.0
chr19	FUT6	5838173	5838373	0	201	0	2530	0	2329	0.0	0.0
chr19	FUT6	5838173	5838399	0	227	0	2530	0	2303	0.0	0.0
chr19	FUT3	5846425	5846966	294	542	294	3117	0	2575	0.5424354243542435	0.0
chr19	FUT3	5846425	5846564	294	140	294	3117	0	2977	2.1	0.0
chr19	FUT3	5846425	5846618	294	194	294	3117	0	2923	1.5154639175257731	0.0
chr19	FUT3	5846425	5846599	294	175	294	3117	0	2942	1.68	0.0
chr19	AC024592.3	5870464	5870623	0	160	1000738	2198	1000738	2038	0.0	491.03925417075567
chr19	RANBP3	5931418	5931531	32469	114	967748	7119	935279	7005	284.8157894736842	133.51591720199858
chr19	RANBP3	5951392	5951596	3264	205	967748	7119	964484	6914	15.921951219512195	139.49725195256002
chr19	RANBP3	5957917	5957973	17073	57	967748	7119	950675	7062	299.5263157894737	134.6183800623053
chr19	RANBP3	5931403	5931531	33487	129	967748	7119	934261	6990	259.5891472868217	133.65679542203148
chr19	RANBP3	5935684	5935839	2335	156	967748	7119	965413	6963	14.967948717948717	138.64900186701135
chr19	RANBP3	5957917	5957968	14864	52	967748	7119	952884	7067	285.84615384615387	134.83571529644829
chr19	RANBP3	5957917	5957935	1707	19	967748	7119	966041	7100	89.84210526315789	136.06211267605633
chr19	RANBP3	5974349	5974431	168	83	967748	7119	967580	7036	2.0240963855421685	137.51847640704946
chr19	RANBP3	5957906	5957973	17073	68	967748	7119	950675	7051	251.0735294117647	134.82839313572543
chr19	RANBP3	5976380	5976574	0	195	967748	7119	967748	6924	0.0	139.76718659734257
chr19	RANBP3	5950716	5950872	422	157	967748	7119	967326	6962	2.6878980891719744	138.94369434070668
chr19	RANBP3	5965732	5965922	444	191	967748	7119	967304	6928	2.324607329842932	139.62240184757505
chr19	RFX2	6004200	6004298	857	99	76789	7521	75932	7422	8.656565656565656	10.230665588790083
chr19	RFX2	6012985	6013105	2803	121	76789	7521	73986	7400	23.165289256198346	9.998108108108108
chr19	RFX2	6026162	6026237	709	76	76789	7521	76080	7445	9.328947368421053	10.218938885157824
chr19	RFX2	6042043	6042123	826	81	76789	7521	75963	7440	10.197530864197532	10.210080645161291
chr19	RFX2	6044192	6044282	2003	91	76789	7521	74786	7430	22.01098901098901	10.065410497981157
chr19	RFX2	6047406	6047504	965	99	76789	7521	75824	7422	9.747474747474747	10.216114254917812
chr19	RFX2	6072004	6072147	442	144	76789	7521	76347	7377	3.0694444444444446	10.349328995526637
chr19	GTF2F1	6387388	6387559	81051	172	1020813	2271	939762	2099	471.2267441860465	447.71891376846116
chr19	GTF2F1	6392202	6392410	2902	209	1020813	2271	1017911	2062	13.885167464114833	493.65227934044617
chr19	KHSRP	6420072	6420144	127146	73	3028878	4006	2901732	3933	1741.7260273972602	737.7909992372234
chr19	SLC25A41	6430520	6430618	0	99	2934	1657	2934	1558	0.0	1.883183568677792
chr19	SLC25A23	6438190	6438312	0	123	431784	3621	431784	3498	0.0	123.43739279588337
chr19	SLC25A23	6452311	6452479	12968	169	431784	3621	418816	3452	76.73372781065089	121.32560834298957
chr19	SLC25A23	6438446	6438534	357	89	431784	3621	431427	3532	4.01123595505618	122.14807474518686
chr19	SLC25A23	6438723	6438821	144	99	431784	3621	431640	3522	1.4545454545454546	122.55536626916525
chr19	SLC25A23	6455951	6456092	50	142	431784	3621	431734	3479	0.352112676056338	124.09715435469963
chr19	SLC25A23	6438723	6438771	0	49	431784	3621	431784	3572	0.0	120.88017917133259
chr19	SLC25A23	6453980	6454088	12358	109	431784	3621	419426	3512	113.37614678899082	119.42653758542141
chr19	DENND1C	6479986	6480051	0	66	1414	4369	1414	4303	0.0	0.3286079479432954
chr19	DENND1C	6479986	6479990	0	5	1414	4369	1414	4364	0.0	0.32401466544454627
chr19	DENND1C	6479858	6479902	0	45	1414	4369	1414	4324	0.0	0.32701202590194267
chr19	TUBB4A	6496369	6496463	0	95	59742	1824	59742	1729	0.0	34.55292076344708
chr19	TUBB4A	6500615	6500742	0	128	59742	1824	59742	1696	0.0	35.2252358490566
chr19	GPR108	6731890	6731934	6128	45	307609	2886	301481	2841	136.17777777777778	106.11791622668075
chr19	GPR108	6732986	6733062	12998	77	307609	2886	294611	2809	168.80519480519482	104.8810964756141
chr19	GPR108	6735621	6735704	11982	84	307609	2886	295627	2802	142.64285714285714	105.505710206995
chr19	GPR108	6735907	6735958	7376	52	307609	2886	300233	2834	141.84615384615384	105.93966125617501
chr19	GPR108	6735539	6735704	12731	166	307609	2886	294878	2720	76.69277108433735	108.4110294117647
chr19	SH2D3A	6760637	6760987	255	351	7255	5600	7000	5249	0.7264957264957265	1.333587349971423
chr19	SH2D3A	6759593	6759670	0	78	7255	5600	7255	5522	0.0	1.3138355668236146
chr19	ADGRE4P	6960974	6961041	0	68	0	3337	0	3269	0.0	0.0
chr19	INSR	7150496	7150532	0	37	263177	10854	263177	10817	0.0	24.32994360728483
chr19	FCER2	7697012	7697075	0	64	38292	2333	38292	2269	0.0	16.876156897311592
chr19	CLEC4G	7729820	7729936	0	117	80	1553	80	1436	0.0	0.055710306406685235
chr19	CLEC4G	7731025	7731088	80	64	80	1553	0	1489	1.25	0.0
chr19	CD209	7744106	7744219	0	114	153407	4420	153407	4306	0.0	35.626335346028796
chr19	AC008763.4	7741566	7741897	0	332	131	4001	131	3669	0.0	0.035704551648950665
chr19	CD209	7746459	7746531	0	73	153407	4420	153407	4347	0.0	35.29031515988038
chr19	CD209	7747305	7747365	27313	61	153407	4420	126094	4359	447.75409836065575	28.927276898371186
chr19	CD209	7744106	7744201	0	96	153407	4420	153407	4324	0.0	35.47802960222017
chr19	TIMM44	7928076	7928166	590	91	33475	3792	32885	3701	6.483516483516484	8.88543636854904
chr19	TIMM44	7941101	7941197	0	97	33475	3792	33475	3695	0.0	9.059539918809202
chr19	FBN3	8075282	8075411	0	130	2200	10051	2200	9921	0.0	0.2217518395323052
chr19	FBN3	8089893	8089959	0	67	2200	10051	2200	9984	0.0	0.2203525641025641
chr19	FBN3	8097288	8097414	0	127	2200	10051	2200	9924	0.0	0.22168480451430875
chr19	FBN3	8141456	8141582	0	127	2200	10051	2200	9924	0.0	0.22168480451430875
chr19	CD320	8305030	8305156	0	127	188	2284	188	2157	0.0	0.0871580899397311
chr19	NDUFA7	8316495	8316645	45	151	96	1399	51	1248	0.2980132450331126	0.040865384615384616
chr19	NDUFA7	8319300	8319394	0	95	96	1399	96	1304	0.0	0.0736196319018405
chr19	KANK3	8334499	8335792	0	1294	271	3505	271	2211	0.0	0.12256897331524197
chr19	ZNF414	8513028	8513341	51	314	43109	2689	43058	2375	0.1624203821656051	18.129684210526317
chr19	ZNF414	8512074	8512131	850	58	43109	2689	42259	2631	14.655172413793103	16.061953629798555
chr19	ADAMTS10	8605622	8605809	0	188	3150	5729	3150	5541	0.0	0.568489442338928
chr19	ADAMTS10	8608133	8608248	0	116	3150	5729	3150	5613	0.0	0.5611972207375735
chr19	MUC16	8865583	8865756	0	174	18306	43914	18306	43740	0.0	0.4185185185185185
chr19	MUC16	8866963	8867014	0	52	18306	43914	18306	43862	0.0	0.4173544298025626
chr19	MUC16	8884958	8885024	0	67	18306	43914	18306	43847	0.0	0.41749720619426645
chr19	ZNF699	9305071	9305124	0	54	13617	6764	13617	6710	0.0	2.029359165424739
chr19	ZNF266	9434797	9434859	274	63	6936	4513	6662	4450	4.349206349206349	1.4970786516853933
chr19	ZNF266	9418765	9418895	0	131	6936	4513	6936	4382	0.0	1.5828388863532634
chr19	ZNF266	9434064	9434235	0	172	6936	4513	6936	4341	0.0	1.5977885279889426
chr19	ZNF266	9418761	9418895	0	135	6936	4513	6936	4378	0.0	1.5842850616719963
chr19	ZNF426	9530984	9531067	593	84	328588	7553	327995	7469	7.059523809523809	43.91417860490026
chr19	ZNF426	9533839	9533966	15	128	328588	7553	328573	7425	0.1171875	44.252255892255896
chr19	ZNF426	9535187	9535279	2250	93	328588	7553	326338	7460	24.193548387096776	43.745040214477214
chr19	ZNF121	9567647	9567705	0	59	51	7252	51	7193	0.0	0.007090226609203392
chr19	ZNF121	9584185	9584348	0	164	51	7252	51	7088	0.0	0.007195259593679458
chr19	ZNF561	9617620	9617758	0	139	51	5565	51	5426	0.0	0.009399189089568744
chr19	ZNF561	9614020	9614103	0	84	51	5565	51	5481	0.0	0.009304871373836891
chr19	ZNF561	9617044	9617171	0	128	51	5565	51	5437	0.0	0.0093801728894611
chr19	ZNF561	9618090	9618179	0	90	51	5565	51	5475	0.0	0.009315068493150684
chr19	ZNF561	9618090	9618166	0	77	51	5565	51	5488	0.0	0.009293002915451895
chr19	ZNF561	9617048	9617171	0	124	51	5565	51	5441	0.0	0.00937327697114501
chr19	ZNF561	9617044	9617226	0	183	51	5565	51	5382	0.0	0.00947603121516165
chr19	ZNF561	9620915	9620963	0	49	51	5565	51	5516	0.0	0.00924583031182016
chr19	ZNF561	9617620	9617768	0	149	51	5565	51	5416	0.0	0.009416543574593796
chr19	ZNF561	9620915	9621049	0	135	51	5565	51	5430	0.0	0.009392265193370166
chr19	ZNF562	9656546	9656653	51	108	44676	2122	44625	2014	0.4722222222222222	22.157398212512412
chr19	ZNF562	9658008	9658135	51	128	44676	2122	44625	1994	0.3984375	22.379638916750253
chr19	ZNF562	9659378	9659467	0	90	44676	2122	44676	2032	0.0	21.986220472440944
chr19	ZNF812P	9700000	9700086	0	87	1460	2311	1460	2224	0.0	0.6564748201438849
chr19	ZNF846	9755516	9755634	5	119	75442	3924	75437	3805	0.04201680672268908	19.825755584756898
chr19	ZNF846	9759859	9759942	6361	84	75442	3924	69081	3840	75.72619047619048	17.98984375
chr19	FBXL12	9813230	9813274	0	45	0	2784	0	2739	0.0	0.0
chr19	FBXL12	9818544	9818617	0	74	0	2784	0	2710	0.0	0.0
chr19	FBXL12	9814571	9814669	0	99	0	2784	0	2685	0.0	0.0
chr19	FBXL12	9814137	9814339	0	203	0	2784	0	2581	0.0	0.0
chr19	FBXL12	9814137	9814342	0	206	0	2784	0	2578	0.0	0.0
chr19	EIF3G	10117083	10117188	0	106	0	3387	0	3281	0.0	0.0
chr19	EIF3G	10118439	10118557	0	119	0	3387	0	3268	0.0	0.0
chr19	DNMT1	10134216	10134307	0	92	49341	13688	49341	13596	0.0	3.6290820829655783
chr19	DNMT1	10166597	10166685	0	89	49341	13688	49341	13599	0.0	3.628281491286124
chr19	DNMT1	10180186	10180234	0	49	49341	13688	49341	13639	0.0	3.6176405894860326
chr19	DNMT1	10180349	10180569	0	221	49341	13688	49341	13467	0.0	3.6638449543328138
chr19	DNMT1	10166591	10166685	0	95	49341	13688	49341	13593	0.0	3.6298830280291328
chr19	DNMT1	10180349	10180529	0	181	49341	13688	49341	13507	0.0	3.652994743466351
chr19	DNMT1	10218751	10218869	49175	119	49341	13688	166	13569	413.2352941176471	0.012233768147984376
chr19	DNMT1	10194819	10195054	0	236	49341	13688	49341	13452	0.0	3.6679304192685103
chr19	DNMT1	10179880	10179982	0	103	49341	13688	49341	13585	0.0	3.6320206109679796
chr19	RAVER1	10321047	10321259	0	213	8210	4719	8210	4506	0.0	1.8220150909897914
chr19	RAVER1	10330459	10330526	0	68	8210	4719	8210	4651	0.0	1.7652117824123845
chr19	ICAM3	10339017	10339245	0	229	9537	2076	9537	1847	0.0	5.163508391987006
chr19	ICAM3	10339061	10339245	0	185	9537	2076	9537	1891	0.0	5.043363299841354
chr19	TYK2	10351051	10351162	0	112	18660	6234	18660	6122	0.0	3.0480235217249265
chr19	TYK2	10353527	10353646	0	120	18660	6234	18660	6114	0.0	3.0520117762512267
chr19	TYK2	10364850	10365048	0	199	18660	6234	18660	6035	0.0	3.091963545981773
chr19	TYK2	10360961	10361073	0	113	18660	6234	18660	6121	0.0	3.0485214834177423
chr19	TYK2	10369756	10369877	3113	122	18660	6234	15547	6112	25.516393442622952	2.543684554973822
chr19	CDC37	10400574	10400693	260	120	844676	3052	844416	2932	2.1666666666666665	288.0
chr19	KEAP1	10489191	10489368	0	178	4225	3562	4225	3384	0.0	1.2485224586288417
chr19	KEAP1	10489647	10489853	0	207	4225	3562	4225	3355	0.0	1.2593144560357674
chr19	KRI1	10558163	10558239	62	77	40681	3939	40619	3862	0.8051948051948052	10.517607457276023
chr19	KRI1	10562728	10562837	630	110	40681	3939	40051	3829	5.7272727272727275	10.459911203969705
chr19	KRI1	10565716	10565790	51	75	40681	3939	40630	3864	0.68	10.515010351966874
chr19	KRI1	10564928	10565034	0	107	40681	3939	40681	3832	0.0	10.616127348643007
chr19	KRI1	10562728	10562821	528	94	40681	3939	40153	3845	5.617021276595745	10.44291287386216
chr19	AP1M2	10574903	10575029	0	127	73812	2145	73812	2018	0.0	36.576808721506445
chr19	AP1M2	10583605	10584070	226	466	73812	2145	73586	1679	0.48497854077253216	43.827278141751044
chr19	AP1M2	10584969	10585044	0	76	73812	2145	73812	2069	0.0	35.67520541324311
chr19	TMED1	10834933	10835117	51	185	2700	1889	2649	1704	0.2756756756756757	1.5545774647887325
chr19	TMED1	10835255	10835353	0	99	2700	1889	2700	1790	0.0	1.5083798882681565
chr19	TMED1	10835290	10835353	0	64	2700	1889	2700	1825	0.0	1.4794520547945205
chr19	TMED1	10834933	10835063	51	131	2700	1889	2649	1758	0.3893129770992366	1.506825938566553
chr19	YIPF2	10924075	10924192	813	118	92640	2417	91827	2299	6.889830508474576	39.94214876033058
chr19	YIPF2	10927629	10927716	55	88	92640	2417	92585	2329	0.625	39.75311292400172
chr19	YIPF2	10928379	10928440	0	62	92640	2417	92640	2355	0.0	39.33757961783439
chr19	KANK2	11169876	11169966	355	91	19006	7137	18651	7046	3.901098901098901	2.647033778030088
chr19	KANK2	11196049	11196227	200	179	19006	7137	18806	6958	1.1173184357541899	2.702788157516528
chr19	DOCK6	11232184	11232289	0	106	308169	9585	308169	9479	0.0	32.51070788057812
chr19	DOCK6	11229297	11229390	221	94	308169	9585	307948	9491	2.351063829787234	32.446317564008005
chr19	TMEM205	11345251	11345415	0	165	12586	1389	12586	1224	0.0	10.282679738562091
chr19	TMEM205	11345519	11345628	0	110	12586	1389	12586	1279	0.0	9.840500390930414
chr19	TMEM205	11345519	11345737	0	219	12586	1389	12586	1170	0.0	10.757264957264958
chr19	EPOR	11382846	11382949	0	104	86	3001	86	2897	0.0	0.02968588194684156
chr19	EPOR	11383430	11383535	0	106	86	3001	86	2895	0.0	0.029706390328151987
chr19	EPOR	11382846	11382982	0	137	86	3001	86	2864	0.0	0.030027932960893854
chr19	RGL3	11405322	11405426	0	105	94	3935	94	3830	0.0	0.02454308093994778
chr19	RGL3	11411252	11411444	0	193	94	3935	94	3742	0.0	0.02512025654730091
chr19	CCDC151	11426682	11426784	0	103	37840	2696	37840	2593	0.0	14.59313536444273
chr19	CCDC151	11430698	11430776	0	79	37840	2696	37840	2617	0.0	14.45930454719144
chr19	ZNF653	11485655	11485770	0	116	5762	3095	5762	2979	0.0	1.9342061094326954
chr19	ZNF653	11500677	11500815	0	139	5762	3095	5762	2956	0.0	1.949255751014885
chr19	ECSIT	11507701	11507850	0	150	0	2365	0	2215	0.0	0.0
chr19	ECSIT	11513055	11513279	0	225	0	2365	0	2140	0.0	0.0
chr19	ECSIT	11519074	11519193	0	120	0	2365	0	2245	0.0	0.0
chr19	ECSIT	11510616	11510660	0	45	0	2365	0	2320	0.0	0.0
chr19	ECSIT	11507701	11507729	0	29	0	2365	0	2336	0.0	0.0
chr19	ECSIT	11513055	11513284	0	230	0	2365	0	2135	0.0	0.0
chr19	ECSIT	11525639	11525737	0	99	0	2365	0	2266	0.0	0.0
chr19	ECSIT	11519843	11519966	0	124	0	2365	0	2241	0.0	0.0
chr19	ELOF1	11555173	11555253	0	81	1349255	4090	1349255	4009	0.0	336.5564978797705
chr19	ELOF1	11554819	11554946	51	128	1349255	4090	1349204	3962	0.3984375	340.53609288238266
chr19	ACP5	11578584	11578657	0	74	0	2095	0	2021	0.0	0.0
chr19	ACP5	11578479	11578657	0	179	0	2095	0	1916	0.0	0.0
chr19	ACP5	11578023	11578194	0	172	0	2095	0	1923	0.0	0.0
chr19	ACP5	11578584	11578764	0	181	0	2095	0	1914	0.0	0.0
chr19	ZNF823	11724193	11724254	5	62	7493	2463	7488	2401	0.08064516129032258	3.1187005414410662
chr19	ZNF823	11725200	11725327	0	128	7493	2463	7493	2335	0.0	3.2089935760171304
chr19	ZNF433	12034827	12034874	0	48	21145	3086	21145	3038	0.0	6.96017116524029
chr19	ZNF433	12030139	12030198	1	60	21145	3086	21144	3026	0.016666666666666666	6.987442167878387
chr19	ZNF433	12021929	12022189	792	261	21145	3086	20353	2825	3.0344827586206895	7.204601769911505
chr19	ZNF20	12136850	12136876	27	27	21683	4090	21656	4063	1.0	5.330051685946345
chr19	ZNF44	12293231	12293375	0	145	25478	6082	25478	5937	0.0	4.291392959407108
chr19	ZNF44	12291219	12291250	0	32	25478	6082	25478	6050	0.0	4.211239669421488
chr19	ZNF563	12324918	12324979	40	62	397	1142	357	1080	0.6451612903225806	0.33055555555555555
chr19	ZNF442	12352987	12353114	792	128	55129	6603	54337	6475	6.1875	8.391814671814672
chr19	ZNF799	12398133	12398251	0	119	30953	5061	30953	4942	0.0	6.263253743423715
chr19	ZNF564	12550462	12550652	0	191	3295	3626	3295	3435	0.0	0.9592430858806404
chr19	ZNF564	12541424	12541537	1212	114	3295	3626	2083	3512	10.631578947368421	0.5931093394077449
chr19	ZNF490	12609869	12609974	38	106	12969	6803	12931	6697	0.3584905660377358	1.9308645662236823
chr19	MAN2B1	12658427	12658510	0	84	1530	4627	1530	4543	0.0	0.33678186220559103
chr19	MAN2B1	12664791	12664985	0	195	1530	4627	1530	4432	0.0	0.34521660649819497
chr19	MAN2B1	12665702	12665805	0	104	1530	4627	1530	4523	0.0	0.3382710590316162
chr19	MAN2B1	12658427	12658507	0	81	1530	4627	1530	4546	0.0	0.3365596128464584
chr19	MAN2B1	12665702	12665832	0	131	1530	4627	1530	4496	0.0	0.3403024911032028
chr19	DHPS	12677107	12677211	0	105	153	2991	153	2886	0.0	0.05301455301455302
chr19	DHPS	12679800	12679922	0	123	153	2991	153	2868	0.0	0.053347280334728034
chr19	DHPS	12679800	12680030	0	231	153	2991	153	2760	0.0	0.05543478260869565
chr19	FBXW9	12691341	12691454	1348	114	18840	2086	17492	1972	11.824561403508772	8.870182555780932
chr19	FBXW9	12694798	12694938	0	141	18840	2086	18840	1945	0.0	9.686375321336762
chr19	TNPO2	12706009	12706109	0	101	10242	6955	10242	6854	0.0	1.494309892033849
chr19	TRIR	12731343	12731557	0	215	1885	1314	1885	1099	0.0	1.7151956323930846
chr19	TRIR	12731343	12731421	0	79	1885	1314	1885	1235	0.0	1.5263157894736843
chr19	HOOK2	12765828	12765834	182	7	332865	5239	332683	5232	26.0	63.5862003058104
chr19	PRDX2	12799858	12799989	6039	132	45063	1852	39024	1720	45.75	22.688372093023254
chr19	DNASE2	12878669	12878834	2441	166	40944	2394	38503	2228	14.704819277108435	17.281418312387792
chr19	FARSA	12928754	12928847	31	94	96097	2378	96066	2284	0.32978723404255317	42.06042031523643
chr19	TRMT1	13109914	13110001	0	88	3786	3150	3786	3062	0.0	1.2364467668190724
chr19	TRMT1	13115625	13115768	510	144	3786	3150	3276	3006	3.5416666666666665	1.089820359281437
chr19	TRMT1	13112704	13112817	0	114	3786	3150	3786	3036	0.0	1.2470355731225296
chr19	TRMT1	13116145	13116431	1122	287	3786	3150	2664	2863	3.9094076655052263	0.9304924903946908
chr19	TRMT1	13116105	13116431	1122	327	3786	3150	2664	2823	3.4311926605504586	0.9436769394261424
chr19	CACNA1A	13210616	13210652	28	37	1105115	33625	1105087	33588	0.7567567567567568	32.90124449208051
chr19	CACNA1A	13227430	13227527	29049	98	1105115	33625	1076066	33527	296.4183673469388	32.09550511528022
chr19	CACNA1A	13235208	13235274	0	67	1105115	33625	1105115	33558	0.0	32.931491745634425
chr19	CACNA1A	13241520	13241526	56	7	1105115	33625	1105059	33618	8.0	32.871051222559345
chr19	CACNA1A	13228698	13228795	837	98	1105115	33625	1104278	33527	8.540816326530612	32.93697616846124
chr19	CACNA1A	13230081	13230209	1349	129	1105115	33625	1103766	33496	10.457364341085272	32.95217339383807
chr19	CACNA1A	13236448	13236618	0	171	1105115	33625	1105115	33454	0.0	33.03386740001196
chr19	C19ORF57	13883307	13883400	1632	94	295150	3853	293518	3759	17.361702127659573	78.08406491088056
chr19	C19ORF57	13889187	13890462	45377	1276	295150	3853	249773	2577	35.56191222570533	96.92394256887854
chr19	C19ORF57	13895371	13895546	256	176	295150	3853	294894	3677	1.4545454545454546	80.19961925482731
chr19	PODNL1	13934253	13934410	4372	158	48802	3221	44430	3063	27.670886075949365	14.505386875612144
chr19	PODNL1	13935979	13936044	0	66	48802	3221	48802	3155	0.0	15.468145800316957
chr19	PODNL1	13934253	13934385	4172	133	48802	3221	44630	3088	31.36842105263158	14.452720207253886
chr19	PODNL1	13935720	13935830	0	111	48802	3221	48802	3110	0.0	15.691961414790997
chr19	RFX1	13993524	13993895	4823	372	12510	5497	7687	5125	12.96505376344086	1.4999024390243902
chr19	RFX1	13998117	13998317	276	201	12510	5497	12234	5296	1.373134328358209	2.3100453172205437
chr19	C19ORF67	14083732	14083877	1289	146	5166	1541	3877	1395	8.82876712328767	2.77921146953405
chr19	PRKACA	14093627	14093792	0	166	5886	6320	5886	6154	0.0	0.956451088722782
chr19	ASF1B	14121531	14121708	0	178	663	1717	663	1539	0.0	0.43079922027290446
chr19	ASF1B	14126121	14126237	0	117	663	1717	663	1600	0.0	0.414375
chr19	ASF1B	14121531	14121677	0	147	663	1717	663	1570	0.0	0.42229299363057327
chr19	ADGRL1	14152132	14152150	0	19	76263	8318	76263	8299	0.0	9.189420412097844
chr19	ADGRL1	14160592	14160696	0	105	76263	8318	76263	8213	0.0	9.285644709606721
chr19	ADGRL1	14167015	14167030	0	16	76263	8318	76263	8302	0.0	9.186099735003614
chr19	ADGRL1	14152132	14152222	0	91	76263	8318	76263	8227	0.0	9.269843199222073
chr19	DDX39A	14409535	14409645	0	111	157	3413	157	3302	0.0	0.04754694124772865
chr19	DDX39A	14410420	14410605	0	186	157	3413	157	3227	0.0	0.04865199876045863
chr19	DDX39A	14410547	14410605	0	59	157	3413	157	3354	0.0	0.0468097793679189
chr19	DDX39A	14413979	14414014	0	36	157	3413	157	3377	0.0	0.04649096831507255
chr19	DDX39A	14415947	14415988	4	42	157	3413	153	3371	0.09523809523809523	0.0453871254820528
chr19	DDX39A	14416268	14416405	153	138	157	3413	4	3275	1.108695652173913	0.0012213740458015267
chr19	GIPC1	14480304	14480485	0	182	0	2445	0	2263	0.0	0.0
chr19	GIPC1	14482688	14483006	0	319	0	2445	0	2126	0.0	0.0
chr19	GIPC1	14492856	14492912	0	57	0	2445	0	2388	0.0	0.0
chr19	GIPC1	14491655	14491743	0	89	0	2445	0	2356	0.0	0.0
chr19	GIPC1	14483488	14483579	0	92	0	2445	0	2353	0.0	0.0
chr19	DNAJB1	14518138	14518268	102	131	66706	7011	66604	6880	0.7786259541984732	9.680813953488371
chr19	DNAJB1	14516465	14517046	5302	582	66706	7011	61404	6429	9.109965635738831	9.551096593560429
chr19	DNAJB1	14552457	14554318	12585	1862	66706	7011	54121	5149	6.758861439312567	10.510973004466887
chr19	DNAJB1	14526122	14526198	713	77	66706	7011	65993	6934	9.25974025974026	9.517306028266512
chr19	ADGRE3	14661962	14662118	0	157	270321	2854	270321	2697	0.0	100.23025583982202
chr19	ADGRE2	14746231	14746323	0	93	4431343	8203	4431343	8110	0.0	546.4048088779285
chr19	ADGRE2	14754953	14755127	0	175	4431343	8203	4431343	8028	0.0	551.9859242650723
chr19	ADGRE2	14755653	14755877	0	225	4431343	8203	4431343	7978	0.0	555.4453497117072
chr19	ADGRE2	14766234	14766381	0	148	4431343	8203	4431343	8055	0.0	550.1356921166977
chr19	ADGRE2	14755653	14755844	0	192	4431343	8203	4431343	8011	0.0	553.1572837348646
chr19	ADGRE2	14765657	14765804	0	148	4431343	8203	4431343	8055	0.0	550.1356921166977
chr19	ADGRE2	14766977	14767109	51	133	4431343	8203	4431292	8070	0.38345864661654133	549.1068153655514
chr19	ADGRE2	14752328	14752526	204	199	4431343	8203	4431139	8004	1.0251256281407035	553.6155672163918
chr19	OR7C1	14821418	14821485	0	68	1639	12216	1639	12148	0.0	0.13491932828449127
chr19	SLC1A6	14956475	14956709	0	235	0	7643	0	7408	0.0	0.0
chr19	SLC1A6	14968302	14968507	0	206	0	7643	0	7437	0.0	0.0
chr19	ILVBL	15123374	15123576	0	203	51	4314	51	4111	0.0	0.012405740695694478
chr19	ILVBL	15124924	15125069	0	146	51	4314	51	4168	0.0	0.012236084452975048
chr19	NOTCH3	15165786	15166091	0	306	357	9441	357	9135	0.0	0.03908045977011494
chr19	NOTCH3	15184294	15184450	0	157	357	9441	357	9284	0.0	0.038453252908229214
chr19	BRD4	15268153	15268281	0	129	28969	13803	28969	13674	0.0	2.118546145970455
chr19	BRD4	15268153	15268240	0	88	28969	13803	28969	13715	0.0	2.1122129055778345
chr19	BRD4	15275656	15275839	0	184	28969	13803	28969	13619	0.0	2.127101843013437
chr19	AKAP8	15373785	15374065	1048	281	214381	4312	213333	4031	3.7295373665480427	52.92309600595386
chr19	AKAP8	15369066	15369224	86	159	214381	4312	214295	4153	0.5408805031446541	51.6000481579581
chr19	AKAP8L	15404009	15404042	0	34	7065	4512	7065	4478	0.0	1.5777132648503795
chr19	AKAP8L	15398629	15398766	0	138	7065	4512	7065	4374	0.0	1.6152263374485596
chr19	AKAP8L	15403474	15403555	0	82	7065	4512	7065	4430	0.0	1.5948081264108351
chr19	AKAP8L	15403657	15403715	200	59	7065	4512	6865	4453	3.389830508474576	1.5416573096788682
chr19	AKAP8L	15403652	15403715	200	64	7065	4512	6865	4448	3.125	1.5433902877697843
chr19	AKAP8L	15398629	15398703	0	75	7065	4512	7065	4437	0.0	1.592292089249493
chr19	WIZ	15428109	15428508	724	400	16136	10053	15412	9653	1.81	1.5966020926136952
chr19	WIZ	15431011	15431182	357	172	16136	10053	15779	9881	2.0755813953488373	1.596903147454711
chr19	WIZ	15438577	15440715	3148	2139	16136	10053	12988	7914	1.471715755025713	1.6411422795046753
chr19	WIZ	15429585	15430089	1377	505	16136	10053	14759	9548	2.726732673267327	1.5457687473816506
chr19	WIZ	15442675	15442748	45	74	16136	10053	16091	9979	0.6081081081081081	1.612486221064235
chr19	RASAL3	15452044	15452815	196	772	15134	4353	14938	3581	0.2538860103626943	4.171460485897794
chr19	CLEC4O	15857917	15858068	0	152	0	780	0	628	0.0	0.0
chr19	CYP4F2	15886241	15886308	0	68	0	2924	0	2856	0.0	0.0
chr19	CYP4F2	15895505	15895650	0	146	0	2924	0	2778	0.0	0.0
chr19	CYP4F2	15897413	15897612	0	200	0	2924	0	2724	0.0	0.0
chr19	CYP4F2	15893736	15893881	0	146	0	2924	0	2778	0.0	0.0
chr19	CYP4F11	15924760	15924882	0	123	0	4039	0	3916	0.0	0.0
chr19	CYP4F11	15914601	15914666	0	66	0	4039	0	3973	0.0	0.0
chr19	EPS15L1	16377121	16377254	0	134	18113	8149	18113	8015	0.0	2.259887710542732
chr19	CALR3	16490366	16490570	204	205	3707	1440	3503	1235	0.9951219512195122	2.8364372469635626
chr19	SLC35E1	16555151	16555397	707	247	17345	4652	16638	4405	2.8623481781376516	3.777071509648127
chr19	SLC35E1	16568031	16568169	204	139	17345	4652	17141	4513	1.4676258992805755	3.7981387103922004
chr19	SLC35E1	16565036	16565132	0	97	17345	4652	17345	4555	0.0	3.8079034028540066
chr19	SMIM7	16654034	16654125	1022	92	247567	4512	246545	4420	11.108695652173912	55.779411764705884
chr19	SMIM7	16659394	16659447	0	54	247567	4512	247567	4458	0.0	55.53319874383131
chr19	AC008764.4	16630467	16630559	20515	93	21921	1192	1406	1099	220.59139784946237	1.2793448589626935
chr19	SMIM7	16647095	16647261	218	167	247567	4512	247349	4345	1.3053892215568863	56.92727272727273
chr19	SMIM7	16652604	16652961	57948	358	247567	4512	189619	4154	161.8659217877095	45.64732787674531
chr19	SMIM7	16659157	16659255	0	99	247567	4512	247567	4413	0.0	56.09947881259914
chr19	SMIM7	16655237	16655368	51	132	247567	4512	247516	4380	0.38636363636363635	56.510502283105026
chr19	CPAMD8	16896455	16896665	0	211	47830	7832	47830	7621	0.0	6.276079254690986
chr19	CPAMD8	16951968	16952200	1408	233	47830	7832	46422	7599	6.042918454935623	6.108961705487564
chr19	HAUS8	17062697	17062779	0	83	153	4402	153	4319	0.0	0.0354248668673304
chr19	AC020913.1	17157294	17157390	0	97	153	499	153	402	0.0	0.3805970149253731
chr19	USHBP1	17264001	17264150	25	150	21163	5041	21138	4891	0.16666666666666666	4.321815579636066
chr19	USHBP1	17258583	17258701	0	119	21163	5041	21163	4922	0.0	4.299674928890695
chr19	ABHD8	17302182	17302232	0	51	12963	2169	12963	2118	0.0	6.120396600566572
chr19	BST2	17404370	17404437	0	68	64345	1106	64345	1038	0.0	61.98940269749518
chr19	UNC13A	17649338	17649344	0	7	216252	11233	216252	11226	0.0	19.26349545697488
chr19	UNC13A	17616407	17616464	3262	58	216252	11233	212990	11175	56.241379310344826	19.05950782997763
chr19	INSL3	17820395	17820490	0	96	0	926	0	830	0.0	0.0
chr19	JAK3	17843776	17843900	272	125	66606	6837	66334	6712	2.176	9.882896305125149
chr19	IL12RB1	18091443	18091545	0	103	153	4312	153	4209	0.0	0.036350677120456164
chr19	IL12RB1	18090649	18090769	0	121	153	4312	153	4191	0.0	0.03650680028632784
chr19	RAB3A	18202512	18202740	0	229	81	1791	81	1562	0.0	0.051856594110115235
chr19	RAB3A	18202512	18202855	0	344	81	1791	81	1447	0.0	0.05597788527988943
chr19	PDE4C	18218333	18218498	0	166	8296	6384	8296	6218	0.0	1.3341910582180765
chr19	PDE4C	18220873	18220923	0	51	8296	6384	8296	6333	0.0	1.3099636822990683
chr19	PDE4C	18220402	18220515	0	114	8296	6384	8296	6270	0.0	1.3231259968102074
chr19	PDE4C	18220402	18220769	0	368	8296	6384	8296	6016	0.0	1.3789893617021276
chr19	PDE4C	18220402	18220708	0	307	8296	6384	8296	6077	0.0	1.3651472766167516
chr19	IQCN	18267771	18267967	0	197	87257	7022	87257	6825	0.0	12.784908424908425
chr19	LSM4	18316023	18316065	0	43	139243	2867	139243	2824	0.0	49.30701133144476
chr19	LSM4	18310109	18310214	0	106	139243	2867	139243	2761	0.0	50.43208982252807
chr19	ISYNA1	18436683	18436877	0	195	0	3012	0	2817	0.0	0.0
chr19	ISYNA1	18437598	18437760	0	163	0	3012	0	2849	0.0	0.0
chr19	ISYNA1	18436972	18437105	0	134	0	3012	0	2878	0.0	0.0
chr19	ELL	18470975	18471035	184	61	12510	4932	12326	4871	3.0163934426229506	2.530486553069185
chr19	FKBP8	18533269	18533347	2871	79	30357	2467	27486	2388	36.34177215189873	11.510050251256281
chr19	FKBP8	18539550	18539720	366	171	30357	2467	29991	2296	2.1403508771929824	13.062282229965156
chr19	COPE	18903267	18903423	0	157	0	2637	0	2480	0.0	0.0
chr19	COPE	18906959	18907112	0	154	0	2637	0	2483	0.0	0.0
chr19	COPE	18910970	18911071	0	102	0	2637	0	2535	0.0	0.0
chr19	COPE	18905866	18905935	0	70	0	2637	0	2567	0.0	0.0
chr19	HOMER3	18931975	18932132	0	158	153	3433	153	3275	0.0	0.0467175572519084
chr19	HOMER3	18934302	18934410	0	109	153	3433	153	3324	0.0	0.046028880866425995
chr19	HOMER3	18940320	18940404	0	85	153	3433	153	3348	0.0	0.0456989247311828
chr19	SUGP2	18993637	18993740	0	104	231411	6566	231411	6462	0.0	35.81104921077066
chr19	SUGP2	18998923	18998985	0	63	231411	6566	231411	6503	0.0	35.585268337690295
chr19	SUGP2	18993647	18993740	0	94	231411	6566	231411	6472	0.0	35.75571693448702
chr19	SUGP2	18991339	18991553	408	215	231411	6566	231003	6351	1.8976744186046512	36.37269721303732
chr19	SUGP2	19030950	19031082	816	133	231411	6566	230595	6433	6.135338345864661	35.845639670449245
chr19	SUGP2	19003495	19003608	48	114	231411	6566	231363	6452	0.42105263157894735	35.85911345319281
chr19	SUGP2	19007346	19007447	0	102	231411	6566	231411	6464	0.0	35.79996905940594
chr19	TMEM161A	19121307	19121421	0	115	296772	3291	296772	3176	0.0	93.44206549118388
chr19	TMEM161A	19134783	19134887	0	105	296772	3291	296772	3186	0.0	93.1487758945386
chr19	TMEM161A	19121317	19121421	0	105	296772	3291	296772	3186	0.0	93.1487758945386
chr19	TMEM161A	19134783	19134916	0	134	296772	3291	296772	3157	0.0	94.00443458980044
chr19	MEF2B	19146272	19146384	405	113	8735	2099	8330	1986	3.584070796460177	4.19436052366566
chr19	MEF2B	19146741	19146875	1745	135	8735	2099	6990	1964	12.925925925925926	3.5590631364562118
chr19	BORCS8-MEF2B	19180685	19180761	0	77	7570	1944	7570	1867	0.0	4.054633101231923
chr19	MEF2B	19146272	19146405	405	134	8735	2099	8330	1965	3.0223880597014925	4.239185750636132
chr19	BORCS8-MEF2B	19157215	19157283	0	69	7570	1944	7570	1875	0.0	4.037333333333334
chr19	NR2C2AP	19202469	19202575	0	107	213	1637	213	1530	0.0	0.1392156862745098
chr19	TM6SF2	19268629	19268754	0	126	143	1794	143	1668	0.0	0.08573141486810551
chr19	SUGP1	19302264	19302443	423	180	61876	4861	61453	4681	2.35	13.128177739799188
chr19	SUGP1	19302264	19302388	381	125	61876	4861	61495	4736	3.048	12.98458614864865
chr19	SUGP1	19303723	19303847	35534	125	61876	4861	26342	4736	284.272	5.562077702702703
chr19	SUGP1	19310096	19310200	66	105	61876	4861	61810	4756	0.6285714285714286	12.996215306980655
chr19	SUGP1	19316421	19316593	0	173	61876	4861	61876	4688	0.0	13.198805460750853
chr19	SUGP1	19303723	19304043	48822	321	61876	4861	13054	4540	152.09345794392524	2.875330396475771
chr19	SUGP1	19316421	19316522	0	102	61876	4861	61876	4759	0.0	13.001891153603697
chr19	SUGP1	19316246	19316593	0	348	61876	4861	61876	4513	0.0	13.710613782406382
chr19	LPAR2	19627753	19627969	51	217	193635	2979	193584	2762	0.2350230414746544	70.08834178131788
chr19	GMIP	19634506	19634703	0	198	75629	3751	75629	3553	0.0	21.285955530537574
chr19	GMIP	19635643	19635721	70	79	75629	3751	75559	3672	0.8860759493670886	20.5770697167756
chr19	GMIP	19640295	19640360	762	66	75629	3751	74867	3685	11.545454545454545	20.316689280868385
chr19	GMIP	19643099	19643227	1313	129	75629	3751	74316	3622	10.178294573643411	20.51794588625069
chr19	LINC00663	19761325	19761421	1977	97	221348	1894	219371	1797	20.38144329896907	122.07623817473566
chr19	LINC00663	19761256	19761421	2690	166	221348	1894	218658	1728	16.204819277108435	126.53819444444444
chr19	LINC00663	19761203	19761421	3393	219	221348	1894	217955	1675	15.493150684931507	130.12238805970148
chr19	ZNF506	19793833	19795660	26630	1828	123524	6969	96894	5141	14.567833698030634	18.847305971600857
chr19	ZNF506	19806030	19806126	0	97	123524	6969	123524	6872	0.0	17.974970896391152
chr19	ZNF506	19806941	19807068	0	128	123524	6969	123524	6841	0.0	18.056424499342203
chr19	ZNF682	20015773	20015837	56	65	21965	2583	21909	2518	0.8615384615384616	8.700953137410643
chr19	ZNF682	20015174	20015266	38	93	21965	2583	21927	2490	0.40860215053763443	8.806024096385542
chr19	ZNF826P	20406008	20406132	0	125	707	6017	707	5892	0.0	0.11999321113374066
chr19	ZNF737	20553708	20553835	0	128	0	2358	0	2230	0.0	0.0
chr19	ZNF737	20564040	20564138	0	99	0	2358	0	2259	0.0	0.0
chr19	ZNF708	21310500	21310627	0	128	59096	4331	59096	4203	0.0	14.060433024030454
chr19	ZNF708	21327959	21328141	18	183	59096	4331	59078	4148	0.09836065573770492	14.242526518804244
chr19	ZNF708	21306817	21306941	5314	125	59096	4331	53782	4206	42.512	12.786970993818354
chr19	AC010615.2	21456460	21456588	768	129	4803	4522	4035	4393	5.953488372093023	0.918506715228773
chr19	ZNF100	21746815	21746889	0	75	306	2806	306	2731	0.0	0.11204686927865251
chr19	ZNF43	21819094	21819221	0	128	102	8432	102	8304	0.0	0.012283236994219654
chr19	ZNF43	21850937	21851027	0	91	102	8432	102	8341	0.0	0.01222874955041362
chr19	ZNF43	21850937	21851162	0	226	102	8432	102	8206	0.0	0.012429929320009749
chr19	ZNF208	22009487	22009581	196	95	7692	6782	7496	6687	2.0631578947368423	1.1209810079258262
chr19	ZNF208	21991438	21991737	5935	300	7692	6782	1757	6482	19.783333333333335	0.2710583153347732
chr19	AC003973.1	22022471	22022599	7983	129	77573	5670	69590	5541	61.883720930232556	12.559104854719365
chr19	AC003973.1	22034880	22034998	98	119	77573	5670	77475	5551	0.8235294117647058	13.956944694649613
chr19	AC003973.1	22034672	22034797	7925	126	77573	5670	69648	5544	62.8968253968254	12.562770562770563
chr19	AC003973.1	22035550	22035702	0	153	77573	5670	77573	5517	0.0	14.060721406561537
chr19	AC003973.1	22035550	22035659	0	110	77573	5670	77573	5560	0.0	13.951978417266186
chr19	AC003973.1	22037414	22037518	0	105	77573	5670	77573	5565	0.0	13.939442946990116
chr19	LINC01785	22619577	22619715	0	139	102	1717	102	1578	0.0	0.06463878326996197
chr19	ZNF728	22985654	22985831	0	178	255	2782	255	2604	0.0	0.097926267281106
chr19	LINC01859	23015449	23015569	0	121	51	3966	51	3845	0.0	0.013263979193758128
chr19	LINC01858	23058464	23058579	28	116	372	3187	344	3071	0.2413793103448276	0.11201563008791925
chr19	AC092329.4	23270217	23270292	0	76	102	4965	102	4889	0.0	0.02086316220085907
chr19	ZNF724	23242588	23242710	0	123	102	3331	102	3208	0.0	0.031795511221945134
chr19	AC092329.4	23272618	23272723	0	106	102	4965	102	4859	0.0	0.020991973657131097
chr19	AC092329.4	23272618	23272719	0	102	102	4965	102	4863	0.0	0.020974706971005553
chr19	ZNF91	23307315	23307402	0	88	768	7683	768	7595	0.0	0.1011191573403555
chr19	ZNF91	23373741	23373837	0	97	768	7683	768	7586	0.0	0.101239124703401
chr19	ZNF91	23374637	23374764	0	128	768	7683	768	7555	0.0	0.10165453342157511
chr19	LINC01224	23405257	23405335	3325	79	50459	3998	47134	3919	42.08860759493671	12.027047716254147
chr19	LINC01224	23402176	23402512	752	337	50459	3998	49707	3661	2.2314540059347183	13.577437858508604
chr19	LINC01224	23404950	23405108	4606	159	50459	3998	45853	3839	28.968553459119498	11.943995832247982
chr19	ZNF675	23656721	23656822	0	102	15654	4781	15654	4679	0.0	3.345586663817055
chr19	ZNF681	23755424	23755551	0	128	114152	6501	114152	6373	0.0	17.911815471520477
chr19	LINC00662	27686871	27686998	0	128	204	28747	204	28619	0.0	0.007128131660784793
chr19	LINC00662	27684694	27685275	0	582	204	28747	204	28165	0.0	0.007243032132078821
chr19	LINC00662	27685056	27685275	0	220	204	28747	204	28527	0.0	0.007151119991586918
chr19	LINC00662	27732795	27732967	0	173	204	28747	204	28574	0.0	0.0071393574578287955
chr19	LINC00662	27727816	27727979	0	164	204	28747	204	28583	0.0	0.007137109470664381
chr19	LINC00662	27746097	27746340	0	244	204	28747	204	28503	0.0	0.007157141353541732
chr19	LINC00662	27778710	27779043	0	334	204	28747	204	28413	0.0	0.007179812057860838
chr19	LINC00662	27739568	27739716	0	149	204	28747	204	28598	0.0	0.007133365969648227
chr19	LINC00662	27771663	27771989	0	327	204	28747	204	28420	0.0	0.007178043631245602
chr19	LINC00662	27771543	27771989	0	447	204	28747	204	28300	0.0	0.007208480565371025
chr19	LINC00662	27775792	27775906	0	115	204	28747	204	28632	0.0	0.007124895222129086
chr19	AC005381.1	28461286	28461497	0	212	0	1279	0	1067	0.0	0.0
chr19	AC005381.1	28453843	28453935	0	93	0	1279	0	1186	0.0	0.0
chr19	C19ORF12	29708253	29708423	0	171	13429	2513	13429	2342	0.0	5.73398804440649
chr19	C19ORF12	29705273	29705394	0	122	13429	2513	13429	2391	0.0	5.616478460895023
chr19	LINC01837	31887754	31887926	0	173	400	7200	400	7027	0.0	0.05692329585883023
chr19	LINC01837	31941620	31941662	0	43	400	7200	400	7157	0.0	0.05588933910856504
chr19	LINC01837	31942309	31942447	0	139	400	7200	400	7061	0.0	0.0566491998300524
chr19	LINC01837	31922728	31922910	0	183	400	7200	400	7017	0.0	0.05700441784238278
chr19	LINC01837	31930851	31930946	0	96	400	7200	400	7104	0.0	0.05630630630630631
chr19	LINC01837	31859871	31859943	0	73	400	7200	400	7127	0.0	0.0561245966044619
chr19	LINC01837	31908195	31908294	0	100	400	7200	400	7100	0.0	0.056338028169014086
chr19	LINC01837	31930287	31930421	0	135	400	7200	400	7065	0.0	0.056617126680820945
chr19	LINC01837	32010423	32010556	0	134	400	7200	400	7066	0.0	0.056609114067364845
chr19	LINC01837	31976726	31976973	102	248	400	7200	298	6952	0.4112903225806452	0.04286536248561565
chr19	ANKRD27	32642023	32642145	0	123	0	7660	0	7537	0.0	0.0
chr19	ANKRD27	32643430	32643484	0	55	0	7660	0	7605	0.0	0.0
chr19	ANKRD27	32646458	32646615	0	158	0	7660	0	7502	0.0	0.0
chr19	ANKRD27	32658913	32659045	0	133	0	7660	0	7527	0.0	0.0
chr19	SLC7A9	32843854	32843951	1998	98	4301	2601	2303	2503	20.387755102040817	0.9200958849380743
chr19	SLC7A9	32864628	32864776	25	149	4301	2601	4276	2452	0.16778523489932887	1.7438825448613378
chr19	CEP89	32923438	32923542	0	105	15596	4642	15596	4537	0.0	3.437513775622658
chr19	CEP89	32937012	32937120	255	109	15596	4642	15341	4533	2.3394495412844036	3.384292962717847
chr19	RHPN2	33011678	33011803	0	126	255	4821	255	4695	0.0	0.054313099041533544
chr19	RHPN2	33021570	33021646	0	77	255	4821	255	4744	0.0	0.05375210792580101
chr19	SLC7A10	33210801	33210898	0	98	884	2710	884	2612	0.0	0.33843797856049007
chr19	SLC7A10	33215768	33215973	0	206	884	2710	884	2504	0.0	0.35303514376996803
chr19	PEPD	33500937	33501001	0	65	29180	4498	29180	4433	0.0	6.58244980825626
chr19	PEPD	33396089	33396155	0	67	29180	4498	29180	4431	0.0	6.585420898217107
chr19	PEPD	33387654	33387744	1017	91	29180	4498	28163	4407	11.175824175824175	6.390515089630134
chr19	PEPD	33477079	33477299	0	221	29180	4498	29180	4277	0.0	6.822539162964695
chr19	ZNF599	34772335	34772473	0	139	4551	6455	4551	6316	0.0	0.7205509816339455
chr19	LINC01801	34829163	34829253	0	91	33889	2628	33889	2537	0.0	13.357903035080804
chr19	AC008555.4	34850668	34850794	436	127	2040	1105	1604	978	3.4330708661417324	1.640081799591002
chr19	LINC00904	34904150	34904752	19321	603	325148	3576	305827	2973	32.04145936981758	102.86814665321225
chr19	LINC00904	34904658	34904752	14128	95	325148	3576	311020	3481	148.7157894736842	89.3478885377765
chr19	LINC00904	34897534	34897610	44	77	325148	3576	325104	3499	0.5714285714285714	92.91340382966563
chr19	HPN-AS1	35099204	35099387	0	184	20	4733	20	4549	0.0	0.004396570674873599
chr19	KRTDAP	35488661	35488703	0	43	2145	668	2145	625	0.0	3.432
chr19	DMKN	35498873	35498897	150	25	109511	4934	109361	4909	6.0	22.277653289875737
chr19	DMKN	35497646	35497681	82	36	109511	4934	109429	4898	2.2777777777777777	22.34156798693344
chr19	DMKN	35500377	35500419	114	43	109511	4934	109397	4891	2.6511627906976742	22.3670006133715
chr19	DMKN	35502829	35502886	1076	58	109511	4934	108435	4876	18.551724137931036	22.238515176374076
chr19	DMKN	35507457	35507511	9	55	109511	4934	109502	4879	0.16363636363636364	22.443533510965363
chr19	DMKN	35505938	35505986	213	49	109511	4934	109298	4885	4.346938775510204	22.374206755373592
chr19	DMKN	35509910	35509961	131	52	109511	4934	109380	4882	2.519230769230769	22.404752150757886
chr19	DMKN	35511410	35511593	51	184	109511	4934	109460	4750	0.27717391304347827	23.04421052631579
chr19	DMKN	35502135	35502183	121	49	109511	4934	109390	4885	2.4693877551020407	22.393039918116685
chr19	DMKN	35508204	35508240	111	37	109511	4934	109400	4897	3.0	22.34020829079028
chr19	DMKN	35506125	35506185	45	61	109511	4934	109466	4873	0.7377049180327869	22.463780012312743
chr19	DMKN	35505938	35506049	241	112	109511	4934	109270	4822	2.1517857142857144	22.660721692243882
chr19	DMKN	35506509	35506665	1123	157	109511	4934	108388	4777	7.1528662420382165	22.689554113460332
chr19	SBSN	35526643	35526877	2105	235	11622	962	9517	727	8.957446808510639	13.090784044016505
chr19	ATP4A	35555165	35555334	0	170	153	3922	153	3752	0.0	0.04077825159914712
chr19	ATP4A	35556912	35557088	0	177	153	3922	153	3745	0.0	0.04085447263017356
chr19	IGFLR1	35739709	35739769	0	61	204	1961	204	1900	0.0	0.10736842105263159
chr19	U2AF1L4	35744625	35744738	0	114	153	2606	153	2492	0.0	0.06139646869983949
chr19	U2AF1L4	35745124	35745212	0	89	153	2606	153	2517	0.0	0.060786650774731825
chr19	U2AF1L4	35744490	35744540	0	51	153	2606	153	2555	0.0	0.059882583170254404
chr19	U2AF1L4	35744625	35744692	0	68	153	2606	153	2538	0.0	0.06028368794326241
chr19	U2AF1L4	35743154	35743345	0	192	153	2606	153	2414	0.0	0.06338028169014084
chr19	U2AF1L4	35745124	35745187	0	64	153	2606	153	2542	0.0	0.06018882769472856
chr19	LINC01529	35791016	35791138	0	123	0	4162	0	4039	0.0	0.0
chr19	LINC01529	35791016	35791353	0	338	0	4162	0	3824	0.0	0.0
chr19	PRODH2	35802190	35802276	0	87	10	2577	10	2490	0.0	0.004016064257028112
chr19	NPHS1	35831642	35831762	0	121	51	6717	51	6596	0.0	0.007731958762886598
chr19	NFKBID	35890577	35890696	0	120	0	2959	0	2839	0.0	0.0
chr19	NFKBID	35897650	35897856	0	207	0	2959	0	2752	0.0	0.0
chr19	TYROBP	35907729	35907762	0	34	0	910	0	876	0.0	0.0
chr19	SYNE4	36005332	36005437	0	106	0	2554	0	2448	0.0	0.0
chr19	SYNE4	36003612	36003671	0	60	0	2554	0	2494	0.0	0.0
chr19	SYNE4	36006422	36006671	0	250	0	2554	0	2304	0.0	0.0
chr19	ALKBH6	36013020	36013089	0	70	0	2256	0	2186	0.0	0.0
chr19	ALKBH6	36013343	36013422	0	80	0	2256	0	2176	0.0	0.0
chr19	ALKBH6	36010893	36011065	0	173	0	2256	0	2083	0.0	0.0
chr19	ALKBH6	36010893	36011077	0	185	0	2256	0	2071	0.0	0.0
chr19	ALKBH6	36010893	36011045	0	153	0	2256	0	2103	0.0	0.0
chr19	ALKBH6	36013513	36013588	0	76	0	2256	0	2180	0.0	0.0
chr19	ALKBH6	36013327	36013422	0	96	0	2256	0	2160	0.0	0.0
chr19	THAP8	36039943	36040136	0	194	22901	1807	22901	1613	0.0	14.197768133911966
chr19	POLR2I	36114658	36114713	1564	56	39090	1141	37526	1085	27.928571428571427	34.586175115207375
chr19	ZNF565	36201976	36202050	0	75	12178	3747	12178	3672	0.0	3.3164488017429194
chr19	LINC00665	36322129	36322225	0	97	58340	10527	58340	10430	0.0	5.593480345158198
chr19	LINC00665	36316177	36316348	0	172	58340	10527	58340	10355	0.0	5.633993239980685
chr19	LINC00665	36316177	36316257	0	81	58340	10527	58340	10446	0.0	5.584912885314953
chr19	LINC00665	36322129	36322384	0	256	58340	10527	58340	10271	0.0	5.680070100282348
chr19	LINC00665	36322129	36322222	0	94	58340	10527	58340	10433	0.0	5.591871944790569
chr19	LINC00665	36326289	36327225	0	937	58340	10527	58340	9590	0.0	6.083420229405631
chr19	LINC00665	36326052	36327225	0	1174	58340	10527	58340	9353	0.0	6.237570832887844
chr19	LINC00665	36326481	36327225	0	745	58340	10527	58340	9782	0.0	5.964015538744633
chr19	ZNF260	36518029	36518143	7870	115	42788	5512	34918	5397	68.43478260869566	6.469890680007412
chr19	ZNF260	36517285	36517393	312	109	42788	5512	42476	5403	2.8623853211009176	7.861558393485101
chr19	ZNF529	36551876	36551977	0	102	215608	4665	215608	4563	0.0	47.25136971290817
chr19	ZNF529	36572332	36572392	9827	61	215608	4665	205781	4604	161.0983606557377	44.696133796698525
chr19	ZNF529	36556103	36556197	969	95	215608	4665	214639	4570	10.2	46.96695842450766
chr19	ZNF461	36643793	36643862	0	70	13537	2885	13537	2815	0.0	4.808880994671403
chr19	ZNF461	36658298	36658425	0	128	13537	2885	13537	2757	0.0	4.910047152702212
chr19	ZNF461	36658335	36658425	0	91	13537	2885	13537	2794	0.0	4.845025053686471
chr19	ZNF461	36657652	36657750	0	99	13537	2885	13537	2786	0.0	4.858937544867193
chr19	ZNF461	36658298	36658446	0	149	13537	2885	13537	2736	0.0	4.947733918128655
chr19	ZNF850	36761642	36761738	15	97	27470	7856	27455	7759	0.15463917525773196	3.538471452506766
chr19	ZNF585A	37150834	37150879	0	46	6192	5475	6192	5429	0.0	1.140541536194511
chr19	ZNF585A	37165594	37165696	20	103	6192	5475	6172	5372	0.1941747572815534	1.1489203276247208
chr19	ZNF585B	37198938	37199054	0	117	8610	4304	8610	4187	0.0	2.0563649390972056
chr19	ZNF585B	37207039	37207254	1200	216	8610	4304	7410	4088	5.555555555555555	1.8126223091976517
chr19	ZNF585B	37195880	37196019	0	140	8610	4304	8610	4164	0.0	2.0677233429394812
chr19	ZNF585B	37199399	37199497	408	99	8610	4304	8202	4205	4.121212121212121	1.9505350772889418
chr19	AC016590.1	37267217	37267611	1612	395	16697	2744	15085	2349	4.0810126582278485	6.421881651766709
chr19	AC016590.1	37267217	37267799	1965	583	16697	2744	14732	2161	3.3704974271012005	6.817214252660805
chr19	ZNF569	37454833	37455073	0	241	25459	5026	25459	4785	0.0	5.320585161964472
chr19	ZNF569	37466738	37466804	0	67	25459	5026	25459	4959	0.0	5.133897963299052
chr19	ZNF793-AS1	37498023	37498183	0	161	2616	1411	2616	1250	0.0	2.0928
chr19	ZNF571	37594219	37594319	0	101	15779	6081	15779	5980	0.0	2.638628762541806
chr19	ZNF607	37707913	37708009	0	97	30006	4710	30006	4613	0.0	6.504660741383048
chr19	ZNF607	37707913	37708012	0	100	30006	4710	30006	4610	0.0	6.508893709327549
chr19	ZNF607	37706381	37706583	0	203	30006	4710	30006	4507	0.0	6.657643665409363
chr19	ZNF573	37772937	37772982	0	46	23113	2912	23113	2866	0.0	8.064549895324495
chr19	ZNF573	37770004	37770097	0	94	23113	2912	23113	2818	0.0	8.201916252661462
chr19	ZNF573	37771563	37771696	0	134	23113	2912	23113	2778	0.0	8.320014398848093
chr19	ZNF573	37773660	37773751	0	92	23113	2912	23113	2820	0.0	8.196099290780142
chr19	ZNF573	37770406	37770597	0	192	23113	2912	23113	2720	0.0	8.497426470588236
chr19	ZNF573	37740640	37740710	17	71	23113	2912	23096	2841	0.23943661971830985	8.129531854980641
chr19	ZNF573	37771563	37771690	0	128	23113	2912	23113	2784	0.0	8.302083333333334
chr19	ZNF573	37778432	37778546	0	115	23113	2912	23113	2797	0.0	8.263496603503754
chr19	DPF1	38216352	38216403	0	52	25512	4499	25512	4447	0.0	5.736901281762986
chr19	DPF1	38217459	38217591	19	133	25512	4499	25493	4366	0.14285714285714285	5.838983050847458
chr19	PPP1R14A	38252893	38252974	0	82	2087	1446	2087	1364	0.0	1.530058651026393
chr19	YIF1B	38307596	38307752	69	157	4361	4073	4292	3916	0.4394904458598726	1.0960163432073544
chr19	YIF1B	38309223	38309328	0	106	4361	4073	4361	3967	0.0	1.0993193849256364
chr19	YIF1B	38306913	38306990	0	78	4361	4073	4361	3995	0.0	1.0916145181476846
chr19	GGN	38385646	38387014	0	1369	0	2303	0	934	0.0	0.0
chr19	RASGRP4	38414847	38415123	0	277	2630	4074	2630	3797	0.0	0.6926520937582302
chr19	RASGRP4	38414847	38414916	0	70	2630	4074	2630	4004	0.0	0.6568431568431569
chr19	MAP4K1	38589177	38589275	51	99	21158	3852	21107	3753	0.5151515151515151	5.624034106048494
chr19	MAP4K1	38599924	38599985	0	62	21158	3852	21158	3790	0.0	5.5825857519788915
chr19	CAPN12	38733702	38733781	0	80	1327	4591	1327	4511	0.0	0.29416980713810686
chr19	CAPN12	38734812	38734870	0	59	1327	4591	1327	4532	0.0	0.29280670785525154
chr19	CAPN12	38734141	38734204	0	64	1327	4591	1327	4527	0.0	0.2931301082394522
chr19	CAPN12	38734318	38734389	0	72	1327	4591	1327	4519	0.0	0.29364903739765436
chr19	LGALS4	38803741	38803780	0	40	6179	1410	6179	1370	0.0	4.5102189781021895
chr19	LGALS4	38808743	38808948	0	206	6179	1410	6179	1204	0.0	5.132059800664452
chr19	ECH1	38816283	38816355	0	73	6028	2085	6028	2012	0.0	2.996023856858847
chr19	ECH1	38831308	38831516	0	209	6028	2085	6028	1876	0.0	3.213219616204691
chr19	HNRNPL	38841612	38841682	0	71	306	5612	306	5541	0.0	0.055224688684353006
chr19	RINL	38873885	38873988	165716	104	788811	3567	623095	3463	1593.423076923077	179.9292520935605
chr19	SIRT2	38898378	38898425	0	48	14048	4562	14048	4514	0.0	3.1120957022596367
chr19	SIRT2	38898793	38898918	0	126	14048	4562	14048	4436	0.0	3.1668169522091976
chr19	SIRT2	38889253	38889323	1087	71	14048	4562	12961	4491	15.309859154929578	2.885994210643509
chr19	SIRT2	38890564	38890662	47	99	14048	4562	14001	4463	0.47474747474747475	3.137127492717903
chr19	SIRT2	38891793	38891966	939	174	14048	4562	13109	4388	5.396551724137931	2.9874658158614404
chr19	SARS2	38920085	38920149	0	65	37	2934	37	2869	0.0	0.012896479609620077
chr19	SARS2	38922001	38922078	0	78	37	2934	37	2856	0.0	0.012955182072829132
chr19	SARS2	38928268	38928350	0	83	37	2934	37	2851	0.0	0.012977902490354262
chr19	IFNL4	39247707	39247851	0	145	0	1842	0	1697	0.0	0.0
chr19	IFNL4	39247923	39247995	0	73	0	1842	0	1769	0.0	0.0
chr19	GMFG	39329543	39329626	512716	84	731932	1395	219216	1311	6103.761904761905	167.21281464530892
chr19	GMFG	39335260	39335310	2964	51	731932	1395	728968	1344	58.11764705882353	542.3869047619048
chr19	GMFG	39329547	39329626	506920	80	731932	1395	225012	1315	6336.5	171.11178707224335
chr19	GMFG	39335434	39335531	1622	98	731932	1395	730310	1297	16.551020408163264	563.0763299922899
chr19	GMFG	39333076	39333126	5436	51	731932	1395	726496	1344	106.58823529411765	540.547619047619
chr19	GMFG	39335434	39335554	1863	121	731932	1395	730069	1274	15.396694214876034	573.052590266876
chr19	PAF1	39389639	39389761	4165	123	90245	2637	86080	2514	33.86178861788618	34.24025457438345
chr19	PAF1	39390259	39390289	1032	31	90245	2637	89213	2606	33.29032258064516	34.23369148119724
chr19	PAF1	39387158	39387227	840	70	90245	2637	89405	2567	12.0	34.82859368913128
chr19	DYRK1B	39826951	39826987	0	37	2739	3204	2739	3167	0.0	0.8648563309125356
chr19	FBL	39840232	39840327	1310	96	24370	2147	23060	2051	13.645833333333334	11.243295953193565
chr19	FBL	39840616	39840787	3776	172	24370	2147	20594	1975	21.953488372093023	10.427341772151898
chr19	FBL	39840619	39840787	3586	169	24370	2147	20784	1978	21.218934911242602	10.507583417593528
chr19	FBL	39840655	39840787	1785	133	24370	2147	22585	2014	13.421052631578947	11.214001986097319
chr19	ZNF780B	40048917	40049056	0	140	260456	9246	260456	9106	0.0	28.602679551943773
chr19	ZNF780B	40055415	40055576	0	162	260456	9246	260456	9084	0.0	28.671950682518712
chr19	ZNF780A	40090165	40090235	0	71	0	5940	0	5869	0.0	0.0
chr19	ZNF780A	40089259	40089414	0	156	0	5940	0	5784	0.0	0.0
chr19	CCNP	40224721	40224811	0	91	357	2051	357	1960	0.0	0.18214285714285713
chr19	AKT2	40236256	40236385	0	130	188	12439	188	12309	0.0	0.01527337720367211
chr19	AKT2	40240044	40240110	0	67	188	12439	188	12372	0.0	0.015195602974458454
chr19	AKT2	40265221	40265351	0	131	188	12439	188	12308	0.0	0.015274618134546636
chr19	AKT2	40265258	40265351	0	94	188	12439	188	12345	0.0	0.015228837586067233
chr19	AKT2	40234448	40234571	0	124	188	12439	188	12315	0.0	0.015265935850588714
chr19	AKT2	40240044	40240121	0	78	188	12439	188	12361	0.0	0.015209125475285171
chr19	AKT2	40244318	40244414	0	97	188	12439	188	12342	0.0	0.01523253929671042
chr19	AKT2	40282216	40282304	0	89	188	12439	188	12350	0.0	0.015222672064777327
chr19	C19ORF47	40341838	40341890	0	53	290305	2632	290305	2579	0.0	112.56494765412951
chr19	C19ORF47	40332521	40332643	685	123	290305	2632	289620	2509	5.569105691056911	115.43244320446394
chr19	C19ORF47	40334834	40334904	214	71	290305	2632	290091	2561	3.0140845070422535	113.27254978524014
chr19	PRX	40398619	40398816	0	198	204	6803	204	6605	0.0	0.03088569265707797
chr19	PRX	40408157	40408256	0	100	204	6803	204	6703	0.0	0.03043413396986424
chr19	PRX	40408339	40408383	0	45	204	6803	204	6758	0.0	0.030186445693992304
chr19	PRX	40398113	40398259	153	147	204	6803	51	6656	1.0408163265306123	0.007662259615384615
chr19	SERTAD3	40442322	40442515	0	194	0	1709	0	1515	0.0	0.0
chr19	BLVRB	40451363	40451492	0	130	103	1617	103	1487	0.0	0.06926698049764626
chr19	NUMBL	40686910	40686995	0	86	136	5408	136	5322	0.0	0.025554302893649003
chr19	COQ8B	40703714	40703855	0	142	19490	11023	19490	10881	0.0	1.7911956621634042
chr19	COQ8B	40705324	40705447	697	124	19490	11023	18793	10899	5.620967741935484	1.7242866318010828
chr19	COQ8B	40710058	40710136	807	79	19490	11023	18683	10944	10.215189873417721	1.7071454678362572
chr19	COQ8B	40714066	40714133	0	68	19490	11023	19490	10955	0.0	1.7790963030579643
chr19	COQ8B	40714530	40714635	664	106	19490	11023	18826	10917	6.264150943396227	1.7244664285059998
chr19	COQ8B	40713739	40713869	0	131	19490	11023	19490	10892	0.0	1.789386705839148
chr19	COQ8B	40705349	40705447	593	99	19490	11023	18897	10924	5.98989898989899	1.7298608568290004
chr19	COQ8B	40716586	40716703	0	118	19490	11023	19490	10905	0.0	1.7872535534158642
chr19	COQ8B	40705095	40705447	1536	353	19490	11023	17954	10670	4.351274787535411	1.6826616682286786
chr19	COQ8B	40714066	40714153	0	88	19490	11023	19490	10935	0.0	1.7823502514860539
chr19	CYP2A6	40849817	40849980	0	164	100	2222	100	2058	0.0	0.04859086491739553
chr19	CYP2A7	40881588	40881751	1275	164	385846	2583	384571	2419	7.774390243902439	158.9793303017776
chr19	TGFB1	41341882	41342030	0	149	1871	3272	1871	3123	0.0	0.5991034261927634
chr19	TGFB1	41342169	41342247	0	79	1871	3272	1871	3193	0.0	0.5859693078609458
chr19	B9D2	41362982	41363077	0	96	0	1486	0	1390	0.0	0.0
chr19	EXOSC5	41392866	41392980	0	115	46	1373	46	1258	0.0	0.03656597774244833
chr19	EXOSC5	41392080	41392146	46	67	46	1373	0	1306	0.6865671641791045	0.0
chr19	DMAC2	41433271	41433434	0	164	0	2624	0	2460	0.0	0.0
chr19	DMAC2	41436391	41436472	0	82	0	2624	0	2542	0.0	0.0
chr19	DMAC2	41438217	41438414	0	198	0	2624	0	2426	0.0	0.0
chr19	PCAT19	41479080	41479284	0	205	0	5541	0	5336	0.0	0.0
chr19	PCAT19	41494539	41495427	0	889	0	5541	0	4652	0.0	0.0
chr19	PCAT19	41456615	41456918	0	304	0	5541	0	5237	0.0	0.0
chr19	PCAT19	41474465	41474539	0	75	0	5541	0	5466	0.0	0.0
chr19	PCAT19	41494539	41494648	0	110	0	5541	0	5431	0.0	0.0
chr19	PCAT19	41495301	41495427	0	127	0	5541	0	5414	0.0	0.0
chr19	PCAT19	41456590	41456923	0	334	0	5541	0	5207	0.0	0.0
chr19	PCAT19	41456615	41456923	0	309	0	5541	0	5232	0.0	0.0
chr19	CEACAM7	41683784	41684063	0	280	52	2660	52	2380	0.0	0.021848739495798318
chr19	LYPD4	41839507	41839583	148	77	100106	2171	99958	2094	1.922077922077922	47.735434574976125
chr19	RABAC1	41958285	41958383	0	99	0	1564	0	1465	0.0	0.0
chr19	RABAC1	41957017	41957119	0	103	0	1564	0	1461	0.0	0.0
chr19	GRIK5	42063300	42063525	0	226	0	5036	0	4810	0.0	0.0
chr19	POU2F2	42117249	42117366	0	118	51	8966	51	8848	0.0	0.005764014466546112
chr19	POU2F2	42091866	42091940	0	75	51	8966	51	8891	0.0	0.0057361376673040155
chr19	POU2F2	42092068	42092270	0	203	51	8966	51	8763	0.0	0.005819924683327628
chr19	POU2F2	42117249	42117432	0	184	51	8966	51	8782	0.0	0.005807333181507629
chr19	POU2F2	42116708	42117005	0	298	51	8966	51	8668	0.0	0.005883710198431011
chr19	DEDD2	42216679	42217045	0	367	0	2616	0	2249	0.0	0.0
chr19	DEDD2	42202050	42202072	0	23	0	2616	0	2593	0.0	0.0
chr19	DEDD2	42201988	42202072	0	85	0	2616	0	2531	0.0	0.0
chr19	GSK3A	42232495	42232682	0	188	0	5487	0	5299	0.0	0.0
chr19	GSK3A	42234352	42234459	0	108	0	5487	0	5379	0.0	0.0
chr19	GSK3A	42236857	42236941	0	85	0	5487	0	5402	0.0	0.0
chr19	GSK3A	42239954	42240142	0	189	0	5487	0	5298	0.0	0.0
chr19	GSK3A	42230678	42230867	0	190	0	5487	0	5297	0.0	0.0
chr19	GSK3A	42231046	42231192	0	147	0	5487	0	5340	0.0	0.0
chr19	GSK3A	42231562	42231764	0	203	0	5487	0	5284	0.0	0.0
chr19	GSK3A	42232495	42232594	0	100	0	5487	0	5387	0.0	0.0
chr19	GSK3A	42233285	42233383	0	99	0	5487	0	5388	0.0	0.0
chr19	GSK3A	42233842	42233866	0	25	0	5487	0	5462	0.0	0.0
chr19	GSK3A	42233842	42233869	0	28	0	5487	0	5459	0.0	0.0
chr19	GSK3A	42233842	42233931	0	90	0	5487	0	5397	0.0	0.0
chr19	GSK3A	42233995	42234191	0	197	0	5487	0	5290	0.0	0.0
chr19	GSK3A	42235001	42235119	0	119	0	5487	0	5368	0.0	0.0
chr19	GSK3A	42235001	42235115	0	115	0	5487	0	5372	0.0	0.0
chr19	GSK3A	42236006	42236141	0	136	0	5487	0	5351	0.0	0.0
chr19	CNFN	42389488	42389568	0	81	854	618	854	537	0.0	1.590316573556797
chr19	LIPE	42406160	42406388	10266	229	94708	5175	84442	4946	44.8296943231441	17.07278608976951
chr19	LIPE	42410306	42410842	32698	537	94708	5175	62010	4638	60.890130353817504	13.369987063389392
chr19	CEACAM1	42511575	42511628	0	54	0	5542	0	5488	0.0	0.0
chr19	CEACAM1	42518947	42519235	0	289	0	5542	0	5253	0.0	0.0
chr19	CEACAM1	42515010	42515103	0	94	0	5542	0	5448	0.0	0.0
chr19	CEACAM1	42516772	42516865	0	94	0	5542	0	5448	0.0	0.0
chr19	PSG3	42723941	42724025	98	85	92110	3408	92012	3323	1.1529411764705881	27.689437255492024
chr19	PSG3	42733386	42733726	8288	341	92110	3408	83822	3067	24.3049853372434	27.330290185849364
chr19	PSG8	42754987	42755266	7955	280	190282	3697	182327	3417	28.410714285714285	53.35879426397425
chr19	PSG8	42758001	42758280	51	280	190282	3697	190231	3417	0.18214285714285713	55.67193444541996
chr19	PSG8	42763915	42764281	51	367	190282	3697	190231	3330	0.13896457765667575	57.12642642642643
chr19	PSG8	42758601	42758911	1020	311	190282	3697	189262	3386	3.279742765273312	55.89545186060248
chr19	PSG8	42758601	42758941	1020	341	190282	3697	189262	3356	2.9912023460410557	56.395113230035754
chr19	PSG1	42868755	42869034	476	280	50091	4967	49615	4687	1.7	10.585662470663538
chr19	PSG1	42871766	42872045	0	280	50091	4967	50091	4687	0.0	10.687219970130148
chr19	PSG6	42916124	42916487	1086	364	7668	3437	6582	3073	2.9835164835164836	2.141880898145135
chr19	PSG6	42907575	42907854	51	280	7668	3437	7617	3157	0.18214285714285713	2.412733607855559
chr19	PSG6	42907575	42907937	127	363	7668	3437	7541	3074	0.349862258953168	2.4531554977228365
chr19	PSG7	42935403	42935769	408	367	1224	4421	816	4054	1.111716621253406	0.20128268376911693
chr19	PSG11	43018769	43019048	0	280	51	3090	51	2810	0.0	0.018149466192170817
chr19	PSG11	43024690	43025056	0	367	51	3090	51	2723	0.0	0.01872934263679765
chr19	PSG11	43019372	43019712	0	341	51	3090	51	2749	0.0	0.018552200800291015
chr19	PSG11	43015766	43016045	0	280	51	3090	51	2810	0.0	0.018149466192170817
chr19	PSG5	43178878	43179157	102	280	11424	4688	11322	4408	0.36428571428571427	2.5685117967332123
chr19	PSG4	43194994	43195273	0	280	0	5236	0	4956	0.0	0.0
chr19	PSG4	43197996	43198275	0	280	0	5236	0	4956	0.0	0.0
chr19	PSG4	43203885	43204251	0	367	0	5236	0	4869	0.0	0.0
chr19	PSG4	43198597	43198937	0	341	0	5236	0	4895	0.0	0.0
chr19	PSG4	43204762	43204947	0	186	0	5236	0	5050	0.0	0.0
chr19	PSG9	43258856	43259135	0	280	2382	5055	2382	4775	0.0	0.49884816753926703
chr19	PSG9	43261859	43262138	0	280	2382	5055	2382	4775	0.0	0.49884816753926703
chr19	PHLDB3	43487023	43487123	0	101	45	4568	45	4467	0.0	0.010073875083948958
chr19	ETHE1	43526200	43526349	0	150	54	1596	54	1446	0.0	0.03734439834024896
chr19	XRCC1	43560909	43561020	0	112	102	2762	102	2650	0.0	0.038490566037735846
chr19	XRCC1	43574909	43575002	0	94	102	2762	102	2668	0.0	0.03823088455772114
chr19	ZNF428	43608504	43608603	0	100	0	1557	0	1457	0.0	0.0
chr19	PLAUR	43655438	43655573	0	136	1020	4200	1020	4064	0.0	0.25098425196850394
chr19	PLAUR	43665315	43665459	0	145	1020	4200	1020	4055	0.0	0.25154130702836003
chr19	PLAUR	43652224	43652371	0	148	1020	4200	1020	4052	0.0	0.25172754195459035
chr19	ZNF112	44340415	44340542	0	128	685	3854	685	3726	0.0	0.1838432635534085
chr19	ZNF112	44343253	44343302	0	50	685	3854	685	3804	0.0	0.18007360672975814
chr19	ZNF285	44392339	44392466	0	128	30009	6726	30009	6598	0.0	4.548196423158533
chr19	ZNF285	44394519	44394540	0	22	30009	6726	30009	6704	0.0	4.476282816229117
chr19	ZNF180	44479282	44479409	94	128	23257	4714	23163	4586	0.734375	5.050806803314435
chr19	ZNF180	44484360	44484435	0	76	23257	4714	23257	4638	0.0	5.0144458818456235
chr19	CEACAM20	44511636	44511672	0	37	4501	2207	4501	2170	0.0	2.074193548387097
chr19	CEACAM20	44516945	44517224	510	280	4501	2207	3991	1927	1.8214285714285714	2.0710949662688116
chr19	TRAPPC6A	45165126	45165194	40115	69	78473	939	38358	870	581.3768115942029	44.08965517241379
chr19	ERCC2	45355664	45355728	307	65	56083	5327	55776	5262	4.723076923076923	10.599771949828963
chr19	ERCC2	45364423	45364547	598	125	56083	5327	55485	5202	4.784	10.666089965397925
chr19	ERCC2	45369069	45369147	0	79	56083	5327	56083	5248	0.0	10.686547256097562
chr19	ERCC2	45370132	45370232	0	101	56083	5327	56083	5226	0.0	10.73153463451971
chr19	PPP1R13L	45382526	45382726	0	201	344323	5042	344323	4841	0.0	71.12642016112373
chr19	PPP1R13L	45404998	45405081	405	84	344323	5042	343918	4958	4.821428571428571	69.36627672448569
chr19	PPP1R13L	45401998	45402124	0	127	344323	5042	344323	4915	0.0	70.05554425228891
chr19	ERCC1	45413962	45414034	0	73	11661	5262	11661	5189	0.0	2.2472538061283482
chr19	ERCC1	45421177	45421393	0	217	11661	5262	11661	5045	0.0	2.3113974231912784
chr19	ERCC1	45414860	45414960	0	101	11661	5262	11661	5161	0.0	2.2594458438287153
chr19	ERCC1	45413676	45413745	120	70	11661	5262	11541	5192	1.7142857142857142	2.2228428351309706
chr19	ERCC1	45419410	45419489	3258	80	11661	5262	8403	5182	40.725	1.6215746815901197
chr19	RTN2	45488636	45488706	656	71	497650	3171	496994	3100	9.23943661971831	160.32064516129032
chr19	RTN2	45489345	45489553	709	209	497650	3171	496941	2962	3.3923444976076556	167.772113436867
chr19	RTN2	45493159	45493378	2706	220	497650	3171	494944	2951	12.3	167.72077261945103
chr19	EML2	45616460	45616558	172	99	36470	6562	36298	6463	1.7373737373737375	5.616277270617361
chr19	EML2	45617629	45617697	120	69	36470	6562	36350	6493	1.7391304347826086	5.59833667026028
chr19	EML2	45619059	45619191	0	133	36470	6562	36470	6429	0.0	5.67273292891585
chr19	EML2	45621482	45621637	336	156	36470	6562	36134	6406	2.1538461538461537	5.640649391195754
chr19	EML2	45624718	45624818	204	101	36470	6562	36266	6461	2.01980198019802	5.613062993344683
chr19	EML2	45629950	45630046	683	97	36470	6562	35787	6465	7.041237113402062	5.535498839907192
chr19	EML2	45614825	45615036	1510	212	36470	6562	34960	6350	7.122641509433962	5.505511811023622
chr19	EML2	45618821	45618943	0	123	36470	6562	36470	6439	0.0	5.663922969405188
chr19	EML2	45628697	45628795	0	99	36470	6562	36470	6463	0.0	5.64289029862293
chr19	SNRPD2	45690571	45690667	0	97	447	1443	447	1346	0.0	0.33209509658246655
chr19	SNRPD2	45689232	45689347	54	116	447	1443	393	1327	0.46551724137931033	0.2961567445365486
chr19	SIX5	45766349	45767155	30201	807	61966	3497	31765	2690	37.42379182156134	11.808550185873607
chr19	DMPK	45771770	45771928	0	159	12161	4865	12161	4706	0.0	2.5841478963025923
chr19	DMPK	45780322	45780381	0	60	12161	4865	12161	4805	0.0	2.530905306971904
chr19	AC011530.1	45784640	45784715	0	76	408	865	408	789	0.0	0.5171102661596958
chr19	DMPK	45780213	45780381	0	169	12161	4865	12161	4696	0.0	2.5896507666098807
chr19	DMPK	45782192	45782250	0	59	12161	4865	12161	4806	0.0	2.5303786933000416
chr19	SYMPK	45861899	45862027	3702	129	354933	10339	351231	10210	28.697674418604652	34.400685602350634
chr19	IGFL2-AS1	46195677	46195838	357	162	92395	3342	92038	3180	2.2037037037037037	28.942767295597484
chr19	IGFL2-AS1	46198407	46198442	1485	36	92395	3342	90910	3306	41.25	27.49848759830611
chr19	IGFL2-AS1	46190284	46190414	306	131	92395	3342	92089	3211	2.33587786259542	28.679227654936156
chr19	IGFL2-AS1	46190223	46190414	306	192	92395	3342	92089	3150	1.59375	29.234603174603176
chr19	IGFL2-AS1	46202534	46202734	1285	201	92395	3342	91110	3141	6.393034825870647	29.00668576886342
chr19	PRKD2	46713862	46714001	3238	140	22041	5270	18803	5130	23.12857142857143	3.665302144249513
chr19	PRKD2	46685424	46685521	0	98	22041	5270	22041	5172	0.0	4.2616009280742455
chr19	STRN4	46746148	46746211	0	64	9700	7060	9700	6996	0.0	1.3865065751858205
chr19	STRN4	46740163	46740285	0	123	9700	7060	9700	6937	0.0	1.398298976502811
chr19	STRN4	46733815	46733875	0	61	9700	7060	9700	6999	0.0	1.3859122731818831
chr19	AP2S1	46839464	46839620	0	157	136	1456	136	1299	0.0	0.10469591993841416
chr19	AP2S1	46839464	46839578	0	115	136	1456	136	1341	0.0	0.10141685309470544
chr19	AP2S1	46845992	46846142	0	151	136	1456	136	1305	0.0	0.10421455938697317
chr19	ZC3H4	47069091	47069343	0	253	933082	5871	933082	5618	0.0	166.0879316482734
chr19	ZC3H4	47086383	47086538	0	156	933082	5871	933082	5715	0.0	163.2689413823272
chr19	BBC3	47226563	47226754	408	192	40334	3188	39926	2996	2.125	13.326435246995995
chr19	BBC3	47228157	47228446	7748	290	40334	3188	32586	2898	26.717241379310344	11.244306418219463
chr19	MEIS3	47406459	47406526	0	68	1278	4243	1278	4175	0.0	0.30610778443113773
chr19	MEIS3	47415050	47415101	0	52	1278	4243	1278	4191	0.0	0.3049391553328561
chr19	SLC8A2	47465728	47466419	1399	692	3701	5282	2302	4590	2.0216763005780347	0.501525054466231
chr19	SLC8A2	47465728	47466147	793	420	3701	5282	2908	4862	1.888095238095238	0.5981077745783628
chr19	NAPA	47500632	47500749	1709	118	73632	4857	71923	4739	14.483050847457626	15.176830554969403
chr19	NAPA	47503422	47503502	459	81	73632	4857	73173	4776	5.666666666666667	15.320979899497488
chr19	NAPA	47503392	47503502	579	111	73632	4857	73053	4746	5.216216216216216	15.392541087231352
chr19	NAPA	47505336	47505543	11506	208	73632	4857	62126	4649	55.31730769230769	13.363303936330393
chr19	ZNF541	47538141	47538439	357	299	65149	4670	64792	4371	1.193979933110368	14.823152596659803
chr19	ZNF541	47539704	47539878	0	175	65149	4670	65149	4495	0.0	14.493659621802003
chr19	ZNF541	47538141	47538496	357	356	65149	4670	64792	4314	1.002808988764045	15.019007881316643
chr19	PLA2G4C	48088685	48088712	0	28	1957	5764	1957	5736	0.0	0.34117852161785217
chr19	PLA2G4C	48090363	48090417	0	55	1957	5764	1957	5709	0.0	0.34279208267647576
chr19	PLA2G4C	48104587	48104724	0	138	1957	5764	1957	5626	0.0	0.34784927124066833
chr19	PLA2G4C	48096698	48097127	0	430	1957	5764	1957	5334	0.0	0.36689163854518186
chr19	PLA2G4C	48108783	48108901	0	119	1957	5764	1957	5645	0.0	0.3466784765279008
chr19	PLA2G4C	48108783	48108922	0	140	1957	5764	1957	5624	0.0	0.34797297297297297
chr19	LIG1	48133980	48134066	132	87	6623	6607	6491	6520	1.5172413793103448	0.9955521472392638
chr19	LIG1	48153871	48153967	0	97	6623	6607	6623	6510	0.0	1.017357910906298
chr19	LIG1	48162261	48162351	0	91	6623	6607	6623	6516	0.0	1.0164211172498465
chr19	LIG1	48151231	48151339	0	109	6623	6607	6623	6498	0.0	1.0192366882117574
chr19	CARD8	48206383	48206520	16508	138	309364	11518	292856	11380	119.6231884057971	25.73427065026362
chr19	CARD8	48218870	48219012	204	143	309364	11518	309160	11375	1.4265734265734267	27.1789010989011
chr19	CARD8	48232452	48232493	128	42	309364	11518	309236	11476	3.0476190476190474	26.946322760543744
chr19	CARD8	48238382	48238532	459	151	309364	11518	308905	11367	3.0397350993377485	27.17559602357702
chr19	CARD8	48249522	48249633	247	112	309364	11518	309117	11406	2.205357142857143	27.101262493424514
chr19	CARD8	48221729	48221855	91309	127	309364	11518	218055	11391	718.9685039370079	19.14274427179352
chr19	CARD8	48246074	48246381	147363	308	309364	11518	162001	11210	478.4512987012987	14.451471900089206
chr19	CARD8	48233271	48233404	267	134	309364	11518	309097	11384	1.992537313432836	27.151879831342235
chr19	CARD8	48232452	48232789	480	338	309364	11518	308884	11180	1.4201183431952662	27.628264758497316
chr19	CARD8	48223718	48223868	1219	151	309364	11518	308145	11367	8.072847682119205	27.108735814198997
chr19	CARD8	48238382	48238526	459	145	309364	11518	308905	11373	3.1655172413793102	27.161259122483074
chr19	CARD8	48242539	48242644	102	106	309364	11518	309262	11412	0.9622641509433962	27.099719593410445
chr19	CCDC114	48318712	48318812	0	101	161	5076	161	4975	0.0	0.032361809045226134
chr19	TMEM143	48345159	48345354	0	196	51	3499	51	3303	0.0	0.015440508628519528
chr19	TMEM143	48360071	48360176	0	106	51	3499	51	3393	0.0	0.015030946065428824
chr19	TMEM143	48360318	48360568	0	251	51	3499	51	3248	0.0	0.015701970443349755
chr19	TMEM143	48360318	48360410	0	93	51	3499	51	3406	0.0	0.014973576042278332
chr19	KDELR1	48387754	48387821	0	68	33	2250	33	2182	0.0	0.015123739688359304
chr19	LMTK3	48509134	48509248	0	115	51	6113	51	5998	0.0	0.008502834278092697
chr19	RPL18	48617790	48617877	327	88	58997	1757	58670	1669	3.715909090909091	35.152786099460755
chr19	RPL18	48615876	48615905	0	30	58997	1757	58997	1727	0.0	34.161551823972204
chr19	AC022154.1	48620798	48620893	10	96	24000	1038	23990	942	0.10416666666666667	25.467091295116774
chr19	CA11	48638239	48638293	1566	55	77993	1956	76427	1901	28.472727272727273	40.203577064702785
chr19	NTN5	48670355	48671006	0	652	42538	2133	42538	1481	0.0	28.72248480756246
chr19	MAMSTR	48714365	48714560	28954	196	75408	2296	46454	2100	147.72448979591837	22.12095238095238
chr19	BCAT2	48807755	48808236	510	482	7045	4283	6535	3801	1.058091286307054	1.7192843988424098
chr19	BCAT2	48796146	48796329	51	184	7045	4283	6994	4099	0.27717391304347827	1.7062698219077823
chr19	HSD17B14	48813432	48813552	0	121	313555	1121	313555	1000	0.0	313.555
chr19	HSD17B14	48813455	48813552	0	98	313555	1121	313555	1023	0.0	306.505376344086
chr19	HSD17B14	48831667	48831759	51	93	313555	1121	313504	1028	0.5483870967741935	304.9649805447471
chr19	PLEKHA4	48861619	48861692	0	74	6366	3788	6366	3714	0.0	1.7140549273021002
chr19	PLEKHA4	48865502	48865610	94	109	6366	3788	6272	3679	0.8623853211009175	1.7048110899701006
chr19	PLEKHA4	48839204	48839263	80	60	6366	3788	6286	3728	1.3333333333333333	1.6861587982832618
chr19	PLEKHA4	48857421	48857496	0	76	6366	3788	6366	3712	0.0	1.714978448275862
chr19	PLEKHA4	48841148	48841310	1185	163	6366	3788	5181	3625	7.269938650306749	1.429241379310345
chr19	TULP2	48895365	48895503	0	139	2303	2263	2303	2124	0.0	1.0842749529190208
chr19	GYS1	48987193	48987385	0	193	141508	4257	141508	4064	0.0	34.81988188976378
chr19	NTF4	49064152	49064295	0	144	0	1474	0	1330	0.0	0.0
chr19	HRC	49152309	49152378	0	70	51	2613	51	2543	0.0	0.02005505308690523
chr19	SLC6A16	49309300	49309411	0	112	14629	3601	14629	3489	0.0	4.192891946116366
chr19	TEAD2	49355958	49355970	56	13	39611	2995	39555	2982	4.3076923076923075	13.264587525150905
chr19	TEAD2	49359843	49360081	6	239	39611	2995	39605	2756	0.02510460251046025	14.370464441219157
chr19	PIH1D1	49447337	49447467	0	131	51	2510	51	2379	0.0	0.021437578814627996
chr19	PIH1D1	49448000	49448062	0	63	51	2510	51	2447	0.0	0.020841847159787496
chr19	PIH1D1	49447337	49447417	0	81	51	2510	51	2429	0.0	0.02099629477151091
chr19	PIH1D1	49447337	49447420	0	84	51	2510	51	2426	0.0	0.021022258862324814
chr19	NOSIP	49556548	49556736	0	189	1956	2911	1956	2722	0.0	0.7185892725936811
chr19	NOSIP	49556548	49556657	0	110	1956	2911	1956	2801	0.0	0.6983220278471974
chr19	IRF3	49660712	49660828	0	117	28716	3464	28716	3347	0.0	8.579623543471765
chr19	IRF3	49661947	49662328	8203	382	28716	3464	20513	3082	21.473821989528794	6.655743024010383
chr19	IRF3	49663342	49663514	0	173	28716	3464	28716	3291	0.0	8.725615314494075
chr19	IRF3	49660712	49660844	0	133	28716	3464	28716	3331	0.0	8.620834584208946
chr19	IRF3	49664673	49664846	14	174	28716	3464	28702	3290	0.08045977011494253	8.72401215805471
chr19	IRF3	49661449	49662328	22464	880	28716	3464	6252	2584	25.527272727272727	2.4195046439628483
chr19	IRF3	49664442	49664673	428	232	28716	3464	28288	3232	1.8448275862068966	8.752475247524753
chr19	IRF3	49664552	49664673	38	122	28716	3464	28678	3342	0.3114754098360656	8.581089168162777
chr19	FUZ	49812250	49812335	2357	86	16551	2967	14194	2881	27.406976744186046	4.926761541131552
chr19	FUZ	49812614	49812736	1838	123	16551	2967	14713	2844	14.94308943089431	5.173347398030942
chr19	FUZ	49808114	49808159	536	46	16551	2967	16015	2921	11.652173913043478	5.482711400205409
chr19	FUZ	49812637	49812736	1648	100	16551	2967	14903	2867	16.48	5.198116498081618
chr19	FUZ	49812446	49812736	4600	291	16551	2967	11951	2676	15.807560137457045	4.465994020926757
chr19	FUZ	49812446	49812685	3168	240	16551	2967	13383	2727	13.2	4.907590759075908
chr19	PTOV1-AS2	49858553	49858626	20052	74	56939	1026	36887	952	270.97297297297297	38.746848739495796
chr19	PNKP	49861771	49861881	288	111	38801	3802	38513	3691	2.5945945945945947	10.434299647791926
chr19	PNKP	49862184	49862281	0	98	38801	3802	38801	3704	0.0	10.475431965442764
chr19	PNKP	49862370	49862463	126	94	38801	3802	38675	3708	1.3404255319148937	10.430151024811218
chr19	PNKP	49863963	49864071	2252	109	38801	3802	36549	3693	20.660550458715598	9.896831844029245
chr19	PNKP	49864178	49864236	1995	59	38801	3802	36806	3743	33.813559322033896	9.833288805770772
chr19	PNKP	49864323	49864403	658	81	38801	3802	38143	3721	8.123456790123457	10.250739048642838
chr19	PNKP	49867468	49867532	0	65	38801	3802	38801	3737	0.0	10.382927481937383
chr19	IL4I1	49896147	49896182	0	36	38	2507	38	2471	0.0	0.01537838931606637
chr19	IL4I1	49901638	49901821	0	184	38	2507	38	2323	0.0	0.016358157554885924
chr19	NUP62	49927693	49927815	0	123	0	2772	0	2649	0.0	0.0
chr19	NUP62	49927693	49927848	0	156	0	2772	0	2616	0.0	0.0
chr19	NUP62	49918507	49918621	0	115	0	2772	0	2657	0.0	0.0
chr19	NUP62	49911104	49911366	0	263	0	2772	0	2509	0.0	0.0
chr19	NUP62	49911104	49911370	0	267	0	2772	0	2505	0.0	0.0
chr19	NUP62	49911104	49911343	0	240	0	2772	0	2532	0.0	0.0
chr19	SIGLEC11	49952297	49952394	6105	98	93943	3184	87838	3086	62.295918367346935	28.46338302009073
chr19	SIGLEC11	49958282	49958570	6	289	93943	3184	93937	2895	0.020761245674740483	32.44801381692574
chr19	VRK3	49997503	49997570	0	68	2662226	7489	2662226	7421	0.0	358.7422180299151
chr19	VRK3	50009235	50009385	0	151	2662226	7489	2662226	7338	0.0	362.7999454892341
chr19	VRK3	50015731	50015793	0	63	2662226	7489	2662226	7426	0.0	358.5006733099919
chr19	VRK3	49995190	49995275	228518	86	2662226	7489	2433708	7403	2657.186046511628	328.7461839794678
chr19	VRK3	50009235	50009289	0	55	2662226	7489	2662226	7434	0.0	358.11487758945384
chr19	IZUMO2	50153676	50153806	51	131	143047	1521	142996	1390	0.3893129770992366	102.87482014388489
chr19	KCNC3	50316032	50316091	48	60	166224	6800	166176	6740	0.8	24.65519287833828
chr19	KCNC3	50320222	50320349	0	128	166224	6800	166224	6672	0.0	24.913669064748202
chr19	NAPSA	50361968	50362092	4791	125	166577	2059	161786	1934	38.328	83.6535677352637
chr19	JOSD2	50507573	50507699	0	127	784	1198	784	1071	0.0	0.7320261437908496
chr19	ASPDH	50512926	50513011	47	86	11311	1675	11264	1589	0.5465116279069767	7.088735053492763
chr19	ASPDH	50512660	50512810	0	151	11311	1675	11311	1524	0.0	7.421916010498688
chr19	SHANK1	50697095	50697122	0	28	93	10516	93	10488	0.0	0.008867276887871853
chr19	SHANK1	50687016	50687040	0	25	93	10516	93	10491	0.0	0.008864741206748641
chr19	SHANK1	50663096	50663169	0	74	93	10516	93	10442	0.0	0.008906339781651024
chr19	C19ORF48	50799293	50799357	0	65	51	2224	51	2159	0.0	0.023622047244094488
chr19	C19ORF48	50802453	50802614	0	162	51	2224	51	2062	0.0	0.024733268671193017
chr19	C19ORF48	50801182	50801349	0	168	51	2224	51	2056	0.0	0.02480544747081712
chr19	C19ORF48	50799271	50799357	0	87	51	2224	51	2137	0.0	0.023865231633130556
chr19	KLK15	50826620	50826757	0	138	0	1623	0	1485	0.0	0.0
chr19	KLK4	50908358	50908495	0	138	105390	1350	105390	1212	0.0	86.95544554455445
chr19	KLK4	50908358	50908491	0	134	105390	1350	105390	1216	0.0	86.66940789473684
chr19	KLK5	50952746	50952814	0	69	38	1576	38	1507	0.0	0.025215660252156602
chr19	KLK6	50967168	50967325	0	158	0	1983	0	1825	0.0	0.0
chr19	KLK6	50968064	50968112	0	49	0	1983	0	1934	0.0	0.0
chr19	KLK7	50981766	50981914	0	149	56990	2454	56990	2305	0.0	24.724511930585685
chr19	KLK7	50982326	50982457	17	132	56990	2454	56973	2322	0.12878787878787878	24.536175710594314
chr19	KLK8	51000423	51000718	0	296	0	1834	0	1538	0.0	0.0
chr19	KLK8	50999995	51000258	0	264	0	1834	0	1570	0.0	0.0
chr19	KLK8	51000423	51000583	0	161	0	1834	0	1673	0.0	0.0
chr19	KLK8	51001531	51001709	0	179	0	1834	0	1655	0.0	0.0
chr19	KLK8	50997750	50997884	0	135	0	1834	0	1699	0.0	0.0
chr19	KLK9	51009182	51009339	7693	158	8702	1448	1009	1290	48.68987341772152	0.7821705426356589
chr19	KLK12	51031875	51032135	0	261	0	1762	0	1501	0.0	0.0
chr19	KLK12	51031779	51032135	0	357	0	1762	0	1405	0.0	0.0
chr19	KLK13	51063585	51063861	0	277	0	2594	0	2317	0.0	0.0
chr19	ETFB	51353131	51353290	0	160	150	5290	150	5130	0.0	0.029239766081871343
chr19	NKG7	51371939	51372074	0	136	0	924	0	788	0.0	0.0
chr19	NKG7	51372160	51372307	0	148	0	924	0	776	0.0	0.0
chr19	NKG7	51372160	51372202	0	43	0	924	0	881	0.0	0.0
chr19	SIGLEC10	51414823	51415108	0	286	0	3547	0	3261	0.0	0.0
chr19	SIGLEC10	51415897	51416167	0	271	0	3547	0	3276	0.0	0.0
chr19	SIGLEC10	51417081	51417465	0	385	0	3547	0	3162	0.0	0.0
chr19	SIGLEC10	51417081	51417358	0	278	0	3547	0	3269	0.0	0.0
chr19	SIGLEC8	51457460	51457739	42	280	51	3178	9	2898	0.15	0.003105590062111801
chr19	SIGLEC8	51457183	51457231	0	49	51	3178	51	3129	0.0	0.016299137104506232
chr19	SIGLEC6	51527746	51527828	0	83	0	4288	0	4205	0.0	0.0
chr19	SIGLEC6	51530436	51530484	0	49	0	4288	0	4239	0.0	0.0
chr19	SIGLEC6	51528159	51528253	0	95	0	4288	0	4193	0.0	0.0
chr19	SIGLEC6	51530436	51530517	0	82	0	4288	0	4206	0.0	0.0
chr19	FPR1	51750202	51750253	0	52	0	2584	0	2532	0.0	0.0
chr19	ZNF577	51886820	51886912	0	93	1110	5101	1110	5008	0.0	0.22164536741214058
chr19	ZNF577	51886115	51886145	0	31	1110	5101	1110	5070	0.0	0.21893491124260356
chr19	ZNF649	51904132	51904245	0	114	3570	3541	3570	3427	0.0	1.0417274584184417
chr19	ZNF649	51899797	51899912	0	116	3570	3541	3570	3425	0.0	1.0423357664233577
chr19	ZNF350	51984047	51984169	0	123	102	4552	102	4429	0.0	0.023030029351998195
chr19	ZNF615	52003696	52003900	0	205	0	4909	0	4704	0.0	0.0
chr19	ZNF615	52000345	52000378	0	34	0	4909	0	4875	0.0	0.0
chr19	ZNF615	52007292	52007330	0	39	0	4909	0	4870	0.0	0.0
chr19	ZNF615	52000258	52000378	0	121	0	4909	0	4788	0.0	0.0
chr19	ZNF615	52000357	52000378	0	22	0	4909	0	4887	0.0	0.0
chr19	ZNF615	52004416	52004723	0	308	0	4909	0	4601	0.0	0.0
chr19	ZNF614	52017575	52017697	0	123	0	5631	0	5508	0.0	0.0
chr19	ZNF616	52122359	52122457	0	99	0	4913	0	4814	0.0	0.0
chr19	ZNF616	52122407	52122457	0	51	0	4913	0	4862	0.0	0.0
chr19	ZNF528-AS1	52396609	52396752	96	144	37060	4684	36964	4540	0.6666666666666666	8.141850220264317
chr19	ZNF528-AS1	52396315	52396499	306	185	37060	4684	36754	4499	1.654054054054054	8.16937097132696
chr19	ZNF528-AS1	52396609	52397267	96	659	37060	4684	36964	4025	0.1456752655538695	9.18360248447205
chr19	ZNF528-AS1	52397194	52397267	0	74	37060	4684	37060	4610	0.0	8.039045553145336
chr19	ZNF83	52614657	52614797	0	141	53702	7542	53702	7401	0.0	7.256046480205377
chr19	ZNF83	52618935	52619062	2540	128	53702	7542	51162	7414	19.84375	6.900728351766928
chr19	ZNF83	52655560	52655687	51	128	53702	7542	53651	7414	0.3984375	7.23644456433774
chr19	ZNF83	52674181	52674253	60	73	53702	7542	53642	7469	0.821917808219178	7.1819520685500065
chr19	ZNF83	52616717	52616875	1226	159	53702	7542	52476	7383	7.710691823899371	7.107679804957335
chr19	ZNF83	52616717	52616841	1226	125	53702	7542	52476	7417	9.808	7.075097748415802
chr19	ZNF83	52617245	52617335	1196	91	53702	7542	52506	7451	13.142857142857142	7.046839350422762
chr19	ZNF611	52707468	52707542	52	75	498257	6713	498205	6638	0.6933333333333334	75.05347996384454
chr19	ZNF611	52716110	52716233	24634	124	498257	6713	473623	6589	198.66129032258064	71.8808620427986
chr19	ZNF611	52729905	52730005	1286	101	498257	6713	496971	6612	12.732673267326733	75.16197822141561
chr19	ZNF611	52714014	52714141	1041	128	498257	6713	497216	6585	8.1328125	75.50736522399393
chr19	ZNF611	52728729	52728831	629	103	498257	6713	497628	6610	6.106796116504855	75.28411497730711
chr19	ZNF611	52707391	52707538	204	148	498257	6713	498053	6565	1.3783783783783783	75.86488956587966
chr19	ZNF611	52715831	52715913	392	83	498257	6713	497865	6630	4.72289156626506	75.09276018099547
chr19	ZNF611	52708176	52708326	0	151	498257	6713	498257	6562	0.0	75.93066138372447
chr19	ZNF611	52707420	52707542	204	123	498257	6713	498053	6590	1.6585365853658536	75.57708649468893
chr19	ZNF611	52711206	52711304	117	99	498257	6713	498140	6614	1.1818181818181819	75.31599637133354
chr19	ZNF600	52763147	52763229	0	83	3493	6973	3493	6890	0.0	0.506966618287373
chr19	ZNF600	52774574	52774701	97	128	3493	6973	3396	6845	0.7578125	0.49612856099342584
chr19	ZNF600	52781316	52781464	204	149	3493	6973	3289	6824	1.3691275167785235	0.4819753810082063
chr19	ZNF28	52808006	52808133	0	128	2088	1934	2088	1806	0.0	1.1561461794019934
chr19	ZNF28	52805144	52805262	0	119	2088	1934	2088	1815	0.0	1.1504132231404958
chr19	ZNF468	52845178	52845296	0	119	2494	4990	2494	4871	0.0	0.512009854239376
chr19	ZNF468	52846557	52846611	0	55	2494	4990	2494	4935	0.0	0.5053698074974671
chr19	ZNF468	52853871	52854107	0	237	2494	4990	2494	4753	0.0	0.5247212286976647
chr19	ZNF468	52853871	52854126	0	256	2494	4990	2494	4734	0.0	0.5268272074355724
chr19	ZNF320	52893778	52893856	272	79	33438	6226	33166	6147	3.4430379746835444	5.395477468683911
chr19	ZNF320	52893778	52893927	496	150	33438	6226	32942	6076	3.3066666666666666	5.421658986175115
chr19	ZNF816	52960026	52960177	558	152	558	3076	0	2924	3.6710526315789473	0.0
chr19	ZNF816	52953283	52953389	0	107	558	3076	558	2969	0.0	0.1879420680363759
chr19	ZNF816	52956191	52956265	0	75	558	3076	558	3001	0.0	0.18593802065978007
chr19	ZNF702P	52974031	52974153	0	123	261	6512	261	6389	0.0	0.04085146345280952
chr19	ZNF702P	52990092	52990210	5	119	261	6512	256	6393	0.04201680672268908	0.040043797903957457
chr19	ZNF702P	52990409	52990532	0	124	261	6512	261	6388	0.0	0.040857858484658734
chr19	ZNF160	53091412	53091497	0	86	58211	7275	58211	7189	0.0	8.097231882042008
chr19	ZNF160	53091412	53091529	0	118	58211	7275	58211	7157	0.0	8.133435797121699
chr19	ZNF160	53091412	53091553	18	142	58211	7275	58193	7133	0.1267605633802817	8.158278424225431
chr19	ZNF415	53115703	53115924	24774	222	70477	3790	45703	3568	111.5945945945946	12.809136771300448
chr19	ZNF415	53115209	53115307	0	99	70477	3790	70477	3691	0.0	19.09428339203468
chr19	ZNF415	53116312	53116433	11493	122	70477	3790	58984	3668	94.20491803278688	16.080697928026172
chr19	ZNF415	53115703	53115811	8427	109	70477	3790	62050	3681	77.31192660550458	16.856832382504756
chr19	ZNF415	53123500	53123655	0	156	70477	3790	70477	3634	0.0	19.393780957622454
chr19	ZNF415	53123792	53123906	0	115	70477	3790	70477	3675	0.0	19.177414965986394
chr19	ZNF415	53123500	53123708	0	209	70477	3790	70477	3581	0.0	19.680815414688634
chr19	ZNF347	53149240	53149367	130	128	44438	9136	44308	9008	1.015625	4.9187388987566605
chr19	ZNF665	53183951	53184080	51	130	9409	6185	9358	6055	0.3923076923076923	1.5454995871180843
chr19	NLRP12	53798242	53798413	0	172	0	4961	0	4789	0.0	0.0
chr19	VSTM1	54042276	54042369	0	94	454	1416	454	1322	0.0	0.3434190620272315
chr19	VSTM1	54055505	54055799	0	295	454	1416	454	1121	0.0	0.4049955396966994
chr19	OSCAR	54099589	54099601	0	13	87	2089	87	2076	0.0	0.04190751445086705
chr19	OSCAR	54099747	54099780	0	34	87	2089	87	2055	0.0	0.042335766423357665
chr19	TFPT	54110050	54110121	0	72	0	1247	0	1175	0.0	0.0
chr19	TMC4	54165418	54165566	0	149	83	3077	83	2928	0.0	0.028346994535519126
chr19	MBOAT7	54188432	54188511	0	80	51	5300	51	5220	0.0	0.009770114942528735
chr19	MBOAT7	54187160	54187287	0	128	51	5300	51	5172	0.0	0.009860788863109048
chr19	LILRA6	54239900	54239951	0	52	0	2564	0	2512	0.0	0.0
chr19	LILRB5	54256042	54256342	51	301	102	3979	51	3678	0.16943521594684385	0.013866231647634585
chr19	LILRB2	54276380	54276456	23795	77	55909	3214	32114	3137	309.02597402597405	10.237169270003188
chr19	LILRA5	54312334	54312370	0	37	0	1544	0	1507	0.0	0.0
chr19	LAIR1	54360021	54360072	0	52	927	7661	927	7609	0.0	0.1218294125377842
chr19	LAIR1	54364294	54364330	0	37	927	7661	927	7624	0.0	0.1215897166841553
chr19	NLRP7	54927604	54927775	0	172	96943	3927	96943	3755	0.0	25.817043941411452
chr19	NLRP7	54947642	54947849	0	208	96943	3927	96943	3719	0.0	26.066953482118848
chr19	NLRP7	54927604	54927738	0	135	96943	3927	96943	3792	0.0	25.565137130801688
chr19	NLRP7	54947468	54947505	0	38	96943	3927	96943	3889	0.0	24.927487786063256
chr19	NLRP7	54947631	54947758	0	128	96943	3927	96943	3799	0.0	25.518031060805477
chr19	GP6	55025217	55025271	0	55	51	2711	51	2656	0.0	0.019201807228915662
chr19	RDH13	55059156	55059275	0	120	0	7482	0	7362	0.0	0.0
chr19	RDH13	55048045	55048257	0	213	0	7482	0	7269	0.0	0.0
chr19	RDH13	55062967	55063217	0	251	0	7482	0	7231	0.0	0.0
chr19	TNNT1	55146433	55146466	0	34	51	2115	51	2081	0.0	0.0245074483421432
chr19	TNNT1	55147998	55148093	0	96	51	2115	51	2019	0.0	0.02526002971768202
chr19	TNNT1	55133552	55133674	0	123	51	2115	51	1992	0.0	0.025602409638554216
chr19	SYT5	55178195	55178368	0	174	172	3349	172	3175	0.0	0.054173228346456694
chr19	TMEM150B	55322647	55322743	0	97	0	1723	0	1626	0.0	0.0
chr19	TMEM150B	55320038	55320166	0	129	0	1723	0	1594	0.0	0.0
chr19	TMEM150B	55320390	55320458	0	69	0	1723	0	1654	0.0	0.0
chr19	COX6B2	55351698	55351890	0	193	0	2992	0	2799	0.0	0.0
chr19	COX6B2	55353311	55353393	0	83	0	2992	0	2909	0.0	0.0
chr19	FAM71E2	55361409	55361434	0	26	0	3231	0	3205	0.0	0.0
chr19	IL11	55368768	55368941	0	174	0	2683	0	2509	0.0	0.0
chr19	UBE2S	55404060	55404147	0	88	3213	2804	3213	2716	0.0	1.1829896907216495
chr19	SHISA7	55438560	55438610	0	51	1887	6088	1887	6037	0.0	0.31257246976975317
chr19	ISOC2	55455635	55455845	0	211	254	3172	254	2961	0.0	0.08578183046268152
chr19	ISOC2	55457091	55457212	0	122	254	3172	254	3050	0.0	0.08327868852459017
chr19	FIZ1	55595619	55595734	51	116	25926	3478	25875	3362	0.4396551724137931	7.696311719214753
chr19	NLRP11	55807852	55808014	0	163	26634	4326	26634	4163	0.0	6.397790055248619
chr19	NLRP11	55817903	55818236	0	334	26634	4326	26634	3992	0.0	6.671843687374749
chr19	NLRP11	55798228	55798304	0	77	26634	4326	26634	4249	0.0	6.26829842315839
chr19	ZSCAN5B	56193119	56193179	34	61	245928	2064	245894	2003	0.5573770491803278	122.76285571642536
chr19	ZNF667	56444130	56444281	0	152	11	8817	11	8665	0.0	0.0012694748990190422
chr19	ZNF667	56449556	56449657	0	102	11	8817	11	8715	0.0	0.0012621916236374069
chr19	AC005498.3	56565940	56566054	0	115	17	2162	17	2047	0.0	0.008304836345872008
chr19	PEG3	56826387	56826463	0	77	14091	8725	14091	8648	0.0	1.6293940795559667
chr19	ZIM2	56782399	56782471	195	73	4228	3080	4033	3007	2.671232876712329	1.3412038576654473
chr19	PEG3	56817745	56817838	0	94	14091	8725	14091	8631	0.0	1.632603406326034
chr19	PEG3	56817745	56817835	0	91	14091	8725	14091	8634	0.0	1.6320361362056983
chr19	PEG3	56833289	56833420	0	132	14091	8725	14091	8593	0.0	1.6398231118352147
chr19	PEG3	56829782	56829921	21	140	14091	8725	14070	8585	0.15	1.638905066977286
chr19	PEG3	56833642	56833763	0	122	14091	8725	14091	8603	0.0	1.6379170056956875
chr19	PEG3	56827133	56827246	0	114	14091	8725	14091	8611	0.0	1.636395308326559
chr19	ZNF460-AS1	57278115	57278182	0	68	5188	1616	5188	1548	0.0	3.351421188630491
chr19	ZNF460-AS1	57276934	57277056	413	123	5188	1616	4775	1493	3.3577235772357725	3.1982585398526457
chr19	ZNF772	57475659	57475786	0	128	102	2414	102	2286	0.0	0.04461942257217848
chr19	ZNF772	57476633	57476672	0	40	102	2414	102	2374	0.0	0.04296545914069082
chr19	ZNF772	57475023	57475146	0	124	102	2414	102	2290	0.0	0.0445414847161572
chr19	ZNF772	57475032	57475146	0	115	102	2414	102	2299	0.0	0.04436711613745106
chr19	ZNF772	57475047	57475146	0	100	102	2414	102	2314	0.0	0.04407951598962835
chr19	ZNF772	57476379	57476672	0	294	102	2414	102	2120	0.0	0.048113207547169815
chr19	ZNF550	57552626	57552722	0	97	51	5093	51	4996	0.0	0.010208166533226582
chr19	ZNF550	57544236	57544583	0	348	51	5093	51	4745	0.0	0.010748155953635406
chr19	ZNF550	57543650	57544583	0	934	51	5093	51	4159	0.0	0.012262563116133687
chr19	ZNF671	57723213	57723340	5877	128	15708	2912	9831	2784	45.9140625	3.53125
chr19	ZNF671	57726907	57727025	1717	119	15708	2912	13991	2793	14.428571428571429	5.009308986752596
chr19	ZNF814	57885882	57885969	0	88	106075	9024	106075	8936	0.0	11.870523724261414
chr19	ZNF814	57875155	57875226	51	72	106075	9024	106024	8952	0.7083333333333334	11.84361036639857
chr19	ZNF814	57870721	57870812	2201	92	106075	9024	103874	8932	23.92391304347826	11.629422301836096
chr19	ZNF417	57915564	57915665	0	102	38014	5283	38014	5181	0.0	7.337193591970662
chr19	ZNF417	57915337	57915531	0	195	38014	5283	38014	5088	0.0	7.471305031446541
chr19	ZNF418	57923191	57923289	343	99	10530	4415	10187	4316	3.4646464646464645	2.3602873030583873
chr19	ZNF418	57932429	57932646	3224	218	10530	4415	7306	4197	14.788990825688073	1.7407672146771505
chr19	ZNF256	57943933	57944060	165	128	12898	2210	12733	2082	1.2890625	6.115754082612872
chr19	ZNF606	57999807	57999896	570	90	29793	7642	29223	7552	6.333333333333333	3.869570974576271
chr19	ZSCAN18	58086905	58087008	0	104	46202	6534	46202	6430	0.0	7.185381026438569
chr19	ZSCAN18	58093227	58093398	0	172	46202	6534	46202	6362	0.0	7.262181703866709
chr19	ZSCAN18	58089864	58090386	2230	523	46202	6534	43972	6011	4.263862332695985	7.315255365163866
chr19	ZSCAN18	58092449	58092568	0	120	46202	6534	46202	6414	0.0	7.203305269722482
chr19	ZNF329	58132241	58132676	28532	436	43959	4234	15427	3798	65.44036697247707	4.06187467087941
chr19	AC010642.2	58312969	58313113	180	145	41239	4472	41059	4327	1.2413793103448276	9.489022417379246
chr19	AC010642.2	58325274	58325361	0	88	41239	4472	41239	4384	0.0	9.406706204379562
chr19	AC010642.2	58322361	58322494	775	134	41239	4472	40464	4338	5.7835820895522385	9.32780082987552
chr19	ZNF497	58357951	58358286	0	336	91956	3901	91956	3565	0.0	25.794109396914447
chr19	A1BG	58352097	58352184	57	88	40682	3597	40625	3509	0.6477272727272727	11.577372470789399
chr19	ZNF497	58358488	58358585	701	98	91956	3901	91255	3803	7.153061224489796	23.995529844859323
chr19	SLC27A5	58498784	58498915	0	132	29662	4687	29662	4555	0.0	6.511964873765093
chr19	MZF1	58572549	58572719	0	171	1992	5903	1992	5732	0.0	0.34752267969295186
chr19	OR4G1P	100275	100432	0	158	0	1758	0	1600	0.0	0.0
chr19	OR4F17	107472	107555	0	84	51	3269	51	3185	0.0	0.016012558869701727
chr19	MADCAM1	497832	498117	0	286	357	2662	357	2376	0.0	0.15025252525252525
chr19	MADCAM1	500111	500159	0	49	357	2662	357	2613	0.0	0.13662456946039037
chr19	MADCAM1	501668	501929	0	262	357	2662	357	2400	0.0	0.14875
chr19	BSG	579499	579656	587799	158	5206982	3151	4619183	2993	3720.246835443038	1543.3287671232877
chr19	BSG	577773	578121	1542	349	5206982	3151	5205440	2802	4.418338108882521	1857.7587437544612
chr19	PALM	740351	740483	5310	133	101291	4924	95981	4791	39.92481203007519	20.033604675433104
chr19	PTBP1	799412	799443	48130	32	5035324	6449	4987194	6417	1504.0625	777.1846657316503
chr19	PTBP1	805491	805569	65999	79	5035324	6449	4969325	6370	835.4303797468355	780.1138147566719
chr19	PTBP1	807868	807902	43245	35	5035324	6449	4992079	6414	1235.5714285714287	778.3097910820081
chr19	PTBP1	805831	805902	1220	72	5035324	6449	5034104	6377	16.944444444444443	789.4157127175788
chr19	PTBP1	805512	805569	48566	58	5035324	6449	4986758	6391	837.3448275862069	780.2782037239868
chr19	KISS1R	918543	918668	0	126	0	1675	0	1549	0.0	0.0
chr19	KISS1R	919873	920106	0	234	0	1675	0	1441	0.0	0.0
chr19	ARID3A	966571	966868	13957	298	144703	7229	130746	6931	46.83557046979866	18.863944596739287
chr19	ARID3A	961761	961940	0	180	144703	7229	144703	7049	0.0	20.528160022698255
chr19	WDR18	985864	985975	9240	112	125302	2003	116062	1891	82.5	61.37599153886833
chr19	WDR18	994019	994088	4828	70	125302	2003	120474	1933	68.97142857142858	62.324883600620794
chr19	CNN2	1026976	1027074	559	99	2272160	3020	2271601	2921	5.646464646464646	777.6792194453955
chr19	CNN2	1036129	1036246	139030	118	2272160	3020	2133130	2902	1178.2203389830509	735.0551343900759
chr19	CNN2	1036066	1036246	143385	181	2272160	3020	2128775	2839	792.182320441989	749.8326875660443
chr19	CNN2	1036878	1037000	1510	123	2272160	3020	2270650	2897	12.276422764227643	783.7935795650673
chr19	ABCA7	1057914	1058059	1326	146	141657	8487	140331	8341	9.082191780821917	16.824241697638172
chr19	ABCA7	1054569	1054694	794	126	141657	8487	140863	8361	6.301587301587301	16.847625882071522
chr19	ABCA7	1055096	1055351	719	256	141657	8487	140938	8231	2.80859375	17.122828331915926
chr19	ABCA7	1055082	1055351	791	270	141657	8487	140866	8217	2.9296296296296296	17.143239625167336
chr19	ABCA7	1057968	1058059	920	92	141657	8487	140737	8395	10.0	16.764383561643836
chr19	ARHGAP45	1068413	1068744	4628	332	404784	6133	400156	5801	13.939759036144578	68.98052059989656
chr19	ARHGAP45	1068332	1068744	4628	413	404784	6133	400156	5720	11.205811138014528	69.95734265734266
chr19	GPX4	1106241	1106266	65534	26	2322068	1885	2256534	1859	2520.5384615384614	1213.8429263044648
chr19	GPX4	1106180	1106266	65585	87	2322068	1885	2256483	1798	753.8505747126437	1254.9961067853171
chr19	STK11	1216267	1216398	742	132	520458	5175	519716	5043	5.621212121212121	103.0569105691057
chr19	MIDN	1253953	1254082	2815	130	390444	4501	387629	4371	21.653846153846153	88.6819949668268
chr19	CIRBP	1271139	1271246	38412	108	816286	5567	777874	5459	355.6666666666667	142.49386334493497
chr19	CIRBP	1269911	1269915	125	5	816286	5567	816161	5562	25.0	146.73876303487953
chr19	CIRBP	1271328	1271467	19126	140	816286	5567	797160	5427	136.61428571428573	146.88778330569374
chr19	CIRBP	1271139	1271467	58364	329	816286	5567	757922	5238	177.3981762917933	144.69683085147003
chr19	CIRBP	1271120	1271246	38900	127	816286	5567	777386	5440	306.2992125984252	142.90183823529412
chr19	CIRBP	1271139	1271365	46606	227	816286	5567	769680	5340	205.31277533039648	144.13483146067415
chr19	CIRBP	1273493	1273715	16139	223	816286	5567	800147	5344	72.37219730941705	149.72810628742516
chr19	CIRBP	1273600	1273715	10989	116	816286	5567	805297	5451	94.73275862068965	147.73381031003487
chr19	PWWP3A	1356323	1356449	14120	127	694598	9648	680478	9521	111.18110236220473	71.47127402583762
chr19	PWWP3A	1358587	1358700	19021	114	694598	9648	675577	9534	166.85087719298247	70.859765051395
chr19	PWWP3A	1358587	1358693	18377	107	694598	9648	676221	9541	171.74766355140187	70.87527512839326
chr19	PWWP3A	1371233	1371390	1279	158	694598	9648	693319	9490	8.094936708860759	73.05785036880927
chr19	NDUFS7	1386517	1386639	0	123	318392	4310	318392	4187	0.0	76.042990207786
chr19	DAZAP1	1418665	1418731	86572	67	2423675	4295	2337103	4228	1292.1194029850747	552.7679754020813
chr19	DAZAP1	1425877	1425960	222265	84	2423675	4295	2201410	4211	2646.0119047619046	522.776062692947
chr19	DAZAP1	1433738	1433827	920	90	2423675	4295	2422755	4205	10.222222222222221	576.1605231866826
chr19	RPS15	1439715	1439826	2989	112	2040851	1135	2037862	1023	26.6875	1992.0449657869012
chr19	RPS15	1439605	1439826	4138	222	2040851	1135	2036713	913	18.63963963963964	2230.791894852136
chr19	REEP6	1496590	1496671	0	82	5784	1718	5784	1636	0.0	3.5354523227383865
chr19	PLK5	1533930	1534041	0	112	12	3988	12	3876	0.0	0.0030959752321981426
chr19	PLK5	1533718	1533848	0	131	12	3988	12	3857	0.0	0.00311122634171636
chr19	SCAMP4	1914978	1915026	3349	49	733836	6808	730487	6759	68.34693877551021	108.07619470335848
chr19	SCAMP4	1918888	1918990	21354	103	733836	6808	712482	6705	207.32038834951456	106.2612975391499
chr19	SCAMP4	1915431	1915544	701	114	733836	6808	733135	6694	6.149122807017544	109.52121302659097
chr19	CSNK1G2	1979162	1979248	30287	87	467344	3302	437057	3215	348.1264367816092	135.94307931570762
chr19	IZUMO4	2097928	2097955	216	28	4993	2228	4777	2200	7.714285714285714	2.1713636363636364
chr19	IZUMO4	2098051	2098127	448	77	4993	2228	4545	2151	5.818181818181818	2.1129707112970713
chr19	IZUMO4	2098786	2098804	0	19	4993	2228	4993	2209	0.0	2.2602987777274786
chr19	IZUMO4	2098975	2099029	0	55	4993	2228	4993	2173	0.0	2.2977450529222274
chr19	DOT1L	2188196	2188289	470	94	812414	9654	811944	9560	5.0	84.93138075313807
chr19	DOT1L	2227362	2227467	248	106	812414	9654	812166	9548	2.339622641509434	85.0613741097612
chr19	AMH	2250336	2250479	909	144	11879	1828	10970	1684	6.3125	6.514251781472684
chr19	OAZ1	2271384	2271530	523998	147	3699685	2110	3175687	1963	3564.612244897959	1617.7722873153336
chr19	SPPL2B	2337114	2337333	1174	220	352215	7292	351041	7072	5.336363636363636	49.63815045248869
chr19	SPPL2B	2330296	2330419	0	124	352215	7292	352215	7168	0.0	49.137137276785715
chr19	THOP1	2786948	2787034	1937	87	783082	6896	781145	6809	22.264367816091955	114.72242620061684
chr19	THOP1	2812198	2812372	634	175	783082	6896	782448	6721	3.6228571428571428	116.41839012051778
chr19	ZNF554	2826249	2826346	0	98	31966	5660	31966	5562	0.0	5.747213232650126
chr19	ZNF554	2833162	2833269	51	108	31966	5660	31915	5552	0.4722222222222222	5.748378962536023
chr19	ZNF57	2912135	2912261	22	127	25748	2312	25726	2185	0.1732283464566929	11.773913043478261
chr19	TLE6	2978197	2978284	203	88	2079	3014	1876	2926	2.3068181818181817	0.6411483253588517
chr19	GNA11	3110148	3110333	76252	186	771237	4595	694985	4409	409.9569892473118	157.62871399410298
chr19	GNA15	3146402	3146591	0	190	510	2761	510	2571	0.0	0.1983663943990665
chr19	NFIC	3425105	3425177	29956	73	1495090	9816	1465134	9743	410.35616438356163	150.37811762290875
chr19	NFIC	3453762	3453916	12320	155	1495090	9816	1482770	9661	79.48387096774194	153.479971017493
chr19	NFIC	3456549	3456635	28991	87	1495090	9816	1466099	9729	333.2298850574713	150.69369924966594
chr19	TJP3	3728423	3728480	0	58	204	3987	204	3929	0.0	0.05192160855179435
chr19	ATCAY	3895126	3895197	0	72	23809	5037	23809	4965	0.0	4.795367573011077
chr19	ATCAY	3922158	3922222	0	65	23809	5037	23809	4972	0.0	4.788616251005632
chr19	NMRK2	3933457	3933697	0	241	0	1149	0	908	0.0	0.0
chr19	PIAS4	4024035	4024120	7344	86	199608	3520	192264	3434	85.3953488372093	55.98835177635411
chr19	CREB3L3	4168350	4168457	0	108	0	2658	0	2550	0.0	0.0
chr19	ANKRD24	4199682	4199769	0	88	1000	4499	1000	4411	0.0	0.22670596236681026
chr19	SHD	4288242	4288362	0	121	0	2071	0	1950	0.0	0.0
chr19	MPND	4358082	4358172	5335	91	62357	2062	57022	1971	58.62637362637363	28.930492135971587
chr19	MPND	4357950	4358172	7187	223	62357	2062	55170	1839	32.228699551569505	30.0
chr19	CHAF1A	4405911	4405962	24792	52	1401952	4343	1377160	4291	476.7692307692308	320.94150547657887
chr19	CHAF1A	4418019	4418076	16879	58	1401952	4343	1385073	4285	291.01724137931035	323.23757292882146
chr19	CHAF1A	4422565	4422795	74458	231	1401952	4343	1327494	4112	322.3290043290043	322.8341439688716
chr19	HDGFL2	4501190	4501317	29115	128	892741	3828	863626	3700	227.4609375	233.41243243243244
chr19	MIR7-3HG	4770545	4770614	0	70	0	2134	0	2064	0.0	0.0
chr19	MIR7-3HG	4770282	4770449	0	168	0	2134	0	1966	0.0	0.0
chr19	MIR7-3HG	4770084	4770221	0	138	0	2134	0	1996	0.0	0.0
chr19	MIR7-3HG	4770548	4770614	0	67	0	2134	0	2067	0.0	0.0
chr19	MIR7-3HG	4770347	4770449	0	103	0	2134	0	2031	0.0	0.0
chr19	MIR7-3HG	4770087	4770221	0	135	0	2134	0	1999	0.0	0.0
chr19	MIR7-3HG	4770523	4770614	0	92	0	2134	0	2042	0.0	0.0
chr19	MIR7-3HG	4770528	4770614	0	87	0	2134	0	2047	0.0	0.0
chr19	KDM4B	5016256	5016339	5869	84	332206	10890	326337	10806	69.86904761904762	30.199611327040532
chr19	KDM4B	5119117	5119219	6017	103	332206	10890	326189	10787	58.41747572815534	30.23908408269213
chr19	SAFB	5648988	5649499	158366	512	1405433	4981	1247067	4469	309.30859375	279.04833296039385
chr19	SAFB	5641739	5641946	171760	208	1405433	4981	1233673	4773	825.7692307692307	258.4690970039807
chr19	SAFB	5641593	5641658	22438	66	1405433	4981	1382995	4915	339.969696969697	281.382502543235
chr19	HSD11B1L	5684988	5685119	4816	132	69686	2790	64870	2658	36.484848484848484	24.40556809631302
chr19	HSD11B1L	5686415	5686527	224	113	69686	2790	69462	2677	1.9823008849557522	25.947702652222638
chr19	HSD11B1L	5684818	5684905	1748	88	69686	2790	67938	2702	19.863636363636363	25.14359733530718
chr19	HSD11B1L	5686899	5686991	1067	93	69686	2790	68619	2697	11.473118279569892	25.442714126807562
chr19	HSD11B1L	5684964	5685119	5152	156	69686	2790	64534	2634	33.02564102564103	24.500379650721335
chr19	HSD11B1L	5684021	5684121	22	101	69686	2790	69664	2689	0.21782178217821782	25.907028635180364
chr19	HSD11B1L	5684992	5685119	4736	128	69686	2790	64950	2662	37.0	24.39894815927874
chr19	ACSBG2	6156430	6156551	0	122	4508	3462	4508	3340	0.0	1.3497005988023951
chr19	ACSBG2	6190583	6190692	293	110	4508	3462	4215	3352	2.6636363636363636	1.2574582338902147
chr19	ACSBG2	6137311	6137415	0	105	4508	3462	4508	3357	0.0	1.342865653857611
chr19	ACSBG2	6175290	6175429	0	140	4508	3462	4508	3322	0.0	1.3570138470800723
chr19	CLPP	6364451	6364639	165331	189	584282	3032	418951	2843	874.7671957671957	147.36229335209285
chr19	CLPP	6366257	6366363	66432	107	584282	3032	517850	2925	620.8598130841121	177.04273504273505
chr19	AC011491.1	6400107	6400221	0	115	0	710	0	595	0.0	0.0
chr19	TRIP10	6741224	6741281	33270	58	864447	3888	831177	3830	573.6206896551724	217.01749347258485
chr19	TRIP10	6746028	6746196	5554	169	864447	3888	858893	3719	32.86390532544379	230.94729766066146
chr19	VAV1	6822418	6822514	0	97	819	4339	819	4242	0.0	0.19306930693069307
chr19	VAV1	6836984	6837050	0	67	819	4339	819	4272	0.0	0.19171348314606743
chr19	ADGRE1	6897148	6897304	0	157	51	3729	51	3572	0.0	0.01427771556550952
chr19	ADGRE1	6904035	6904182	0	148	51	3729	51	3581	0.0	0.014241831890533371
chr19	ADGRE1	6924677	6924872	0	196	51	3729	51	3533	0.0	0.014435324087178035
chr19	MCOLN1	7527519	7527628	306	110	59021	3878	58715	3768	2.7818181818181817	15.582537154989383
chr19	PNPLA6	7534378	7534446	0	69	73313	6495	73313	6426	0.0	11.408807967631496
chr19	PNPLA6	7541983	7542067	217	85	73313	6495	73096	6410	2.552941176470588	11.403432137285492
chr19	PNPLA6	7543006	7543084	49	79	73313	6495	73264	6416	0.620253164556962	11.418952618453865
chr19	PNPLA6	7560647	7560764	0	118	73313	6495	73313	6377	0.0	11.496471695154462
chr19	PNPLA6	7535126	7535213	3479	88	73313	6495	69834	6407	39.53409090909091	10.89964101763696
chr19	PNPLA6	7535126	7535202	3185	77	73313	6495	70128	6418	41.36363636363637	10.926768463695856
chr19	PET100	7630572	7630659	0	88	51	1104	51	1016	0.0	0.05019685039370079
chr19	STXBP2	7641704	7641853	0	150	584	4772	584	4622	0.0	0.12635222847252273
chr19	PET100	7631231	7631321	0	91	51	1104	51	1013	0.0	0.050345508390918066
chr19	STXBP2	7643164	7643245	0	82	584	4772	584	4690	0.0	0.12452025586353944
chr19	STXBP2	7646248	7646344	0	97	584	4772	584	4675	0.0	0.12491978609625669
chr19	STXBP2	7647353	7647511	0	159	584	4772	584	4613	0.0	0.12659874268371993
chr19	STXBP2	7644878	7644934	0	57	584	4772	584	4715	0.0	0.12386002120890774
chr19	STXBP2	7646171	7646344	0	174	584	4772	584	4598	0.0	0.12701174423662462
chr19	RETN	7669820	7669898	0	79	204	520	204	441	0.0	0.46258503401360546
chr19	MCEMP1	7677636	7677726	0	91	126	1913	126	1822	0.0	0.06915477497255763
chr19	CLEC4M	7763392	7763476	0	85	40	3275	40	3190	0.0	0.012539184952978056
chr19	CLEC4M	7767515	7767628	0	114	40	3275	40	3161	0.0	0.012654223347042075
chr19	CLEC4M	7765184	7765268	0	85	40	3275	40	3190	0.0	0.012539184952978056
chr19	EVI5L	7857091	7857124	0	34	156	5020	156	4986	0.0	0.031287605294825514
chr19	LRRC8E	7893716	7893859	0	144	1524	4333	1524	4189	0.0	0.3638099785151587
chr19	LRRC8E	7895598	7895741	0	144	1524	4333	1524	4189	0.0	0.3638099785151587
chr19	MAP2K7	7905807	7905855	16	49	23002	5033	22986	4984	0.32653061224489793	4.611958266452649
chr19	CCL25	8056365	8056499	1015	135	2058	995	1043	860	7.518518518518518	1.2127906976744185
chr19	CERS4	8251043	8251249	0	207	102	3466	102	3259	0.0	0.03129794415464866
chr19	CERS4	8210682	8210862	0	181	102	3466	102	3285	0.0	0.031050228310502283
chr19	CERS4	8251075	8251249	0	175	102	3466	102	3291	0.0	0.03099361896080219
chr19	CERS4	8251109	8251249	0	141	102	3466	102	3325	0.0	0.03067669172932331
chr19	CERS4	8210705	8210862	0	158	102	3466	102	3308	0.0	0.03083434099153567
chr19	ANGPTL4	8369218	8369332	1515	115	8298	2482	6783	2367	13.173913043478262	2.865652724968314
chr19	RAB11B	8399862	8400058	0	197	204	2315	204	2118	0.0	0.09631728045325778
chr19	MARCHF2	8418536	8418807	51	272	56861	2076	56810	1804	0.1875	31.491130820399114
chr19	MARCHF2	8418741	8418807	0	67	56861	2076	56861	2009	0.0	28.303135888501743
chr19	MARCHF2	8430657	8430867	4521	211	56861	2076	52340	1865	21.42654028436019	28.064343163538872
chr19	HNRNPM	8462528	8462581	6	54	19490	4301	19484	4247	0.1111111111111111	4.58770897103838
chr19	HNRNPM	8465479	8465515	25	37	19490	4301	19465	4264	0.6756756756756757	4.5649624765478425
chr19	HNRNPM	8473663	8473708	0	46	19490	4301	19490	4255	0.0	4.580493537015276
chr19	HNRNPM	8483157	8483211	983	55	19490	4301	18507	4246	17.87272727272727	4.358690532265662
chr19	HNRNPM	8488008	8488066	0	59	19490	4301	19490	4242	0.0	4.594530881659595
chr19	NFILZ	8638492	8638656	0	165	0	1698	0	1533	0.0	0.0
chr19	ZNF317	9155924	9156041	0	118	0	5054	0	4936	0.0	0.0
chr19	ZNF317	9157979	9158075	0	97	0	5054	0	4957	0.0	0.0
chr19	ZNF317	9157833	9158075	0	243	0	5054	0	4811	0.0	0.0
chr19	OR7D2	9180697	9180788	0	92	17	3289	17	3197	0.0	0.005317485142320926
chr19	ZNF559-ZNF177	9339192	9339319	0	128	0	3733	0	3605	0.0	0.0
chr19	ZNF559-ZNF177	9337795	9337858	0	64	0	3733	0	3669	0.0	0.0
chr19	ZNF559-ZNF177	9371609	9371752	0	144	0	3733	0	3589	0.0	0.0
chr19	ZNF559-ZNF177	9333014	9333113	0	100	0	3733	0	3633	0.0	0.0
chr19	ZNF559-ZNF177	9341101	9341184	0	84	0	3733	0	3649	0.0	0.0
chr19	ZNF559-ZNF177	9364861	9364948	0	88	0	3733	0	3645	0.0	0.0
chr19	ZNF561-AS1	9627715	9627806	0	92	46434	6441	46434	6349	0.0	7.313592691762483
chr19	ZNF561-AS1	9626783	9626860	0	78	46434	6441	46434	6363	0.0	7.297501178689298
chr19	ZNF561-AS1	9626783	9627806	0	1024	46434	6441	46434	5417	0.0	8.571903267491232
chr19	PIN1	9838011	9838075	0	65	204	2938	204	2873	0.0	0.07100591715976332
chr19	RDH8	10018730	10018910	0	181	1215	2007	1215	1826	0.0	0.6653888280394304
chr19	C3P1	10044070	10044199	51	130	112	4999	61	4869	0.3923076923076923	0.01252823988498665
chr19	C3P1	10052761	10052974	0	214	112	4999	112	4785	0.0	0.023406478578892373
chr19	SHFL	10089110	10089378	0	269	0	3788	0	3519	0.0	0.0
chr19	PPAN	10106822	10107005	0	184	0	2799	0	2615	0.0	0.0
chr19	MRPL4	10256707	10256825	36	119	437249	3641	437213	3522	0.3025210084033613	124.13770584894947
chr19	PDE4A	10459594	10459759	0	166	262576	6586	262576	6420	0.0	40.89968847352025
chr19	ATG4D	10546838	10547115	0	278	3489	2174	3489	1896	0.0	1.8401898734177216
chr19	ATG4D	10552204	10552324	0	121	3489	2174	3489	2053	0.0	1.6994641987335606
chr19	ATG4D	10546838	10547071	0	234	3489	2174	3489	1940	0.0	1.7984536082474227
chr19	ATG4D	10547188	10547253	918	66	3489	2174	2571	2108	13.909090909090908	1.2196394686907022
chr19	ATG4D	10548903	10549034	0	132	3489	2174	3489	2042	0.0	1.708619000979432
chr19	ATG4D	10546838	10547082	0	245	3489	2174	3489	1929	0.0	1.8087091757387248
chr19	SLC44A2	10627721	10627795	0	75	12149	4084	12149	4009	0.0	3.0304315290596158
chr19	SLC44A2	10638022	10638093	0	72	12149	4084	12149	4012	0.0	3.0281655034895314
chr19	SLC44A2	10627919	10628004	0	86	12149	4084	12149	3998	0.0	3.0387693846923463
chr19	SLC44A2	10642896	10643021	0	126	12149	4084	12149	3958	0.0	3.069479535118747
chr19	ILF3	10671357	10671535	204	179	87032	9698	86828	9519	1.1396648044692737	9.121546380922366
chr19	ILF3	10678612	10678704	272	93	87032	9698	86760	9605	2.924731182795699	9.032795419052578
chr19	ILF3	10680345	10680443	88	99	87032	9698	86944	9599	0.8888888888888888	9.057610167725805
chr19	ILF3	10687345	10687708	510	364	87032	9698	86522	9334	1.401098901098901	9.269552174844653
chr19	ILF3	10684415	10684476	153	62	87032	9698	86879	9636	2.467741935483871	9.016085512660855
chr19	ILF3	10666491	10666649	160	159	87032	9698	86872	9539	1.0062893081761006	9.107034280322885
chr19	QTRT1	10706709	10706825	0	117	22598	2287	22598	2170	0.0	10.413824884792627
chr19	QTRT1	10709280	10709364	0	85	22598	2287	22598	2202	0.0	10.262488646684831
chr19	DNM2	10808568	10808580	0	13	2080184	9503	2080184	9490	0.0	219.19747102212855
chr19	DNM2	10803638	10803668	0	31	2080184	9503	2080184	9472	0.0	219.61402027027026
chr19	CARM1	10904950	10905076	0	127	207096	4435	207096	4308	0.0	48.07242339832869
chr19	CARM1	10920435	10920573	2420	139	207096	4435	204676	4296	17.41007194244604	47.64338919925512
chr19	CARM1	10921374	10921443	1583	70	207096	4435	205513	4365	22.614285714285714	47.08201603665521
chr19	CARM1	10908549	10908747	9756	199	207096	4435	197340	4236	49.02512562814071	46.58640226628895
chr19	CARM1	10908549	10908668	6789	120	207096	4435	200307	4315	56.575	46.42108922363847
chr19	CARM1	10908549	10908633	5706	85	207096	4435	201390	4350	67.12941176470588	46.296551724137935
chr19	SMARCA4	11010380	11010531	111	152	1031494	15628	1031383	15476	0.7302631578947368	66.64402946497803
chr19	SMARCA4	11039457	11039553	617	97	1031494	15628	1030877	15531	6.360824742268041	66.37544266306098
chr19	SMARCA4	11058787	11058889	306	103	1031494	15628	1031188	15525	2.970873786407767	66.4211272141707
chr19	SMARCA4	11033766	11033865	17133	100	1031494	15628	1014361	15528	171.33	65.32463936115404
chr19	SMARCA4	10980776	10980852	0	77	1031494	15628	1031494	15551	0.0	66.32975371358755
chr19	SMARCA4	10977652	10977815	0	164	1031494	15628	1031494	15464	0.0	66.70292291774444
chr19	SMARCA4	10983479	10983711	285	233	1031494	15628	1031209	15395	1.2231759656652361	66.98337122442351
chr19	SMARCA4	10965306	10965309	0	4	1031494	15628	1031494	15624	0.0	66.01984126984127
chr19	SMARCA4	11056216	11056382	0	167	1031494	15628	1031494	15461	0.0	66.7158657266671
chr19	SMARCA4	11007901	11008023	0	123	1031494	15628	1031494	15505	0.0	66.52653982586263
chr19	SMARCA4	11033771	11033865	16405	95	1031494	15628	1015089	15533	172.68421052631578	65.35047962402626
chr19	SMARCA4	11047594	11047795	116	202	1031494	15628	1031378	15426	0.5742574257425742	66.85971736030079
chr19	LDLR	11102663	11102786	798	124	155534	6361	154736	6237	6.435483870967742	24.809363476030143
chr19	LDLR	11105219	11105600	94978	382	155534	6361	60556	5979	248.63350785340313	10.128115069409601
chr19	LDLR	11110651	11110771	0	121	155534	6361	155534	6240	0.0	24.925320512820512
chr19	LDLR	11116858	11116998	22	141	155534	6361	155512	6220	0.15602836879432624	25.00192926045016
chr19	LDLR	11120369	11120522	0	154	155534	6361	155534	6207	0.0	25.057837924923472
chr19	LDLR	11106564	11106687	144	124	155534	6361	155390	6237	1.1612903225806452	24.91422158088825
chr19	ANGPTL8	11240134	11240296	75499	163	77047	1229	1548	1066	463.18404907975463	1.452157598499062
chr19	TSPAN16	11298871	11298946	531	76	7214	1568	6683	1492	6.9868421052631575	4.479222520107238
chr19	TSPAN16	11307861	11308061	334	201	7214	1568	6880	1367	1.6616915422885572	5.032918800292611
chr19	CCDC159	11348965	11349083	825	119	16202	3263	15377	3144	6.932773109243698	4.890903307888041
chr19	CCDC159	11352056	11352133	0	78	16202	3263	16202	3185	0.0	5.086970172684459
chr19	CNN1	11539294	11539560	0	267	199612	2816	199612	2549	0.0	78.30992546096509
chr19	CNN1	11549322	11549469	47	148	199612	2816	199565	2668	0.31756756756756754	74.79947526236882
chr19	CNN1	11539294	11539569	0	276	199612	2816	199612	2540	0.0	78.58740157480315
chr19	ZNF627	11604209	11604364	459	156	751325	3821	750866	3665	2.9423076923076925	204.87476125511597
chr19	ZNF833P	11684113	11684165	0	53	590	1596	590	1543	0.0	0.38237200259235254
chr19	ZNF441	11778115	11778179	1834	65	539162	4753	537328	4688	28.215384615384615	114.61774744027304
chr19	ZNF491	11804541	11804667	900	127	3624	3455	2724	3328	7.086614173228346	0.8185096153846154
chr19	ZNF440	11830282	11830409	172	128	37986	6459	37814	6331	1.34375	5.972832096035382
chr19	ZNF440	11830273	11830409	180	137	37986	6459	37806	6322	1.313868613138686	5.9800695982284084
chr19	ZNF763	11977370	11977431	2005	62	64290	3085	62285	3023	32.33870967741935	20.603704928878596
chr19	AC008770.2	11961660	11961758	145	99	35325	2226	35180	2127	1.4646464646464648	16.539727315467793
chr19	ZNF763	11977037	11977164	4374	128	64290	3085	59916	2957	34.171875	20.26242813662496
chr19	ZNF844	12074360	12074421	0	62	15429	6592	15429	6530	0.0	2.3627871362940276
chr19	ZNF433-AS1	12001773	12001822	1104	50	44742	5851	43638	5801	22.08	7.522496121358387
chr19	ZNF433-AS1	11990168	11990381	0	214	44742	5851	44742	5637	0.0	7.937200638637573
chr19	ZNF844	12074030	12074157	435	128	15429	6592	14994	6464	3.3984375	2.3196163366336635
chr19	ZNF788P	12094065	12094184	0	120	33867	5701	33867	5581	0.0	6.068267335602939
chr19	ZNF788P	12093835	12093895	0	61	33867	5701	33867	5640	0.0	6.004787234042553
chr19	ZNF788P	12110633	12110694	242	62	33867	5701	33625	5639	3.903225806451613	5.962936690902643
chr19	ZNF136	12169281	12169391	0	111	95924	5383	95924	5272	0.0	18.194992412746586
chr19	ZNF136	12164465	12164874	0	410	95924	5383	95924	4973	0.0	19.28896038608486
chr19	ZNF136	12185784	12185911	0	128	95924	5383	95924	5255	0.0	18.25385347288297
chr19	AC012618.3	12234712	12234824	51	113	18683	3146	18632	3033	0.45132743362831856	6.1430926475436864
chr19	AC012618.3	12202319	12202551	102	233	18683	3146	18581	2913	0.43776824034334766	6.378647442499142
chr19	ZNF791	12612225	12612365	0	141	19085	6647	19085	6506	0.0	2.9334460498001844
chr19	ZNF791	12624649	12624710	170	62	19085	6647	18915	6585	2.7419354838709675	2.8724373576309796
chr19	ZNF791	12612225	12612316	0	92	19085	6647	19085	6555	0.0	2.911517925247902
chr19	ZNF791	12623699	12623826	0	128	19085	6647	19085	6519	0.0	2.9275962570946463
chr19	WDR83	12672462	12672549	0	88	34204	1664	34204	1576	0.0	21.70304568527919
chr19	RNASEH2A	12807205	12807329	5251	125	121760	1973	116509	1848	42.008	63.04599567099567
chr19	MAST1	12843528	12843607	0	80	281962	6561	281962	6481	0.0	43.50594044128992
chr19	GCDH	12891486	12891522	0	37	1377	4015	1377	3978	0.0	0.34615384615384615
chr19	GCDH	12892115	12892178	0	64	1377	4015	1377	3951	0.0	0.34851936218678814
chr19	GCDH	12891486	12891660	102	175	1377	4015	1275	3840	0.5828571428571429	0.33203125
chr19	GCDH	12892316	12892434	0	119	1377	4015	1377	3896	0.0	0.3534394250513347
chr19	GCDH	12892386	12892434	0	49	1377	4015	1377	3966	0.0	0.3472012102874433
chr19	CALR	12939427	12939631	457	205	878	2690	421	2485	2.229268292682927	0.16941649899396377
chr19	RAD23A	12949080	12949159	0	80	5725	2229	5725	2149	0.0	2.664029781293625
chr19	RAD23A	12952688	12952853	19	166	5725	2229	5706	2063	0.1144578313253012	2.7658749394086284
chr19	RAD23A	12948496	12948552	12	57	5725	2229	5713	2172	0.21052631578947367	2.6302946593001844
chr19	RAD23A	12951491	12951589	0	99	5725	2229	5725	2130	0.0	2.687793427230047
chr19	RAD23A	12948513	12948552	0	40	5725	2229	5725	2189	0.0	2.615349474645957
chr19	RAD23A	12952688	12952820	0	133	5725	2229	5725	2096	0.0	2.7313931297709924
chr19	DAND5	12970450	12970535	0	86	15507	2001	15507	1915	0.0	8.097650130548303
chr19	NFIX	13078612	13078735	0	124	1936	3883	1936	3759	0.0	0.5150305932428837
chr19	NFIX	13087988	13088136	0	149	1936	3883	1936	3734	0.0	0.5184788430637386
chr19	CCDC130	13751607	13751811	0	205	0	3082	0	2877	0.0	0.0
chr19	MRI1	13765953	13766065	0	113	218	3471	218	3358	0.0	0.06491959499702203
chr19	MRI1	13765953	13766129	0	177	218	3471	218	3294	0.0	0.06618093503339405
chr19	C19ORF53	13774651	13774707	0	57	0	1201	0	1144	0.0	0.0
chr19	C19ORF53	13775470	13775613	0	144	0	1201	0	1057	0.0	0.0
chr19	C19ORF53	13775476	13775613	0	138	0	1201	0	1063	0.0	0.0
chr19	ZSWIM4	13814514	13814865	1335	352	2377	4727	1042	4375	3.7926136363636362	0.23817142857142856
chr19	CC2D1A	13919817	13919951	1637	135	16443	4964	14806	4829	12.125925925925927	3.0660592255125283
chr19	DCAF15	13953029	13953308	0	280	4930	2900	4930	2620	0.0	1.881679389312977
chr19	RLN3	14030244	14030356	5539	113	58558	1204	53019	1091	49.017699115044245	48.59670027497709
chr19	ADGRE5	14388449	14388500	0	52	714	5308	714	5256	0.0	0.1358447488584475
chr19	ADGRE5	14397888	14397935	0	48	714	5308	714	5260	0.0	0.13574144486692016
chr19	ADGRE5	14396341	14396473	0	133	714	5308	714	5175	0.0	0.13797101449275362
chr19	ADGRE5	14397076	14397223	0	148	714	5308	714	5160	0.0	0.13837209302325582
chr19	PKN1	14434589	14434654	0	66	844	4395	844	4329	0.0	0.19496419496419495
chr19	PKN1	14471101	14471426	96	326	844	4395	748	4069	0.294478527607362	0.18382895060211354
chr19	TECR	14564948	14564992	187	45	78459	5686	78272	5641	4.155555555555556	13.875553979790817
chr19	TECR	14565617	14565663	0	47	78459	5686	78459	5639	0.0	13.913637169710942
chr19	TECR	14545113	14545180	0	68	78459	5686	78459	5618	0.0	13.965646137415451
chr19	CLEC17A	14600030	14600182	3698	153	15762	3130	12064	2977	24.169934640522875	4.0524017467248905
chr19	CLEC17A	14606992	14607102	92	111	15762	3130	15670	3019	0.8288288288288288	5.190460417356741
chr19	ZNF333	14701583	14701897	0	315	3908006	10691	3908006	10376	0.0	376.6389745566692
chr19	SYDE1	15111631	15111792	0	162	0	3522	0	3360	0.0	0.0
chr19	CYP4F8	15622218	15622340	0	123	53	4309	53	4186	0.0	0.012661251791686574
chr19	CYP4F8	15628760	15628843	0	84	53	4309	53	4225	0.0	0.012544378698224851
chr19	CYP4F8	15628530	15628595	0	66	53	4309	53	4243	0.0	0.012491161913740279
chr19	CYP4F3	15643906	15644051	0	146	14	5101	14	4955	0.0	0.0028254288597376388
chr19	CYP4F3	15645718	15645863	0	146	14	5101	14	4955	0.0	0.0028254288597376388
chr19	CYP4F12	15678260	15678405	0	146	102	4073	102	3927	0.0	0.025974025974025976
chr19	CYP4F12	15678260	15678329	0	70	102	4073	102	4003	0.0	0.02548088933300025
chr19	UCA1	15831254	15831356	0	103	0	2973	0	2870	0.0	0.0
chr19	UCA1	15834501	15835114	0	614	0	2973	0	2359	0.0	0.0
chr19	UCA1	15834973	15835114	0	142	0	2973	0	2831	0.0	0.0
chr19	UCA1	15831197	15831356	0	160	0	2973	0	2813	0.0	0.0
chr19	UCA1	15831254	15831337	0	84	0	2973	0	2889	0.0	0.0
chr19	UCA1	15831207	15831356	0	150	0	2973	0	2823	0.0	0.0
chr19	UCA1	15835217	15835280	0	64	0	2973	0	2909	0.0	0.0
chr19	UCA1	15834635	15835114	0	480	0	2973	0	2493	0.0	0.0
chr19	UCA1	15834575	15835114	0	540	0	2973	0	2433	0.0	0.0
chr19	UCA1	15832512	15832588	0	77	0	2973	0	2896	0.0	0.0
chr19	UCA1	15834501	15835280	0	780	0	2973	0	2193	0.0	0.0
chr19	UCA1	15833570	15833632	0	63	0	2973	0	2910	0.0	0.0
chr19	LINC00905	16034479	16034637	0	159	0	3588	0	3429	0.0	0.0
chr19	TPM4	16081912	16082046	0	135	102	9477	102	9342	0.0	0.010918432883750802
chr19	TPM4	16095263	16095357	0	95	102	9477	102	9382	0.0	0.010871882327861864
chr19	TPM4	16093039	16093132	0	94	102	9477	102	9383	0.0	0.010870723649152723
chr19	TPM4	16095263	16095893	0	631	102	9477	102	8846	0.0	0.01153063531539679
chr19	TPM4	16077956	16078149	0	194	102	9477	102	9283	0.0	0.010987827211030917
chr19	TPM4	16081019	16081075	0	57	102	9477	102	9420	0.0	0.010828025477707006
chr19	HSH2D	16148723	16148875	0	153	0	3407	0	3254	0.0	0.0
chr19	HSH2D	16151446	16151578	0	133	0	3407	0	3274	0.0	0.0
chr19	HSH2D	16155641	16155763	0	123	0	3407	0	3284	0.0	0.0
chr19	FAM32A	16190519	16190573	2636	55	186066	1896	183430	1841	47.92727272727273	99.63606735469854
chr19	FAM32A	16189387	16189511	30793	125	186066	1896	155273	1771	246.344	87.67532467532467
chr19	AP1M1	16228769	16228928	0	160	1181097	13929	1181097	13769	0.0	85.77943205752052
chr19	AP1M1	16210359	16210395	52	37	1181097	13929	1181045	13892	1.4054054054054055	85.01619637201267
chr19	AP1M1	16202988	16203101	51	114	1181097	13929	1181046	13815	0.4473684210526316	85.49011943539631
chr19	AP1M1	16202946	16203101	51	156	1181097	13929	1181046	13773	0.3269230769230769	85.7508168155086
chr19	KLF2	16325215	16326032	4335	818	9026	2823	4691	2005	5.299511002444988	2.339650872817955
chr19	C19ORF44	16503064	16503380	37610	317	80849	4349	43239	4032	118.64353312302839	10.723958333333334
chr19	C19ORF44	16513013	16513109	4749	97	80849	4349	76100	4252	48.95876288659794	17.897460018814677
chr19	C19ORF44	16514496	16514663	30367	168	80849	4349	50482	4181	180.75595238095238	12.07414494140158
chr19	C19ORF44	16514549	16514663	28839	115	80849	4349	52010	4234	250.77391304347827	12.28389230042513
chr19	C19ORF44	16499473	16499620	151	148	80849	4349	80698	4201	1.0202702702702702	19.209235896215187
chr19	NWD1	16724365	16724463	0	99	154354	9155	154354	9056	0.0	17.044390459363957
chr19	NWD1	16794462	16794553	0	92	154354	9155	154354	9063	0.0	17.03122586340064
chr19	NWD1	16721397	16721617	0	221	154354	9155	154354	8934	0.0	17.277143496753972
chr19	NWD1	16721394	16721617	0	224	154354	9155	154354	8931	0.0	17.282947038405553
chr19	NWD1	16812744	16812850	0	107	154354	9155	154354	9048	0.0	17.05946065428824
chr19	NWD1	16738225	16738269	0	45	154354	9155	154354	9110	0.0	16.943358946212953
chr19	NWD1	16738225	16738292	0	68	154354	9155	154354	9087	0.0	16.98624408495653
chr19	SIN3B	16862883	16862979	0	97	419	8288	419	8191	0.0	0.05115370528628983
chr19	MYO9B	17180926	17181040	94	115	247569	9359	247475	9244	0.8173913043478261	26.77141929900476
chr19	MYO9B	17210332	17210380	0	49	247569	9359	247569	9310	0.0	26.59172932330827
chr19	MYO9B	17177796	17177886	0	91	247569	9359	247569	9268	0.0	26.712235649546827
chr19	USE1	17215801	17215851	8450	51	23530	1745	15080	1694	165.68627450980392	8.902007083825266
chr19	USE1	17219212	17219387	1597	176	23530	1745	21933	1569	9.073863636363637	13.978967495219885
chr19	OCEL1	17227839	17228005	0	167	1983	1754	1983	1587	0.0	1.2495274102079394
chr19	OCEL1	17228802	17228915	0	114	1983	1754	1983	1640	0.0	1.2091463414634147
chr19	BABAM1	17271596	17271655	0	60	18401	1792	18401	1732	0.0	10.624133949191686
chr19	BABAM1	17273903	17274024	12424	122	18401	1792	5977	1670	101.8360655737705	3.5790419161676645
chr19	BABAM1	17277383	17277479	279	97	18401	1792	18122	1695	2.8762886597938144	10.691445427728613
chr19	ANKLE1	17285680	17285819	0	140	100907	3243	100907	3103	0.0	32.51917499194328
chr19	ANKLE1	17284088	17284266	0	179	100907	3243	100907	3064	0.0	32.93309399477807
chr19	MRPL34	17298311	17298377	0	67	69331	1418	69331	1351	0.0	51.318282753515916
chr19	GTPBP3	17338953	17339026	0	74	60901	3908	60901	3834	0.0	15.884454877412624
chr19	BISPR	17413096	17413305	1583	210	20468	3025	18885	2815	7.538095238095238	6.708703374777975
chr19	MVB12A	17422331	17422458	102	128	82217	3168	82115	3040	0.796875	27.011513157894736
chr19	MVB12A	17424620	17424677	81	58	82217	3168	82136	3110	1.396551724137931	26.410289389067525
chr19	SLC27A1	17486562	17487335	51	774	152	6378	101	5604	0.06589147286821706	0.018022840827980013
chr19	SLC27A1	17483881	17484121	0	241	152	6378	152	6137	0.0	0.02476780185758514
chr19	SLC27A1	17488847	17488939	0	93	152	6378	152	6285	0.0	0.024184566428003183
chr19	SLC27A1	17501272	17501419	0	148	152	6378	152	6230	0.0	0.024398073836276082
chr19	SLC27A1	17500711	17500876	0	166	152	6378	152	6212	0.0	0.02446877012234385
chr19	PGLS	17516370	17516474	706	105	13842	1863	13136	1758	6.723809523809524	7.472127417519909
chr19	PGLS	17517709	17517850	0	142	13842	1863	13842	1721	0.0	8.042998256827426
chr19	PGLS	17512944	17512968	0	25	13842	1863	13842	1838	0.0	7.5310119695321
chr19	NIBAN3	17530754	17530885	48	132	8255	6554	8207	6422	0.36363636363636365	1.277950794145126
chr19	NIBAN3	17543523	17543631	25	109	8255	6554	8230	6445	0.22935779816513763	1.2769588828549263
chr19	NIBAN3	17549443	17549527	24	85	8255	6554	8231	6469	0.2823529411764706	1.2723759468233111
chr19	NIBAN3	17549454	17549527	24	74	8255	6554	8231	6480	0.32432432432432434	1.2702160493827162
chr19	NIBAN3	17530754	17530816	0	63	8255	6554	8255	6491	0.0	1.2717608997072871
chr19	COLGALT1	17572482	17572602	0	121	3284	4112	3284	3991	0.0	0.8228514156852919
chr19	MAP1S	17721250	17721463	0	214	905	3788	905	3574	0.0	0.253217683268047
chr19	MAP1S	17720985	17721037	0	53	905	3788	905	3735	0.0	0.24230254350736277
chr19	MAP1S	17720935	17721037	0	103	905	3788	905	3685	0.0	0.24559023066485752
chr19	FCHO1	17781230	17781343	138	114	2037	5470	1899	5356	1.2105263157894737	0.3545556385362211
chr19	FCHO1	17755075	17755191	0	117	2037	5470	2037	5353	0.0	0.38053427984307864
chr19	FCHO1	17755117	17755191	0	75	2037	5470	2037	5395	0.0	0.37757182576459686
chr19	FCHO1	17754591	17754758	0	168	2037	5470	2037	5302	0.0	0.3841946435307431
chr19	FCHO1	17754591	17754621	0	31	2037	5470	2037	5439	0.0	0.3745173745173745
chr19	FCHO1	17758684	17758791	0	108	2037	5470	2037	5362	0.0	0.37989556135770236
chr19	FCHO1	17753691	17753809	255	119	2037	5470	1782	5351	2.142857142857143	0.33302186507194914
chr19	FCHO1	17752283	17752401	1593	119	2037	5470	444	5351	13.38655462184874	0.08297514483274154
chr19	PIK3R2	18161278	18161495	0	218	117	4944	117	4726	0.0	0.02475666525603047
chr19	PIK3R2	18161053	18161185	0	133	117	4944	117	4811	0.0	0.024319268343379753
chr19	MPV17L2	18194776	18194853	0	78	0	2103	0	2025	0.0	0.0
chr19	PGPEP1	18342858	18342911	0	54	0	2114	0	2060	0.0	0.0
chr19	PGPEP1	18357382	18357615	0	234	0	2114	0	1880	0.0	0.0
chr19	PGPEP1	18348947	18349068	0	122	0	2114	0	1992	0.0	0.0
chr19	PGPEP1	18358005	18358070	0	66	0	2114	0	2048	0.0	0.0
chr19	SSBP4	18427751	18427813	0	63	71246	2816	71246	2753	0.0	25.8794042862332
chr19	SSBP4	18431792	18431862	0	71	71246	2816	71246	2745	0.0	25.954826958105645
chr19	SSBP4	18431352	18431418	0	67	71246	2816	71246	2749	0.0	25.917060749363404
chr19	SSBP4	18425908	18426083	0	176	71246	2816	71246	2640	0.0	26.987121212121213
chr19	KXD1	18567131	18567178	38	48	13856	3162	13818	3114	0.7916666666666666	4.4373795761079
chr19	KXD1	18560419	18560550	0	132	13856	3162	13856	3030	0.0	4.572937293729373
chr19	KXD1	18565133	18565190	72	58	13856	3162	13784	3104	1.2413793103448276	4.440721649484536
chr19	KXD1	18560099	18560550	102	452	13856	3162	13754	2710	0.22566371681415928	5.075276752767528
chr19	UBA52	18572350	18572607	19704	258	21617	2211	1913	1953	76.37209302325581	0.9795186891961085
chr19	REX1BD	18589478	18589683	0	206	102	1799	102	1593	0.0	0.064030131826742
chr19	REX1BD	18589412	18589683	0	272	102	1799	102	1527	0.0	0.06679764243614932
chr19	KLHL26	18659686	18659784	0	99	143503	3465	143503	3366	0.0	42.63309566250743
chr19	CRTC1	18744107	18744155	0	49	113126	6980	113126	6931	0.0	16.321742894243254
chr19	DDX49	18920833	18920909	0	77	102	2821	102	2744	0.0	0.03717201166180758
chr19	DDX49	18920844	18920909	0	66	102	2821	102	2755	0.0	0.037023593466424684
chr19	DDX49	18921662	18921748	0	87	102	2821	102	2734	0.0	0.03730797366495977
chr19	ARMC6	19043991	19044074	51	84	65154	4030	65103	3946	0.6071428571428571	16.498479472883933
chr19	ARMC6	19055790	19055928	134	139	65154	4030	65020	3891	0.9640287769784173	16.71035723464405
chr19	ARMC6	19037551	19037707	654	157	65154	4030	64500	3873	4.165605095541402	16.65375677769171
chr19	ARMC6	19039321	19039414	10407	94	65154	4030	54747	3936	110.7127659574468	13.909298780487806
chr19	ARMC6	19034130	19034238	0	109	65154	4030	65154	3921	0.0	16.616679418515684
chr19	ARMC6	19042710	19042877	32383	168	65154	4030	32771	3862	192.75595238095238	8.485499741066805
chr19	ARMC6	19040689	19040792	51	104	65154	4030	65103	3926	0.49038461538461536	16.582526744778402
chr19	ARMC6	19055790	19055977	153	188	65154	4030	65001	3842	0.8138297872340425	16.918532014575742
chr19	SLC25A42	19101780	19101886	36326	107	262482	4650	226156	4543	339.49532710280374	49.78120184899846
chr19	RFXANK	19197185	19197251	0	67	1587	2341	1587	2274	0.0	0.6978891820580475
chr19	RFXANK	19198959	19199003	0	45	1587	2341	1587	2296	0.0	0.6912020905923345
chr19	RFXANK	19200818	19200893	0	76	1587	2341	1587	2265	0.0	0.7006622516556291
chr19	NCAN	19248699	19248882	70	184	10234	6935	10164	6751	0.3804347826086957	1.5055547326322027
chr19	MAU2	19338844	19338939	0	96	131	10018	131	9922	0.0	0.013202983269502117
chr19	GATAD2A	19436130	19436219	0	90	10708	7305	10708	7215	0.0	1.4841302841302841
chr19	GATAD2A	19492305	19492438	0	134	10708	7305	10708	7171	0.0	1.493236647608423
chr19	GATAD2A	19494293	19494383	0	91	10708	7305	10708	7214	0.0	1.4843360133074577
chr19	GATAD2A	19501968	19502043	147	76	10708	7305	10561	7229	1.9342105263157894	1.4609212892516255
chr19	YJEFN3	19529363	19529513	0	151	434	2966	434	2815	0.0	0.1541740674955595
chr19	ZNF101	19677863	19677990	204	128	29552	4964	29348	4836	1.59375	6.0686517783291976
chr19	ZNF101	19677863	19677986	204	124	29552	4964	29348	4840	1.6451612903225807	6.0636363636363635
chr19	ZNF101	19672209	19672358	0	150	29552	4964	29552	4814	0.0	6.13876194432904
chr19	ZNF253	19878480	19878607	196	128	16867	3129	16671	3001	1.53125	5.555148283905365
chr19	ZNF253	19880050	19880146	0	97	16867	3129	16867	3032	0.0	5.562994722955145
chr19	ZNF93	19915279	19915406	1550	128	12834	5442	11284	5314	12.109375	2.1234474971772674
chr19	ZNF93	19926100	19926221	0	122	12834	5442	12834	5320	0.0	2.412406015037594
chr19	ZNF90	20104238	20104365	0	128	28934	6096	28934	5968	0.0	4.84819034852547
chr19	ZNF90	20121221	20121346	603	126	28934	6096	28331	5970	4.785714285714286	4.745561139028475
chr19	ZNF90	20106947	20107085	0	139	28934	6096	28934	5957	0.0	4.857142857142857
chr19	ZNF85	20934965	20935047	0	83	0	4677	0	4594	0.0	0.0
chr19	ZNF85	20934023	20934150	0	128	0	4677	0	4549	0.0	0.0
chr19	ZNF85	20934948	20935047	0	100	0	4677	0	4577	0.0	0.0
chr19	ZNF85	20934969	20935047	0	79	0	4677	0	4598	0.0	0.0
chr19	ZNF85	20946299	20946389	0	91	0	4677	0	4586	0.0	0.0
chr19	ZNF714	21083977	21084069	0	93	43856	9849	43856	9756	0.0	4.495284952849529
chr19	ZNF714	21098184	21098311	0	128	43856	9849	43856	9721	0.0	4.51147001337311
chr19	ZNF714	21109622	21109644	564	23	43856	9849	43292	9826	24.52173913043478	4.40586199877875
chr19	ZNF714	21116806	21118885	24191	2080	43856	9849	19665	7769	11.630288461538461	2.5312137984296563
chr19	ZNF714	21098811	21098910	0	100	43856	9849	43856	9749	0.0	4.4985126679659455
chr19	ZNF431	21175452	21175474	20	23	6923	8821	6903	8798	0.8695652173913043	0.7846101386678791
chr19	ZNF431	21169802	21169882	18	81	6923	8821	6905	8740	0.2222222222222222	0.790045766590389
chr19	ZNF431	21151078	21151198	0	121	6923	8821	6923	8700	0.0	0.7957471264367816
chr19	ZNF738	21360474	21360596	0	123	50941	3288	50941	3165	0.0	16.095102685624013
chr19	ZNF493	21413465	21413508	0	44	2377	9218	2377	9174	0.0	0.25910180946152167
chr19	LINC00664	21488310	21488456	0	147	10355	5905	10355	5758	0.0	1.798367488711358
chr19	ZNF429	21553916	21553954	156	39	34447	6761	34291	6722	4.0	5.101309134186254
chr19	ZNF257	22081553	22081670	0	118	255	5178	255	5060	0.0	0.05039525691699605
chr19	ZNF257	22060507	22060628	0	122	255	5178	255	5056	0.0	0.05043512658227848
chr19	ZNF257	22087530	22087595	0	66	255	5178	255	5112	0.0	0.04988262910798122
chr19	GOLGA2P9	22599705	22599793	0	89	578	2661	578	2572	0.0	0.22472783825816486
chr19	GOLGA2P9	22599232	22599321	0	90	578	2661	578	2571	0.0	0.2248152469856087
chr19	GOLGA2P9	22602977	22603130	0	154	578	2661	578	2507	0.0	0.23055444754686877
chr19	AC092279.1	24049661	24049839	0	179	3569	11997	3569	11818	0.0	0.3019969537992892
chr19	AC092279.1	24047707	24047850	765	144	3569	11997	2804	11853	5.3125	0.23656458280604067
chr19	AC092279.1	24048936	24049014	0	79	3569	11997	3569	11918	0.0	0.29946299714717234
chr19	AC092279.1	24057930	24058106	38	177	3569	11997	3531	11820	0.21468926553672316	0.2987309644670051
chr19	AC092279.1	24063815	24063941	0	127	3569	11997	3569	11870	0.0	0.30067396798652063
chr19	AC092279.1	24036252	24036382	0	131	3569	11997	3569	11866	0.0	0.3007753244564301
chr19	AC092279.1	24042442	24042722	0	281	3569	11997	3569	11716	0.0	0.30462615227039946
chr19	AC092279.1	24047050	24047146	0	97	3569	11997	3569	11900	0.0	0.2999159663865546
chr19	AC092279.1	24065462	24065648	0	187	3569	11997	3569	11810	0.0	0.30220152413209145
chr19	AC092279.1	24064546	24064669	0	124	3569	11997	3569	11873	0.0	0.30059799545186555
chr19	AC092279.1	24049404	24049548	0	145	3569	11997	3569	11852	0.0	0.30113061086736415
chr19	AC092279.1	24050184	24050302	0	119	3569	11997	3569	11878	0.0	0.3004714598417242
chr19	AC092279.1	24057930	24058300	38	371	3569	11997	3531	11626	0.10242587601078167	0.3037158093927404
chr19	AC092279.1	24034522	24034712	0	191	3569	11997	3569	11806	0.0	0.30230391326444184
chr19	AC092279.1	24063818	24063941	0	124	3569	11997	3569	11873	0.0	0.30059799545186555
chr19	AC092279.1	24057930	24058230	38	301	3569	11997	3531	11696	0.12624584717607973	0.3018980848153215
chr19	AC092279.1	24049409	24049548	0	140	3569	11997	3569	11857	0.0	0.30100362654971746
chr19	ZNF254	24106547	24106643	2790	97	30530	4811	27740	4714	28.762886597938145	5.884599066610098
chr19	ZNF254	24091900	24092015	0	116	30530	4811	30530	4695	0.0	6.5026624068157615
chr19	ZNF254	24105939	24106066	1391	128	30530	4811	29139	4683	10.8671875	6.222293401665599
chr19	ZNF254	24103746	24103867	3391	122	30530	4811	27139	4689	27.795081967213115	5.787801236937513
chr19	AC006504.5	27797753	27798176	0	424	102	13629	102	13205	0.0	0.007724346838318819
chr19	AC006504.5	27794681	27794869	0	189	102	13629	102	13440	0.0	0.007589285714285714
chr19	LINC00906	28916501	28916695	0	195	144	6203	144	6008	0.0	0.023968042609853527
chr19	LINC00906	28970200	28970267	0	68	144	6203	144	6135	0.0	0.0234718826405868
chr19	LINC00906	28968946	28969042	0	97	144	6203	144	6106	0.0	0.023583360628889615
chr19	LINC00906	28965929	28966627	0	699	144	6203	144	5504	0.0	0.02616279069767442
chr19	LINC00906	28965929	28966663	0	735	144	6203	144	5468	0.0	0.026335040234089245
chr19	LINC00906	28965929	28966472	0	544	144	6203	144	5659	0.0	0.025446191906697297
chr19	LINC00906	28967804	28969042	0	1239	144	6203	144	4964	0.0	0.029008863819500404
chr19	LINC01532	29004173	29004252	0	80	0	4140	0	4060	0.0	0.0
chr19	LINC01532	29010730	29010946	0	217	0	4140	0	3923	0.0	0.0
chr19	LINC01532	29003601	29003740	0	140	0	4140	0	4000	0.0	0.0
chr19	AC007786.1	29213713	29213821	0	109	0	1609	0	1500	0.0	0.0
chr19	POP4	29610408	29610632	0	225	51	4182	51	3957	0.0	0.01288855193328279
chr19	CCNE1	29821995	29822130	0	136	51	2472	51	2336	0.0	0.02183219178082192
chr19	URI1	29980158	29980364	0	207	0	4959	0	4752	0.0	0.0
chr19	URI1	29957976	29958072	0	97	0	4959	0	4862	0.0	0.0
chr19	URI1	29971192	29971227	0	36	0	4959	0	4923	0.0	0.0
chr19	URI1	29980158	29980250	0	93	0	4959	0	4866	0.0	0.0
chr19	URI1	30014180	30014222	0	43	0	4959	0	4916	0.0	0.0
chr19	ZNF536	30284071	30284141	0	71	5547	8670	5547	8599	0.0	0.6450750087219445
chr19	LINC01791	31195589	31195703	0	115	0	3441	0	3326	0.0	0.0
chr19	LINC01791	31204745	31204920	0	176	0	3441	0	3265	0.0	0.0
chr19	LINC01791	31168344	31168656	0	313	0	3441	0	3128	0.0	0.0
chr19	LINC01791	31195586	31195703	0	118	0	3441	0	3323	0.0	0.0
chr19	LINC01791	31170179	31170265	0	87	0	3441	0	3354	0.0	0.0
chr19	LINC01791	31178723	31178816	0	94	0	3441	0	3347	0.0	0.0
chr19	LINC01791	31167684	31167833	0	150	0	3441	0	3291	0.0	0.0
chr19	AC011525.2	31588817	31588948	0	132	612	3123	612	2991	0.0	0.2046138415245737
chr19	AC011525.2	31591219	31591310	0	92	612	3123	612	3031	0.0	0.2019135598812273
chr19	AC011525.2	31588627	31588680	0	54	612	3123	612	3069	0.0	0.19941348973607037
chr19	AC011525.2	31588761	31588948	0	188	612	3123	612	2935	0.0	0.20851788756388415
chr19	AC011525.2	31591212	31591310	0	99	612	3123	612	3024	0.0	0.20238095238095238
chr19	AC011525.2	31590355	31590478	0	124	612	3123	612	2999	0.0	0.20406802267422475
chr19	AC011525.2	31590039	31590116	0	78	612	3123	612	3045	0.0	0.20098522167487684
chr19	AC011525.2	31589862	31590116	0	255	612	3123	612	2868	0.0	0.21338912133891214
chr19	AC011525.2	31589981	31590116	0	136	612	3123	612	2987	0.0	0.20488784733846668
chr19	AC011525.2	31588786	31588948	0	163	612	3123	612	2960	0.0	0.20675675675675675
chr19	AC011525.2	31591073	31591310	0	238	612	3123	612	2885	0.0	0.2121317157712305
chr19	AC011525.2	31589857	31590116	0	260	612	3123	612	2863	0.0	0.2137617883339155
chr19	AC011525.2	31590355	31590452	0	98	612	3123	612	3025	0.0	0.20231404958677687
chr19	AC011525.2	31588600	31588680	0	81	612	3123	612	3042	0.0	0.20118343195266272
chr19	LINC01533	32039492	32039619	0	128	0	3749	0	3621	0.0	0.0
chr19	LINC01533	32040365	32040570	0	206	0	3749	0	3543	0.0	0.0
chr19	LINC01533	32042903	32043071	0	169	0	3749	0	3580	0.0	0.0
chr19	LINC01533	32042899	32043071	0	173	0	3749	0	3576	0.0	0.0
chr19	LINC01533	32036989	32037095	0	107	0	3749	0	3642	0.0	0.0
chr19	ZNF507	32347244	32347338	0	95	0	11247	0	11152	0.0	0.0
chr19	ZNF507	32380608	32380620	0	13	0	11247	0	11234	0.0	0.0
chr19	DPY19L3	32468730	32468813	0	84	0	10805	0	10721	0.0	0.0
chr19	DPY19L3	32480704	32480756	0	53	0	10805	0	10752	0.0	0.0
chr19	DPY19L3	32467473	32467626	0	154	0	10805	0	10651	0.0	0.0
chr19	DPY19L3	32481040	32481940	0	901	0	10805	0	9904	0.0	0.0
chr19	PDCD5	32585815	32585907	0	93	0	1079	0	986	0.0	0.0
chr19	TDRD12	32826682	32826749	0	68	0	7059	0	6991	0.0	0.0
chr19	FAAP24	32973425	32973562	5894	138	41543	2193	35649	2055	42.710144927536234	17.34744525547445
chr19	FAAP24	32973183	32973302	5125	120	41543	2193	36418	2073	42.708333333333336	17.56777616980222
chr19	GPATCH1	33100172	33100274	91	103	104865	4490	104774	4387	0.883495145631068	23.882835650786415
chr19	WDR88	33174181	33174296	0	116	0	1858	0	1742	0.0	0.0
chr19	CHST8	33667766	33667843	540	78	540	3061	0	2983	6.923076923076923	0.0
chr19	KCTD15	33799593	33799718	0	126	123	5017	123	4891	0.0	0.025148231445512165
chr19	KCTD15	33798263	33798390	0	128	123	5017	123	4889	0.0	0.025158519124565352
chr19	LSM14A	34195218	34195320	0	103	0	4760	0	4657	0.0	0.0
chr19	LSM14A	34226407	34226464	0	58	0	4760	0	4702	0.0	0.0
chr19	LSM14A	34208928	34209051	0	124	0	4760	0	4636	0.0	0.0
chr19	LSM14A	34215123	34215300	0	178	0	4760	0	4582	0.0	0.0
chr19	GPI	34368582	34368702	0	121	0	7809	0	7688	0.0	0.0
chr19	GPI	34377502	34377586	0	85	0	7809	0	7724	0.0	0.0
chr19	GPI	34396580	34396657	0	78	0	7809	0	7731	0.0	0.0
chr19	GPI	34377734	34377881	0	148	0	7809	0	7661	0.0	0.0
chr19	UBA2	34430092	34430186	0	95	0	4835	0	4740	0.0	0.0
chr19	UBA2	34458768	34458924	0	157	0	4835	0	4678	0.0	0.0
chr19	UBA2	34430575	34430659	0	85	0	4835	0	4750	0.0	0.0
chr19	ZNF302	34679827	34679959	0	133	97950	4981	97950	4848	0.0	20.20420792079208
chr19	ZNF181	34736074	34736206	0	133	153	6016	153	5883	0.0	0.026007139214686385
chr19	AC008555.2	34839598	34839818	2277	221	164857	8366	162580	8145	10.30316742081448	19.96071209330878
chr19	AC008555.2	34839598	34839786	1861	189	164857	8366	162996	8177	9.846560846560847	19.933471933471935
chr19	ZNF30	34942593	34942673	57	81	9326	2751	9269	2670	0.7037037037037037	3.4715355805243444
chr19	GRAMD1A	35009422	35009443	0	22	3587	5699	3587	5677	0.0	0.6318478069402854
chr19	GRAMD1A	35013255	35013368	0	114	3587	5699	3587	5585	0.0	0.6422560429722471
chr19	GRAMD1A	35022899	35022911	0	13	3587	5699	3587	5686	0.0	0.6308476960956736
chr19	SCN1B	35035887	35036013	0	127	1359	4311	1359	4184	0.0	0.32480879541108987
chr19	SCN1B	35037162	35037354	51	193	1359	4311	1308	4118	0.26424870466321243	0.3176299174356484
chr19	FXYD3	35119167	35119251	0	85	593	3345	593	3260	0.0	0.18190184049079755
chr19	FXYD3	35117256	35117378	0	123	593	3345	593	3222	0.0	0.1840471756672874
chr19	FXYD5	35156843	35156974	0	132	15019	2929	15019	2797	0.0	5.36968180193064
chr19	LSR	35261924	35261981	671	58	2164	2695	1493	2637	11.568965517241379	0.5661736822146378
chr19	LSR	35262545	35262692	402	148	2164	2695	1762	2547	2.7162162162162162	0.6917942677659992
chr19	LSR	35266678	35266738	0	61	2164	2695	2164	2634	0.0	0.8215641609719059
chr19	LSR	35258944	35259064	20	121	2164	2695	2144	2574	0.1652892561983471	0.8329448329448329
chr19	USF2	35269802	35270003	0	202	0	2816	0	2614	0.0	0.0
chr19	USF2	35275782	35275900	0	119	0	2816	0	2697	0.0	0.0
chr19	MAG	35295385	35295454	0	70	0	2972	0	2902	0.0	0.0
chr19	MAG	35312280	35312325	0	46	0	2972	0	2926	0.0	0.0
chr19	MAG	35295454	35295510	0	57	0	2972	0	2915	0.0	0.0
chr19	CD22	35332018	35332074	0	57	0	5309	0	5252	0.0	0.0
chr19	CD22	35336035	35336341	0	307	0	5309	0	5002	0.0	0.0
chr19	CD22	35345601	35345720	0	120	0	5309	0	5189	0.0	0.0
chr19	CD22	35331926	35332074	0	149	0	5309	0	5160	0.0	0.0
chr19	CD22	35331905	35332074	0	170	0	5309	0	5139	0.0	0.0
chr19	CD22	35332593	35332924	0	332	0	5309	0	4977	0.0	0.0
chr19	CD22	35330572	35330660	0	89	0	5309	0	5220	0.0	0.0
chr19	CD22	35338167	35338431	0	265	0	5309	0	5044	0.0	0.0
chr19	CD22	35337754	35338021	0	268	0	5309	0	5041	0.0	0.0
chr19	LINC01531	35409285	35409472	0	188	1312	3495	1312	3307	0.0	0.39673420018143335
chr19	LINC01531	35401058	35401117	0	60	1312	3495	1312	3435	0.0	0.3819505094614265
chr19	GAPDHS	35536812	35536990	0	179	0	1490	0	1311	0.0	0.0
chr19	LINC01766	35597322	35597430	0	109	0	971	0	862	0.0	0.0
chr19	LINC01766	35597875	35597957	0	83	0	971	0	888	0.0	0.0
chr19	HAUS5	35618401	35618465	0	65	7802	5031	7802	4966	0.0	1.5710833668948851
chr19	RBM42	35637157	35637352	244	196	17981	2216	17737	2020	1.2448979591836735	8.780693069306931
chr19	RBM42	35632935	35633001	47	67	17981	2216	17934	2149	0.7014925373134329	8.345276872964169
chr19	RBM42	35631330	35631405	18	76	17981	2216	17963	2140	0.23684210526315788	8.39392523364486
chr19	ETV2	35642433	35642530	1561	98	35824	2008	34263	1910	15.928571428571429	17.93874345549738
chr19	COX6B1	35654570	35654671	966	102	500209	1374	499243	1272	9.470588235294118	392.4866352201258
chr19	UPK1A	35676235	35676333	0	99	0	1375	0	1276	0.0	0.0
chr19	ZBTB32	35715756	35715830	0	75	0	2349	0	2274	0.0	0.0
chr19	ZBTB32	35715938	35716007	0	70	0	2349	0	2279	0.0	0.0
chr19	KMT2B	35728363	35728455	0	93	189	7477	189	7384	0.0	0.02559588299024919
chr19	PROSER3	35759788	35759991	161	204	147436	4865	147275	4661	0.7892156862745098	31.59729671744261
chr19	ARHGAP33	35785188	35785334	0	147	0	4441	0	4294	0.0	0.0
chr19	ARHGAP33	35777644	35777742	0	99	0	4441	0	4342	0.0	0.0
chr19	KIRREL2	35857344	35857494	0	151	0	3075	0	2924	0.0	0.0
chr19	KIRREL2	35862492	35862597	0	106	0	3075	0	2969	0.0	0.0
chr19	APLP1	35874503	35874662	0	160	0	3559	0	3399	0.0	0.0
chr19	APLP1	35878084	35878108	0	25	0	3559	0	3534	0.0	0.0
chr19	APLP1	35878081	35878108	0	28	0	3559	0	3531	0.0	0.0
chr19	WDR62	36081793	36081935	0	143	22785	9265	22785	9122	0.0	2.4978074983556238
chr19	WDR62	36058976	36059060	0	85	22785	9265	22785	9180	0.0	2.4820261437908497
chr19	WDR62	36075953	36075990	0	38	22785	9265	22785	9227	0.0	2.46938333152704
chr19	TBCB	36124249	36124363	730	115	78786	3141	78056	3026	6.3478260869565215	25.7951090548579
chr19	TBCB	36117790	36117928	62	139	78786	3141	78724	3002	0.4460431654676259	26.223850766155895
chr19	TBCB	36118527	36118664	0	138	78786	3141	78786	3003	0.0	26.235764235764236
chr19	CAPNS1	36142651	36142741	182	91	94248	2477	94066	2386	2.0	39.42414082145851
chr19	CAPNS1	36140357	36140511	204	155	94248	2477	94044	2322	1.3161290322580645	40.50129198966408
chr19	ZNF146	36218121	36218195	2594	75	775496	3653	772902	3578	34.586666666666666	216.01509223029626
chr19	AC092296.2	36310994	36311388	0	395	0	2027	0	1632	0.0	0.0
chr19	AC092296.2	36312521	36312635	0	115	0	2027	0	1912	0.0	0.0
chr19	ZNF529-AS1	36594155	36594299	16245	145	201569	3624	185324	3479	112.03448275862068	53.269330267318196
chr19	ZNF382	36609901	36610053	3615	153	753467	7939	749852	7786	23.627450980392158	96.307731826355
chr19	ZNF382	36609926	36610053	3248	128	753467	7939	750219	7811	25.375	96.04647292280117
chr19	ZNF567	36694801	36694876	140	76	64568	4734	64428	4658	1.8421052631578947	13.831687419493345
chr19	ZNF567	36718947	36720561	18300	1615	64568	4734	46268	3119	11.3312693498452	14.834241744148766
chr19	ZNF790-AS1	36801202	36801240	215	39	97040	7129	96825	7090	5.512820512820513	13.656558533145276
chr19	ZNF790-AS1	36812909	36813032	4081	124	97040	7129	92959	7005	32.91129032258065	13.27037830121342
chr19	ZNF790-AS1	36823730	36823821	100	92	97040	7129	96940	7037	1.0869565217391304	13.775756714509024
chr19	ZNF790-AS1	36812509	36812606	0	98	97040	7129	97040	7031	0.0	13.801735172806143
chr19	ZNF345	36854449	36854594	0	146	26414	4030	26414	3884	0.0	6.800720906282184
chr19	ZNF345	36872550	36872748	0	199	26414	4030	26414	3831	0.0	6.894805533803185
chr19	ZNF345	36876784	36876876	2662	93	26414	4030	23752	3937	28.623655913978496	6.033020066040132
chr19	ZNF345	36862916	36863011	0	96	26414	4030	26414	3934	0.0	6.714285714285714
chr19	ZNF568	36922585	36922846	0	262	15675	9232	15675	8970	0.0	1.7474916387959867
chr19	ZNF568	36931552	36931645	0	94	15675	9232	15675	9138	0.0	1.7153644123440577
chr19	ZNF568	36991175	36991299	90	125	15675	9232	15585	9107	0.72	1.7113209618974414
chr19	ZNF568	36925199	36925258	0	60	15675	9232	15675	9172	0.0	1.7090056694286961
chr19	ZNF568	36976326	36976367	0	42	15675	9232	15675	9190	0.0	1.705658324265506
chr19	ZNF420	37080344	37080388	136	45	12696	2747	12560	2702	3.022222222222222	4.648408586232421
chr19	ZNF420	37111599	37111711	0	113	12696	2747	12696	2634	0.0	4.82004555808656
chr19	ZNF420	37096030	37096115	2078	86	12696	2747	10618	2661	24.162790697674417	3.990229237128899
chr19	ZNF383	37219598	37219749	0	152	11818	8163	11818	8011	0.0	1.4752215703407814
chr19	ZNF383	37224817	37224939	51	123	11818	8163	11767	8040	0.4146341463414634	1.4635572139303483
chr19	LINC01535	37256398	37256519	0	122	2495	2437	2495	2315	0.0	1.0777537796976242
chr19	LINC01535	37258947	37259069	0	123	2495	2437	2495	2314	0.0	1.078219533275713
chr19	LINC01535	37256187	37256519	510	333	2495	2437	1985	2104	1.5315315315315314	0.9434410646387833
chr19	LINC01535	37264695	37264755	0	61	2495	2437	2495	2376	0.0	1.0500841750841752
chr19	ZNF875	37324795	37324936	481	142	18915	6750	18434	6608	3.387323943661972	2.789648910411622
chr19	ZNF875	37357961	37358039	0	79	18915	6750	18915	6671	0.0	2.8354069854594512
chr19	ZNF875	37322184	37322232	612	49	18915	6750	18303	6701	12.489795918367347	2.7313833756155796
chr19	ZNF875	37325153	37325274	2652	122	18915	6750	16263	6628	21.737704918032787	2.4536813518406757
chr19	ZNF875	37358546	37358661	0	116	18915	6750	18915	6634	0.0	2.8512209828157973
chr19	ZNF875	37359425	37359546	0	122	18915	6750	18915	6628	0.0	2.853802051901026
chr19	ZNF875	37347189	37347316	0	128	18915	6750	18915	6622	0.0	2.8563877982482633
chr19	ZNF875	37335168	37335257	662	90	18915	6750	18253	6660	7.355555555555555	2.7406906906906907
chr19	ZNF875	37346422	37346492	0	71	18915	6750	18915	6679	0.0	2.8320107800568945
chr19	ZNF875	37347231	37347316	0	86	18915	6750	18915	6664	0.0	2.8383853541416566
chr19	ZNF875	37346887	37347052	0	166	18915	6750	18915	6584	0.0	2.8728736330498177
chr19	ZNF875	37335199	37335257	435	59	18915	6750	18480	6691	7.372881355932203	2.7619189956658197
chr19	ZNF875	37344609	37344774	0	166	18915	6750	18915	6584	0.0	2.8728736330498177
chr19	ZNF875	37358540	37358661	0	122	18915	6750	18915	6628	0.0	2.853802051901026
chr19	ZNF527	37380276	37380372	6666	97	56769	2491	50103	2394	68.72164948453609	20.928571428571427
chr19	ZNF527	37380047	37380372	13009	326	56769	2491	43760	2165	39.90490797546012	20.212471131639724
chr19	ZNF570	37470303	37470387	4875	85	73207	6067	68332	5982	57.35294117647059	11.422935473085925
chr19	ZNF793	37520183	37520312	237	130	8780	9645	8543	9515	1.823076923076923	0.897845507094062
chr19	ZNF793	37522531	37522647	718	117	8780	9645	8062	9528	6.136752136752137	0.8461376994122586
chr19	ZNF571-AS1	37566030	37566089	11	60	19237	6494	19226	6434	0.18333333333333332	2.9881877525645013
chr19	ZNF571-AS1	37583482	37583834	515	353	19237	6494	18722	6141	1.4589235127478755	3.048689138576779
chr19	ZNF571-AS1	37550861	37550991	0	131	19237	6494	19237	6363	0.0	3.023259468804023
chr19	ZNF571-AS1	37567617	37567750	27	134	19237	6494	19210	6360	0.20149253731343283	3.020440251572327
chr19	ZNF571-AS1	37569849	37569996	663	148	19237	6494	18574	6346	4.47972972972973	2.9268830759533566
chr19	ZNF540	37599625	37599752	0	128	1361	3869	1361	3741	0.0	0.36380646885859397
chr19	ZNF540	37601009	37601105	44	97	1361	3869	1317	3772	0.4536082474226804	0.34915164369034996
chr19	ZNF571-AS1	37566439	37566484	0	46	19237	6494	19237	6448	0.0	2.9834057071960296
chr19	ZNF571-AS1	37585083	37585161	848	79	19237	6494	18389	6415	10.734177215189874	2.8665627435697583
chr19	ZNF540	37601006	37601105	48	100	1361	3869	1313	3769	0.48	0.3483682674449456
chr19	ZNF540	37597447	37597570	0	124	1361	3869	1361	3745	0.0	0.3634178905206943
chr19	AC016582.3	37819496	37819617	9878	122	131584	6940	121706	6818	80.9672131147541	17.850689351716046
chr19	AC016582.3	37823810	37823906	622	97	131584	6940	130962	6843	6.412371134020619	19.13809732573433
chr19	SPINT2	38283626	38283797	51	172	2732	3644	2681	3472	0.29651162790697677	0.7721774193548387
chr19	SPINT2	38287875	38287935	0	61	2732	3644	2732	3583	0.0	0.7624895339101312
chr19	CATSPERG	38343992	38344119	0	128	241	6878	241	6750	0.0	0.0357037037037037
chr19	CATSPERG	38352260	38352432	0	173	241	6878	241	6705	0.0	0.03594332587621178
chr19	CATSPERG	38356483	38356543	0	61	241	6878	241	6817	0.0	0.035352794484377295
chr19	CATSPERG	38352393	38352432	0	40	241	6878	241	6838	0.0	0.03524422345715121
chr19	CATSPERG	38356741	38356861	80	121	241	6878	161	6757	0.6611570247933884	0.023827142222879977
chr19	CATSPERG	38337739	38337861	0	123	241	6878	241	6755	0.0	0.035677276091783866
chr19	CATSPERG	38369445	38369624	8	180	241	6878	233	6698	0.044444444444444446	0.03478650343386085
chr19	PSMD8	38381148	38381312	0	165	0	3064	0	2899	0.0	0.0
chr19	SPRED3	38394360	38394476	0	117	3503	5774	3503	5657	0.0	0.6192328089093159
chr19	FAM98C	38405343	38405421	51	79	1304	2931	1253	2852	0.6455696202531646	0.43934081346423565
chr19	FAM98C	38406909	38407077	0	169	1304	2931	1304	2762	0.0	0.4721216509775525
chr19	RYR1	38511560	38511610	0	51	21414	16081	21414	16030	0.0	1.335870243293824
chr19	RYR1	38512071	38512132	0	62	21414	16081	21414	16019	0.0	1.3367875647668395
chr19	RYR1	38523914	38523929	0	16	21414	16081	21414	16065	0.0	1.3329598506069094
chr19	RYR1	38536749	38536767	0	19	21414	16081	21414	16062	0.0	1.3332088158386253
chr19	RYR1	38570606	38570693	0	88	21414	16081	21414	15993	0.0	1.3389607953479647
chr19	RYR1	38535996	38536070	0	75	21414	16081	21414	16006	0.0	1.3378732975134324
chr19	EIF3K	38632600	38632678	0	79	3919	2691	3919	2612	0.0	1.5003828483920367
chr19	EIF3K	38620336	38620435	25	100	3919	2691	3894	2591	0.25	1.5028946352759551
chr19	ACP7	39106946	39107084	0	139	302035	3057	302035	2918	0.0	103.50753941055517
chr19	ACP7	39100226	39100350	0	125	302035	3057	302035	2932	0.0	103.01330150068213
chr19	ACP7	39101465	39101537	0	73	302035	3057	302035	2984	0.0	101.218163538874
chr19	PAK4	39168229	39168312	0	84	18507	7124	18507	7040	0.0	2.6288352272727273
chr19	PAK4	39172917	39173106	280	190	18507	7124	18227	6934	1.4736842105263157	2.6286414767810786
chr19	PAK4	39167991	39168085	28	95	18507	7124	18479	7029	0.29473684210526313	2.6289657134727555
chr19	PAK4	39172917	39173376	2138	460	18507	7124	16369	6664	4.647826086956521	2.4563325330132053
chr19	PAK4	39168624	39168840	81	217	18507	7124	18426	6907	0.37327188940092165	2.6677283914868974
chr19	PAK4	39168229	39168302	0	74	18507	7124	18507	7050	0.0	2.6251063829787236
chr19	SAMD4B	39354005	39354066	0	62	174468	5835	174468	5773	0.0	30.221375368092847
chr19	SAMD4B	39375649	39375889	0	241	174468	5835	174468	5594	0.0	31.188416160171613
chr19	MED29	39392463	39392522	183	60	213927	3844	213744	3784	3.05	56.48625792811839
chr19	MED29	39392651	39392802	138	152	213927	3844	213789	3692	0.9078947368421053	57.90601300108342
chr19	PLEKHG2	39421074	39421113	192	40	708269	7761	708077	7721	4.8	91.70793938608989
chr19	PLEKHG2	39420948	39420996	514	49	708269	7761	707755	7712	10.489795918367347	91.77321058091286
chr19	SUPT5H	39458293	39458305	273	13	9428	8603	9155	8590	21.0	1.0657741559953435
chr19	SUPT5H	39464797	39465049	27	253	9428	8603	9401	8350	0.1067193675889328	1.125868263473054
chr19	TIMM50	39481882	39482033	0	152	0	5589	0	5437	0.0	0.0
chr19	TIMM50	39485543	39485602	0	60	0	5589	0	5529	0.0	0.0
chr19	TIMM50	39483134	39483156	0	23	0	5589	0	5566	0.0	0.0
chr19	TIMM50	39485151	39485263	0	113	0	5589	0	5476	0.0	0.0
chr19	SELENOV	39518607	39518632	0	26	55866	1738	55866	1712	0.0	32.632009345794394
chr19	SELENOV	39518902	39518977	0	76	55866	1738	55866	1662	0.0	33.61371841155235
chr19	AC005176.1	39640820	39640906	429	87	2593	1839	2164	1752	4.931034482758621	1.235159817351598
chr19	LGALS17A	39681432	39681509	42	78	42	1750	0	1672	0.5384615384615384	0.0
chr19	LGALS17A	39681997	39682208	0	212	42	1750	42	1538	0.0	0.027308192457737322
chr19	LGALS14	39705704	39706009	0	306	0	909	0	603	0.0	0.0
chr19	LGALS14	39706596	39706673	0	78	0	909	0	831	0.0	0.0
chr19	ZNF546	39999600	39999854	0	255	43550	9041	43550	8786	0.0	4.956749374004097
chr19	ZNF546	39998247	39998410	4241	164	43550	9041	39309	8877	25.859756097560975	4.428185197701926
chr19	ZNF546	39998247	39998332	3816	86	43550	9041	39734	8955	44.372093023255815	4.437074260189838
chr19	MAP3K10	40204484	40204633	0	150	51	4074	51	3924	0.0	0.012996941896024464
chr19	MAP3K10	40205910	40206157	0	248	51	4074	51	3826	0.0	0.013329848405645583
chr19	PLD3	40365717	40365930	0	214	102	4360	102	4146	0.0	0.024602026049204053
chr19	PLD3	40365552	40365585	0	34	102	4360	102	4326	0.0	0.023578363384188627
chr19	PLD3	40365552	40365930	0	379	102	4360	102	3981	0.0	0.02562170308967596
chr19	PLD3	40365661	40365930	0	270	102	4360	102	4090	0.0	0.02493887530562347
chr19	SPTBN4	40524543	40524629	1107	87	52526	11711	51419	11624	12.724137931034482	4.423520302821748
chr19	SHKBP1	40578153	40578212	748	60	13988	3701	13240	3641	12.466666666666667	3.6363636363636362
chr19	SHKBP1	40586773	40586944	51	172	13988	3701	13937	3529	0.29651162790697677	3.949277415698498
chr19	SHKBP1	40590243	40590422	0	180	13988	3701	13988	3521	0.0	3.9727350184606647
chr19	SHKBP1	40578122	40578212	748	91	13988	3701	13240	3610	8.219780219780219	3.667590027700831
chr19	SHKBP1	40588623	40588779	57	157	13988	3701	13931	3544	0.3630573248407643	3.930869074492099
chr19	SHKBP1	40578096	40578212	764	117	13988	3701	13224	3584	6.52991452991453	3.689732142857143
chr19	SHKBP1	40589081	40589178	1353	98	13988	3701	12635	3603	13.806122448979592	3.5067998889814045
chr19	LTBP4	40611151	40611394	0	244	1155	7848	1155	7604	0.0	0.15189374013677012
chr19	LTBP4	40616888	40617020	0	133	1155	7848	1155	7715	0.0	0.14970836033700582
chr19	LTBP4	40617099	40617225	0	127	1155	7848	1155	7721	0.0	0.14959202175883954
chr19	LTBP4	40622949	40623021	0	73	1155	7848	1155	7775	0.0	0.14855305466237942
chr19	ITPKC	40733159	40733364	51	206	126284	3383	126233	3177	0.24757281553398058	39.73339628580422
chr19	SNRPA	40758783	40758869	2	87	42575	2064	42573	1977	0.022988505747126436	21.534142640364188
chr19	MIA	40775751	40775885	130	135	28144	1167	28014	1032	0.9629629629629629	27.1453488372093
chr19	RAB4B	40783777	40783840	1918	64	76086	2971	74168	2907	29.96875	25.51358789129687
chr19	RAB4B	40783920	40784075	5068	156	76086	2971	71018	2815	32.48717948717949	25.22841918294849
chr19	MIA	40775751	40775833	128	83	28144	1167	28016	1084	1.5421686746987953	25.8450184501845
chr19	EGLN2	40806554	40806674	1493	121	22647	5469	21154	5348	12.338842975206612	3.9554973821989527
chr19	CYP2B6	41012673	41012815	0	143	102	3744	102	3601	0.0	0.02832546514856984
chr19	CYP2B6	41007478	41007600	0	123	102	3744	102	3621	0.0	0.028169014084507043
chr19	CYP2B6	41012972	41013030	0	59	102	3744	102	3685	0.0	0.0276797829036635
chr19	CYP2F1	41116177	41116359	1279	183	70629	2330	69350	2147	6.9890710382513666	32.30088495575221
chr19	CYP2F1	41125738	41125788	558	51	70629	2330	70071	2279	10.941176470588236	30.74637999122422
chr19	CYP2S1	41203449	41203637	0	189	56857	2723	56857	2534	0.0	22.437647987371744
chr19	CYP2S1	41194543	41194709	6056	167	56857	2723	50801	2556	36.26347305389221	19.875195618153363
chr19	CYP2S1	41197778	41197928	7435	151	56857	2723	49422	2572	49.23841059602649	19.2153965785381
chr19	AXL	41239693	41239720	0	28	28983	5156	28983	5128	0.0	5.651911076443057
chr19	HNRNPUL1	41268222	41268345	459	124	388413	6669	387954	6545	3.7016129032258065	59.27486631016043
chr19	HNRNPUL1	41281162	41281275	0	114	388413	6669	388413	6555	0.0	59.25446224256293
chr19	HNRNPUL1	41305645	41305867	193	223	388413	6669	388220	6446	0.8654708520179372	60.22649705243562
chr19	HNRNPUL1	41305675	41305867	193	193	388413	6669	388220	6476	1.0	59.947498455836936
chr19	HNRNPUL1	41305831	41305867	37	37	388413	6669	388376	6632	1.0	58.56091676718938
chr19	HNRNPUL1	41279076	41279176	0	101	388413	6669	388413	6568	0.0	59.137180267965896
chr19	TMEM91	41382771	41382921	0	151	0	1776	0	1625	0.0	0.0
chr19	BCKDHA	41410922	41411009	0	88	102	2171	102	2083	0.0	0.04896783485357657
chr19	TMEM91	41383560	41383632	0	73	0	1776	0	1703	0.0	0.0
chr19	BCKDHA	41418724	41418817	0	94	102	2171	102	2077	0.0	0.04910929224843524
chr19	CEACAM21	41586153	41586195	0	43	0	1988	0	1945	0.0	0.0
chr19	CEACAM5	41715649	41715904	0	256	6827	3969	6827	3713	0.0	1.838674925935901
chr19	CEACAM5	41714970	41715249	51	280	6827	3969	6776	3689	0.18214285714285713	1.8368121442125238
chr19	CEACAM3	41809964	41810017	67388	54	697553	2545	630165	2491	1247.9259259259259	252.97671617824167
chr19	CEACAM3	41807110	41807244	1129	135	697553	2545	696424	2410	8.362962962962962	288.9726141078838
chr19	RPS19	41861479	41861560	544	82	28153	3216	27609	3134	6.634146341463414	8.809508615188259
chr19	ARHGEF1	41894625	41894661	31	37	204820	8522	204789	8485	0.8378378378378378	24.135415439010018
chr19	ARHGEF1	41904948	41905036	0	89	204820	8522	204820	8433	0.0	24.287916518439463
chr19	ARHGEF1	41905174	41905261	0	88	204820	8522	204820	8434	0.0	24.28503675598767
chr19	ARHGEF1	41906456	41906620	0	165	204820	8522	204820	8357	0.0	24.508795022137132
chr19	ARHGEF1	41892024	41892123	94	100	204820	8522	204726	8422	0.94	24.30847779624792
chr19	ARHGEF1	41897945	41898113	51	169	204820	8522	204769	8353	0.30177514792899407	24.514425954746798
chr19	ARHGEF1	41897314	41897326	0	13	204820	8522	204820	8509	0.0	24.07098366435539
chr19	MEGF8	42371349	42371482	0	134	167474	10518	167474	10384	0.0	16.128081664098612
chr19	MEGF8	42348271	42348472	0	202	167474	10518	167474	10316	0.0	16.234393175649476
chr19	ZNF283	43833504	43833626	135	123	2185	7162	2050	7039	1.0975609756097562	0.29123455036226736
chr19	ZNF283	43837052	43837179	152	128	2185	7162	2033	7034	1.1875	0.28902473699175435
chr19	ZNF283	43827775	43827940	1413	166	2185	7162	772	6996	8.512048192771084	0.11034877072612921
chr19	ZNF283	43831317	43831381	0	65	2185	7162	2185	7097	0.0	0.30787656756375936
chr19	ZNF221	43960186	43960356	0	171	6926	2719	6926	2548	0.0	2.718210361067504
chr19	ZNF221	43961823	43961971	0	149	6926	2719	6926	2570	0.0	2.6949416342412453
chr19	ZNF155	43990023	43990112	0	90	5931	3441	5931	3351	0.0	1.7699194270367054
chr19	ZNF222	44026025	44026086	312	62	1759	2008	1447	1946	5.032258064516129	0.7435765673175745
chr19	ZNF223	44060454	44060581	0	128	4844	3317	4844	3189	0.0	1.5189714644089056
chr19	ZNF222	44027397	44027490	197	94	1759	2008	1562	1914	2.095744680851064	0.8160919540229885
chr19	ZNF223	44063264	44063566	134	303	4844	3317	4710	3014	0.44224422442244227	1.5627073656270736
chr19	ZNF225	44114048	44114213	204	166	193291	6611	193087	6445	1.2289156626506024	29.959193173002326
chr19	ZNF225	44129041	44129098	77	58	193291	6611	193214	6553	1.3275862068965518	29.4848161147566
chr19	ZNF234	44144556	44144647	0	92	771794	5221	771794	5129	0.0	150.47650614154807
chr19	ZNF234	44149770	44149976	346	207	771794	5221	771448	5014	1.671497584541063	153.8587953729557
chr19	ZNF226	44165587	44165613	405	27	107816	5116	107411	5089	15.0	21.106504224798584
chr19	ZNF226	44166704	44166882	379	179	107816	5116	107437	4937	2.11731843575419	21.761596110998582
chr19	ZNF226	44167818	44167860	0	43	107816	5116	107816	5073	0.0	21.252907549773308
chr19	ZNF226	44169564	44169628	101649	65	107816	5116	6167	5051	1563.8307692307692	1.2209463472579687
chr19	ZNF227	44229732	44229816	0	85	144102	4812	144102	4727	0.0	30.4848741273535
chr19	ZNF227	44217790	44217852	0	63	144102	4812	144102	4749	0.0	30.343651295009476
chr19	IGSF23	44618075	44618192	105	118	18653	1421	18548	1303	0.8898305084745762	14.234842670759786
chr19	PVR	44657761	44657910	1428	150	92908	6106	91480	5956	9.52	15.359301544660847
chr19	PVR	44658741	44658765	17	25	92908	6106	92891	6081	0.68	15.275612563723072
chr19	PVR	44658741	44658900	17	160	92908	6106	92891	5946	0.10625	15.62243525058863
chr19	CEACAM19	44666957	44667321	0	365	46707	4281	46707	3916	0.0	11.927221654749745
chr19	CEACAM19	44671303	44671436	240	134	46707	4281	46467	4147	1.791044776119403	11.204967446346757
chr19	CBLC	44784263	44784401	0	139	3592	1624	3592	1485	0.0	2.418855218855219
chr19	CBLC	44784263	44784417	0	155	3592	1624	3592	1469	0.0	2.445200816882233
chr19	BCAM	44814151	44814288	0	138	1675	4838	1675	4700	0.0	0.35638297872340424
chr19	APOC1	44914671	44914733	0	63	0	1238	0	1175	0.0	0.0
chr19	APOC1	44916189	44916325	0	137	0	1238	0	1101	0.0	0.0
chr19	APOC1	44916189	44916470	0	282	0	1238	0	956	0.0	0.0
chr19	APOC1	44918840	44918961	0	122	0	1238	0	1116	0.0	0.0
chr19	APOC1	44916189	44916359	0	171	0	1238	0	1067	0.0	0.0
chr19	APOC1	44915097	44915217	0	121	0	1238	0	1117	0.0	0.0
chr19	APOC1P1	44927794	44927930	0	137	10971	925	10971	788	0.0	13.92258883248731
chr19	APOC1P1	44927609	44927930	0	322	10971	925	10971	603	0.0	18.19402985074627
chr19	APOC4-APOC2	44945139	44946075	459	937	2897	1835	2438	898	0.48986125933831376	2.714922048997773
chr19	CLPTM1	44974438	44974597	46	160	5028	4812	4982	4652	0.2875	1.0709372312983663
chr19	CLPTM1	44991237	44991373	0	137	5028	4812	5028	4675	0.0	1.0755080213903743
chr19	RELB	45008457	45008721	0	265	24	3028	24	2763	0.0	0.008686210640608035
chr19	RELB	45009813	45009822	0	10	24	3028	24	3018	0.0	0.007952286282306162
chr19	CLASRP	45068419	45068480	54	62	156	4944	102	4882	0.8709677419354839	0.020893076607947564
chr19	GEMIN7	45079906	45080029	0	124	94	1913	94	1789	0.0	0.05254332029066518
chr19	BLOC1S3	45198888	45199013	0	126	24	1768	24	1642	0.0	0.014616321559074299
chr19	BLOC1S3	45180267	45180413	0	147	24	1768	24	1621	0.0	0.014805675508945095
chr19	MARK4	45298142	45298222	0	81	34743	6665	34743	6584	0.0	5.276883353584447
chr19	POLR1G	45407093	45407235	361	143	214598	3199	214237	3056	2.5244755244755246	70.10373036649214
chr19	FOSB	45471193	45471301	0	109	1357	4899	1357	4790	0.0	0.28329853862212945
chr19	FOSB	45470628	45470949	184	322	1357	4899	1173	4577	0.5714285714285714	0.2562814070351759
chr19	FOSB	45470745	45470949	184	205	1357	4899	1173	4694	0.8975609756097561	0.24989348103962505
chr19	PPM1N	45500649	45500710	0	62	989	2380	989	2318	0.0	0.4266609145815358
chr19	PPM1N	45500680	45500710	0	31	989	2380	989	2349	0.0	0.4210302256279268
chr19	PPM1N	45500689	45500710	0	22	989	2380	989	2358	0.0	0.41942324003392706
chr19	VASP	45521321	45521406	0	86	22358	3335	22358	3249	0.0	6.881502000615574
chr19	VASP	45524877	45525077	19	201	22358	3335	22339	3134	0.0945273631840796	7.127951499680919
chr19	EML2-AS1	45641878	45642072	0	195	603	1237	603	1042	0.0	0.5786948176583493
chr19	GIPR	45671579	45671757	0	179	61655	4844	61655	4665	0.0	13.216505894962486
chr19	GIPR	45671284	45671392	102	109	61655	4844	61553	4735	0.9357798165137615	12.999577613516367
chr19	QPCTL	45695400	45695718	0	319	51	2550	51	2231	0.0	0.02285970416853429
chr19	QPCTL	45698800	45698900	0	101	51	2550	51	2449	0.0	0.0208248264597795
chr19	QPCTL	45695436	45695718	0	283	51	2550	51	2267	0.0	0.022496691662990738
chr19	QPCTL	45695632	45695718	0	87	51	2550	51	2463	0.0	0.020706455542021926
chr19	CCDC61	46003418	46003501	0	84	27689	2352	27689	2268	0.0	12.208553791887125
chr19	CCDC61	45996244	45996401	0	158	27689	2352	27689	2194	0.0	12.620328167730174
chr19	AC006262.1	46203559	46203656	721	98	418433	4973	417712	4875	7.357142857142857	85.68451282051282
chr19	AC006262.1	46211608	46211678	0	71	418433	4973	418433	4902	0.0	85.35964912280701
chr19	AC006262.1	46213328	46213483	51	156	418433	4973	418382	4817	0.3269230769230769	86.85530413120199
chr19	HIF3A	46305244	46305390	0	147	152952	8157	152952	8010	0.0	19.095131086142324
chr19	HIF3A	46305098	46305135	0	38	152952	8157	152952	8119	0.0	18.83877324793694
chr19	HIF3A	46310541	46310691	0	151	152952	8157	152952	8006	0.0	19.104671496377716
chr19	PPP5C	46383410	46383476	0	67	108546	6407	108546	6340	0.0	17.120820189274447
chr19	CALM3	46605826	46605857	0	32	1798	3098	1798	3066	0.0	0.5864318330071755
chr19	CALM3	46605993	46606185	0	193	1798	3098	1798	2905	0.0	0.6189328743545611
chr19	FKRP	46748514	46748717	0	204	102	5171	102	4967	0.0	0.020535534527884036
chr19	FKRP	46748774	46748884	0	111	102	5171	102	5060	0.0	0.02015810276679842
chr19	FKRP	46747233	46747305	0	73	102	5171	102	5098	0.0	0.02000784621420165
chr19	FKRP	46748514	46748884	0	371	102	5171	102	4800	0.0	0.02125
chr19	FKRP	46754248	46754315	0	68	102	5171	102	5103	0.0	0.019988242210464434
chr19	FKRP	46748514	46748665	0	152	102	5171	102	5019	0.0	0.020322773460848775
chr19	FKRP	46747233	46747294	0	62	102	5171	102	5109	0.0	0.01996476805637111
chr19	FKRP	46747578	46747732	0	155	102	5171	102	5016	0.0	0.02033492822966507
chr19	FKRP	46748514	46748621	0	108	102	5171	102	5063	0.0	0.020146158404108237
chr19	FKRP	46754101	46754181	0	81	102	5171	102	5090	0.0	0.020039292730844795
chr19	FKRP	46747578	46747681	0	104	102	5171	102	5067	0.0	0.020130254588513915
chr19	SAE1	47143493	47143605	0	113	446615	3760	446615	3647	0.0	122.46092678914177
chr19	SAE1	47142510	47142611	0	102	446615	3760	446615	3658	0.0	122.09267359212684
chr19	SAE1	47197232	47197377	11441	146	446615	3760	435174	3614	78.36301369863014	120.41339236303266
chr19	SAE1	47180145	47180303	0	159	446615	3760	446615	3601	0.0	124.02527075812274
chr19	SAE1	47156986	47157181	240	196	446615	3760	446375	3564	1.2244897959183674	125.24551066217732
chr19	SAE1	47156568	47156661	0	94	446615	3760	446615	3666	0.0	121.82624113475177
chr19	SAE1	47203670	47203740	24	71	446615	3760	446591	3689	0.3380281690140845	121.06017891027379
chr19	SAE1	47151995	47152053	134	59	446615	3760	446481	3701	2.2711864406779663	120.63793569305594
chr19	DHX34	47362475	47362693	0	219	59338	4787	59338	4568	0.0	12.989929947460595
chr19	DHX34	47376914	47376989	0	76	59338	4787	59338	4711	0.0	12.595627255359796
chr19	EHD2	47716557	47717016	51	460	51373	3852	51322	3392	0.1108695652173913	15.130306603773585
chr19	NOP53	47755755	47755822	0	68	1382	3435	1382	3367	0.0	0.41045441045441045
chr19	SELENOW	47780724	47780749	241	26	79073	2027	78832	2001	9.26923076923077	39.39630184907546
chr19	CRX	47834408	47834543	0	136	51	3965	51	3829	0.0	0.013319404544267433
chr19	CRX	47836242	47836394	0	153	51	3965	51	3812	0.0	0.013378803777544596
chr19	ELSPBP1	48014170	48014308	306	139	4243	1130	3937	991	2.2014388489208634	3.972754793138244
chr19	AC011466.3	48122208	48122365	0	158	204	1013	204	855	0.0	0.23859649122807017
chr19	ZNF114	48271726	48271828	0	103	43454	2813	43454	2710	0.0	16.03468634686347
chr19	ZNF114	48271748	48271828	0	81	43454	2813	43454	2732	0.0	15.905563689604685
chr19	ZNF114	48281551	48281689	0	139	43454	2813	43454	2674	0.0	16.25056095736724
chr19	EMP3	48327520	48327623	0	104	0	1570	0	1466	0.0	0.0
chr19	EMP3	48326829	48326922	0	94	0	1570	0	1476	0.0	0.0
chr19	EMP3	48325990	48326053	0	64	0	1570	0	1506	0.0	0.0
chr19	SYNGR4	48375612	48375752	0	141	102	1200	102	1059	0.0	0.09631728045325778
chr19	CYTH2	48470602	48470669	0	68	153	6155	153	6087	0.0	0.025135534746180386
chr19	CYTH2	48477716	48477719	0	4	153	6155	153	6151	0.0	0.024874004226954967
chr19	SPHK2	48625949	48626362	21670	414	165155	5205	143485	4791	52.34299516908212	29.948862450427885
chr19	SPHK2	48626067	48626362	21340	296	165155	5205	143815	4909	72.0945945945946	29.296190670197596
chr19	SPHK2	48625890	48626362	21874	473	165155	5205	143281	4732	46.245243128964056	30.27916314454776
chr19	SPHK2	48628680	48629726	8157	1047	165155	5205	156998	4158	7.7908309455587395	37.75805675805676
chr19	DHDH	48936031	48936195	0	165	2422	1071	2422	906	0.0	2.673289183222958
chr19	DHDH	48942439	48942564	0	126	2422	1071	2422	945	0.0	2.562962962962963
chr19	DHDH	48944356	48944507	11	152	2422	1071	2411	919	0.07236842105263158	2.623503808487486
chr19	BAX	48955686	48955833	51	148	182482	1767	182431	1619	0.34459459459459457	112.68128474366893
chr19	BAX	48955547	48955599	175	53	182482	1767	182307	1714	3.30188679245283	106.36347724620771
chr19	BAX	48960238	48960336	3595	99	182482	1767	178887	1668	36.313131313131315	107.24640287769785
chr19	RUVBL2	48999318	48999373	54	56	1062	3172	1008	3116	0.9642857142857143	0.32349165596919127
chr19	RUVBL2	49015020	49015150	0	131	1062	3172	1062	3041	0.0	0.349227227885564
chr19	RUVBL2	49001348	49001590	102	243	1062	3172	960	2929	0.41975308641975306	0.32775691362239673
chr19	SNRNP70	49086404	49086561	0	158	790	4668	790	4510	0.0	0.17516629711751663
chr19	SNRNP70	49102113	49102173	0	61	790	4668	790	4607	0.0	0.171478185370089
chr19	SNRNP70	49102113	49103587	612	1475	790	4668	178	3193	0.41491525423728814	0.0557469464453492
chr19	SNRNP70	49102113	49102185	0	73	790	4668	790	4595	0.0	0.1719260065288357
chr19	SNRNP70	49087633	49087777	0	145	790	4668	790	4523	0.0	0.1746628344019456
chr19	LIN7B	49116262	49116472	0	211	400	1760	400	1549	0.0	0.2582311168495804
chr19	LIN7B	49115824	49116024	288	201	400	1760	112	1559	1.4328358208955223	0.0718409236690186
chr19	PPFIA3	49129992	49130067	151	76	52632	5974	52481	5898	1.986842105263158	8.898101051203797
chr19	PPFIA3	49138204	49138427	588	224	52632	5974	52044	5750	2.625	9.051130434782609
chr19	PPFIA3	49146165	49146192	140	28	52632	5974	52492	5946	5.0	8.82811974436596
chr19	TRPM4	49166040	49166215	0	176	3570	6483	3570	6307	0.0	0.5660377358490566
chr19	TRPM4	49190207	49190320	0	114	3570	6483	3570	6369	0.0	0.5605275553462082
chr19	TRPM4	49196439	49196874	0	436	3570	6483	3570	6047	0.0	0.5903753927567389
chr19	TRPM4	49211014	49211087	0	74	3570	6483	3570	6409	0.0	0.5570291777188329
chr19	TRPM4	49167916	49168097	0	182	3570	6483	3570	6301	0.0	0.5665767338517695
chr19	TRPM4	49181348	49181461	0	114	3570	6483	3570	6369	0.0	0.5605275553462082
chr19	TRPM4	49168259	49168423	0	165	3570	6483	3570	6318	0.0	0.5650522317188984
chr19	TRPM4	49172008	49172108	0	101	3570	6483	3570	6382	0.0	0.5593857724851143
chr19	CD37	49335885	49336029	0	145	20350	3440	20350	3295	0.0	6.1760242792109254
chr19	DKKL1	49365792	49365885	0	94	6178	1332	6178	1238	0.0	4.990306946688206
chr19	DKKL1	49365508	49365649	64	142	6178	1332	6114	1190	0.4507042253521127	5.137815126050421
chr19	KASH5	49390788	49390926	0	139	313326	5515	313326	5376	0.0	58.28236607142857
chr19	KASH5	49393345	49393419	1	75	313326	5515	313325	5440	0.013333333333333334	57.596507352941174
chr19	KASH5	49391685	49391781	0	97	313326	5515	313326	5418	0.0	57.83056478405316
chr19	KASH5	49391680	49391781	0	102	313326	5515	313326	5413	0.0	57.88398300387955
chr19	KASH5	49393345	49393400	1	56	313326	5515	313325	5459	0.017857142857142856	57.396043231361055
chr19	ALDH16A1	49461883	49462036	7	154	443073	3286	443066	3132	0.045454545454545456	141.46424010217115
chr19	ALDH16A1	49464126	49464263	108428	138	443073	3286	334645	3148	785.7101449275362	106.30400254129606
chr19	ALDH16A1	49458959	49459086	98693	128	443073	3286	344380	3158	771.0390625	109.05003166561114
chr19	ALDH16A1	49459669	49459848	4400	180	443073	3286	438673	3106	24.444444444444443	141.2340631036703
chr19	ALDH16A1	49458485	49458588	866	104	443073	3286	442207	3182	8.326923076923077	138.97140163419232
chr19	FLT3LG	49478962	49479047	0	86	152987	2805	152987	2719	0.0	56.26590658330269
chr19	FLT3LG	49480297	49480476	70	180	152987	2805	152917	2625	0.3888888888888889	58.25409523809524
chr19	FLT3LG	49478908	49479047	0	140	152987	2805	152987	2665	0.0	57.406003752345214
chr19	RPL13A	49490231	49490297	281	67	84337	3165	84056	3098	4.1940298507462686	27.13234344738541
chr19	FCGRT	49513386	49513473	1994	88	385117	3363	383123	3275	22.65909090909091	116.98412213740458
chr19	FCGRT	49514210	49514486	267848	277	385117	3363	117269	3086	966.9602888086642	38.00032404406999
chr19	FCGRT	49515176	49515269	0	94	385117	3363	385117	3269	0.0	117.80881003364944
chr19	FCGRT	49513881	49514133	969	253	385117	3363	384148	3110	3.8300395256916997	123.52025723472669
chr19	FCGRT	49521694	49521813	0	120	385117	3363	385117	3243	0.0	118.75331483194573
chr19	FCGRT	49520668	49521201	1556	534	385117	3363	383561	2829	2.9138576779026217	135.58183103570167
chr19	RCN3	49534192	49534395	0	204	97	1663	97	1459	0.0	0.06648389307745031
chr19	RCN3	49534192	49534301	0	110	97	1663	97	1553	0.0	0.062459755312298776
chr19	BCL2L12	49667018	49667161	568	144	11111	2223	10543	2079	3.9444444444444446	5.071188071188071
chr19	BCL2L12	49670215	49670488	9595	274	11111	2223	1516	1949	35.018248175182485	0.7778347870702924
chr19	BCL2L12	49669023	49669164	247	142	11111	2223	10864	2081	1.7394366197183098	5.220567035079289
chr19	BCL2L12	49667021	49667161	559	141	11111	2223	10552	2082	3.9645390070921986	5.068203650336216
chr19	BCL2L12	49669023	49669115	247	93	11111	2223	10864	2130	2.6559139784946235	5.100469483568075
chr19	BCL2L12	49668850	49668937	194	88	11111	2223	10917	2135	2.2045454545454546	5.113348946135831
chr19	PRMT1	49676345	49676439	1495	95	42307	4621	40812	4526	15.736842105263158	9.017233760494918
chr19	PRMT1	49679871	49679925	0	55	42307	4621	42307	4566	0.0	9.265659220324135
chr19	CPT1C	49696481	49696602	102	122	34491	5093	34389	4971	0.8360655737704918	6.917923958961979
chr19	CPT1C	49700683	49700855	102	173	34491	5093	34389	4920	0.5895953757225434	6.989634146341463
chr19	CPT1C	49701316	49701418	0	103	34491	5093	34491	4990	0.0	6.9120240480961925
chr19	CPT1C	49691660	49691770	0	111	34491	5093	34491	4982	0.0	6.923123243677238
chr19	CPT1C	49691820	49691889	0	70	34491	5093	34491	5023	0.0	6.8666135775433
chr19	CPT1C	49691820	49691953	1044	134	34491	5093	33447	4959	7.791044776119403	6.744706594071386
chr19	AP2A1	49802533	49802599	353	67	3704	6084	3351	6017	5.268656716417911	0.5569220541798239
chr19	PTOV1	49854969	49855077	28	109	133480	4048	133452	3939	0.25688073394495414	33.87966488956588
chr19	TBC1D17	49878142	49878241	132	100	204	4759	72	4659	1.32	0.015453960077269801
chr19	TBC1D17	49879322	49879504	0	183	204	4759	204	4576	0.0	0.044580419580419584
chr19	ATF5	49929700	49929865	0	166	5303	2898	5303	2732	0.0	1.941068814055637
chr19	ZNF473	50031013	50031091	0	79	221535	6268	221535	6189	0.0	35.79495879786718
chr19	ZNF473	50030891	50031091	0	201	221535	6268	221535	6067	0.0	36.51475193670677
chr19	ZNF473	50040533	50040629	0	97	221535	6268	221535	6171	0.0	35.89936801166748
chr19	MYH14	50224153	50224177	0	25	580074	7572	580074	7547	0.0	76.86153438452365
chr19	MYH14	50255219	50255318	0	100	580074	7572	580074	7472	0.0	77.63302997858672
chr19	MYH14	50230824	50230999	0	176	580074	7572	580074	7396	0.0	78.43077339102217
chr19	NR1H2	50376234	50376576	76608	343	256105	5355	179497	5012	223.3469387755102	35.8134477254589
chr19	NR1H2	50378148	50378312	2911	165	256105	5355	253194	5190	17.64242424242424	48.7849710982659
chr19	NR1H2	50378148	50378439	5508	292	256105	5355	250597	5063	18.863013698630137	49.495753505826585
chr19	POLD1	50417044	50417097	1842	54	86748	4790	84906	4736	34.111111111111114	17.92778716216216
chr19	POLD1	50415723	50415826	45	104	86748	4790	86703	4686	0.4326923076923077	18.50256081946223
chr19	POLD1	50395024	50395150	0	127	86748	4790	86748	4663	0.0	18.60347415826721
chr19	POLD1	50410982	50411058	44953	77	86748	4790	41795	4713	583.8051948051948	8.86802461277318
chr19	SPIB	50422822	50423037	4932	216	110147	4287	105215	4071	22.833333333333332	25.84500122819946
chr19	EMC10	50481860	50481947	51	88	118488	9750	118437	9662	0.5795454545454546	12.258021113641068
chr19	KLK3	50858028	50858086	0	59	0	2916	0	2857	0.0	0.0
chr19	KLK2	50874720	50874880	50	161	10676	5806	10626	5645	0.3105590062111801	1.8823737821080602
chr19	KLK2	50874720	50874966	51	247	10676	5806	10625	5559	0.20647773279352227	1.9113149847094801
chr19	KLK2	50877703	50877756	0	54	10676	5806	10676	5752	0.0	1.8560500695410291
chr19	SIGLEC7	51144405	51144684	61	280	84	2050	23	1770	0.21785714285714286	0.012994350282485875
chr19	SIGLEC7	51147220	51147317	0	98	84	2050	84	1952	0.0	0.0430327868852459
chr19	SIGLEC17P	51168602	51168650	0	49	51	1572	51	1523	0.0	0.0334865397242285
chr19	CD33	51226308	51226356	0	49	0	3144	0	3095	0.0	0.0
chr19	CD33	51225217	51225598	0	382	0	3144	0	2762	0.0	0.0
chr19	SIGLECL1	51265367	51265649	102	283	313	2360	211	2077	0.36042402826855124	0.10158883004333173
chr19	LINC01872	51279197	51279300	0	104	51	1114	51	1010	0.0	0.0504950495049505
chr19	AC008750.2	51343687	51343811	0	125	0	443	0	318	0.0	0.0
chr19	FPR2	51762416	51762535	0	120	51	3632	51	3512	0.0	0.014521640091116172
chr19	FPR2	51763361	51763517	0	157	51	3632	51	3475	0.0	0.014676258992805755
chr19	ZNF613	51929731	51929824	0	94	154	3225	154	3131	0.0	0.04918556371766209
chr19	ZNF613	51927894	51927994	0	101	154	3225	154	3124	0.0	0.04929577464788732
chr19	ZNF613	51929731	51929896	0	166	154	3225	154	3059	0.0	0.05034324942791762
chr19	ZNF613	51936027	51936235	0	209	154	3225	154	3016	0.0	0.05106100795755968
chr19	PPP2R1A	52200273	52200398	154	126	4883	7147	4729	7021	1.2222222222222223	0.6735507762427004
chr19	ZNF766	52282110	52282237	0	128	0	6941	0	6813	0.0	0.0
chr19	ZNF766	52277153	52277541	0	389	0	6941	0	6552	0.0	0.0
chr19	ZNF766	52288041	52288115	0	75	0	6941	0	6866	0.0	0.0
chr19	ZNF766	52275577	52275607	0	31	0	6941	0	6910	0.0	0.0
chr19	ZNF480	52314152	52314279	0	128	0	3049	0	2921	0.0	0.0
chr19	ZNF480	52315833	52315962	0	130	0	3049	0	2919	0.0	0.0
chr19	ZNF480	52317415	52317513	0	99	0	3049	0	2950	0.0	0.0
chr19	ZNF610	52354250	52354379	0	130	3426	3557	3426	3427	0.0	0.9997081995914794
chr19	ZNF880	52379420	52379540	765	121	10820	3725	10055	3604	6.322314049586777	2.789955604883463
chr19	ZNF528	52401684	52401753	287	70	3695	7868	3408	7798	4.1	0.4370351372146704
chr19	ZNF528	52402428	52402545	760	118	3695	7868	2935	7750	6.440677966101695	0.37870967741935485
chr19	ZNF528	52414203	52414368	51	166	3695	7868	3644	7702	0.3072289156626506	0.4731238639314464
chr19	ZNF528	52414938	52415039	0	102	3695	7868	3695	7766	0.0	0.4757919134689673
chr19	ZNF534	52435080	52435209	0	130	6112	3285	6112	3155	0.0	1.937242472266244
chr19	ZNF808	52547511	52547638	0	128	30291	5015	30291	4887	0.0	6.198281154082259
chr19	ZNF808	52532907	52533009	0	103	30291	5015	30291	4912	0.0	6.1667345276872965
chr19	ZNF701	52572236	52572368	0	133	22488	7085	22488	6952	0.0	3.234752589182969
chr19	AC092070.2	53202551	53202702	750	152	5267	4057	4517	3905	4.934210526315789	1.1567221510883483
chr19	ZNF845	53340823	53340925	0	103	9889	6455	9889	6352	0.0	1.5568324937027709
chr19	ZNF765	53402064	53402191	0	128	116234	9293	116234	9165	0.0	12.682378614293508
chr19	ZNF813	53486631	53486758	216	128	7198	6251	6982	6123	1.6875	1.1402907071696882
chr19	ZNF813	53488207	53488300	408	94	7198	6251	6790	6157	4.340425531914893	1.102809809972389
chr19	ZNF331	53522616	53522684	246	69	20657	8057	20411	7988	3.5652173913043477	2.5552078117175765
chr19	ZNF331	53539215	53539282	39	68	20657	8057	20618	7989	0.5735294117647058	2.5807985980723496
chr19	ZNF331	53555844	53555908	0	65	20657	8057	20657	7992	0.0	2.58470970970971
chr19	ZNF331	53523263	53523496	102	234	20657	8057	20555	7823	0.4358974358974359	2.627508628403426
chr19	ZNF331	53563762	53563792	0	31	20657	8057	20657	8026	0.0	2.573760279092948
chr19	MYADM	53869689	53869838	77	150	2565	4306	2488	4156	0.5133333333333333	0.5986525505293552
chr19	MYADM	53869753	53869838	28	86	2565	4306	2537	4220	0.32558139534883723	0.6011848341232228
chr19	MYADM	53872711	53872787	0	77	2565	4306	2565	4229	0.0	0.606526365571057
chr19	CACNG6	53999633	53999771	0	139	1917	1857	1917	1718	0.0	1.1158323632130385
chr19	CACNG6	53998238	53998313	540	76	1917	1857	1377	1781	7.105263157894737	0.7731611454239191
chr19	NDUFA3	54105596	54105703	0	108	0	2142	0	2034	0.0	0.0
chr19	NDUFA3	54106352	54106446	0	95	0	2142	0	2047	0.0	0.0
chr19	NDUFA3	54106810	54106978	0	169	0	2142	0	1973	0.0	0.0
chr19	CNOT3	54152427	54152626	0	200	191	5828	191	5628	0.0	0.03393745557924662
chr19	CNOT3	54153180	54153393	0	214	191	5828	191	5614	0.0	0.03402208763804774
chr19	RPS9	54206275	54206462	0	188	0	3672	0	3484	0.0	0.0
chr19	RPS9	54206552	54206724	0	173	0	3672	0	3499	0.0	0.0
chr19	RPS9	54206275	54206724	0	450	0	3672	0	3222	0.0	0.0
chr19	TTYH1	54421276	54421388	0	113	1113	6918	1113	6805	0.0	0.16355620867009552
chr19	TTYH1	54435827	54435873	0	47	1113	6918	1113	6871	0.0	0.1619851549992723
chr19	LENG8	54451289	54451382	0	94	61	5922	61	5828	0.0	0.010466712422786548
chr19	LENG8	54453545	54453656	0	112	61	5922	61	5810	0.0	0.010499139414802065
chr19	LAIR2	54503699	54503735	0	37	0	1050	0	1013	0.0	0.0
chr19	LAIR2	54509034	54509085	0	52	0	1050	0	998	0.0	0.0
chr19	KIR3DX1	54542523	54542646	51	124	30114	4481	30063	4357	0.4112903225806452	6.8999311452834515
chr19	KIR3DX1	54535585	54535647	0	63	30114	4481	30114	4418	0.0	6.816206428248076
chr19	LILRA2	54573697	54573912	0	216	184	5359	184	5143	0.0	0.03577678397822283
chr19	LILRA2	54574075	54574111	0	37	184	5359	184	5322	0.0	0.03457346862081924
chr19	LILRA2	54573830	54573912	0	83	184	5359	184	5276	0.0	0.034874905231235785
chr19	LILRA2	54587009	54587060	0	52	184	5359	184	5307	0.0	0.034671188995666104
chr19	LILRA2	54577464	54577723	92	260	184	5359	92	5099	0.35384615384615387	0.01804275348107472
chr19	LILRA1	54594196	54594278	0	83	4575	3887	4575	3804	0.0	1.2026813880126184
chr19	LILRB1	54635103	54635179	17747	77	332540	4895	314793	4818	230.4805194805195	65.33686176836862
chr19	LILRB1	54633637	54633688	94	52	332540	4895	332446	4843	1.8076923076923077	68.6446417509808
chr19	LILRB1	54634363	54634402	120	40	332540	4895	332420	4855	3.0	68.46961894953657
chr19	LILRB4	54667634	54667793	0	160	108389	6341	108389	6181	0.0	17.53583562530335
chr19	LILRB4	54667637	54667793	0	157	108389	6341	108389	6184	0.0	17.527328589909445
chr19	KIR2DL1	54780088	54780166	0	79	0	1701	0	1622	0.0	0.0
chr19	KIR2DL4	54804792	54805077	0	286	51	1732	51	1446	0.0	0.035269709543568464
chr19	KIR2DL4	54808832	54808883	0	52	51	1732	51	1680	0.0	0.030357142857142857
chr19	KIR2DL4	54813124	54813228	0	105	51	1732	51	1627	0.0	0.0313460356484327
chr19	KIR2DL4	54813124	54813295	0	172	51	1732	51	1560	0.0	0.032692307692307694
chr19	KIR3DL1	54818314	54818599	0	286	10	1880	10	1594	0.0	0.006273525721455458
chr19	KIR3DL1	54825027	54825078	0	52	10	1880	10	1828	0.0	0.005470459518599562
chr19	KIR2DS4	54842867	54842918	0	52	0	1616	0	1564	0.0	0.0
chr19	KIR3DL2	54859078	54859129	0	52	20	1886	20	1834	0.0	0.010905125408942203
chr19	FCAR	54875329	54875365	0	37	0	3333	0	3296	0.0	0.0
chr19	FCAR	54888006	54888294	0	289	0	3333	0	3044	0.0	0.0
chr19	FCAR	54885234	54885525	0	292	0	3333	0	3041	0.0	0.0
chr19	FCAR	54888006	54888228	0	223	0	3333	0	3110	0.0	0.0
chr19	FCAR	54888006	54888220	0	215	0	3333	0	3118	0.0	0.0
chr19	NCR1	54906298	54906334	0	37	12	1901	12	1864	0.0	0.006437768240343348
chr19	NCR1	54906522	54906807	0	286	12	1901	12	1615	0.0	0.007430340557275541
chr19	NCR1	54912167	54912218	12	52	12	1901	0	1849	0.23076923076923078	0.0
chr19	NCR1	54912170	54912218	12	49	12	1901	0	1852	0.24489795918367346	0.0
chr19	NLRP2	54977751	54977823	0	73	117189	6333	117189	6260	0.0	18.720287539936102
chr19	NLRP2	54981616	54981682	0	67	117189	6333	117189	6266	0.0	18.702361953399297
chr19	NLRP2	54976859	54976958	0	100	117189	6333	117189	6233	0.0	18.801379752927964
chr19	NLRP2	54981625	54981682	0	58	117189	6333	117189	6275	0.0	18.67553784860558
chr19	NLRP2	54989556	54989752	0	197	117189	6333	117189	6136	0.0	19.098598435462844
chr19	EPS8L1	55078998	55079057	0	60	0	4935	0	4875	0.0	0.0
chr19	EPS8L1	55078087	55078128	0	42	0	4935	0	4893	0.0	0.0
chr19	EPS8L1	55083766	55084642	0	877	0	4935	0	4058	0.0	0.0
chr19	BRSK1	55304049	55304110	0	62	0	3974	0	3912	0.0	0.0
chr19	KMT5C	55342214	55342380	0	167	0	4651	0	4484	0.0	0.0
chr19	ZNF628	55479833	55479917	0	85	357	3565	357	3480	0.0	0.10258620689655172
chr19	SSC5D	55497879	55498197	0	319	51	7009	51	6690	0.0	0.007623318385650224
chr19	CCDC106	55649204	55649309	0	106	59824	2490	59824	2384	0.0	25.093959731543624
chr19	U2AF2	55658861	55658981	0	121	2652	4130	2652	4009	0.0	0.6615115989024695
chr19	EPN1	55689296	55689371	824	76	126256	16106	125432	16030	10.842105263157896	7.824828446662508
chr19	NLRP4	55867708	55867876	0	169	13746	3723	13746	3554	0.0	3.867754642656162
chr19	ZNF444	56142275	56142386	0	112	116528	4183	116528	4071	0.0	28.623925325472857
chr19	GALP	56180585	56180634	0	50	291048	956	291048	906	0.0	321.2450331125828
chr19	EDDM13	56302841	56302983	0	143	0	2340	0	2197	0.0	0.0
chr19	ZNF542P	56369278	56369337	0	60	102	4675	102	4615	0.0	0.02210184182015168
chr19	ZNF542P	56374685	56374757	0	73	102	4675	102	4602	0.0	0.02216427640156454
chr19	ZNF542P	56374685	56374825	0	141	102	4675	102	4534	0.0	0.022496691662990738
chr19	ZNF582-AS1	56394216	56394441	0	226	26	1662	26	1436	0.0	0.018105849582172703
chr19	ZNF667-AS1	56491576	56491766	0	191	108	6804	108	6613	0.0	0.016331468319975805
chr19	ZFP28	56548377	56548478	0	102	235	6918	235	6816	0.0	0.03447769953051643
chr19	ZNF470	56574393	56574520	0	128	754	8087	754	7959	0.0	0.09473551953763036
chr19	ZNF71	56613811	56613938	267	128	20238	6139	19971	6011	2.0859375	3.3224089169855264
chr19	SMIM17	56647557	56647634	0	78	13204	2547	13204	2469	0.0	5.34791413527744
chr19	AC006115.2	56791054	56791307	52	254	50818	16166	50766	15912	0.2047244094488189	3.190422322775264
chr19	AC006115.2	56793103	56793232	252	130	50818	16166	50566	16036	1.9384615384615385	3.153280119730606
chr19	AC006115.2	56789927	56791307	1122	1381	50818	16166	49696	14785	0.8124547429398986	3.361244504565438
chr19	AC006115.2	56821727	56821812	440	86	50818	16166	50378	16080	5.116279069767442	3.132960199004975
chr19	AC006115.2	56789927	56790078	0	152	50818	16166	50818	16014	0.0	3.173348320219808
chr19	ZNF264	57205396	57205492	0	97	51	12290	51	12193	0.0	0.004182727794636266
chr19	AURKC	57233459	57233608	0	150	51	1747	51	1597	0.0	0.031934877896055106
chr19	ZNF805	57243922	57244049	135	128	339	10173	204	10045	1.0546875	0.0203086112493778
chr19	ZNF304	57355270	57355411	0	142	51	4614	51	4472	0.0	0.011404293381037567
chr19	ZNF304	57352654	57352735	0	82	51	4614	51	4532	0.0	0.011253309796999117
chr19	ZNF547	57370972	57371094	0	123	0	3420	0	3297	0.0	0.0
chr19	ZNF548	57394187	57394223	0	37	306	6008	306	5971	0.0	0.05124769720314855
chr19	ZNF548	57394042	57394223	0	182	306	6008	306	5826	0.0	0.05252317198764161
chr19	ZNF548	57392800	57392948	0	149	306	6008	306	5859	0.0	0.05222734254992319
chr19	ZNF548	57390721	57390845	0	125	306	6008	306	5883	0.0	0.05201427842937277
chr19	ZNF548	57392787	57392948	0	162	306	6008	306	5846	0.0	0.052343482723229556
chr19	ZNF17	57413595	57413636	0	42	0	3186	0	3144	0.0	0.0
chr19	ZNF17	57417911	57418038	0	128	0	3186	0	3058	0.0	0.0
chr19	ZNF749	57441884	57442011	0	128	0	4546	0	4418	0.0	0.0
chr19	ZNF419	57492112	57492211	0	100	51	5698	51	5598	0.0	0.009110396570203644
chr19	ZNF419	57490146	57490185	0	40	51	5698	51	5658	0.0	0.009013785790031814
chr19	ZNF419	57490130	57490185	0	56	51	5698	51	5642	0.0	0.009039347749025168
chr19	ZNF773	57508519	57508564	0	46	153	5246	153	5200	0.0	0.029423076923076923
chr19	ZNF549	57531069	57531108	0	40	0	9284	0	9244	0.0	0.0
chr19	ZIK1	57588538	57588665	0	128	153	5376	153	5248	0.0	0.029153963414634148
chr19	ZIK1	57584951	57584990	0	40	153	5376	153	5336	0.0	0.028673163418290855
chr19	ZIK1	57588580	57588665	0	86	153	5376	153	5290	0.0	0.02892249527410208
chr19	ZNF530	57600727	57600779	0	53	51	3993	51	3940	0.0	0.012944162436548223
chr19	ZNF530	57605685	57607827	0	2143	51	3993	51	1850	0.0	0.027567567567567567
chr19	ZNF134	57619411	57619508	0	98	0	5143	0	5045	0.0	0.0
chr19	ZNF134	57618791	57618877	0	87	0	5143	0	5056	0.0	0.0
chr19	ZNF211	57639911	57640067	0	157	0	4549	0	4392	0.0	0.0
chr19	ZNF211	57634022	57634061	0	40	0	4549	0	4509	0.0	0.0
chr19	ZNF211	57633785	57633905	0	121	0	4549	0	4428	0.0	0.0
chr19	ZNF211	57633712	57633905	0	194	0	4549	0	4355	0.0	0.0
chr19	ZNF551	57685261	57685385	68	125	31273	4707	31205	4582	0.544	6.810344827586207
chr19	ZNF586	57774765	57774815	0	51	38235	5489	38235	5438	0.0	7.031077602059581
chr19	ZNF586	57776542	57776669	0	128	38235	5489	38235	5361	0.0	7.132064913262451
chr19	AC010522.1	57820493	57820549	0	57	14107	1165	14107	1108	0.0	12.731949458483754
chr19	AC010522.1	57856106	57856233	0	128	14107	1165	14107	1037	0.0	13.603664416586307
chr19	AC010522.1	57856103	57856233	0	131	14107	1165	14107	1034	0.0	13.643133462282398
chr19	AC008969.1	58004382	58004700	9996	319	40931	5845	30935	5526	31.33542319749216	5.598081795150199
chr19	AC008969.1	58005906	58005995	2775	90	40931	5845	38156	5755	30.833333333333332	6.630060816681147
chr19	ZSCAN1	58035439	58035502	401	64	51397	2403	50996	2339	6.265625	21.802479692176142
chr19	ZNF135	58059973	58060035	9	63	36365	6389	36356	6326	0.14285714285714285	5.747075561176099
chr19	ZNF135	58059968	58060398	1326	431	36365	6389	35039	5958	3.0765661252900234	5.881000335683115
chr19	ZNF135	58059968	58060035	9	68	36365	6389	36356	6321	0.1323529411764706	5.751621578864103
chr19	ZNF274	58185711	58185838	0	128	44542	6244	44542	6116	0.0	7.282864617396991
chr19	ZNF274	58186946	58187042	0	97	44542	6244	44542	6147	0.0	7.246136326663413
chr19	ZNF274	58185696	58185838	0	143	44542	6244	44542	6101	0.0	7.30077036551385
chr19	ZNF544	58230393	58230462	0	70	19955	6745	19955	6675	0.0	2.9895131086142324
chr19	ZNF544	58246745	58246794	164	50	19955	6745	19791	6695	3.28	2.956086631814787
chr19	ZNF544	58237248	58237334	318	87	19955	6745	19637	6658	3.6551724137931036	2.9493841994592973
chr19	ZNF544	58246710	58246794	164	85	19955	6745	19791	6660	1.9294117647058824	2.9716216216216216
chr19	ZNF544	58230393	58230497	0	105	19955	6745	19955	6640	0.0	3.0052710843373496
chr19	ZNF544	58276322	58276429	0	108	19955	6745	19955	6637	0.0	3.006629501280699
chr19	ERVK3-1	58312020	58312061	1074	42	15409	2116	14335	2074	25.571428571428573	6.911764705882353
chr19	ERVK3-1	58311198	58311380	2688	183	15409	2116	12721	1933	14.688524590163935	6.580962234868081
chr19	A1BG-AS1	58353320	58353474	7868	155	109092	3102	101224	2947	50.76129032258064	34.34815066168986
chr19	A1BG-AS1	58353320	58353461	7295	142	109092	3102	101797	2960	51.37323943661972	34.39087837837838
chr19	A1BG-AS1	58353378	58353474	3781	97	109092	3102	105311	3005	38.97938144329897	35.045257903494175
chr19	RPS5	58387031	58387339	510	309	8308	2650	7798	2341	1.6504854368932038	3.3310551046561296
chr19	RPS5	58392975	58393185	801	211	8308	2650	7507	2439	3.796208530805687	3.07790077900779
chr19	RPS5	58388417	58388480	111	64	8308	2650	8197	2586	1.734375	3.1697602474864657
chr19	ZNF584	58415792	58415940	4809	149	53381	2662	48572	2513	32.2751677852349	19.328292877039395
chr19	ZNF584	58409940	58410091	0	152	53381	2662	53381	2510	0.0	21.267330677290836
chr19	ZNF584	58410005	58410091	0	87	53381	2662	53381	2575	0.0	20.730485436893204
chr19	ZNF584	58409964	58410091	0	128	53381	2662	53381	2534	0.0	21.065903709550117
chr19	ZNF584	58415818	58415940	3954	123	53381	2662	49427	2539	32.146341463414636	19.467113036628593
chr19	ZNF324B	58453186	58453266	1672	81	31627	4041	29955	3960	20.641975308641975	7.5643939393939394
chr19	ZNF324B	58452127	58452782	15564	656	31627	4041	16063	3385	23.725609756097562	4.745347119645495
chr19	ZNF446	58479642	58479727	0	86	3927	4698	3927	4612	0.0	0.8514744145706852
chr19	ZNF446	58476439	58476504	0	66	3927	4698	3927	4632	0.0	0.8477979274611399
chr19	MZF1-AS1	58571857	58571955	0	99	5976	3845	5976	3746	0.0	1.595301655098772
chr19	AC016629.3	58591497	58591624	162	128	78822	3405	78660	3277	1.265625	24.003661885871225
chr20	NRSN2	349637	349832	0	196	357	2380	357	2184	0.0	0.16346153846153846
chr20	NRSN2	347433	347506	0	74	357	2380	357	2306	0.0	0.15481352992194275
chr20	NRSN2	347433	347512	0	80	357	2380	357	2300	0.0	0.15521739130434783
chr20	NRSN2	355325	355349	0	25	357	2380	357	2355	0.0	0.15159235668789808
chr20	TRIB3	382432	382626	0	195	72468	3039	72468	2844	0.0	25.481012658227847
chr20	RBCK1	409880	410025	0	146	195068	4749	195068	4603	0.0	42.37844883771454
chr20	RBCK1	420870	421006	35982	137	195068	4749	159086	4612	262.64233576642334	34.493928881179535
chr20	RBCK1	409883	410025	0	143	195068	4749	195068	4606	0.0	42.35084672166739
chr20	RBCK1	420870	421031	39499	162	195068	4749	155569	4587	243.820987654321	33.91519511663397
chr20	RBCK1	417219	417342	27206	124	195068	4749	167862	4625	219.40322580645162	36.294486486486484
chr20	FAM110A	839454	839563	0	110	3601	2312	3601	2202	0.0	1.6353315168029066
chr20	PSMF1	1118752	1118902	255	151	2805	9208	2550	9057	1.6887417218543046	0.28155018217952965
chr20	PSMF1	1127425	1127508	0	84	2805	9208	2805	9124	0.0	0.30743095133713283
chr20	PSMF1	1163129	1163183	0	55	2805	9208	2805	9153	0.0	0.30645689937725334
chr20	RAD21L1	1246209	1246305	0	97	939	2747	939	2650	0.0	0.3543396226415094
chr20	SDCBP2-AS1	1350338	1350481	846368	144	864935	5316	18567	5172	5877.555555555556	3.589907192575406
chr20	SDCBP2-AS1	1374483	1374698	0	216	864935	5316	864935	5100	0.0	169.59509803921569
chr20	SDCBP2-AS1	1373077	1373178	1324	102	864935	5316	863611	5214	12.980392156862745	165.6331031837361
chr20	TGM6	2430893	2431027	0	135	0	2312	0	2177	0.0	0.0
chr20	NOP56	2657638	2657692	0	55	54	4253	54	4198	0.0	0.012863268222963315
chr20	NOP56	2657372	2657488	0	117	54	4253	54	4136	0.0	0.013056092843326886
chr20	EBF4	2709573	2709642	0	70	1281	3015	1281	2945	0.0	0.43497453310696094
chr20	PTPRA	2975214	2975241	0	28	251832	4499	251832	4471	0.0	56.32565421605905
chr20	PTPRA	2923206	2923285	0	80	251832	4499	251832	4419	0.0	56.98845892735913
chr20	PTPRA	2947981	2948024	248	44	251832	4499	251584	4455	5.636363636363637	56.472278338945
chr20	PTPRA	2955608	2955698	0	91	251832	4499	251832	4408	0.0	57.13067150635209
chr20	ITPA	3213318	3213383	0	66	77834	1951	77834	1885	0.0	41.291246684350135
chr20	ITPA	3213168	3213226	0	59	77834	1951	77834	1892	0.0	41.1384778012685
chr20	HSPA12B	3740814	3740912	5035	99	30450	3146	25415	3047	50.85858585858586	8.340991138825073
chr20	CDC25B	3800742	3800865	74	124	259622	4331	259548	4207	0.5967741935483871	61.69431899215593
chr20	CDC25B	3801721	3801802	633	82	259622	4331	258989	4249	7.719512195121951	60.95293010120028
chr20	MAVS	3857634	3857809	914	176	273130	11778	272216	11602	5.193181818181818	23.462851232546114
chr20	PANK2	3901547	3901617	3273	71	197701	5369	194428	5298	46.098591549295776	36.698376745941864
chr20	PANK2	3901551	3901617	2985	67	197701	5369	194716	5302	44.55223880597015	36.725009430403624
chr20	SMOX	4182088	4182848	0	761	1497	2958	1497	2197	0.0	0.6813837050523441
chr20	SMOX	4186742	4186832	51	91	1497	2958	1446	2867	0.5604395604395604	0.5043599581444018
chr20	CDS2	5173522	5173659	2172	138	91508	11814	89336	11676	15.73913043478261	7.651250428228845
chr20	AL121757.1	5471853	5471931	0	79	3212	3014	3212	2935	0.0	1.0943781942078366
chr20	AL121757.2	5488957	5489429	0	473	74	3073	74	2600	0.0	0.02846153846153846
chr20	SHLD1	5765093	5765184	0	92	0	2191	0	2099	0.0	0.0
chr20	SHLD1	5756711	5756848	0	138	0	2191	0	2053	0.0	0.0
chr20	CHGB	5914617	5914713	0	97	136787	4453	136787	4356	0.0	31.401974288337925
chr20	MCM8	5973055	5973196	612	142	237891	7711	237279	7569	4.309859154929577	31.348791121680538
chr20	CRLS1	6031284	6031370	0	87	16489	5374	16489	5287	0.0	3.118781917911859
chr20	LINC01706	7357779	7357988	0	210	0	1390	0	1180	0.0	0.0
chr20	LINC01706	7353807	7353918	0	112	0	1390	0	1278	0.0	0.0
chr20	AL021396.1	8022380	8022449	0	70	0	4232	0	4162	0.0	0.0
chr20	PLCB1	8657183	8657284	0	102	1579	16902	1579	16800	0.0	0.09398809523809523
chr20	PLCB1	8802055	8802173	0	119	1579	16902	1579	16783	0.0	0.09408329857593994
chr20	PLCB1	8141870	8141948	0	79	1579	16902	1579	16823	0.0	0.09385959698032456
chr20	PLCB4	9096286	9096342	0	57	14915	6909	14915	6852	0.0	2.176736719206071
chr20	PLCB4	9373046	9373104	0	59	14915	6909	14915	6850	0.0	2.1773722627737224
chr20	PLCB4	9405312	9405348	0	37	14915	6909	14915	6872	0.0	2.1704016298020954
chr20	PLCB4	9459634	9459810	9165	177	14915	6909	5750	6732	51.779661016949156	0.8541295306001189
chr20	PLCB4	9476716	9476753	0	38	14915	6909	14915	6871	0.0	2.1707175083685053
chr20	LAMP5	9515999	9516131	0	133	0	2048	0	1915	0.0	0.0
chr20	ANKEF1	10035578	10035642	0	65	3273	5882	3273	5817	0.0	0.5626611655492522
chr20	BTBD3	11919085	11919176	61	92	2165	5915	2104	5823	0.6630434782608695	0.3613257770908466
chr20	BTBD3	11917777	11918011	0	235	2165	5915	2165	5680	0.0	0.38116197183098594
chr20	LINC01723	12951450	12951567	0	118	51	2909	51	2791	0.0	0.01827302042278753
chr20	LINC01723	12994909	12994996	0	88	51	2909	51	2821	0.0	0.018078695498050336
chr20	NDUFAF5	13794837	13794941	357	105	4650	6832	4293	6727	3.4	0.6381745205886725
chr20	NDUFAF5	13801485	13801683	312	199	4650	6832	4338	6633	1.5678391959798994	0.6540027137042063
chr20	NDUFAF5	13814417	13814515	0	99	4650	6832	4650	6733	0.0	0.6906282489232141
chr20	NDUFAF5	13816462	13816546	0	85	4650	6832	4650	6747	0.0	0.6891951978657181
chr20	NDUFAF5	13801507	13801683	312	177	4650	6832	4338	6655	1.7627118644067796	0.6518407212622088
chr20	MACROD2	15892926	15893010	0	85	234	11457	234	11372	0.0	0.02057685543440028
chr20	MACROD2	16044570	16044639	0	70	234	11457	234	11387	0.0	0.02054974971458681
chr20	PCSK2	17260239	17260344	0	106	510	7043	510	6937	0.0	0.07351881216664265
chr20	DSTN	17591931	17592063	102	133	341577	3645	341475	3512	0.7669172932330827	97.23092255125285
chr20	DSTN	17605109	17605211	762	103	341577	3645	340815	3542	7.398058252427185	96.22106154714851
chr20	BANF2	17712160	17712540	51	381	51	1365	0	984	0.13385826771653545	0.0
chr20	BANF2	17722715	17722878	0	164	51	1365	51	1201	0.0	0.042464612822647796
chr20	MGME1	17975683	17975903	0	221	5017	2236	5017	2015	0.0	2.4898263027295284
chr20	MGME1	17988165	17988298	0	134	5017	2236	5017	2102	0.0	2.3867745004757372
chr20	KAT14	18159083	18159265	0	183	70314	4878	70314	4695	0.0	14.976357827476038
chr20	KAT14	18183534	18183581	0	48	70314	4878	70314	4830	0.0	14.557763975155279
chr20	ZNF133	18297984	18298062	0	79	2901	5437	2901	5358	0.0	0.5414333706606943
chr20	ZNF133	18305007	18305178	0	172	2901	5437	2901	5265	0.0	0.550997150997151
chr20	ZNF133	18305667	18305807	0	141	2901	5437	2901	5296	0.0	0.5477719033232629
chr20	ZNF133	18310168	18310306	0	139	2901	5437	2901	5298	0.0	0.5475651189127972
chr20	ZNF133	18306297	18306393	0	97	2901	5437	2901	5340	0.0	0.5432584269662921
chr20	ZNF133	18289898	18290074	300	177	2901	5437	2601	5260	1.694915254237288	0.4944866920152091
chr20	ZNF133	18298288	18298464	0	177	2901	5437	2901	5260	0.0	0.5515209125475286
chr20	ZNF133	18306705	18306747	0	43	2901	5437	2901	5394	0.0	0.5378197997775306
chr20	POLR3F	18481618	18481810	0	193	82773	2678	82773	2485	0.0	33.309054325955735
chr20	POLR3F	18468943	18469061	19524	119	82773	2678	63249	2559	164.0672268907563	24.716295427901525
chr20	SEC23B	18551088	18551175	0	88	145404	4075	145404	3987	0.0	36.46952595936794
chr20	SEC23B	18508090	18508297	144056	208	145404	4075	1348	3867	692.5769230769231	0.3485906387380398
chr20	SEC23B	18509615	18509943	0	329	145404	4075	145404	3746	0.0	38.815803523758674
chr20	DTD1	18620066	18620113	0	48	138435	6424	138435	6376	0.0	21.711888331242157
chr20	RIN2	19870843	19870915	0	73	61013	8294	61013	8221	0.0	7.421603211288164
chr20	RIN2	19964951	19965024	0	74	61013	8294	61013	8220	0.0	7.422506082725061
chr20	NAA20	20032507	20032653	0	147	26593	2189	26593	2042	0.0	13.023016650342802
chr20	NAA20	20022455	20022480	0	26	26593	2189	26593	2163	0.0	12.294498381877023
chr20	CFAP61	20056645	20056796	0	152	52	7956	52	7804	0.0	0.006663249615581753
chr20	CFAP61	20056617	20056796	0	180	52	7956	52	7776	0.0	0.006687242798353909
chr20	CFAP61	20191341	20191419	0	79	52	7956	52	7877	0.0	0.006601498032245779
chr20	CFAP61	20199767	20199902	0	136	52	7956	52	7820	0.0	0.006649616368286445
chr20	CFAP61	20246116	20246215	0	100	52	7956	52	7856	0.0	0.006619144602851324
chr20	CFAP61	20277165	20277458	0	294	52	7956	52	7662	0.0	0.006786739754633255
chr20	CFAP61	20288608	20288936	0	329	52	7956	52	7627	0.0	0.006817883833748525
chr20	CFAP61	20069744	20069901	0	158	52	7956	52	7798	0.0	0.006668376506796614
chr20	CFAP61	20107645	20107771	0	127	52	7956	52	7829	0.0	0.0066419721548090435
chr20	CFAP61	20232320	20232503	0	184	52	7956	52	7772	0.0	0.0066906845084920225
chr20	KIZ	21215582	21215648	1450	67	2481	3152	1031	3085	21.64179104477612	0.3341977309562399
chr20	KIZ	21232733	21232830	0	98	2481	3152	2481	3054	0.0	0.81237721021611
chr20	KIZ	21132096	21132159	2	64	2481	3152	2479	3088	0.03125	0.8027849740932642
chr20	KIZ	21145564	21145654	297	91	2481	3152	2184	3061	3.2637362637362637	0.7134923227703365
chr20	KIZ	21131863	21131957	102	95	2481	3152	2379	3057	1.0736842105263158	0.7782139352306182
chr20	KIZ	21136389	21136552	0	164	2481	3152	2481	2988	0.0	0.8303212851405622
chr20	LINC01727	21612547	21612683	0	137	0	7415	0	7278	0.0	0.0
chr20	LINC01727	21615612	21615888	0	277	0	7415	0	7138	0.0	0.0
chr20	LINC01727	21615661	21615888	0	228	0	7415	0	7187	0.0	0.0
chr20	LINC01727	21651673	21651813	0	141	0	7415	0	7274	0.0	0.0
chr20	AL118508.1	23186399	23186550	0	152	0	3797	0	3645	0.0	0.0
chr20	AL118508.1	23187212	23187640	0	429	0	3797	0	3368	0.0	0.0
chr20	AL118508.1	23186222	23186313	0	92	0	3797	0	3705	0.0	0.0
chr20	AL118508.1	23185869	23185950	0	82	0	3797	0	3715	0.0	0.0
chr20	AL118508.1	23186402	23186550	0	149	0	3797	0	3648	0.0	0.0
chr20	AL118508.1	23180603	23180793	0	191	0	3797	0	3606	0.0	0.0
chr20	AL118508.1	23180931	23181216	0	286	0	3797	0	3511	0.0	0.0
chr20	AL118508.1	23187314	23187640	0	327	0	3797	0	3470	0.0	0.0
chr20	AL118508.1	23187574	23187640	0	67	0	3797	0	3730	0.0	0.0
chr20	AL118508.1	23186453	23186550	0	98	0	3797	0	3699	0.0	0.0
chr20	GZF1	23367002	23367097	614	96	31170	5470	30556	5374	6.395833333333333	5.685895050241905
chr20	GZF1	23369583	23369741	506	159	31170	5470	30664	5311	3.1823899371069184	5.77367727358313
chr20	AL121894.3	23672593	23672720	0	128	0	3234	0	3106	0.0	0.0
chr20	AL591074.1	23803714	23803836	0	123	0	1556	0	1433	0.0	0.0
chr20	AL591074.1	23803738	23803836	0	99	0	1556	0	1457	0.0	0.0
chr20	LINC01721	24201465	24202251	51	787	51	8968	0	8181	0.06480304955527319	0.0
chr20	ENTPD6	25207075	25207397	117105	323	131420	6012	14315	5689	362.55417956656345	2.5162594480576552
chr20	ENTPD6	25213262	25213406	0	145	131420	6012	131420	5867	0.0	22.39986364411113
chr20	ENTPD6	25221231	25221333	0	103	131420	6012	131420	5909	0.0	22.240649856151634
chr20	ENTPD6	25206521	25206590	11199	70	131420	6012	120221	5942	159.9857142857143	20.232413328845507
chr20	ENTPD6	25207078	25207397	114747	320	131420	6012	16673	5692	358.584375	2.929198875614898
chr20	ZNF337-AS1	25674896	25675078	5137	183	36614	3182	31477	2999	28.07103825136612	10.495831943981328
chr20	ZNF337-AS1	25634728	25634827	0	100	36614	3182	36614	3082	0.0	11.879948085658663
chr20	ZNF337-AS1	25645530	25645648	0	119	36614	3182	36614	3063	0.0	11.953640222004571
chr20	FAM182A	26073769	26073869	0	101	7126	10300	7126	10199	0.0	0.6986959505833905
chr20	FAM182A	26076333	26076505	0	173	7126	10300	7126	10127	0.0	0.7036634738817024
chr20	HM13	31538178	31538261	0	84	561	7787	561	7703	0.0	0.07282876801246267
chr20	HM13	31549206	31549332	0	127	561	7787	561	7660	0.0	0.07323759791122715
chr20	HM13	31554745	31554829	0	85	561	7787	561	7702	0.0	0.07283822383796416
chr20	HM13	31568077	31568280	0	204	561	7787	561	7583	0.0	0.07398127390214955
chr20	HM13	31566209	31566295	0	87	561	7787	561	7700	0.0	0.07285714285714286
chr20	HM13	31527921	31528050	0	130	561	7787	561	7657	0.0	0.07326629228157241
chr20	HM13	31568077	31568224	0	148	561	7787	561	7639	0.0	0.07343893179735568
chr20	HM13	31538178	31538554	0	377	561	7787	561	7410	0.0	0.0757085020242915
chr20	HM13	31554759	31554829	0	71	561	7787	561	7716	0.0	0.07270606531881804
chr20	HM13	31538178	31538359	0	182	561	7787	561	7605	0.0	0.073767258382643
chr20	HM13	31549028	31549114	0	87	561	7787	561	7700	0.0	0.07285714285714286
chr20	HM13	31567639	31567740	0	102	561	7787	561	7685	0.0	0.07299934938191281
chr20	COX4I2	31643403	31643535	0	133	0	674	0	541	0.0	0.0
chr20	TPX2	31780938	31781046	0	109	158	3624	158	3515	0.0	0.044950213371266
chr20	TTLL9	31919863	31919932	0	70	2126	5733	2126	5663	0.0	0.3754193890164224
chr20	TTLL9	31926048	31926091	0	44	2126	5733	2126	5689	0.0	0.3737036386008086
chr20	TTLL9	31934691	31934888	204	198	2126	5733	1922	5535	1.0303030303030303	0.34724480578139116
chr20	TTLL9	31939141	31939266	0	126	2126	5733	2126	5607	0.0	0.3791688960228286
chr20	TTLL9	31884020	31884102	0	83	2126	5733	2126	5650	0.0	0.37628318584070797
chr20	TTLL9	31938158	31938263	0	106	2126	5733	2126	5627	0.0	0.37782121912208994
chr20	TTLL9	31925872	31925960	0	89	2126	5733	2126	5644	0.0	0.3766832034018427
chr20	TTLL9	31938181	31938263	0	83	2126	5733	2126	5650	0.0	0.37628318584070797
chr20	TTLL9	31920645	31920719	0	75	2126	5733	2126	5658	0.0	0.375751148815836
chr20	CCM2L	32025855	32025919	24	65	12675	2609	12651	2544	0.36923076923076925	4.972877358490566
chr20	HCK	32069687	32069751	0	65	1027	3098	1027	3033	0.0	0.3386086383119024
chr20	HCK	32054215	32054281	0	67	1027	3098	1027	3031	0.0	0.33883206862421644
chr20	TM9SF4	32136876	32136997	420	122	3900	5182	3480	5060	3.442622950819672	0.6877470355731226
chr20	POFUT1	32210070	32210192	0	123	186810	4772	186810	4649	0.0	40.182835018283505
chr20	ASXL1	32367726	32367729	0	4	676650	10047	676650	10043	0.0	67.37528626904312
chr20	ASXL1	32429900	32430053	63	154	676650	10047	676587	9893	0.4090909090909091	68.39047811583949
chr20	ASXL1	32371777	32371874	210	98	676650	10047	676440	9949	2.142857142857143	67.99075283948136
chr20	ASXL1	32360709	32360806	0	98	676650	10047	676650	9949	0.0	68.01186048849131
chr20	DNMT3B	32786501	32786627	0	127	17815	4654	17815	4527	0.0	3.9352772255356747
chr20	DNMT3B	32793535	32793595	0	61	17815	4654	17815	4593	0.0	3.878728499891139
chr20	DNMT3B	32784757	32784859	0	103	17815	4654	17815	4551	0.0	3.9145242803779388
chr20	BPIFB6	33033302	33033613	306	312	1389	1692	1083	1380	0.9807692307692307	0.7847826086956522
chr20	BPIFA3	33224354	33224462	0	109	70599	2536	70599	2427	0.0	29.08899876390606
chr20	CBFA2T2	33573973	33574261	204	289	65423	9475	65219	9186	0.7058823529411765	7.099825821902896
chr20	CBFA2T2	33601829	33601905	0	77	65423	9475	65423	9398	0.0	6.961374760587359
chr20	CBFA2T2	33623772	33623854	408	83	65423	9475	65015	9392	4.9156626506024095	6.922380749574105
chr20	ZNF341	33745102	33745299	0	198	469	5472	469	5274	0.0	0.08892681076981418
chr20	ZNF341	33781290	33781387	0	98	469	5472	469	5374	0.0	0.08727205061406773
chr20	RALY	34065043	34065160	0	118	136095	7527	136095	7409	0.0	18.368875691726277
chr20	RALY	34073818	34073866	0	49	136095	7527	136095	7478	0.0	18.199384862262637
chr20	RALY	34033163	34033239	0	77	136095	7527	136095	7450	0.0	18.26778523489933
chr20	ITCH	34393769	34393881	0	113	25998	10673	25998	10560	0.0	2.461931818181818
chr20	ITCH	34408650	34408792	102	143	25998	10673	25896	10530	0.7132867132867133	2.4592592592592593
chr20	ITCH	34393790	34393881	0	92	25998	10673	25998	10581	0.0	2.4570456478593705
chr20	ITCH	34442207	34442303	0	97	25998	10673	25998	10576	0.0	2.4582072617246595
chr20	ITCH	34397207	34397321	38	115	25998	10673	25960	10558	0.33043478260869563	2.4587990149649555
chr20	ITCH	34365459	34365576	6	118	25998	10673	25992	10555	0.05084745762711865	2.4625296068214118
chr20	ITCH	34392736	34392914	1122	179	25998	10673	24876	10494	6.268156424581005	2.3704974271012005
chr20	ITCH	34417116	34417239	141	124	25998	10673	25857	10549	1.1370967741935485	2.4511328087970425
chr20	DYNLRB1	34529851	34530234	1275	384	8827	2460	7552	2076	3.3203125	3.6377649325626202
chr20	MAP1LC3A	34559207	34559263	0	57	0	1158	0	1101	0.0	0.0
chr20	TP53INP2	34705357	34705474	0	118	102	4174	102	4056	0.0	0.02514792899408284
chr20	ACSS2	34926104	34926281	0	178	0	5112	0	4934	0.0	0.0
chr20	ACSS2	34893568	34893622	0	55	0	5112	0	5057	0.0	0.0
chr20	ACSS2	34908904	34908943	0	40	0	5112	0	5072	0.0	0.0
chr20	ACSS2	34915217	34915256	0	40	0	5112	0	5072	0.0	0.0
chr20	PROCR	35177086	35177215	272	130	18679	1313	18407	1183	2.0923076923076924	15.559594251901943
chr20	CEP250	35458303	35458374	0	72	133162	10901	133162	10829	0.0	12.296795641333457
chr20	CEP250	35475501	35475646	903	146	133162	10901	132259	10755	6.184931506849315	12.297443049744304
chr20	CEP250	35500048	35500169	0	122	133162	10901	133162	10779	0.0	12.35383616290936
chr20	CEP250	35474793	35474852	0	60	133162	10901	133162	10841	0.0	12.283184208098884
chr20	ERGIC3	35554371	35554386	0	16	31771	4803	31771	4787	0.0	6.636933361186547
chr20	ERGIC3	35556032	35556129	0	98	31771	4803	31771	4705	0.0	6.752603613177471
chr20	ERGIC3	35543660	35543804	561	145	31771	4803	31210	4658	3.8689655172413793	6.700300558179476
chr20	ERGIC3	35549162	35549207	0	46	31771	4803	31771	4757	0.0	6.678789152827412
chr20	SPAG4	35618086	35618130	0	45	5508	2311	5508	2266	0.0	2.4307149161518096
chr20	SPAG4	35618611	35618720	0	110	5508	2311	5508	2201	0.0	2.502498864152658
chr20	PHF20	35858301	35858381	60769	81	84485	8400	23716	8319	750.2345679012345	2.8508234162759947
chr20	PHF20	35863012	35863400	1430	389	84485	8400	83055	8011	3.6760925449871467	10.36761952315566
chr20	PHF20	35870954	35871134	0	181	84485	8400	84485	8219	0.0	10.279231050006084
chr20	PHF20	35782327	35782609	0	283	84485	8400	84485	8117	0.0	10.408402119009486
chr20	PHF20	35845384	35845508	0	125	84485	8400	84485	8275	0.0	10.209667673716012
chr20	PHF20	35800093	35800173	0	81	84485	8400	84485	8319	0.0	10.155667748527467
chr20	CNBD2	35983981	35984138	0	158	21342	5019	21342	4861	0.0	4.390454638963177
chr20	CNBD2	35987394	35987533	0	140	21342	5019	21342	4879	0.0	4.3742570198811235
chr20	CNBD2	36023601	36023771	0	171	21342	5019	21342	4848	0.0	4.4022277227722775
chr20	CNBD2	36023613	36023771	0	159	21342	5019	21342	4860	0.0	4.391358024691358
chr20	AL035420.1	36071897	36071988	0	92	0	2043	0	1951	0.0	0.0
chr20	AL035420.1	36081877	36081970	0	94	0	2043	0	1949	0.0	0.0
chr20	AL035420.1	36072677	36072810	0	134	0	2043	0	1909	0.0	0.0
chr20	AL035420.1	36070485	36070808	0	324	0	2043	0	1719	0.0	0.0
chr20	EPB41L1	36177951	36178056	0	106	574	9712	574	9606	0.0	0.059754320216531334
chr20	EPB41L1	36209487	36209898	0	412	574	9712	574	9300	0.0	0.06172043010752688
chr20	EPB41L1	36173763	36173954	0	192	574	9712	574	9520	0.0	0.060294117647058824
chr20	EPB41L1	36121659	36121816	84	158	574	9712	490	9554	0.5316455696202531	0.0512874188821436
chr20	EPB41L1	36214356	36214440	0	85	574	9712	574	9627	0.0	0.059623974239119144
chr20	EPB41L1	36218875	36218962	0	88	574	9712	574	9624	0.0	0.05964256026600166
chr20	EPB41L1	36113692	36113799	0	108	574	9712	574	9604	0.0	0.0597667638483965
chr20	EPB41L1	36195328	36195364	0	37	574	9712	574	9675	0.0	0.059328165374677
chr20	EPB41L1	36214359	36214440	0	82	574	9712	574	9630	0.0	0.05960539979231568
chr20	EPB41L1	36112425	36112480	0	56	574	9712	574	9656	0.0	0.05944490472245236
chr20	EPB41L1	36125422	36125527	247	106	574	9712	327	9606	2.330188679245283	0.034041224234853215
chr20	EPB41L1	36208300	36208408	0	109	574	9712	574	9603	0.0	0.05977298760803915
chr20	DLGAP4	36499241	36499321	1579	81	47078	7378	45499	7297	19.493827160493826	6.235302178977662
chr20	DLGAP4	36499587	36499676	867	90	47078	7378	46211	7288	9.633333333333333	6.34069703622393
chr20	DLGAP4	36465264	36465367	0	104	47078	7378	47078	7274	0.0	6.4720923838328295
chr20	DLGAP4	36493057	36493185	714	129	47078	7378	46364	7249	5.534883720930233	6.395916678162505
chr20	MYL9	36548031	36548193	0	163	1317	2812	1317	2649	0.0	0.4971687429218573
chr20	TGIF2	36576214	36576403	0	190	1259	3979	1259	3789	0.0	0.3322776458168382
chr20	RAB5IF	36609600	36609730	0	131	8007	1286	8007	1155	0.0	6.932467532467532
chr20	TGIF2	36590909	36591009	0	101	1259	3979	1259	3878	0.0	0.32465188241361526
chr20	RAB5IF	36607889	36608000	90	112	8007	1286	7917	1174	0.8035714285714286	6.743611584327087
chr20	RAB5IF	36609600	36609758	0	159	8007	1286	8007	1127	0.0	7.104702750665483
chr20	TLDC2	36889250	36889403	0	154	51	2560	51	2406	0.0	0.02119700748129676
chr20	RPN2	37199049	37199225	1785	177	29828	2720	28043	2543	10.084745762711865	11.027526543452614
chr20	RPN2	37232295	37232391	0	97	29828	2720	29828	2623	0.0	11.371711780404118
chr20	RPN2	37238401	37238449	0	49	29828	2720	29828	2671	0.0	11.16735305129165
chr20	RPN2	37198396	37198492	812	97	29828	2720	29016	2623	8.371134020618557	11.062142584826535
chr20	RPN2	37200446	37200494	344	49	29828	2720	29484	2671	7.020408163265306	11.038562336203668
chr20	RPN2	37236579	37236709	0	131	29828	2720	29828	2589	0.0	11.521050598686752
chr20	MANBAL	37302279	37302323	0	45	0	2051	0	2006	0.0	0.0
chr20	SRC	37386459	37386477	0	19	75034	6499	75034	6480	0.0	11.57932098765432
chr20	NNAT	37522357	37522384	0	28	0	1332	0	1304	0.0	0.0
chr20	NNAT	37522357	37522438	0	82	0	1332	0	1250	0.0	0.0
chr20	NNAT	37522357	37522433	0	77	0	1332	0	1255	0.0	0.0
chr20	CTNNBL1	37727301	37727402	0	102	0	4173	0	4071	0.0	0.0
chr20	CTNNBL1	37694926	37695033	0	108	0	4173	0	4065	0.0	0.0
chr20	VSTM2L	37933538	37933589	0	52	0	1956	0	1904	0.0	0.0
chr20	VSTM2L	37931634	37931804	0	171	0	1956	0	1785	0.0	0.0
chr20	RPRD1B	38040434	38040564	0	131	0	5344	0	5213	0.0	0.0
chr20	RPRD1B	38048347	38048481	0	135	0	5344	0	5209	0.0	0.0
chr20	SNHG11	38447929	38448093	0	165	0	4261	0	4096	0.0	0.0
chr20	RALGAPB	38534384	38534393	0	10	102	11777	102	11767	0.0	0.008668309679612475
chr20	PPP1R16B	38905968	38906094	0	127	58	6421	58	6294	0.0	0.009215125516364792
chr20	DHX35	38972558	38972651	0	94	44	5021	44	4927	0.0	0.008930383600568297
chr20	DHX35	39023689	39023767	0	79	44	5021	44	4942	0.0	0.008903278025091057
chr20	DHX35	39030703	39030775	0	73	44	5021	44	4948	0.0	0.00889248181083266
chr20	DHX35	39010511	39010579	44	69	44	5021	0	4952	0.6376811594202898	0.0
chr20	LINC01370	40006934	40007046	0	113	0	4191	0	4078	0.0	0.0
chr20	LINC01370	40008340	40008459	0	120	0	4191	0	4071	0.0	0.0
chr20	PLCG1	41172192	41172289	0	98	102	9334	102	9236	0.0	0.01104374187960156
chr20	PLCG1	41174123	41174311	0	189	102	9334	102	9145	0.0	0.011153635866593768
chr20	PLCG1	41180503	41180664	0	162	102	9334	102	9172	0.0	0.011120802442215439
chr20	PLCG1	41174466	41174539	0	74	102	9334	102	9260	0.0	0.011015118790496761
chr20	PLCG1	41185573	41185775	0	203	102	9334	102	9131	0.0	0.011170737049611214
chr20	LPIN3	41354644	41354737	0	94	0	4686	0	4592	0.0	0.0
chr20	AL021395.1	43194976	43195054	35	79	749	2448	714	2369	0.4430379746835443	0.30139299282397636
chr20	AL021395.1	43198848	43198957	0	110	749	2448	749	2338	0.0	0.3203592814371258
chr20	SRSF6	43460702	43460852	0	151	0	2895	0	2744	0.0	0.0
chr20	SRSF6	43459152	43459420	0	269	0	2895	0	2626	0.0	0.0
chr20	L3MBTL1	43515291	43515415	560	125	2544979	12176	2544419	12051	4.48	211.13758194340718
chr20	L3MBTL1	43530797	43530889	2557	93	2544979	12176	2542422	12083	27.49462365591398	210.41314243151535
chr20	L3MBTL1	43532772	43532924	752	153	2544979	12176	2544227	12023	4.915032679738562	211.61332446144888
chr20	L3MBTL1	43513475	43513639	0	165	2544979	12176	2544979	12011	0.0	211.8873532595121
chr20	L3MBTL1	43518606	43518703	0	98	2544979	12176	2544979	12078	0.0	210.71195562179167
chr20	L3MBTL1	43513558	43513639	0	82	2544979	12176	2544979	12094	0.0	210.433190011576
chr20	L3MBTL1	43540752	43540815	602	64	2544979	12176	2544377	12112	9.40625	210.07075627476883
chr20	SGK2	43565041	43565286	3155	246	427746	4836	424591	4590	12.825203252032521	92.50348583877995
chr20	SGK2	43583182	43583374	273	193	427746	4836	427473	4643	1.4145077720207253	92.06827482231316
chr20	IFT52	43642478	43642624	0	147	6883	2501	6883	2354	0.0	2.9239592183517416
chr20	MYBL2	43681783	43681855	145	73	59805	2790	59660	2717	1.9863013698630136	21.958041958041957
chr20	TOX2	44064776	44064857	0	82	795048	3248	795048	3166	0.0	251.12065698041692
chr20	TOX2	43955147	43955272	165388	126	795048	3248	629660	3122	1312.6031746031747	201.68481742472773
chr20	TOX2	44065711	44066107	204	397	795048	3248	794844	2851	0.5138539042821159	278.79480883900385
chr20	OSER1-DT	44217366	44217682	0	317	102	9245	102	8928	0.0	0.0114247311827957
chr20	OSER1-DT	44214887	44215003	0	117	102	9245	102	9128	0.0	0.011174408413672217
chr20	OSER1-DT	44223718	44223872	0	155	102	9245	102	9090	0.0	0.011221122112211221
chr20	GDAP1L1	44258433	44258607	0	175	0	2968	0	2793	0.0	0.0
chr20	GDAP1L1	44258376	44258607	0	232	0	2968	0	2736	0.0	0.0
chr20	HNF4A	44390457	44390679	0	223	546118	7355	546118	7132	0.0	76.57291082445317
chr20	HNF4A	44402553	44402644	0	92	546118	7355	546118	7263	0.0	75.19179402450779
chr20	TTPAL	44478623	44478647	0	25	66377	7062	66377	7037	0.0	9.432570697740514
chr20	PKIG	44585099	44585204	921	106	5176	2475	4255	2369	8.68867924528302	1.796116504854369
chr20	PKIG	44582584	44582731	2721	148	5176	2475	2455	2327	18.385135135135137	1.0550064460678985
chr20	PKIG	44598615	44598890	0	276	5176	2475	5176	2199	0.0	2.3537971805366076
chr20	CCN5	44724737	44724992	0	256	363114	4985	363114	4729	0.0	76.7845210403891
chr20	YWHAB	44903035	44903121	0	87	0	5857	0	5770	0.0	0.0
chr20	YWHAB	44887647	44887742	0	96	0	5857	0	5761	0.0	0.0
chr20	YWHAB	44887544	44887742	0	199	0	5857	0	5658	0.0	0.0
chr20	YWHAB	44886878	44886978	0	101	0	5857	0	5756	0.0	0.0
chr20	YWHAB	44902897	44903121	0	225	0	5857	0	5632	0.0	0.0
chr20	PABPC1L	44916755	44916871	0	117	0	3854	0	3737	0.0	0.0
chr20	PABPC1L	44932341	44932432	0	92	0	3854	0	3762	0.0	0.0
chr20	PABPC1L	44938673	44938748	0	76	0	3854	0	3778	0.0	0.0
chr20	PABPC1L	44933071	44933185	0	115	0	3854	0	3739	0.0	0.0
chr20	PABPC1L	44934500	44934563	0	64	0	3854	0	3790	0.0	0.0
chr20	PABPC1L	44933056	44933185	0	130	0	3854	0	3724	0.0	0.0
chr20	PABPC1L	44931832	44932026	0	195	0	3854	0	3659	0.0	0.0
chr20	PABPC1L	44936893	44936976	0	84	0	3854	0	3770	0.0	0.0
chr20	PABPC1L	44938060	44938191	0	132	0	3854	0	3722	0.0	0.0
chr20	STK4	44987131	44987296	60838	166	156873	9018	96035	8852	366.49397590361446	10.848960686850429
chr20	STK4	45053085	45053180	0	96	156873	9018	156873	8922	0.0	17.5827168796234
chr20	SYS1	45363528	45363693	1060	166	3382	6006	2322	5840	6.385542168674699	0.3976027397260274
chr20	SYS1	45363543	45363693	803	151	3382	6006	2579	5855	5.317880794701987	0.4404782237403928
chr20	SYS1-DBNDD2	45399689	45399751	0	63	2091	1409	2091	1346	0.0	1.5534918276374443
chr20	PIGT	45419294	45419395	0	102	51	11655	51	11553	0.0	0.004414437808361465
chr20	PIGT	45421382	45421583	0	202	51	11655	51	11453	0.0	0.004452981751506156
chr20	PIGT	45424495	45424579	0	85	51	11655	51	11570	0.0	0.004407951598962835
chr20	PIGT	45416516	45416694	0	179	51	11655	51	11476	0.0	0.004444057162774486
chr20	PIGT	45416516	45416654	0	139	51	11655	51	11516	0.0	0.004428621048975338
chr20	PIGT	45418851	45418979	0	129	51	11655	51	11526	0.0	0.004424778761061947
chr20	PIGT	45421382	45421533	0	152	51	11655	51	11503	0.0	0.004433626010605929
chr20	PIGT	45418771	45418979	0	209	51	11655	51	11446	0.0	0.004455705049799056
chr20	PIGT	45447634	45447816	0	183	51	11655	51	11472	0.0	0.00444560669456067
chr20	PIGT	45416516	45416664	0	149	51	11655	51	11506	0.0	0.004432470015644012
chr20	PIGT	45419277	45419395	0	119	51	11655	51	11536	0.0	0.004420943134535367
chr20	PIGT	45419142	45419395	0	254	51	11655	51	11401	0.0	0.004473291816507324
chr20	PIGT	45418771	45419395	0	625	51	11655	51	11030	0.0	0.004623753399818676
chr20	PIGT	45421382	45421664	0	283	51	11655	51	11372	0.0	0.004484699261343651
chr20	PIGT	45424460	45424579	0	120	51	11655	51	11535	0.0	0.004421326397919376
chr20	WFDC2	45470388	45470532	0	145	0	1137	0	992	0.0	0.0
chr20	WFDC2	45471152	45471281	0	130	0	1137	0	1007	0.0	0.0
chr20	DNTTIP1	45795344	45795443	0	100	0	1880	0	1780	0.0	0.0
chr20	DNTTIP1	45809113	45809185	0	73	0	1880	0	1807	0.0	0.0
chr20	UBE2C	45814383	45814470	0	88	0	1293	0	1205	0.0	0.0
chr20	UBE2C	45815389	45815540	0	152	0	1293	0	1141	0.0	0.0
chr20	UBE2C	45815540	45815745	0	206	0	1293	0	1087	0.0	0.0
chr20	UBE2C	45815442	45815745	0	304	0	1293	0	989	0.0	0.0
chr20	SNX21	45840447	45840458	172	12	68032	3701	67860	3689	14.333333333333334	18.395229059365683
chr20	CTSA	45892272	45892323	286	52	25021	7771	24735	7719	5.5	3.204430625728721
chr20	CTSA	45894649	45894741	12	93	25021	7771	25009	7678	0.12903225806451613	3.257228444907528
chr20	CTSA	45897716	45897806	0	91	25021	7771	25021	7680	0.0	3.257942708333333
chr20	CTSA	45893219	45893311	0	93	25021	7771	25021	7678	0.0	3.258791351914561
chr20	CTSA	45891915	45892027	0	113	25021	7771	25021	7658	0.0	3.2673021676677982
chr20	CTSA	45892978	45893145	66	168	25021	7771	24955	7603	0.39285714285714285	3.282257003814284
chr20	CTSA	45893039	45893145	0	107	25021	7771	25021	7664	0.0	3.264744258872651
chr20	CTSA	45897725	45897806	0	82	25021	7771	25021	7689	0.0	3.254129275588503
chr20	CTSA	45896964	45897040	51	77	25021	7771	24970	7694	0.6623376623376623	3.2453860150766833
chr20	SLC12A5	46037254	46037385	0	132	99	8372	99	8240	0.0	0.012014563106796116
chr20	SLC12A5	46022842	46023071	0	230	99	8372	99	8142	0.0	0.012159174649963155
chr20	SLC12A5	46022929	46023071	0	143	99	8372	99	8229	0.0	0.012030623405030989
chr20	SLC12A5	46038223	46038330	0	108	99	8372	99	8264	0.0	0.011979670861568249
chr20	CD40	46123125	46123219	0	95	3417	2531	3417	2436	0.0	1.4027093596059113
chr20	CD40	46126639	46126701	0	63	3417	2531	3417	2468	0.0	1.3845218800648298
chr20	EYA2	47143058	47143148	0	91	102	3638	102	3547	0.0	0.028756695799266985
chr20	LINC00494	48360605	48360975	0	371	0	5148	0	4777	0.0	0.0
chr20	LINC00494	48360605	48360883	0	279	0	5148	0	4869	0.0	0.0
chr20	LINC00494	48365872	48366007	0	136	0	5148	0	5012	0.0	0.0
chr20	LINC00494	48366735	48367059	0	325	0	5148	0	4823	0.0	0.0
chr20	CSE1L	49072285	49072453	0	169	0	3652	0	3483	0.0	0.0
chr20	DDX27	49231022	49231115	0	94	80	4140	80	4046	0.0	0.019772614928324272
chr20	ZFAS1	49280484	49280570	0	87	459	7898	459	7811	0.0	0.058763282550249644
chr20	ZFAS1	49281751	49281818	0	68	459	7898	459	7830	0.0	0.05862068965517241
chr20	ZFAS1	49280902	49280964	0	63	459	7898	459	7835	0.0	0.058583280153158904
chr20	AL035685.1	49331379	49331455	0	77	534	3966	534	3889	0.0	0.13731036256106968
chr20	RNF114	49949247	49949355	0	109	0	4344	0	4235	0.0	0.0
chr20	RNF114	49941582	49941711	0	130	0	4344	0	4214	0.0	0.0
chr20	RNF114	49941560	49941711	0	152	0	4344	0	4192	0.0	0.0
chr20	RNF114	49941106	49941220	0	115	0	4344	0	4229	0.0	0.0
chr20	LINC01273	50173201	50173318	0	118	51	1682	51	1564	0.0	0.03260869565217391
chr20	PELATON	50276056	50276390	0	335	561	7207	561	6872	0.0	0.08163562281722933
chr20	PELATON	50275645	50275735	0	91	561	7207	561	7116	0.0	0.07883642495784149
chr20	PELATON	50275650	50275735	0	86	561	7207	561	7121	0.0	0.07878107007442775
chr20	LINC01270	50298155	50298413	0	259	2462	5084	2462	4825	0.0	0.5102590673575129
chr20	LINC01270	50311613	50311706	0	94	2462	5084	2462	4990	0.0	0.4933867735470942
chr20	LINC01270	50313068	50313299	0	232	2462	5084	2462	4852	0.0	0.5074196207749382
chr20	LINC01270	50293242	50293728	0	487	2462	5084	2462	4597	0.0	0.5355666739177725
chr20	PTPN1	50561362	50561453	0	92	522	4051	522	3959	0.0	0.13185147764587016
chr20	BCAS4	50875996	50876093	0	98	0	7591	0	7493	0.0	0.0
chr20	BCAS4	50841765	50841900	0	136	0	7591	0	7455	0.0	0.0
chr20	BCAS4	50840536	50840930	0	395	0	7591	0	7196	0.0	0.0
chr20	ADNP-AS1	50933723	50933827	0	105	0	1053	0	948	0.0	0.0
chr20	ADNP-AS1	50933719	50933827	0	109	0	1053	0	944	0.0	0.0
chr20	LINC01524	52234768	52234932	0	165	63358	14925	63358	14760	0.0	4.292547425474255
chr20	LINC01524	52304954	52304991	0	38	63358	14925	63358	14887	0.0	4.255927990864513
chr20	LINC01524	52325461	52325632	0	172	63358	14925	63358	14753	0.0	4.294584152375788
chr20	LINC01524	52281833	52281964	16	132	63358	14925	63342	14793	0.12121212121212122	4.2818900831474345
chr20	LINC01524	52416125	52416218	0	94	63358	14925	63358	14831	0.0	4.271997842357225
chr20	LINC01524	52340489	52340652	0	164	63358	14925	63358	14761	0.0	4.292256622180069
chr20	LINC01524	52442499	52442638	0	140	63358	14925	63358	14785	0.0	4.285289144403111
chr20	LINC01524	52438858	52438993	0	136	63358	14925	63358	14789	0.0	4.284130096693488
chr20	LINC01524	52215466	52215558	0	93	63358	14925	63358	14832	0.0	4.271709816612729
chr20	LINC01524	52355321	52355359	0	39	63358	14925	63358	14886	0.0	4.256213892247749
chr20	LINC01524	52538751	52539061	0	311	63358	14925	63358	14614	0.0	4.335431777747366
chr20	LINC01524	52666718	52666777	0	60	63358	14925	63358	14865	0.0	4.262226707029936
chr20	LINC01524	52285096	52285170	51	75	63358	14925	63307	14850	0.68	4.263097643097643
chr20	LINC01524	52324714	52324759	184	46	63358	14925	63174	14879	4.0	4.245849855501041
chr20	LINC01524	52646489	52646806	0	318	63358	14925	63358	14607	0.0	4.337509413294995
chr20	LINC01524	52646979	52647720	0	742	63358	14925	63358	14183	0.0	4.467179017133188
chr20	AL031674.1	52675209	52675310	0	102	0	3306	0	3204	0.0	0.0
chr20	AL031674.1	52677019	52677108	0	90	0	3306	0	3216	0.0	0.0
chr20	AL031674.1	52681404	52681550	0	147	0	3306	0	3159	0.0	0.0
chr20	AL031674.1	52685074	52685213	0	140	0	3306	0	3166	0.0	0.0
chr20	AL031674.1	52687948	52688165	0	218	0	3306	0	3088	0.0	0.0
chr20	AL031674.1	52690521	52690614	0	94	0	3306	0	3212	0.0	0.0
chr20	AL031674.1	52687951	52688165	0	215	0	3306	0	3091	0.0	0.0
chr20	LINC01440	55411929	55411983	0	55	0	5095	0	5040	0.0	0.0
chr20	LINC01440	55438128	55438303	0	176	0	5095	0	4919	0.0	0.0
chr20	LINC01440	55448864	55448969	0	106	0	5095	0	4989	0.0	0.0
chr20	AL109828.1	55779379	55779515	0	137	2340	1444	2340	1307	0.0	1.7903596021423107
chr20	CASS4	56451818	56453129	0	1312	0	5076	0	3764	0.0	0.0
chr20	RTF2	56472325	56472415	0	91	0	4074	0	3983	0.0	0.0
chr20	RTF2	56516934	56516989	0	56	0	4074	0	4018	0.0	0.0
chr20	SPO11	57331832	57331946	0	115	0	1837	0	1722	0.0	0.0
chr20	SPO11	57337738	57337771	0	34	0	1837	0	1803	0.0	0.0
chr20	RAE1	57373474	57373581	0	108	0	3313	0	3205	0.0	0.0
chr20	RAE1	57351890	57351998	0	109	0	3313	0	3204	0.0	0.0
chr20	RBM38	57393278	57393333	0	56	0	2646	0	2590	0.0	0.0
chr20	RBM38	57399927	57399968	0	42	0	2646	0	2604	0.0	0.0
chr20	VAPB	58434601	58434705	0	105	7656	10486	7656	10381	0.0	0.7375012041229169
chr20	VAPB	58440906	58441083	47	178	7656	10486	7609	10308	0.2640449438202247	0.7381645324020178
chr20	VAPB	58438944	58439025	11	82	7656	10486	7645	10404	0.13414634146341464	0.7348135332564398
chr20	APCDD1L-DT	58521389	58521551	12199	163	40303	5587	28104	5424	74.84049079754601	5.18141592920354
chr20	APCDD1L-DT	58519503	58519625	5151	123	40303	5587	35152	5464	41.8780487804878	6.4333821376281115
chr20	APCDD1L-DT	58519503	58519599	5059	97	40303	5587	35244	5490	52.154639175257735	6.419672131147541
chr20	APCDD1L-DT	58547811	58547928	0	118	40303	5587	40303	5469	0.0	7.369354543792284
chr20	STX16	58669290	58669453	0	164	0	5049	0	4885	0.0	0.0
chr20	STX16	58671153	58671297	0	145	0	5049	0	4904	0.0	0.0
chr20	STX16	58659622	58659634	0	13	0	5049	0	5036	0.0	0.0
chr20	STX16	58667200	58667318	0	119	0	5049	0	4930	0.0	0.0
chr20	NPEPL1	58705497	58705569	0	73	0	5961	0	5888	0.0	0.0
chr20	STX16	58671163	58671297	0	135	0	5049	0	4914	0.0	0.0
chr20	STX16	58669301	58669453	0	153	0	5049	0	4896	0.0	0.0
chr20	GNAS	58898940	58898985	0	46	26	12313	26	12267	0.0	0.002119507622075487
chr20	GNAS	58840849	58840886	0	38	26	12313	26	12275	0.0	0.0021181262729124237
chr20	GNAS	58899948	58900030	26	83	26	12313	0	12230	0.3132530120481928	0.0
chr20	GNAS	58891581	58891865	0	285	26	12313	26	12028	0.0	0.002161622879946791
chr20	GNAS	58889525	58889549	0	25	26	12313	26	12288	0.0	0.0021158854166666665
chr20	EDN3	59322371	59322452	0	82	0	3293	0	3211	0.0	0.0
chr20	EDN3	59322371	59322417	0	47	0	3293	0	3246	0.0	0.0
chr20	EDN3	59323665	59323723	0	59	0	3293	0	3234	0.0	0.0
chr20	EDN3	59322371	59322482	0	112	0	3293	0	3181	0.0	0.0
chr20	PHACTR3	59767185	59767395	0	211	0	6122	0	5911	0.0	0.0
chr20	CDH26	60001342	60001411	0	70	0	5774	0	5704	0.0	0.0
chr20	CDH26	60002812	60002866	0	55	0	5774	0	5719	0.0	0.0
chr20	C20ORF197	60058906	60058986	0	81	125	3400	125	3319	0.0	0.03766194636938837
chr20	MIR646HG	60284476	60284593	0	118	1329	22150	1329	22032	0.0	0.06032135076252723
chr20	MIR646HG	60088596	60088721	0	126	1329	22150	1329	22024	0.0	0.06034326189611333
chr20	MIR646HG	60138493	60138644	0	152	1329	22150	1329	21998	0.0	0.060414583143922174
chr20	MIR646HG	60272066	60272240	0	175	1329	22150	1329	21975	0.0	0.0604778156996587
chr20	MIR646HG	60098928	60098963	0	36	1329	22150	1329	22114	0.0	0.06009767568056435
chr20	MIR646HG	60098928	60099032	0	105	1329	22150	1329	22045	0.0	0.06028577908822862
chr20	MIR646HG	60117743	60117807	0	65	1329	22150	1329	22085	0.0	0.060176590446004076
chr20	MIR646HG	60123779	60123860	0	82	1329	22150	1329	22068	0.0	0.06022294725394236
chr20	MIR646HG	60091977	60092062	0	86	1329	22150	1329	22064	0.0	0.060233865119651925
chr20	MIR646HG	60101690	60101798	0	109	1329	22150	1329	22041	0.0	0.060296719749557644
chr20	MIR646HG	60123491	60123606	0	116	1329	22150	1329	22034	0.0	0.06031587546519016
chr20	MIR646HG	60253358	60253498	0	141	1329	22150	1329	22009	0.0	0.0603843882048253
chr20	MIR646HG	60098928	60099069	0	142	1329	22150	1329	22008	0.0	0.06038713195201745
chr20	MIR646HG	60096534	60097521	0	988	1329	22150	1329	21162	0.0	0.06280124751913808
chr20	MIR646HG	60100170	60100219	0	50	1329	22150	1329	22100	0.0	0.06013574660633484
chr20	MIR646HG	60280982	60281124	0	143	1329	22150	1329	22007	0.0	0.06038987594856182
chr20	MIR646HG	60117357	60117507	0	151	1329	22150	1329	21999	0.0	0.06041183690167735
chr20	MIR646HG	60096534	60097664	0	1131	1329	22150	1329	21019	0.0	0.06322850754079642
chr20	MIR646HG	60117361	60117507	0	147	1329	22150	1329	22003	0.0	0.06040085442894151
chr20	MIR646HG	60121027	60121121	0	95	1329	22150	1329	22055	0.0	0.06025844479709817
chr20	MIR646HG	60098665	60098726	0	62	1329	22150	1329	22088	0.0	0.06016841724013039
chr20	MIR646HG	60138271	60138644	0	374	1329	22150	1329	21776	0.0	0.061030492285084496
chr20	MIR646HG	60527386	60527458	0	73	1329	22150	1329	22077	0.0	0.060198396521266476
chr20	MIR646HG	60320632	60320858	0	227	1329	22150	1329	21923	0.0	0.060621265337773116
chr20	MIR646HG	60246792	60246927	0	136	1329	22150	1329	22014	0.0	0.060370673207958574
chr20	MIR646HG	60318920	60319007	0	88	1329	22150	1329	22062	0.0	0.060239325537122655
chr20	MIR646HG	60246037	60246129	0	93	1329	22150	1329	22057	0.0	0.06025298091308882
chr20	MIR646HG	60313309	60313387	0	79	1329	22150	1329	22071	0.0	0.06021476145167867
chr20	MIR646HG	60247554	60247689	0	136	1329	22150	1329	22014	0.0	0.060370673207958574
chr20	LSM14B	62130218	62130296	0	79	18930	3388	18930	3309	0.0	5.7207615593835
chr20	LSM14B	62127584	62127701	0	118	18930	3388	18930	3270	0.0	5.7889908256880735
chr20	SS18L1	62154280	62154465	1132	186	2118	4351	986	4165	6.086021505376344	0.23673469387755103
chr20	MTG2	62197851	62197967	51	117	131005	5139	130954	5022	0.4358974358974359	26.076065312624454
chr20	MTG2	62198633	62198852	26670	220	131005	5139	104335	4919	121.22727272727273	21.210611912990444
chr20	MTG2	62188789	62188805	0	17	131005	5139	131005	5122	0.0	25.576923076923077
chr20	OSBPL2	62259980	62260125	3898	146	126363	10826	122465	10680	26.698630136986303	11.466760299625468
chr20	OSBPL2	62256056	62256221	306	166	126363	10826	126057	10660	1.8433734939759037	11.825234521575984
chr20	OSBPL2	62286336	62286488	1265	153	126363	10826	125098	10673	8.267973856209151	11.72097816921203
chr20	OSBPL2	62289206	62289330	51	125	126363	10826	126312	10701	0.408	11.803756658256237
chr20	OSBPL2	62242320	62242661	765	342	126363	10826	125598	10484	2.236842105263158	11.979969477298742
chr20	OSBPL2	62260016	62260125	2430	110	126363	10826	123933	10716	22.09090909090909	11.565229563269877
chr20	OSBPL2	62264628	62264718	0	91	126363	10826	126363	10735	0.0	11.771122496506754
chr20	OSBPL2	62280008	62280122	0	115	126363	10826	126363	10711	0.0	11.797497899355802
chr20	OSBPL2	62285535	62286217	18044	683	126363	10826	108319	10143	26.41874084919473	10.679187617075815
chr20	OSBPL2	62271633	62271731	11762	99	126363	10826	114601	10727	118.8080808080808	10.683415680059662
chr20	OSBPL2	62242320	62242434	0	115	126363	10826	126363	10711	0.0	11.797497899355802
chr20	OSBPL2	62291244	62291344	0	101	126363	10826	126363	10725	0.0	11.782097902097902
chr20	ADRM1	62304460	62304577	0	118	6427	2153	6427	2035	0.0	3.1582309582309582
chr20	LAMA5-AS1	62355267	62355480	0	214	1621	846	1621	632	0.0	2.564873417721519
chr20	MIR1-1HG	62564988	62565100	37030	113	42330	1224	5300	1111	327.6991150442478	4.77047704770477
chr20	SLCO4A1	62668011	62668184	0	174	6155	3905	6155	3731	0.0	1.649691771642991
chr20	SLCO4A1	62668157	62668184	0	28	6155	3905	6155	3877	0.0	1.5875677069899408
chr20	SLCO4A1	62668154	62668184	0	31	6155	3905	6155	3874	0.0	1.588797108931337
chr20	COL9A3	62836477	62836532	0	56	63	4195	63	4139	0.0	0.015221067890794878
chr20	SLC17A9	62953210	62953272	0	63	39	5474	39	5411	0.0	0.0072075401958972465
chr20	ARFGAP1	63276090	63276200	0	111	0	6173	0	6062	0.0	0.0
chr20	ARFGAP1	63277204	63277305	0	102	0	6173	0	6071	0.0	0.0
chr20	ARFGAP1	63283850	63283880	0	31	0	6173	0	6142	0.0	0.0
chr20	ARFGAP1	63273999	63274210	0	212	0	6173	0	5961	0.0	0.0
chr20	ARFGAP1	63285979	63286218	0	240	0	6173	0	5933	0.0	0.0
chr20	ARFGAP1	63279219	63279306	0	88	0	6173	0	6085	0.0	0.0
chr20	COL20A1	63322057	63322111	0	55	0	9868	0	9813	0.0	0.0
chr20	COL20A1	63325268	63325364	0	97	0	9868	0	9771	0.0	0.0
chr20	PPDPF	63521283	63521363	0	81	0	1055	0	974	0.0	0.0
chr20	RTEL1	63689501	63689648	0	148	0	5965	0	5817	0.0	0.0
chr20	RTEL1	63690086	63690210	0	125	0	5965	0	5840	0.0	0.0
chr20	RTEL1	63660675	63660796	0	122	0	5965	0	5843	0.0	0.0
chr20	RTEL1	63659232	63659504	0	273	0	5965	0	5692	0.0	0.0
chr20	LIME1	63738597	63738931	0	335	0	2442	0	2107	0.0	0.0
chr20	SLC2A4RG	63741868	63742056	0	189	0	2703	0	2514	0.0	0.0
chr20	TPD52L2	63875815	63875875	0	61	0	4020	0	3959	0.0	0.0
chr20	TPD52L2	63882718	63882820	0	103	0	4020	0	3917	0.0	0.0
chr20	TPD52L2	63889189	63889238	0	50	0	4020	0	3970	0.0	0.0
chr20	TPD52L2	63887563	63887605	0	43	0	4020	0	3977	0.0	0.0
chr20	TPD52L2	63886015	63886042	0	28	0	4020	0	3992	0.0	0.0
chr20	DNAJC5	63931108	63931182	0	75	0	5349	0	5274	0.0	0.0
chr20	C20ORF204	64038295	64038448	0	154	0	5445	0	5291	0.0	0.0
chr20	TCEA2	64063891	64063949	0	59	0	3909	0	3850	0.0	0.0
chr20	OPRL1	64091965	64092116	0	152	0	3647	0	3495	0.0	0.0
chr20	MYT1	64151696	64151910	0	215	0	6891	0	6676	0.0	0.0
chr20	MYT1	64207593	64208487	0	895	0	6891	0	5996	0.0	0.0
chr20	MYT1	64223290	64223359	0	70	0	6891	0	6821	0.0	0.0
chr20	MYT1	64171103	64171281	0	179	0	6891	0	6712	0.0	0.0
chr20	MYT1	64195912	64196054	0	143	0	6891	0	6748	0.0	0.0
chr20	PCMTD2	64258766	64258882	0	117	0	5895	0	5778	0.0	0.0
chr20	LINC00266-1	64303150	64303358	0	209	0	1443	0	1234	0.0	0.0
chr20	C20ORF96	289558	289676	0	119	57785	1737	57785	1618	0.0	35.71384425216316
chr20	CSNK2A1	492253	492364	0	112	99299	19650	99299	19538	0.0	5.0823523390316305
chr20	CSNK2A1	495718	495802	0	85	99299	19650	99299	19565	0.0	5.075338614873498
chr20	CSNK2A1	499254	499305	0	52	99299	19650	99299	19598	0.0	5.066792529849985
chr20	CSNK2A1	499832	499934	612	103	99299	19650	98687	19547	5.941747572815534	5.0487031257993555
chr20	CSNK2A1	508450	508660	6505	211	99299	19650	92794	19439	30.829383886255926	4.7735994649930555
chr20	CSNK2A1	527932	528049	0	118	99299	19650	99299	19532	0.0	5.083913577718616
chr20	CSNK2A1	483927	484076	0	150	99299	19650	99299	19500	0.0	5.09225641025641
chr20	CSNK2A1	499524	499630	0	107	99299	19650	99299	19543	0.0	5.081052039093281
chr20	CSNK2A1	500030	500115	492	86	99299	19650	98807	19564	5.72093023255814	5.050449805765692
chr20	CSNK2A1	526695	526942	0	248	99299	19650	99299	19402	0.0	5.117977528089888
chr20	CSNK2A1	497720	497780	0	61	99299	19650	99299	19589	0.0	5.069120424728164
chr20	CSNK2A1	499524	499573	0	50	99299	19650	99299	19600	0.0	5.066275510204082
chr20	CSNK2A1	508450	508605	2279	156	99299	19650	97020	19494	14.60897435897436	4.976915974145891
chr20	CSNK2A1	540889	541099	0	211	99299	19650	99299	19439	0.0	5.108236020371418
chr20	CSNK2A1	540827	541099	0	273	99299	19650	99299	19377	0.0	5.1245806884450635
chr20	CSNK2A1	508450	508621	3240	172	99299	19650	96059	19478	18.837209302325583	4.931666495533422
chr20	CSNK2A1	510167	510338	0	172	99299	19650	99299	19478	0.0	5.098008009035835
chr20	SLC52A3	763497	764003	0	507	796	5203	796	4696	0.0	0.1695059625212947
chr20	SLC52A3	768296	768482	0	187	796	5203	796	5016	0.0	0.15869218500797447
chr20	RSPO4	963934	964120	0	187	0	2762	0	2575	0.0	0.0
chr20	FKBP1A	1375490	1375603	0	114	47778	4404	47778	4290	0.0	11.137062937062938
chr20	FKBP1A	1392833	1392881	1243	49	47778	4404	46535	4355	25.367346938775512	10.685419058553387
chr20	FKBP1A	1377429	1377511	0	83	47778	4404	47778	4321	0.0	11.057162693820874
chr20	FKBP1A	1371119	1371147	0	29	47778	4404	47778	4375	0.0	10.920685714285714
chr20	FKBP1A	1371021	1371147	0	127	47778	4404	47778	4277	0.0	11.170914192190788
chr20	NSFL1C	1454212	1454305	0	94	6880	6545	6880	6451	0.0	1.0665013176251743
chr20	NSFL1C	1464328	1464426	0	99	6880	6545	6880	6446	0.0	1.0673285758609992
chr20	NSFL1C	1455713	1455719	0	7	6880	6545	6880	6538	0.0	1.052309574793515
chr20	NSFL1C	1463334	1463441	0	108	6880	6545	6880	6437	0.0	1.0688208792915954
chr20	NSFL1C	1455713	1455870	0	158	6880	6545	6880	6387	0.0	1.0771880382025991
chr20	SIRPB2	1479699	1479794	0	96	0	4491	0	4395	0.0	0.0
chr20	SIRPB1	1603094	1603207	0	114	0	8242	0	8128	0.0	0.0
chr20	SIRPG	1635266	1635599	0	334	204	2251	204	1917	0.0	0.10641627543035993
chr20	SIRPG	1636187	1636505	0	319	204	2251	204	1932	0.0	0.10559006211180125
chr20	AL109809.4	1800530	1800663	0	134	1224	8563	1224	8429	0.0	0.14521295527346068
chr20	AL109809.4	1811114	1811224	0	111	1224	8563	1224	8452	0.0	0.14481779460482727
chr20	PDYN	1992583	1992643	0	61	0	3531	0	3470	0.0	0.0
chr20	SNRPB	2467191	2467315	804	125	29974	1286	29170	1161	6.432	25.12489233419466
chr20	ZNF343	2486640	2486763	0	124	102	4645	102	4521	0.0	0.0225613802256138
chr20	ZNF343	2495414	2495524	0	111	102	4645	102	4534	0.0	0.022496691662990738
chr20	IDH3B	2658637	2658837	0	201	510	2575	510	2374	0.0	0.21482729570345407
chr20	IDH3B	2658758	2658837	0	80	510	2575	510	2495	0.0	0.20440881763527055
chr20	PCED1A	2836038	2836314	0	277	32222	2329	32222	2052	0.0	15.702729044834308
chr20	UBOX5	3115304	3115466	51	163	4760	4744	4709	4581	0.3128834355828221	1.027941497489631
chr20	UBOX5	3156683	3156790	150	108	4760	4744	4610	4636	1.3888888888888888	0.9943917169974116
chr20	DDRGK1	3191189	3191238	2303	50	23510	1840	21207	1790	46.06	11.847486033519553
chr20	SLC4A11	3230731	3230845	4872	115	48628	4340	43756	4225	42.36521739130435	10.356449704142012
chr20	ADAM33	3671418	3671496	0	79	0	5402	0	5323	0.0	0.0
chr20	C20ORF27	3754396	3754519	0	124	1437	1361	1437	1237	0.0	1.1616814874696848
chr20	RNF24	3974331	3974400	0	70	6097	7652	6097	7582	0.0	0.8041413874967027
chr20	AL139350.1	4429577	4429684	0	108	0	1456	0	1348	0.0	0.0
chr20	TMEM230	5111056	5111174	0	119	744431	3050	744431	2931	0.0	253.98532923916753
chr20	TMEM230	5111763	5111808	0	46	744431	3050	744431	3004	0.0	247.81324900133157
chr20	TMEM230	5111499	5111605	51	107	744431	3050	744380	2943	0.4766355140186916	252.9323819232076
chr20	LINC00658	5433788	5434092	0	305	102	2892	102	2587	0.0	0.039427908774642445
chr20	LINC00658	5437099	5437273	102	175	102	2892	0	2717	0.5828571428571429	0.0
chr20	LINC00658	5433788	5434405	0	618	102	2892	102	2274	0.0	0.044854881266490766
chr20	LINC00658	5433788	5433962	0	175	102	2892	102	2717	0.0	0.03754140596245859
chr20	LINC00658	5433788	5434065	0	278	102	2892	102	2614	0.0	0.03902065799540933
chr20	LINC00658	5433788	5434070	0	283	102	2892	102	2609	0.0	0.039095438865465695
chr20	LINC00658	5438209	5438315	0	107	102	2892	102	2785	0.0	0.03662477558348295
chr20	LINC00658	5434114	5434401	0	288	102	2892	102	2604	0.0	0.03917050691244239
chr20	LINC00658	5434114	5434405	0	292	102	2892	102	2600	0.0	0.03923076923076923
chr20	LINC00658	5433962	5434092	0	131	102	2892	102	2761	0.0	0.03694313654473017
chr20	LINC00658	5433962	5434070	0	109	102	2892	102	2783	0.0	0.03665109593963349
chr20	LINC00658	5437099	5437266	102	168	102	2892	0	2724	0.6071428571428571	0.0
chr20	LINC00654	5508260	5508328	0	69	4077	8091	4077	8022	0.0	0.5082273747195213
chr20	LINC00654	5502902	5503083	0	182	4077	8091	4077	7909	0.0	0.5154886837779744
chr20	GPCPD1	5586193	5586269	0	77	24020	7494	24020	7417	0.0	3.23850613455575
chr20	GPCPD1	5567796	5567842	658	47	24020	7494	23362	7447	14.0	3.1371021888008594
chr20	TRMT6	5944804	5944914	72	111	60093	3690	60021	3579	0.6486486486486487	16.77032690695725
chr20	FERMT1	6110297	6110511	0	215	3857	4862	3857	4647	0.0	0.8299978480740262
chr20	AL080248.1	7256974	7257094	0	121	0	2270	0	2149	0.0	0.0
chr20	TMX4	8018792	8019039	0	248	31873	6567	31873	6319	0.0	5.043994302896028
chr20	PAK5	9784357	9784506	0	150	0	4995	0	4845	0.0	0.0
chr20	PAK5	9818679	9818785	0	107	0	4995	0	4888	0.0	0.0
chr20	SNAP25-AS1	10125181	10125291	0	111	11611	11293	11611	11182	0.0	1.0383652298336612
chr20	SNAP25-AS1	10198752	10198875	343	124	11611	11293	11268	11169	2.7661290322580645	1.008863819500403
chr20	SNAP25-AS1	10190056	10190152	0	97	11611	11293	11611	11196	0.0	1.037066809574848
chr20	SNAP25-AS1	10196817	10196937	51	121	11611	11293	11560	11172	0.4214876033057851	1.0347296813462228
chr20	SNAP25-AS1	10231483	10231619	0	137	11611	11293	11611	11156	0.0	1.0407852276801721
chr20	MKKS	10428729	10428816	0	88	184231	7048	184231	6960	0.0	26.469971264367818
chr20	AL050403.1	10884485	10884690	0	206	0	2937	0	2731	0.0	0.0
chr20	AL050403.1	10893964	10894020	0	57	0	2937	0	2880	0.0	0.0
chr20	AL050403.1	10907578	10907641	0	64	0	2937	0	2873	0.0	0.0
chr20	LINC00687	11849506	11849658	0	153	407	1995	407	1842	0.0	0.22095548317046687
chr20	LINC00687	11871985	11872193	102	209	407	1995	305	1786	0.4880382775119617	0.1707726763717805
chr20	TASP1	13623445	13623514	0	70	700	2914	700	2844	0.0	0.24613220815752462
chr20	SEL1L2	13859261	13859434	0	174	97	3912	97	3738	0.0	0.025949705724986623
chr20	SEL1L2	13865348	13865514	51	167	97	3912	46	3745	0.30538922155688625	0.012283044058744993
chr20	SEL1L2	13885346	13885403	0	58	97	3912	97	3854	0.0	0.025168655941878566
chr20	SEL1L2	13915120	13915241	0	122	97	3912	97	3790	0.0	0.02559366754617414
chr20	SEL1L2	13866701	13866850	0	150	97	3912	97	3762	0.0	0.025784157363104732
chr20	FLRT3	14329133	14329327	0	195	612	5194	612	4999	0.0	0.1224244848969794
chr20	MACROD2-AS1	14909648	14909737	0	90	0	1891	0	1801	0.0	0.0
chr20	MACROD2-AS1	14888095	14888304	0	210	0	1891	0	1681	0.0	0.0
chr20	AL161941.1	16256935	16257362	204	428	204	3469	0	3041	0.4766355140186916	0.0
chr20	AL161941.1	16181888	16182018	0	131	204	3469	204	3338	0.0	0.06111443978430198
chr20	KIF16B	16374256	16374409	0	154	2485	7763	2485	7609	0.0	0.3265869365225391
chr20	KIF16B	16382097	16382130	0	34	2485	7763	2485	7729	0.0	0.3215163669297451
chr20	BFSP1	17541064	17541199	106	136	2173	3386	2067	3250	0.7794117647058824	0.636
chr20	RRBP1	17679998	17680075	0	78	169991	5199	169991	5121	0.0	33.19488381175552
chr20	RRBP1	17658595	17660528	3264	1934	169991	5199	166727	3265	1.687693898655636	51.06493108728943
chr20	SNX5	17952586	17952710	5515	125	287252	6160	281737	6035	44.12	46.683844241922124
chr20	SNX5	17955364	17955475	12017	112	287252	6160	275235	6048	107.29464285714286	45.50843253968254
chr20	SNX5	17956932	17957037	0	106	287252	6160	287252	6054	0.0	47.44829864552362
chr20	SNX5	17968374	17968457	1035	84	287252	6160	286217	6076	12.321428571428571	47.106155365371954
chr20	AL049646.1	18345489	18345546	0	58	3162	3242	3162	3184	0.0	0.9930904522613065
chr20	DZANK1	18415326	18415449	0	124	55568	6644	55568	6520	0.0	8.522699386503067
chr20	DZANK1	18452614	18452682	0	69	55568	6644	55568	6575	0.0	8.451406844106463
chr20	DZANK1	18451853	18451962	1479	110	55568	6644	54089	6534	13.445454545454545	8.27808386899296
chr20	DZANK1	18394674	18394858	0	185	55568	6644	55568	6459	0.0	8.603189348196315
chr20	RBBP9	18490394	18490480	181	87	25863	3848	25682	3761	2.0804597701149423	6.828503057697421
chr20	RBBP9	18495837	18495880	0	44	25863	3848	25863	3804	0.0	6.798895899053628
chr20	LINC00652	18791741	18792133	0	393	51	4119	51	3726	0.0	0.013687600644122383
chr20	RALGAPA2	20396694	20396734	0	41	11618	11690	11618	11649	0.0	0.997338827367156
chr20	RALGAPA2	20598678	20598819	0	142	11618	11690	11618	11548	0.0	1.0060616556979562
chr20	KIZ-AS1	21213535	21213592	13	58	1933	2796	1920	2738	0.22413793103448276	0.7012417823228634
chr20	KIZ-AS1	21198728	21198804	0	77	1933	2796	1933	2719	0.0	0.710923133504965
chr20	LINC01427	22276420	22280540	255	4121	255	6326	0	2205	0.061878184906576074	0.0
chr20	LINC01427	22280338	22280540	0	203	255	6326	255	6123	0.0	0.04164625183733464
chr20	AL133464.1	22406628	22406712	0	85	0	5302	0	5217	0.0	0.0
chr20	AL133464.1	22406628	22406715	0	88	0	5302	0	5214	0.0	0.0
chr20	LINC00656	23128628	23128729	0	102	1342	1914	1342	1812	0.0	0.7406181015452539
chr20	NAPB	23397071	23397188	0	118	28413	4598	28413	4480	0.0	6.3421875
chr20	NAPB	23395138	23395185	0	48	28413	4598	28413	4550	0.0	6.2446153846153845
chr20	NAPB	23397071	23397200	0	130	28413	4598	28413	4468	0.0	6.3592211280214865
chr20	CST11	23451815	23451920	0	106	21	588	21	482	0.0	0.043568464730290454
chr20	APMAP	24964374	24964398	0	25	2692	2236	2692	2211	0.0	1.2175486205336952
chr20	VSX1	25077684	25077865	0	182	0	3605	0	3423	0.0	0.0
chr20	VSX1	25072535	25072643	0	109	0	3605	0	3496	0.0	0.0
chr20	ABHD12	25300698	25300884	32162	187	48666	4504	16504	4317	171.98930481283423	3.82302524901552
chr20	ABHD12	25302218	25302346	0	129	48666	4504	48666	4375	0.0	11.123657142857143
chr20	ABHD12	25303549	25303628	0	80	48666	4504	48666	4424	0.0	11.000452079566003
chr20	ABHD12	25306832	25306915	0	84	48666	4504	48666	4420	0.0	11.010407239819004
chr20	ABHD12	25309445	25309575	616	131	48666	4504	48050	4373	4.702290076335878	10.987880173793734
chr20	ABHD12	25314924	25314970	0	47	48666	4504	48666	4457	0.0	10.919003814224816
chr20	ABHD12	25301718	25302034	0	317	48666	4504	48666	4187	0.0	11.623119178409363
chr20	ABHD12	25302218	25302276	0	59	48666	4504	48666	4445	0.0	10.948481439820023
chr20	ABHD12	25301718	25301833	0	116	48666	4504	48666	4388	0.0	11.09070191431176
chr20	ABHD12	25301248	25301294	5	47	48666	4504	48661	4457	0.10638297872340426	10.917881983396903
chr20	ABHD12	25301331	25301378	70	48	48666	4504	48596	4456	1.4583333333333333	10.905745062836624
chr20	ABHD12	25341945	25342096	51	152	48666	4504	48615	4352	0.3355263157894737	11.170726102941176
chr20	ABHD12	25338884	25339004	0	121	48666	4504	48666	4383	0.0	11.103353867214237
chr20	NINL	25476042	25477089	3336	1048	38971	6054	35635	5006	3.183206106870229	7.118457850579305
chr20	NINL	25491350	25491525	2406	176	38971	6054	36565	5878	13.670454545454545	6.220653283429738
chr20	MIR663AHG	26192132	26192232	0	101	252	6568	252	6467	0.0	0.03896706355342508
chr20	MIR663AHG	26194297	26194444	0	148	252	6568	252	6420	0.0	0.03925233644859813
chr20	MIR663AHG	26191792	26191896	0	105	252	6568	252	6463	0.0	0.03899118056630048
chr20	MIR663AHG	26199448	26199523	0	76	252	6568	252	6492	0.0	0.038817005545286505
chr20	MIR663AHG	26200195	26200316	0	122	252	6568	252	6446	0.0	0.039094011790257524
chr20	MIR663AHG	26194385	26194444	0	60	252	6568	252	6508	0.0	0.03872157344806392
chr20	MIR663AHG	26192128	26192232	0	105	252	6568	252	6463	0.0	0.03899118056630048
chr20	MIR663AHG	26200195	26200312	0	118	252	6568	252	6450	0.0	0.03906976744186046
chr20	MIR663AHG	26189962	26190119	252	158	252	6568	0	6410	1.5949367088607596	0.0
chr20	FRG1CP	28601602	28601756	0	155	0	2742	0	2587	0.0	0.0
chr20	FRG1CP	28583869	28583946	0	78	0	2742	0	2664	0.0	0.0
chr20	FRG1CP	28601656	28601756	0	101	0	2742	0	2641	0.0	0.0
chr20	ANKRD20A21P	30720215	30720330	0	116	47020	3750	47020	3634	0.0	12.938910291689599
chr20	DEFB119	31378351	31378391	14	41	10708	789	10694	748	0.34146341463414637	14.296791443850267
chr20	BCL2L1	31666990	31667147	0	158	0	3964	0	3806	0.0	0.0
chr20	BCL2L1	31684366	31684588	0	223	0	3964	0	3741	0.0	0.0
chr20	DUSP15	31869563	31869597	0	35	18	3591	18	3556	0.0	0.005061867266591676
chr20	NOL4L	32454014	32454084	0	71	218	5380	218	5309	0.0	0.041062346957995856
chr20	FO393400.1	32640565	32640687	0	123	6753	4720	6753	4597	0.0	1.4690015227322166
chr20	FO393400.1	32651732	32651981	204	250	6753	4720	6549	4470	0.816	1.4651006711409396
chr20	SUN5	33001211	33001278	0	68	1633	1488	1633	1420	0.0	1.15
chr20	SUN5	33002586	33002661	611	76	1633	1488	1022	1412	8.039473684210526	0.7237960339943342
chr20	CDK5RAP1	33379460	33379691	0	232	6277	4575	6277	4343	0.0	1.4453142988717476
chr20	CDK5RAP1	33387322	33387533	0	212	6277	4575	6277	4363	0.0	1.4386889754755903
chr20	CDK5RAP1	33396760	33396936	111	177	6277	4575	6166	4398	0.6271186440677966	1.4020009095043202
chr20	CDK5RAP1	33396760	33397084	364	325	6277	4575	5913	4250	1.12	1.3912941176470588
chr20	CDK5RAP1	33383479	33383521	613	43	6277	4575	5664	4532	14.255813953488373	1.2497793468667255
chr20	CDK5RAP1	33395012	33395116	51	105	6277	4575	6226	4470	0.4857142857142857	1.3928411633109619
chr20	CDK5RAP1	33394031	33394066	0	36	6277	4575	6277	4539	0.0	1.3829037232870676
chr20	NECAB3	33659496	33659550	0	55	61974	4125	61974	4070	0.0	15.227027027027027
chr20	PXMP4	33710554	33710753	216	200	458992	5723	458776	5523	1.08	83.0664493934456
chr20	PXMP4	33710554	33710773	684	220	458992	5723	458308	5503	3.109090909090909	83.2833000181719
chr20	RALY-AS1	33993059	33993150	1259	92	101515	8725	100256	8633	13.684782608695652	11.61311247538515
chr20	PIGU	34585436	34585580	0	145	175152	2721	175152	2576	0.0	67.99378881987577
chr20	PIGU	34616041	34616139	0	99	175152	2721	175152	2622	0.0	66.80091533180779
chr20	PIGU	34645274	34645334	0	61	175152	2721	175152	2660	0.0	65.84661654135338
chr20	NCOA6	34740362	34743341	3824	2980	41775	11155	37951	8175	1.2832214765100671	4.642324159021407
chr20	GGT7	34850781	34850917	23	137	78548	2979	78525	2842	0.1678832116788321	27.6301900070373
chr20	GGT7	34863679	34863730	0	52	78548	2979	78548	2927	0.0	26.83566791937137
chr20	GSS	34929400	34929590	0	191	62	5144	62	4953	0.0	0.012517666060973147
chr20	GSS	34935575	34935642	0	68	62	5144	62	5076	0.0	0.012214342001576044
chr20	GSS	34942487	34942627	0	141	62	5144	62	5003	0.0	0.012392564461323205
chr20	GSS	34942930	34943006	0	77	62	5144	62	5067	0.0	0.012236037102822183
chr20	GSS	34945952	34946098	0	147	62	5144	62	4997	0.0	0.012407444466680007
chr20	GSS	34936762	34936840	0	79	62	5144	62	5065	0.0	0.012240868706811452
chr20	GSS	34941712	34941829	0	118	62	5144	62	5026	0.0	0.012335853561480302
chr20	GSS	34942487	34942585	0	99	62	5144	62	5045	0.0	0.012289395441030724
chr20	GSS	34945952	34946051	0	100	62	5144	62	5044	0.0	0.012291831879460745
chr20	GSS	34954268	34954547	0	280	62	5144	62	4864	0.0	0.01274671052631579
chr20	EDEM2	35146824	35146935	799	112	5962	1895	5163	1783	7.133928571428571	2.895681435782389
chr20	MMP24OS	35236080	35236191	167014	112	193528	5505	26514	5393	1491.1964285714287	4.916373076209902
chr20	MMP24OS	35276155	35276314	0	160	193528	5505	193528	5345	0.0	36.207296538821325
chr20	EIF6	35280653	35280829	58843	177	105796	1643	46953	1466	332.44632768361583	32.02796725784447
chr20	EIF6	35284175	35284261	1184	87	105796	1643	104612	1556	13.60919540229885	67.23136246786632
chr20	UQCC1	35314687	35314765	451	79	156139	4188	155688	4109	5.708860759493671	37.889510829885616
chr20	UQCC1	35384037	35384133	32598	97	156139	4188	123541	4091	336.0618556701031	30.198240039110242
chr20	UQCC1	35374183	35374256	0	74	156139	4188	156139	4114	0.0	37.95308701993194
chr20	UQCC1	35409344	35409467	62538	124	156139	4188	93601	4064	504.33870967741933	23.031742125984252
chr20	UQCC1	35381917	35382025	0	109	156139	4188	156139	4079	0.0	38.2787447903898
chr20	UQCC1	35392235	35392277	103	43	156139	4188	156036	4145	2.395348837209302	37.64439083232811
chr20	UQCC1	35346700	35346747	0	48	156139	4188	156139	4140	0.0	37.714734299516905
chr20	UQCC1	35386276	35386389	0	114	156139	4188	156139	4074	0.0	38.32572410407462
chr20	UQCC1	35384558	35384644	51	87	156139	4188	156088	4101	0.5862068965517241	38.060960741282614
chr20	CEP250-AS1	35481132	35481251	385	120	4226	843	3841	723	3.2083333333333335	5.312586445366528
chr20	CEP250-AS1	35477825	35477945	354	121	4226	843	3872	722	2.925619834710744	5.362880886426593
chr20	FER1L4	35567600	35567654	0	55	22581	9174	22581	9119	0.0	2.476258361662463
chr20	FER1L4	35578835	35578967	0	133	22581	9174	22581	9041	0.0	2.497621944475169
chr20	FER1L4	35562808	35562969	0	162	22581	9174	22581	9012	0.0	2.505659121171771
chr20	FER1L4	35582838	35583012	0	175	22581	9174	22581	8999	0.0	2.5092788087565285
chr20	FER1L4	35583685	35583810	308	126	22581	9174	22273	9048	2.4444444444444446	2.4616489832007074
chr20	FER1L4	35585123	35585276	0	154	22581	9174	22581	9020	0.0	2.5034368070953437
chr20	FER1L4	35602106	35602266	0	161	22581	9174	22581	9013	0.0	2.505381116165539
chr20	CPNE1	35632162	35632234	10339	73	50298	2948	39959	2875	141.63013698630138	13.898782608695653
chr20	CPNE1	35632794	35632923	0	130	50298	2948	50298	2818	0.0	17.848828956706885
chr20	CPNE1	35655201	35655344	8	144	50298	2948	50290	2804	0.05555555555555555	17.93509272467903
chr20	CPNE1	35658929	35658982	0	54	50298	2948	50298	2894	0.0	17.380096751900485
chr20	CPNE1	35632162	35632248	12279	87	50298	2948	38019	2861	141.13793103448276	13.288710241174414
chr20	CPNE1	35658929	35659014	0	86	50298	2948	50298	2862	0.0	17.57442348008386
chr20	NFS1	35675044	35675202	0	159	36524	5562	36524	5403	0.0	6.759948176938738
chr20	NFS1	35690412	35690565	3310	154	36524	5562	33214	5408	21.493506493506494	6.141642011834319
chr20	NFS1	35692248	35692370	0	123	36524	5562	36524	5439	0.0	6.715205000919287
chr20	NFS1	35692248	35692296	0	49	36524	5562	36524	5513	0.0	6.625068021041176
chr20	RBM39	35716739	35716805	0	67	5698	11032	5698	10965	0.0	0.5196534427724578
chr20	RBM39	35729461	35729527	0	67	5698	11032	5698	10965	0.0	0.5196534427724578
chr20	RBM39	35740524	35740597	0	74	5698	11032	5698	10958	0.0	0.5199853987954006
chr20	RBM39	35707939	35707992	0	54	5698	11032	5698	10978	0.0	0.5190380761523046
chr20	RBM39	35734185	35734257	0	73	5698	11032	5698	10959	0.0	0.5199379505429328
chr20	RBM39	35710282	35710420	0	139	5698	11032	5698	10893	0.0	0.5230882217938125
chr20	RBM39	35713701	35713857	4	157	5698	11032	5694	10875	0.025477707006369428	0.5235862068965518
chr20	RBM39	35736512	35736567	0	56	5698	11032	5698	10976	0.0	0.5191326530612245
chr20	RBM39	35739392	35739547	0	156	5698	11032	5698	10876	0.0	0.523905847738139
chr20	NDRG3	36654800	36654839	0	40	9234	3278	9234	3238	0.0	2.8517603458925262
chr20	NDRG3	36706971	36707007	80	37	9234	3278	9154	3241	2.1621621621621623	2.824436902190682
chr20	DSN1	36770872	36771193	612	322	122812	2481	122200	2159	1.9006211180124224	56.600277906438166
chr20	DSN1	36770872	36770977	264	106	122812	2481	122548	2375	2.490566037735849	51.59915789473684
chr20	DSN1	36771424	36771473	0	50	122812	2481	122812	2431	0.0	50.51912793089264
chr20	SAMHD1	36898439	36898544	0	106	138	8463	138	8357	0.0	0.016513102788081848
chr20	SAMHD1	36935028	36935189	0	162	138	8463	138	8301	0.0	0.016624503071919046
chr20	SAMHD1	36917151	36917215	0	65	138	8463	138	8398	0.0	0.016432483924743987
chr20	SAMHD1	36935340	36935403	110	64	138	8463	28	8399	1.71875	0.0033337302059769022
chr20	SAMHD1	36935080	36935189	0	110	138	8463	138	8353	0.0	0.01652101041541961
chr20	RBL1	37081887	37082029	0	143	28652	5979	28652	5836	0.0	4.909527073337903
chr20	MROH8	37173994	37174116	0	123	4475	3902	4475	3779	0.0	1.184175707859222
chr20	BLCAP	37521318	37521451	0	134	0	5359	0	5225	0.0	0.0
chr20	BLCAP	37521318	37521409	0	92	0	5359	0	5267	0.0	0.0
chr20	TTI1	38019004	38019144	0	141	102	4062	102	3921	0.0	0.026013771996939557
chr20	KIAA1755	38225664	38225781	0	118	102	8084	102	7966	0.0	0.012804418779814211
chr20	SNHG17	38422086	38422241	0	156	199	11084	199	10928	0.0	0.018210102489019032
chr20	SNHG17	38425934	38426048	0	115	199	11084	199	10969	0.0	0.018142036648737352
chr20	SNHG17	38422290	38422368	0	79	199	11084	199	11005	0.0	0.018082689686506132
chr20	SNHG17	38434503	38434626	114	124	199	11084	85	10960	0.9193548387096774	0.007755474452554745
chr20	SNHG17	38422091	38422241	0	151	199	11084	199	10933	0.0	0.018201774444342816
chr20	SNHG17	38427679	38427766	0	88	199	11084	199	10996	0.0	0.018097489996362313
chr20	SNHG17	38425934	38426052	0	119	199	11084	199	10965	0.0	0.018148654810761514
chr20	SNHG17	38422095	38422241	0	147	199	11084	199	10937	0.0	0.018195117491085308
chr20	SNHG17	38429868	38429959	0	92	199	11084	199	10992	0.0	0.018104075691411935
chr20	SNHG17	38427679	38427847	0	169	199	11084	199	10915	0.0	0.018231791113147044
chr20	ZHX3	41201285	41201384	0	100	0	4825	0	4725	0.0	0.0
chr20	ZHX3	41254587	41254635	0	49	0	4825	0	4776	0.0	0.0
chr20	ZHX3	41238687	41238796	0	110	0	4825	0	4715	0.0	0.0
chr20	ZHX3	41213733	41213899	0	167	0	4825	0	4658	0.0	0.0
chr20	ZHX3	41267462	41267612	0	151	0	4825	0	4674	0.0	0.0
chr20	ZHX3	41269410	41269485	0	76	0	4825	0	4749	0.0	0.0
chr20	CHD6	41551304	41551360	0	57	56	14072	56	14015	0.0	0.003995718872636461
chr20	CHD6	41564010	41564151	0	142	56	14072	56	13930	0.0	0.004020100502512563
chr20	PTPRT	42270396	42270453	0	58	6630	12975	6630	12917	0.0	0.5132770767206007
chr20	PTPRT	42116038	42116098	0	61	6630	12975	6630	12914	0.0	0.5133963140777451
chr20	PTPRT	42236228	42236258	5	31	6630	12975	6625	12944	0.16129032258064516	0.5118201483312732
chr20	ADA	44622587	44622652	0	66	15662	2687	15662	2621	0.0	5.975581838992751
chr20	ADA	44623006	44623078	0	73	15662	2687	15662	2614	0.0	5.991583779648049
chr20	KCNK15-AS1	44716624	44716793	0	170	2499	1509	2499	1339	0.0	1.866318147871546
chr20	KCNK15-AS1	44737510	44737570	0	61	2499	1509	2499	1448	0.0	1.725828729281768
chr20	KCNS1	45100159	45100361	0	203	0	5654	0	5451	0.0	0.0
chr20	MATN4	45303388	45303511	408	124	3118	2479	2710	2355	3.2903225806451615	1.1507430997876857
chr20	MATN4	45301320	45301443	0	124	3118	2479	3118	2355	0.0	1.3239915074309978
chr20	MATN4	45301101	45301224	0	124	3118	2479	3118	2355	0.0	1.3239915074309978
chr20	WFDC10B	45685901	45686056	0	156	0	634	0	478	0.0	0.0
chr20	WFDC3	45787835	45787982	0	148	50	2416	50	2268	0.0	0.02204585537918871
chr20	WFDC3	45777074	45777209	0	136	50	2416	50	2280	0.0	0.021929824561403508
chr20	WFDC3	45788930	45789059	0	130	50	2416	50	2286	0.0	0.021872265966754154
chr20	WFDC3	45789893	45789982	50	90	50	2416	0	2326	0.5555555555555556	0.0
chr20	WFDC3	45777074	45777206	0	133	50	2416	50	2283	0.0	0.021901007446342532
chr20	ACOT8	45843526	45843721	488	196	28264	3508	27776	3312	2.489795918367347	8.38647342995169
chr20	ACOT8	45855158	45855292	100	135	28264	3508	28164	3373	0.7407407407407407	8.349836940409132
chr20	ACOT8	45843526	45843772	488	247	28264	3508	27776	3261	1.9757085020242915	8.517632628028212
chr20	ACOT8	45848449	45848675	1167	227	28264	3508	27097	3281	5.140969162995595	8.258762572386468
chr20	ACOT8	45853922	45853984	52	63	28264	3508	28212	3445	0.8253968253968254	8.189259796806967
chr20	ACOT8	45853922	45853979	52	58	28264	3508	28212	3450	0.896551724137931	8.177391304347825
chr20	PLTP	45909941	45910070	590	130	16846	2558	16256	2428	4.538461538461538	6.695222405271829
chr20	PLTP	45909515	45909671	0	157	16846	2558	16846	2401	0.0	7.016243231986672
chr20	NCOA5	46079386	46079453	0	68	0	3232	0	3164	0.0	0.0
chr20	SLC35C2	46355801	46355874	0	74	153	7719	153	7645	0.0	0.02001308044473512
chr20	ELMO2	46387337	46387437	0	101	155	4584	155	4483	0.0	0.03457506134285077
chr20	ELMO2	46398696	46398771	0	76	155	4584	155	4508	0.0	0.03438331854480923
chr20	ELMO2	46393528	46393601	0	74	155	4584	155	4510	0.0	0.03436807095343681
chr20	ELMO2	46387337	46387431	0	95	155	4584	155	4489	0.0	0.03452884829583426
chr20	AL031686.1	46459218	46459622	0	405	0	4281	0	3876	0.0	0.0
chr20	ZNF334	46506306	46506458	0	153	0	6001	0	5848	0.0	0.0
chr20	ZNF334	46509604	46509751	0	148	0	6001	0	5853	0.0	0.0
chr20	SLC13A3	46588058	46588163	0	106	0	6075	0	5969	0.0	0.0
chr20	SLC13A3	46599970	46600037	0	68	0	6075	0	6007	0.0	0.0
chr20	ZMYND8	47229725	47229806	0	82	459	7654	459	7572	0.0	0.06061806656101426
chr20	ZMYND8	47238757	47239138	0	382	459	7654	459	7272	0.0	0.06311881188118812
chr20	ZMYND8	47262287	47262428	0	142	459	7654	459	7512	0.0	0.06110223642172524
chr20	ZMYND8	47294665	47294779	0	115	459	7654	459	7539	0.0	0.060883406287306006
chr20	ZMYND8	47212641	47212725	0	85	459	7654	459	7569	0.0	0.06064209274673008
chr20	ZMYND8	47238895	47239138	0	244	459	7654	459	7410	0.0	0.06194331983805668
chr20	ZMYND8	47355449	47355520	0	72	459	7654	459	7582	0.0	0.06053811659192825
chr20	ZMYND8	47349860	47349988	0	129	459	7654	459	7525	0.0	0.060996677740863786
chr20	SULF2	47659398	47659452	0	55	42946	6098	42946	6043	0.0	7.106735065364885
chr20	SULF2	47690125	47690295	160	171	42946	6098	42786	5927	0.935672514619883	7.21882908722794
chr20	SULF2	47736702	47736942	233	241	42946	6098	42713	5857	0.966804979253112	7.292641283933754
chr20	CSE1L-AS1	49043149	49043372	0	224	0	682	0	458	0.0	0.0
chr20	STAU1	49165996	49166285	0	290	2656	4110	2656	3820	0.0	0.6952879581151833
chr20	STAU1	49174194	49174269	0	76	2656	4110	2656	4034	0.0	0.6584035696579078
chr20	STAU1	49179121	49179244	0	124	2656	4110	2656	3986	0.0	0.6663321625689914
chr20	PTGIS	49547840	49548019	2216	180	365096	5580	362880	5400	12.311111111111112	67.2
chr20	UBE2V1	50084128	50084254	0	127	675	4832	675	4705	0.0	0.1434643995749203
chr20	UBE2V1	50096671	50096820	0	150	675	4832	675	4682	0.0	0.14416915847928236
chr20	UBE2V1	50098881	50098981	0	101	675	4832	675	4731	0.0	0.14267596702599875
chr20	UBE2V1	50111288	50111562	0	275	675	4832	675	4557	0.0	0.14812376563528637
chr20	UBE2V1	50108972	50109111	0	140	675	4832	675	4692	0.0	0.1438618925831202
chr20	PEDS1	50130855	50130947	0	93	1785	7939	1785	7846	0.0	0.2275044608717818
chr20	UBE2V1	50096482	50096534	0	53	675	4832	675	4779	0.0	0.14124293785310735
chr20	UBE2V1	50098881	50098964	0	84	675	4832	675	4748	0.0	0.14216512215669755
chr20	PEDS1	50130864	50130947	0	84	1785	7939	1785	7855	0.0	0.22724379376193507
chr20	PEDS1	50151211	50151315	0	105	1785	7939	1785	7834	0.0	0.22785294868521827
chr20	LINC01275	50163638	50164033	0	396	0	1006	0	610	0.0	0.0
chr20	ADNP	50904765	50904849	0	85	0	7594	0	7509	0.0	0.0
chr20	ADNP	50918738	50918781	0	44	0	7594	0	7550	0.0	0.0
chr20	ADNP	50903888	50904001	0	114	0	7594	0	7480	0.0	0.0
chr20	ADNP	50928650	50928825	0	176	0	7594	0	7418	0.0	0.0
chr20	DPM1	50941128	50941209	0	82	0	1217	0	1135	0.0	0.0
chr20	DPM1	50942030	50942126	0	97	0	1217	0	1120	0.0	0.0
chr20	DPM1	50941104	50941209	0	106	0	1217	0	1111	0.0	0.0
chr20	KCNG1	51012358	51012416	0	59	0	5421	0	5362	0.0	0.0
chr20	KCNG1	51013728	51013844	0	117	0	5421	0	5304	0.0	0.0
chr20	NFATC2	51398642	51398730	0	89	102	8298	102	8209	0.0	0.012425386770617615
chr20	SALL4	51790021	51792352	0	2332	0	5780	0	3448	0.0	0.0
chr20	SALL4	51791332	51792352	0	1021	0	5780	0	4759	0.0	0.0
chr20	ZFP64	52165863	52166025	0	163	14102	5849	14102	5686	0.0	2.480126626802673
chr20	ZNF217	53571720	53571853	0	134	0	6191	0	6057	0.0	0.0
chr20	BCAS1	53992511	53992646	0	136	51	8200	51	8064	0.0	0.006324404761904762
chr20	BCAS1	53957431	53957497	0	67	51	8200	51	8133	0.0	0.006270748801180376
chr20	BCAS1	53966905	53967073	0	169	51	8200	51	8031	0.0	0.00635039223010833
chr20	BCAS1	53975388	53975430	0	43	51	8200	51	8157	0.0	0.00625229863920559
chr20	CYP24A1	54157387	54157585	0	199	0	4000	0	3801	0.0	0.0
chr20	AURKA	56390555	56390665	0	111	0	2904	0	2793	0.0	0.0
chr20	AURKA	56388686	56388784	0	99	0	2904	0	2805	0.0	0.0
chr20	AURKA	56388311	56388506	0	196	0	2904	0	2708	0.0	0.0
chr20	BMP7	57183721	57183919	0	199	5252	5438	5252	5239	0.0	1.0024813895781637
chr20	BMP7	57225854	57225962	0	109	5252	5438	5252	5329	0.0	0.9855507599924939
chr20	CTCFL	57514591	57514741	0	151	2916	8679	2916	8528	0.0	0.3419324577861163
chr20	CTCFL	57523662	57524216	0	555	2916	8679	2916	8124	0.0	0.35893648449039883
chr20	CTCFL	57525027	57525127	0	101	2916	8679	2916	8578	0.0	0.3399393798088132
chr20	CTCFL	57513235	57513872	0	638	2916	8679	2916	8041	0.0	0.3626414625046636
chr20	CTCFL	57523067	57523278	2763	212	2916	8679	153	8467	13.033018867924529	0.018070154718318177
chr20	ZBP1	57616243	57616468	2331	226	735032	5371	732701	5145	10.314159292035399	142.4103012633625
chr20	PMEPA1	57700015	57700186	0	172	0	5734	0	5562	0.0	0.0
chr20	PPP4R1L	58238210	58238311	0	102	51	9090	51	8988	0.0	0.005674232309746329
chr20	PPP4R1L	58271362	58271505	0	144	51	9090	51	8946	0.0	0.005700871898054996
chr20	PPP4R1L	58263371	58263517	0	147	51	9090	51	8943	0.0	0.0057027843005702785
chr20	APCDD1L	58513816	58513987	2152	172	20341	4216	18189	4044	12.511627906976743	4.497774480712166
chr20	AL121917.1	58884846	58885015	0	170	0	2065	0	1895	0.0	0.0
chr20	PRELID3B	59037190	59037280	0	91	0	2883	0	2792	0.0	0.0
chr20	PRELID3B	59037190	59037299	0	110	0	2883	0	2773	0.0	0.0
chr20	SYCP2	59868412	59868568	0	157	0	6512	0	6355	0.0	0.0
chr20	SYCP2	59932061	59932154	0	94	0	6512	0	6418	0.0	0.0
chr20	AL160412.1	61435702	61435794	0	93	9582	3576	9582	3483	0.0	2.7510766580534023
chr20	AL160412.1	61436479	61436633	0	155	9582	3576	9582	3421	0.0	2.8009353990061387
chr20	AL160412.1	61434955	61435151	0	197	9582	3576	9582	3379	0.0	2.8357502219591595
chr20	AL160412.1	61436185	61436633	32646	449	9582	3576	-23064	3127	72.70824053452115	-7.375759513911097
chr20	AL162457.2	61740470	61740887	0	418	0	1357	0	939	0.0	0.0
chr20	LAMA5	62310418	62310572	195	155	493187	14260	492992	14105	1.2580645161290323	34.951577454803264
chr20	LAMA5	62312887	62313010	1358	124	493187	14260	491829	14136	10.951612903225806	34.79265704584041
chr20	LAMA5	62336903	62336986	259	84	493187	14260	492928	14176	3.0833333333333335	34.77200902934537
chr20	LAMA5	62350987	62351257	850	271	493187	14260	492337	13989	3.1365313653136533	35.19458145685896
chr20	CABLES2	62394156	62394265	0	110	3061	3795	3061	3685	0.0	0.8306648575305292
chr20	MIR1-1HG-AS1	62547547	62547702	969	156	18925	2949	17956	2793	6.211538461538462	6.428929466523451
chr20	MIR1-1HG-AS1	62548311	62548461	1785	151	18925	2949	17140	2798	11.821192052980132	6.125804145818441
chr20	LINC00029	63035564	63035721	0	158	0	1794	0	1636	0.0	0.0
chr20	YTHDF1	63202286	63203807	0	1522	0	3211	0	1689	0.0	0.0
chr20	NKAIN4	63242538	63242623	0	86	0	2605	0	2519	0.0	0.0
chr20	NKAIN4	63244469	63244543	0	75	0	2605	0	2530	0.0	0.0
chr20	CHRNA4	63355495	63355595	0	101	0	11311	0	11210	0.0	0.0
chr20	KCNQ2	63419618	63419672	0	55	0	11982	0	11927	0.0	0.0
chr20	KCNQ2	63431339	63431369	0	31	0	11982	0	11951	0.0	0.0
chr20	KCNQ2	63411774	63411882	0	109	0	11982	0	11873	0.0	0.0
chr20	KCNQ2	63409960	63410009	0	50	0	11982	0	11932	0.0	0.0
chr20	PTK6	63534937	63535059	0	123	0	2961	0	2838	0.0	0.0
chr20	ARFRP1	63701829	63701900	0	72	0	2709	0	2637	0.0	0.0
chr20	ARFRP1	63706998	63707092	0	95	0	2709	0	2614	0.0	0.0
chr20	ARFRP1	63706998	63707097	0	100	0	2709	0	2609	0.0	0.0
chr20	ARFRP1	63701829	63701898	0	70	0	2709	0	2639	0.0	0.0
chr20	UCKL1	63943652	63943669	0	18	0	3201	0	3183	0.0	0.0
chr20	SAMD10	63978244	63978361	0	118	0	2457	0	2339	0.0	0.0
chr20	RGS19	64076856	64076954	0	99	0	2035	0	1936	0.0	0.0
chr21	FP565260.3	5026279	5026630	0	352	0	3365	0	3013	0.0	0.0
chr21	FP565260.3	5026431	5026630	0	200	0	3365	0	3165	0.0	0.0
chr21	CU633967.1	5585822	5585987	0	166	0	5133	0	4967	0.0	0.0
chr21	CU633967.1	5586444	5586499	0	56	0	5133	0	5077	0.0	0.0
chr21	CU633967.1	5566124	5566183	0	60	0	5133	0	5073	0.0	0.0
chr21	CU633967.1	5579669	5579808	0	140	0	5133	0	4993	0.0	0.0
chr21	CU633967.1	5584809	5584975	0	167	0	5133	0	4966	0.0	0.0
chr21	CU633967.1	5584809	5585063	0	255	0	5133	0	4878	0.0	0.0
chr21	LINC01669	6075739	6075807	0	69	0	1690	0	1621	0.0	0.0
chr21	CU633906.2	6329547	6329607	0	61	0	3412	0	3351	0.0	0.0
chr21	CU634019.1	7061346	7061405	0	60	0	3064	0	3004	0.0	0.0
chr21	CU634019.1	7080035	7080289	0	255	0	3064	0	2809	0.0	0.0
chr21	CU633904.1	7463448	7463503	0	56	0	3394	0	3338	0.0	0.0
chr21	CU633904.1	7443124	7443183	0	60	0	3394	0	3334	0.0	0.0
chr21	CU633904.1	7461813	7462067	0	255	0	3394	0	3139	0.0	0.0
chr21	SMIM11B	7754951	7755118	0	168	0	4297	0	4129	0.0	0.0
chr21	CR381653.1	9325630	9325823	0	194	0	1910	0	1716	0.0	0.0
chr21	CR381653.1	9325604	9325823	0	220	0	1910	0	1690	0.0	0.0
chr21	CR381653.1	9325873	9325961	0	89	0	1910	0	1821	0.0	0.0
chr21	AC018692.1	9914092	9914182	107	91	566	923	459	832	1.1758241758241759	0.5516826923076923
chr21	TPTE	10552656	10552716	56	61	353	2620	297	2559	0.9180327868852459	0.1160609613130129
chr21	TPTE	10595981	10596087	13	107	353	2620	340	2513	0.12149532710280374	0.13529645841623558
chr21	TPTE	10542394	10542448	0	55	353	2620	353	2565	0.0	0.13762183235867445
chr21	TPTE	10543328	10543382	0	55	353	2620	353	2565	0.0	0.13762183235867445
chr21	ANKRD30BP2	13046235	13046373	0	139	0	4155	0	4016	0.0	0.0
chr21	LINC01674	13556392	13556511	0	120	0	1252	0	1132	0.0	0.0
chr21	LINC01674	13565664	13565781	0	118	0	1252	0	1134	0.0	0.0
chr21	RBM11	14219562	14219725	0	164	0	2365	0	2201	0.0	0.0
chr21	ABCC13	14336079	14336257	0	179	0	8015	0	7836	0.0	0.0
chr21	ABCC13	14308971	14309098	0	128	0	8015	0	7887	0.0	0.0
chr21	USP25	15826203	15826365	0	163	0	7850	0	7687	0.0	0.0
chr21	USP25	15849776	15849872	0	97	0	7850	0	7753	0.0	0.0
chr21	USP25	15847662	15847776	0	115	0	7850	0	7735	0.0	0.0
chr21	MIR99AHG	16231055	16231115	0	61	517	42307	517	42246	0.0	0.012237845003077214
chr21	MIR99AHG	16391613	16391685	0	73	517	42307	517	42234	0.0	0.012241322157503433
chr21	MIR99AHG	15972310	15972515	0	206	517	42307	517	42101	0.0	0.01227999334932662
chr21	MIR99AHG	16537378	16537439	0	62	517	42307	517	42245	0.0	0.012238134690495917
chr21	MIR99AHG	15965331	15965407	0	77	517	42307	517	42230	0.0	0.012242481648117452
chr21	MIR99AHG	16257392	16257454	0	63	517	42307	517	42244	0.0	0.01223842439162958
chr21	MIR99AHG	16589352	16589557	0	206	517	42307	517	42101	0.0	0.01227999334932662
chr21	MIR99AHG	16535033	16535709	0	677	517	42307	517	41630	0.0	0.012418928657218352
chr21	MIR99AHG	16594339	16594454	0	116	517	42307	517	42191	0.0	0.012253798203408309
chr21	MIR99AHG	16477844	16478039	0	196	517	42307	517	42111	0.0	0.01227707724822493
chr21	MIR99AHG	16383159	16383304	0	146	517	42307	517	42161	0.0	0.012262517492469344
chr21	MIR99AHG	16589352	16589467	0	116	517	42307	517	42191	0.0	0.012253798203408309
chr21	MIR99AHG	16589352	16589540	0	189	517	42307	517	42118	0.0	0.012275036801367586
chr21	MIR99AHG	16214256	16214378	0	123	517	42307	517	42184	0.0	0.012255831594917504
chr21	MIR99AHG	16564773	16564809	0	37	517	42307	517	42270	0.0	0.012230896616986042
chr21	MIR99AHG	16352128	16352273	7	146	517	42307	510	42161	0.04794520547945205	0.012096487274969758
chr21	MIR99AHG	16223523	16223574	0	52	517	42307	517	42255	0.0	0.012235238433321501
chr21	MIR99AHG	16596384	16596402	0	19	517	42307	517	42288	0.0	0.012225690503216043
chr21	MIR99AHG	16606225	16606273	0	49	517	42307	517	42258	0.0	0.01223436982346538
chr21	MIR99AHG	16521718	16521816	0	99	517	42307	517	42208	0.0	0.012248862774829417
chr21	MIR99AHG	16560446	16560498	0	53	517	42307	517	42254	0.0	0.012235527997349364
chr21	MIR99AHG	16485711	16485816	0	106	517	42307	517	42201	0.0	0.012250894528565674
chr21	MIR99AHG	16589352	16589413	0	62	517	42307	517	42245	0.0	0.012238134690495917
chr21	MIR99AHG	16631440	16631489	0	50	517	42307	517	42257	0.0	0.012234659346380482
chr21	CXADR	17558975	17559131	0	157	909	6029	909	5872	0.0	0.15480245231607628
chr21	CXADR	17551748	17551953	0	206	909	6029	909	5823	0.0	0.1561051004636785
chr21	CHODL	18262790	18262893	0	104	663	3103	663	2999	0.0	0.22107369123041012
chr21	CHODL	18027871	18027971	0	101	663	3103	663	3002	0.0	0.22085276482345104
chr21	LINC01425	21748394	21748684	0	291	22	777	22	486	0.0	0.04526748971193416
chr21	LINC01684	24441168	24441353	34	186	34	9534	0	9348	0.1827956989247312	0.0
chr21	LINC01684	24522888	24522999	0	112	34	9534	34	9422	0.0	0.0036085756739545746
chr21	LINC01684	24443963	24444128	0	166	34	9534	34	9368	0.0	0.003629376601195559
chr21	LINC01684	24488112	24488309	0	198	34	9534	34	9336	0.0	0.003641816623821765
chr21	LINC01684	24443557	24443743	0	187	34	9534	34	9347	0.0	0.0036375307585321493
chr21	LINC01684	24485622	24485685	0	64	34	9534	34	9470	0.0	0.003590285110876452
chr21	JAM2	25689865	25689973	0	109	75	5938	75	5829	0.0	0.012866700977869275
chr21	JAM2	25711366	25711568	0	203	75	5938	75	5735	0.0	0.013077593722755012
chr21	GABPA	25741572	25741675	0	104	816	5752	816	5648	0.0	0.14447592067988668
chr21	AP001442.1	25937789	25937912	0	124	0	2606	0	2482	0.0	0.0
chr21	AP001442.1	25934909	25935048	0	140	0	2606	0	2466	0.0	0.0
chr21	AP000229.1	26180536	26180601	0	66	0	4249	0	4183	0.0	0.0
chr21	AP001604.1	27391389	27391551	0	163	0	1219	0	1056	0.0	0.0
chr21	LINC01673	27669351	27669530	0	180	0	2081	0	1901	0.0	0.0
chr21	LINC01673	27645458	27645640	0	183	0	2081	0	1898	0.0	0.0
chr21	LINC01673	27653118	27653222	0	105	0	2081	0	1976	0.0	0.0
chr21	LINC01697	28101265	28101319	0	55	0	4071	0	4016	0.0	0.0
chr21	LINC01697	28095880	28096114	0	235	0	4071	0	3836	0.0	0.0
chr21	USP16	29025708	29025771	0	64	102	5713	102	5649	0.0	0.018056293149229952
chr21	USP16	29026566	29026661	0	96	102	5713	102	5617	0.0	0.01815915969378672
chr21	MAP3K7CL	29080551	29080708	0	158	0	4362	0	4204	0.0	0.0
chr21	MAP3K7CL	29133305	29133414	0	110	0	4362	0	4252	0.0	0.0
chr21	MAP3K7CL	29130794	29130923	0	130	0	4362	0	4232	0.0	0.0
chr21	MAP3K7CL	29085071	29085143	0	73	0	4362	0	4289	0.0	0.0
chr21	MAP3K7CL	29109039	29109183	0	145	0	4362	0	4217	0.0	0.0
chr21	BACH1	29218860	29218926	0	67	0	7684	0	7617	0.0	0.0
chr21	BACH1	29270356	29270456	0	101	0	7684	0	7583	0.0	0.0
chr21	BACH1	29582311	29582351	0	41	0	7684	0	7643	0.0	0.0
chr21	GRIK1-AS1	29760019	29760065	0	47	0	3102	0	3055	0.0	0.0
chr21	GRIK1-AS1	29758830	29759010	0	181	0	3102	0	2921	0.0	0.0
chr21	GRIK1-AS1	29761256	29761419	0	164	0	3102	0	2938	0.0	0.0
chr21	HUNK	31958842	31958970	0	129	408	8601	408	8472	0.0	0.04815864022662889
chr21	MRAP	32298961	32299077	0	117	0	1347	0	1230	0.0	0.0
chr21	EVA1C	32453311	32453508	0	198	11327	4328	11327	4130	0.0	2.7426150121065374
chr21	EVA1C	32457596	32457720	0	125	11327	4328	11327	4203	0.0	2.694979776350226
chr21	EVA1C	32495026	32495170	1694	145	11327	4328	9633	4183	11.682758620689656	2.3028926607697824
chr21	EVA1C	32501414	32501495	0	82	11327	4328	11327	4246	0.0	2.667687235044748
chr21	EVA1C	32501414	32501538	0	125	11327	4328	11327	4203	0.0	2.694979776350226
chr21	EVA1C	32501414	32501486	0	73	11327	4328	11327	4255	0.0	2.662044653349001
chr21	PAXBP1-AS1	32732518	32732825	0	308	1643	9689	1643	9381	0.0	0.1751412429378531
chr21	PAXBP1-AS1	32733588	32733657	0	70	1643	9689	1643	9619	0.0	0.17080777627612018
chr21	PAXBP1-AS1	32738271	32738341	0	71	1643	9689	1643	9618	0.0	0.17082553545435641
chr21	C21ORF62-AS1	32784796	32784919	0	124	1625	9197	1625	9073	0.0	0.17910283258018295
chr21	C21ORF62-AS1	32788611	32788701	0	91	1625	9197	1625	9106	0.0	0.17845376674719965
chr21	IFNAR2	33244950	33245074	0	125	205	4591	205	4466	0.0	0.04590237348858039
chr21	IFNAR2	33260596	33260727	0	132	205	4591	205	4459	0.0	0.04597443372953577
chr21	IL10RB	33276595	33276753	0	159	0	4535	0	4376	0.0	0.0
chr21	IFNAR2	33252137	33252248	0	112	205	4591	205	4479	0.0	0.045769144898414826
chr21	IL10RB	33268393	33268517	0	125	0	4535	0	4410	0.0	0.0
chr21	IL10RB	33294011	33294127	0	117	0	4535	0	4418	0.0	0.0
chr21	IFNAR1	33343267	33343422	0	156	408	6892	408	6736	0.0	0.060570071258907364
chr21	IFNAR1	33343534	33343676	0	143	408	6892	408	6749	0.0	0.060453400503778336
chr21	IFNAR1	33345245	33345360	0	116	408	6892	408	6776	0.0	0.0602125147579693
chr21	IFNGR2	33414887	33415020	0	134	163	2453	163	2319	0.0	0.07028891763691246
chr21	IFNGR2	33411444	33411575	51	132	163	2453	112	2321	0.38636363636363635	0.04825506247307195
chr21	IFNGR2	33410835	33410892	0	58	163	2453	163	2395	0.0	0.06805845511482254
chr21	IFNGR2	33410840	33410892	0	53	163	2453	163	2400	0.0	0.06791666666666667
chr21	SON	33549475	33555391	0	5917	714	12719	714	6802	0.0	0.10496912672743311
chr21	SON	33572550	33572630	0	81	714	12719	714	12638	0.0	0.05649628105712929
chr21	ITSN1	33750253	33750322	0	70	102746	21317	102746	21247	0.0	4.8357885819174475
chr21	ITSN1	33818266	33818472	51	207	102746	21317	102695	21110	0.2463768115942029	4.864756039791568
chr21	ITSN1	33823486	33823653	106	168	102746	21317	102640	21149	0.6309523809523809	4.853184547732753
chr21	ITSN1	33716430	33716555	504	126	102746	21317	102242	21191	4.0	4.82478410646029
chr21	ITSN1	33750142	33750322	0	181	102746	21317	102746	21136	0.0	4.861184708554125
chr21	ITSN1	33802429	33802444	0	16	102746	21317	102746	21301	0.0	4.823529411764706
chr21	ITSN1	33875353	33875521	847	169	102746	21317	101899	21148	5.011834319526627	4.818375260071875
chr21	ITSN1	33882242	33882455	422	214	102746	21317	102324	21103	1.97196261682243	4.848789271667536
chr21	ITSN1	33829623	33829745	0	123	102746	21317	102746	21194	0.0	4.847881475889403
chr21	ITSN1	33689321	33689383	11876	63	102746	21317	90870	21254	188.5079365079365	4.275430507198645
chr21	ITSN1	33802436	33802444	0	9	102746	21317	102746	21308	0.0	4.821944809461235
chr21	ITSN1	33828967	33829050	0	84	102746	21317	102746	21233	0.0	4.838977064004144
chr21	ITSN1	33826817	33826863	0	47	102746	21317	102746	21270	0.0	4.830559473436765
chr21	ITSN1	33883549	33883671	51	123	102746	21317	102695	21194	0.4146341463414634	4.845475134472021
chr21	LINC00649	33923896	33924311	0	416	125150	8737	125150	8321	0.0	15.040259584184593
chr21	LINC00310	34182707	34183192	0	486	663	3286	663	2800	0.0	0.2367857142857143
chr21	LINC00310	34182707	34183118	0	412	663	3286	663	2874	0.0	0.23068893528183715
chr21	LINC00310	34188216	34188662	0	447	663	3286	663	2839	0.0	0.23353293413173654
chr21	SMIM11A	34385477	34385644	0	168	0	7871	0	7703	0.0	0.0
chr21	CLIC6	34706026	34706080	0	55	159664	4262	159664	4207	0.0	37.95198478725933
chr21	MORC3	36333645	36333718	0	74	2483	6433	2483	6359	0.0	0.39047019971693664
chr21	MORC3	36384186	36384210	0	25	2483	6433	2483	6408	0.0	0.3874843945068664
chr21	RIPPLY3	37013550	37013618	0	69	0	2188	0	2119	0.0	0.0
chr21	TTC3	37121816	37121979	0	164	102	15936	102	15772	0.0	0.006467156987065686
chr21	TTC3	37087832	37087875	0	44	102	15936	102	15892	0.0	0.006418323684872892
chr21	TTC3	37090232	37090286	0	55	102	15936	102	15881	0.0	0.00642276934701845
chr21	TTC3	37094004	37094090	0	87	102	15936	102	15849	0.0	0.006435737270490252
chr21	TTC3	37148545	37148647	0	103	102	15936	102	15833	0.0	0.00644224088928188
chr21	TTC3	37192111	37192213	0	103	102	15936	102	15833	0.0	0.00644224088928188
chr21	TTC3	37157160	37157214	0	55	102	15936	102	15881	0.0	0.00642276934701845
chr21	DSCR9	37210004	37210114	0	111	0	1584	0	1473	0.0	0.0
chr21	DSCR9	37214095	37214153	0	59	0	1584	0	1525	0.0	0.0
chr21	DSCR9	37216404	37216493	0	90	0	1584	0	1494	0.0	0.0
chr21	DYRK1A	37506098	37506223	0	126	233084	22440	233084	22314	0.0	10.445639508828538
chr21	DYRK1A	37420298	37420384	81	87	233084	22440	233003	22353	0.9310344827586207	10.423790990023711
chr21	DYRK1A	37410569	37410670	961	102	233084	22440	232123	22338	9.42156862745098	10.391395827737488
chr21	DYRK1A	37506098	37506354	0	257	233084	22440	233084	22183	0.0	10.507325429382862
chr21	DYRK1A	37415489	37415565	154	77	233084	22440	232930	22363	2.0	10.4158654921075
chr21	DYRK1A	37430268	37430400	0	133	233084	22440	233084	22307	0.0	10.448917380194558
chr21	DYRK1A	37421773	37421866	0	94	233084	22440	233084	22346	0.0	10.430681106238254
chr21	DYRK1A	37456129	37456308	0	180	233084	22440	233084	22260	0.0	10.470979335130279
chr21	DSCR8	38154414	38154529	308	116	18958	835	18650	719	2.6551724137931036	25.938803894297635
chr21	DSCR8	38154432	38154529	308	98	18958	835	18650	737	3.142857142857143	25.30529172320217
chr21	KCNJ15	38169168	38169268	0	101	21554	10358	21554	10257	0.0	2.1013941698352343
chr21	KCNJ15	38257045	38257185	528	141	21554	10358	21026	10217	3.74468085106383	2.0579426446119213
chr21	KCNJ15	38291605	38291747	306	143	21554	10358	21248	10215	2.13986013986014	2.0800783162016643
chr21	KCNJ15	38256742	38256787	0	46	21554	10358	21554	10312	0.0	2.0901861908456167
chr21	KCNJ15	38298143	38298282	0	140	21554	10358	21554	10218	0.0	2.10941475826972
chr21	KCNJ15	38285586	38285689	52	104	21554	10358	21502	10254	0.5	2.096937780378389
chr21	ETS2	38806450	38806808	0	359	153	4917	153	4558	0.0	0.03356735410267661
chr21	ETS2	38806690	38806808	0	119	153	4917	153	4798	0.0	0.0318882867861609
chr21	GET1	39393165	39393280	0	116	0	8656	0	8540	0.0	0.0
chr21	GET1	39390697	39390863	0	167	0	8656	0	8489	0.0	0.0
chr21	SH3BGR	39475134	39475215	0	82	0	1493	0	1411	0.0	0.0
chr21	SH3BGR	39499822	39499915	0	94	0	1493	0	1399	0.0	0.0
chr21	GET1	39405913	39406058	0	146	0	8656	0	8510	0.0	0.0
chr21	GET1	39407792	39407917	0	126	0	8656	0	8530	0.0	0.0
chr21	GET1	39405913	39406298	0	386	0	8656	0	8270	0.0	0.0
chr21	GET1	39425759	39426034	0	276	0	8656	0	8380	0.0	0.0
chr21	GET1	39391226	39391476	0	251	0	8656	0	8405	0.0	0.0
chr21	GET1	39408605	39408677	0	73	0	8656	0	8583	0.0	0.0
chr21	GET1	39413809	39414591	0	783	0	8656	0	7873	0.0	0.0
chr21	B3GALT5	39659752	39659912	0	161	2448	14328	2448	14167	0.0	0.17279593421331263
chr21	PCP4	39926046	39926191	0	146	0	991	0	845	0.0	0.0
chr21	DSCAM-AS1	40383651	40384138	0	488	744	1772	744	1284	0.0	0.5794392523364486
chr21	BACE2	41250751	41250901	0	151	102	9570	102	9419	0.0	0.01082917507166366
chr21	BACE2	41257157	41257326	0	170	102	9570	102	9400	0.0	0.010851063829787235
chr21	FAM3B	41322922	41323066	0	145	0	3839	0	3694	0.0	0.0
chr21	FAM3B	41322587	41322704	0	118	0	3839	0	3721	0.0	0.0
chr21	MX2	41372933	41372999	0	67	204	11393	204	11326	0.0	0.01801165460003532
chr21	MX2	41363268	41363389	0	122	204	11393	204	11271	0.0	0.01809954751131222
chr21	MX2	41399195	41399337	51	143	204	11393	153	11250	0.35664335664335667	0.0136
chr21	MX2	41373897	41374127	0	231	204	11393	204	11162	0.0	0.018276294570865437
chr21	MX1	41430532	41430608	0	77	0	6893	0	6816	0.0	0.0
chr21	MX1	41427205	41427304	0	100	0	6893	0	6793	0.0	0.0
chr21	ZNF295-AS1	42041516	42041982	0	467	0	3806	0	3339	0.0	0.0
chr21	UMODL1	42088293	42088480	0	188	0	7308	0	7120	0.0	0.0
chr21	UMODL1	42090297	42090438	0	142	0	7308	0	7166	0.0	0.0
chr21	UMODL1	42122830	42123150	0	321	0	7308	0	6987	0.0	0.0
chr21	UMODL1	42101707	42101817	0	111	0	7308	0	7197	0.0	0.0
chr21	UMODL1	42093870	42094024	0	155	0	7308	0	7153	0.0	0.0
chr21	UMODL1	42086529	42086626	0	98	0	7308	0	7210	0.0	0.0
chr21	UMODL1	42093403	42093522	0	120	0	7308	0	7188	0.0	0.0
chr21	UMODL1	42088293	42088473	0	181	0	7308	0	7127	0.0	0.0
chr21	ABCG1	42276894	42276945	0	52	51	6143	51	6091	0.0	0.008373009358069283
chr21	UBASH3A	42413409	42413523	38	115	38	3935	0	3820	0.33043478260869563	0.0
chr21	SLC37A1	42514869	42514935	0	67	178	6841	178	6774	0.0	0.02627694124594036
chr21	PDE9A	42686191	42686262	0	72	14845	5304	14845	5232	0.0	2.837347094801223
chr21	PDE9A	42687916	42687994	0	79	14845	5304	14845	5225	0.0	2.841148325358852
chr21	PDE9A	42731769	42731949	0	181	14845	5304	14845	5123	0.0	2.8977161819246535
chr21	PDE9A	42732069	42732124	0	56	14845	5304	14845	5248	0.0	2.8286966463414633
chr21	PDE9A	42743775	42743860	0	86	14845	5304	14845	5218	0.0	2.8449597546952856
chr21	PDE9A	42697414	42697490	0	77	14845	5304	14845	5227	0.0	2.840061220585422
chr21	PDE9A	42698967	42699011	0	45	14845	5304	14845	5259	0.0	2.8227799961969957
chr21	NDUFV3	42903181	42904276	0	1096	0	6349	0	5253	0.0	0.0
chr21	NDUFV3	42896926	42897047	0	122	0	6349	0	6227	0.0	0.0
chr21	PKNOX1	43010052	43010224	0	173	4731	7547	4731	7374	0.0	0.6415785191212368
chr21	PDXK	43743723	43743807	0	85	0	11305	0	11220	0.0	0.0
chr21	PDXK	43732138	43732647	0	510	0	11305	0	10795	0.0	0.0
chr21	PDXK	43732138	43732442	0	305	0	11305	0	11000	0.0	0.0
chr21	RRP1	43791015	43791056	0	42	0	4003	0	3961	0.0	0.0
chr21	AGPAT3	43954549	43955242	765	694	1703	9318	938	8624	1.1023054755043227	0.10876623376623376
chr21	AGPAT3	43948153	43948329	0	177	1703	9318	1703	9141	0.0	0.18630346789191554
chr21	TRAPPC10	44063052	44063168	0	117	1428	8744	1428	8627	0.0	0.1655268343572505
chr21	PWP2	44114178	44114278	0	101	528	6249	528	6148	0.0	0.08588158750813273
chr21	GATD3A	44134101	44134154	0	54	255	7961	255	7907	0.0	0.032249905147337804
chr21	GATD3A	44140249	44140342	0	94	255	7961	255	7867	0.0	0.03241388076776408
chr21	PFKL	44305799	44305935	0	137	49552	8712	49552	8575	0.0	5.77865889212828
chr21	PFKL	44304274	44304455	255	182	49552	8712	49297	8530	1.401098901098901	5.779249706916764
chr21	TRPM2	44427009	44427111	0	103	10791	6626	10791	6523	0.0	1.6543001686340641
chr21	TRPM2	44422269	44422419	18	151	10791	6626	10773	6475	0.11920529801324503	1.6637837837837839
chr21	TSPEAR-AS2	44518258	44518332	2132	75	263575	3030	261443	2955	28.426666666666666	88.47478849407783
chr21	ITGB2-AS1	44927624	44927667	0	44	4835	2443	4835	2399	0.0	2.0154230929553982
chr21	ITGB2-AS1	44922912	44922983	0	72	4835	2443	4835	2371	0.0	2.0392239561366514
chr21	ADARB1	45184473	45184593	0	121	490711	8105	490711	7984	0.0	61.46179859719439
chr21	LINC00334	45243531	45243626	0	96	153	2102	153	2006	0.0	0.07627118644067797
chr21	COL18A1	45507560	45507593	890	34	107903	8507	107013	8473	26.176470588235293	12.629883158267438
chr21	LINC01694	45595572	45595661	0	90	280	3518	280	3428	0.0	0.08168028004667445
chr21	PCBP3	45913950	45914025	0	76	38877	6336	38877	6260	0.0	6.210383386581469
chr21	PCBP3	45930785	45930845	0	61	38877	6336	38877	6275	0.0	6.195537848605578
chr21	PCBP3	45929916	45929995	0	80	38877	6336	38877	6256	0.0	6.2143542199488495
chr21	PCBP3	45913950	45914094	0	145	38877	6336	38877	6191	0.0	6.279599418510742
chr21	MCM3AP-AS1	46236223	46236326	153	104	15028	9232	14875	9128	1.4711538461538463	1.6296012269938651
chr21	MCM3AP-AS1	46230326	46230527	284	202	15028	9232	14744	9030	1.4059405940594059	1.632779623477298
chr21	YBEY	46291333	46291462	3275	130	39436	1807	36161	1677	25.192307692307693	21.562909958258796
chr21	PCNT	46351428	46351540	911	113	43654	11691	42743	11578	8.061946902654867	3.691742960787701
chr21	DIP2A	46504360	46504489	0	130	14970	12486	14970	12356	0.0	1.2115571382324377
chr21	DIP2A	46559833	46559863	0	31	14970	12486	14970	12455	0.0	1.2019269369731032
chr21	PRMT2	46658744	46658920	0	177	10776	5492	10776	5315	0.0	2.0274694261523987
chr21	PRMT2	46663382	46663554	0	173	10776	5492	10776	5319	0.0	2.0259447264523405
chr21	PRMT2	46636438	46636547	0	110	10776	5492	10776	5382	0.0	2.0022296544035676
chr21	PRMT2	46661799	46661936	0	138	10776	5492	10776	5354	0.0	2.0127007844602165
chr21	GATD3B	5121710	5121803	0	94	0	2837	0	2743	0.0	0.0
chr21	GATD3B	5127897	5127950	0	54	0	2837	0	2783	0.0	0.0
chr21	FP565260.1	5134360	5134479	0	120	0	7451	0	7331	0.0	0.0
chr21	CU633906.1	6254790	6254849	0	60	0	2884	0	2824	0.0	0.0
chr21	CU633906.1	6234982	6235147	0	166	0	2884	0	2718	0.0	0.0
chr21	CU633906.1	6235988	6236160	0	173	0	2884	0	2711	0.0	0.0
chr21	CBSL	6447735	6447777	0	43	0	3896	0	3853	0.0	0.0
chr21	U2AF1L5	6492130	6492197	0	68	0	7422	0	7354	0.0	0.0
chr21	U2AF1L5	6493043	6493110	0	68	0	7422	0	7354	0.0	0.0
chr21	CU638689.4	6659518	6659578	0	61	0	6658	0	6597	0.0	0.0
chr21	ANKRD20A11P	13927334	13927447	0	114	0	4871	0	4757	0.0	0.0
chr21	LIPI	14166361	14166451	0	91	0	1755	0	1664	0.0	0.0
chr21	SAMSN1	14523270	14523394	0	125	0	5206	0	5081	0.0	0.0
chr21	AF127936.1	14750862	14750909	0	48	35	4958	35	4910	0.0	0.007128309572301426
chr21	AF127936.1	14753323	14753394	0	72	35	4958	35	4886	0.0	0.0071633237822349575
chr21	NRIP1	15014343	15014466	0	124	102	8505	102	8381	0.0	0.012170385395537525
chr21	NRIP1	15043494	15043574	0	81	102	8505	102	8424	0.0	0.012108262108262107
chr21	AJ009632.2	15394472	15394506	0	35	22574	18447	22574	18412	0.0	1.2260482294155985
chr21	AJ009632.2	15513864	15513934	0	71	22574	18447	22574	18376	0.0	1.22845015237266
chr21	AJ009632.2	15393970	15394049	0	80	22574	18447	22574	18367	0.0	1.229052104317526
chr21	AJ009632.2	15397888	15397984	0	97	22574	18447	22574	18350	0.0	1.230190735694823
chr21	AJ009632.2	15385621	15385689	0	69	22574	18447	22574	18378	0.0	1.2283164653389922
chr21	AJ009632.2	15383028	15383173	0	146	22574	18447	22574	18301	0.0	1.2334845090432216
chr21	AJ009632.2	15441777	15441847	0	71	22574	18447	22574	18376	0.0	1.22845015237266
chr21	AJ009632.2	15571191	15571356	0	166	22574	18447	22574	18281	0.0	1.2348339806356325
chr21	AJ009632.2	15573972	15574034	0	63	22574	18447	22574	18384	0.0	1.2279155787641427
chr21	BTG3	17604144	17604276	0	133	0	2311	0	2178	0.0	0.0
chr21	BTG3	17611656	17611774	0	119	0	2311	0	2192	0.0	0.0
chr21	C21ORF91-OT1	17785547	17785612	0	66	0	1005	0	939	0.0	0.0
chr21	C21ORF91	17795207	17795270	0	64	0	2406	0	2342	0.0	0.0
chr21	TMPRSS15	18379282	18379318	0	37	1071	4390	1071	4353	0.0	0.24603721571330117
chr21	TMPRSS15	18380539	18380584	0	46	1071	4390	1071	4344	0.0	0.24654696132596685
chr21	MIR548XHG	18563314	18563372	0	59	0	2746	0	2687	0.0	0.0
chr21	MIR548XHG	18752747	18753116	0	370	0	2746	0	2376	0.0	0.0
chr21	LINC00320	20782306	20782446	0	141	378	16661	378	16520	0.0	0.02288135593220339
chr21	LINC00320	20743615	20743833	0	219	378	16661	378	16442	0.0	0.022989903904634474
chr21	LINC00320	20757310	20757417	0	108	378	16661	378	16553	0.0	0.02283573974506132
chr21	LINC00320	20786035	20786088	0	54	378	16661	378	16607	0.0	0.022761486120310714
chr21	LINC00320	20782249	20782446	0	198	378	16661	378	16463	0.0	0.0229605782664156
chr21	LINC00320	20778642	20778762	0	121	378	16661	378	16540	0.0	0.022853688029020557
chr21	LINC00320	20778642	20778796	0	155	378	16661	378	16506	0.0	0.022900763358778626
chr21	LINC00320	20780810	20780907	0	98	378	16661	378	16563	0.0	0.022821952544828834
chr21	LINC00320	20786035	20786111	0	77	378	16661	378	16584	0.0	0.022793053545586108
chr21	LINC00320	20778183	20778344	0	162	378	16661	378	16499	0.0	0.022910479422995334
chr21	LINC00320	20757218	20757417	0	200	378	16661	378	16461	0.0	0.022963367960634227
chr21	LINC00320	20783271	20783409	0	139	378	16661	378	16522	0.0	0.02287858612758746
chr21	LINC01687	22032384	22032505	0	122	0	3693	0	3571	0.0	0.0
chr21	LINC01687	22042944	22043087	0	144	0	3693	0	3549	0.0	0.0
chr21	AP000470.1	24182692	24182777	0	86	0	1137	0	1051	0.0	0.0
chr21	LINC00158	25388913	25389082	0	170	0	4142	0	3972	0.0	0.0
chr21	LINC00158	25424553	25424649	0	97	0	4142	0	4045	0.0	0.0
chr21	LINC00158	25396448	25396684	0	237	0	4142	0	3905	0.0	0.0
chr21	LINC00158	25420707	25420800	0	94	0	4142	0	4048	0.0	0.0
chr21	LINC00158	25421508	25421775	0	268	0	4142	0	3874	0.0	0.0
chr21	LINC00158	25428890	25428959	0	70	0	4142	0	4072	0.0	0.0
chr21	LINC00158	25428890	25429030	0	141	0	4142	0	4001	0.0	0.0
chr21	MRPL39	25587700	25587789	0	90	0	1210	0	1120	0.0	0.0
chr21	ATP5PF	25734332	25734375	0	44	0	1583	0	1539	0.0	0.0
chr21	APP	25905023	25905077	0	55	0	5908	0	5853	0.0	0.0
chr21	APP	26111978	26112146	0	169	0	5908	0	5739	0.0	0.0
chr21	APP	25997359	25997416	0	58	0	5908	0	5850	0.0	0.0
chr21	APP	26000014	26000182	0	169	0	5908	0	5739	0.0	0.0
chr21	ADAMTS1	26840997	26841165	0	169	0	7313	0	7144	0.0	0.0
chr21	ADAMTS5	26939811	26939955	642	145	35290	9774	34648	9629	4.427586206896552	3.598296811714612
chr21	LINC01695	28167225	28167319	0	95	139960	5328	139960	5233	0.0	26.7456525893369
chr21	LINC01695	28217177	28217347	6219	171	139960	5328	133741	5157	36.36842105263158	25.933876284661626
chr21	N6AMT1	28879869	28879953	0	85	51	4871	51	4786	0.0	0.01065608023401588
chr21	LTN1	28967601	28967973	0	373	1245	8909	1245	8536	0.0	0.14585285848172447
chr21	RWDD2B	29008239	29008307	0	69	39	3266	39	3197	0.0	0.012198936502971536
chr21	CCT8	29064967	29065105	0	139	0	3204	0	3065	0.0	0.0
chr21	CCT8	29069422	29069502	0	81	0	3204	0	3123	0.0	0.0
chr21	GRIK1	29537797	29537884	0	88	6529	4262	6529	4174	0.0	1.56420699568759
chr21	GRIK1	29596525	29596570	0	46	6529	4262	6529	4216	0.0	1.5486242884250474
chr21	TIAM1	31202907	31203012	0	106	649	9246	649	9140	0.0	0.07100656455142232
chr21	TIAM1	31213397	31213472	0	76	649	9246	649	9170	0.0	0.07077426390403489
chr21	SCAF4	31705422	31705467	0	46	0	4942	0	4896	0.0	0.0
chr21	LINC00159	32083473	32083617	0	145	40	1514	40	1369	0.0	0.029218407596785977
chr21	CFAP298-TCP10L	32505636	32505734	0	99	25849	19230	25849	19131	0.0	1.3511578067011656
chr21	CFAP298-TCP10L	32582199	32582415	2973	217	25849	19230	22876	19013	13.700460829493087	1.2031767737863568
chr21	CFAP298-TCP10L	32603160	32603292	0	133	25849	19230	25849	19097	0.0	1.3535633869194115
chr21	CFAP298-TCP10L	32587312	32587477	0	166	25849	19230	25849	19064	0.0	1.3559064204783886
chr21	CFAP298-TCP10L	32607648	32607716	0	69	25849	19230	25849	19161	0.0	1.3490423255571213
chr21	CFAP298-TCP10L	32572507	32572595	0	89	25849	19230	25849	19141	0.0	1.3504519095136096
chr21	CFAP298-TCP10L	32574095	32574124	0	30	25849	19230	25849	19200	0.0	1.3463020833333332
chr21	CFAP298-TCP10L	32567940	32568079	0	140	25849	19230	25849	19090	0.0	1.354059717129387
chr21	CFAP298-TCP10L	32573283	32574676	0	1394	25849	19230	25849	17836	0.0	1.4492599237497197
chr21	CFAP298-TCP10L	32572491	32572595	0	105	25849	19230	25849	19125	0.0	1.3515816993464052
chr21	CFAP298-TCP10L	32584160	32584305	0	146	25849	19230	25849	19084	0.0	1.3544854328233076
chr21	CFAP298-TCP10L	32575376	32576923	2016	1548	25849	19230	23833	17682	1.302325581395349	1.3478678882479358
chr21	CFAP298-TCP10L	32602271	32602367	0	97	25849	19230	25849	19133	0.0	1.351016568232896
chr21	SYNJ1	32634860	32634884	0	25	7891	8097	7891	8072	0.0	0.9775768087215064
chr21	SYNJ1	32676331	32676355	0	25	7891	8097	7891	8072	0.0	0.9775768087215064
chr21	SYNJ1	32643409	32643457	0	49	7891	8097	7891	8048	0.0	0.9804920477137177
chr21	SYNJ1	32634860	32634881	0	22	7891	8097	7891	8075	0.0	0.9772136222910217
chr21	PAXBP1	32750916	32751032	0	117	1060	6180	1060	6063	0.0	0.17483094177799768
chr21	C21ORF62	32807641	32807716	0	76	2018	1113	2018	1037	0.0	1.9459980713596914
chr21	C21ORF62	32810573	32810654	102	82	2018	1113	1916	1031	1.2439024390243902	1.8583899127061105
chr21	TMEM50B	33456003	33456097	0	95	226	4429	226	4334	0.0	0.05214582371942778
chr21	GART	33529566	33529768	0	203	936	6725	936	6522	0.0	0.14351425942962281
chr21	DONSON	33579349	33579562	0	214	0	2762	0	2548	0.0	0.0
chr21	DONSON	33583487	33583666	0	180	0	2762	0	2582	0.0	0.0
chr21	DONSON	33584589	33584726	0	138	0	2762	0	2624	0.0	0.0
chr21	DONSON	33587521	33587602	0	82	0	2762	0	2680	0.0	0.0
chr21	DONSON	33579349	33579417	0	69	0	2762	0	2693	0.0	0.0
chr21	DONSON	33584589	33584768	0	180	0	2762	0	2582	0.0	0.0
chr21	DONSON	33582164	33582246	0	83	0	2762	0	2679	0.0	0.0
chr21	ATP5PO	33909081	33909211	0	131	210	1528	210	1397	0.0	0.15032211882605584
chr21	CRYZL1	33597279	33597401	0	123	78518	5121	78518	4998	0.0	15.709883953581432
chr21	CRYZL1	33616705	33616750	0	46	78518	5121	78518	5075	0.0	15.471527093596059
chr21	CRYZL1	33631485	33631557	0	73	78518	5121	78518	5048	0.0	15.554278922345484
chr21	CRYZL1	33613537	33613606	0	70	78518	5121	78518	5051	0.0	15.54504058602257
chr21	CRYZL1	33641178	33641305	43582	128	78518	5121	34936	4993	340.484375	6.996995794111757
chr21	CRYZL1	33631485	33631527	0	43	78518	5121	78518	5078	0.0	15.462386766443482
chr21	ATP5PO	33906448	33906500	177	53	210	1528	33	1475	3.339622641509434	0.022372881355932205
chr21	ATP5PO	33906727	33906794	0	68	210	1528	210	1460	0.0	0.14383561643835616
chr21	ATP5PO	33906725	33906821	0	97	210	1528	210	1431	0.0	0.14675052410901468
chr21	KCNE1	34458653	34458764	0	112	0	4010	0	3898	0.0	0.0
chr21	KCNE1	34458653	34458736	0	84	0	4010	0	3926	0.0	0.0
chr21	RCAN1	34525087	34525608	0	522	3132	6537	3132	6015	0.0	0.5206982543640898
chr21	RUNX1	34834409	34834601	1513	193	217102	15480	215589	15287	7.839378238341969	14.102767056976516
chr21	RUNX1	34892924	34892963	0	40	217102	15480	217102	15440	0.0	14.0610103626943
chr21	RUNX1	34886842	34887096	728	255	217102	15480	216374	15225	2.854901960784314	14.211756978653531
chr21	SETD4	36048307	36048396	0	90	0	6423	0	6333	0.0	0.0
chr21	SETD4	36057383	36057477	0	95	0	6423	0	6328	0.0	0.0
chr21	CBR3-AS1	36146255	36146355	0	101	0	8894	0	8793	0.0	0.0
chr21	CBR3-AS1	36133686	36133761	0	76	0	8894	0	8818	0.0	0.0
chr21	CBR3-AS1	36137093	36137176	0	84	0	8894	0	8810	0.0	0.0
chr21	CBR3-AS1	36137093	36137308	0	216	0	8894	0	8678	0.0	0.0
chr21	CBR3-AS1	36137093	36137229	0	137	0	8894	0	8757	0.0	0.0
chr21	CBR3-AS1	36144978	36145076	0	99	0	8894	0	8795	0.0	0.0
chr21	CLDN14	36477373	36477563	0	191	0	2389	0	2198	0.0	0.0
chr21	HLCS	36946008	36946154	0	147	0	10535	0	10388	0.0	0.0
chr21	HLCS	36947332	36948287	0	956	0	10535	0	9579	0.0	0.0
chr21	HLCS	36948165	36948287	0	123	0	10535	0	10412	0.0	0.0
chr21	PIGP	37069551	37069624	0	74	0	4217	0	4143	0.0	0.0
chr21	PIGP	37072144	37072310	0	167	0	4217	0	4050	0.0	0.0
chr21	VPS26C	37240495	37240639	0	145	0	8542	0	8397	0.0	0.0
chr21	VPS26C	37233361	37233442	0	82	0	8542	0	8460	0.0	0.0
chr21	ERG	38445403	38445621	609	219	7247	7601	6638	7382	2.780821917808219	0.8992143050663777
chr21	ERG	38392375	38392444	0	70	7247	7601	7247	7531	0.0	0.9622892046209003
chr21	ERG	38400573	38400645	0	73	7247	7601	7247	7528	0.0	0.9626726886291179
chr21	AP001042.1	38893960	38894285	0	326	69893	10133	69893	9807	0.0	7.126848169674722
chr21	AP001042.1	38880591	38880708	75	118	69893	10133	69818	10015	0.635593220338983	6.9713429855217175
chr21	AP001042.1	38904229	38904483	0	255	69893	10133	69893	9878	0.0	7.075622595667139
chr21	AP001042.1	38920741	38920839	0	99	69893	10133	69893	10034	0.0	6.965616902531393
chr21	AF064858.1	38990826	38991024	0	199	0	6658	0	6459	0.0	0.0
chr21	AF064858.1	39008101	39008231	0	131	0	6658	0	6527	0.0	0.0
chr21	PSMG1	39179923	39179986	0	64	0	2159	0	2095	0.0	0.0
chr21	PSMG1	39181771	39181878	0	108	0	2159	0	2051	0.0	0.0
chr21	BRWD1	39210785	39210929	0	145	12	16239	12	16094	0.0	0.000745619485522555
chr21	BRWD1	39247700	39247832	0	133	12	16239	12	16106	0.0	0.0007450639513224885
chr21	BRWD1	39255644	39255828	0	185	12	16239	12	16054	0.0	0.0007474772642332129
chr21	BRWD1	39210865	39210929	0	65	12	16239	12	16174	0.0	0.0007419314949919624
chr21	BRWD1	39255664	39255828	0	165	12	16239	12	16074	0.0	0.0007465472191116088
chr21	HMGN1	39345829	39345958	0	130	51	4327	51	4197	0.0	0.012151536812008578
chr21	HMGN1	39348421	39348451	0	31	51	4327	51	4296	0.0	0.011871508379888268
chr21	HMGN1	39347378	39347478	0	101	51	4327	51	4226	0.0	0.012068149550402271
chr21	HMGN1	39347378	39347483	0	106	51	4327	51	4221	0.0	0.012082444918265814
chr21	HMGN1	39347113	39347292	0	180	51	4327	51	4147	0.0	0.012298046780805401
chr21	HMGN1	39347915	39347952	0	38	51	4327	51	4289	0.0	0.011890883655863837
chr21	HMGN1	39347246	39347292	0	47	51	4327	51	4280	0.0	0.01191588785046729
chr21	LCA5L	39428171	39428503	0	333	0	4442	0	4109	0.0	0.0
chr21	LCA5L	39435419	39435573	0	155	0	4442	0	4287	0.0	0.0
chr21	LCA5L	39444134	39444201	0	68	0	4442	0	4374	0.0	0.0
chr21	LCA5L	39436096	39436167	0	72	0	4442	0	4370	0.0	0.0
chr21	LCA5L	39444643	39444745	0	103	0	4442	0	4339	0.0	0.0
chr21	LCA5L	39435419	39435542	0	124	0	4442	0	4318	0.0	0.0
chr21	LCA5L	39438683	39438718	0	36	0	4442	0	4406	0.0	0.0
chr21	LCA5L	39439633	39439773	0	141	0	4442	0	4301	0.0	0.0
chr21	B3GALT5-AS1	39601418	39601543	0	126	0	6066	0	5940	0.0	0.0
chr21	B3GALT5-AS1	39599340	39600279	0	940	0	6066	0	5126	0.0	0.0
chr21	LINC00323	41147348	41147499	0	152	357	2574	357	2422	0.0	0.14739884393063585
chr21	LINC00323	41145076	41145335	0	260	357	2574	357	2314	0.0	0.15427830596369924
chr21	PLAC4	41180471	41180573	0	103	0	4468	0	4365	0.0	0.0
chr21	PLAC4	41182149	41182245	0	97	0	4468	0	4371	0.0	0.0
chr21	TMPRSS2	41488393	41488513	0	121	0	6341	0	6220	0.0	0.0
chr21	TMPRSS2	41494355	41494578	0	224	0	6341	0	6117	0.0	0.0
chr21	TMPRSS2	41477346	41477462	0	117	0	6341	0	6224	0.0	0.0
chr21	TMPRSS2	41494479	41494578	0	100	0	6341	0	6241	0.0	0.0
chr21	TMPRSS2	41489506	41489593	0	88	0	6341	0	6253	0.0	0.0
chr21	TMPRSS2	41498118	41498189	0	72	0	6341	0	6269	0.0	0.0
chr21	LINC00479	41713855	41713936	0	82	0	1003	0	921	0.0	0.0
chr21	PRDM15	41823317	41823449	0	133	231	11221	231	11088	0.0	0.020833333333333332
chr21	PRDM15	41834504	41834564	0	61	231	11221	231	11160	0.0	0.020698924731182795
chr21	PRDM15	41859030	41859228	0	199	231	11221	231	11022	0.0	0.020958083832335328
chr21	ZBTB21	41992492	41994108	0	1617	153	8068	153	6451	0.0	0.02371725313904821
chr21	ZBTB21	42002896	42002961	0	66	153	8068	153	8002	0.0	0.019120219945013745
chr21	ZBTB21	42002349	42002503	0	155	153	8068	153	7913	0.0	0.019335271072917982
chr21	ZBTB21	42009466	42009597	0	132	153	8068	153	7936	0.0	0.019279233870967742
chr21	ZBTB21	42002349	42002563	0	215	153	8068	153	7853	0.0	0.01948300012733987
chr21	RSPH1	42492965	42493079	0	115	0	1896	0	1781	0.0	0.0
chr21	CBS	43056057	43056099	0	43	204	6280	204	6237	0.0	0.03270803270803271
chr21	U2AF1	43100452	43100519	0	68	357	7408	357	7340	0.0	0.04863760217983651
chr21	U2AF1	43101365	43101432	0	68	357	7408	357	7340	0.0	0.04863760217983651
chr21	LINC00313	43463339	43463489	0	151	1915	3377	1915	3226	0.0	0.5936143831370118
chr21	LINC00313	43462457	43462525	0	69	1915	3377	1915	3308	0.0	0.5788996372430472
chr21	LINC00313	43476539	43476751	0	213	1915	3377	1915	3164	0.0	0.6052465233881164
chr21	CSTB	43774657	43774759	0	103	0	2378	0	2275	0.0	0.0
chr21	AATBC	43806963	43807239	0	277	0	4099	0	3822	0.0	0.0
chr21	ICOSLG	44236866	44237217	82	352	1670	9348	1588	8996	0.23295454545454544	0.17652289906625165
chr21	DNMT3L	44260794	44260839	5899	46	26033	1872	20134	1826	128.2391304347826	11.026286966046003
chr21	TSPEAR	44690544	44690606	0	63	26287	4477	26287	4414	0.0	5.95536927956502
chr21	UBE2G2	44779143	44779216	0	74	0	6326	0	6252	0.0	0.0
chr21	UBE2G2	44801283	44801398	0	116	0	6326	0	6210	0.0	0.0
chr21	UBE2G2	44774566	44774741	0	176	0	6326	0	6150	0.0	0.0
chr21	PTTG1IP	44861162	44861271	321	110	3468	3546	3147	3436	2.918181818181818	0.9158905704307334
chr21	ITGB2	44903364	44903535	207	172	8147	6221	7940	6049	1.2034883720930232	1.3126136551496115
chr21	ITGB2	44920820	44921050	0	231	8147	6221	8147	5990	0.0	1.3601001669449082
chr21	ITGB2	44898541	44898613	0	73	8147	6221	8147	6148	0.0	1.3251463890696162
chr21	ITGB2	44920820	44920962	0	143	8147	6221	8147	6078	0.0	1.3404080289568938
chr21	ITGB2	44908073	44908182	51	110	8147	6221	8096	6111	0.4636363636363636	1.3248240877106856
chr21	LINC01547	44937538	44937682	153	145	3774	3203	3621	3058	1.0551724137931036	1.184107259646828
chr21	POFUT2	45266021	45266227	0	207	239	5242	239	5035	0.0	0.04746772591857001
chr21	POFUT2	45283382	45283527	0	146	239	5242	239	5096	0.0	0.04689952904238619
chr21	POFUT2	45285268	45285328	0	61	239	5242	239	5181	0.0	0.04613009071607798
chr21	POFUT2	45282803	45282938	0	136	239	5242	239	5106	0.0	0.04680767724245985
chr21	POFUT2	45282348	45282459	0	112	239	5242	239	5130	0.0	0.04658869395711501
chr21	SLC19A1	45543776	45543859	0	84	241704	8967	241704	8883	0.0	27.209726443768997
chr21	FTCD	46138879	46138923	0	45	23	3340	23	3295	0.0	0.006980273141122913
chr21	SPATC1L	46182623	46183774	102	1152	102	2338	0	1186	0.08854166666666667	0.0
chr21	LSS	46191065	46191235	167904	171	1830016	7259	1662112	7088	981.8947368421053	234.49661399548532
chr21	LSS	46191075	46191235	160400	161	1830016	7259	1669616	7098	996.2732919254659	235.2234432234432
chr21	C21ORF58	46301996	46302154	0	159	51	4107	51	3948	0.0	0.012917933130699088
chr21	C21ORF58	46318784	46318961	0	178	51	4107	51	3929	0.0	0.012980402137948587
chr21	S100B	46600281	46600375	2782	95	13615	1810	10833	1715	29.28421052631579	6.316618075801749
chr22	ANKRD62P1-PARP4P3	16673599	16673752	0	154	51	1190	51	1036	0.0	0.04922779922779923
chr22	GAB4	16969942	16970193	0	252	102	3152	102	2900	0.0	0.03517241379310345
chr22	GAB4	16987959	16988167	0	209	102	3152	102	2943	0.0	0.034658511722731905
chr22	GAB4	16987959	16988116	0	158	102	3152	102	2994	0.0	0.03406813627254509
chr22	GAB4	16969612	16970193	0	582	102	3152	102	2570	0.0	0.03968871595330739
chr22	HDHD5	17138549	17138738	0	190	102	3533	102	3343	0.0	0.03051151660185462
chr22	HDHD5	17149541	17149745	0	205	102	3533	102	3328	0.0	0.03064903846153846
chr22	ADA2	17189941	17190032	0	92	0	8720	0	8628	0.0	0.0
chr22	ADA2	17209355	17209723	0	369	0	8720	0	8351	0.0	0.0
chr22	ADA2	17209355	17209598	0	244	0	8720	0	8476	0.0	0.0
chr22	ADA2	17203853	17203889	0	37	0	8720	0	8683	0.0	0.0
chr22	ADA2	17209355	17209690	0	336	0	8720	0	8384	0.0	0.0
chr22	ATP6V1E1	17601091	17601181	0	91	68363	3153	68363	3062	0.0	22.326257348138473
chr22	ATP6V1E1	17619460	17619526	8506	67	68363	3153	59857	3086	126.95522388059702	19.396305897602073
chr22	ATP6V1E1	17619033	17619127	21423	95	68363	3153	46940	3058	225.50526315789475	15.349901896664486
chr22	BID	17743802	17744013	0	212	221	4429	221	4217	0.0	0.05240692435380603
chr22	BID	17750104	17750174	0	71	221	4429	221	4358	0.0	0.050711335474988524
chr22	BID	17740081	17740176	0	96	221	4429	221	4333	0.0	0.05100392337872144
chr22	MICAL3	17827643	17827781	0	139	571	22491	571	22352	0.0	0.025545812455261274
chr22	MICAL3	17899447	17899548	0	102	571	22491	571	22389	0.0	0.02550359551565501
chr22	MICAL3	17830066	17830154	0	89	571	22491	571	22402	0.0	0.02548879564324614
chr22	MICAL3	17803810	17803861	0	52	571	22491	571	22439	0.0	0.025446766789963902
chr22	MICAL3	17812506	17812557	0	52	571	22491	571	22439	0.0	0.025446766789963902
chr22	MICAL3	17793728	17793794	0	67	571	22491	571	22424	0.0	0.02546378879771673
chr22	MICAL3	17826453	17826516	0	64	571	22491	571	22427	0.0	0.02546038257457529
chr22	MICAL3	17884274	17884358	61	85	571	22491	510	22406	0.7176470588235294	0.02276176024279211
chr22	FAM230J	18368390	18370713	95085	2324	98375	4160	3290	1836	40.91437177280551	1.7919389978213507
chr22	PRODH	18923114	18923179	0	66	1123	7184	1123	7118	0.0	0.15776903624613656
chr22	PRODH	18930989	18931198	766	210	1123	7184	357	6974	3.6476190476190475	0.051190134786349296
chr22	PRODH	18936014	18936327	0	314	1123	7184	1123	6870	0.0	0.16346433770014557
chr22	DGCR2	19089367	19089490	0	124	4374	5617	4374	5493	0.0	0.7962861824139814
chr22	DGCR2	19060565	19060955	144	391	4374	5617	4230	5226	0.36828644501278773	0.8094144661308841
chr22	CLTCL1	19187980	19188091	51	112	12733	6720	12682	6608	0.45535714285714285	1.9191888619854722
chr22	CLTCL1	19208153	19208311	0	159	12733	6720	12733	6561	0.0	1.9407102575826856
chr22	CLTCL1	19225452	19225633	0	182	12733	6720	12733	6538	0.0	1.9475374732334048
chr22	CLTCL1	19187557	19187728	0	172	12733	6720	12733	6548	0.0	1.9445632254123397
chr22	CLTCL1	19184395	19184536	702	142	12733	6720	12031	6578	4.943661971830986	1.8289753724536333
chr22	CLTCL1	19257804	19257867	0	64	12733	6720	12733	6656	0.0	1.9130108173076923
chr22	HIRA	19355759	19355865	0	107	52500	4326	52500	4219	0.0	12.44370703958284
chr22	UFD1	19475067	19475100	0	34	193894	7600	193894	7566	0.0	25.627015596087762
chr22	UFD1	19475469	19475602	0	134	193894	7600	193894	7466	0.0	25.9702652022502
chr22	UFD1	19471686	19471808	0	123	193894	7600	193894	7477	0.0	25.93205831215728
chr22	GNB1L	19820597	19820723	0	127	1627	1660	1627	1533	0.0	1.061317677756034
chr22	GNB1L	19821227	19821375	51	149	1627	1660	1576	1511	0.3422818791946309	1.043017868960953
chr22	TXNRD2	19880621	19880717	102	97	13934	6767	13832	6670	1.0515463917525774	2.0737631184407794
chr22	TXNRD2	19919542	19919599	39	58	13934	6767	13895	6709	0.6724137931034483	2.071098524370249
chr22	TXNRD2	19931029	19931095	945	67	13934	6767	12989	6700	14.104477611940299	1.9386567164179105
chr22	TXNRD2	19931029	19931098	969	70	13934	6767	12965	6697	13.842857142857143	1.9359414663282066
chr22	TXNRD2	19880855	19880945	357	91	13934	6767	13577	6676	3.923076923076923	2.0337028160575197
chr22	ARVCF	19971215	19971335	425	121	2703	5658	2278	5537	3.512396694214876	0.4114141231713925
chr22	ARVCF	19976705	19976723	0	19	2703	5658	2703	5639	0.0	0.4793403085653485
chr22	AC006547.1	20067013	20067249	0	237	11859	2243	11859	2006	0.0	5.911764705882353
chr22	AC006547.1	20069042	20069164	2592	123	11859	2243	9267	2120	21.073170731707318	4.371226415094339
chr22	DGCR6L	20316118	20316219	0	102	126	1197	126	1095	0.0	0.11506849315068493
chr22	KLHL22	20488984	20489244	0	261	255	4144	255	3883	0.0	0.06567087303631212
chr22	KLHL22	20488984	20489212	0	229	255	4144	255	3915	0.0	0.06513409961685823
chr22	KLHL22	20493147	20493217	0	71	255	4144	255	4073	0.0	0.06260741468205254
chr22	KLHL22	20471349	20471515	0	167	255	4144	255	3977	0.0	0.06411868242393765
chr22	SMPD4P1	20621262	20621417	0	156	0	3882	0	3726	0.0	0.0
chr22	SMPD4P1	20624098	20624185	0	88	0	3882	0	3794	0.0	0.0
chr22	TUBA3FP	21013041	21013184	0	144	296	2126	296	1982	0.0	0.14934409687184663
chr22	TUBA3FP	21012526	21012658	0	133	296	2126	296	1993	0.0	0.14851981936778724
chr22	FAM230H	21307558	21309524	169654	1967	302799	5886	133145	3919	86.25012709710218	33.97422811941822
chr22	FAM230H	21321591	21321719	0	129	302799	5886	302799	5757	0.0	52.596664929650856
chr22	PI4KAP2	21476643	21476764	0	122	5401	6796	5401	6674	0.0	0.8092598142043752
chr22	YDJC	21629009	21629187	0	179	0	1668	0	1489	0.0	0.0
chr22	MAPK1	21788256	21788388	0	133	282	6188	282	6055	0.0	0.04657308009909166
chr22	TOP3B	21970979	21971061	373	83	425353	6344	424980	6261	4.493975903614458	67.87733588883565
chr22	TOP3B	21975904	21975953	15530	50	425353	6344	409823	6294	310.6	65.11328249126151
chr22	TOP3B	21982413	21982449	13517	37	425353	6344	411836	6307	365.3243243243243	65.29824005073728
chr22	TOP3B	21975980	21976187	157925	208	425353	6344	267428	6136	759.2548076923077	43.583441981747065
chr22	TOP3B	21975904	21976187	196781	284	425353	6344	228572	6060	692.8908450704225	37.71815181518152
chr22	PRAME	22556811	22556909	0	99	2	3814	2	3715	0.0	0.0005383580080753701
chr22	PRAME	22556811	22556930	0	120	2	3814	2	3694	0.0	0.0005414185165132648
chr22	PRAME	22556811	22556977	0	167	2	3814	2	3647	0.0	0.0005483959418700301
chr22	PRAME	22556811	22557086	0	276	2	3814	2	3538	0.0	0.0005652911249293386
chr22	PRAME	22552808	22552951	0	144	2	3814	2	3670	0.0	0.0005449591280653951
chr22	CES5AP1	23368779	23368884	0	106	0	1570	0	1464	0.0	0.0
chr22	ZDHHC8P1	23402036	23402155	0	120	0	3277	0	3157	0.0	0.0
chr22	ZDHHC8P1	23401840	23401953	0	114	0	3277	0	3163	0.0	0.0
chr22	IGLL1	23574966	23575082	0	117	357	901	357	784	0.0	0.45535714285714285
chr22	IGLL1	23574966	23575085	0	120	357	901	357	781	0.0	0.45710627400768244
chr22	GUSBP11	23683724	23683867	0	144	10883	7702	10883	7558	0.0	1.4399311987298227
chr22	GUSBP11	23686830	23686995	0	166	10883	7702	10883	7536	0.0	1.4441348195329087
chr22	GUSBP11	23640307	23640423	237	117	10883	7702	10646	7585	2.0256410256410255	1.4035596572181939
chr22	GUSBP11	23700725	23700845	0	121	10883	7702	10883	7581	0.0	1.4355625906872445
chr22	GUSBP11	23686837	23686995	0	159	10883	7702	10883	7543	0.0	1.4427946440408326
chr22	CHCHD10	23767373	23767593	0	221	0	893	0	672	0.0	0.0
chr22	CHCHD10	23767373	23767540	0	168	0	893	0	725	0.0	0.0
chr22	GSTT4	24001174	24001325	4604	152	8235	1112	3631	960	30.289473684210527	3.7822916666666666
chr22	GSTT4	24004180	24004322	51	143	8235	1112	8184	969	0.35664335664335667	8.445820433436532
chr22	GGT5	24233873	24234004	1148	132	24047	2603	22899	2471	8.696969696969697	9.267098340752732
chr22	GGT5	24220491	24220584	523	94	24047	2603	23524	2509	5.5638297872340425	9.375846950976484
chr22	GGT5	24233497	24233593	777	97	24047	2603	23270	2506	8.010309278350515	9.285714285714286
chr22	ADORA2A-AS1	24460452	24460771	23623	320	48243	4042	24620	3722	73.821875	6.61472326706072
chr22	ADORA2A-AS1	24471767	24471895	0	129	48243	4042	48243	3913	0.0	12.32890365448505
chr22	ADORA2A-AS1	24439293	24439567	18821	275	48243	4042	29422	3767	68.44	7.810459251393682
chr22	ADORA2A-AS1	24452210	24452328	0	119	48243	4042	48243	3923	0.0	12.297476421106296
chr22	GUCD1	24543841	24544083	0	243	3172	4101	3172	3858	0.0	0.8221876620010368
chr22	GUCD1	24554948	24555136	0	189	3172	4101	3172	3912	0.0	0.810838445807771
chr22	LRRC75B	24588678	24589265	35	588	255	2629	220	2041	0.05952380952380952	0.10779029887310142
chr22	LRRC75B	24592216	24592423	0	208	255	2629	255	2421	0.0	0.10532837670384139
chr22	PIWIL3	24761878	24761961	0	84	2033	3826	2033	3742	0.0	0.5432923570283271
chr22	PIWIL3	24769670	24769789	499	120	2033	3826	1534	3706	4.158333333333333	0.4139233675121425
chr22	LRP5L	25361208	25361319	0	112	204	3674	204	3562	0.0	0.057271195957327346
chr22	MYO18B-AS1	25895110	25895268	0	159	4763	5997	4763	5838	0.0	0.815861596437136
chr22	MYO18B-AS1	25898383	25898441	0	59	4763	5997	4763	5938	0.0	0.8021219265746042
chr22	MYO18B-AS1	25900269	25900329	0	61	4763	5997	4763	5936	0.0	0.8023921832884097
chr22	MYO18B-AS1	25895337	25895498	0	162	4763	5997	4763	5835	0.0	0.8162810625535561
chr22	MYO18B-AS1	25895110	25895370	0	261	4763	5997	4763	5736	0.0	0.8303695955369595
chr22	MYO18B-AS1	25899715	25899884	0	170	4763	5997	4763	5827	0.0	0.817401750471941
chr22	HPS4	26479264	26479355	0	92	0	7752	0	7660	0.0	0.0
chr22	HPS4	26466050	26466104	0	55	0	7752	0	7697	0.0	0.0
chr22	HPS4	26471212	26471388	0	177	0	7752	0	7575	0.0	0.0
chr22	HPS4	26471212	26471288	0	77	0	7752	0	7675	0.0	0.0
chr22	TFIP11	26510616	26510702	0	87	0	5452	0	5365	0.0	0.0
chr22	TFIP11	26511118	26511195	0	78	0	5452	0	5374	0.0	0.0
chr22	TFIP11	26511118	26511153	0	36	0	5452	0	5416	0.0	0.0
chr22	TFIP11	26510616	26510692	0	77	0	5452	0	5375	0.0	0.0
chr22	TFIP11	26511118	26511317	0	200	0	5452	0	5252	0.0	0.0
chr22	TPST2	26544603	26544675	0	73	0	6926	0	6853	0.0	0.0
chr22	TPST2	26543107	26543277	0	171	0	6926	0	6755	0.0	0.0
chr22	TPST2	26547499	26547618	0	120	0	6926	0	6806	0.0	0.0
chr22	PITPNB	27854853	27854939	0	87	0	5142	0	5055	0.0	0.0
chr22	TTC28	27990788	27990812	0	25	815	12670	815	12645	0.0	0.06445235270858046
chr22	CHEK2	28696900	28696987	0	88	190	4425	190	4337	0.0	0.043809084620705555
chr22	CHEK2	28703504	28703566	0	63	190	4425	190	4362	0.0	0.04355800091701054
chr22	CHEK2	28719394	28719485	0	92	190	4425	190	4333	0.0	0.043849526886683594
chr22	CHEK2	28734402	28734727	51	326	190	4425	139	4099	0.15644171779141106	0.033910709929251034
chr22	CHEK2	28721517	28721631	0	115	190	4425	190	4310	0.0	0.04408352668213457
chr22	CHEK2	28737884	28738038	0	155	190	4425	190	4270	0.0	0.04449648711943794
chr22	CHEK2	28730419	28730548	0	130	190	4425	190	4295	0.0	0.04423748544819558
chr22	CHEK2	28738081	28738197	0	117	190	4425	190	4308	0.0	0.04410399257195915
chr22	CHEK2	28730455	28730548	0	94	190	4425	190	4331	0.0	0.043869776033248674
chr22	AP1B1	29329711	29329720	0	10	1227	5928	1227	5918	0.0	0.20733355863467387
chr22	AP1B1	29339753	29339774	0	22	1227	5928	1227	5906	0.0	0.20775482560108363
chr22	RFPL1S	29472305	29472446	0	142	3386	3117	3386	2975	0.0	1.1381512605042017
chr22	RFPL1S	29472305	29472449	0	145	3386	3117	3386	2972	0.0	1.139300134589502
chr22	THOC5	29531830	29531963	0	134	2188	7903	2188	7769	0.0	0.281632127686961
chr22	THOC5	29550727	29550843	0	117	2188	7903	2188	7786	0.0	0.2810172103776008
chr22	THOC5	29528273	29528359	0	87	2188	7903	2188	7816	0.0	0.27993858751279427
chr22	THOC5	29531077	29531110	0	34	2188	7903	2188	7869	0.0	0.2780531198373364
chr22	NIPSNAP1	29580098	29580155	0	58	186	2996	186	2938	0.0	0.06330837304288632
chr22	NIPSNAP1	29564237	29564371	33	135	186	2996	153	2861	0.24444444444444444	0.05347780496329955
chr22	ASCC2	29832244	29832342	0	99	15791	5178	15791	5079	0.0	3.1090765898798978
chr22	ASCC2	29825621	29825780	0	160	15791	5178	15791	5018	0.0	3.1468712634515743
chr22	ASCC2	29827476	29827600	0	125	15791	5178	15791	5053	0.0	3.125074213338611
chr22	ASCC2	29834488	29834550	0	63	15791	5178	15791	5115	0.0	3.0871945259042035
chr22	ASCC2	29833540	29833614	0	75	15791	5178	15791	5103	0.0	3.094454242602391
chr22	ASCC2	29836437	29836500	37	64	15791	5178	15754	5114	0.578125	3.08056315995307
chr22	HORMAD2-AS1	30040176	30040278	0	103	6951	1445	6951	1342	0.0	5.179582712369598
chr22	LIF	30244754	30244933	0	180	153	3874	153	3694	0.0	0.04141851651326475
chr22	OSM	30265001	30265144	0	144	51	2129	51	1985	0.0	0.025692695214105794
chr22	CASTOR1	30286262	30286376	0	115	51	2662	51	2547	0.0	0.020023557126030624
chr22	CASTOR1	30288705	30288776	0	72	51	2662	51	2590	0.0	0.019691119691119693
chr22	TBC1D10A	30292772	30292851	0	80	1494	4998	1494	4918	0.0	0.30378202521350145
chr22	CASTOR1	30287789	30287862	0	74	51	2662	51	2588	0.0	0.01970633693972179
chr22	TBC1D10A	30304530	30304630	0	101	1494	4998	1494	4897	0.0	0.3050847457627119
chr22	TBC1D10A	30304530	30304651	0	122	1494	4998	1494	4876	0.0	0.30639868744872845
chr22	TBC1D10A	30293158	30293319	0	162	1494	4998	1494	4836	0.0	0.30893300248138955
chr22	RNF215	30379481	30379622	0	142	32997	5055	32997	4913	0.0	6.716262975778546
chr22	RNF215	30379547	30379622	0	76	32997	5055	32997	4979	0.0	6.627234384414541
chr22	SEC14L3	30470211	30470255	0	45	0	3646	0	3601	0.0	0.0
chr22	SEC14L3	30471159	30471207	0	49	0	3646	0	3597	0.0	0.0
chr22	SEC14L3	30468788	30468958	0	171	0	3646	0	3475	0.0	0.0
chr22	SEC14L3	30471159	30471277	0	119	0	3646	0	3527	0.0	0.0
chr22	SEC14L4	30495741	30495790	0	50	0	2154	0	2104	0.0	0.0
chr22	SEC14L6	30525349	30525519	0	171	0	3404	0	3233	0.0	0.0
chr22	GAL3ST1	30558278	30558388	0	111	0	3105	0	2994	0.0	0.0
chr22	GAL3ST1	30558259	30558388	0	130	0	3105	0	2975	0.0	0.0
chr22	GAL3ST1	30563229	30563278	0	50	0	3105	0	3055	0.0	0.0
chr22	GAL3ST1	30560276	30560418	0	143	0	3105	0	2962	0.0	0.0
chr22	GAL3ST1	30565076	30565201	0	126	0	3105	0	2979	0.0	0.0
chr22	DUSP18	30663012	30663260	0	249	510	2739	510	2490	0.0	0.20481927710843373
chr22	DUSP18	30663403	30664080	0	678	510	2739	510	2061	0.0	0.24745269286754004
chr22	DUSP18	30664954	30665121	0	168	510	2739	510	2571	0.0	0.1983663943990665
chr22	MORC2	30927529	30927803	0	275	8963	8653	8963	8378	0.0	1.0698257340654094
chr22	MORC2	30933693	30933777	0	85	8963	8653	8963	8568	0.0	1.0461017740429506
chr22	PIK3IP1	31289314	31289393	0	80	8623	3646	8623	3566	0.0	2.4181155356141333
chr22	PATZ1	31328786	31328924	10356	139	48303	5813	37947	5674	74.50359712230215	6.687874515333099
chr22	PATZ1	31328786	31328859	197	74	48303	5813	48106	5739	2.6621621621621623	8.382296567346227
chr22	EIF4ENIF1	31450288	31450360	0	73	496	5677	496	5604	0.0	0.08850820842255532
chr22	EIF4ENIF1	31446937	31447008	0	72	496	5677	496	5605	0.0	0.08849241748438894
chr22	PISD	31620552	31620713	0	162	9971	4943	9971	4781	0.0	2.0855469567036184
chr22	PISD	31650698	31650778	0	81	9971	4943	9971	4862	0.0	2.050802139037433
chr22	PISD	31628002	31628210	0	209	9971	4943	9971	4734	0.0	2.1062526404731727
chr22	PISD	31625762	31626016	2543	255	9971	4943	7428	4688	9.972549019607843	1.5844709897610922
chr22	PISD	31620552	31620599	0	48	9971	4943	9971	4895	0.0	2.036976506639428
chr22	PISD	31632182	31632291	0	110	9971	4943	9971	4833	0.0	2.063107800537968
chr22	PRR14L	31701655	31701762	102	108	14612	11816	14510	11708	0.9444444444444444	1.2393235394601982
chr22	PRR14L	31738386	31738911	10332	526	14612	11816	4280	11290	19.6425855513308	0.37909654561558903
chr22	C22ORF24	31927093	31927291	1668	199	6484	5555	4816	5356	8.381909547738694	0.8991784914115011
chr22	C22ORF24	31927098	31927310	1277	213	6484	5555	5207	5342	5.995305164319249	0.9747285660801198
chr22	C22ORF24	31927093	31927310	1687	218	6484	5555	4797	5337	7.738532110091743	0.8988195615514334
chr22	RFPL2	32194344	32194490	13	147	115	2941	102	2794	0.08843537414965986	0.03650680028632784
chr22	RFPL2	32194344	32194398	13	55	115	2941	102	2886	0.23636363636363636	0.035343035343035345
chr22	RFPL3S	32362971	32363058	0	88	204	6910	204	6822	0.0	0.02990325417766051
chr22	RFPL3S	32370898	32370941	0	44	204	6910	204	6866	0.0	0.029711622487620156
chr22	BPIFC	32432372	32432543	0	172	618330	2245	618330	2073	0.0	298.2778581765557
chr22	BPIFC	32461573	32461661	0	89	618330	2245	618330	2156	0.0	286.79499072356214
chr22	SYN3	32527917	32528005	0	89	0	10207	0	10118	0.0	0.0
chr22	LARGE1	33304228	33304507	51	280	635	14082	584	13802	0.18214285714285713	0.04231270830314447
chr22	LARGE1	33316084	33316248	0	165	635	14082	635	13917	0.0	0.04562764963713444
chr22	LARGE1	33337645	33337801	0	157	635	14082	635	13925	0.0	0.04560143626570916
chr22	LARGE1	33381918	33382044	0	127	635	14082	635	13955	0.0	0.04550340379792189
chr22	LARGE1	33283201	33283348	0	148	635	14082	635	13934	0.0	0.045571982201808525
chr22	LARGE1	33305531	33305625	0	95	635	14082	635	13987	0.0	0.04539929934939587
chr22	LARGE1	33761370	33761558	0	189	635	14082	635	13893	0.0	0.045706470884618156
chr22	LARGE1	33856739	33856802	0	64	635	14082	635	14018	0.0	0.04529890141246968
chr22	LARGE1	33291968	33293173	0	1206	635	14082	635	12876	0.0	0.04931655793724759
chr22	MB	35621965	35622096	0	132	0	2060	0	1928	0.0	0.0
chr22	RBFOX2	35778024	35778078	64	55	219287	10064	219223	10009	1.1636363636363636	21.902587671096015
chr22	RBFOX2	35756104	35756144	0	41	219287	10064	219287	10023	0.0	21.878379726628754
chr22	RBFOX2	35750425	35750457	0	33	219287	10064	219287	10031	0.0	21.860931113548002
chr22	RBFOX2	35752612	35752655	0	44	219287	10064	219287	10020	0.0	21.88493013972056
chr22	RBFOX2	35836319	35836439	0	121	219287	10064	219287	9943	0.0	22.054410137785375
chr22	APOL3	36149045	36149142	574	98	120451	5914	119877	5816	5.857142857142857	20.61158872077029
chr22	APOL3	36149258	36149371	364	114	120451	5914	120087	5800	3.192982456140351	20.704655172413794
chr22	APOL3	36149045	36149371	1798	327	120451	5914	118653	5587	5.4984709480122325	21.237336674422767
chr22	APOL3	36161483	36161546	26351	64	120451	5914	94100	5850	411.734375	16.085470085470085
chr22	APOL3	36156843	36157006	126	164	120451	5914	120325	5750	0.7682926829268293	20.92608695652174
chr22	APOL3	36149045	36149185	694	141	120451	5914	119757	5773	4.921985815602837	20.744327039667418
chr22	APOL3	36146139	36146408	1535	270	120451	5914	118916	5644	5.685185185185185	21.06945428773919
chr22	APOL3	36153284	36153423	262	140	120451	5914	120189	5774	1.8714285714285714	20.815552476619327
chr22	APOL3	36149770	36149964	495	195	120451	5914	119956	5719	2.5384615384615383	20.9749956286064
chr22	APOL4	36201992	36202055	0	64	1440	4268	1440	4204	0.0	0.3425309229305423
chr22	APOL4	36201699	36201888	0	190	1440	4268	1440	4078	0.0	0.35311427170181464
chr22	APOL4	36201699	36202055	0	357	1440	4268	1440	3911	0.0	0.3681922781897213
chr22	APOL4	36201699	36201796	0	98	1440	4268	1440	4170	0.0	0.34532374100719426
chr22	APOL4	36201699	36201841	0	143	1440	4268	1440	4125	0.0	0.3490909090909091
chr22	APOL4	36199555	36199608	0	54	1440	4268	1440	4214	0.0	0.34171808258187
chr22	APOL2	36237060	36237185	0	126	126768	3251	126768	3125	0.0	40.56576
chr22	APOL2	36234235	36234335	125566	101	126768	3251	1202	3150	1243.2277227722773	0.3815873015873016
chr22	MYH9	36364778	36364833	0	56	17890	8953	17890	8897	0.0	2.0107901539844892
chr22	TXN2	36468601	36468717	0	117	0	1656	0	1539	0.0	0.0
chr22	EIF3D	36526819	36526905	0	87	51	3779	51	3692	0.0	0.0138136511375948
chr22	IFT27	36760843	36760919	600	77	4455	3881	3855	3804	7.792207792207792	1.0134069400630914
chr22	IFT27	36767982	36768099	0	118	4455	3881	4455	3763	0.0	1.1838958277969704
chr22	PVALB	36811474	36811524	0	51	342418	1058	342418	1007	0.0	340.0377358490566
chr22	TMPRSS6	37068615	37068681	0	67	0	4253	0	4186	0.0	0.0
chr22	IL2RB	37161792	37161983	0	192	51	4633	51	4441	0.0	0.011483900022517451
chr22	C1QTNF6	37184336	37184437	0	102	4	3780	4	3678	0.0	0.001087547580206634
chr22	RAC2	37244113	37244202	0	90	0	2531	0	2441	0.0	0.0
chr22	MFNG	37472442	37472528	0	87	0	3033	0	2946	0.0	0.0
chr22	MFNG	37480720	37480769	0	50	0	3033	0	2983	0.0	0.0
chr22	ANKRD54	37832957	37833082	0	126	0	4400	0	4274	0.0	0.0
chr22	ANKRD54	37838499	37838598	0	100	0	4400	0	4300	0.0	0.0
chr22	ANKRD54	37840186	37840234	0	49	0	4400	0	4351	0.0	0.0
chr22	ANKRD54	37838499	37838593	0	95	0	4400	0	4305	0.0	0.0
chr22	C22ORF23	37951459	37951522	0	64	0	2290	0	2226	0.0	0.0
chr22	SOX10	37983356	37983868	153	513	2449	3734	2296	3221	0.2982456140350877	0.7128221049363551
chr22	BAIAP2L2	38085685	38085732	0	48	28407	2163	28407	2115	0.0	13.431205673758866
chr22	PLA2G6	38128268	38128430	292	163	23420	8089	23128	7926	1.7914110429447854	2.9179914206409285
chr22	PLA2G6	38139981	38140169	25	189	23420	8089	23395	7900	0.13227513227513227	2.961392405063291
chr22	PLA2G6	38143104	38143288	0	185	23420	8089	23420	7904	0.0	2.963056680161943
chr22	PLA2G6	38145437	38145653	0	217	23420	8089	23420	7872	0.0	2.97510162601626
chr22	PLA2G6	38114433	38114570	0	138	23420	8089	23420	7951	0.0	2.945541441328135
chr22	PLA2G6	38125638	38125691	1062	54	23420	8089	22358	8035	19.666666666666668	2.782576228998133
chr22	PLA2G6	38148492	38148623	0	132	23420	8089	23420	7957	0.0	2.9433203468643963
chr22	PLA2G6	38147349	38147475	51	127	23420	8089	23369	7962	0.4015748031496063	2.9350665661893998
chr22	PLA2G6	38114433	38114637	0	205	23420	8089	23420	7884	0.0	2.9705733130390666
chr22	PLA2G6	38116319	38116410	0	92	23420	8089	23420	7997	0.0	2.928598224334125
chr22	PLA2G6	38127406	38127458	168	53	23420	8089	23252	8036	3.169811320754717	2.8934793429566947
chr22	TMEM184B	38230668	38230744	232	77	57550	6174	57318	6097	3.012987012987013	9.401016893554207
chr22	TMEM184B	38246784	38246885	357	102	57550	6174	57193	6072	3.5	9.419137022397893
chr22	TMEM184B	38222641	38222662	0	22	57550	6174	57550	6152	0.0	9.354681404421326
chr22	TMEM184B	38246805	38246885	287	81	57550	6174	57263	6093	3.54320987654321	9.398161825045134
chr22	CSNK1E	38295386	38295447	0	62	17283	6057	17283	5995	0.0	2.882902418682235
chr22	TPTEP2	38347488	38347585	264	98	11720	3870	11456	3772	2.693877551020408	3.0371155885471897
chr22	TPTEP2	38369985	38370045	0	61	11720	3870	11720	3809	0.0	3.076923076923077
chr22	TPTEP2	38363053	38363104	34	52	11720	3870	11686	3818	0.6538461538461539	3.0607647983237296
chr22	DDX17	38489227	38489458	0	232	43114	8894	43114	8662	0.0	4.977372431309166
chr22	FAM227A	38639654	38639724	294	71	3223	3270	2929	3199	4.140845070422535	0.9155986245701782
chr22	JOSD1	38689295	38689424	8029	130	285791	4226	277762	4096	61.761538461538464	67.81298828125
chr22	SUN2	38750897	38751035	861	139	17420	6389	16559	6250	6.194244604316546	2.64944
chr22	SUN2	38754641	38754706	100	66	17420	6389	17320	6323	1.5151515151515151	2.7392060730665824
chr22	CBX7	39141370	39141436	228	67	226318	4555	226090	4488	3.4029850746268657	50.37655971479501
chr22	RPS19BP1	39530463	39530554	1333	92	36840	2963	35507	2871	14.48913043478261	12.367467781260885
chr22	MRTFA	40423535	40423685	0	151	409	7572	409	7421	0.0	0.05511386605578763
chr22	MRTFA	40594673	40594735	14	63	409	7572	395	7509	0.2222222222222222	0.05260354241576774
chr22	MRTFA	40519463	40519612	0	150	409	7572	409	7422	0.0	0.05510644031258421
chr22	SLC25A17	40794513	40794580	21	68	1668	3372	1647	3304	0.3088235294117647	0.4984866828087167
chr22	SLC25A17	40779757	40779894	0	138	1668	3372	1668	3234	0.0	0.5157699443413729
chr22	SLC25A17	40792524	40792676	21	153	1668	3372	1647	3219	0.13725490196078433	0.5116495806150979
chr22	SLC25A17	40776189	40776308	0	120	1668	3372	1668	3252	0.0	0.5129151291512916
chr22	SLC25A17	40799022	40799040	0	19	1668	3372	1668	3353	0.0	0.4974649567551446
chr22	SLC25A17	40797283	40797336	49	54	1668	3372	1619	3318	0.9074074074074074	0.48794454490657024
chr22	SLC25A17	40799022	40799083	252	62	1668	3372	1416	3310	4.064516129032258	0.42779456193353477
chr22	SLC25A17	40784512	40784604	183	93	1668	3372	1485	3279	1.967741935483871	0.45288197621225984
chr22	SLC25A17	40797253	40797336	79	84	1668	3372	1589	3288	0.9404761904761905	0.48327250608272504
chr22	SLC25A17	40799560	40799671	133	112	1668	3372	1535	3260	1.1875	0.4708588957055215
chr22	ST13	40832568	40832671	0	104	34852	3646	34852	3542	0.0	9.839638622247318
chr22	ST13	40832086	40832216	0	131	34852	3646	34852	3515	0.0	9.915220483641535
chr22	L3MBTL2-AS1	41213629	41214703	8896	1075	14834	4463	5938	3388	8.275348837209302	1.7526564344746163
chr22	L3MBTL2-AS1	41213795	41214703	8393	909	14834	4463	6441	3554	9.233223322332233	1.8123241418120428
chr22	RANGAP1	41261445	41261580	98	136	28379	5891	28281	5755	0.7205882352941176	4.914161598609905
chr22	POLR3H	41532658	41532745	0	88	34149	6368	34149	6280	0.0	5.437738853503185
chr22	POLR3H	41540698	41540795	0	98	34149	6368	34149	6270	0.0	5.446411483253589
chr22	POLR3H	41532603	41532745	0	143	34149	6368	34149	6225	0.0	5.485783132530121
chr22	POLR3H	41533521	41533687	1605	167	34149	6368	32544	6201	9.610778443113773	5.248185776487663
chr22	PMM1	41589051	41589163	0	113	4801	4510	4801	4397	0.0	1.0918808278371617
chr22	SNU13	41682355	41682587	232	233	24858	2935	24626	2702	0.9957081545064378	9.1139896373057
chr22	SNU13	41688078	41688327	0	250	24858	2935	24858	2685	0.0	9.258100558659217
chr22	SNU13	41688151	41688327	0	177	24858	2935	24858	2758	0.0	9.013052936910805
chr22	SNU13	41687721	41688327	44	607	24858	2935	24814	2328	0.07248764415156507	10.65893470790378
chr22	SNU13	41688793	41688981	0	189	24858	2935	24858	2746	0.0	9.052439912600146
chr22	CENPM	41943609	41943701	0	93	34683	1757	34683	1664	0.0	20.84314903846154
chr22	CYP2D6	42129032	42129185	0	154	612	1726	612	1572	0.0	0.3893129770992366
chr22	CYP2D7	42142727	42142880	0	154	68	3408	68	3254	0.0	0.02089735709895513
chr22	TCF20	42168608	42168736	0	129	14382	8217	14382	8088	0.0	1.7781899109792285
chr22	TCF20	42168608	42168703	0	96	14382	8217	14382	8121	0.0	1.7709641669745104
chr22	RRP7A	42518612	42518728	0	117	1126	5708	1126	5591	0.0	0.2013950992666786
chr22	POLDIP3	42601969	42602056	0	88	1326	3658	1326	3570	0.0	0.37142857142857144
chr22	POLDIP3	42601969	42602107	0	139	1326	3658	1326	3519	0.0	0.37681159420289856
chr22	CYB5R3	42646640	42646701	0	62	585	5573	585	5511	0.0	0.10615133369624388
chr22	ARFGAP3	42810812	42810944	0	133	121	3290	121	3157	0.0	0.03832752613240418
chr22	ARFGAP3	42835361	42835493	0	133	121	3290	121	3157	0.0	0.03832752613240418
chr22	ARFGAP3	42834241	42834325	0	85	121	3290	121	3205	0.0	0.037753510140405615
chr22	PACSIN2	42876887	42877010	0	124	97188	4388	97188	4264	0.0	22.79268292682927
chr22	PACSIN2	42880616	42880622	0	7	97188	4388	97188	4381	0.0	22.183976261127597
chr22	PACSIN2	42993619	42993780	2193	162	97188	4388	94995	4226	13.537037037037036	22.47870326549929
chr22	TTLL1	43051800	43051887	0	88	1369	1880	1369	1792	0.0	0.7639508928571429
chr22	TTLL1	43070170	43070242	0	73	1369	1880	1369	1807	0.0	0.7576092971776425
chr22	MCAT	43137080	43137298	0	219	0	2393	0	2174	0.0	0.0
chr22	SCUBE1	43255487	43255577	38	91	47776	5437	47738	5346	0.4175824175824176	8.929667040778153
chr22	EFCAB6	43615825	43615922	0	98	31811	8593	31811	8495	0.0	3.7446733372572103
chr22	EFCAB6	43772891	43773103	0	213	31811	8593	31811	8380	0.0	3.7960620525059667
chr22	EFCAB6	43782179	43782325	0	147	31811	8593	31811	8446	0.0	3.766398295050912
chr22	SULT4A1	43841801	43841932	0	132	0	2867	0	2735	0.0	0.0
chr22	SULT4A1	43827513	43827640	0	128	0	2867	0	2739	0.0	0.0
chr22	PHF21B	44933472	44933518	0	47	16568	5722	16568	5675	0.0	2.9194713656387665
chr22	KIAA0930	45207572	45207772	0	201	72	8069	72	7868	0.0	0.009150991357397052
chr22	KIAA0930	45226151	45226383	0	233	72	8069	72	7836	0.0	0.009188361408882083
chr22	BX324167.1	45877213	45877360	0	148	0	991	0	843	0.0	0.0
chr22	CDPF1	46248171	46248284	0	114	1836	1642	1836	1528	0.0	1.2015706806282722
chr22	CDPF1	46246672	46246795	0	124	1836	1642	1836	1518	0.0	1.209486166007905
chr22	CDPF1	46247109	46247221	1020	113	1836	1642	816	1529	9.026548672566372	0.5336821451929366
chr22	CERK	46711085	46711149	0	65	97956	4945	97956	4880	0.0	20.07295081967213
chr22	LINC00898	47627161	47627242	0	82	1187	4992	1187	4910	0.0	0.24175152749490836
chr22	Z84468.2	48476309	48476411	0	103	0	2513	0	2410	0.0	0.0
chr22	AL078622.1	49049394	49049463	0	70	0	3815	0	3745	0.0	0.0
chr22	AL078622.1	49049394	49049546	0	153	0	3815	0	3662	0.0	0.0
chr22	AL078622.1	49049394	49049460	0	67	0	3815	0	3748	0.0	0.0
chr22	C22ORF34	49416601	49416735	0	135	663	6782	663	6647	0.0	0.09974424552429667
chr22	MLC1	50083083	50083173	0	91	51	3835	51	3744	0.0	0.013621794871794872
chr22	HDAC10	50247691	50247776	0	86	5467	4150	5467	4064	0.0	1.345226377952756
chr22	HDAC10	50248830	50248890	286	61	5467	4150	5181	4089	4.688524590163935	1.2670579603815113
chr22	HDAC10	50248365	50248472	481	108	5467	4150	4986	4042	4.453703703703703	1.2335477486392874
chr22	HDAC10	50250426	50250523	45	98	5467	4150	5422	4052	0.45918367346938777	1.3381046396841065
chr22	HDAC10	50248830	50248859	18	30	5467	4150	5449	4120	0.6	1.3225728155339807
chr22	MAPK12	50256934	50256964	0	31	6940	9010	6940	8979	0.0	0.7729145784608531
chr22	HDAC10	50248661	50248751	663	91	5467	4150	4804	4059	7.285714285714286	1.1835427445183542
chr22	MAPK12	50257081	50257193	92	113	6940	9010	6848	8897	0.8141592920353983	0.7696976508935597
chr22	MAPK11	50267568	50267627	0	60	3398	2698	3398	2638	0.0	1.2880970432145564
chr22	PLXNB2	50282183	50282313	3244	131	309508	7083	306264	6952	24.763358778625953	44.054085155350975
chr22	PLXNB2	50284844	50284913	462	70	309508	7083	309046	7013	6.6	44.06758876372451
chr22	DENND6B	50316565	50316626	0	62	118414	5745	118414	5683	0.0	20.836530001759634
chr22	DENND6B	50316565	50316712	0	148	118414	5745	118414	5597	0.0	21.156691084509557
chr22	SBF1	50457033	50457111	0	79	270	9490	270	9411	0.0	0.028689831048772714
chr22	TYMP	50526000	50526141	0	142	0	1961	0	1819	0.0	0.0
chr22	TYMP	50527164	50527283	0	120	0	1961	0	1841	0.0	0.0
chr22	TYMP	50528511	50528610	0	100	0	1961	0	1861	0.0	0.0
chr22	TYMP	50526000	50526156	0	157	0	1961	0	1804	0.0	0.0
chr22	TYMP	50527164	50527328	0	165	0	1961	0	1796	0.0	0.0
chr22	TYMP	50528511	50528573	0	63	0	1961	0	1898	0.0	0.0
chr22	ODF3B	50531569	50531702	7	134	7	2010	0	1876	0.05223880597014925	0.0
chr22	ODF3B	50531569	50531773	7	205	7	2010	0	1805	0.03414634146341464	0.0
chr22	CPT1B	50576535	50576637	0	103	0	4122	0	4019	0.0	0.0
chr22	CPT1B	50576535	50576593	0	59	0	4122	0	4063	0.0	0.0
chr22	CHKB-CPT1B	50578548	50578659	0	112	0	5050	0	4938	0.0	0.0
chr22	CPT1B	50573807	50573921	0	115	0	4122	0	4007	0.0	0.0
chr22	ARSA	50627555	50627792	1029	238	9992	3989	8963	3751	4.323529411764706	2.3894961343641694
chr22	RABL2B	50769904	50770016	0	113	1955	5879	1955	5766	0.0	0.33905653832813043
chr22	RABL2B	50775771	50775851	102	81	1955	5879	1853	5798	1.2592592592592593	0.31959296309072094
chr22	RABL2B	50783038	50783286	147	249	1955	5879	1808	5630	0.5903614457831325	0.3211367673179396
chr22	RABL2B	50782890	50783045	0	156	1955	5879	1955	5723	0.0	0.34160405381792763
chr22	RABL2B	50780612	50780718	0	107	1955	5879	1955	5772	0.0	0.3387040887040887
chr22	POTEH	15697373	15697629	0	257	0	2253	0	1996	0.0	0.0
chr22	TPTEP1	16647604	16647785	0	182	0	5184	0	5002	0.0	0.0
chr22	CECR7	17046345	17046444	0	100	3009	4460	3009	4360	0.0	0.6901376146788991
chr22	IL17RA	17097061	17097086	0	26	51	9049	51	9023	0.0	0.005652222099080129
chr22	IL17RA	17105852	17105954	0	103	51	9049	51	8946	0.0	0.005700871898054996
chr22	LINC01664	17122568	17122738	0	171	0	1936	0	1765	0.0	0.0
chr22	CECR2	17550242	17550409	3381	168	61124	10783	57743	10615	20.125	5.439755063589261
chr22	SLC25A18	17569923	17569986	0	64	99374	4735	99374	4671	0.0	21.274673517448083
chr22	BCL2L13	17688985	17689142	51	158	13098	7270	13047	7112	0.3227848101265823	1.8345050618672667
chr22	BCL2L13	17696140	17696210	0	71	13098	7270	13098	7199	0.0	1.8194193638005278
chr22	BCL2L13	17655661	17655832	0	172	13098	7270	13098	7098	0.0	1.84530853761623
chr22	BCL2L13	17683213	17683321	0	109	13098	7270	13098	7161	0.0	1.8290741516547968
chr22	BCL2L13	17702242	17702386	0	145	13098	7270	13098	7125	0.0	1.8383157894736841
chr22	PEX26	18085111	18085258	102	148	116510	20054	116408	19906	0.6891891891891891	5.84788505978097
chr22	AC008132.1	18852218	18852594	0	377	850	7577	850	7200	0.0	0.11805555555555555
chr22	DGCR6	18909979	18910098	0	120	51	5168	51	5048	0.0	0.010103011093502378
chr22	DGCR5	18985835	18986019	0	185	1599	8044	1599	7859	0.0	0.20346100012724266
chr22	DGCR5	18989739	18989964	0	226	1599	8044	1599	7818	0.0	0.20452801227935533
chr22	DGCR5	18988090	18988195	0	106	1599	8044	1599	7938	0.0	0.20143613000755858
chr22	DGCR5	18987756	18987900	0	145	1599	8044	1599	7899	0.0	0.20243068742878845
chr22	CDC45	19482689	19482827	1020	139	5421	2603	4401	2464	7.338129496402877	1.78612012987013
chr22	CDC45	19479825	19480019	0	195	5421	2603	5421	2408	0.0	2.25124584717608
chr22	CDC45	19494506	19494602	1010	97	5421	2603	4411	2506	10.412371134020619	1.760175578611333
chr22	CDC45	19480685	19480779	306	95	5421	2603	5115	2508	3.221052631578947	2.039473684210526
chr22	CDC45	19494473	19494602	1010	130	5421	2603	4411	2473	7.769230769230769	1.7836635665183986
chr22	SEPTIN5	19721639	19721736	0	98	0	4211	0	4113	0.0	0.0
chr22	COMT	19961696	19961874	3226	179	40758	6477	37532	6298	18.022346368715084	5.959352175293744
chr22	COMT	19947306	19947490	160	185	40758	6477	40598	6292	0.8648648648648649	6.452320406865861
chr22	COMT	19966625	19966718	213	94	40758	6477	40545	6383	2.265957446808511	6.352028826570578
chr22	COMT	19967163	19967621	4773	459	40758	6477	35985	6018	10.398692810457517	5.979561316051845
chr22	TANGO2	20061529	20061683	200	155	31465	4941	31265	4786	1.2903225806451613	6.532595068951108
chr22	TANGO2	20019180	20019299	0	120	31465	4941	31465	4821	0.0	6.526654221115951
chr22	TANGO2	20055942	20056013	0	72	31465	4941	31465	4869	0.0	6.46231258985418
chr22	TANGO2	20053436	20053551	1953	116	31465	4941	29512	4825	16.836206896551722	6.116476683937824
chr22	TANGO2	20053359	20053551	7970	193	31465	4941	23495	4748	41.295336787564764	4.948399326032013
chr22	TANGO2	20063337	20063442	0	106	31465	4941	31465	4835	0.0	6.50775594622544
chr22	TANGO2	20061529	20061681	195	153	31465	4941	31270	4788	1.2745098039215685	6.530910609857978
chr22	DGCR8	20092808	20092907	1146	100	257398	7302	256252	7202	11.46	35.58067203554568
chr22	RANBP1	20122579	20122697	0	119	79693	4188	79693	4069	0.0	19.585401818628657
chr22	ZNF74	20394562	20394662	4279	101	11725	5230	7446	5129	42.366336633663366	1.4517449795281732
chr22	ZNF74	20395332	20395418	0	87	11725	5230	11725	5143	0.0	2.2797977833949057
chr22	ZNF74	20401276	20401372	513	97	11725	5230	11212	5133	5.288659793814433	2.184297681667641
chr22	ZNF74	20399594	20399690	416	97	11725	5230	11309	5133	4.288659793814433	2.20319501266316
chr22	MED15	20518877	20518995	0	119	51	8263	51	8144	0.0	0.006262278978388998
chr22	MED15	20554935	20555148	0	214	51	8263	51	8049	0.0	0.00633619083115915
chr22	MED15	20582610	20582747	0	138	51	8263	51	8125	0.0	0.006276923076923077
chr22	MED15	20584854	20585015	0	162	51	8263	51	8101	0.0	0.006295519071719541
chr22	MED15	20575112	20575232	0	121	51	8263	51	8142	0.0	0.006263817243920413
chr22	MED15	20552538	20552709	0	172	51	8263	51	8091	0.0	0.006303299962921765
chr22	TMEM191A	20703467	20703524	0	58	0	2582	0	2524	0.0	0.0
chr22	TMEM191A	20702843	20702893	0	51	0	2582	0	2531	0.0	0.0
chr22	TMEM191A	20703818	20703883	0	66	0	2582	0	2516	0.0	0.0
chr22	TMEM191A	20702829	20702893	0	65	0	2582	0	2517	0.0	0.0
chr22	AIFM3	20973757	20973867	0	111	27	4168	27	4057	0.0	0.006655163914222332
chr22	AIFM3	20977699	20977776	0	78	27	4168	27	4090	0.0	0.006601466992665036
chr22	AIFM3	20980746	20980767	0	22	27	4168	27	4146	0.0	0.006512301013024602
chr22	AIFM3	20966505	20966546	0	42	27	4168	27	4126	0.0	0.006543868153174988
chr22	LZTR1	20985840	20985897	0	58	204	6931	204	6873	0.0	0.02968136185072021
chr22	LZTR1	20987503	20987583	0	81	204	6931	204	6850	0.0	0.02978102189781022
chr22	LZTR1	20988788	20988872	0	85	204	6931	204	6846	0.0	0.029798422436459245
chr22	LZTR1	20995367	20995484	0	118	204	6931	204	6813	0.0	0.029942756494936152
chr22	P2RX6	21022675	21022751	0	77	0	4616	0	4539	0.0	0.0
chr22	P2RX6	21017920	21018060	0	141	0	4616	0	4475	0.0	0.0
chr22	FAM230B	21183270	21185587	102	2318	9475	6180	9373	3862	0.04400345125107852	2.4269808389435528
chr22	FAM230B	21171080	21171208	0	129	9475	6180	9475	6051	0.0	1.5658568831598083
chr22	TMEM191C	21469129	21469194	0	66	714	4210	714	4144	0.0	0.17229729729729729
chr22	TMEM191C	21468151	21468202	0	52	714	4210	714	4158	0.0	0.1717171717171717
chr22	UBE2L3	21592860	21592956	0	97	20673	3843	20673	3746	0.0	5.518686599038975
chr22	PPIL2	21669333	21669426	0	94	552	6288	552	6194	0.0	0.08911850177591217
chr22	PPIL2	21670298	21670360	0	63	552	6288	552	6225	0.0	0.08867469879518072
chr22	PPIL2	21685637	21685726	153	90	552	6288	399	6198	1.7	0.0643756050338819
chr22	GGTLC2	22646982	22647038	0	57	2815	1402	2815	1345	0.0	2.092936802973978
chr22	IGLL5	22893696	22893818	0	123	561	1342	561	1219	0.0	0.4602132895816243
chr22	IGLL5	22893699	22893818	0	120	561	1342	561	1222	0.0	0.4590834697217676
chr22	RAB36	23152460	23152526	0	67	0	4118	0	4051	0.0	0.0
chr22	BCR	23268407	23268515	0	109	24	11548	24	11439	0.0	0.002098085496984002
chr22	BCR	23290338	23290413	0	76	24	11548	24	11472	0.0	0.0020920502092050207
chr22	BCR	23313967	23314073	0	107	24	11548	24	11441	0.0	0.0020977187308801677
chr22	BCR	23295023	23295155	0	133	24	11548	24	11415	0.0	0.002102496714848883
chr22	RGL4	23696327	23696494	0	168	0	4727	0	4559	0.0	0.0
chr22	RGL4	23698414	23698548	0	135	0	4727	0	4592	0.0	0.0
chr22	RGL4	23698554	23698645	0	92	0	4727	0	4635	0.0	0.0
chr22	MMP11	23771117	23771299	0	183	0	4173	0	3990	0.0	0.0
chr22	MMP11	23771186	23771307	0	122	0	4173	0	4051	0.0	0.0
chr22	SMARCB1	23800943	23801081	0	139	969	12335	969	12196	0.0	0.07945227943588061
chr22	SMARCB1	23800943	23801135	0	193	969	12335	969	12142	0.0	0.07980563333882391
chr22	SMARCB1	23800943	23801964	0	1022	969	12335	969	11313	0.0	0.08565367276584461
chr22	SMARCB1	23800943	23800970	0	28	969	12335	969	12307	0.0	0.07873567888193711
chr22	SLC2A11	23877720	23877869	0	150	1701	8383	1701	8233	0.0	0.20660755496173935
chr22	SLC2A11	23883771	23883873	273	103	1701	8383	1428	8280	2.650485436893204	0.17246376811594202
chr22	SLC2A11	23857420	23857531	0	112	1701	8383	1701	8271	0.0	0.20565832426550598
chr22	SLC2A11	23867734	23867899	0	166	1701	8383	1701	8217	0.0	0.20700985761226726
chr22	SLC2A11	23877384	23877869	0	486	1701	8383	1701	7897	0.0	0.21539825250094974
chr22	CABIN1	24050824	24050974	564	151	119528	9431	118964	9280	3.7350993377483444	12.819396551724138
chr22	CABIN1	24041138	24041273	51	136	119528	9431	119477	9295	0.375	12.853899946207639
chr22	CABIN1	24176110	24176275	6	166	119528	9431	119522	9265	0.03614457831325301	12.900377765785214
chr22	POM121L9P	24257996	24258059	337	64	47751	4967	47414	4903	5.265625	9.67040587395472
chr22	SPECC1L	24411587	24411704	0	118	15373	7480	15373	7362	0.0	2.0881553925563705
chr22	SPECC1L	24276699	24276803	0	105	15373	7480	15373	7375	0.0	2.0844745762711865
chr22	SPECC1L	24311993	24312131	3283	139	15373	7480	12090	7341	23.618705035971225	1.646914589293012
chr22	SPECC1L	24321404	24322918	8991	1515	15373	7480	6382	5965	5.934653465346535	1.069907795473596
chr22	ADORA2A	24432620	24432726	1450	107	1654	4202	204	4095	13.551401869158878	0.04981684981684982
chr22	UPB1	24521985	24522028	0	44	36167	6805	36167	6761	0.0	5.349356604052655
chr22	UPB1	24500106	24500278	420	173	36167	6805	35747	6632	2.4277456647398843	5.390078407720145
chr22	GGT1	24609961	24610033	0	73	580	4343	580	4270	0.0	0.1358313817330211
chr22	GGT1	24614775	24614906	0	132	580	4343	580	4211	0.0	0.13773450486820232
chr22	GGT1	24620912	24621070	0	159	580	4343	580	4184	0.0	0.13862332695984703
chr22	GGT1	24607953	24608023	0	71	580	4343	580	4272	0.0	0.13576779026217228
chr22	GGT1	24609964	24610033	0	70	580	4343	580	4273	0.0	0.1357360168499883
chr22	GGT1	24608989	24609231	0	243	580	4343	580	4100	0.0	0.14146341463414633
chr22	GGT1	24628080	24628136	0	57	580	4343	580	4286	0.0	0.1353243117125525
chr22	AP000356.3	24649277	24649383	0	107	36	1611	36	1504	0.0	0.023936170212765957
chr22	SGSM1	24874414	24874579	0	166	1453	8635	1453	8469	0.0	0.1715668910142874
chr22	SGSM1	24893430	24893613	0	184	1453	8635	1453	8451	0.0	0.17193231570228376
chr22	CRYBB3	25205219	25205362	0	144	0	861	0	717	0.0	0.0
chr22	GRK3	25644591	25644665	0	75	1750	9263	1750	9188	0.0	0.19046582498911624
chr22	GRK3	25702841	25702991	99	151	1750	9263	1651	9112	0.6556291390728477	0.18118964003511853
chr22	MYO18B	25797952	25798097	0	146	18772	9758	18772	9612	0.0	1.9529754473574699
chr22	MYO18B	26003264	26003309	0	46	18772	9758	18772	9712	0.0	1.9328665568369028
chr22	MYO18B	26028340	26028595	0	256	18772	9758	18772	9502	0.0	1.9755840875605135
chr22	SEZ6L	26351051	26351243	0	193	0	7179	0	6986	0.0	0.0
chr22	SEZ6L	26373450	26373483	0	34	0	7179	0	7145	0.0	0.0
chr22	SEZ6L	26365371	26365566	0	196	0	7179	0	6983	0.0	0.0
chr22	CRYBA4	26623233	26623352	0	120	0	815	0	695	0.0	0.0
chr22	MIAT	26660698	26660816	0	119	0	13610	0	13491	0.0	0.0
chr22	MIAT	26647173	26647311	0	139	0	13610	0	13471	0.0	0.0
chr22	MIAT	26667184	26667310	0	127	0	13610	0	13483	0.0	0.0
chr22	MIAT	26656031	26656154	0	124	0	13610	0	13486	0.0	0.0
chr22	MIAT	26663315	26663398	0	84	0	13610	0	13526	0.0	0.0
chr22	MIAT	26657481	26657654	0	174	0	13610	0	13436	0.0	0.0
chr22	MIAT	26663315	26663509	0	195	0	13610	0	13415	0.0	0.0
chr22	MIAT	26658182	26658339	0	158	0	13610	0	13452	0.0	0.0
chr22	MIATNB	26693680	26693836	0	157	27	5101	27	4944	0.0	0.0054611650485436895
chr22	MIATNB	26711829	26712008	27	180	27	5101	0	4921	0.15	0.0
chr22	MIATNB	26718139	26718231	0	93	27	5101	27	5008	0.0	0.005391373801916933
chr22	LINC01422	26877328	26877413	0	86	182976	9911	182976	9825	0.0	18.62351145038168
chr22	AL020994.2	27337135	27337657	0	523	171	1407	171	884	0.0	0.19343891402714933
chr22	TTC28-AS1	27989881	27990026	0	146	153	11188	153	11042	0.0	0.013856185473646079
chr22	TTC28-AS1	27935150	27935230	0	81	153	11188	153	11107	0.0	0.01377509678581075
chr22	TTC28-AS1	27993123	27993535	0	413	153	11188	153	10775	0.0	0.01419953596287703
chr22	TTC28-AS1	27994472	27994653	0	182	153	11188	153	11006	0.0	0.013901508268217335
chr22	TTC28-AS1	27997985	27998152	0	168	153	11188	153	11020	0.0	0.013883847549909257
chr22	TTC28-AS1	27922017	27922178	0	162	153	11188	153	11026	0.0	0.013876292399782332
chr22	TTC28-AS1	27940019	27940171	0	153	153	11188	153	11035	0.0	0.013864975079293159
chr22	TTC28-AS1	27919722	27919966	0	245	153	11188	153	10943	0.0	0.013981540710956777
chr22	TTC28-AS1	27998603	27998838	0	236	153	11188	153	10952	0.0	0.013970051132213295
chr22	TTC28-AS1	27922017	27922227	0	211	153	11188	153	10977	0.0	0.013938234490297895
chr22	TTC28-AS1	27997985	27998838	0	854	153	11188	153	10334	0.0	0.014805496419585833
chr22	TTC28-AS1	27998071	27998152	0	82	153	11188	153	11106	0.0	0.013776337115072933
chr22	HSCB	28745863	28746008	0	146	0	1462	0	1316	0.0	0.0
chr22	CCDC117	28773724	28773778	0	55	153	4332	153	4277	0.0	0.03577273790039748
chr22	CCDC117	28780947	28781172	0	226	153	4332	153	4106	0.0	0.03726254262055528
chr22	EMID1	29225132	29225216	0	85	63	3322	63	3237	0.0	0.019462465245597776
chr22	EMID1	29234136	29234199	0	64	63	3322	63	3258	0.0	0.019337016574585635
chr22	EMID1	29231457	29231508	0	52	63	3322	63	3270	0.0	0.01926605504587156
chr22	EMID1	29254202	29254287	0	86	63	3322	63	3236	0.0	0.01946847960444994
chr22	EWSR1	29282389	29282557	0	169	1411	6389	1411	6220	0.0	0.22684887459807074
chr22	EWSR1	29274264	29274282	0	19	1411	6389	1411	6370	0.0	0.22150706436420722
chr22	EWSR1	29274267	29274282	0	16	1411	6389	1411	6373	0.0	0.22140279303310842
chr22	GAS2L1	29306994	29307153	0	160	1836	4005	1836	3845	0.0	0.4775032509752926
chr22	NF2	29636750	29636876	0	127	251405	5395	251405	5268	0.0	47.72304479878512
chr22	NF2	29639089	29639212	0	124	251405	5395	251405	5271	0.0	47.69588313413015
chr22	NF2	29628657	29628773	0	117	251405	5395	251405	5278	0.0	47.63262599469496
chr22	NF2	29661204	29661339	9941	136	251405	5395	241464	5259	73.09558823529412	45.91443240159726
chr22	NF2	29681438	29681601	461	164	251405	5395	250944	5231	2.8109756097560976	47.97247180271459
chr22	NF2	29683019	29683064	32931	46	251405	5395	218474	5349	715.8913043478261	40.843896055337446
chr22	NF2	29683019	29683079	46978	61	251405	5395	204427	5334	770.1311475409836	38.32527184101987
chr22	NF2	29654974	29655080	0	107	251405	5395	251405	5288	0.0	47.54254916792738
chr22	MTMR3	29957035	29957088	284	54	11255	9913	10971	9859	5.2592592592592595	1.1127903438482605
chr22	MTMR3	29970975	29971062	1011	88	11255	9913	10244	9825	11.488636363636363	1.04264631043257
chr22	MTMR3	29988479	29988562	0	84	11255	9913	11255	9829	0.0	1.1450808831010275
chr22	MTMR3	30023456	30023483	0	28	11255	9913	11255	9885	0.0	1.1385938290338897
chr22	MTMR3	30022028	30022139	153	112	11255	9913	11102	9801	1.3660714285714286	1.1327415569839812
chr22	HORMAD2	30104400	30104437	0	38	64347	2297	64347	2259	0.0	28.48472775564409
chr22	CCDC157	30361960	30362114	0	155	7379	6596	7379	6441	0.0	1.1456295606272318
chr22	CCDC157	30365943	30366248	0	306	7379	6596	7379	6290	0.0	1.1731319554848967
chr22	CCDC157	30375478	30375663	448	186	7379	6596	6931	6410	2.4086021505376345	1.0812792511700469
chr22	CCDC157	30365989	30366248	0	260	7379	6596	7379	6336	0.0	1.164614898989899
chr22	CCDC157	30375485	30375663	448	179	7379	6596	6931	6417	2.5027932960893855	1.0800997350786972
chr22	SEC14L2	30407094	30407154	0	61	184845	5735	184845	5674	0.0	32.57754670426507
chr22	SEC14L2	30407414	30407603	51	190	184845	5735	184794	5545	0.26842105263157895	33.32623985572588
chr22	SEC14L2	30415758	30415865	2975	108	184845	5735	181870	5627	27.546296296296298	32.320952550204375
chr22	SEC14L2	30399642	30399718	0	77	184845	5735	184845	5658	0.0	32.66967126193001
chr22	SEC14L2	30397748	30397870	306	123	184845	5735	184539	5612	2.4878048780487805	32.88292943692088
chr22	SEC14L2	30415947	30416087	9583	141	184845	5735	175262	5594	67.9645390070922	31.330353950661422
chr22	SEC14L2	30416233	30416403	14450	171	184845	5735	170395	5564	84.50292397660819	30.6245506829619
chr22	MTFP1	30427170	30427403	0	234	4814	1331	4814	1097	0.0	4.3883318140382865
chr22	MTFP1	30427121	30427403	0	283	4814	1331	4814	1048	0.0	4.593511450381679
chr22	MTFP1	30427239	30427403	0	165	4814	1331	4814	1166	0.0	4.128644939965695
chr22	AC004832.1	30491423	30491592	0	170	102	2426	102	2256	0.0	0.04521276595744681
chr22	TCN2	30610234	30610335	0	102	2086	2960	2086	2858	0.0	0.7298810356892932
chr22	OSBP2	30893121	30893242	0	122	33335	6541	33335	6419	0.0	5.193176507244119
chr22	OSBP2	30893816	30894001	0	186	33335	6541	33335	6355	0.0	5.245476003147128
chr22	OSBP2	30770582	30770681	0	100	33335	6541	33335	6441	0.0	5.175438596491228
chr22	MORC2-AS1	30923245	30923422	0	178	51	2729	51	2551	0.0	0.0199921599372795
chr22	MORC2-AS1	30923245	30923451	0	207	51	2729	51	2522	0.0	0.020222045995241873
chr22	SMTN	31082909	31083002	0	94	2377	7949	2377	7855	0.0	0.3026098026734564
chr22	SMTN	31082915	31083002	0	88	2377	7949	2377	7861	0.0	0.3023788322096425
chr22	SMTN	31100884	31101049	0	166	2377	7949	2377	7783	0.0	0.30540922523448544
chr22	SMTN	31100884	31100953	0	70	2377	7949	2377	7879	0.0	0.30168803147607565
chr22	SMTN	31093783	31093876	0	94	2377	7949	2377	7855	0.0	0.3026098026734564
chr22	SMTN	31087082	31087200	0	119	2377	7949	2377	7830	0.0	0.30357598978288636
chr22	INPP5J	31124141	31124263	0	123	0	4440	0	4317	0.0	0.0
chr22	INPP5J	31133405	31133483	0	79	0	4440	0	4361	0.0	0.0
chr22	INPP5J	31124844	31126010	0	1167	0	4440	0	3273	0.0	0.0
chr22	INPP5J	31125832	31126010	0	179	0	4440	0	4261	0.0	0.0
chr22	INPP5J	31124844	31124906	0	63	0	4440	0	4377	0.0	0.0
chr22	RNF185	31187046	31187270	0	225	714	3456	714	3231	0.0	0.22098421541318478
chr22	RNF185	31195468	31195581	0	114	714	3456	714	3342	0.0	0.21364452423698385
chr22	RNF185	31196935	31197157	0	223	714	3456	714	3233	0.0	0.22084751005258274
chr22	LIMK2	31225719	31225819	0	101	153	6188	153	6087	0.0	0.025135534746180386
chr22	DRG1	31400619	31400743	0	125	123	2211	123	2086	0.0	0.05896452540747843
chr22	DRG1	31403028	31403204	0	177	123	2211	123	2034	0.0	0.06047197640117994
chr22	DRG1	31421307	31421399	0	93	123	2211	123	2118	0.0	0.05807365439093484
chr22	SFI1	31528689	31528863	0	175	45866	12126	45866	11951	0.0	3.8378378378378377
chr22	SFI1	31603743	31603819	0	77	45866	12126	45866	12049	0.0	3.8066229562619305
chr22	SFI1	31604308	31604404	0	97	45866	12126	45866	12029	0.0	3.8129520325879125
chr22	SFI1	31531057	31531129	0	73	45866	12126	45866	12053	0.0	3.8053596614950633
chr22	SFI1	31546860	31546971	0	112	45866	12126	45866	12014	0.0	3.8177126685533542
chr22	SFI1	31580271	31580364	0	94	45866	12126	45866	12032	0.0	3.812001329787234
chr22	SFI1	31530591	31530784	409	194	45866	12126	45457	11932	2.1082474226804124	3.8096714716728126
chr22	SFI1	31497247	31497348	418	102	45866	12126	45448	12024	4.098039215686274	3.77977378576181
chr22	DEPDC5	31766584	31766668	0	85	175219	17819	175219	17734	0.0	9.880399233111538
chr22	DEPDC5	31778098	31778168	0	71	175219	17819	175219	17748	0.0	9.872605363984674
chr22	DEPDC5	31806121	31806191	0	71	175219	17819	175219	17748	0.0	9.872605363984674
chr22	DEPDC5	31876156	31876265	0	110	175219	17819	175219	17709	0.0	9.894347506917386
chr22	DEPDC5	31901741	31901802	0	62	175219	17819	175219	17757	0.0	9.867601509263952
chr22	DEPDC5	31833914	31833980	1712	67	175219	17819	173507	17752	25.55223880597015	9.773940964398378
chr22	DEPDC5	31861367	31861433	31	67	175219	17819	175188	17752	0.4626865671641791	9.868634520054078
chr22	DEPDC5	31895358	31895954	51	597	175219	17819	175168	17222	0.08542713567839195	10.171176402276158
chr22	DEPDC5	31831063	31831225	1224	163	175219	17819	173995	17656	7.50920245398773	9.854723606705935
chr22	DEPDC5	31766603	31766668	0	66	175219	17819	175219	17753	0.0	9.869824818340563
chr22	DEPDC5	31876086	31876265	0	180	175219	17819	175219	17639	0.0	9.933613016610918
chr22	YWHAH	31945499	31945678	0	180	10132	2398	10132	2218	0.0	4.568079350766456
chr22	YWHAH	31950307	31950422	0	116	10132	2398	10132	2282	0.0	4.439964943032428
chr22	YWHAH	31945556	31945678	0	123	10132	2398	10132	2275	0.0	4.453626373626373
chr22	LINC02558	31976623	31976737	0	115	3405	1635	3405	1520	0.0	2.2401315789473686
chr22	LINC02558	31972575	31972732	310	158	3405	1635	3095	1477	1.9620253164556962	2.095463777928233
chr22	SLC5A4-AS1	32229089	32229372	0	284	18071	6812	18071	6528	0.0	2.7682291666666665
chr22	FBXO7	32479132	32479275	0	144	0	5275	0	5131	0.0	0.0
chr22	FBXO7	32478980	32479275	0	296	0	5275	0	4979	0.0	0.0
chr22	LINC01640	33134592	33134702	0	111	0	2020	0	1909	0.0	0.0
chr22	LARGE-AS1	33732255	33732649	0	395	666	2871	666	2476	0.0	0.2689822294022617
chr22	LARGE-AS1	33744128	33744328	0	201	666	2871	666	2670	0.0	0.24943820224719102
chr22	LARGE-AS1	33746414	33746457	0	44	666	2871	666	2827	0.0	0.23558542624690484
chr22	LARGE-AS1	33747669	33747824	12	156	666	2871	654	2715	0.07692307692307693	0.2408839779005525
chr22	LARGE-AS1	33725611	33725756	0	146	666	2871	666	2725	0.0	0.24440366972477065
chr22	LARGE-AS1	33726115	33726197	0	83	666	2871	666	2788	0.0	0.23888091822094693
chr22	LARGE-AS1	33747625	33747824	12	200	666	2871	654	2671	0.06	0.244852115312617
chr22	LARGE-AS1	33732255	33733685	632	1431	666	2871	34	1440	0.4416491963661775	0.02361111111111111
chr22	LARGE-AS1	33725611	33725655	0	45	666	2871	666	2826	0.0	0.2356687898089172
chr22	LARGE-AS1	33743134	33743198	0	65	666	2871	666	2806	0.0	0.23734853884533144
chr22	LINC01643	34083968	34084027	0	60	0	3786	0	3726	0.0	0.0
chr22	LINC01643	34109325	34109434	0	110	0	3786	0	3676	0.0	0.0
chr22	LINC01643	34161595	34161791	0	197	0	3786	0	3589	0.0	0.0
chr22	LINC01643	34107938	34107989	0	52	0	3786	0	3734	0.0	0.0
chr22	LINC01643	34206081	34206194	0	114	0	3786	0	3672	0.0	0.0
chr22	LINC01643	34147995	34148132	0	138	0	3786	0	3648	0.0	0.0
chr22	LINC01643	34213811	34213970	0	160	0	3786	0	3626	0.0	0.0
chr22	LINC01643	34107938	34107993	0	56	0	3786	0	3730	0.0	0.0
chr22	LINC01643	34188184	34188425	0	242	0	3786	0	3544	0.0	0.0
chr22	LINC01643	34100357	34100441	0	85	0	3786	0	3701	0.0	0.0
chr22	LINC01643	34175389	34175440	0	52	0	3786	0	3734	0.0	0.0
chr22	LINC01643	34205472	34205558	0	87	0	3786	0	3699	0.0	0.0
chr22	LINC01643	34149923	34150019	0	97	0	3786	0	3689	0.0	0.0
chr22	LINC01643	34206081	34206163	0	83	0	3786	0	3703	0.0	0.0
chr22	LINC01643	34213811	34213919	0	109	0	3786	0	3677	0.0	0.0
chr22	LINC01643	34061274	34061500	0	227	0	3786	0	3559	0.0	0.0
chr22	LINC01643	34102622	34102816	0	195	0	3786	0	3591	0.0	0.0
chr22	LINC01643	34151864	34151927	0	64	0	3786	0	3722	0.0	0.0
chr22	HMGXB4	35262322	35262421	0	100	51	6019	51	5919	0.0	0.008616320324379118
chr22	HMGXB4	35263981	35264096	0	116	51	6019	51	5903	0.0	0.008639674741656785
chr22	TOM1	35323495	35323630	0	136	0	5019	0	4883	0.0	0.0
chr22	TOM1	35317876	35317961	0	86	0	5019	0	4933	0.0	0.0
chr22	TOM1	35321741	35321847	0	107	0	5019	0	4912	0.0	0.0
chr22	TOM1	35331295	35331495	0	201	0	5019	0	4818	0.0	0.0
chr22	TOM1	35321958	35322037	0	80	0	5019	0	4939	0.0	0.0
chr22	TOM1	35323518	35323630	0	113	0	5019	0	4906	0.0	0.0
chr22	HMOX1	35386684	35387176	0	493	0	2254	0	1761	0.0	0.0
chr22	HMOX1	35389863	35389963	0	101	0	2254	0	2153	0.0	0.0
chr22	MCM5	35401665	35401814	0	150	148	5194	148	5044	0.0	0.029341792228390166
chr22	MCM5	35403413	35403542	0	130	148	5194	148	5064	0.0	0.029225908372827805
chr22	MCM5	35401370	35401466	0	97	148	5194	148	5097	0.0	0.029036688247989013
chr22	APOL1	36257082	36257136	0	55	803	2686	803	2631	0.0	0.30520714557202583
chr22	APOL1	36253837	36253991	0	155	803	2686	803	2531	0.0	0.3172659028052153
chr22	APOL1	36259668	36259856	0	189	803	2686	803	2497	0.0	0.32158590308370044
chr22	APOL1	36259668	36259918	0	251	803	2686	803	2435	0.0	0.3297741273100616
chr22	NCF4	36864044	36864129	42	86	67941	2252	67899	2166	0.4883720930232558	31.34764542936288
chr22	MPST	37023751	37023927	0	177	0	2486	0	2309	0.0	0.0
chr22	MPST	37025001	37025127	0	127	0	2486	0	2359	0.0	0.0
chr22	KCTD17	37060822	37060922	0	101	0	2580	0	2479	0.0	0.0
chr22	KCTD17	37061103	37061175	0	73	0	2580	0	2507	0.0	0.0
chr22	KCTD17	37061538	37061629	0	92	0	2580	0	2488	0.0	0.0
chr22	CDC42EP1	37565599	37565722	0	124	0	2546	0	2422	0.0	0.0
chr22	GGA1	37613023	37613191	0	169	162	9038	162	8869	0.0	0.01826586988386515
chr22	GGA1	37613118	37613191	0	74	162	9038	162	8964	0.0	0.018072289156626505
chr22	GGA1	37613032	37613191	0	160	162	9038	162	8878	0.0	0.018247353007434106
chr22	SH3BP1	37641125	37641168	0	44	152	4670	152	4626	0.0	0.03285776048421963
chr22	SH3BP1	37655271	37655315	0	45	152	4670	152	4625	0.0	0.03286486486486487
chr22	LGALS1	37678375	37678392	0	18	0	1073	0	1055	0.0	0.0
chr22	TRIOBP	37713209	37713411	0	203	8168	12205	8168	12002	0.0	0.680553241126479
chr22	TRIOBP	37754876	37754984	408	109	8168	12205	7760	12096	3.743119266055046	0.6415343915343915
chr22	TRIOBP	37750641	37750730	0	90	8168	12205	8168	12115	0.0	0.6742055303342963
chr22	GCAT	37809948	37810157	477	210	1632	2112	1155	1902	2.2714285714285714	0.6072555205047319
chr22	GCAT	37810026	37810157	335	132	1632	2112	1297	1980	2.537878787878788	0.6550505050505051
chr22	EIF3L	37850014	37850063	0	50	42659	4164	42659	4114	0.0	10.369227029654837
chr22	EIF3L	37855564	37855644	0	81	42659	4164	42659	4083	0.0	10.447954935096742
chr22	EIF3L	37850523	37850574	0	52	42659	4164	42659	4112	0.0	10.374270428015564
chr22	EIF3L	37886949	37887071	7633	123	42659	4164	35026	4041	62.05691056910569	8.667656520663202
chr22	POLR2F	37959345	37959476	459	132	58086	6258	57627	6126	3.477272727272727	9.406953966699314
chr22	POLR2F	37958373	37958471	307	99	58086	6258	57779	6159	3.101010101010101	9.38123071927261
chr22	PICK1	38059233	38059345	0	113	1776492	4356	1776492	4243	0.0	418.6877209521565
chr22	PICK1	38067703	38067770	52	68	1776492	4356	1776440	4288	0.7647058823529411	414.28171641791045
chr22	MAFF	38213822	38213889	0	68	1067074	3894	1067074	3826	0.0	278.9006795608991
chr22	CBY1	38665545	38665685	0	141	617	2355	617	2214	0.0	0.2786811201445348
chr22	CBY1	38656955	38657143	274	189	617	2355	343	2166	1.4497354497354498	0.15835641735918743
chr22	GTPBP1	38708844	38708956	0	113	4962	8041	4962	7928	0.0	0.625882946518668
chr22	GTPBP1	38736028	38736256	0	229	4962	8041	4962	7812	0.0	0.6351766513056836
chr22	GTPBP1	38735173	38735310	0	138	4962	8041	4962	7903	0.0	0.6278628368973808
chr22	APOBEC3B	38989456	38989610	0	155	3058	1623	3058	1468	0.0	2.0831062670299727
chr22	APOBEC3C	39015594	39015751	53	158	665	2648	612	2490	0.33544303797468356	0.2457831325301205
chr22	APOBEC3G	39078931	39079085	149270	155	649209	4135	499939	3980	963.0322580645161	125.61281407035176
chr22	APOBEC3H	39101917	39102042	1313	126	1525	1257	212	1131	10.420634920634921	0.1874447391688771
chr22	APOBEC3H	39102511	39102605	161	95	1525	1257	1364	1162	1.694736842105263	1.1738382099827882
chr22	MIEF1	39509421	39509571	0	151	195	6464	195	6313	0.0	0.030888642483763662
chr22	MIEF1	39509337	39509571	51	235	195	6464	144	6229	0.2170212765957447	0.023117675389308076
chr22	CACNA1I	39647821	39647926	0	106	153	10828	153	10722	0.0	0.014269725797425853
chr22	GRAP2	39947092	39947184	0	93	812	6197	812	6104	0.0	0.13302752293577982
chr22	TNRC6B	40264687	40267036	0	2350	255	20027	255	17677	0.0	0.014425524693104033
chr22	TNRC6B	40270121	40270280	0	160	255	20027	255	19867	0.0	0.012835355111491418
chr22	TNRC6B	40281118	40281289	0	172	255	20027	255	19855	0.0	0.012843112566104256
chr22	ADSL	40354247	40354327	0	81	1168	7463	1168	7382	0.0	0.1582227038742888
chr22	ADSL	40353072	40353117	0	46	1168	7463	1168	7417	0.0	0.15747606849130377
chr22	ADSL	40364879	40365056	0	178	1168	7463	1168	7285	0.0	0.16032944406314345
chr22	ADSL	40373345	40373535	0	191	1168	7463	1168	7272	0.0	0.16061606160616063
chr22	ADSL	40353332	40353419	0	88	1168	7463	1168	7375	0.0	0.1583728813559322
chr22	SGSM3	40401592	40401675	0	84	0	3960	0	3876	0.0	0.0
chr22	ADSL	40366435	40366498	0	64	1168	7463	1168	7399	0.0	0.15785917015812947
chr22	XPNPEP3	40870047	40870139	0	93	10155	8939	10155	8846	0.0	1.147976486547592
chr22	EP300	41137652	41137790	0	139	34315	11539	34315	11400	0.0	3.010087719298246
chr22	EP300	41146738	41146816	0	79	34315	11539	34315	11460	0.0	2.994328097731239
chr22	L3MBTL2	41219418	41219536	0	119	90391	6141	90391	6022	0.0	15.010129525074726
chr22	L3MBTL2	41213892	41214026	1005	135	90391	6141	89386	6006	7.444444444444445	14.882783882783883
chr22	L3MBTL2	41208314	41208457	867	144	90391	6141	89524	5997	6.020833333333333	14.928130732032683
chr22	L3MBTL2	41227574	41227679	98	106	90391	6141	90293	6035	0.9245283018867925	14.961557580778791
chr22	ACO2	41518480	41518572	179	93	52146	9940	51967	9847	1.924731182795699	5.277444907078298
chr22	ACO2	41522829	41522987	51	159	52146	9940	52095	9781	0.32075471698113206	5.326142521214599
chr22	ACO2	41526261	41526453	561	193	52146	9940	51585	9747	2.906735751295337	5.292397660818714
chr22	ACO2	41527138	41527202	0	65	52146	9940	52146	9875	0.0	5.280607594936709
chr22	ACO2	41502629	41502771	0	143	52146	9940	52146	9797	0.0	5.322649790752271
chr22	ACO2	41507445	41507606	140	162	52146	9940	52006	9778	0.8641975308641975	5.318674575577828
chr22	ACO2	41517942	41518408	0	467	52146	9940	52146	9473	0.0	5.504697561490552
chr22	ACO2	41518495	41518572	154	78	52146	9940	51992	9862	1.9743589743589745	5.271952950719935
chr22	ACO2	41477912	41478127	204	216	52146	9940	51942	9724	0.9444444444444444	5.341628959276018
chr22	ACO2	41504910	41505035	0	126	52146	9940	52146	9814	0.0	5.313429794171592
chr22	ACO2	41511030	41511147	0	118	52146	9940	52146	9822	0.0	5.309102015882712
chr22	XRCC6	41628117	41628230	0	114	189727	3146	189727	3032	0.0	62.574868073878626
chr22	MEI1	41753948	41754046	9325	99	46658	6712	37333	6613	94.1919191919192	5.645395433237562
chr22	MEI1	41784607	41784783	0	177	46658	6712	46658	6535	0.0	7.139709257842387
chr22	MEI1	41795410	41795542	0	133	46658	6712	46658	6579	0.0	7.091959264325886
chr22	MEI1	41784338	41784420	51	83	46658	6712	46607	6629	0.6144578313253012	7.030773872378941
chr22	SREBF2	41878658	41878758	0	101	45581	7580	45581	7479	0.0	6.094531354459153
chr22	SREBF2	41904534	41904732	0	199	45581	7580	45581	7381	0.0	6.175450480964639
chr22	SEPTIN3	41981644	41981836	102	193	131334	4980	131232	4787	0.5284974093264249	27.41424691873825
chr22	WBP2NL	42032392	42032487	391	96	280623	4482	280232	4386	4.072916666666667	63.89238486092111
chr22	WBP2NL	42022248	42022356	0	109	280623	4482	280623	4373	0.0	64.17173565058313
chr22	NDUFA6-DT	42092118	42092232	2102	115	14794	5096	12692	4981	18.278260869565216	2.5480827143143947
chr22	NDUFA6-DT	42112305	42112390	0	86	14794	5096	14794	5010	0.0	2.9528942115768464
chr22	NDUFA6-DT	42123765	42123804	0	40	14794	5096	14794	5056	0.0	2.9260284810126582
chr22	NDUFA6-DT	42120035	42120128	0	94	14794	5096	14794	5002	0.0	2.9576169532187127
chr22	NDUFA6-DT	42123525	42123591	0	67	14794	5096	14794	5029	0.0	2.941737920063631
chr22	NDUFA6-DT	42133329	42133410	1	82	14794	5096	14793	5014	0.012195121951219513	2.9503390506581573
chr22	OGFRP1	42273893	42273974	14082	82	172549	3801	158467	3719	171.73170731707316	42.61011024468943
chr22	OGFRP1	42274655	42274821	3910	167	172549	3801	168639	3634	23.41317365269461	46.40588882773803
chr22	SERHL	42511815	42511927	0	113	409	2853	409	2740	0.0	0.14927007299270073
chr22	SERHL2	42555663	42555705	0	43	8009	2806	8009	2763	0.0	2.898660875859573
chr22	SERHL2	42554937	42555087	80	151	8009	2806	7929	2655	0.5298013245033113	2.986440677966102
chr22	SERHL2	42560185	42560265	17	81	8009	2806	7992	2725	0.20987654320987653	2.9328440366972477
chr22	SERHL2	42566303	42566338	0	36	8009	2806	8009	2770	0.0	2.891335740072202
chr22	TSPO	43159209	43159420	0	212	47	1395	47	1183	0.0	0.039729501267962805
chr22	PARVB	44151482	44151551	0	70	1055	7393	1055	7323	0.0	0.1440666393554554
chr22	PARVG	44181741	44181917	0	177	1768	7893	1768	7716	0.0	0.22913426645930535
chr22	PARVG	44196346	44196415	0	70	1768	7893	1768	7823	0.0	0.2260002556563978
chr22	LINC00207	44570499	44570588	0	90	0	1410	0	1320	0.0	0.0
chr22	LINC00207	44570499	44570624	0	126	0	1410	0	1284	0.0	0.0
chr22	LINC00207	44569596	44569663	0	68	0	1410	0	1342	0.0	0.0
chr22	PRR5	44702491	44702608	45	118	689	5239	644	5121	0.3813559322033898	0.12575668814684632
chr22	PRR5	44725243	44725292	0	50	689	5239	689	5189	0.0	0.1327808826363461
chr22	PRR5	44735026	44735162	0	137	689	5239	689	5102	0.0	0.1350450803606429
chr22	PRR5	44679346	44679885	0	540	689	5239	689	4699	0.0	0.14662694190253245
chr22	ARHGAP8	44802076	44802164	0	89	158	4776	158	4687	0.0	0.03371026242799232
chr22	ARHGAP8	44808306	44808438	0	133	158	4776	158	4643	0.0	0.034029722162395006
chr22	ARHGAP8	44859730	44859834	0	105	158	4776	158	4671	0.0	0.03382573324769857
chr22	ARHGAP8	44809005	44809098	0	94	158	4776	158	4682	0.0	0.03374626228107646
chr22	ARHGAP8	44777161	44777229	0	69	158	4776	158	4707	0.0	0.03356702783089016
chr22	ARHGAP8	44808671	44808732	0	62	158	4776	158	4714	0.0	0.03351718285956724
chr22	ARHGAP8	44786041	44786101	0	61	158	4776	158	4715	0.0	0.03351007423117709
chr22	NUP50	45175893	45176080	0	188	339	6581	339	6393	0.0	0.05302674800563116
chr22	NUP50	45178237	45178900	0	664	339	6581	339	5917	0.0	0.05729254689876627
chr22	NUP50	45170987	45171143	0	157	339	6581	339	6424	0.0	0.052770859277708596
chr22	NUP50	45166308	45166430	0	123	339	6581	339	6458	0.0	0.05249303189842056
chr22	NUP50	45170987	45171152	0	166	339	6581	339	6415	0.0	0.05284489477786438
chr22	NUP50	45170987	45171177	0	191	339	6581	339	6390	0.0	0.053051643192488264
chr22	NUP50	45165864	45166116	51	253	339	6581	288	6328	0.2015810276679842	0.045512010113780026
chr22	FBLN1	45523090	45523204	8	115	52811	7040	52803	6925	0.06956521739130435	7.624981949458483
chr22	FBLN1	45531264	45531324	0	61	52811	7040	52811	6979	0.0	7.567129961312509
chr22	FBLN1	45548612	45548744	121	133	52811	7040	52690	6907	0.9097744360902256	7.6284928333574635
chr22	ATXN10	45689711	45689903	0	193	3180	5148	3180	4955	0.0	0.6417759838546923
chr22	PRR34-AS1	46055598	46055733	0	136	0	1098	0	962	0.0	0.0
chr22	MIRLET7BHG	46103191	46103249	0	59	936	5737	936	5678	0.0	0.16484677703416695
chr22	PPARA	46176752	46176836	306	85	339665	13233	339359	13148	3.6	25.810693641618496
chr22	PPARA	46188722	46188822	0	101	339665	13233	339665	13132	0.0	25.865443192202253
chr22	TTC38	46269141	46269289	0	149	207	3596	207	3447	0.0	0.06005221932114883
chr22	TTC38	46281970	46282151	0	182	207	3596	207	3414	0.0	0.06063268892794376
chr22	TTC38	46292202	46292328	0	127	207	3596	207	3469	0.0	0.05967137503603344
chr22	TRMU	46337778	46337944	0	167	153	7870	153	7703	0.0	0.019862391276126184
chr22	TRMU	46355989	46356072	0	84	153	7870	153	7786	0.0	0.019650655021834062
chr22	TRMU	46343261	46343368	0	108	153	7870	153	7762	0.0	0.019711414583870136
chr22	TRMU	46347372	46347495	0	124	153	7870	153	7746	0.0	0.019752130131680867
chr22	TBC1D22A	46792667	46792804	0	138	6870	5336	6870	5198	0.0	1.3216621777606772
chr22	TBC1D22A	46797443	46797620	0	178	6870	5336	6870	5158	0.0	1.331911593640946
chr22	TBC1D22A	46878652	46878723	0	72	6870	5336	6870	5264	0.0	1.3050911854103344
chr22	TBC1D22A	46792519	46792576	94	58	6870	5336	6776	5278	1.6206896551724137	1.2838196286472148
chr22	TBC1D22A	46789311	46789471	0	161	6870	5336	6870	5175	0.0	1.327536231884058
chr22	TBC1D22A	46792667	46792762	0	96	6870	5336	6870	5240	0.0	1.3110687022900764
chr22	AL117329.1	47635179	47635353	0	175	102	31762	102	31587	0.0	0.003229176559977206
chr22	AL117329.1	47635179	47635355	0	177	102	31762	102	31585	0.0	0.003229381035301567
chr22	AL117329.1	47687140	47687206	0	67	102	31762	102	31695	0.0	0.003218173213440606
chr22	AL117329.1	47704588	47704747	0	160	102	31762	102	31602	0.0	0.0032276438200113918
chr22	AL117329.1	47738433	47738576	0	144	102	31762	102	31618	0.0	0.003226010500347903
chr22	AL117329.1	47728828	47728995	0	168	102	31762	102	31594	0.0	0.0032284611002089004
chr22	AL117329.1	47641984	47642173	0	190	102	31762	102	31572	0.0	0.0032307107563664004
chr22	AL117329.1	47637509	47637604	0	96	102	31762	102	31666	0.0	0.00322112044464094
chr22	AL117329.1	47688595	47688719	0	125	102	31762	102	31637	0.0	0.0032240730789897904
chr22	AL117329.1	47724273	47724325	0	53	102	31762	102	31709	0.0	0.003216752341606484
chr22	AL117329.1	47793397	47793517	0	121	102	31762	102	31641	0.0	0.00322366549729781
chr22	AL117329.1	47685316	47685477	0	162	102	31762	102	31600	0.0	0.0032278481012658227
chr22	AL117329.1	47760418	47760492	0	75	102	31762	102	31687	0.0	0.0032189857039164327
chr22	AL117329.1	47634446	47634636	0	191	102	31762	102	31571	0.0	0.00323081308796047
chr22	AL117329.1	47637502	47637604	0	103	102	31762	102	31659	0.0	0.0032218326542215485
chr22	AL117329.1	47861991	47862122	0	132	102	31762	102	31630	0.0	0.0032247865950047424
chr22	AL117329.1	47710698	47710747	0	50	102	31762	102	31712	0.0	0.0032164480322906157
chr22	TAFA5	48646596	48646746	0	151	0	3087	0	2936	0.0	0.0
chr22	CRELD2	49923233	49923317	0	85	0	3667	0	3582	0.0	0.0
chr22	CRELD2	49924359	49924455	0	97	0	3667	0	3570	0.0	0.0
chr22	CRELD2	49922296	49922443	0	148	0	3667	0	3519	0.0	0.0
chr22	MOV10L1	50120501	50120616	0	116	220	6832	220	6716	0.0	0.03275759380583681
chr22	MOV10L1	50150734	50150899	0	166	220	6832	220	6666	0.0	0.033003300330033
chr22	MOV10L1	50160687	50160825	0	139	220	6832	220	6693	0.0	0.03287016285671597
chr22	MOV10L1	50160963	50161055	0	93	220	6832	220	6739	0.0	0.03264579314438344
chr22	PANX2	50175431	50175482	938	52	29234	3023	28296	2971	18.03846153846154	9.524065971053517
chr22	PPP6R2	50436987	50437068	0	82	255	5374	255	5292	0.0	0.0481859410430839
chr22	NCAPH2	50516446	50516548	0	103	51	4166	51	4063	0.0	0.012552301255230125
chr22	NCAPH2	50515719	50515774	0	56	51	4166	51	4110	0.0	0.012408759124087591
chr22	SHANK3	50724126	50724153	0	28	290709	9119	290709	9091	0.0	31.977670223297768
chr22	SHANK3	50698143	50698342	357	200	290709	9119	290352	8919	1.785	32.55432223343424
chrX	PLCXD1	281481	281684	1352	204	56871	6077	55519	5873	6.627450980392157	9.453260684488336
chrX	CSF2RA	1274754	1274842	0	89	0	3562	0	3473	0.0	0.0
chrX	CSF2RA	1285777	1285920	0	144	0	3562	0	3418	0.0	0.0
chrX	CSF2RA	1303260	1303362	0	103	0	3562	0	3459	0.0	0.0
chrX	CSF2RA	1300490	1300626	0	137	0	3562	0	3425	0.0	0.0
chrX	CSF2RA	1303922	1304019	0	98	0	3562	0	3464	0.0	0.0
chrX	CSF2RA	1274754	1274818	0	65	0	3562	0	3497	0.0	0.0
chrX	CSF2RA	1282408	1282560	0	153	0	3562	0	3409	0.0	0.0
chrX	CSF2RA	1305445	1305527	0	83	0	3562	0	3479	0.0	0.0
chrX	AKAP17A	1600137	1600207	0	71	215	3371	215	3300	0.0	0.06515151515151515
chrX	ASMT	1632703	1632787	0	85	153	1797	153	1712	0.0	0.08936915887850468
chrX	ASMT	1633149	1633290	0	142	153	1797	153	1655	0.0	0.09244712990936556
chrX	CD99P1	2622689	2622734	0	46	232684	5932	232684	5886	0.0	39.531770302412504
chrX	CD99	2717604	2717652	0	49	0	4873	0	4824	0.0	0.0
chrX	CD99	2733356	2733374	0	19	0	4873	0	4854	0.0	0.0
chrX	CD99	2727292	2727343	0	52	0	4873	0	4821	0.0	0.0
chrX	XG	2806700	2806745	0	46	612	3368	612	3322	0.0	0.18422636965683323
chrX	GYG2	2842997	2843090	0	94	467	3634	467	3540	0.0	0.13192090395480227
chrX	GYG2	2853979	2854154	0	176	467	3634	467	3458	0.0	0.13504916136495085
chrX	GYG2	2877199	2877307	0	109	467	3634	467	3525	0.0	0.1324822695035461
chrX	GYG2	2843212	2843354	0	143	467	3634	467	3491	0.0	0.13377255800630192
chrX	GYG2	2875809	2875914	0	106	467	3634	467	3528	0.0	0.13236961451247165
chrX	LINC01546	3276985	3277517	0	533	459	4425	459	3892	0.0	0.11793422404933196
chrX	STS	7305045	7305183	0	139	0	12361	0	12222	0.0	0.0
chrX	TBL1X	9653544	9653689	0	146	1816	9022	1816	8876	0.0	0.20459666516448852
chrX	TBL1X	9534899	9535034	0	136	1816	9022	1816	8886	0.0	0.204366419086203
chrX	TBL1X	9636281	9637918	306	1638	1816	9022	1510	7384	0.18681318681318682	0.20449620801733479
chrX	CLCN4	10195702	10195726	0	25	153	7579	153	7554	0.0	0.020254169976171566
chrX	CLCN4	10228345	10228595	0	251	153	7579	153	7328	0.0	0.02087882096069869
chrX	CLCN4	10191889	10191975	0	87	153	7579	153	7492	0.0	0.020421783235451147
chrX	AMELX	11298102	11298144	0	43	0	842	0	799	0.0	0.0
chrX	AMELX	11296778	11296826	0	49	0	842	0	793	0.0	0.0
chrX	MSL3	11759792	11759875	0	84	0	7299	0	7215	0.0	0.0
chrX	MSL3	11760402	11760498	0	97	0	7299	0	7202	0.0	0.0
chrX	MSL3	11768572	11768682	0	111	0	7299	0	7188	0.0	0.0
chrX	MSL3	11772620	11772705	0	86	0	7299	0	7213	0.0	0.0
chrX	MSL3	11761499	11761582	0	84	0	7299	0	7215	0.0	0.0
chrX	MSL3	11768574	11768682	0	109	0	7299	0	7190	0.0	0.0
chrX	MSL3	11766960	11767052	0	93	0	7299	0	7206	0.0	0.0
chrX	MSL3	11766960	11767169	0	210	0	7299	0	7089	0.0	0.0
chrX	MSL3	11766960	11767046	0	87	0	7299	0	7212	0.0	0.0
chrX	MSL3	11767818	11767862	0	45	0	7299	0	7254	0.0	0.0
chrX	PRPS2	12819506	12819680	956	175	5552	2703	4596	2528	5.462857142857143	1.8180379746835442
chrX	TLR8	12910305	12910442	0	138	102	4356	102	4218	0.0	0.02418207681365576
chrX	LINC01203	13379597	13379798	0	202	0	6494	0	6292	0.0	0.0
chrX	LINC01203	13395261	13395392	0	132	0	6494	0	6362	0.0	0.0
chrX	LINC01203	13335211	13335312	0	102	0	6494	0	6392	0.0	0.0
chrX	LINC01203	13373061	13373234	0	174	0	6494	0	6320	0.0	0.0
chrX	LINC01203	13335658	13335697	0	40	0	6494	0	6454	0.0	0.0
chrX	RAB9A	13703813	13703902	0	90	51	2116	51	2026	0.0	0.025172754195459033
chrX	RAB9A	13703734	13703902	0	169	51	2116	51	1947	0.0	0.026194144838212634
chrX	OFD1	13740088	13740213	510	126	19218	5201	18708	5075	4.0476190476190474	3.6863054187192117
chrX	OFD1	13751248	13751368	0	121	19218	5201	19218	5080	0.0	3.7830708661417325
chrX	OFD1	13758336	13758448	326	113	19218	5201	18892	5088	2.8849557522123894	3.713050314465409
chrX	OFD1	13763744	13763855	0	112	19218	5201	19218	5089	0.0	3.7763804283749263
chrX	GLRA2	14530971	14531178	0	208	490	3717	490	3509	0.0	0.1396409233399829
chrX	BMX	15534211	15534339	0	129	12711	2849	12711	2720	0.0	4.673161764705882
chrX	CA5B	15745630	15745710	0	81	40742	7863	40742	7782	0.0	5.235415060395785
chrX	MAGEB17	16168731	16168908	2182	178	56128	1614	53946	1436	12.258426966292134	37.56685236768802
chrX	NHS	17719343	17719406	0	64	102	10626	102	10562	0.0	0.009657261882219277
chrX	SCML1	17744070	17744219	0	150	1377	4066	1377	3916	0.0	0.3516343207354443
chrX	SCML1	17745455	17745539	0	85	1377	4066	1377	3981	0.0	0.3458929917106255
chrX	CDKL5	18623878	18624001	0	124	4711	18806	4711	18682	0.0	0.2521678621132641
chrX	CDKL5	18443818	18443959	0	142	4711	18806	4711	18664	0.0	0.25241105872267466
chrX	CDKL5	18457482	18457534	0	53	4711	18806	4711	18753	0.0	0.25121313923105637
chrX	PPEF1	18730180	18730308	0	129	0	3534	0	3405	0.0	0.0
chrX	PPEF1	18803891	18804077	0	187	0	3534	0	3347	0.0	0.0
chrX	PPEF1	18823922	18824086	0	165	0	3534	0	3369	0.0	0.0
chrX	AL732509.1	19051703	19052145	0	443	99	5265	99	4822	0.0	0.020530900041476566
chrX	PDHA1	19346509	19346623	0	115	102	4235	102	4120	0.0	0.02475728155339806
chrX	PDHA1	19354490	19354583	0	94	102	4235	102	4141	0.0	0.02463173146582951
chrX	PDHA1	19345735	19345819	0	85	102	4235	102	4150	0.0	0.02457831325301205
chrX	CNKSR2	21526866	21527000	0	135	10190	24430	10190	24295	0.0	0.41942786581601155
chrX	CNKSR2	21594973	21595047	0	75	10190	24430	10190	24355	0.0	0.41839458016834324
chrX	CNKSR2	21516484	21516631	0	148	10190	24430	10190	24282	0.0	0.4196524174285479
chrX	CNKSR2	21561470	21561560	0	91	10190	24430	10190	24339	0.0	0.4186696248818768
chrX	CNKSR2	21607994	21608131	0	138	10190	24430	10190	24292	0.0	0.4194796640869422
chrX	CNKSR2	21590714	21590786	0	73	10190	24430	10190	24357	0.0	0.4183602249866568
chrX	CNKSR2	21468594	21468674	0	81	10190	24430	10190	24349	0.0	0.4184976795761633
chrX	CNKSR2	21637273	21637414	0	142	10190	24430	10190	24288	0.0	0.4195487483530962
chrX	SMS	21971896	21971990	96	95	2038	2038	1942	1943	1.0105263157894737	0.9994853319608852
chrX	SMS	21972506	21972571	495	66	2038	2038	1543	1972	7.5	0.7824543610547667
chrX	PTCHD1	23379590	23380251	0	662	5403	12886	5403	12224	0.0	0.44199934554973824
chrX	PRDX4	23686001	23686047	0	47	1224	1865	1224	1818	0.0	0.6732673267326733
chrX	SAT1	23783799	23783883	98	85	4240	2184	4142	2099	1.1529411764705881	1.9733206288708909
chrX	SAT1	23784293	23784403	349	111	4240	2184	3891	2073	3.144144144144144	1.8769898697539797
chrX	CXORF58	23923084	23923207	33	124	150	1855	117	1731	0.2661290322580645	0.06759098786828423
chrX	ZFX	24208217	24208370	0	154	11644	9055	11644	8901	0.0	1.308167621615549
chrX	ZFX	24173606	24173723	1275	118	11644	9055	10369	8937	10.805084745762711	1.1602327402931631
chrX	ZFX	24207325	24207475	4	151	11644	9055	11640	8904	0.026490066225165563	1.307277628032345
chrX	ZFX	24152719	24152830	0	112	11644	9055	11644	8943	0.0	1.3020239293302025
chrX	ZFX	24151690	24151800	0	111	11644	9055	11644	8944	0.0	1.3018783542039356
chrX	ZFX	24161714	24161842	0	129	11644	9055	11644	8926	0.0	1.3045036970647546
chrX	POLA1	24703250	24703347	0	98	14328	14745	14328	14647	0.0	0.978220796067454
chrX	POLA1	24744599	24744893	0	295	14328	14745	14328	14450	0.0	0.9915570934256055
chrX	POLA1	24733754	24733816	0	63	14328	14745	14328	14682	0.0	0.9758888434818145
chrX	POLA1	24739374	24739550	0	177	14328	14745	14328	14568	0.0	0.9835255354200988
chrX	POLA1	24742001	24742121	175	121	14328	14745	14153	14624	1.4462809917355373	0.967792669584245
chrX	DCAF8L2	27712557	27712649	0	93	51	4428	51	4335	0.0	0.011764705882352941
chrX	MAGEB1	30247389	30247472	0	84	51	1976	51	1892	0.0	0.026955602536997886
chrX	GK	30668011	30668118	0	108	1313	5391	1313	5283	0.0	0.24853303047510883
chrX	GK	30691122	30691199	0	78	1313	5391	1313	5313	0.0	0.2471296819122906
chrX	GK	30727465	30727552	0	88	1313	5391	1313	5303	0.0	0.24759570054686028
chrX	GK	30697731	30697749	0	19	1313	5391	1313	5372	0.0	0.24441548771407298
chrX	GK	30674301	30674466	0	166	1313	5391	1313	5225	0.0	0.2512918660287081
chrX	GK	30665510	30665584	0	75	1313	5391	1313	5316	0.0	0.24699021820917982
chrX	GK	30695082	30695132	29	51	1313	5391	1284	5340	0.5686274509803921	0.24044943820224718
chrX	AL591501.1	33917911	33917960	0	50	102	14454	102	14404	0.0	0.00708136628714246
chrX	AL591501.1	34295941	34296002	0	62	102	14454	102	14392	0.0	0.007087270705947749
chrX	AL591501.1	33853614	33853715	0	102	102	14454	102	14352	0.0	0.007107023411371237
chrX	AL591501.1	34270089	34270260	0	172	102	14454	102	14282	0.0	0.007141856882789525
chrX	MAGEB16	35801320	35801374	0	55	0	1991	0	1936	0.0	0.0
chrX	MAGEB16	35800516	35800568	0	53	0	1991	0	1938	0.0	0.0
chrX	CFAP47	36366965	36367127	0	163	209	11508	209	11345	0.0	0.01842221242838255
chrX	PRRG1	37425839	37426000	0	162	204	6149	204	5987	0.0	0.034073826624352765
chrX	PRRG1	37386598	37386689	0	92	204	6149	204	6057	0.0	0.033680039623576026
chrX	LANCL3	37668367	37668450	0	84	51	10304	51	10220	0.0	0.004990215264187867
chrX	SYTL5	38103025	38103091	0	67	4672	4838	4672	4771	0.0	0.9792496332005869
chrX	OTC	38373595	38373738	0	144	76	1694	76	1550	0.0	0.04903225806451613
chrX	TSPAN7	38655995	38656155	735	161	735	2953	0	2792	4.565217391304348	0.0
chrX	TSPAN7	38622902	38623033	0	132	735	2953	735	2821	0.0	0.26054590570719605
chrX	TSPAN7	38646261	38646312	0	52	735	2953	735	2901	0.0	0.2533609100310238
chrX	MID1IP1	38802534	38804413	0	1880	0	4839	0	2959	0.0	0.0
chrX	MID1IP1	38804309	38804413	0	105	0	4839	0	4734	0.0	0.0
chrX	ATP6AP2	40597248	40597344	0	97	12402	6093	12402	5996	0.0	2.0683789192795197
chrX	ATP6AP2	40588985	40589116	0	132	12402	6093	12402	5961	0.0	2.080523402113739
chrX	ATP6AP2	40597526	40597664	6828	139	12402	6093	5574	5954	49.12230215827338	0.9361773597581458
chrX	ATP6AP2	40600761	40600881	0	121	12402	6093	12402	5972	0.0	2.076691225720027
chrX	ATP6AP2	40598935	40599018	0	84	12402	6093	12402	6009	0.0	2.0639041437843235
chrX	ATP6AP2	40600768	40600881	0	114	12402	6093	12402	5979	0.0	2.0742599096838936
chrX	ATP6AP2	40597252	40597344	0	93	12402	6093	12402	6000	0.0	2.067
chrX	ATP6AP2	40598680	40598734	0	55	12402	6093	12402	6038	0.0	2.0539913878767804
chrX	ATP6AP2	40600781	40600881	0	101	12402	6093	12402	5992	0.0	2.0697596795727637
chrX	ATP6AP2	40603336	40603439	0	104	12402	6093	12402	5989	0.0	2.0707964601769913
chrX	DDX3X	41339035	41339083	0	49	1939	11657	1939	11608	0.0	0.16703997243280497
chrX	DDX3X	41334125	41334297	0	173	1939	11657	1939	11484	0.0	0.1688436084987809
chrX	DDX3X	41343215	41343351	0	137	1939	11657	1939	11520	0.0	0.16831597222222222
chrX	DDX3X	41343736	41343822	0	87	1939	11657	1939	11570	0.0	0.1675885911840968
chrX	DDX3X	41344029	41344128	0	100	1939	11657	1939	11557	0.0	0.16777710478497881
chrX	DDX3X	41347859	41347915	0	57	1939	11657	1939	11600	0.0	0.1671551724137931
chrX	DDX3X	41357832	41358000	0	169	1939	11657	1939	11488	0.0	0.16878481894150418
chrX	DDX3X	41347639	41347915	0	277	1939	11657	1939	11380	0.0	0.17038664323374342
chrX	DDX3X	41357832	41357939	0	108	1939	11657	1939	11549	0.0	0.16789332409732444
chrX	DDX3X	41357832	41357990	0	159	1939	11657	1939	11498	0.0	0.16863802400417463
chrX	DDX3X	41337407	41337465	0	59	1939	11657	1939	11598	0.0	0.1671839972409036
chrX	DDX3X	41341948	41342046	0	99	1939	11657	1939	11558	0.0	0.16776258868316318
chrX	DDX3X	41339038	41339083	0	46	1939	11657	1939	11611	0.0	0.16699681336663508
chrX	DDX3X	41337690	41339083	102	1394	1939	11657	1837	10263	0.07317073170731707	0.1789924973204716
chrX	DDX3X	41343220	41343351	0	132	1939	11657	1939	11525	0.0	0.16824295010845988
chrX	DDX3X	41340635	41340814	0	180	1939	11657	1939	11477	0.0	0.16894658882983357
chrX	DDX3X	41337690	41338912	102	1223	1939	11657	1837	10434	0.08340147179067865	0.1760590377611654
chrX	DDX3X	41336082	41336159	0	78	1939	11657	1939	11579	0.0	0.16745832973486485
chrX	DDX3X	41343288	41343351	0	64	1939	11657	1939	11593	0.0	0.16725610282066763
chrX	MAOA	43657861	43657969	0	109	0	5544	0	5435	0.0	0.0
chrX	NDP-AS1	43967842	43968686	0	845	0	2172	0	1327	0.0	0.0
chrX	KDM6A	44974665	44974715	0	51	51	19804	51	19753	0.0	0.002581886295752544
chrX	KDM6A	45020609	45020730	0	122	51	19804	51	19682	0.0	0.002591200081292552
chrX	KDM6A	45051708	45051802	0	95	51	19804	51	19709	0.0	0.002587650312040185
chrX	KDM6A	45060608	45060764	0	157	51	19804	51	19647	0.0	0.002595816155138189
chrX	KDM6A	45062646	45062748	0	103	51	19804	51	19701	0.0	0.0025887010811633925
chrX	KDM6A	45079145	45079351	0	207	51	19804	51	19597	0.0	0.0026024391488493137
chrX	KDM6A	45106541	45106713	0	173	51	19804	51	19631	0.0	0.0025979318424940146
chrX	KDM6A	44976651	44976708	0	58	51	19804	51	19746	0.0	0.002582801580066849
chrX	KDM6A	45090722	45090864	0	143	51	19804	51	19661	0.0	0.002593967753420477
chrX	KDM6A	45060021	45060156	0	136	51	19804	51	19668	0.0	0.0025930445393532644
chrX	KDM6A	44961283	44961392	0	110	51	19804	51	19694	0.0	0.0025896212044277445
chrX	KDM6A	45068580	45069043	0	464	51	19804	51	19340	0.0	0.002637021716649431
chrX	KDM6A	45090722	45090832	0	111	51	19804	51	19693	0.0	0.0025897527040064997
chrX	KDM6A	45106541	45106649	0	109	51	19804	51	19695	0.0	0.0025894897182025894
chrX	RGN	47080316	47080936	19903	621	119765	2818	99862	2197	32.049919484702095	45.45380063723259
chrX	RGN	47091677	47091809	0	133	119765	2818	119765	2685	0.0	44.605214152700185
chrX	RGN	47089775	47089991	0	217	119765	2818	119765	2601	0.0	46.04575163398693
chrX	RBM10	47171027	47171258	0	232	0	3562	0	3330	0.0	0.0
chrX	UBA1	47198308	47198355	0	48	408	6442	408	6394	0.0	0.06380982170785111
chrX	UBA1	47198166	47198355	0	190	408	6442	408	6252	0.0	0.06525911708253358
chrX	CDK16	47222272	47222342	0	71	29	5750	29	5679	0.0	0.005106532840288783
chrX	CDK16	47222260	47222380	0	121	29	5750	29	5629	0.0	0.005151891987919701
chrX	CDK16	47222260	47222342	0	83	29	5750	29	5667	0.0	0.005117346038468326
chrX	TIMP1	47583407	47583536	0	130	102	1443	102	1313	0.0	0.07768469154607768
chrX	UXT-AS1	47685315	47685461	0	147	0	5414	0	5267	0.0	0.0
chrX	ZNF81	47842649	47842768	1953	120	15364	11822	13411	11702	16.275	1.1460434113826696
chrX	SSX4	48389345	48389481	459	137	29964	1240	29505	1103	3.3503649635036497	26.749773345421577
chrX	FTSJ1	48476562	48476668	0	107	1683	2878	1683	2771	0.0	0.6073619631901841
chrX	FTSJ1	48481150	48481203	0	54	1683	2878	1683	2824	0.0	0.5959631728045326
chrX	PORCN	48511294	48511487	0	194	142	2636	142	2442	0.0	0.05814905814905815
chrX	PORCN	48514126	48514141	0	16	142	2636	142	2620	0.0	0.05419847328244275
chrX	PORCN	48512834	48512852	0	19	142	2636	142	2617	0.0	0.054260603744745894
chrX	PORCN	48511365	48511487	0	123	142	2636	142	2513	0.0	0.05650616792678074
chrX	PORCN	48509423	48509577	0	155	142	2636	142	2481	0.0	0.05723498589278517
chrX	EBP	48522144	48522252	0	109	1116	1774	1116	1665	0.0	0.6702702702702703
chrX	EBP	48522192	48522252	0	61	1116	1774	1116	1713	0.0	0.6514886164623468
chrX	TBC1D25	48544868	48545023	0	156	47477	3839	47477	3683	0.0	12.89084985066522
chrX	TBC1D25	48541332	48541442	0	111	47477	3839	47477	3728	0.0	12.73524678111588
chrX	RBM3	48575560	48575630	0	71	1123	5201	1123	5130	0.0	0.2189083820662768
chrX	RBM3	48575560	48575667	0	108	1123	5201	1123	5093	0.0	0.22049872373846455
chrX	RBM3	48575921	48576083	0	163	1123	5201	1123	5038	0.0	0.22290591504565305
chrX	WAS	48686780	48686955	0	176	16997	2375	16997	2199	0.0	7.729422464756707
chrX	GATA1	48791090	48791329	2737	240	151687	1498	148950	1258	11.404166666666667	118.40222575516694
chrX	HDAC6	48802662	48802785	0	124	133522	7947	133522	7823	0.0	17.06787677361626
chrX	HDAC6	48808257	48808326	38	70	133522	7947	133484	7877	0.5428571428571428	16.946045448774914
chrX	HDAC6	48818219	48818412	1812	194	133522	7947	131710	7753	9.34020618556701	16.9882626080227
chrX	HDAC6	48820105	48820255	0	151	133522	7947	133522	7796	0.0	17.12698819907645
chrX	PQBP1	48902232	48902517	51	286	35001	1863	34950	1577	0.17832167832167833	22.162333544705135
chrX	PQBP1	48902232	48902384	46	153	35001	1863	34955	1710	0.3006535947712418	20.441520467836256
chrX	MAGIX	49164907	49165090	0	184	0	4936	0	4752	0.0	0.0
chrX	MAGIX	49164862	49165090	0	229	0	4936	0	4707	0.0	0.0
chrX	PPP1R3F	49270607	49270873	0	267	0	4334	0	4067	0.0	0.0
chrX	GAGE1	49604997	49605140	0	144	0	3135	0	2991	0.0	0.0
chrX	CLCN5	50085451	50085634	0	184	0	11479	0	11295	0.0	0.0
chrX	CLCN5	50088412	50088484	0	73	0	11479	0	11406	0.0	0.0
chrX	CCNB3	50308504	50311496	0	2993	0	5427	0	2434	0.0	0.0
chrX	MAGED1	51894275	51894349	0	75	51	5346	51	5271	0.0	0.009675583380762664
chrX	MAGED1	51894268	51894349	0	82	51	5346	51	5264	0.0	0.009688449848024316
chrX	MAGED1	51894626	51894794	0	169	51	5346	51	5177	0.0	0.009851265211512458
chrX	AC239585.2	52054056	52054190	0	135	0	765	0	630	0.0	0.0
chrX	MAGED4	52190344	52190392	0	49	204	4286	204	4237	0.0	0.04814727401463299
chrX	SSX8P	52628941	52629144	0	204	29	1783	29	1579	0.0	0.01836605446485117
chrX	SSX8P	52625226	52625349	0	124	29	1783	29	1659	0.0	0.017480409885473176
chrX	SSX2B	52759500	52759646	0	147	0	2265	0	2118	0.0	0.0
chrX	XAGE5	52814188	52814344	0	157	0	1120	0	963	0.0	0.0
chrX	FAM156B	52900567	52900660	0	94	204	4461	204	4367	0.0	0.04671399129837417
chrX	FAM156B	52900570	52900660	0	91	204	4461	204	4370	0.0	0.04668192219679634
chrX	GPR173	53070987	53071110	0	124	0	4913	0	4789	0.0	0.0
chrX	RIBC1	53428282	53428627	6048	346	75276	2329	69228	1983	17.479768786127167	34.910741301059
chrX	GNL3L	54541272	54541389	0	118	102437	11968	102437	11850	0.0	8.644472573839662
chrX	GNL3L	54550365	54550616	51	252	102437	11968	102386	11716	0.20238095238095238	8.738989416182998
chrX	TRO	54920965	54921059	0	95	0	4939	0	4844	0.0	0.0
chrX	TRO	54922202	54922291	0	90	0	4939	0	4849	0.0	0.0
chrX	TRO	54922577	54923768	0	1192	0	4939	0	3747	0.0	0.0
chrX	TRO	54922217	54922291	0	75	0	4939	0	4864	0.0	0.0
chrX	TRO	54930740	54931031	0	292	0	4939	0	4647	0.0	0.0
chrX	APEX2	55002250	55002431	0	182	102	3245	102	3063	0.0	0.03330068560235064
chrX	RRAGB	55727306	55727390	0	85	3571	2726	3571	2641	0.0	1.352139341158652
chrX	AL050309.1	56002824	56002983	0	160	357	12309	357	12149	0.0	0.029385134578977692
chrX	AL050309.1	55985998	55986224	0	227	357	12309	357	12082	0.0	0.02954808806488992
chrX	KLF8	56250230	56250304	0	75	82	9486	82	9411	0.0	0.008713207948145786
chrX	KLF8	56270181	56270321	31	141	82	9486	51	9345	0.2198581560283688	0.005457463884430177
chrX	KLF8	56268912	56268991	0	80	82	9486	82	9406	0.0	0.008717839676802041
chrX	NBDY	56811019	56811179	0	161	408	2378	408	2217	0.0	0.18403247631935046
chrX	NBDY	56732062	56732199	0	138	408	2378	408	2240	0.0	0.18214285714285713
chrX	MIR223HG	66017064	66017189	0	126	0	3451	0	3325	0.0	0.0
chrX	HEPH	66170557	66170737	0	181	1377	7136	1377	6955	0.0	0.19798705966930266
chrX	HEPH	66171126	66171268	0	143	1377	7136	1377	6993	0.0	0.1969111969111969
chrX	AR	67680719	67681003	0	285	3601	12830	3601	12545	0.0	0.28704663212435233
chrX	AR	67568835	67569022	0	188	3601	12830	3601	12642	0.0	0.28484417022623004
chrX	YIPF6	68511848	68511977	0	130	102	8616	102	8486	0.0	0.012019797313221777
chrX	STARD8	68715293	68715375	0	83	0	5575	0	5492	0.0	0.0
chrX	EDA	69670209	69670293	0	85	1089	7019	1089	6934	0.0	0.157052206518604
chrX	EDA	69620895	69620946	0	52	1089	7019	1089	6967	0.0	0.15630831060714798
chrX	GDPD2	70424975	70425089	0	115	25	2654	25	2539	0.0	0.009846396218983852
chrX	GDPD2	70426647	70426741	0	95	25	2654	25	2559	0.0	0.009769441187964049
chrX	GDPD2	70430973	70431126	0	154	25	2654	25	2500	0.0	0.01
chrX	GDPD2	70425353	70425457	25	105	25	2654	0	2549	0.23809523809523808	0.0
chrX	DLG3	70448579	70448633	0	55	184399	7893	184399	7838	0.0	23.526282214850728
chrX	DLG3	70497179	70497221	0	43	184399	7893	184399	7850	0.0	23.49031847133758
chrX	DLG3	70493375	70493475	0	101	184399	7893	184399	7792	0.0	23.665169404517453
chrX	DLG3	70495407	70495453	42	47	184399	7893	184357	7846	0.8936170212765957	23.49694111649248
chrX	NLGN3	71153476	71153536	0	61	0	4014	0	3953	0.0	0.0
chrX	NLGN3	71148845	71148905	0	61	0	4014	0	3953	0.0	0.0
chrX	GJB1	71217720	71217895	0	176	0	4661	0	4485	0.0	0.0
chrX	GJB1	71223186	71223335	0	150	0	4661	0	4511	0.0	0.0
chrX	GJB1	71223219	71223335	0	117	0	4661	0	4544	0.0	0.0
chrX	GJB1	71222583	71222766	0	184	0	4661	0	4477	0.0	0.0
chrX	NONO	71284396	71284453	0	58	0	9256	0	9198	0.0	0.0
chrX	NONO	71294226	71294528	0	303	0	9256	0	8953	0.0	0.0
chrX	NONO	71297835	71297938	0	104	0	9256	0	9152	0.0	0.0
chrX	NONO	71284983	71285097	0	115	0	9256	0	9141	0.0	0.0
chrX	NONO	71299660	71299758	0	99	0	9256	0	9157	0.0	0.0
chrX	NONO	71297839	71297938	0	100	0	9256	0	9156	0.0	0.0
chrX	NONO	71297587	71297677	0	91	0	9256	0	9165	0.0	0.0
chrX	NONO	71294226	71294348	0	123	0	9256	0	9133	0.0	0.0
chrX	NONO	71296564	71296660	0	97	0	9256	0	9159	0.0	0.0
chrX	NONO	71290628	71290791	0	164	0	9256	0	9092	0.0	0.0
chrX	NONO	71288426	71288534	0	109	0	9256	0	9147	0.0	0.0
chrX	NONO	71294397	71294528	0	132	0	9256	0	9124	0.0	0.0
chrX	TAF1	71455006	71455012	0	7	919951	10823	919951	10816	0.0	85.05464127218934
chrX	TAF1	71459149	71459251	0	103	919951	10823	919951	10720	0.0	85.81632462686566
chrX	OGT	71555189	71555385	2001	197	11527	8012	9526	7815	10.157360406091371	1.218937939859245
chrX	NHSL2	72137093	72137225	0	133	0	16667	0	16534	0.0	0.0
chrX	DMRTC1B	72846884	72846945	0	62	0	1921	0	1859	0.0	0.0
chrX	DMRTC1B	72845871	72846005	0	135	0	1921	0	1786	0.0	0.0
chrX	CHIC1	73679653	73679713	0	61	2578	4763	2578	4702	0.0	0.5482773287962569
chrX	CHIC1	73578703	73578785	0	83	2578	4763	2578	4680	0.0	0.5508547008547009
chrX	JPX	73994839	73994961	0	123	306	19827	306	19704	0.0	0.015529841656516443
chrX	JPX	73998767	73998844	0	78	306	19827	306	19749	0.0	0.015494455415464074
chrX	JPX	73998953	74000496	0	1544	306	19827	306	18283	0.0	0.01673685937756386
chrX	JPX	73944583	73944662	0	80	306	19827	306	19747	0.0	0.015496024712614574
chrX	JPX	73999354	74000496	0	1143	306	19827	306	18684	0.0	0.016377649325626204
chrX	JPX	73946998	73947374	0	377	306	19827	306	19450	0.0	0.015732647814910027
chrX	JPX	73998767	74000496	0	1730	306	19827	306	18097	0.0	0.01690887992484942
chrX	JPX	73984443	73984541	0	99	306	19827	306	19728	0.0	0.01551094890510949
chrX	JPX	73962730	73962801	0	72	306	19827	306	19755	0.0	0.015489749430523917
chrX	JPX	73962734	73962801	0	68	306	19827	306	19759	0.0	0.015486613695025051
chrX	JPX	73997043	73997166	0	124	306	19827	306	19703	0.0	0.015530629853321829
chrX	JPX	73997040	73997166	0	127	306	19827	306	19700	0.0	0.015532994923857868
chrX	JPX	73994863	73994961	0	99	306	19827	306	19728	0.0	0.01551094890510949
chrX	JPX	73966510	73966654	0	145	306	19827	306	19682	0.0	0.015547200487755309
chrX	SLC16A2	74529212	74529441	0	230	9643	4299	9643	4069	0.0	2.369869746866552
chrX	SLC16A2	74476962	74477125	0	164	9643	4299	9643	4135	0.0	2.332043530834341
chrX	UPRT	75291674	75291747	0	74	0	3706	0	3632	0.0	0.0
chrX	UPRT	75294562	75294620	0	59	0	3706	0	3647	0.0	0.0
chrX	UPRT	75296341	75296411	0	71	0	3706	0	3635	0.0	0.0
chrX	UPRT	75291392	75291560	0	169	0	3706	0	3537	0.0	0.0
chrX	PBDC1	76176880	76176992	0	113	51	1213	51	1100	0.0	0.046363636363636364
chrX	COX7B	77901743	77901867	0	125	0	3029	0	2904	0.0	0.0
chrX	ATP7A	78012878	78013112	0	235	51	10947	51	10712	0.0	0.0047610156833457805
chrX	ATP7A	77922998	77923042	0	45	51	10947	51	10902	0.0	0.004678040726472207
chrX	ATP7A	77922998	77923052	0	55	51	10947	51	10892	0.0	0.004682335659199412
chrX	ATP7A	77974744	77974808	0	65	51	10947	51	10882	0.0	0.004686638485572505
chrX	LPAR4	78750729	78750792	0	64	140	3119	140	3055	0.0	0.04582651391162029
chrX	P2RY10	78947814	78947863	0	50	0	3580	0	3530	0.0	0.0
chrX	P2RY10	78952192	78952335	0	144	0	3580	0	3436	0.0	0.0
chrX	CYLC1	83872885	83874631	0	1747	0	2133	0	386	0.0	0.0
chrX	ZNF711	85246929	85247188	0	260	1730	5056	1730	4796	0.0	0.36071726438698914
chrX	ZNF711	85267277	85267415	0	139	1730	5056	1730	4917	0.0	0.3518405531828351
chrX	ZNF711	85246929	85247183	0	255	1730	5056	1730	4801	0.0	0.3603415955009373
chrX	DACH2	86376823	86376862	0	40	105	2770	105	2730	0.0	0.038461538461538464
chrX	DACH2	86827765	86827812	0	48	105	2770	105	2722	0.0	0.03857457751653196
chrX	DACH2	86742642	86742726	105	85	105	2770	0	2685	1.2352941176470589	0.0
chrX	DACH2	86184232	86184350	0	119	105	2770	105	2651	0.0	0.03960769520935496
chrX	KLHL4	87666474	87666880	0	407	0	3722	0	3315	0.0	0.0
chrX	PCDH11X	92201374	92201455	0	82	0	11642	0	11560	0.0	0.0
chrX	PCDH11X	92468298	92468322	0	25	0	11642	0	11617	0.0	0.0
chrX	PCDH11X	92263113	92263143	0	31	0	11642	0	11611	0.0	0.0
chrX	FAM133A	93698396	93698485	0	90	0	3385	0	3295	0.0	0.0
chrX	DIAPH2	96763099	96763120	0	22	983	9579	983	9557	0.0	0.10285654494088103
chrX	AL157778.1	98578985	98579074	0	90	0	2649	0	2559	0.0	0.0
chrX	SRPX2	100646321	100646404	3309	84	69381	7526	66072	7442	39.392857142857146	8.878258532652513
chrX	SRPX2	100646192	100646404	5113	213	69381	7526	64268	7313	24.004694835680752	8.788185423218925
chrX	SRPX2	100669247	100669369	153	123	69381	7526	69228	7403	1.2439024390243902	9.351344049709578
chrX	CSTF2	100830807	100830867	0	61	82	2791	82	2730	0.0	0.030036630036630037
chrX	ARL13A	100988377	100988384	0	8	0	1320	0	1312	0.0	0.0
chrX	ARL13A	100988377	100988558	0	182	0	1320	0	1138	0.0	0.0
chrX	DRP2	101231584	101231764	0	181	159	8211	159	8030	0.0	0.019800747198007472
chrX	DRP2	101224603	101224706	0	104	159	8211	159	8107	0.0	0.01961268039965462
chrX	RPL36A	101395334	101395457	0	124	5151	3343	5151	3219	0.0	1.6001863932898415
chrX	RPL36A	101392049	101392095	0	47	5151	3343	5151	3296	0.0	1.5628033980582525
chrX	ARMCX4	101488443	101489315	0	873	224	13064	224	12191	0.0	0.0183742104831433
chrX	ARMCX4	101524203	101524432	0	230	224	13064	224	12834	0.0	0.017453638772011844
chrX	ARMCX3	101624157	101624218	0	62	51	4243	51	4181	0.0	0.012198038746711314
chrX	NXF4	102566516	102566624	0	109	0	2849	0	2740	0.0	0.0
chrX	ARMCX5-GPRASP2	102600919	102601032	0	114	510	8165	510	8051	0.0	0.0633461681778661
chrX	ARMCX5-GPRASP2	102601879	102601977	0	99	510	8165	510	8066	0.0	0.06322836598065956
chrX	ARMCX5-GPRASP2	102601463	102601509	0	47	510	8165	510	8118	0.0	0.06282335550628233
chrX	ARMCX5-GPRASP2	102637995	102638045	0	51	510	8165	510	8114	0.0	0.06285432585654424
chrX	GPRASP1	102651686	102651908	0	223	51	6794	51	6571	0.0	0.00776137574189621
chrX	GPRASP1	102652830	102652898	0	69	51	6794	51	6725	0.0	0.00758364312267658
chrX	GPRASP1	102652174	102652265	0	92	51	6794	51	6702	0.0	0.007609668755595345
chrX	GPRASP1	102651686	102651733	0	48	51	6794	51	6746	0.0	0.007560035576638008
chrX	GPRASP2	102713129	102713217	0	89	69	3852	69	3763	0.0	0.018336433696518734
chrX	BHLHB9	102747816	102747911	0	96	0	5486	0	5390	0.0	0.0
chrX	BHLHB9	102747832	102747911	0	80	0	5486	0	5406	0.0	0.0
chrX	BHLHB9	102747584	102747696	0	113	0	5486	0	5373	0.0	0.0
chrX	LINC00630	102770351	102770420	0	70	295252	11012	295252	10942	0.0	26.983366843355878
chrX	LINC00630	102816991	102817082	0	92	295252	11012	295252	10920	0.0	27.03772893772894
chrX	LINC00630	102825992	102826169	0	178	295252	11012	295252	10834	0.0	27.25235370131069
chrX	LINC00630	102843328	102843407	466	80	295252	11012	294786	10932	5.825	26.96542261251372
chrX	Z68871.1	102901022	102901133	0	112	1717	1139	1717	1027	0.0	1.6718597857838364
chrX	BEX4	103215681	103215764	0	84	7228	1315	7228	1231	0.0	5.871649065800162
chrX	TCEAL9	103357082	103357161	0	80	8142	1048	8142	968	0.0	8.411157024793388
chrX	BEX3	103377027	103377106	0	80	1367	1115	1367	1035	0.0	1.3207729468599034
chrX	TCEAL4	103586218	103586291	0	74	0	2405	0	2331	0.0	0.0
chrX	TCEAL4	103585858	103586107	0	250	0	2405	0	2155	0.0	0.0
chrX	TMSB15B	103964227	103964294	0	68	102	8594	102	8526	0.0	0.011963406052076003
chrX	H2BW2	104041087	104041106	0	20	0	1885	0	1865	0.0	0.0
chrX	PWWP3B	106177223	106177359	0	137	17669	4349	17669	4212	0.0	4.194919278252612
chrX	TBC1D8B	106854197	106854296	0	100	1523	9523	1523	9423	0.0	0.1616258091902791
chrX	DNAAF6	107207147	107207422	0	276	0	1964	0	1688	0.0	0.0
chrX	PRPS1	107639294	107639478	165	185	828	3405	663	3220	0.8918918918918919	0.2059006211180124
chrX	PRPS1	107640901	107641000	0	100	828	3405	828	3305	0.0	0.25052950075642966
chrX	PRPS1	107642365	107642490	0	126	828	3405	828	3279	0.0	0.252516010978957
chrX	PRPS1	107645176	107645350	0	175	828	3405	828	3230	0.0	0.2563467492260062
chrX	PRPS1	107636587	107636679	0	93	828	3405	828	3312	0.0	0.25
chrX	PRPS1	107636993	107637095	0	103	828	3405	828	3302	0.0	0.25075711689884916
chrX	PRPS1	107640903	107641000	0	98	828	3405	828	3307	0.0	0.25037798609011186
chrX	PRPS1	107644360	107644428	0	69	828	3405	828	3336	0.0	0.24820143884892087
chrX	PRPS1	107643222	107643286	0	65	828	3405	828	3340	0.0	0.24790419161676647
chrX	PRPS1	107646123	107646245	0	123	828	3405	828	3282	0.0	0.2522851919561243
chrX	PRPS1	107646147	107646245	0	99	828	3405	828	3306	0.0	0.25045372050816694
chrX	PRPS1	107647961	107648048	0	88	828	3405	828	3317	0.0	0.24962315345191438
chrX	VSIG1	108061427	108061535	0	109	0	3778	0	3669	0.0	0.0
chrX	ATG4A	108128780	108128852	0	73	0	2821	0	2748	0.0	0.0
chrX	ATG4A	108138112	108138191	0	80	0	2821	0	2741	0.0	0.0
chrX	ATG4A	108126792	108127094	0	303	0	2821	0	2518	0.0	0.0
chrX	COL4A5	108695266	108695439	0	174	33	9386	33	9212	0.0	0.0035822839774207554
chrX	TMEM164	110003882	110004164	0	283	13	6593	13	6310	0.0	0.0020602218700475437
chrX	PAK3	111013827	111013900	0	74	2091	10441	2091	10367	0.0	0.20169769460789042
chrX	PAK3	111146520	111146565	0	46	2091	10441	2091	10395	0.0	0.20115440115440114
chrX	PAK3	111144859	111144922	0	64	2091	10441	2091	10377	0.0	0.20150332466030646
chrX	ALG13	111689086	111689197	0	112	0	8141	0	8029	0.0	0.0
chrX	ALG13	111722792	111722857	0	66	0	8141	0	8075	0.0	0.0
chrX	ALG13	111730524	111730580	0	57	0	8141	0	8084	0.0	0.0
chrX	ALG13	111744667	111744904	0	238	0	8141	0	7903	0.0	0.0
chrX	ALG13	111716952	111717004	0	53	0	8141	0	8088	0.0	0.0
chrX	ALG13	111686136	111686174	0	39	0	8141	0	8102	0.0	0.0
chrX	ALG13	111708026	111708393	0	368	0	8141	0	7773	0.0	0.0
chrX	ALG13	111723797	111723898	0	102	0	8141	0	8039	0.0	0.0
chrX	ALG13	111721602	111721711	0	110	0	8141	0	8031	0.0	0.0
chrX	HTR2C	114717585	114717676	0	92	204	4849	204	4757	0.0	0.04288417069581669
chrX	LUZP4	115303299	115303418	0	120	0	1750	0	1630	0.0	0.0
chrX	PLS3	115614152	115614534	0	383	204	4122	204	3739	0.0	0.05456004279219043
chrX	PLS3	115610802	115610921	0	120	204	4122	204	4002	0.0	0.050974512743628186
chrX	PLS3	115640109	115640136	0	28	204	4122	204	4094	0.0	0.049829018075232046
chrX	DANT1	115842643	115842763	0	121	0	449	0	328	0.0	0.0
chrX	SLC6A14	116457608	116457776	0	169	94	4550	94	4381	0.0	0.02145628851860306
chrX	WDR44	118378418	118378452	4474	35	4824	4223	350	4188	127.82857142857142	0.08357211079274117
chrX	WDR44	118387339	118387414	0	76	4824	4223	4824	4147	0.0	1.1632505425608874
chrX	WDR44	118441367	118441559	0	193	4824	4223	4824	4030	0.0	1.1970223325062035
chrX	WDR44	118447059	118447114	0	56	4824	4223	4824	4167	0.0	1.1576673866090712
chrX	DOCK11	118616201	118616240	0	40	387106	6776	387106	6736	0.0	57.468230403800476
chrX	DOCK11	118685519	118685537	0	19	387106	6776	387106	6757	0.0	57.289625573479356
chrX	LINC01285	118841814	118841865	0	52	1478	5759	1478	5707	0.0	0.2589801997546872
chrX	LINC01285	118845240	118845285	0	46	1478	5759	1478	5713	0.0	0.2587082093471031
chrX	LINC01285	118841814	118841871	0	58	1478	5759	1478	5701	0.0	0.25925276267321523
chrX	LINC01285	118881777	118881876	0	100	1478	5759	1478	5659	0.0	0.26117688637568476
chrX	LONRF3	118982820	118982943	1589	124	38309	4054	36720	3930	12.814516129032258	9.34351145038168
chrX	LONRF3	118986924	118987080	0	157	38309	4054	38309	3897	0.0	9.830382345393893
chrX	PGRMC1	119240308	119240464	0	157	0	1922	0	1765	0.0	0.0
chrX	SLC25A43	119406459	119406701	31	243	31	2845	0	2602	0.12757201646090535	0.0
chrX	SLC25A43	119410189	119410362	0	174	31	2845	31	2671	0.0	0.011606140022463497
chrX	UBE2A	119581506	119581596	0	91	811521	4993	811521	4902	0.0	165.54895960832314
chrX	UBE2A	119576944	119577066	0	123	811521	4993	811521	4870	0.0	166.63675564681725
chrX	AKAP14	119914698	119914878	0	181	102	1177	102	996	0.0	0.10240963855421686
chrX	ZBTB33	120252668	120252770	0	103	102	5316	102	5213	0.0	0.01956646844427393
chrX	ATP1B4	120370714	120370843	0	130	51	4781	51	4651	0.0	0.010965383788432596
chrX	GRIA3	123465673	123465788	56	116	3106	6507	3050	6391	0.4827586206896552	0.47723360976373025
chrX	GRIA3	123480062	123480177	0	116	3106	6507	3106	6391	0.0	0.4859959317790643
chrX	XIAP	123860166	123860293	0	128	152	3270	152	3142	0.0	0.0483768300445576
chrX	XIAP	123891237	123891316	0	80	152	3270	152	3190	0.0	0.04764890282131661
chrX	XIAP	123885630	123886539	102	910	152	3270	50	2360	0.11208791208791209	0.0211864406779661
chrX	XIAP	123891237	123891309	0	73	152	3270	152	3197	0.0	0.0475445730372224
chrX	STAG2	124021366	124021431	0	66	0	8243	0	8177	0.0	0.0
chrX	STAG2	124090853	124090964	0	112	0	8243	0	8131	0.0	0.0
chrX	STAG2	124026564	124026687	0	124	0	8243	0	8119	0.0	0.0
chrX	STAG2	123962078	123962106	0	29	0	8243	0	8214	0.0	0.0
chrX	SH2D1A	124367589	124367661	0	73	0	2825	0	2752	0.0	0.0
chrX	SH2D1A	124365760	124365824	0	65	0	2825	0	2760	0.0	0.0
chrX	OCRL	129584343	129584367	0	25	4948	6110	4948	6085	0.0	0.8131470829909614
chrX	OCRL	129575653	129575719	0	67	4948	6110	4948	6043	0.0	0.8187986099619394
chrX	OCRL	129575896	129576062	0	167	4948	6110	4948	5943	0.0	0.8325761399966347
chrX	OCRL	129589236	129589364	0	129	4948	6110	4948	5981	0.0	0.8272864069553586
chrX	UTP14A	129911765	129911921	0	157	0	4103	0	3946	0.0	0.0
chrX	BCORL1	130010507	130010663	0	157	0	8013	0	7856	0.0	0.0
chrX	BCORL1	130024989	130025379	0	391	0	8013	0	7622	0.0	0.0
chrX	BCORL1	130034454	130034676	0	223	0	8013	0	7790	0.0	0.0
chrX	SLC25A14	130346543	130346691	0	149	0	2668	0	2519	0.0	0.0
chrX	SLC25A14	130350645	130350731	0	87	0	2668	0	2581	0.0	0.0
chrX	SLC25A14	130340106	130340344	0	239	0	2668	0	2429	0.0	0.0
chrX	SLC25A14	130359046	130359139	0	94	0	2668	0	2574	0.0	0.0
chrX	SLC25A14	130340106	130340353	0	248	0	2668	0	2420	0.0	0.0
chrX	STK26	132055455	132055521	0	67	0	3330	0	3263	0.0	0.0
chrX	STK26	132069477	132069663	0	187	0	3330	0	3143	0.0	0.0
chrX	STK26	132054630	132054861	0	232	0	3330	0	3098	0.0	0.0
chrX	CCDC160	134238778	134238840	360	63	360	1793	0	1730	5.714285714285714	0.0
chrX	LINC00629	134558379	134558497	0	119	0	2775	0	2656	0.0	0.0
chrX	FAM122C	134847882	134847971	0	90	0	7535	0	7445	0.0	0.0
chrX	FAM122C	134852799	134852896	0	98	0	7535	0	7437	0.0	0.0
chrX	FAM122C	134849166	134849228	0	63	0	7535	0	7472	0.0	0.0
chrX	FAM122C	134847382	134847475	0	94	0	7535	0	7441	0.0	0.0
chrX	FAM122C	134844109	134844193	0	85	0	7535	0	7450	0.0	0.0
chrX	FAM122C	134847885	134847971	0	87	0	7535	0	7448	0.0	0.0
chrX	INTS6L	135556167	135556300	0	134	141354	5582	141354	5448	0.0	25.946035242290748
chrX	INTS6L	135570435	135570546	0	112	141354	5582	141354	5470	0.0	25.841681901279706
chrX	SLC9A6	136028885	136028975	378	91	38335	9929	37957	9838	4.153846153846154	3.8582028867656026
chrX	SLC9A6	136000577	136000651	255	75	38335	9929	38080	9854	3.4	3.8644205398822815
chrX	FHL1	136208454	136208641	0	188	476	5097	476	4909	0.0	0.09696475860664086
chrX	FHL1	136169906	136169980	21	75	476	5097	455	5022	0.28	0.09060135404221425
chrX	FHL1	136160473	136160569	18	97	476	5097	458	5000	0.18556701030927836	0.0916
chrX	FHL1	136209339	136209442	0	104	476	5097	476	4993	0.0	0.09533346685359503
chrX	FHL1	136209242	136209442	40	201	476	5097	436	4896	0.19900497512437812	0.08905228758169935
chrX	FHL1	136182723	136182865	0	143	476	5097	476	4954	0.0	0.09608397254743642
chrX	FHL1	136168129	136168288	0	160	476	5097	476	4937	0.0	0.09641482681790561
chrX	FHL1	136167844	136168035	0	192	476	5097	476	4905	0.0	0.09704383282364934
chrX	FHL1	136167903	136168035	0	133	476	5097	476	4964	0.0	0.0958904109589041
chrX	ADGRG4	136322777	136323392	0	616	0	10103	0	9487	0.0	0.0
chrX	VGLL1	136548588	136549008	0	421	0	1483	0	1062	0.0	0.0
chrX	VGLL1	136548588	136548867	0	280	0	1483	0	1203	0.0	0.0
chrX	CD40LG	136656355	136656418	0	64	0	1857	0	1793	0.0	0.0
chrX	AL390879.1	136921243	136922776	0	1534	0	3942	0	2408	0.0	0.0
chrX	AL390879.1	136925246	136925379	0	134	0	3942	0	3808	0.0	0.0
chrX	Z96074.1	137915531	137915607	0	77	0	2109	0	2032	0.0	0.0
chrX	F9	139541075	139541189	0	115	0	2835	0	2720	0.0	0.0
chrX	LINC00632	140713516	140716289	0	2774	2038	14900	2038	12126	0.0	0.16806861289790534
chrX	LINC00632	140733877	140733964	0	88	2038	14900	2038	14812	0.0	0.13759114231704023
chrX	LINC00632	140768339	140768406	0	68	2038	14900	2038	14832	0.0	0.13740560949298813
chrX	LINC00632	140711991	140712074	0	84	2038	14900	2038	14816	0.0	0.13755399568034557
chrX	LINC00632	140730922	140731044	0	123	2038	14900	2038	14777	0.0	0.13791703322731272
chrX	LINC00632	140713428	140713489	0	62	2038	14900	2038	14838	0.0	0.1373500471761693
chrX	LINC00632	140772077	140772358	0	282	2038	14900	2038	14618	0.0	0.13941715692981255
chrX	LINC00632	140772077	140772251	0	175	2038	14900	2038	14725	0.0	0.13840407470288624
chrX	LINC00632	140768344	140768406	0	63	2038	14900	2038	14837	0.0	0.13735930444159872
chrX	SPANXA2-OT1	141187766	141187837	0	72	0	3893	0	3821	0.0	0.0
chrX	SPANXA2-OT1	141183151	141183229	0	79	0	3893	0	3814	0.0	0.0
chrX	MAGEC3	141896430	141896507	0	78	0	2774	0	2696	0.0	0.0
chrX	FMR1	147928321	147928393	0	73	102	8809	102	8736	0.0	0.011675824175824176
chrX	FMR1	147938098	147938161	0	64	102	8809	102	8745	0.0	0.011663807890222984
chrX	FMR1	147937465	147937600	0	136	102	8809	102	8673	0.0	0.01176063645797302
chrX	FMR1	147943130	147943326	0	197	102	8809	102	8612	0.0	0.011843938690199722
chrX	FMR1	147924918	147925055	0	138	102	8809	102	8671	0.0	0.011763349094683427
chrX	FMR1	147933400	147933540	0	141	102	8809	102	8668	0.0	0.011767420396862021
chrX	FMR1NB	148025910	148026038	0	129	0	1146	0	1017	0.0	0.0
chrX	AFF2	148837646	148837733	0	88	770	14265	770	14177	0.0	0.05431332439867391
chrX	MAGEA8	149883070	149883349	0	280	3459	2367	3459	2087	0.0	1.6574029707714422
chrX	LINC00894	149941056	149941239	294	184	13439	6782	13145	6598	1.5978260869565217	1.9922703849651409
chrX	LINC00894	149943650	149943762	385	113	13439	6782	13054	6669	3.4070796460176993	1.9574149047833258
chrX	LINC00894	149948077	149948175	6	99	13439	6782	13433	6683	0.06060606060606061	2.01002543767769
chrX	LINC00894	149942183	149942329	349	147	13439	6782	13090	6635	2.3741496598639458	1.972871137905049
chrX	LINC00894	149944290	149944570	782	281	13439	6782	12657	6501	2.7829181494661923	1.946931241347485
chrX	LINC00894	149941789	149941847	231	59	13439	6782	13208	6723	3.9152542372881354	1.9645991372899003
chrX	LINC00894	149945347	149945677	1786	331	13439	6782	11653	6451	5.395770392749244	1.806386606727639
chrX	LINC00894	149962582	149962716	0	135	13439	6782	13439	6647	0.0	2.021814352339401
chrX	MAMLD1	150462771	150462846	0	76	0	5969	0	5893	0.0	0.0
chrX	MTM1	150598591	150598686	0	96	649	3847	649	3751	0.0	0.17302052785923755
chrX	MTMR1	150712341	150712365	0	25	43	4511	43	4486	0.0	0.009585376727596968
chrX	MTMR1	150714478	150714529	0	52	43	4511	43	4459	0.0	0.009643417806683112
chrX	MTMR1	150714478	150714532	0	55	43	4511	43	4456	0.0	0.009649910233393177
chrX	MTMR1	150712729	150712753	0	25	43	4511	43	4486	0.0	0.009585376727596968
chrX	MTMR1	150736594	150736780	0	187	43	4511	43	4324	0.0	0.009944495837187789
chrX	MTMR1	150751029	150751240	0	212	43	4511	43	4299	0.0	0.010002326122354036
chrX	MTMR1	150762564	150762737	0	174	43	4511	43	4337	0.0	0.009914687572054416
chrX	MTMR1	150712943	150712970	0	28	43	4511	43	4483	0.0	0.009591791211242472
chrX	VMA21	151396798	151397057	0	260	408	5114	408	4854	0.0	0.08405438813349815
chrX	FATE1	151721394	151721501	0	108	0	1077	0	969	0.0	0.0
chrX	MAGEA2B	152716647	152716745	1627	99	18605	2427	16978	2328	16.434343434343436	7.292955326460481
chrX	MAGEA2B	152715956	152716076	166	121	18605	2427	18439	2306	1.371900826446281	7.996097137901128
chrX	MAGEA2B	152715078	152715157	90	80	18605	2427	18515	2347	1.125	7.888794205368556
chrX	MAGEA2B	152714846	152714928	287	83	18605	2427	18318	2344	3.4578313253012047	7.814846416382252
chrX	MAGEA12	152735147	152735253	0	107	408	1969	408	1862	0.0	0.21911922663802363
chrX	NSDHL	152831633	152831700	0	68	2983	2005	2983	1937	0.0	1.5400103252452246
chrX	ZNF185	152932872	152932971	0	100	301000	4837	301000	4737	0.0	63.542326366898884
chrX	ZNF185	152945266	152945464	0	199	301000	4837	301000	4638	0.0	64.89866321690384
chrX	ZNF185	152920327	152920411	0	85	301000	4837	301000	4752	0.0	63.341750841750844
chrX	ZNF185	152922719	152922809	0	91	301000	4837	301000	4746	0.0	63.42182890855457
chrX	ZNF185	152928574	152928661	0	88	301000	4837	301000	4749	0.0	63.38176458201727
chrX	ZNF185	152936417	152936513	36	97	301000	4837	300964	4740	0.3711340206185567	63.494514767932486
chrX	ZNF275	153336633	153336710	0	78	24604	7519	24604	7441	0.0	3.306544819244725
chrX	ATP2B3	153546087	153546129	0	43	11488029	7513	11488029	7470	0.0	1537.8887550200802
chrX	ATP2B3	153569602	153569756	0	155	11488029	7513	11488029	7358	0.0	1561.2977711334602
chrX	PLXNB3	153766158	153766324	0	167	206129	7027	206129	6860	0.0	30.04795918367347
chrX	SSR4	153797457	153797532	547	76	9406	2164	8859	2088	7.197368421052632	4.242816091954023
chrX	OPN1LW	154154573	154154739	0	167	204	1248	204	1081	0.0	0.1887141535615171
chrX	OPN1MW	154191687	154191853	0	167	0	2004	0	1837	0.0	0.0
chrX	OPN1MW2	154228827	154228993	0	167	0	1267	0	1100	0.0	0.0
chrX	EMD	154379689	154379794	0	106	51	1860	51	1754	0.0	0.029076396807297605
chrX	RPL10	154400463	154400626	0	164	51	4328	51	4164	0.0	0.012247838616714697
chrX	TAZ	154412085	154412214	0	130	161	3645	161	3515	0.0	0.04580369843527738
chrX	TAZ	154419704	154419746	0	43	161	3645	161	3602	0.0	0.044697390338700724
chrX	TAZ	154414100	154414190	0	91	161	3645	161	3554	0.0	0.04530106921778278
chrX	TAZ	154419542	154419623	0	82	161	3645	161	3563	0.0	0.04518664047151277
chrX	TAZ	154418545	154418602	0	58	161	3645	161	3587	0.0	0.04488430443267354
chrX	TAZ	154419542	154419746	0	205	161	3645	161	3440	0.0	0.04680232558139535
chrX	ATP6AP1	154434830	154435050	0	221	273	5136	273	4915	0.0	0.055544252288911494
chrX	ATP6AP1	154431519	154431657	111	139	273	5136	162	4997	0.7985611510791367	0.0324194516710026
chrX	ATP6AP1	154435138	154435186	0	49	273	5136	273	5087	0.0	0.05366620798112837
chrX	ATP6AP1	154434985	154435050	0	66	273	5136	273	5070	0.0	0.05384615384615385
chrX	GDI1	154439709	154439797	0	89	408	4782	408	4693	0.0	0.08693799275516727
chrX	GDI1	154438215	154438386	0	172	408	4782	408	4610	0.0	0.08850325379609544
chrX	PLXNA3	154460156	154460777	6483	622	997333	11650	990850	11028	10.42282958199357	89.84856728327892
chrX	IKBKG	154560406	154560559	0	154	0	3473	0	3319	0.0	0.0
chrX	IKBKG	154542281	154542452	0	172	0	3473	0	3301	0.0	0.0
chrX	IKBKG	154562809	154562953	0	145	0	3473	0	3328	0.0	0.0
chrX	DKC1	154766996	154767061	0	66	40999	3861	40999	3795	0.0	10.8034255599473
chrX	DKC1	154774785	154774844	20379	60	40999	3861	20620	3801	339.65	5.424888187319127
chrX	FUNDC2	155046508	155046584	0	77	12954	7527	12954	7450	0.0	1.738791946308725
chrX	FUNDC2	155047368	155047391	0	24	12954	7527	12954	7503	0.0	1.7265093962415035
chrX	BRCC3	155116056	155116188	0	133	306	3197	306	3064	0.0	0.09986945169712794
chrX	BRCC3	155099314	155099389	0	76	306	3197	306	3121	0.0	0.09804549823774432
chrX	VAMP7	155895622	155895680	0	59	0	2623	0	2564	0.0	0.0
chrX	VAMP7	155919812	155919880	0	69	0	2623	0	2554	0.0	0.0
chrX	IL9R	156007522	156007607	0	86	0	2491	0	2405	0.0	0.0
chrX	WASH6P	156022698	156022834	0	137	0	2698	0	2561	0.0	0.0
chrX	CRLF2	1208805	1208908	0	104	0	1993	0	1889	0.0	0.0
chrX	CRLF2	1208805	1208905	0	101	0	1993	0	1892	0.0	0.0
chrX	ASMTL	1439096	1439144	0	49	249	3520	249	3471	0.0	0.07173725151253241
chrX	DHRSX	2408744	2408813	11929	70	12175	3640	246	3570	170.4142857142857	0.06890756302521009
chrX	DHRSX	2392353	2392474	0	122	12175	3640	12175	3518	0.0	3.460773166571916
chrX	ARSD	2915555	2915692	0	138	51	6092	51	5954	0.0	0.00856567013772254
chrX	ARSD	2923167	2923306	0	140	51	6092	51	5952	0.0	0.008568548387096774
chrX	ARSL	2958273	2958435	0	163	0	2937	0	2774	0.0	0.0
chrX	ARSL	2964223	2964340	0	118	0	2937	0	2819	0.0	0.0
chrX	ARSL	2959602	2959888	0	287	0	2937	0	2650	0.0	0.0
chrX	BX890604.1	3822373	3822580	2659	208	43393	13199	40734	12991	12.783653846153847	3.1355553844969593
chrX	BX890604.1	3818656	3818703	0	48	43393	13199	43393	13151	0.0	3.2995969888221426
chrX	BX890604.1	3822072	3822285	2052	214	43393	13199	41341	12985	9.588785046728972	3.1837504813246054
chrX	BX890604.1	3818441	3818500	371	60	43393	13199	43022	13139	6.183333333333334	3.2743740010655302
chrX	BX890604.1	3860789	3860996	0	208	43393	13199	43393	12991	0.0	3.34023554768686
chrX	AC110995.1	5671083	5671199	0	117	0	1930	0	1813	0.0	0.0
chrX	AC110995.1	5724065	5724287	0	223	0	1930	0	1707	0.0	0.0
chrX	NLGN4X	6032690	6032750	0	61	153	7453	153	7392	0.0	0.020698051948051948
chrX	NLGN4X	6187482	6187789	0	308	153	7453	153	7145	0.0	0.021413575927221835
chrX	PUDP	7116965	7117034	0	70	702	3833	702	3763	0.0	0.18655328195588627
chrX	PNPLA4	7925939	7926132	0	194	51	3419	51	3225	0.0	0.01581395348837209
chrX	MID1	10620289	10620419	0	131	1156	6672	1156	6541	0.0	0.17673138663812873
chrX	MID1	10501406	10501559	49	154	1156	6672	1107	6518	0.3181818181818182	0.16983737342743171
chrX	MID1	10553122	10553244	0	123	1156	6672	1156	6549	0.0	0.17651549854939685
chrX	ARHGAP6	11148629	11148719	0	91	38768	8912	38768	8821	0.0	4.394966557079696
chrX	ARHGAP6	11290382	11290478	0	97	38768	8912	38768	8815	0.0	4.397958026091889
chrX	LINC02154	13287428	13287564	0	137	0	1560	0	1423	0.0	0.0
chrX	TRAPPC2	13734043	13734185	4306	143	43291	5668	38985	5525	30.111888111888113	7.056108597285068
chrX	TRAPPC2	13734049	13734185	4282	137	43291	5668	39009	5531	31.255474452554743	7.052793346591937
chrX	TRAPPC2	13720427	13720497	0	71	43291	5668	43291	5597	0.0	7.734679292478114
chrX	GPM6B	13807649	13807769	0	121	19482	5721	19482	5600	0.0	3.4789285714285714
chrX	GPM6B	13812870	13812908	0	39	19482	5721	19482	5682	0.0	3.4287222808870115
chrX	GEMIN8	14026051	14026221	0	171	7091	2432	7091	2261	0.0	3.136222910216718
chrX	FANCB	14862251	14862332	0	82	50422	3605	50422	3523	0.0	14.312233891569685
chrX	FANCB	14868922	14869043	366	122	50422	3605	50056	3483	3.0	14.371518805627332
chrX	ASB11	15291909	15292027	0	119	1330	3133	1330	3014	0.0	0.44127405441274054
chrX	PIGA	15324664	15324871	0	208	0	5184	0	4976	0.0	0.0
chrX	PIGA	15331215	15331992	0	778	0	5184	0	4406	0.0	0.0
chrX	PIGA	15325913	15326046	0	134	0	5184	0	5050	0.0	0.0
chrX	PIGA	15331589	15331992	0	404	0	5184	0	4780	0.0	0.0
chrX	PIGA	15326949	15327255	0	307	0	5184	0	4877	0.0	0.0
chrX	PIGA	15331819	15331992	0	174	0	5184	0	5010	0.0	0.0
chrX	PIGA	15331215	15331299	0	85	0	5184	0	5099	0.0	0.0
chrX	PIGA	15331873	15331992	0	120	0	5184	0	5064	0.0	0.0
chrX	PIGA	15328343	15328537	0	195	0	5184	0	4989	0.0	0.0
chrX	ACE2	15500497	15500585	0	89	0	5741	0	5652	0.0	0.0
chrX	AP1S2	15828191	15828200	10	10	53339	5359	53329	5349	1.0	9.969900916059077
chrX	AP1S2	15840496	15840591	612	96	53339	5359	52727	5263	6.375	10.018430552916588
chrX	AP1S2	15831451	15831568	123	118	53339	5359	53216	5241	1.0423728813559323	10.153787445144056
chrX	AP1S2	15833443	15833524	0	82	53339	5359	53339	5277	0.0	10.10782641652454
chrX	AC078993.1	16159652	16159695	0	44	12980	1531	12980	1487	0.0	8.728984532616005
chrX	RAI2	17837536	17837730	0	195	204	2626	204	2431	0.0	0.08391608391608392
chrX	RAI2	17837536	17837733	0	198	204	2626	204	2428	0.0	0.08401976935749589
chrX	SCML2	18242438	18242590	0	153	7936	3305	7936	3152	0.0	2.517766497461929
chrX	ADGRG2	18994895	18995048	0	154	1025	5324	1025	5170	0.0	0.19825918762088976
chrX	ADGRG2	19033612	19033654	0	43	1025	5324	1025	5281	0.0	0.19409202802499526
chrX	ADGRG2	19037466	19037490	0	25	1025	5324	1025	5299	0.0	0.19343272315531232
chrX	ADGRG2	19037588	19037636	0	49	1025	5324	1025	5275	0.0	0.1943127962085308
chrX	ADGRG2	19037597	19037636	0	40	1025	5324	1025	5284	0.0	0.19398183194549584
chrX	MAP3K15	19414259	19414332	0	74	259049	5606	259049	5532	0.0	46.827368040491685
chrX	BCLAF3	19923157	19923407	0	251	5486	5764	5486	5513	0.0	0.9951024850353709
chrX	MAP7D2	20050823	20050946	0	124	42255	4385	42255	4261	0.0	9.916686223891105
chrX	MAP7D2	20052877	20052988	0	112	42255	4385	42255	4273	0.0	9.888836882752164
chrX	EIF1AX	20138538	20138622	0	85	145	4421	145	4336	0.0	0.033440959409594094
chrX	RPS6KA3	20187827	20187970	600	144	156452	9830	155852	9686	4.166666666666667	16.090439810035104
chrX	RPS6KA3	20209287	20209404	612	118	156452	9830	155840	9712	5.186440677966102	16.046128500823723
chrX	RPS6KA3	20240568	20240605	0	38	156452	9830	156452	9792	0.0	15.977532679738562
chrX	RPS6KA3	20235492	20235513	0	22	156452	9830	156452	9808	0.0	15.951468189233278
chrX	RPS6KA3	20240568	20240669	0	102	156452	9830	156452	9728	0.0	16.08264802631579
chrX	RPS6KA3	20241592	20241686	0	95	156452	9830	156452	9735	0.0	16.071083718541345
chrX	AL807742.1	21061972	21062120	0	149	0	5068	0	4919	0.0	0.0
chrX	AL807742.1	21029768	21029835	0	68	0	5068	0	5000	0.0	0.0
chrX	SMPX	21733655	21733757	0	103	0	1331	0	1228	0.0	0.0
chrX	ACOT9	23713134	23713208	36	75	64998	6263	64962	6188	0.48	10.498060762766645
chrX	ACOT9	23722669	23722753	0	85	64998	6263	64998	6178	0.0	10.520880543865328
chrX	ACOT9	23734340	23734367	649	28	64998	6263	64349	6235	23.178571428571427	10.320609462710506
chrX	ACOT9	23735918	23736016	663	99	64998	6263	64335	6164	6.696969696969697	10.437216093445814
chrX	APOO	23856301	23856382	0	82	10145	2364	10145	2282	0.0	4.445661700262927
chrX	APOO	23874402	23874457	8972	56	10145	2364	1173	2308	160.21428571428572	0.5082322357019065
chrX	APOO	23833606	23833612	0	7	10145	2364	10145	2357	0.0	4.304200254560882
chrX	PCYT1B	24587240	24587319	0	80	5040	1920	5040	1840	0.0	2.739130434782609
chrX	AC107419.1	27265747	27265811	0	65	204	6825	204	6760	0.0	0.03017751479289941
chrX	AC107419.1	27375860	27376091	0	232	204	6825	204	6593	0.0	0.03094190808433187
chrX	TAB3	30842965	30843049	0	85	21868	9842	21868	9757	0.0	2.241262683201804
chrX	TAB3	30845932	30846071	1471	140	21868	9842	20397	9702	10.507142857142858	2.1023500309214596
chrX	DMD	31172347	31172413	0	67	366	18920	366	18853	0.0	0.019413355964567974
chrX	DMD	31177931	31177970	0	40	366	18920	366	18880	0.0	0.019385593220338983
chrX	DMD	31819974	31820083	0	110	366	18920	366	18810	0.0	0.01945773524720893
chrX	DMD	31126641	31126673	0	33	366	18920	366	18887	0.0	0.019378408429078203
chrX	DMD	32365019	32365199	0	181	366	18920	366	18739	0.0	0.0195314584556273
chrX	SRPX	38154461	38154583	0	123	1953	1998	1953	1875	0.0	1.0416
chrX	SRPX	38178284	38178344	768	61	1953	1998	1185	1937	12.59016393442623	0.6117707795560144
chrX	SRPX	38171880	38172057	675	178	1953	1998	1278	1820	3.792134831460674	0.7021978021978021
chrX	RPGR	38287860	38288041	0	182	45	8385	45	8203	0.0	0.00548579787882482
chrX	RPGR	38291392	38291484	0	93	45	8385	45	8292	0.0	0.005426917510853835
chrX	RPGR	38298955	38299141	0	187	45	8385	45	8198	0.0	0.005489143693583801
chrX	RPGR	38304634	38304790	0	157	45	8385	45	8228	0.0	0.005469129800680603
chrX	RPGR	38322852	38322945	0	94	45	8385	45	8291	0.0	0.005427572066095766
chrX	RPGR	38287093	38288041	0	949	45	8385	45	7436	0.0	0.006051640667025283
chrX	RPGR	38279166	38279205	0	40	45	8385	45	8345	0.0	0.005392450569203115
chrX	RPGR	38272310	38272589	0	280	45	8385	45	8105	0.0	0.005552128315854411
chrX	RPGR	38287093	38287245	0	153	45	8385	45	8232	0.0	0.005466472303206997
chrX	RPGR	38287864	38288041	0	178	45	8385	45	8207	0.0	0.005483124162300475
chrX	RPGR	38295984	38296144	0	161	45	8385	45	8224	0.0	0.005471789883268482
chrX	RPGR	38302612	38302672	0	61	45	8385	45	8324	0.0	0.005406054781355117
chrX	RPGR	38317810	38317893	0	84	45	8385	45	8301	0.0	0.005421033610408385
chrX	LINC01282	39371791	39371850	0	60	0	1432	0	1372	0.0	0.0
chrX	BCOR	40071636	40071690	0	55	389	9975	389	9920	0.0	0.039213709677419356
chrX	MED14	40679863	40680133	0	271	1219	8462	1219	8191	0.0	0.14882187767061408
chrX	CASK	41555599	41555635	0	37	20301	19740	20301	19703	0.0	1.030350708014008
chrX	CASK	41787177	41787283	0	107	20301	19740	20301	19633	0.0	1.034024346763103
chrX	CASK	41557031	41557100	150	70	20301	19740	20151	19670	2.142857142857143	1.0244534824606
chrX	CASK	41622616	41622634	0	19	20301	19740	20301	19721	0.0	1.0294102733127124
chrX	CASK	41529528	41529648	0	121	20301	19740	20301	19619	0.0	1.034762220296651
chrX	CASK	41522998	41523025	0	28	20301	19740	20301	19712	0.0	1.029880275974026
chrX	CASK	41635685	41635769	0	85	20301	19740	20301	19655	0.0	1.0328669549732892
chrX	NDP	43966507	43966602	0	96	0	1823	0	1727	0.0	0.0
chrX	LINC01186	46326374	46326454	2155	81	42716	2534	40561	2453	26.604938271604937	16.535262943334693
chrX	SYN1	47574001	47574590	0	590	19	3747	19	3157	0.0	0.006018371872030409
chrX	ELK1	47649920	47650026	0	107	0	3406	0	3299	0.0	0.0
chrX	UXT	47657571	47657639	0	69	0	1123	0	1054	0.0	0.0
chrX	ZNF182	47988523	47988617	0	95	1836	3605	1836	3510	0.0	0.5230769230769231
chrX	ZNF630	48060818	48060945	0	128	528	3458	528	3330	0.0	0.15855855855855855
chrX	ZNF630	48060818	48060903	0	86	528	3458	528	3372	0.0	0.15658362989323843
chrX	SSX5	48195006	48195129	0	124	0	1493	0	1369	0.0	0.0
chrX	SSX4B	48405943	48406079	35	137	9439	1240	9404	1103	0.25547445255474455	8.525838621940164
chrX	TIMM17B	48895351	48895501	1132	151	315920	2570	314788	2419	7.496688741721854	130.13145928069451
chrX	TIMM17B	48895351	48895972	196580	622	315920	2570	119340	1948	316.04501607717043	61.26283367556468
chrX	TIMM17B	48895351	48895454	760	104	315920	2570	315160	2466	7.3076923076923075	127.80210867802109
chrX	SLC35A2	48904163	48905482	153	1320	3300	2960	3147	1640	0.1159090909090909	1.9189024390243903
chrX	SLC35A2	48909813	48909996	0	184	3300	2960	3300	2776	0.0	1.1887608069164266
chrX	SLC35A2	48904745	48905482	0	738	3300	2960	3300	2222	0.0	1.4851485148514851
chrX	SLC35A2	48904745	48904892	0	148	3300	2960	3300	2812	0.0	1.1735419630156472
chrX	SLC35A2	48910233	48910317	0	85	3300	2960	3300	2875	0.0	1.1478260869565218
chrX	SLC35A2	48909852	48909996	0	145	3300	2960	3300	2815	0.0	1.1722912966252221
chrX	GRIPAP1	48981794	48981872	0	79	78872	6161	78872	6082	0.0	12.968102597829661
chrX	GRIPAP1	48993427	48993578	0	152	78872	6161	78872	6009	0.0	13.125644866034282
chrX	GRIPAP1	48987784	48987877	0	94	78872	6161	78872	6067	0.0	13.000164826108456
chrX	GRIPAP1	49000860	49000959	0	100	78872	6161	78872	6061	0.0	13.013034152780069
chrX	GRIPAP1	49000565	49000689	0	125	78872	6161	78872	6036	0.0	13.066931742876077
chrX	PRAF2	49072432	49072650	0	219	0	1665	0	1446	0.0	0.0
chrX	WDR45	49075135	49075281	0	147	663	3931	663	3784	0.0	0.17521141649048627
chrX	WDR45	49075363	49075465	0	103	663	3931	663	3828	0.0	0.1731974921630094
chrX	WDR45	49076644	49076750	0	107	663	3931	663	3824	0.0	0.17337866108786612
chrX	WDR45	49077642	49077747	0	106	663	3931	663	3825	0.0	0.17333333333333334
chrX	WDR45	49078040	49078112	0	73	663	3931	663	3858	0.0	0.171850699844479
chrX	WDR45	49076644	49076753	0	110	663	3931	663	3821	0.0	0.17351478670505102
chrX	WDR45	49076429	49076524	0	96	663	3931	663	3835	0.0	0.17288135593220338
chrX	WDR45	49076644	49076825	0	182	663	3931	663	3749	0.0	0.17684715924246466
chrX	WDR45	49076644	49076804	0	161	663	3931	663	3770	0.0	0.17586206896551723
chrX	WDR45	49079938	49080095	0	158	663	3931	663	3773	0.0	0.17572223694672676
chrX	SYP	49197714	49197839	0	126	0	4790	0	4664	0.0	0.0
chrX	SYP	49194165	49194361	0	197	0	4790	0	4593	0.0	0.0
chrX	SYP	49197538	49197839	0	302	0	4790	0	4488	0.0	0.0
chrX	SYP	49197486	49197839	0	354	0	4790	0	4436	0.0	0.0
chrX	FOXP3	49253125	49253202	0	78	0	3100	0	3022	0.0	0.0
chrX	FOXP3	49255428	49255509	0	82	0	3100	0	3018	0.0	0.0
chrX	FOXP3	49257663	49257768	0	106	0	3100	0	2994	0.0	0.0
chrX	LINC01284	51101053	51101148	0	96	0	5668	0	5572	0.0	0.0
chrX	LINC01284	51101053	51101144	0	92	0	5668	0	5576	0.0	0.0
chrX	LINC01284	51099800	51099874	0	75	0	5668	0	5593	0.0	0.0
chrX	MAGED4B	52063702	52063750	0	49	102	4000	102	3951	0.0	0.025816249050873197
chrX	SSX2	52698785	52698931	0	147	0	1545	0	1398	0.0	0.0
chrX	FAM156A	52955153	52955246	0	94	193538	5892	193538	5798	0.0	33.38013107968265
chrX	FAM156A	52956272	52956755	0	484	193538	5892	193538	5408	0.0	35.78735207100592
chrX	FAM156A	52957087	52957238	0	152	193538	5892	193538	5740	0.0	33.717421602787454
chrX	FAM156A	52955153	52955243	0	91	193538	5892	193538	5801	0.0	33.36286847095328
chrX	FAM156A	52964083	52964235	0	153	193538	5892	193538	5739	0.0	33.72329674159261
chrX	FAM156A	52957087	52957123	0	37	193538	5892	193538	5855	0.0	33.05516652433817
chrX	KDM5C	53218275	53218398	49	124	91236	8589	91187	8465	0.3951612903225806	10.772238629651506
chrX	KDM5C	53220838	53220916	3215	79	91236	8589	88021	8510	40.69620253164557	10.343243243243244
chrX	KDM5C	53221687	53221730	5953	44	91236	8589	85283	8545	135.29545454545453	9.980456407255705
chrX	KDM5C	53218563	53218712	98	150	91236	8589	91138	8439	0.6533333333333333	10.799620808152625
chrX	IQSEC2	53235782	53235832	390	51	398177	13953	397787	13902	7.647058823529412	28.61365271184002
chrX	IQSEC2	53291894	53291924	38	31	398177	13953	398139	13922	1.2258064516129032	28.597830771440886
chrX	IQSEC2	53279563	53279659	6022	97	398177	13953	392155	13856	62.08247422680412	28.302179561200923
chrX	IQSEC2	53237420	53237516	196	97	398177	13953	397981	13856	2.020618556701031	28.722647228637413
chrX	IQSEC2	53279563	53279776	12949	214	398177	13953	385228	13739	60.50934579439252	28.039013028604703
chrX	SMC1A	53381017	53381087	0	71	273455	10856	273455	10785	0.0	25.355122855818266
chrX	SMC1A	53421894	53422040	51	147	273455	10856	273404	10709	0.3469387755102041	25.530301615463628
chrX	HSD17B10	53431824	53431906	736	83	32268	1118	31532	1035	8.867469879518072	30.465700483091787
chrX	HSD17B10	53431797	53431906	1173	110	32268	1118	31095	1008	10.663636363636364	30.848214285714285
chrX	HUWE1	53544559	53544762	0	204	213808	17357	213808	17153	0.0	12.46475835130881
chrX	HUWE1	53625785	53626034	0	250	213808	17357	213808	17107	0.0	12.498275559712399
chrX	HUWE1	53680558	53680694	0	137	213808	17357	213808	17220	0.0	12.416260162601626
chrX	PHF8	53993600	53993903	0	304	24833	9217	24833	8913	0.0	2.7861550544148996
chrX	PHF8	53995130	53995205	0	76	24833	9217	24833	9141	0.0	2.716661196805601
chrX	WNK3	54228713	54228743	0	31	9310	11498	9310	11467	0.0	0.8118950030522368
chrX	PFKFB1	54960823	54960917	0	95	63631	2183	63631	2088	0.0	30.47461685823755
chrX	PFKFB1	54960823	54960851	0	29	63631	2183	63631	2154	0.0	29.540854224698236
chrX	ALAS2	55013485	55013648	0	164	2815	2059	2815	1895	0.0	1.4854881266490765
chrX	ALAS2	55021051	55021274	0	224	2815	2059	2815	1835	0.0	1.534059945504087
chrX	ALAS2	55027750	55027857	1805	108	2815	2059	1010	1951	16.712962962962962	0.5176832393644285
chrX	ALAS2	55023756	55023867	0	112	2815	2059	2815	1947	0.0	1.445814072932717
chrX	ALAS2	55025819	55026015	0	197	2815	2059	2815	1862	0.0	1.511815252416756
chrX	SPIN3	56978291	56978421	204	131	2630	13521	2426	13390	1.5572519083969465	0.1811799850634802
chrX	SPIN3	56978291	56978498	254	208	2630	13521	2376	13313	1.2211538461538463	0.1784721700593405
chrX	SPIN3	56979297	56979422	40	126	2630	13521	2590	13395	0.31746031746031744	0.19335572974990667
chrX	SPIN3	56978291	56978417	204	127	2630	13521	2426	13394	1.6062992125984252	0.18112587725847396
chrX	SPIN3	56993786	56993888	459	103	2630	13521	2171	13418	4.456310679611651	0.1617975853331346
chrX	LINC01278	63516909	63517082	40	174	1173	13947	1133	13773	0.22988505747126436	0.08226239744427503
chrX	LINC01278	63343205	63343289	0	85	1173	13947	1173	13862	0.0	0.08461982397922378
chrX	LINC01278	63509943	63510079	0	137	1173	13947	1173	13810	0.0	0.08493845039826213
chrX	LINC01278	63238992	63239059	0	68	1173	13947	1173	13879	0.0	0.08451617551696808
chrX	LINC01278	63432363	63432491	0	129	1173	13947	1173	13818	0.0	0.08488927485887972
chrX	LINC01278	63259667	63259817	0	151	1173	13947	1173	13796	0.0	0.08502464482458684
chrX	LINC01278	63314996	63315107	0	112	1173	13947	1173	13835	0.0	0.08478496566678713
chrX	LINC01278	63253448	63253539	204	92	1173	13947	969	13855	2.217391304347826	0.06993865030674846
chrX	LINC01278	63425947	63426052	0	106	1173	13947	1173	13841	0.0	0.08474821183440504
chrX	LINC01278	63516909	63517100	51	192	1173	13947	1122	13755	0.265625	0.08157033805888768
chrX	ARHGEF9	63655493	63655737	8160	245	8262	12238	102	11993	33.30612244897959	0.00850496122738264
chrX	ARHGEF9	63665885	63666017	0	133	8262	12238	8262	12105	0.0	0.6825278810408922
chrX	ARHGEF9	63724531	63724711	0	181	8262	12238	8262	12057	0.0	0.6852450858422493
chrX	ARHGEF9	63754303	63754676	0	374	8262	12238	8262	11864	0.0	0.6963924477410655
chrX	ARHGEF9	63726645	63726693	0	49	8262	12238	8262	12189	0.0	0.6778242677824268
chrX	ARHGEF9	63719673	63719856	51	184	8262	12238	8211	12054	0.27717391304347827	0.681184668989547
chrX	ARHGEF9	63715987	63716119	0	133	8262	12238	8262	12105	0.0	0.6825278810408922
chrX	ARHGEF9	63736989	63737118	0	130	8262	12238	8262	12108	0.0	0.682358771060456
chrX	ARHGEF9	63743368	63743446	0	79	8262	12238	8262	12159	0.0	0.6794966691339749
chrX	ARHGEF9	63638552	63638662	0	111	8262	12238	8262	12127	0.0	0.681289684175806
chrX	ARHGEF9	63725682	63725735	0	54	8262	12238	8262	12184	0.0	0.678102429415627
chrX	ARHGEF9	63724795	63724846	0	52	8262	12238	8262	12186	0.0	0.6779911373707533
chrX	ARHGEF9	63732005	63732310	0	306	8262	12238	8262	11932	0.0	0.6924237344954743
chrX	ARHGEF9	63722761	63722897	0	137	8262	12238	8262	12101	0.0	0.6827534914469878
chrX	ARHGEF9	63656509	63658064	0	1556	8262	12238	8262	10682	0.0	0.7734506646695375
chrX	ARHGEF9	63755833	63755910	0	78	8262	12238	8262	12160	0.0	0.6794407894736842
chrX	MTMR8	64336078	64336128	0	51	0	2817	0	2766	0.0	0.0
chrX	MTMR8	64343610	64343720	0	111	0	2817	0	2706	0.0	0.0
chrX	MTMR8	64345044	64345177	0	134	0	2817	0	2683	0.0	0.0
chrX	ZC4H2	64919041	64919204	78	164	3308	3190	3230	3026	0.47560975609756095	1.0674157303370786
chrX	LAS1L	65529211	65529258	0	48	51	7818	51	7770	0.0	0.006563706563706564
chrX	LAS1L	65528259	65528369	0	111	51	7818	51	7707	0.0	0.006617360840794083
chrX	LAS1L	65532560	65532630	0	71	51	7818	51	7747	0.0	0.006583193494255841
chrX	LAS1L	65533609	65533735	0	127	51	7818	51	7691	0.0	0.0066311272916395785
chrX	LAS1L	65524563	65524614	0	52	51	7818	51	7766	0.0	0.006567087303631213
chrX	LAS1L	65520701	65520817	0	117	51	7818	51	7701	0.0	0.006622516556291391
chrX	LAS1L	65522745	65522849	0	105	51	7818	51	7713	0.0	0.0066122131466355505
chrX	LAS1L	65527275	65527368	0	94	51	7818	51	7724	0.0	0.006602796478508545
chrX	VSIG4	66032467	66032749	0	283	0	2341	0	2058	0.0	0.0
chrX	VSIG4	66025477	66025618	0	142	0	2341	0	2199	0.0	0.0
chrX	PDZD11	70289521	70289593	0	73	25391	1367	25391	1294	0.0	19.622102009273572
chrX	TEX11	70897464	70897586	0	123	3944	3383	3944	3260	0.0	1.2098159509202453
chrX	SNX12	71061842	71061967	0	126	102	2360	102	2234	0.0	0.045658012533572066
chrX	AL590764.2	71107852	71107921	0	70	0	2383	0	2313	0.0	0.0
chrX	AL590764.2	71108598	71108695	0	98	0	2383	0	2285	0.0	0.0
chrX	AL590764.2	71110155	71110295	0	141	0	2383	0	2242	0.0	0.0
chrX	ZMYM3	71242169	71242424	0	256	0	6928	0	6672	0.0	0.0
chrX	ZMYM3	71250431	71250726	0	296	0	6928	0	6632	0.0	0.0
chrX	ERCC6L	72237830	72237948	0	119	0	4347	0	4228	0.0	0.0
chrX	CITED1	72305301	72305422	0	122	0	1756	0	1634	0.0	0.0
chrX	HDAC8	72488932	72489041	0	110	139	18208	139	18098	0.0	0.007680406674770693
chrX	HDAC8	72567888	72568030	0	143	139	18208	139	18065	0.0	0.007694436756158317
chrX	HDAC8	72490928	72491006	0	79	139	18208	139	18129	0.0	0.007667273429312151
chrX	HDAC8	72495155	72495268	0	114	139	18208	139	18094	0.0	0.0076821045650491875
chrX	HDAC8	72568753	72568884	0	132	139	18208	139	18076	0.0	0.007689754370435937
chrX	HDAC8	72349691	72349926	0	236	139	18208	139	17972	0.0	0.007734253282884487
chrX	HDAC8	72330657	72330768	0	112	139	18208	139	18096	0.0	0.0076812555260831125
chrX	HDAC8	72330690	72330876	0	187	139	18208	139	18021	0.0	0.007713223461517119
chrX	HDAC8	72330690	72330768	0	79	139	18208	139	18129	0.0	0.007667273429312151
chrX	HDAC8	72490928	72491000	0	73	139	18208	139	18135	0.0	0.0076647366969947615
chrX	HDAC8	72330815	72330876	0	62	139	18208	139	18146	0.0	0.007660090378044748
chrX	HDAC8	72494195	72494381	0	187	139	18208	139	18021	0.0	0.007713223461517119
chrX	HDAC8	72393958	72394098	0	141	139	18208	139	18067	0.0	0.007693584989206841
chrX	HDAC8	72462361	72462442	0	82	139	18208	139	18126	0.0	0.007668542425245503
chrX	HDAC8	72562635	72562669	0	35	139	18208	139	18173	0.0	0.007648709624167721
chrX	HDAC8	72495155	72495266	0	112	139	18208	139	18096	0.0	0.0076812555260831125
chrX	PHKA1	72601990	72602029	0	40	35	6383	35	6343	0.0	0.005517893741131956
chrX	PHKA1	72620724	72620901	0	178	35	6383	35	6205	0.0	0.0056406124093473006
chrX	PHKA1	72599815	72599866	0	52	35	6383	35	6331	0.0	0.00552835255093982
chrX	XIST	73831065	73831274	816	210	6963	13551	6147	13341	3.8857142857142857	0.4607600629637958
chrX	XIST	73833237	73833374	563	138	6963	13551	6400	13413	4.079710144927536	0.47714903451875046
chrX	XIST	73822070	73822216	0	147	6963	13551	6963	13404	0.0	0.5194717994628469
chrX	XIST	73822070	73822233	0	164	6963	13551	6963	13387	0.0	0.5201314708299096
chrX	XIST	73826114	73826347	78	234	6963	13551	6885	13317	0.3333333333333333	0.517008335210633
chrX	XIST	73822066	73822216	0	151	6963	13551	6963	13400	0.0	0.5196268656716417
chrX	XIST	73831065	73831206	816	142	6963	13551	6147	13409	5.746478873239437	0.4584234469386233
chrX	XIST	73830622	73830790	361	169	6963	13551	6602	13382	2.136094674556213	0.49334927514571814
chrX	FTX	74274341	74274410	0	70	12300	26391	12300	26321	0.0	0.46730747312032217
chrX	FTX	74008874	74009010	0	137	12300	26391	12300	26254	0.0	0.46850003808943397
chrX	FTX	74290394	74290430	0	37	12300	26391	12300	26354	0.0	0.46672231919253243
chrX	FTX	74284742	74284944	3314	203	12300	26391	8986	26188	16.32512315270936	0.34313425996639685
chrX	FTX	74247331	74247424	0	94	12300	26391	12300	26297	0.0	0.46773396204890294
chrX	FTX	74261911	74262030	0	120	12300	26391	12300	26271	0.0	0.4681968710745689
chrX	FTX	74215396	74215536	0	141	12300	26391	12300	26250	0.0	0.4685714285714286
chrX	FTX	74247331	74247422	0	92	12300	26391	12300	26299	0.0	0.4676983915738241
chrX	FTX	74274341	74274457	0	117	12300	26391	12300	26274	0.0	0.4681434117378397
chrX	FTX	74284742	74284948	3530	207	12300	26391	8770	26184	17.053140096618357	0.3349373663305836
chrX	FTX	74285914	74286170	0	257	12300	26391	12300	26134	0.0	0.4706512588964567
chrX	RLIM	74612581	74612643	0	63	19273	10632	19273	10569	0.0	1.8235405430977387
chrX	ABCB7	75098941	75099061	13	121	13	5384	0	5263	0.10743801652892562	0.0
chrX	ABCB7	75114753	75114834	0	82	13	5384	13	5302	0.0	0.0024519049415314977
chrX	ABCB7	75114753	75114831	0	79	13	5384	13	5305	0.0	0.0024505183788878417
chrX	ABCB7	75114620	75114632	0	13	13	5384	13	5371	0.0	0.0024204058834481476
chrX	ABCB7	75112885	75112972	0	88	13	5384	13	5296	0.0	0.0024546827794561933
chrX	ABCB7	75097455	75097538	0	84	13	5384	13	5300	0.0	0.0024528301886792454
chrX	ZDHHC15	75505820	75505847	0	28	2622	6833	2622	6805	0.0	0.38530492285084494
chrX	MIR325HG	76658501	76658668	0	168	0	4180	0	4012	0.0	0.0
chrX	MIR325HG	77007275	77007380	0	106	0	4180	0	4074	0.0	0.0
chrX	MIR325HG	76692966	76693087	0	122	0	4180	0	4058	0.0	0.0
chrX	MIR325HG	76837809	76837892	0	84	0	4180	0	4096	0.0	0.0
chrX	ATRX	77693823	77693937	0	115	221	17249	221	17134	0.0	0.012898330804248861
chrX	ATRX	77717130	77717243	0	114	221	17249	221	17135	0.0	0.01289757805660928
chrX	ATRX	77690802	77690925	0	124	221	17249	221	17125	0.0	0.012905109489051094
chrX	ATRX	77595711	77595785	0	75	221	17249	221	17174	0.0	0.012868289274484686
chrX	ATRX	77691224	77691291	0	68	221	17249	221	17181	0.0	0.01286304638845236
chrX	CYSLTR1	78283453	78283540	0	88	0	5571	0	5483	0.0	0.0
chrX	ITM2A	79363422	79363554	0	133	0	2058	0	1925	0.0	0.0
chrX	CHMP1B2P	80289838	80289905	0	68	357	7056	357	6988	0.0	0.05108757870635375
chrX	HMGN5	81119787	81119817	0	31	0	2398	0	2367	0.0	0.0
chrX	HMGN5	81118729	81118759	0	31	0	2398	0	2367	0.0	0.0
chrX	HMGN5	81197705	81197778	0	74	0	2398	0	2324	0.0	0.0
chrX	HMGN5	81195117	81195297	0	181	0	2398	0	2217	0.0	0.0
chrX	HDX	84475250	84475397	0	148	10590	7271	10590	7123	0.0	1.4867331180682297
chrX	HDX	84488023	84488132	0	110	10590	7271	10590	7161	0.0	1.478843736908253
chrX	SATL1	85093184	85093225	0	42	20773	6989	20773	6947	0.0	2.990211602130416
chrX	SATL1	85117283	85117404	5656	122	20773	6989	15117	6867	46.36065573770492	2.201397990388816
chrX	AL022151.1	96371481	96371525	0	45	153	6265	153	6220	0.0	0.024598070739549838
chrX	PCDH19	100403523	100403664	2076	142	68070	5435	65994	5293	14.619718309859154	12.468165501605895
chrX	TSPAN6	100632484	100632568	0	85	102	4546	102	4461	0.0	0.022864828513786146
chrX	NOX1	100849279	100849426	0	148	29528	2213	29528	2065	0.0	14.299273607748184
chrX	NOX1	100863484	100863595	0	112	29528	2213	29528	2101	0.0	14.054259876249406
chrX	XKRX	100922792	100923061	0	270	73517	3375	73517	3105	0.0	23.67697262479871
chrX	TRMT2B	101037916	101038051	0	136	0	4036	0	3900	0.0	0.0
chrX	TRMT2B	101051250	101051366	0	117	0	4036	0	3919	0.0	0.0
chrX	TAF7L	101276306	101276528	0	223	0	2726	0	2503	0.0	0.0
chrX	TIMM8A	101348060	101348401	0	342	0	3083	0	2741	0.0	0.0
chrX	BTK	101377858	101378023	0	166	0	4323	0	4157	0.0	0.0
chrX	GLA	101400665	101400757	0	93	0	2857	0	2764	0.0	0.0
chrX	GLA	101398369	101398567	0	199	0	2857	0	2658	0.0	0.0
chrX	GLA	101399743	101399800	0	58	0	2857	0	2799	0.0	0.0
chrX	GLA	101405110	101405233	0	124	0	2857	0	2733	0.0	0.0
chrX	GLA	101401232	101401347	0	116	0	2857	0	2741	0.0	0.0
chrX	ARMCX6	101617502	101617584	0	83	0	2071	0	1988	0.0	0.0
chrX	ARMCX6	101617282	101617370	0	89	0	2071	0	1982	0.0	0.0
chrX	ARMCX6	101617291	101617370	0	80	0	2071	0	1991	0.0	0.0
chrX	ARMCX2	101658460	101658569	0	110	0	3553	0	3443	0.0	0.0
chrX	ARMCX2	101658460	101658525	0	66	0	3553	0	3487	0.0	0.0
chrX	ARMCX2	101659418	101659501	0	84	0	3553	0	3469	0.0	0.0
chrX	ARMCX2	101659407	101659501	0	95	0	3553	0	3458	0.0	0.0
chrX	ZMAT1	101918512	101918633	0	122	13666	7107	13666	6985	0.0	1.9564781675017895
chrX	AC235565.2	102372950	102373156	0	207	291	4954	291	4747	0.0	0.0613018748683379
chrX	AC235565.2	102438552	102438674	109	123	291	4954	182	4831	0.8861788617886179	0.0376733595528876
chrX	AC235565.2	102456806	102456914	0	109	291	4954	291	4845	0.0	0.060061919504643964
chrX	TCEAL8	103254604	103254677	0	74	0	551	0	477	0.0	0.0
chrX	MORF4L2	103678498	103678600	0	103	0	2654	0	2551	0.0	0.0
chrX	MORF4L2	103678498	103678651	0	154	0	2654	0	2500	0.0	0.0
chrX	MORF4L2	103684680	103684729	0	50	0	2654	0	2604	0.0	0.0
chrX	GLRA4	103719056	103719271	0	216	0	7972	0	7756	0.0	0.0
chrX	AC234782.2	103708469	103708567	0	99	163	7805	163	7706	0.0	0.021152348819102
chrX	AC234782.2	103728132	103728261	0	130	163	7805	163	7675	0.0	0.021237785016286644
chrX	AC234782.2	103827004	103827078	0	75	163	7805	163	7730	0.0	0.021086675291073737
chrX	AC234782.2	103813121	103813233	0	113	163	7805	163	7692	0.0	0.021190847633905358
chrX	AC234782.2	103788409	103788505	0	97	163	7805	163	7708	0.0	0.02114686040477426
chrX	AC234782.2	103791253	103791400	0	148	163	7805	163	7657	0.0	0.021287710591615515
chrX	TMSB15B-AS1	103914736	103914794	0	59	51	2837	51	2778	0.0	0.0183585313174946
chrX	RBM41	107113396	107113468	0	73	51	4714	51	4641	0.0	0.01098901098901099
chrX	NUP62CL	107154095	107154246	0	152	0	1877	0	1725	0.0	0.0
chrX	NUP62CL	107193028	107193072	0	45	0	1877	0	1832	0.0	0.0
chrX	NUP62CL	107150855	107150967	0	113	0	1877	0	1764	0.0	0.0
chrX	TSC22D3	107777019	107777184	0	166	969	4689	969	4523	0.0	0.21423833738669024
chrX	AL109946.1	107934634	107934680	0	47	100115	3953	100115	3906	0.0	25.631080389144905
chrX	AL109946.1	107934316	107934364	15	49	100115	3953	100100	3904	0.30612244897959184	25.640368852459016
chrX	PSMD10	108087952	108088099	0	148	0	2395	0	2247	0.0	0.0
chrX	PSMD10	108088751	108088850	0	100	0	2395	0	2295	0.0	0.0
chrX	COL4A6	108164599	108164698	0	100	5	9330	5	9230	0.0	0.0005417118093174431
chrX	COL4A6	108169944	108170016	0	73	5	9330	5	9257	0.0	0.0005401317921572864
chrX	COL4A6	108183721	108183772	0	52	5	9330	5	9278	0.0	0.0005389092476826903
chrX	ACSL4	109696143	109696196	0	54	2036	6568	2036	6514	0.0	0.31255756831439974
chrX	ACSL4	109685426	109685444	0	19	2036	6568	2036	6549	0.0	0.3108871583447855
chrX	ACSL4	109691002	109691131	0	130	2036	6568	2036	6438	0.0	0.31624728176452316
chrX	AMMECR1	110264488	110264599	0	112	0	6372	0	6260	0.0	0.0
chrX	DCX	111411969	111411997	0	29	0	10073	0	10044	0.0	0.0
chrX	XACT	114042367	114042484	51	118	1013	26548	962	26430	0.4322033898305085	0.03639803253878169
chrX	LRCH2	115126842	115126893	0	52	0	4974	0	4922	0.0	0.0
chrX	DANT2	115951294	115951383	0	90	102	4390	102	4300	0.0	0.02372093023255814
chrX	KLHL13	118028423	118028497	0	75	7751	6416	7751	6341	0.0	1.2223624034064027
chrX	KLHL13	117983479	117983545	0	67	7751	6416	7751	6349	0.0	1.2208221767207434
chrX	CXORF56	119545462	119545504	0	43	206531	2588	206531	2545	0.0	81.1516699410609
chrX	NKRF	119603461	119603559	0	99	1121195	4550	1121195	4451	0.0	251.89732644349584
chrX	SEPTIN6	119625334	119625379	0	46	4820	5563	4820	5517	0.0	0.8736632227659961
chrX	SEPTIN6	119618712	119618786	0	75	4820	5563	4820	5488	0.0	0.8782798833819242
chrX	UPF3B	119840645	119840684	0	40	0	3097	0	3057	0.0	0.0
chrX	TMEM255A	120285624	120285696	0	73	51	3870	51	3797	0.0	0.013431656570977087
chrX	LAMP2	120439075	120439293	0	219	51	7735	51	7516	0.0	0.006785524215007983
chrX	CUL4B	120532421	120532594	0	174	2142	8106	2142	7932	0.0	0.2700453857791225
chrX	CUL4B	120558248	120558292	0	45	2142	8106	2142	8061	0.0	0.26572385560104206
chrX	C1GALT1C1	120627255	120627427	0	173	0	1811	0	1638	0.0	0.0
chrX	THOC2	123623643	123623709	0	67	51	10063	51	9996	0.0	0.00510204081632653
chrX	TENM1	124487208	124487229	0	22	74	12928	74	12906	0.0	0.00573376724004339
chrX	AL008633.1	129121150	129121238	0	89	7925	7238	7925	7149	0.0	1.1085466498811023
chrX	SMARCA1	129516330	129516497	0	168	3816	4382	3816	4214	0.0	0.9055529188419554
chrX	SMARCA1	129493039	129493075	226	37	3816	4382	3590	4345	6.108108108108108	0.8262370540851554
chrX	ZDHHC9	129814657	129814795	0	139	9078	5255	9078	5116	0.0	1.77443315089914
chrX	AIFM1	130136044	130136185	0	142	102	10093	102	9951	0.0	0.010250226107928851
chrX	AIFM1	130140532	130140617	0	86	102	10093	102	10007	0.0	0.010192864994503847
chrX	AIFM1	130155155	130155286	0	132	102	10093	102	9961	0.0	0.010239935749422748
chrX	AIFM1	130136044	130136181	0	138	102	10093	102	9955	0.0	0.010246107483676544
chrX	AIFM1	130156460	130156603	0	144	102	10093	102	9949	0.0	0.010252286661976077
chrX	AIFM1	130137322	130137525	0	204	102	10093	102	9889	0.0	0.010314490848417434
chrX	AIFM1	130136047	130136185	0	139	102	10093	102	9954	0.0	0.010247136829415311
chrX	AIFM1	130155155	130155187	0	33	102	10093	102	10060	0.0	0.010139165009940358
chrX	ZNF280C	130226758	130226905	0	148	35	4657	35	4509	0.0	0.007762253271235307
chrX	ENOX2	130709242	130709331	0	90	100	4295	100	4205	0.0	0.023781212841854936
chrX	ENOX2	130783546	130783690	0	145	100	4295	100	4150	0.0	0.024096385542168676
chrX	IGSF1	131275477	131275765	0	289	228	7445	228	7156	0.0	0.03186137506987144
chrX	IGSF1	131286436	131286463	0	28	228	7445	228	7417	0.0	0.03074019145206957
chrX	FIRRE	131777622	131777744	0	123	0	9139	0	9016	0.0	0.0
chrX	FIRRE	131695843	131695913	0	71	0	9139	0	9068	0.0	0.0
chrX	FIRRE	131709497	131709556	0	60	0	9139	0	9079	0.0	0.0
chrX	FIRRE	131743095	131743248	0	154	0	9139	0	8985	0.0	0.0
chrX	FIRRE	131711650	131711720	0	71	0	9139	0	9068	0.0	0.0
chrX	FIRRE	131711650	131711744	0	95	0	9139	0	9044	0.0	0.0
chrX	FIRRE	131695466	131695620	0	155	0	9139	0	8984	0.0	0.0
chrX	FIRRE	131703416	131703518	0	103	0	9139	0	9036	0.0	0.0
chrX	FIRRE	131795808	131796331	0	524	0	9139	0	8615	0.0	0.0
chrX	FIRRE	131804971	131805037	0	67	0	9139	0	9072	0.0	0.0
chrX	MBNL3	132384662	132384698	0	37	0	12213	0	12176	0.0	0.0
chrX	MBNL3	132381358	132381432	0	75	0	12213	0	12138	0.0	0.0
chrX	MBNL3	132439434	132439572	0	139	0	12213	0	12074	0.0	0.0
chrX	GPC3	133953049	133953211	0	163	3917	2883	3917	2720	0.0	1.4400735294117648
chrX	GPC3	133704204	133704273	0	70	3917	2883	3917	2813	0.0	1.3924635620334163
chrX	MIR503HG	134545951	134546156	0	206	0	2887	0	2681	0.0	0.0
chrX	PLAC1	134733434	134733519	0	86	0	1909	0	1823	0.0	0.0
chrX	FAM122B	134789579	134789636	0	58	0	4413	0	4355	0.0	0.0
chrX	FAM122B	134772142	134772283	0	142	0	4413	0	4271	0.0	0.0
chrX	MOSPD1	134891478	134891640	0	163	153	2593	153	2430	0.0	0.06296296296296296
chrX	MOSPD1	134899089	134899165	0	77	153	2593	153	2516	0.0	0.060810810810810814
chrX	MAP7D3	136240381	136240486	0	106	50	6907	50	6801	0.0	0.007351860020585208
chrX	RBMX	136876502	136876655	0	154	22	4833	22	4679	0.0	0.004701859371660611
chrX	RBMX	136877914	136878086	1	173	22	4833	21	4660	0.005780346820809248	0.004506437768240343
chrX	RBMX	136877914	136877964	0	51	22	4833	22	4782	0.0	0.004600585529067336
chrX	FGF13	138990507	138990617	0	111	51	20751	51	20640	0.0	0.0024709302325581395
chrX	FGF13	138857511	138857679	0	169	51	20751	51	20582	0.0	0.0024778933048294626
chrX	FGF13	138985017	138985091	0	75	51	20751	51	20676	0.0	0.0024666279744631455
chrX	MCF2	139631394	139631511	0	118	181	5089	181	4971	0.0	0.036411184872259104
chrX	MCF2	139613215	139613263	0	49	181	5089	181	5040	0.0	0.03591269841269841
chrX	ATP11C	139787172	139787244	0	73	68	7441	68	7368	0.0	0.009229098805646038
chrX	ATP11C	139731650	139731755	0	106	68	7441	68	7335	0.0	0.0092706203135651
chrX	ATP11C	139737730	139737796	0	67	68	7441	68	7374	0.0	0.009221589368049905
chrX	FMR1-AS1	147911280	147911384	0	105	0	2104	0	1999	0.0	0.0
chrX	AC244197.3	149526935	149527068	0	134	224	9717	224	9583	0.0	0.02337472607742878
chrX	LINC00893	149536173	149536213	0	41	241	2916	241	2875	0.0	0.08382608695652174
chrX	LINC00893	149538723	149538906	102	184	241	2916	139	2732	0.5543478260869565	0.05087847730600293
chrX	IDS	149491537	149491667	0	131	0	8659	0	8528	0.0	0.0
chrX	IDS	149502074	149502177	0	104	0	8659	0	8555	0.0	0.0
chrX	LINC00893	149537632	149537778	0	147	241	2916	241	2769	0.0	0.08703503069700252
chrX	LINC00893	149536173	149536255	7	83	241	2916	234	2833	0.08433734939759036	0.08259795270031768
chrX	LINC00893	149535946	149535982	0	37	241	2916	241	2879	0.0	0.08370962139631817
chrX	LINC00893	149537632	149537742	0	111	241	2916	241	2805	0.0	0.08591800356506239
chrX	MAGEA9B	149583546	149583633	0	88	4156	1926	4156	1838	0.0	2.261153427638738
chrX	TMEM185A	149603986	149604070	0	85	918	4993	918	4908	0.0	0.18704156479217604
chrX	TMEM185A	149608626	149608834	0	209	918	4993	918	4784	0.0	0.19188963210702342
chrX	TMEM185A	149611286	149611463	0	178	918	4993	918	4815	0.0	0.19065420560747665
chrX	EOLA2	149934376	149934573	45	198	213489	2354	213444	2156	0.22727272727272727	99.0
chrX	EOLA2	149934376	149934568	45	193	213489	2354	213444	2161	0.23316062176165803	98.77093937991671
chrX	CD99L2	150828305	150829604	20	1300	581	5777	561	4477	0.015384615384615385	0.12530712530712532
chrX	CD99L2	150771804	150771822	0	19	581	5777	581	5758	0.0	0.1009030913511636
chrX	CD99L2	150795417	150795486	0	70	581	5777	581	5707	0.0	0.10180480112142982
chrX	MAGEA4-AS1	151907341	151907399	0	59	932	1596	932	1537	0.0	0.6063760572543917
chrX	GABRE	151955367	151955567	0	201	0	7557	0	7356	0.0	0.0
chrX	GABRE	151961282	151961365	0	84	0	7557	0	7473	0.0	0.0
chrX	GABRE	151971139	151971317	0	179	0	7557	0	7378	0.0	0.0
chrX	MAGEA10-MAGEA5	152129488	152129613	0	126	1050	1319	1050	1193	0.0	0.8801341156747695
chrX	MAGEA10	152135989	152136080	0	92	4101	2903	4101	2811	0.0	1.4589114194236927
chrX	MAGEA10	152136061	152136080	0	20	4101	2903	4101	2883	0.0	1.4224765868886577
chrX	CSAG1	152733024	152733236	0	213	42149	1096	42149	883	0.0	47.73386183465459
chrX	CSAG1	152733020	152733236	0	217	42149	1096	42149	879	0.0	47.95108077360637
chrX	MAGEA2	152751724	152751822	0	99	0	2115	0	2016	0.0	0.0
chrX	MAGEA2	152751508	152751574	0	67	0	2115	0	2048	0.0	0.0
chrX	MAGEA2	152753541	152753623	0	83	0	2115	0	2032	0.0	0.0
chrX	MAGEA2	152753312	152753391	0	80	0	2115	0	2035	0.0	0.0
chrX	MAGEA2	152752393	152752513	0	121	0	2115	0	1994	0.0	0.0
chrX	MAGEA6	152769218	152769277	0	60	0	1867	0	1807	0.0	0.0
chrX	TREX2	153445598	153445644	0	47	70	2729	70	2682	0.0	0.02609992542878449
chrX	TREX2	153446008	153446111	0	104	70	2729	70	2625	0.0	0.02666666666666667
chrX	HAUS7	153454876	153455053	0	178	70	2885	70	2707	0.0	0.025858884373845585
chrX	HAUS7	153464987	153465055	70	69	70	2885	0	2816	1.0144927536231885	0.0
chrX	CCNQ	153592505	153592733	860915	229	2515831	1673	1654916	1444	3759.4541484716156	1146.0637119113574
chrX	CCNQ	153594546	153594679	213819	134	2515831	1673	2302012	1539	1595.6641791044776	1495.7842755035738
chrX	CCNQ	153597421	153597706	1922	286	2515831	1673	2513909	1387	6.72027972027972	1812.4794520547946
chrX	PNCK	153672565	153672697	211262	133	2463660	4218	2252398	4085	1588.436090225564	551.3826193390453
chrX	PNCK	153672565	153672666	159160	102	2463660	4218	2304500	4116	1560.3921568627452	559.88824101069
chrX	PNCK	153686500	153686683	0	184	2463660	4218	2463660	4034	0.0	610.7238472979673
chrX	BCAP31	153723507	153723612	0	106	30479	2972	30479	2866	0.0	10.634682484298674
chrX	IDH3G	153789113	153789200	49	88	84138	2656	84089	2568	0.5568181818181818	32.74493769470405
chrX	PDZD4	153807896	153808139	0	244	1226	4353	1226	4109	0.0	0.2983694329520565
chrX	L1CAM	153863882	153864017	353	136	212202	7299	211849	7163	2.5955882352941178	29.57545721066592
chrX	L1CAM	153867799	153867910	14710	112	212202	7299	197492	7187	131.33928571428572	27.479059412828718
chrX	L1CAM	153863367	153863379	26	13	212202	7299	212176	7286	2.0	29.121054076310735
chrX	L1CAM	153873227	153873242	236	16	212202	7299	211966	7283	14.75	29.104215295894548
chrX	L1CAM	153875760	153875944	2520	185	212202	7299	209682	7114	13.621621621621621	29.47455721113298
chrX	L1CAM	153880281	153880363	56	83	212202	7299	212146	7216	0.6746987951807228	29.399390243902438
chrX	ARHGAP4	153910170	153910404	0	235	444	5199	444	4964	0.0	0.0894439967767929
chrX	ARHGAP4	153910921	153910999	0	79	444	5199	444	5120	0.0	0.08671875
chrX	ARHGAP4	153921096	153921159	0	64	444	5199	444	5135	0.0	0.08646543330087633
chrX	ARHGAP4	153919566	153919686	51	121	444	5199	393	5078	0.4214876033057851	0.07739267428121308
chrX	ARHGAP4	153918831	153919053	0	223	444	5199	444	4976	0.0	0.08922829581993569
chrX	ARHGAP4	153910505	153910611	0	107	444	5199	444	5092	0.0	0.08719560094265515
chrX	NAA10	153932070	153932115	0	46	0	4351	0	4305	0.0	0.0
chrX	RENBP	153941949	153942031	0	83	0	2045	0	1962	0.0	0.0
chrX	RENBP	153944079	153944155	0	77	0	2045	0	1968	0.0	0.0
chrX	RENBP	153937091	153937188	0	98	0	2045	0	1947	0.0	0.0
chrX	RENBP	153944121	153944155	0	35	0	2045	0	2010	0.0	0.0
chrX	RENBP	153936003	153936105	0	103	0	2045	0	1942	0.0	0.0
chrX	HCFC1	153961541	153961648	0	108	51	9037	51	8929	0.0	0.005711725837159816
chrX	IRAK1	154012528	154012678	1443	151	88402	3637	86959	3486	9.556291390728477	24.94520940906483
chrX	IRAK1	154018005	154018120	121	116	88402	3637	88281	3521	1.043103448275862	25.07270661743823
chrX	IRAK1	154013042	154013433	21824	392	88402	3637	66578	3245	55.673469387755105	20.517103235747303
chrX	IRAK1	154014041	154014278	0	238	88402	3637	88402	3399	0.0	26.008237716975582
chrX	IRAK1	154016031	154016097	0	67	88402	3637	88402	3570	0.0	24.7624649859944
chrX	IRAK1	154013042	154013343	2055	302	88402	3637	86347	3335	6.804635761589404	25.891154422788606
chrX	MECP2	154092183	154092307	0	125	9171	6999	9171	6874	0.0	1.334157695664824
chrX	MECP2	154058398	154058566	0	169	9171	6999	9171	6830	0.0	1.342752562225476
chrX	MECP2	154058398	154058548	0	151	9171	6999	9171	6848	0.0	1.3392231308411215
chrX	MECP2	154072990	154073106	0	117	9171	6999	9171	6882	0.0	1.332606800348736
chrX	FLNA	154352552	154352675	688	124	116779	9862	116091	9738	5.548387096774194	11.921441774491681
chrX	FLNA	154353553	154353727	2119	175	116779	9862	114660	9687	12.108571428571429	11.836481882935894
chrX	FLNA	154357250	154357274	0	25	116779	9862	116779	9837	0.0	11.871403883297754
chrX	FLNA	154365744	154365801	0	58	116779	9862	116779	9804	0.0	11.911362709098327
chrX	DNASE1L1	154409417	154409675	0	259	0	3587	0	3328	0.0	0.0
chrX	DNASE1L1	154409111	154409196	0	86	0	3587	0	3501	0.0	0.0
chrX	DNASE1L1	154409417	154409813	0	397	0	3587	0	3190	0.0	0.0
chrX	UBL4A	154486227	154486333	0	107	204	1102	204	995	0.0	0.2050251256281407
chrX	FAM3A	154507810	154507861	0	52	561	4886	561	4834	0.0	0.11605295821266032
chrX	FAM3A	154508473	154508597	255	125	561	4886	306	4761	2.04	0.06427221172022685
chrX	FAM3A	154512822	154512936	0	115	561	4886	561	4771	0.0	0.11758541186334102
chrX	FAM3A	154512313	154512411	0	99	561	4886	561	4787	0.0	0.11719239607269688
chrX	FAM3A	154507810	154507882	0	73	561	4886	561	4813	0.0	0.11655931851236236
chrX	FAM3A	154508473	154508811	255	339	561	4886	306	4547	0.7522123893805309	0.06729711897954696
chrX	FAM3A	154508473	154508652	255	180	561	4886	306	4706	1.4166666666666667	0.06502337441563961
chrX	FAM3A	154512313	154512431	0	119	561	4886	561	4767	0.0	0.11768407803650094
chrX	GAB3	154680131	154680248	0	118	3162	5284	3162	5166	0.0	0.6120789779326364
chrX	GAB3	154712228	154712701	398	474	3162	5284	2764	4810	0.8396624472573839	0.5746361746361747
chrX	MPP1	154799744	154799893	0	150	332	5410	332	5260	0.0	0.06311787072243347
chrX	MPP1	154804696	154804827	0	132	332	5410	332	5278	0.0	0.06290261462675256
chrX	MPP1	154789953	154790022	0	70	332	5410	332	5340	0.0	0.062172284644194754
chrX	F8	154947697	154947907	0	211	1071	10987	1071	10776	0.0	0.09938752783964365
chrX	F8	154977351	154977441	0	91	1071	10987	1071	10896	0.0	0.09829295154185022
chrX	F8	155022409	155022496	0	88	1071	10987	1071	10899	0.0	0.09826589595375723
chrX	MTCP1	155065905	155066057	0	153	0	2468	0	2315	0.0	0.0
chrX	CLIC2	155298784	155298910	0	127	0	2848	0	2721	0.0	0.0
chrY	PLCXD1	281481	281684	0	204	741	6077	741	5873	0.0	0.12617061127192236
chrY	CSF2RA	1274754	1274842	0	89	421	3562	421	3473	0.0	0.1212208465303772
chrY	CSF2RA	1285777	1285920	0	144	421	3562	421	3418	0.0	0.12317144528964306
chrY	CSF2RA	1303260	1303362	0	103	421	3562	421	3459	0.0	0.12171147730557964
chrY	CSF2RA	1300490	1300626	33	137	421	3562	388	3425	0.24087591240875914	0.11328467153284671
chrY	CSF2RA	1303922	1304019	78	98	421	3562	343	3464	0.7959183673469388	0.09901847575057737
chrY	CSF2RA	1274754	1274818	0	65	421	3562	421	3497	0.0	0.12038890477552187
chrY	CSF2RA	1282408	1282560	0	153	421	3562	421	3409	0.0	0.1234966265767087
chrY	CSF2RA	1305445	1305527	16	83	421	3562	405	3479	0.1927710843373494	0.1164127622880138
chrY	AKAP17A	1600137	1600207	0	71	204	3371	204	3300	0.0	0.06181818181818182
chrY	ASMT	1632703	1632787	0	85	51	1797	51	1712	0.0	0.029789719626168224
chrY	ASMT	1633149	1633290	0	142	51	1797	51	1655	0.0	0.03081570996978852
chrY	CD99P1	2622689	2622734	0	46	947	5932	947	5886	0.0	0.16089024804621135
chrY	CD99	2717604	2717652	0	49	0	4873	0	4824	0.0	0.0
chrY	CD99	2733356	2733374	0	19	0	4873	0	4854	0.0	0.0
chrY	CD99	2727292	2727343	0	52	0	4873	0	4821	0.0	0.0
chrY	ZFY	2961073	2961646	0	574	0	5444	0	4870	0.0	0.0
chrY	ZFY	2976669	2976822	0	154	0	5444	0	5290	0.0	0.0
chrY	ZFY	2953908	2953997	0	90	0	5444	0	5354	0.0	0.0
chrY	LINC00278	3102084	3102194	0	111	0	4194	0	4083	0.0	0.0
chrY	LINC00278	3058656	3058784	0	129	0	4194	0	4065	0.0	0.0
chrY	LINC00278	3079283	3079341	0	59	0	4194	0	4135	0.0	0.0
chrY	PCDH11Y	5030898	5031067	0	170	0	10882	0	10712	0.0	0.0
chrY	PCDH11Y	5002687	5002758	0	72	0	10882	0	10810	0.0	0.0
chrY	TTTY7	6457158	6457414	0	257	0	1473	0	1216	0.0	0.0
chrY	TBL1Y	6978212	6978243	0	32	51	2646	51	2614	0.0	0.019510328997704666
chrY	TBL1Y	6995803	6995898	0	96	51	2646	51	2550	0.0	0.02
chrY	TTTY12	7805543	7805625	0	83	0	1178	0	1095	0.0	0.0
chrY	USP9Y	12847238	12847327	0	90	0	15112	0	15022	0.0	0.0
chrY	USP9Y	12708633	12708693	0	61	0	15112	0	15051	0.0	0.0
chrY	ANOS2P	13854443	13854577	0	135	0	4421	0	4286	0.0	0.0
chrY	ANOS2P	13790918	13790966	0	49	0	4421	0	4372	0.0	0.0
chrY	NLGN4Y	14622008	14622591	0	584	153	8602	153	8018	0.0	0.01908206535295585
chrY	NLGN4Y	14719458	14719518	0	61	153	8602	153	8541	0.0	0.01791359325605901
chrY	NLGN4Y	14748618	14748729	0	112	153	8602	153	8490	0.0	0.01802120141342756
chrY	OFD1P6Y	18732158	18732272	0	115	0	4111	0	3996	0.0	0.0
chrY	TXLNGY	19591779	19591959	0	181	0	8366	0	8185	0.0	0.0
chrY	TXLNGY	19569384	19569459	0	76	0	8366	0	8290	0.0	0.0
chrY	TXLNGY	19591919	19591959	0	41	0	8366	0	8325	0.0	0.0
chrY	TXLNGY	19598551	19598639	0	89	0	8366	0	8277	0.0	0.0
chrY	EIF1AY	20584473	20584524	0	52	0	2900	0	2848	0.0	0.0
chrY	RBMY1B	21517056	21517234	0	179	0	2279	0	2100	0.0	0.0
chrY	RBMY1B	21524511	21524622	0	112	0	2279	0	2167	0.0	0.0
chrY	RBMY1A1	21548052	21548163	0	112	0	2267	0	2155	0.0	0.0
chrY	RBMY1A1	21540597	21540775	0	179	0	2267	0	2088	0.0	0.0
chrY	RBMY1J	22409151	22409329	0	179	0	1907	0	1728	0.0	0.0
chrY	PRY	22512637	22512752	0	116	0	1359	0	1243	0.0	0.0
chrY	BPY2	22994480	22994598	0	119	51	1447	51	1328	0.0	0.038403614457831324
chrY	DAZ2	23236827	23236899	0	73	0	4192	0	4119	0.0	0.0
chrY	DAZ2	23246385	23246457	0	73	0	4192	0	4119	0.0	0.0
chrY	DAZ2	23253540	23253612	0	73	0	4192	0	4119	0.0	0.0
chrY	DAZ2	23239209	23239281	0	73	0	4192	0	4119	0.0	0.0
chrY	DAZ2	23255917	23255989	0	73	0	4192	0	4119	0.0	0.0
chrY	DAZ2	23243989	23244061	0	73	0	4192	0	4119	0.0	0.0
chrY	DAZ2	23251144	23251216	0	73	0	4192	0	4119	0.0	0.0
chrY	BPY2B	24628221	24628339	0	119	0	1447	0	1328	0.0	0.0
chrY	DAZ4	24888533	24888605	0	73	0	4377	0	4304	0.0	0.0
chrY	DAZ4	24893302	24893374	0	73	0	4377	0	4304	0.0	0.0
chrY	VAMP7	57082142	57082200	0	59	0	2623	0	2564	0.0	0.0
chrY	VAMP7	57106332	57106400	0	69	0	2623	0	2554	0.0	0.0
chrY	IL9R	57194042	57194127	0	86	0	2491	0	2405	0.0	0.0
chrY	WASH6P	57209218	57209354	0	137	0	2698	0	2561	0.0	0.0
chrY	CRLF2	1208805	1208908	0	104	0	1993	0	1889	0.0	0.0
chrY	CRLF2	1208805	1208905	0	101	0	1993	0	1892	0.0	0.0
chrY	ASMTL	1439096	1439144	0	49	519	3520	519	3471	0.0	0.1495246326707001
chrY	DHRSX	2408744	2408813	0	70	1424	3640	1424	3570	0.0	0.3988795518207283
chrY	DHRSX	2392353	2392474	0	122	1424	3640	1424	3518	0.0	0.40477544059124504
chrY	TTTY2B	6419764	6419851	0	88	0	5866	0	5778	0.0	0.0
chrY	AMELY	6868867	6868909	0	43	0	998	0	955	0.0	0.0
chrY	RFTN1P1	7805494	7805604	0	111	0	3939	0	3828	0.0	0.0
chrY	TTTY7B	9707315	9707571	0	257	0	1473	0	1216	0.0	0.0
chrY	RBMY2QP	10024356	10024471	0	116	51	1635	51	1519	0.0	0.03357472021066491
chrY	GYG2P1	12407192	12407309	0	118	0	5162	0	5044	0.0	0.0
chrY	UTY	13251016	13251187	0	172	3446	9223	3446	9051	0.0	0.3807314108938239
chrY	UTY	13306037	13306112	0	76	3446	9223	3446	9147	0.0	0.3767355417076637
chrY	UTY	13359087	13359222	1120	136	3446	9223	2326	9087	8.235294117647058	0.2559700671288654
chrY	UTY	13360429	13360528	0	100	3446	9223	3446	9123	0.0	0.37772662501370163
chrY	UTY	13393858	13393893	0	36	3446	9223	3446	9187	0.0	0.37509524327854576
chrY	UTY	13354785	13354833	0	49	3446	9223	3446	9174	0.0	0.37562677131022454
chrY	UTY	13358463	13358553	0	91	3446	9223	3446	9132	0.0	0.3773543583004818
chrY	UTY	13358463	13358619	31	157	3446	9223	3415	9066	0.19745222929936307	0.3766821089786014
chrY	UTY	13396917	13396972	0	56	3446	9223	3446	9167	0.0	0.3759136031417039
chrY	TTTY9B	18588130	18588244	0	115	153	1648	153	1533	0.0	0.09980430528375733
chrY	TTTY14	18789810	18789919	0	110	408	17451	408	17341	0.0	0.023528054898794764
chrY	TTTY14	18813615	18813743	0	129	408	17451	408	17322	0.0	0.023553862140630412
chrY	TTTY14	18927075	18928373	0	1299	408	17451	408	16152	0.0	0.02526002971768202
chrY	TTTY14	19068723	19068798	0	76	408	17451	408	17375	0.0	0.02348201438848921
chrY	TTTY14	18877067	18877205	0	139	408	17451	408	17312	0.0	0.02356746765249538
chrY	TTTY14	18932742	18932841	0	100	408	17451	408	17351	0.0	0.023514494841795863
chrY	TTTY14	19073498	19073561	0	64	408	17451	408	17387	0.0	0.02346580778742739
chrY	TTTY14	18932650	18932841	0	192	408	17451	408	17259	0.0	0.02363984008343473
chrY	TTTY14	19045241	19045291	0	51	408	17451	408	17400	0.0	0.023448275862068966
chrY	BCORP1	19457056	19457117	0	62	0	10235	0	10173	0.0	0.0
chrY	BCORP1	19459958	19460104	0	147	0	10235	0	10088	0.0	0.0
chrY	KDM5D	19739527	19739662	0	136	0	9273	0	9137	0.0	0.0
chrY	KDM5D	19741317	19741488	0	172	0	9273	0	9101	0.0	0.0
chrY	KDM5D	19741734	19741857	0	124	0	9273	0	9149	0.0	0.0
chrY	KDM5D	19723340	19723433	0	94	0	9273	0	9179	0.0	0.0
chrY	TTTY10	20469871	20469981	0	111	0	8026	0	7915	0.0	0.0
chrY	TTTY10	20518270	20518329	0	60	0	8026	0	7966	0.0	0.0
chrY	TTTY10	20524267	20524440	0	174	0	8026	0	7852	0.0	0.0
chrY	TTTY10	20565067	20565191	0	125	0	8026	0	7901	0.0	0.0
chrY	TTTY10	20519035	20519233	0	199	0	8026	0	7827	0.0	0.0
chrY	RBMY1D	21881239	21881350	0	112	0	1933	0	1821	0.0	0.0
chrY	RBMY1D	21888627	21888805	0	179	0	1933	0	1754	0.0	0.0
chrY	RBMY1E	21904780	21904891	0	112	0	1933	0	1821	0.0	0.0
chrY	RBMY1E	21912168	21912346	0	179	0	1933	0	1754	0.0	0.0
chrY	PRY2	22073643	22073758	0	116	0	1359	0	1243	0.0	0.0
chrY	RBMY1F	22169704	22169815	0	112	0	1933	0	1821	0.0	0.0
chrY	RBMY1F	22177093	22177271	0	179	0	1933	0	1754	0.0	0.0
chrY	DAZ1	23143010	23143082	0	73	51	4311	51	4238	0.0	0.012033978291647004
chrY	DAZ1	23155173	23155245	0	73	51	4311	51	4238	0.0	0.012033978291647004
chrY	DAZ1	23159952	23160024	0	73	51	4311	51	4238	0.0	0.012033978291647004
chrY	DAZ1	23138209	23138281	0	73	51	4311	51	4238	0.0	0.012033978291647004
chrY	DAZ1	23139846	23139881	0	36	51	4311	51	4275	0.0	0.011929824561403509
chrY	DAZ3	24784136	24784208	0	73	51	3535	51	3462	0.0	0.014731369150779897
chrY	DAZ3	24786513	24786585	0	73	51	3535	51	3462	0.0	0.014731369150779897
chrY	DAZ3	24791270	24791342	0	73	51	3535	51	3462	0.0	0.014731369150779897
chrY	DAZ3	24796026	24796098	0	73	51	3535	51	3462	0.0	0.014731369150779897
chrY	BPY2C	25041768	25041886	0	119	0	1447	0	1328	0.0	0.0
