chrom	geneName	splicedExonStart	splicedExonEnd	splicedExonReadCount(rc)	splicedExonLength(sl)	othersExonsReadCount(RC)	othersExonsLength(L)	RC - rc	L - sl	splicedExonAverageReadCoverage(n)	otherExonsAverageReadCoverage(N)
chr1	LINC01409	804841	804966	0	126	32806	6771	32806	6645	0.0	4.9369450714823175
chr1	LINC01409	782044	782136	51	93	32806	6771	32755	6678	0.5483870967741935	4.904911650194669
chr1	LINC01128	852015	852110	273	96	56879	13620	56606	13524	2.84375	4.1855959775214435
chr1	LINC01128	852095	852110	16	16	56879	13620	56863	13604	1.0	4.17987356659806
chr1	LINC01128	841374	844498	11317	3125	56879	13620	45562	10495	3.62144	4.34130538351596
chr1	LINC01128	855122	855136	0	15	56879	13620	56879	13605	0.0	4.180742374127159
chr1	LINC01128	852111	852766	408	656	56879	13620	56471	12964	0.6219512195121951	4.355985806849738
chr1	LINC01128	827776	827853	0	78	56879	13620	56879	13542	0.0	4.200191995273962
chr1	LINC01128	827850	827853	0	4	56879	13620	56879	13616	0.0	4.177364864864865
chr1	LINC01128	852015	852094	257	80	56879	13620	56622	13540	3.2125	4.181831610044314
chr1	LINC01128	827854	828127	0	274	56879	13620	56879	13346	0.0	4.2618762175932865
chr1	LINC01128	827850	828127	0	278	56879	13620	56879	13342	0.0	4.263153949932544
chr1	SAMD11	939413	939460	89	48	29500	4083	29411	4035	1.8541666666666667	7.2889714993804215
chr1	KLHL17	964168	964180	0	13	1275	3324	1275	3311	0.0	0.38508003624282694
chr1	ISG15	1001264	1001281	3040	18	15201	864	12161	846	168.88888888888889	14.374704491725769
chr1	TTLL10	1179738	1179853	490	116	17704	4015	17214	3899	4.224137931034483	4.414978199538343
chr1	SCNN1D	1282316	1282319	8	4	51188	3430	51180	3426	2.0	14.938704028021016
chr1	MRPL20-AS1	1399686	1399689	0	4	153	2407	153	2403	0.0	0.06367041198501873
chr1	MIB2	1623483	1623699	337	217	67209	7887	66872	7670	1.5529953917050692	8.71864406779661
chr1	MIB2	1623680	1623699	0	20	67209	7887	67209	7867	0.0	8.543154951061396
chr1	MIB2	1623483	1623679	337	197	67209	7887	66872	7690	1.7106598984771573	8.695968790637192
chr1	MMP23B	1633356	1633480	0	125	110201	2013	110201	1888	0.0	58.36917372881356
chr1	GABRD	2025402	2025432	0	31	51	4393	51	4362	0.0	0.011691884456671253
chr1	GABRD	2028288	2028292	0	5	51	4393	51	4388	0.0	0.01162260711030082
chr1	GABRD	2029267	2029408	0	142	51	4393	51	4251	0.0	0.011997177134791814
chr1	PLCH2	2502410	2502910	0	501	16039	6815	16039	6314	0.0	2.5402280646183084
chr1	TNFRSF14	2555851	2556252	0	402	0	4905	0	4503	0.0	0.0
chr1	TNFRSF14	2556033	2556252	0	220	0	4905	0	4685	0.0	0.0
chr1	TNFRSF14	2556253	2556261	0	9	0	4905	0	4896	0.0	0.0
chr1	SMIM1	3772789	3772841	0	53	7893	996	7893	943	0.0	8.370095440084835
chr1	DFFB	3858845	3858866	0	22	0	3880	0	3858	0.0	0.0
chr1	LINC01777	4412350	4412632	0	283	102	2582	102	2299	0.0	0.04436711613745106
chr1	KCNAB2	6097358	6097555	0	198	42121	13510	42121	13312	0.0	3.1641376201923075
chr1	KCNAB2	6034795	6034963	0	169	42121	13510	42121	13341	0.0	3.1572595757439474
chr1	KCNAB2	6046184	6046357	17775	174	42121	13510	24346	13336	102.15517241379311	1.8255848830233954
chr1	KCNAB2	6094486	6094962	0	477	42121	13510	42121	13033	0.0	3.231872937926801
chr1	ESPN	6448803	6449091	32	289	10054	6800	10022	6511	0.11072664359861592	1.5392412839809553
chr1	ZBTB48	6580050	6580136	168	87	213031	3499	212863	3412	1.9310344827586208	62.38657678780774
chr1	ZBTB48	6580071	6580136	42	66	213031	3499	212989	3433	0.6363636363636364	62.041654529565974
chr1	ZBTB48	6580050	6580070	126	21	213031	3499	212905	3478	6.0	61.214778608395626
chr1	LINC01672	6724851	6724855	145	5	5326	2191	5181	2186	29.0	2.370082342177493
chr1	PER3	7810568	7810588	0	21	22788	7397	22788	7376	0.0	3.089479392624729
chr1	PARK7	7961736	7961793	0	58	102	2378	102	2320	0.0	0.04396551724137931
chr1	PARK7	7962082	7962101	0	20	102	2378	102	2358	0.0	0.043256997455470736
chr1	AL139424.2	10396371	10396376	0	6	2997	1237	2997	1231	0.0	2.4346060113728676
chr1	TARDBP	11012429	11012480	0	52	153	4648	153	4596	0.0	0.03328981723237598
chr1	TARDBP	11012429	11012606	0	178	153	4648	153	4470	0.0	0.03422818791946309
chr1	TARDBP	11012481	11012606	0	126	153	4648	153	4522	0.0	0.03383458646616541
chr1	TARDBP	11022178	11022241	11	64	153	4648	142	4584	0.171875	0.030977312390924956
chr1	TARDBP	11022242	11022250	9	9	153	4648	144	4639	1.0	0.031041172666522957
chr1	TARDBP	11022178	11022250	20	73	153	4648	133	4575	0.273972602739726	0.02907103825136612
chr1	TARDBP	11022242	11022268	27	27	153	4648	126	4621	1.0	0.027266825362475655
chr1	TARDBP	11022251	11022268	18	18	153	4648	135	4630	1.0	0.029157667386609073
chr1	TARDBP	11022178	11022268	38	91	153	4648	115	4557	0.4175824175824176	0.02523590081193768
chr1	TARDBP	11023330	11023667	51	338	153	4648	102	4310	0.15088757396449703	0.023665893271461718
chr1	EXOSC10-AS1	11099815	11099910	0	96	0	538	0	442	0.0	0.0
chr1	FBXO44	11658365	11658393	0	29	0	3061	0	3032	0.0	0.0
chr1	AGTRAP	11748590	11748610	0	21	247528	2351	247528	2330	0.0	106.2351931330472
chr1	MFN2	12007250	12007295	0	46	419893	10140	419893	10094	0.0	41.59827620368536
chr1	PDPN	13614406	13614411	0	6	0	3705	0	3699	0.0	0.0
chr1	PDPN	13584101	13584188	0	88	0	3705	0	3617	0.0	0.0
chr1	PDPN	13585569	13585639	0	71	0	3705	0	3634	0.0	0.0
chr1	PRDM2	13732856	13732882	0	27	486	10938	486	10911	0.0	0.04454220511410503
chr1	FHAD1	15341889	15341893	0	5	5626	11501	5626	11496	0.0	0.4893876130828114
chr1	DNAJC16	15566181	15566410	0	230	2105	7125	2105	6895	0.0	0.3052936910804931
chr1	DNAJC16	15566300	15566410	0	111	2105	7125	2105	7014	0.0	0.30011405759908755
chr1	DNAJC16	15566181	15566299	0	119	2105	7125	2105	7006	0.0	0.3004567513559806
chr1	FBLIM1	15756729	15756732	905	4	19561	4315	18656	4311	226.25	4.327534214799351
chr1	FBLIM1	15758330	15758355	20	26	19561	4315	19541	4289	0.7692307692307693	4.55607367684775
chr1	FBLIM1	15764548	15764685	0	138	19561	4315	19561	4177	0.0	4.683026095283696
chr1	NECAP2	16447943	16447974	154	32	1967543	4594	1967389	4562	4.8125	431.255808855765
chr1	NECAP2	16440776	16440853	38	78	1967543	4594	1967505	4516	0.48717948717948717	435.67426926483614
chr1	BX284668.2	16873108	16873143	0	36	0	2347	0	2311	0.0	0.0
chr1	BX284668.2	16873144	16873429	0	286	0	2347	0	2061	0.0	0.0
chr1	BX284668.2	16873108	16873507	0	400	0	2347	0	1947	0.0	0.0
chr1	BX284668.2	16873144	16873507	0	364	0	2347	0	1983	0.0	0.0
chr1	BX284668.2	16873430	16873507	0	78	0	2347	0	2269	0.0	0.0
chr1	LINC02810	17718721	17718791	0	71	2029	1332	2029	1261	0.0	1.6090404440919905
chr1	PLA2G5	20069033	20069034	0	2	11625	3257	11625	3255	0.0	3.5714285714285716
chr1	VWA5B1	20348359	20348376	0	18	81	6402	81	6384	0.0	0.01268796992481203
chr1	VWA5B1	20303213	20303349	0	137	81	6402	81	6265	0.0	0.012928970470869912
chr1	NBPF3	21478197	21478307	0	111	8259	6838	8259	6727	0.0	1.2277389623903672
chr1	NBPF3	21478228	21478307	0	80	8259	6838	8259	6758	0.0	1.222107132287659
chr1	NBPF3	21478197	21478227	0	31	8259	6838	8259	6807	0.0	1.2133098281181136
chr1	LINC00339	22025640	22025945	51	306	15847	3569	15796	3263	0.16666666666666666	4.840943916641128
chr1	LINC00339	22025644	22025945	51	302	15847	3569	15796	3267	0.16887417218543047	4.835016835016835
chr1	LINC00339	22025946	22026119	51	174	15847	3569	15796	3395	0.29310344827586204	4.652724594992637
chr1	LINC00339	22025644	22026119	102	476	15847	3569	15745	3093	0.21428571428571427	5.090526996443582
chr1	LINC00339	22025640	22025643	0	4	15847	3569	15847	3565	0.0	4.445161290322581
chr1	LINC00339	22025946	22026649	51	704	15847	3569	15796	2865	0.07244318181818182	5.513438045375218
chr1	LINC00339	22026120	22026649	0	530	15847	3569	15847	3039	0.0	5.214544257979599
chr1	LINC00339	22025644	22026649	102	1006	15847	3569	15745	2563	0.10139165009940358	6.1431915723761215
chr1	LINC00339	22027535	22028379	8575	845	15847	3569	7272	2724	10.14792899408284	2.6696035242290748
chr1	LINC00339	22027781	22028379	8524	599	15847	3569	7323	2970	14.230383973288815	2.4656565656565657
chr1	CDC42	22052743	22052868	5770	126	21611	13175	15841	13049	45.79365079365079	1.2139627557667254
chr1	C1QC	22643715	22643737	0	23	0	1335	0	1312	0.0	0.0
chr1	C1QC	22643715	22643886	0	172	0	1335	0	1163	0.0	0.0
chr1	C1QC	22643738	22643886	0	149	0	1335	0	1186	0.0	0.0
chr1	ZNF436-AS1	23369325	23369513	0	189	45	1052	45	863	0.0	0.05214368482039398
chr1	RPL11	23691830	23692060	68	231	34423	2664	34355	2433	0.2943722943722944	14.120427455815864
chr1	GRHL3	24319569	24319747	337	179	1172	3924	835	3745	1.8826815642458101	0.22296395193591456
chr1	RCAN3	24503118	24503150	0	33	838	6672	838	6639	0.0	0.12622382888989306
chr1	SRRM1	24655124	24655129	0	6	8136	5651	8136	5645	0.0	1.4412754650132862
chr1	MTFR1L	25823324	25823439	357	116	22094	4825	21737	4709	3.0775862068965516	4.616054363983861
chr1	MTFR1L	25820350	25820414	22	65	22094	4825	22072	4760	0.3384615384615385	4.636974789915967
chr1	MTFR1L	25820350	25820659	144	310	22094	4825	21950	4515	0.4645161290322581	4.861572535991141
chr1	MTFR1L	25820415	25820659	122	245	22094	4825	21972	4580	0.49795918367346936	4.7973799126637555
chr1	MTFR1L	25820922	25821003	0	82	22094	4825	22094	4743	0.0	4.6582331857474175
chr1	CNKSR1	26177581	26177599	99	19	151527	3847	151428	3828	5.2105263157894735	39.557993730407524
chr1	CNKSR1	26183415	26183435	0	21	151527	3847	151527	3826	0.0	39.60454783063251
chr1	CATSPER4	26201042	26201075	163	34	37716	2040	37553	2006	4.794117647058823	18.720338983050848
chr1	ZPLD2P	26222757	26222770	354	14	945727	3201	945373	3187	25.285714285714285	296.63413868842173
chr1	ZPLD2P	26223602	26223753	0	152	945727	3201	945727	3049	0.0	310.176123319121
chr1	DHDDS	26432377	26432395	0	19	6867	5593	6867	5574	0.0	1.2319698600645856
chr1	DHDDS	26432377	26432415	0	39	6867	5593	6867	5554	0.0	1.2364061937342457
chr1	DHDDS	26432396	26432415	0	20	6867	5593	6867	5573	0.0	1.2321909205095998
chr1	DHDDS	26432377	26432518	0	142	6867	5593	6867	5451	0.0	1.259768849752339
chr1	DHDDS	26432396	26432518	0	123	6867	5593	6867	5470	0.0	1.2553930530164534
chr1	DHDDS	26432416	26432518	0	103	6867	5593	6867	5490	0.0	1.2508196721311475
chr1	DHDDS	26432493	26432518	0	26	6867	5593	6867	5567	0.0	1.2335189509610203
chr1	DHDDS	26432377	26432594	0	218	6867	5593	6867	5375	0.0	1.2775813953488373
chr1	DHDDS	26432396	26432594	0	199	6867	5593	6867	5394	0.0	1.2730812013348165
chr1	DHDDS	26432416	26432594	0	179	6867	5593	6867	5414	0.0	1.268378278537126
chr1	DHDDS	26432519	26432594	0	76	6867	5593	6867	5517	0.0	1.2446982055464926
chr1	DHDDS	26432493	26432594	0	102	6867	5593	6867	5491	0.0	1.2505918776179201
chr1	DHDDS	26432377	26432641	0	265	6867	5593	6867	5328	0.0	1.2888513513513513
chr1	DHDDS	26432396	26432641	0	246	6867	5593	6867	5347	0.0	1.2842715541425098
chr1	DHDDS	26432416	26432641	0	226	6867	5593	6867	5367	0.0	1.2794857462269424
chr1	DHDDS	26432519	26432641	0	123	6867	5593	6867	5470	0.0	1.2553930530164534
chr1	DHDDS	26432595	26432641	0	47	6867	5593	6867	5546	0.0	1.2381896862603678
chr1	DHDDS	26432493	26432641	0	149	6867	5593	6867	5444	0.0	1.261388684790595
chr1	DHDDS	26432377	26432492	0	116	6867	5593	6867	5477	0.0	1.2537885703852474
chr1	DHDDS	26432396	26432492	0	97	6867	5593	6867	5496	0.0	1.2494541484716157
chr1	DHDDS	26432416	26432492	0	77	6867	5593	6867	5516	0.0	1.2449238578680204
chr1	DHDDS	26432416	26432723	0	308	6867	5593	6867	5285	0.0	1.2993377483443709
chr1	DHDDS	26432519	26432723	0	205	6867	5593	6867	5388	0.0	1.274498886414254
chr1	DHDDS	26432595	26432723	0	129	6867	5593	6867	5464	0.0	1.2567715959004393
chr1	DHDDS	26432642	26432723	0	82	6867	5593	6867	5511	0.0	1.246053347849755
chr1	DHDDS	26432493	26432723	0	231	6867	5593	6867	5362	0.0	1.2806788511749347
chr1	ARID1A	26696101	26697540	0	1440	104732	12546	104732	11106	0.0	9.430217900234108
chr1	PIGV	26795215	26795234	0	20	955660	5866	955660	5846	0.0	163.47245980157373
chr1	PIGV	26787990	26788268	0	279	955660	5866	955660	5587	0.0	171.05065330230894
chr1	PIGV	26788269	26788394	0	126	955660	5866	955660	5740	0.0	166.49128919860627
chr1	PIGV	26788269	26788819	1180	551	955660	5866	954480	5315	2.1415607985480944	179.58231420507997
chr1	PIGV	26788395	26788819	1180	425	955660	5866	954480	5441	2.776470588235294	175.42363536114684
chr1	ZDHHC18	26832054	26832072	19	19	93	2665	74	2646	1.0	0.027966742252456538
chr1	TRNP1	26994613	26994630	0	18	0	1981	0	1963	0.0	0.0
chr1	AL445490.1	27669541	27669586	0	46	27317	1636	27317	1590	0.0	17.18050314465409
chr1	PPP1R8	27830892	27831366	0	475	603	2822	603	2347	0.0	0.25692373242437155
chr1	PPP1R8	27831247	27831366	0	120	603	2822	603	2702	0.0	0.2231680236861584
chr1	PPP1R8	27830892	27831246	0	355	603	2822	603	2467	0.0	0.24442642886096475
chr1	THEMIS2	27872641	27872665	114	25	18413	2665	18299	2640	4.56	6.931439393939394
chr1	THEMIS2	27882078	27882125	0	48	18413	2665	18413	2617	0.0	7.035918991211311
chr1	MED18	28329125	28329180	0	56	204	1315	204	1259	0.0	0.16203335980937253
chr1	PHACTR4	28457856	28457859	0	4	3249	7336	3249	7332	0.0	0.443126022913257
chr1	RCC1	28508902	28508905	0	4	64274	3738	64274	3734	0.0	17.213176218532404
chr1	RCC1	28516854	28516867	0	14	64274	3738	64274	3724	0.0	17.2593984962406
chr1	RCC1	28530574	28530615	0	42	64274	3738	64274	3696	0.0	17.390151515151516
chr1	YTHDF2	28738330	28738338	81	9	11743	3737	11662	3728	9.0	3.1282188841201717
chr1	EPB41	29068769	29068783	1362	15	280693	17917	279331	17902	90.8	15.603340408892862
chr1	EPB41	28914769	28914773	0	5	280693	17917	280693	17912	0.0	15.67066770879857
chr1	PTPRU	29311545	29311553	0	9	1034	6715	1034	6706	0.0	0.15419027736355503
chr1	MATN1-AS1	30719566	30721174	0	1609	0	3750	0	2141	0.0	0.0
chr1	MATN1-AS1	30719233	30721174	0	1942	0	3750	0	1808	0.0	0.0
chr1	MATN1-AS1	30719233	30719565	0	333	0	3750	0	3417	0.0	0.0
chr1	ZCCHC17	31297097	31297213	0	117	1275	1930	1275	1813	0.0	0.7032542746828461
chr1	ZCCHC17	31297076	31297213	0	138	1275	1930	1275	1792	0.0	0.7114955357142857
chr1	ZCCHC17	31346741	31346818	378	78	1275	1930	897	1852	4.846153846153846	0.484341252699784
chr1	LDC1P	31501528	31501539	9	12	1491	2358	1482	2346	0.75	0.6317135549872123
chr1	PEF1-AS1	31645121	31645146	0	26	51	2148	51	2122	0.0	0.02403393025447691
chr1	PEF1-AS1	31645139	31645146	0	8	51	2148	51	2140	0.0	0.02383177570093458
chr1	PEF1-AS1	31645121	31645138	0	18	51	2148	51	2130	0.0	0.023943661971830985
chr1	PEF1-AS1	31645342	31645382	0	41	51	2148	51	2107	0.0	0.02420503084954912
chr1	PEF1-AS1	31656045	31656185	0	141	51	2148	51	2007	0.0	0.025411061285500747
chr1	KPNA6	32156928	32156945	98	18	2531	7472	2433	7454	5.444444444444445	0.32640193184867183
chr1	IQCC	32205724	32205963	6881	240	30899	2467	24018	2227	28.670833333333334	10.784912438257745
chr1	EIF3I	32226284	32226320	0	37	17127	5731	17127	5694	0.0	3.0079030558482613
chr1	EIF3I	32228817	32229208	0	392	17127	5731	17127	5339	0.0	3.20790410189174
chr1	EIF3I	32228817	32229024	0	208	17127	5731	17127	5523	0.0	3.1010320478001088
chr1	RBBP4	32651716	32651822	510	107	307145	9163	306635	9056	4.766355140186916	33.85987190812721
chr1	RBBP4	32679699	32679817	0	119	307145	9163	307145	9044	0.0	33.961189739053516
chr1	S100PBP	32817600	32817689	2	90	92597	9206	92595	9116	0.022222222222222223	10.157415533128566
chr1	S100PBP	32825430	32825485	976	56	92597	9206	91621	9150	17.428571428571427	10.013224043715846
chr1	AL513327.1	33307438	33307449	206	12	36566	3838	36360	3826	17.166666666666668	9.503397804495556
chr1	ZSCAN20	33472688	33472691	0	4	10953	5316	10953	5312	0.0	2.0619352409638556
chr1	CSMD2-AS1	33870425	33870494	0	70	6568	2628	6568	2558	0.0	2.5676309616888195
chr1	ZMYM1	35094010	35094083	0	74	0	5220	0	5146	0.0	0.0
chr1	NCDN	35557884	35558223	206	340	84468	4926	84262	4586	0.6058823529411764	18.373746184038378
chr1	C1ORF122	37808307	37808439	0	133	0	1487	0	1354	0.0	0.0
chr1	LINC01685	38513938	38514011	0	74	261	3681	261	3607	0.0	0.07235930135846964
chr1	NDUFS5	39026399	39026402	0	4	0	551	0	547	0.0	0.0
chr1	MACF1	39269688	39269720	0	33	306202	41060	306202	41027	0.0	7.463426523996393
chr1	PPIE	39738924	39738931	0	8	6319	11133	6319	11125	0.0	0.568
chr1	PPIE	39741922	39742031	0	110	6319	11133	6319	11023	0.0	0.5732559194411685
chr1	PPIE	39745499	39748767	1676	3269	6319	11133	4643	7864	0.5126950137656776	0.590412004069176
chr1	MFSD2A	39955380	39955385	0	6	76	3841	76	3835	0.0	0.019817470664928293
chr1	CAP1	40040468	40040783	1602	316	75024	3616	73422	3300	5.069620253164557	22.24909090909091
chr1	CAP1	40040784	40040801	30	18	75024	3616	74994	3598	1.6666666666666667	20.84324624791551
chr1	EXO5	40508909	40509790	0	882	561	2819	561	1937	0.0	0.28962312854930305
chr1	EXO5	40508878	40509790	0	913	561	2819	561	1906	0.0	0.2943336831059811
chr1	EXO5	40508890	40509790	0	901	561	2819	561	1918	0.0	0.2924921793534932
chr1	EXO5	40509350	40509790	0	441	561	2819	561	2378	0.0	0.2359125315391085
chr1	EXO5	40508878	40508908	0	31	561	2819	561	2788	0.0	0.20121951219512196
chr1	EXO5	40508890	40508908	0	19	561	2819	561	2800	0.0	0.20035714285714284
chr1	EXO5	40508878	40508889	0	12	561	2819	561	2807	0.0	0.19985749910936942
chr1	PPCS	42456629	42457073	33	445	102	3395	69	2950	0.07415730337078652	0.023389830508474575
chr1	CCDC30	42463891	42463898	0	8	152932	22898	152932	22890	0.0	6.681170816950633
chr1	CCDC30	42463658	42463898	0	241	152932	22898	152932	22657	0.0	6.749878624707596
chr1	CCDC30	42498893	42498916	0	24	152932	22898	152932	22874	0.0	6.6858441899099414
chr1	CCDC30	42463658	42463890	0	233	152932	22898	152932	22665	0.0	6.747496139422016
chr1	PPIH	42659252	42659370	0	119	5057	4021	5057	3902	0.0	1.2960020502306508
chr1	ERMAP	42825736	42825738	0	3	10	5141	10	5138	0.0	0.001946282600233554
chr1	ERMAP	42835761	42835764	0	4	10	5141	10	5137	0.0	0.0019466614755693985
chr1	FAM183A	43148085	43148091	80	7	523	811	443	804	11.428571428571429	0.5509950248756219
chr1	FAM183A	43152932	43152979	0	48	523	811	523	763	0.0	0.6854521625163827
chr1	CFAP57	43172403	43172453	0	51	29256	5416	29256	5365	0.0	5.4531220876048465
chr1	CFAP57	43219538	43219631	0	94	29256	5416	29256	5322	0.0	5.497181510710259
chr1	SZT2	43419945	43419961	0	17	36229	24016	36229	23999	0.0	1.5096045668569524
chr1	PTPRF	43603528	43603533	6	6	16003	10480	15997	10474	1.0	1.5273057093755966
chr1	ST3GAL3	43801542	43801545	0	4	359390	18223	359390	18219	0.0	19.726110104835612
chr1	ST3GAL3	43814934	43815004	0	71	359390	18223	359390	18152	0.0	19.79892022917585
chr1	ST3GAL3	43736381	43736425	0	45	359390	18223	359390	18178	0.0	19.77060182638354
chr1	ST3GAL3	43899264	43899289	129	26	359390	18223	359261	18197	4.961538461538462	19.74286970379733
chr1	ST3GAL3	43920929	43920940	12	12	359390	18223	359378	18211	1.0	19.734116742628082
chr1	ST3GAL3	43898299	43898438	1075	140	359390	18223	358315	18083	7.678571428571429	19.81501963169828
chr1	DPH2	43970271	43970322	0	52	0	2729	0	2677	0.0	0.0
chr1	DPH2	43970315	43970322	0	8	0	2729	0	2721	0.0	0.0
chr1	DPH2	43970313	43970322	0	10	0	2729	0	2719	0.0	0.0
chr1	DPH2	43970709	43970817	0	109	0	2729	0	2620	0.0	0.0
chr1	DPH2	43971541	43972070	0	530	0	2729	0	2199	0.0	0.0
chr1	DPH2	43970271	43970314	0	44	0	2729	0	2685	0.0	0.0
chr1	DPH2	43970313	43970314	0	2	0	2729	0	2727	0.0	0.0
chr1	DPH2	43970271	43970312	0	42	0	2729	0	2687	0.0	0.0
chr1	ATP6V0B	43975108	43975297	1377	190	2958	2433	1581	2243	7.247368421052632	0.7048595630851539
chr1	ATP6V0B	43975108	43975307	1377	200	2958	2433	1581	2233	6.885	0.7080161218092252
chr1	B4GALT2	43979512	43979616	517	105	3851	5400	3334	5295	4.923809523809524	0.6296506137865912
chr1	B4GALT2	43980047	43980614	2754	568	3851	5400	1097	4832	4.848591549295775	0.22702814569536423
chr1	AL139220.2	44030469	44030557	784	89	138097	9671	137313	9582	8.808988764044944	14.330306825297432
chr1	AL139220.2	44044759	44045269	15004	511	138097	9671	123093	9160	29.362035225048924	13.438100436681223
chr1	AL139220.2	44051108	44051158	1198	51	138097	9671	136899	9620	23.49019607843137	14.230665280665281
chr1	AL139220.2	44051495	44051531	1529	37	138097	9671	136568	9634	41.32432432432432	14.175627984222546
chr1	DMAP1	44213528	44213662	0	135	4135	2653	4135	2518	0.0	1.642176330420969
chr1	RNF220	44405527	44405530	0	4	19961	8963	19961	8959	0.0	2.22803884362094
chr1	RNF220	44635589	44635666	0	78	19961	8963	19961	8885	0.0	2.246595385481148
chr1	RNF220	44632209	44632212	0	4	19961	8963	19961	8959	0.0	2.22803884362094
chr1	KIF2C	44740003	44740042	11	40	45570	3547	45559	3507	0.275	12.990875392072997
chr1	RPS8	44776715	44776774	0	60	205	2666	205	2606	0.0	0.07866462010744436
chr1	RPS8	44777738	44777789	0	52	205	2666	205	2614	0.0	0.0784238714613619
chr1	BTBD19	44810250	44810426	99	177	14840	3529	14741	3352	0.559322033898305	4.397673031026253
chr1	RAD54L	46248599	46248623	0	25	44622	4044	44622	4019	0.0	11.102761881064941
chr1	RAD54L	46261016	46261074	0	59	44622	4044	44622	3985	0.0	11.197490589711418
chr1	UQCRH	46309128	46309143	128	16	816	1345	688	1329	8.0	0.5176824680210684
chr1	NSUN4	46344963	46345144	0	182	12138	8320	12138	8138	0.0	1.4915212582944213
chr1	NSUN4	46341498	46341865	867	368	12138	8320	11271	7952	2.3559782608695654	1.4173792756539236
chr1	NSUN4	46341866	46344294	7293	2429	12138	8320	4845	5891	3.00247015232606	0.8224410117127822
chr1	SLC5A9	48229166	48229177	0	12	0	4404	0	4392	0.0	0.0
chr1	OSBPL9	51669513	51669814	0	302	1649	7377	1649	7075	0.0	0.23307420494699646
chr1	OSBPL9	51730002	51730124	14	123	1649	7377	1635	7254	0.11382113821138211	0.22539288668320925
chr1	AL050343.2	51794054	51794074	0	21	51	1470	51	1449	0.0	0.035196687370600416
chr1	CPT2	53211251	53211319	0	69	414	5091	414	5022	0.0	0.08243727598566308
chr1	CPT2	53211251	53211369	0	119	414	5091	414	4972	0.0	0.083266291230893
chr1	CPT2	53211320	53211369	0	50	414	5091	414	5041	0.0	0.08212656219004166
chr1	DIO1	53894439	53894547	31	109	82	2265	51	2156	0.28440366972477066	0.02365491651205937
chr1	DIO1	53894356	53894547	69	192	82	2265	13	2073	0.359375	0.006271104679208876
chr1	DIO1	53894356	53894438	38	83	82	2265	44	2182	0.4578313253012048	0.02016498625114574
chr1	MRPL37	54200242	54200589	0	348	69	2523	69	2175	0.0	0.031724137931034485
chr1	DHCR24-DT	54887784	54887976	0	193	1122	691	1122	498	0.0	2.253012048192771
chr1	DHCR24-DT	54887969	54887976	0	8	1122	691	1122	683	0.0	1.642752562225476
chr1	LINC01767	56415151	56415609	0	459	0	2023	0	1564	0.0	0.0
chr1	LINC01767	56415343	56415353	0	11	0	2023	0	2012	0.0	0.0
chr1	LINC01767	56415610	56415695	0	86	0	2023	0	1937	0.0	0.0
chr1	DAB1-AS1	57860920	57860926	0	7	0	4284	0	4277	0.0	0.0
chr1	DAB1-AS1	57860910	57860926	0	17	0	4284	0	4267	0.0	0.0
chr1	DAB1-AS1	57860873	57860926	0	54	0	4284	0	4230	0.0	0.0
chr1	DAB1-AS1	57860927	57861033	0	107	0	4284	0	4177	0.0	0.0
chr1	DAB1-AS1	57860920	57861033	0	114	0	4284	0	4170	0.0	0.0
chr1	DAB1-AS1	57860910	57861033	0	124	0	4284	0	4160	0.0	0.0
chr1	DAB1-AS1	57860936	57861033	0	98	0	4284	0	4186	0.0	0.0
chr1	DAB1-AS1	57860873	57861033	0	161	0	4284	0	4123	0.0	0.0
chr1	DAB1-AS1	57860910	57860919	0	10	0	4284	0	4274	0.0	0.0
chr1	DAB1-AS1	57860873	57860919	0	47	0	4284	0	4237	0.0	0.0
chr1	DAB1-AS1	57860873	57860909	0	37	0	4284	0	4247	0.0	0.0
chr1	DAB1-AS1	57860927	57860935	0	9	0	4284	0	4275	0.0	0.0
chr1	DAB1-AS1	57860920	57860935	0	16	0	4284	0	4268	0.0	0.0
chr1	DAB1-AS1	57860910	57860935	0	26	0	4284	0	4258	0.0	0.0
chr1	DAB1-AS1	57860873	57860935	0	63	0	4284	0	4221	0.0	0.0
chr1	DAB1-AS1	57862520	57863040	0	521	0	4284	0	3763	0.0	0.0
chr1	DAB1-AS1	57862928	57863040	0	113	0	4284	0	4171	0.0	0.0
chr1	DAB1-AS1	57862520	57862927	0	408	0	4284	0	3876	0.0	0.0
chr1	LINC01358	59056750	59057032	0	283	6847	8361	6847	8078	0.0	0.8476107947511761
chr1	USP1	62436468	62436562	0	95	0	3878	0	3783	0.0	0.0
chr1	ATG4C	62784226	62784273	0	48	453	3126	453	3078	0.0	0.14717348927875243
chr1	ALG6	63411156	63411331	0	176	51	5100	51	4924	0.0	0.010357432981316004
chr1	ALG6	63371060	63371287	0	228	51	5100	51	4872	0.0	0.010467980295566502
chr1	EFCAB7	63523570	63523634	0	65	0	5719	0	5654	0.0	0.0
chr1	MIER1	66984593	66984652	0	60	51	6542	51	6482	0.0	0.00786794199321197
chr1	LINC01707	69192587	69192610	0	24	10	6166	10	6142	0.0	0.0016281341582546401
chr1	HHLA3	70355108	70355111	0	4	10965	1228	10965	1224	0.0	8.958333333333334
chr1	HHLA3	70355108	70355208	0	101	10965	1228	10965	1127	0.0	9.729370008873115
chr1	HHLA3	70355112	70355208	0	97	10965	1228	10965	1131	0.0	9.694960212201591
chr1	ZRANB2-AS2	71237196	71237386	0	191	47	14846	47	14655	0.0	0.0032070965540771067
chr1	ZRANB2-AS2	71202057	71202131	18	75	47	14846	29	14771	0.24	0.0019633064789113803
chr1	ZRANB2-AS2	71407816	71407871	0	56	47	14846	47	14790	0.0	0.0031778228532792427
chr1	ZRANB2-AS2	71488048	71488148	0	101	47	14846	47	14745	0.0	0.0031875211936249577
chr1	ZRANB2-AS2	71486514	71486534	0	21	47	14846	47	14825	0.0	0.003170320404721754
chr1	LINC01360	73306275	73306297	0	23	51	5538	51	5515	0.0	0.009247506799637352
chr1	LINC01360	73307364	73307384	0	21	51	5538	51	5517	0.0	0.009244154431756389
chr1	FPGT	74199832	74199845	0	14	153	3573	153	3559	0.0	0.042989603821298114
chr1	FPGT	74198361	74198426	0	66	153	3573	153	3507	0.0	0.04362703165098375
chr1	AC092813.1	75932617	75932670	0	54	0	2089	0	2035	0.0	0.0
chr1	MIGA1	77783268	77783351	0	84	352	6906	352	6822	0.0	0.0515977719143946
chr1	DNAJB4	77979294	77979619	42	326	746	3709	704	3383	0.12883435582822086	0.20809932013006208
chr1	MGC27382	78250374	78251010	51	637	1287	2490	1236	1853	0.08006279434850863	0.6670264436049649
chr1	IFI44L	78628019	78628393	0	375	102	7676	102	7301	0.0	0.013970688946719628
chr1	IFI44	78662879	78662917	0	39	131	1958	131	1919	0.0	0.068264721208963
chr1	ADGRL2	81800480	81800512	0	33	10464	19025	10464	18992	0.0	0.5509688289806234
chr1	ADGRL2	81989696	81989709	0	14	10464	19025	10464	19011	0.0	0.5504181789490296
chr1	LINC01362	82903455	82903823	0	369	0	2150	0	1781	0.0	0.0
chr1	LINC01362	82952729	82952837	0	109	0	2150	0	2041	0.0	0.0
chr1	SAMD13	84301802	84302014	0	213	3653	3415	3653	3202	0.0	1.1408494690818238
chr1	LINC01140	87132864	87132912	0	49	5678	6060	5678	6011	0.0	0.9446015637997005
chr1	LINC01140	87132253	87132259	0	7	5678	6060	5678	6053	0.0	0.9380472492978689
chr1	AC092805.1	90719703	90719706	0	4	0	2433	0	2429	0.0	0.0
chr1	BRDT	91949489	91949682	51	194	29498	4344	29447	4150	0.26288659793814434	7.09566265060241
chr1	BRDT	91968261	91968272	48	12	29498	4344	29450	4332	4.0	6.798245614035087
chr1	BRDT	91949489	91949519	0	31	29498	4344	29498	4313	0.0	6.839322977046139
chr1	BRDT	91949959	91950474	0	516	29498	4344	29498	3828	0.0	7.705851619644723
chr1	RPL5	92832118	92832251	444	134	3975	2191	3531	2057	3.3134328358208953	1.7165775401069518
chr1	CCDC18	93180280	93180418	0	139	1481	5355	1481	5216	0.0	0.2839340490797546
chr1	CCDC18	93180419	93180882	0	464	1481	5355	1481	4891	0.0	0.30280106317726435
chr1	CCDC18	93180853	93180882	0	30	1481	5355	1481	5325	0.0	0.27812206572769954
chr1	ARHGAP29-AS1	94248040	94248134	104	95	33571	3779	33467	3684	1.0947368421052632	9.08441910966341
chr1	SLC44A3	94827548	94827643	0	96	0	2888	0	2792	0.0	0.0
chr1	RWDD3	95244652	95244698	0	47	0	1781	0	1734	0.0	0.0
chr1	LINC02790	95992123	95992238	0	116	0	2786	0	2670	0.0	0.0
chr1	LINC02790	96006422	96006425	0	4	0	2786	0	2782	0.0	0.0
chr1	PTBP2	96721873	96721896	0	24	357	14696	357	14672	0.0	0.02433206106870229
chr1	AL445433.2	99144131	99144151	0	21	1263	5989	1263	5968	0.0	0.21162868632707774
chr1	AGL	99850619	99850898	0	280	255	8193	255	7913	0.0	0.032225451788196635
chr1	SLC35A3	99970163	99970300	0	138	306	15955	306	15817	0.0	0.019346272997407852
chr1	SLC35A3	99993742	99993745	0	4	306	15955	306	15951	0.0	0.019183750235094978
chr1	VCAM1	100720566	100720751	0	186	69287	3110	69287	2924	0.0	23.69596443228454
chr1	AC093157.1	101025948	101026061	0	114	0	7130	0	7016	0.0	0.0
chr1	RNPC3	103525824	103526262	0	439	51	5469	51	5030	0.0	0.010139165009940358
chr1	RNPC3	103525824	103525930	0	107	51	5469	51	5362	0.0	0.009511376352107423
chr1	AL355306.2	106041912	106042040	0	129	0	8939	0	8810	0.0	0.0
chr1	LINC02785	108050736	108050788	0	53	0	4139	0	4086	0.0	0.0
chr1	GPSM2	108918790	108919150	1221	361	12506	18055	11285	17694	3.3822714681440442	0.637786820391093
chr1	TMEM167B	109093022	109093082	0	61	0	3617	0	3556	0.0	0.0
chr1	ELAPOR1	109113916	109113992	0	77	265817	9175	265817	9098	0.0	29.217080677071884
chr1	ELAPOR1	109113989	109113992	0	4	265817	9175	265817	9171	0.0	28.984516410424163
chr1	CYB561D1	109494155	109494287	2858	133	83095	5618	80237	5485	21.48872180451128	14.628441203281678
chr1	GPR61	109545374	109545389	0	16	2480	3508	2480	3492	0.0	0.7101947308132875
chr1	AMPD2	109630407	109630439	0	33	46677	8217	46677	8184	0.0	5.703445747800586
chr1	GSTM4	109657280	109657671	0	392	1224	3643	1224	3251	0.0	0.3764995386035066
chr1	GSTM2	109668484	109668500	0	17	912	5816	912	5799	0.0	0.15726849456802897
chr1	AHCYL1	109985173	109985543	0	371	33659	5052	33659	4681	0.0	7.190557573168126
chr1	RBM15	110342182	110342268	0	87	3575	3757	3575	3670	0.0	0.9741144414168937
chr1	LAMTOR5-AS1	110407816	110407954	0	139	1030	11148	1030	11009	0.0	0.09355981469706603
chr1	LAMTOR5-AS1	110418367	110418375	0	9	1030	11148	1030	11139	0.0	0.0924679055570518
chr1	LAMTOR5-AS1	110407955	110409158	0	1204	1030	11148	1030	9944	0.0	0.10358004827031375
chr1	LAMTOR5-AS1	110407816	110409158	0	1343	1030	11148	1030	9805	0.0	0.10504844467108618
chr1	LAMTOR5-AS1	110408228	110409158	0	931	1030	11148	1030	10217	0.0	0.10081237153763335
chr1	AL358215.3	110484945	110485078	0	134	0	1194	0	1060	0.0	0.0
chr1	CHI3L2	111235001	111235057	0	57	0	3296	0	3239	0.0	0.0
chr1	CHI3L2	111229811	111229881	0	71	0	3296	0	3225	0.0	0.0
chr1	CHIAP2	111281753	111281861	0	109	0	2199	0	2090	0.0	0.0
chr1	RAP1A	111627560	111627563	0	4	59597	5543	59597	5539	0.0	10.759523379671421
chr1	INKA2-AS1	111740078	111740098	0	21	0	2417	0	2396	0.0	0.0
chr1	KCND3-AS1	111910277	111910313	0	37	0	744	0	707	0.0	0.0
chr1	SLC16A1-AS1	112956957	112957722	0	766	92741	12689	92741	11923	0.0	7.778327602113562
chr1	AL137856.1	113812613	113812825	306	213	306	1590	0	1377	1.4366197183098592	0.0
chr1	HIPK1	113957185	113957286	0	102	1523	9171	1523	9069	0.0	0.16793472268166282
chr1	VANGL1	115659768	115659773	0	6	557	9055	557	9049	0.0	0.0615537628467234
chr1	LINC01649	115922446	115922566	0	121	12	2435	12	2314	0.0	0.005185825410544511
chr1	LINC01525	117296634	117296801	0	168	0	862	0	694	0.0	0.0
chr1	HSD3B1	119507220	119507262	0	43	0	2447	0	2404	0.0	0.0
chr1	PHGDH	119741877	119741897	0	21	31547	6218	31547	6197	0.0	5.090689043085364
chr1	PHGDH	119721322	119721654	7559	333	31547	6218	23988	5885	22.6996996996997	4.076125743415463
chr1	PHGDH	119721335	119721654	6693	320	31547	6218	24854	5898	20.915625	4.213970837572059
chr1	PHGDH	119724876	119724957	3436	82	31547	6218	28111	6136	41.90243902439025	4.58132333767927
chr1	PHGDH	119724876	119724967	3576	92	31547	6218	27971	6126	38.869565217391305	4.565948416585047
chr1	PHGDH	119724958	119724967	140	10	31547	6218	31407	6208	14.0	5.059117268041237
chr1	PHGDH	119721322	119721334	866	13	31547	6218	30681	6205	66.61538461538461	4.944560838033843
chr1	NBPF26	120822157	120822267	0	111	35337	6817	35337	6706	0.0	5.269460184909037
chr1	NBPF26	120805454	120805458	0	5	35337	6817	35337	6812	0.0	5.18746330005872
chr1	FCGR1B	121094959	121095021	0	63	51	4239	51	4176	0.0	0.01221264367816092
chr1	GNRHR2	145919420	145919569	153	150	1751	2338	1598	2188	1.02	0.7303473491773309
chr1	LIX1L-AS1	145947146	145947361	0	216	1727	3264	1727	3048	0.0	0.5666010498687664
chr1	LIX1L-AS1	145927658	145927794	51	137	1727	3264	1676	3127	0.3722627737226277	0.5359769747361689
chr1	LINC01719	146057989	146058461	2777	473	34193	2631	31416	2158	5.871035940803383	14.557924003707136
chr1	NBPF12	146960007	146960011	0	5	0	7308	0	7303	0.0	0.0
chr1	CHD1L	147256563	147256570	0	8	0	4200	0	4192	0.0	0.0
chr1	CHD1L	147271006	147271113	0	108	0	4200	0	4092	0.0	0.0
chr1	CHD1L	147272282	147272630	0	349	0	4200	0	3851	0.0	0.0
chr1	CHD1L	147271006	147271195	0	190	0	4200	0	4010	0.0	0.0
chr1	CHD1L	147271114	147271195	0	82	0	4200	0	4118	0.0	0.0
chr1	CHD1L	147243168	147243190	0	23	0	4200	0	4177	0.0	0.0
chr1	BCL9	147612978	147613199	1469	222	55598	6342	54129	6120	6.617117117117117	8.844607843137254
chr1	LINC02805	148163816	148163866	0	51	0	5857	0	5806	0.0	0.0
chr1	LINC02805	148162993	148163588	0	596	0	5857	0	5261	0.0	0.0
chr1	LINC02805	148162993	148163815	0	823	0	5857	0	5034	0.0	0.0
chr1	AC245100.4	148427944	148427958	0	15	0	3322	0	3307	0.0	0.0
chr1	AC245100.4	148424639	148424678	0	40	0	3322	0	3282	0.0	0.0
chr1	AC245100.4	148427959	148427992	0	34	0	3322	0	3288	0.0	0.0
chr1	AC245100.4	148427944	148427992	0	49	0	3322	0	3273	0.0	0.0
chr1	PDE4DIP	149001697	149002026	0	330	6068	23819	6068	23489	0.0	0.2583336881093278
chr1	PDE4DIP	148952155	148953905	3825	1751	6068	23819	2243	22068	2.1844660194174756	0.10164038426681167
chr1	LINC00869	149646655	149646945	561	291	16158	10886	15597	10595	1.9278350515463918	1.472109485606418
chr1	LINC00869	149636694	149636716	0	23	16158	10886	16158	10863	0.0	1.487434410383872
chr1	LINC00869	149646946	149647064	0	119	16158	10886	16158	10767	0.0	1.5006965728615214
chr1	H4C14	149833115	149833864	24135	750	28934	1868	4799	1118	32.18	4.292486583184258
chr1	BOLA1	149899673	149899730	1722	58	197370	1464	195648	1406	29.689655172413794	139.15220483641536
chr1	VPS45	150067607	150067950	51	344	16832	5991	16781	5647	0.14825581395348839	2.9716663715247034
chr1	SETDB1	150926349	150926517	19	169	121385	7114	121366	6945	0.11242603550295859	17.47530597552196
chr1	SETDB1	150926464	150926517	19	54	121385	7114	121366	7060	0.35185185185185186	17.190651558073654
chr1	SETDB1	150926349	150926531	33	183	121385	7114	121352	6931	0.18032786885245902	17.508584619823978
chr1	SETDB1	150926518	150926531	14	14	121385	7114	121371	7100	1.0	17.09450704225352
chr1	SETDB1	150926464	150926531	33	68	121385	7114	121352	7046	0.4852941176470588	17.22282145898382
chr1	SETDB1	150926518	150926544	27	27	121385	7114	121358	7087	1.0	17.124029913926908
chr1	SETDB1	150926532	150926544	13	13	121385	7114	121372	7101	1.0	17.092240529502888
chr1	BNIPL	151038565	151038568	36	4	9540	3554	9504	3550	9.0	2.6771830985915495
chr1	SCNM1	151166204	151166252	0	49	8915	3270	8915	3221	0.0	2.76777398323502
chr1	PIP5K1A	151199082	151199187	0	106	137443	5373	137443	5267	0.0	26.09512056198975
chr1	PSMD4	151266113	151266121	200	9	220280	2624	220080	2615	22.22222222222222	84.16061185468452
chr1	PSMD4	151266122	151266198	5136	77	220280	2624	215144	2547	66.7012987012987	84.46957204554377
chr1	PSMD4	151266113	151266198	5336	86	220280	2624	214944	2538	62.04651162790697	84.6903073286052
chr1	PSMB4	151400186	151400187	8	2	35431	1700	35423	1698	4.0	20.86160188457008
chr1	SNX27	151612382	151612512	0	131	157502	16235	157502	16104	0.0	9.780303030303031
chr1	AL450992.1	152018838	152018839	0	2	556	4122	556	4120	0.0	0.13495145631067962
chr1	FLG-AS1	152189509	152189655	51	147	2905	12348	2854	12201	0.3469387755102041	0.2339152528481272
chr1	FLG-AS1	152189482	152189655	51	174	2905	12348	2854	12174	0.29310344827586204	0.2344340397568589
chr1	FLG-AS1	152189482	152189508	0	27	2905	12348	2905	12321	0.0	0.23577631685739794
chr1	LCE1E	152786308	152786363	0	56	0	1147	0	1091	0.0	0.0
chr1	CREB3L4	153968640	153968699	27	60	413210	2539	413183	2479	0.45	166.67325534489714
chr1	CREB3L4	153968165	153968184	48962	20	413210	2539	364248	2519	2448.1	144.60023818975785
chr1	UBAP2L	154234739	154234759	68	21	140763	6628	140695	6607	3.238095238095238	21.294838807325565
chr1	UBAP2L	154234760	154234792	357	33	140763	6628	140406	6595	10.818181818181818	21.289764973464745
chr1	UBAP2L	154234739	154234792	425	54	140763	6628	140338	6574	7.87037037037037	21.34742926680864
chr1	UBAP2L	154220976	154221040	4	65	140763	6628	140759	6563	0.06153846153846154	21.44735639189395
chr1	HAX1	154273535	154273598	0	64	102	1613	102	1549	0.0	0.065848934796643
chr1	IL6R	154430596	154430606	0	11	105	6465	105	6454	0.0	0.016268980477223426
chr1	TDRD10	154547480	154547568	0	89	8761	2719	8761	2630	0.0	3.3311787072243346
chr1	CHRNB2	154569837	154569842	0	6	82898	4878	82898	4872	0.0	17.01518883415435
chr1	CKS1B	154974805	154974912	0	108	17028	2309	17028	2201	0.0	7.736483416628805
chr1	FLAD1	154990258	154990528	23454	271	204753	3992	181299	3721	86.54612546125462	48.72319269013706
chr1	ADAM15	155061976	155062117	0	142	8716	4801	8716	4659	0.0	1.870787722687272
chr1	SLC50A1	155135599	155135680	0	82	51	1885	51	1803	0.0	0.028286189683860232
chr1	SLC50A1	155136377	155136396	0	20	51	1885	51	1865	0.0	0.027345844504021447
chr1	TRIM46	155174030	155174039	81	10	576844	4548	576763	4538	8.1	127.09629792860291
chr1	MTX1	155210416	155210435	16885	20	51662	2569	34777	2549	844.25	13.643389564535111
chr1	HCN3	155288708	155289007	2523	300	602315	3866	599792	3566	8.41	168.19742007851934
chr1	FDPS	155308966	155309076	0	111	4826	3010	4826	2899	0.0	1.664711969644705
chr1	RUSC1	155324365	155324544	521	180	3934	4428	3413	4248	2.8944444444444444	0.803436911487759
chr1	RUSC1	155324545	155324587	225	43	3934	4428	3709	4385	5.232558139534884	0.8458380843785633
chr1	RUSC1	155324810	155324943	259	134	3934	4428	3675	4294	1.9328358208955223	0.8558453656264555
chr1	MSTO1	155613734	155613766	0	33	9091	4041	9091	4008	0.0	2.2682135728542914
chr1	DAP3	155689175	155689243	0	69	57901	4354	57901	4285	0.0	13.512485414235705
chr1	LMNA	156134524	156134528	0	5	324066	7357	324066	7352	0.0	44.07861806311208
chr1	LMNA	156138608	156138757	0	150	324066	7357	324066	7207	0.0	44.96545025669488
chr1	LMNA	156136437	156136549	0	113	324066	7357	324066	7244	0.0	44.7357813362783
chr1	LMNA	156114792	156114911	24	120	324066	7357	324042	7237	0.2	44.775735802127954
chr1	LMNA	156126916	156126949	0	34	324066	7357	324066	7323	0.0	44.25317492830807
chr1	TMEM79	156285268	156285983	20793	716	36529	3037	15736	2321	29.04050279329609	6.779836277466609
chr1	BCAN	156642272	156642275	0	4	51	4571	51	4567	0.0	0.011167068097219181
chr1	RRNAD1	156734053	156734493	918	441	13315	2891	12397	2450	2.0816326530612246	5.06
chr1	PRCC	156767584	156768239	0	656	612	4062	612	3406	0.0	0.17968291250733998
chr1	AL357143.1	157183015	157183252	0	238	0	5822	0	5584	0.0	0.0
chr1	KIRREL1	157993729	157993732	0	4	2754	7887	2754	7883	0.0	0.3493593809463402
chr1	CD1D	158181051	158181162	0	112	51	4291	51	4179	0.0	0.012203876525484566
chr1	CD1E	158355941	158356105	0	165	51	2210	51	2045	0.0	0.02493887530562347
chr1	CD1E	158356002	158356105	0	104	51	2210	51	2106	0.0	0.024216524216524215
chr1	CD1E	158355941	158356001	0	61	51	2210	51	2149	0.0	0.023731968357375524
chr1	MNDA	158847890	158847916	0	27	0	2032	0	2005	0.0	0.0
chr1	CADM3	159193903	159194040	0	138	51	3857	51	3719	0.0	0.013713363807475128
chr1	DUSP23	159780994	159781000	0	7	0	801	0	794	0.0	0.0
chr1	ATP1A4	160167413	160167429	0	17	407617	6294	407617	6277	0.0	64.93818703202167
chr1	ATP1A4	160176563	160176602	36	40	407617	6294	407581	6254	0.9	65.17125039974417
chr1	PEA15	160211651	160211716	0	66	56561	2770	56561	2704	0.0	20.917529585798817
chr1	NCSTN	160343803	160343888	0	86	204	4150	204	4064	0.0	0.05019685039370079
chr1	AL121985.1	160683696	160683785	0	90	0	4131	0	4041	0.0	0.0
chr1	SLAMF7	160750094	160750132	0	39	153	3183	153	3144	0.0	0.04866412213740458
chr1	NIT1	161118179	161118209	0	31	8085	3450	8085	3419	0.0	2.3647265282246273
chr1	NIT1	161118179	161118551	102	373	8085	3450	7983	3077	0.2734584450402145	2.5944101397465062
chr1	NIT1	161118240	161118551	102	312	8085	3450	7983	3138	0.3269230769230769	2.543977055449331
chr1	NIT1	161118179	161118225	0	47	8085	3450	8085	3403	0.0	2.3758448427857775
chr1	NIT1	161118210	161118225	0	16	8085	3450	8085	3434	0.0	2.354397204426325
chr1	NIT1	161118179	161118239	0	61	8085	3450	8085	3389	0.0	2.3856594865742107
chr1	NIT1	161118210	161118239	0	30	8085	3450	8085	3420	0.0	2.3640350877192984
chr1	NIT1	161118226	161118239	0	14	8085	3450	8085	3436	0.0	2.3530267753201395
chr1	UFC1	161154071	161154120	0	50	1482	1386	1482	1336	0.0	1.1092814371257484
chr1	USP21	161163923	161163981	3794	59	63835	3470	60041	3411	64.30508474576271	17.602169451773673
chr1	PPOX	161166612	161166672	1774	61	13139	4416	11365	4355	29.081967213114755	2.6096440872560276
chr1	NDUFS2	161212655	161213182	0	528	22843	7304	22843	6776	0.0	3.3711629279811097
chr1	NDUFS2	161213922	161214032	71	111	22843	7304	22772	7193	0.6396396396396397	3.165855693034895
chr1	NDUFS2	161214021	161214032	20	12	22843	7304	22823	7292	1.6666666666666667	3.12986834887548
chr1	NDUFS2	161213947	161214032	56	86	22843	7304	22787	7218	0.6511627906976745	3.156968689387642
chr1	NDUFS2	161213922	161214020	51	99	22843	7304	22792	7205	0.5151515151515151	3.163358778625954
chr1	NDUFS2	161213947	161214020	36	74	22843	7304	22807	7230	0.4864864864864865	3.1544951590594743
chr1	NDUFS2	161213922	161213946	15	25	22843	7304	22828	7279	0.6	3.136145074872922
chr1	NDUFS2	161213922	161214053	128	132	22843	7304	22715	7172	0.9696969696969697	3.1671779141104293
chr1	NDUFS2	161214033	161214053	57	21	22843	7304	22786	7283	2.7142857142857144	3.128655773719621
chr1	NDUFS2	161214021	161214053	77	33	22843	7304	22766	7271	2.3333333333333335	3.1310686287993397
chr1	NDUFS2	161213947	161214053	113	107	22843	7304	22730	7197	1.0560747663551402	3.1582603862720577
chr1	FCGR2A	161506592	161506707	0	116	102	4043	102	3927	0.0	0.025974025974025976
chr1	FCRLA	161710864	161710912	0	49	0	2862	0	2813	0.0	0.0
chr1	RGS4	163069409	163069528	0	120	0	3740	0	3620	0.0	0.0
chr1	NUF2	163322067	163322212	0	146	7078	3228	7078	3082	0.0	2.2965606748864373
chr1	AL356441.1	165598623	165598684	0	62	165711	2014	165711	1952	0.0	84.89293032786885
chr1	POGK	166839605	166839769	459	165	1814	8441	1355	8276	2.7818181818181817	0.16372643789270178
chr1	BLZF1	169368343	169368362	0	20	0	3828	0	3808	0.0	0.0
chr1	FMO1	171248615	171248623	0	9	1326	2776	1326	2767	0.0	0.4792193711601012
chr1	FMO1	171282066	171282333	0	268	1326	2776	1326	2508	0.0	0.5287081339712919
chr1	FMO1	171282334	171283216	0	883	1326	2776	1326	1893	0.0	0.7004754358161648
chr1	PRRC2C	171514631	171514645	450	15	50971	11736	50521	11721	30.0	4.31029775616415
chr1	PRRC2C	171584527	171584541	0	15	50971	11736	50971	11721	0.0	4.348690384779456
chr1	PRRC2C	171591201	171591204	0	4	50971	11736	50971	11732	0.0	4.3446130242072964
chr1	EEF1AKNMT	171781796	171782120	0	325	16	3836	16	3511	0.0	0.004557106237539163
chr1	SUCO	172588925	172589926	0	1002	14562	7919	14562	6917	0.0	2.10524793985832
chr1	RABGAP1L	174219185	174219295	0	111	53514	13119	53514	13008	0.0	4.113929889298893
chr1	RABGAP1L	174700747	174700865	0	119	53514	13119	53514	13000	0.0	4.116461538461539
chr1	RABGAP1L	174701123	174701145	0	23	53514	13119	53514	13096	0.0	4.086285888821014
chr1	CACYBP	175004815	175004833	0	19	2818	4456	2818	4437	0.0	0.635113815641199
chr1	TEX35	178514078	178514185	285	108	6892	3115	6607	3007	2.638888888888889	2.1972065181243763
chr1	TEX35	178513228	178513251	0	24	6892	3115	6892	3091	0.0	2.2296991264962793
chr1	AXDND1	179365982	179366000	0	19	171	6113	171	6094	0.0	0.02806038726616344
chr1	AXDND1	179366001	179366126	0	126	171	6113	171	5987	0.0	0.028561884082178052
chr1	AXDND1	179365982	179366126	0	145	171	6113	171	5968	0.0	0.028652815013404824
chr1	AXDND1	179366001	179366011	0	11	171	6113	171	6102	0.0	0.028023598820058997
chr1	TOR1AIP1	179882978	179882992	735	15	18794	4707	18059	4692	49.0	3.8488917306052857
chr1	LHX4	180248457	180248469	232	13	11323	6091	11091	6078	17.846153846153847	1.8247778874629812
chr1	OVAAL	180562267	180562344	0	78	102	2221	102	2143	0.0	0.04759682687820812
chr1	OVAAL	180562345	180562349	0	5	102	2221	102	2216	0.0	0.046028880866425995
chr1	OVAAL	180562267	180562349	0	83	102	2221	102	2138	0.0	0.047708138447146865
chr1	RGSL1	182460735	182460756	0	22	21006	8963	21006	8941	0.0	2.349401632926966
chr1	NPL	182806233	182806531	4817	299	11147	4113	6330	3814	16.110367892976587	1.659674882013634
chr1	SMG7	183542365	183542502	0	138	17569	8348	17569	8210	0.0	2.1399512789281365
chr1	TSEN15	184072299	184072310	0	12	298	8390	298	8378	0.0	0.03556934829314872
chr1	TSEN15	184072195	184072310	0	116	298	8390	298	8274	0.0	0.03601643703166546
chr1	TSEN15	184072195	184072298	0	104	298	8390	298	8286	0.0	0.03596427709389331
chr1	RO60	193069182	193069634	51	453	69774	8943	69723	8490	0.11258278145695365	8.212367491166077
chr1	RO60	193084658	193084698	0	41	69774	8943	69774	8902	0.0	7.838013929454055
chr1	CRB1	197442293	197442534	0	242	2601	9131	2601	8889	0.0	0.29260884238947016
chr1	C1ORF53	197902851	197902913	0	63	0	484	0	421	0.0	0.0
chr1	NEK7	198157097	198157276	0	180	416	5465	416	5285	0.0	0.07871333964049196
chr1	PTPRC	198639335	198639341	0	7	0	9077	0	9070	0.0	0.0
chr1	AC104461.1	200474183	200474186	0	4	378	4073	378	4069	0.0	0.09289751781764562
chr1	AC104461.1	200474101	200474186	0	86	378	4073	378	3987	0.0	0.09480812641083522
chr1	AC104461.1	200474101	200474182	0	82	378	4073	378	3991	0.0	0.09471310448509146
chr1	INAVA	200891403	200891701	0	299	51	4229	51	3930	0.0	0.012977099236641221
chr1	MROH3P	200928418	200928421	0	4	663	3084	663	3080	0.0	0.21525974025974026
chr1	MROH3P	200937332	200937334	0	3	663	3084	663	3081	0.0	0.21518987341772153
chr1	MROH3P	200958988	200959038	0	51	663	3084	663	3033	0.0	0.218595450049456
chr1	AL358473.1	201024077	201024085	0	9	0	3510	0	3501	0.0	0.0
chr1	ELF3	202010707	202011299	0	593	0	4243	0	3650	0.0	0.0
chr1	ELF3	202011294	202011299	0	6	0	4243	0	4237	0.0	0.0
chr1	ELF3	202010707	202010820	0	114	0	4243	0	4129	0.0	0.0
chr1	PTPRVP	202168108	202168511	0	404	0	6628	0	6224	0.0	0.0
chr1	PTPRVP	202177302	202177333	0	32	0	6628	0	6596	0.0	0.0
chr1	LINC01353	203288251	203288306	0	56	0	1392	0	1336	0.0	0.0
chr1	LAX1	203765384	203765654	16776	271	64447	3342	47671	3071	61.904059040590404	15.522956691631391
chr1	ZC3H11A	203795776	203795794	78	19	13902	8033	13824	8014	4.105263157894737	1.7249812827551785
chr1	ZC3H11A	203796497	203796601	102	105	13902	8033	13800	7928	0.9714285714285714	1.7406659939455096
chr1	ZC3H11A	203796497	203796607	102	111	13902	8033	13800	7922	0.918918918918919	1.7419843473870236
chr1	ZC3H11A	203796602	203796607	0	6	13902	8033	13902	8027	0.0	1.7319048212283543
chr1	ERLNC1	204141793	204142016	0	224	0	1534	0	1310	0.0	0.0
chr1	ERLNC1	204141793	204142260	0	468	0	1534	0	1066	0.0	0.0
chr1	ERLNC1	204142017	204142260	0	244	0	1534	0	1290	0.0	0.0
chr1	CNTN2	205073842	205073912	0	71	172972	14396	172972	14325	0.0	12.074834205933682
chr1	CNTN2	205073237	205073564	51	328	172972	14396	172921	14068	0.15548780487804878	12.291796986067672
chr1	CDK18	205523626	205523715	0	90	57	5600	57	5510	0.0	0.010344827586206896
chr1	CDK18	205504797	205504878	0	82	57	5600	57	5518	0.0	0.010329829648423342
chr1	AC119673.2	205858294	205858320	0	27	9399	5942	9399	5915	0.0	1.589010989010989
chr1	AC119673.2	205858290	205858320	0	31	9399	5942	9399	5911	0.0	1.59008627981729
chr1	AC119673.2	205858290	205858293	0	4	9399	5942	9399	5938	0.0	1.5828561805321657
chr1	SRGAP2	206203483	206203650	0	168	0	12849	0	12681	0.0	0.0
chr1	SRGAP2	206342901	206343008	0	108	0	12849	0	12741	0.0	0.0
chr1	RASSF5	206584685	206585295	0	611	31782	5452	31782	4841	0.0	6.565172485023756
chr1	DYRK3	206635781	206635835	7935	55	176936	10320	169001	10265	144.27272727272728	16.46380905991232
chr1	DYRK3	206635836	206636224	57298	389	176936	10320	119638	9931	147.2956298200514	12.046923774040883
chr1	IL19	206770831	206771078	0	248	309604	6241	309604	5993	0.0	51.66093776072084
chr1	CD46	207752098	207752309	0	212	102	7781	102	7569	0.0	0.013476020610384463
chr1	LINC01717	208728730	208728734	0	5	0	1633	0	1628	0.0	0.0
chr1	LINC01717	208728730	208728932	0	203	0	1633	0	1430	0.0	0.0
chr1	LINC01717	208728735	208728932	0	198	0	1633	0	1435	0.0	0.0
chr1	MIR205HG	209428883	209429088	0	206	0	2601	0	2395	0.0	0.0
chr1	MIR205HG	209430477	209430500	0	24	0	2601	0	2577	0.0	0.0
chr1	MIR205HG	209430501	209431825	0	1325	0	2601	0	1276	0.0	0.0
chr1	MIR205HG	209429409	209431825	0	2417	0	2601	0	184	0.0	0.0
chr1	MIR205HG	209430477	209431825	0	1349	0	2601	0	1252	0.0	0.0
chr1	CAMK1G	209583773	209583932	0	160	0	3342	0	3182	0.0	0.0
chr1	TRAF3IP3	209760325	209760384	0	60	0	5521	0	5461	0.0	0.0
chr1	SYT14	210100191	210100461	0	271	98699	13990	98699	13719	0.0	7.194329032728333
chr1	RCOR3	211312836	211312961	0	126	51	9078	51	8952	0.0	0.005697050938337802
chr1	LINC00467	211422640	211422700	0	61	23936	6958	23936	6897	0.0	3.470494417862839
chr1	LINC00467	211422671	211422700	0	30	23936	6958	23936	6928	0.0	3.4549653579676676
chr1	LINC00467	211396832	211396841	0	10	23936	6958	23936	6948	0.0	3.445020149683362
chr1	LINC00467	211422640	211422670	0	31	23936	6958	23936	6927	0.0	3.4554641258842214
chr1	LINC00467	211382926	211382975	0	50	23936	6958	23936	6908	0.0	3.464968152866242
chr1	LINC01693	211639890	211640189	0	300	19	2205	19	1905	0.0	0.009973753280839895
chr1	LINC01693	211640190	211640360	0	171	19	2205	19	2034	0.0	0.009341199606686333
chr1	LINC01693	211639890	211640360	0	471	19	2205	19	1734	0.0	0.010957324106113034
chr1	AC096637.2	211685793	211685806	0	14	0	2423	0	2409	0.0	0.0
chr1	KCNK2	215083308	215083431	0	124	0	3448	0	3324	0.0	0.0
chr1	MTARC1	220798015	220798065	0	51	2360	9006	2360	8955	0.0	0.26353992183137914
chr1	TAF1A-AS1	222589963	222590407	0	445	0	2263	0	1818	0.0	0.0
chr1	DISP1	222942971	222943332	0	362	44593	10206	44593	9844	0.0	4.529967492889069
chr1	DISP1	222815079	222815171	16186	93	44593	10206	28407	10113	174.04301075268816	2.8089587659448236
chr1	AC138393.1	223996002	223996094	51	93	2173	3147	2122	3054	0.5483870967741935	0.6948264571054354
chr1	DNAH14	224967515	224967583	0	69	5066	19791	5066	19722	0.0	0.25687049994929523
chr1	DNAH14	225051685	225051795	0	111	5066	19791	5066	19680	0.0	0.2574186991869919
chr1	DNAH14	225367877	225368032	0	156	5066	19791	5066	19635	0.0	0.258008658008658
chr1	DNAH14	225250704	225250707	0	4	5066	19791	5066	19787	0.0	0.25602668418658714
chr1	EPHX1	225810170	225810615	1827	446	4203	2518	2376	2072	4.096412556053812	1.1467181467181466
chr1	H3-3A	226062812	226062948	0	137	42301	3832	42301	3695	0.0	11.448173207036536
chr1	H3-3A	226065810	226065817	0	8	42301	3832	42301	3824	0.0	11.061976987447698
chr1	H3-3A	226063597	226063681	0	85	42301	3832	42301	3747	0.0	11.289298105150788
chr1	LINC01703	226083642	226083968	0	327	0	1616	0	1289	0.0	0.0
chr1	PSEN2	226891845	226891849	0	5	4542	12917	4542	12912	0.0	0.3517657992565056
chr1	ARF1	228082766	228082850	0	85	51	3176	51	3091	0.0	0.01649951472015529
chr1	ARF1	228083310	228083374	0	65	51	3176	51	3111	0.0	0.01639344262295082
chr1	ARF1	228083353	228083374	0	22	51	3176	51	3154	0.0	0.016169942929613188
chr1	ARF1	228083310	228083352	0	43	51	3176	51	3133	0.0	0.016278327481646985
chr1	GUK1	228148457	228148539	0	83	35	2999	35	2916	0.0	0.012002743484224965
chr1	GUK1	228145625	228145649	0	25	35	2999	35	2974	0.0	0.011768661735036988
chr1	GUK1	228141508	228141829	0	322	35	2999	35	2677	0.0	0.01307433694434068
chr1	OBSCN	228374749	228374752	0	4	3355766	37944	3355766	37940	0.0	88.44928835002636
chr1	OBSCN	228356194	228356344	74	151	3355766	37944	3355692	37793	0.4900662251655629	88.79136348000952
chr1	LINC01736	230006025	230006098	0	74	357	1189	357	1115	0.0	0.3201793721973094
chr1	AL118511.1	230874716	230875155	0	440	8	1948	8	1508	0.0	0.005305039787798408
chr1	ARV1	230979257	230979279	1665	23	33081	2003	31416	1980	72.3913043478261	15.866666666666667
chr1	TRIM67	231201512	231201517	0	6	216	8359	216	8353	0.0	0.025858972824135042
chr1	GNPAT	231260654	231260683	0	30	0	2954	0	2924	0.0	0.0
chr1	DISC1	232008984	232009049	0	66	32525	12565	32525	12499	0.0	2.6022081766541323
chr1	TBCE	235414470	235414618	0	149	11570	8049	11570	7900	0.0	1.4645569620253165
chr1	TBCE	235419516	235419561	0	46	11570	8049	11570	8003	0.0	1.4457078595526678
chr1	TBCE	235433099	235433171	0	73	11570	8049	11570	7976	0.0	1.4506018054162488
chr1	AL357556.3	235329184	235330500	12174	1317	17682	5210	5508	3893	9.24373576309795	1.4148471615720524
chr1	AL357556.3	235330501	235330602	2291	102	17682	5210	15391	5108	22.46078431372549	3.013116679718089
chr1	TBCE	235367505	235367552	0	48	11570	8049	11570	8001	0.0	1.446069241344832
chr1	TBCE	235438923	235438988	980	66	11570	8049	10590	7983	14.848484848484848	1.3265689590379557
chr1	TBCE	235438927	235438988	980	62	11570	8049	10590	7987	15.806451612903226	1.3259045949668211
chr1	TBCE	235438923	235438926	0	4	11570	8049	11570	8045	0.0	1.4381603480422622
chr1	TBCE	235442912	235442961	0	50	11570	8049	11570	7999	0.0	1.4464308038504814
chr1	MTR	236838519	236838599	0	81	10583	12378	10583	12297	0.0	0.8606164105066276
chr1	CHRM3	239632277	239632286	0	10	51	15165	51	15155	0.0	0.0033652259980204552
chr1	CHRM3	239545750	239545753	0	4	51	15165	51	15161	0.0	0.0033638942022294043
chr1	AL365184.1	240763660	240763862	0	203	24	2738	24	2535	0.0	0.009467455621301775
chr1	AL365184.1	240768232	240768304	0	73	24	2738	24	2665	0.0	0.00900562851782364
chr1	AL359764.2	241436504	241436522	0	19	51	9640	51	9621	0.0	0.005300904271905207
chr1	AL359764.2	241424550	241424714	0	165	51	9640	51	9475	0.0	0.005382585751978892
chr1	EXO1	241848273	241848353	0	81	102	4110	102	4029	0.0	0.02531645569620253
chr1	EXO1	241853473	241853481	0	9	102	4110	102	4101	0.0	0.02487198244330651
chr1	CNST	246566664	246566789	0	126	7449	5943	7449	5817	0.0	1.2805569881382155
chr1	LINC01341	246780510	246780583	0	74	4644	4672	4644	4598	0.0	1.0100043497172684
chr1	LINC01341	246790847	246791195	0	349	4644	4672	4644	4323	0.0	1.0742539902845247
chr1	NLRP3	247425600	247425770	0	171	129	4587	129	4416	0.0	0.029211956521739132
chr1	AL390860.1	247640430	247640433	0	4	0	3842	0	3838	0.0	0.0
chr1	AL627309.1	120720	120773	211	54	6593	3729	6382	3675	3.9074074074074074	1.7365986394557824
chr1	AL627309.5	167958	168098	3619	141	64448	7438	60829	7297	25.666666666666668	8.336165547485267
chr1	AL732372.2	502464	502860	0	397	0	6130	0	5733	0.0	0.0
chr1	AL732372.2	498046	498071	0	26	0	6130	0	6104	0.0	0.0
chr1	AL732372.2	517155	517183	0	29	0	6130	0	6101	0.0	0.0
chr1	FAM41C	874111	875038	11932	928	13991	1807	2059	879	12.857758620689655	2.342434584755404
chr1	HES4	999691	999864	1024	174	13025	966	12001	792	5.885057471264368	15.152777777777779
chr1	C1ORF159	1083914	1084351	0	438	1497	4115	1497	3677	0.0	0.4071253739461518
chr1	TNFRSF18	1204033	1204053	14	21	5678	1276	5664	1255	0.6666666666666666	4.513147410358566
chr1	UBE2J2	1267732	1267860	0	129	387997	4676	387997	4547	0.0	85.33032768858588
chr1	UBE2J2	1273498	1273664	34178	167	387997	4676	353819	4509	204.65868263473052	78.4695054335773
chr1	UBE2J2	1273376	1273664	46625	289	387997	4676	341372	4387	161.33217993079586	77.81445178937771
chr1	UBE2J2	1273376	1273497	12447	122	387997	4676	375550	4554	102.02459016393442	82.46596398770312
chr1	UBE2J2	1262169	1262267	16612	99	387997	4676	371385	4577	167.7979797979798	81.1415774524798
chr1	UBE2J2	1272852	1273375	2098	524	387997	4676	385899	4152	4.0038167938931295	92.9429190751445
chr1	INTS11	1322891	1323179	62320	289	583314	6765	520994	6476	215.6401384083045	80.44996911673873
chr1	INTS11	1323146	1323179	27693	34	583314	6765	555621	6731	814.5	82.54657554598128
chr1	INTS11	1322891	1323145	34627	255	583314	6765	548687	6510	135.7921568627451	84.2837173579109
chr1	DVL1	1339286	1339360	2933	75	185122	3895	182189	3820	39.10666666666667	47.693455497382196
chr1	AURKAIP1	1375074	1375152	191	79	6018	1466	5827	1387	2.4177215189873418	4.201153568853641
chr1	AURKAIP1	1374996	1375152	951	157	6018	1466	5067	1309	6.057324840764331	3.8708938120702827
chr1	AURKAIP1	1374996	1375073	760	78	6018	1466	5258	1388	9.743589743589743	3.788184438040346
chr1	CCNL2	1392678	1392788	26	111	59013	6208	58987	6097	0.23423423423423423	9.674758077743153
chr1	CCNL2	1398987	1399017	0	31	59013	6208	59013	6177	0.0	9.553666828557553
chr1	ANKRD65	1420796	1420814	114	19	127423	2647	127309	2628	6.0	48.44330289193303
chr1	LINC01770	1434177	1434186	0	10	22717	854	22717	844	0.0	26.915876777251185
chr1	CDK11B	1642346	1642384	1356	39	217634	3502	216278	3463	34.76923076923077	62.45394166907306
chr1	CDK11A	1707408	1707523	0	116	168180	4549	168180	4433	0.0	37.93819084141665
chr1	CDK11A	1719327	1719356	681	30	168180	4549	167499	4519	22.7	37.06550121708342
chr1	CDK11A	1722587	1722706	0	120	168180	4549	168180	4429	0.0	37.9724542786182
chr1	CDK11A	1709478	1709516	42	39	168180	4549	168138	4510	1.0769230769230769	37.281152993348115
chr1	CDK11A	1723799	1723947	2346	149	168180	4549	165834	4400	15.74496644295302	37.68954545454545
chr1	CDK11A	1723948	1724256	257	309	168180	4549	167923	4240	0.8317152103559871	39.60448113207547
chr1	NADK	1756738	1756777	516	40	243123	5178	242607	5138	12.9	47.21817827948618
chr1	FAAP20	2203435	2203562	591	128	99991	8807	99400	8679	4.6171875	11.452932365479894
chr1	FAAP20	2198753	2201048	11632	2296	99991	8807	88359	6511	5.066202090592334	13.570726462908924
chr1	FAAP20	2192646	2192843	3613	198	99991	8807	96378	8609	18.247474747474747	11.195028458589848
chr1	PEX10	2408451	2408454	0	4	0	3454	0	3450	0.0	0.0
chr1	PEX10	2410260	2410369	0	110	0	3454	0	3344	0.0	0.0
chr1	TNFRSF14-AS1	2554723	2555679	0	957	0	4264	0	3307	0.0	0.0
chr1	MMEL1	2592654	2592719	0	66	0	3894	0	3828	0.0	0.0
chr1	PRDM16-DT	3060500	3061105	0	606	0	4427	0	3821	0.0	0.0
chr1	TP73-AS1	3745380	3745605	1713	226	167096	6550	165383	6324	7.579646017699115	26.151644528779254
chr1	TP73-AS1	3746436	3746526	26245	91	167096	6550	140851	6459	288.4065934065934	21.806936058213346
chr1	TP73-AS1	3743279	3743299	5066	21	167096	6550	162030	6529	241.23809523809524	24.816970439577272
chr1	CEP104	3837287	3837290	0	4	38388	11552	38388	11548	0.0	3.3242119847592657
chr1	CEP104	3829132	3829264	0	133	38388	11552	38388	11419	0.0	3.3617654785883175
chr1	CHD5	6130147	6130202	0	56	19320	10138	19320	10082	0.0	1.916286451100972
chr1	TNFRSF25	6463064	6463070	0	7	101	3596	101	3589	0.0	0.02814154360546113
chr1	TNFRSF25	6462862	6463070	0	209	101	3596	101	3387	0.0	0.02981989961617951
chr1	PLEKHG5	6485801	6485834	0	34	266	6625	266	6591	0.0	0.04035806402670308
chr1	PLEKHG5	6485801	6485808	0	8	266	6625	266	6617	0.0	0.04019948617198126
chr1	PLEKHG5	6491586	6491635	134	50	266	6625	132	6575	2.68	0.020076045627376426
chr1	PLEKHG5	6485809	6485834	0	26	266	6625	266	6599	0.0	0.04030913774814366
chr1	LZIC	9943248	9943347	357	100	49241	5468	48884	5368	3.57	9.10655737704918
chr1	DFFA	10462987	10463056	1903	70	471547	6631	469644	6561	27.185714285714287	71.5811614083219
chr1	C1ORF127	10949623	10949700	0	78	102	3581	102	3503	0.0	0.029117898943762488
chr1	SRM	11058709	11058798	0	90	0	1901	0	1811	0.0	0.0
chr1	MAD2L2	11676808	11676846	0	39	0	2907	0	2868	0.0	0.0
chr1	MTHFR	11803404	11803797	1089	394	160765	6734	159676	6340	2.763959390862944	25.185488958990536
chr1	MTHFR	11805346	11805886	26821	541	160765	6734	133944	6193	49.57670979667283	21.628290004844178
chr1	CASP9	15518109	15518248	188	140	3314	4712	3126	4572	1.3428571428571427	0.6837270341207349
chr1	HSPB7	16017073	16017087	266	15	4934	2655	4668	2640	17.733333333333334	1.768181818181818
chr1	ATP13A2	17004691	17004705	0	15	45701	5196	45701	5181	0.0	8.820883999227949
chr1	SDHB	17028599	17028652	0	54	0	2335	0	2281	0.0	0.0
chr1	EMC1	19244738	19244904	2727	167	36257	8562	33530	8395	16.32934131736527	3.9940440738534844
chr1	KIF17	20717348	20717474	0	127	1224	4306	1224	4179	0.0	0.2928930366116296
chr1	HP1BP3	20780344	20780348	0	5	1202	5936	1202	5931	0.0	0.20266396897656383
chr1	HP1BP3	20786185	20786251	0	67	1202	5936	1202	5869	0.0	0.204804907139206
chr1	HP1BP3	20786252	20786647	0	396	1202	5936	1202	5540	0.0	0.21696750902527076
chr1	HP1BP3	20786252	20786512	0	261	1202	5936	1202	5675	0.0	0.21180616740088107
chr1	RAP1GAP	21603657	21603833	0	177	5043	5400	5043	5223	0.0	0.9655370476737507
chr1	USP48	21736429	21736444	0	16	28401	9527	28401	9511	0.0	2.986121333193145
chr1	LINC01635	22024805	22025058	0	254	71	1231	71	977	0.0	0.07267144319344933
chr1	ASAP3	23433076	23433156	0	81	7435	5015	7435	4934	0.0	1.506890960680989
chr1	ASAP3	23484004	23484034	0	31	7435	5015	7435	4984	0.0	1.4917736757624398
chr1	ASAP3	23433361	23433423	0	63	7435	5015	7435	4952	0.0	1.5014135702746365
chr1	ASAP3	23435722	23435849	654	128	7435	5015	6781	4887	5.109375	1.3875588295477799
chr1	ELOA-AS1	23772267	23772270	0	4	21592	2991	21592	2987	0.0	7.228657515902243
chr1	GALE	23800307	23800385	0	79	1045	3023	1045	2944	0.0	0.35495923913043476
chr1	RCAN3AS	24502347	24502371	0	25	0	767	0	742	0.0	0.0
chr1	RSRP1	25337039	25337976	0	938	462	5486	462	4548	0.0	0.10158311345646438
chr1	RSRP1	25337039	25338067	0	1029	462	5486	462	4457	0.0	0.10365716849899036
chr1	RSRP1	25244176	25245148	0	973	462	5486	462	4513	0.0	0.10237092842898293
chr1	RSRP1	25244176	25244452	0	277	462	5486	462	5209	0.0	0.08869264734114034
chr1	RSRP1	25337977	25338067	0	91	462	5486	462	5395	0.0	0.08563484708063021
chr1	AL020996.1	25819643	25819710	0	68	2860	1576	2860	1508	0.0	1.896551724137931
chr1	AL020996.1	25818222	25818401	220	180	2860	1576	2640	1396	1.2222222222222223	1.8911174785100286
chr1	CRYBG2	26354035	26354044	0	10	918	6090	918	6080	0.0	0.15098684210526317
chr1	ZNF683	26372463	26372667	204	205	1876	2318	1672	2113	0.9951219512195122	0.791292001893043
chr1	ZNF683	26372534	26372667	136	134	1876	2318	1740	2184	1.0149253731343284	0.7967032967032966
chr1	AHDC1	27604105	27604108	0	4	1716	4518	1716	4514	0.0	0.38015064244572444
chr1	IFI6	27669220	27669243	0	24	1255	847	1255	823	0.0	1.5249088699878492
chr1	IFI6	27669220	27669231	0	12	1255	847	1255	835	0.0	1.5029940119760479
chr1	IFI6	27669232	27669243	0	12	1255	847	1255	835	0.0	1.5029940119760479
chr1	RPA2	27914421	27914432	24	12	2815	1976	2791	1964	2.0	1.4210794297352343
chr1	SNHG12	28579911	28579940	0	30	1224	3699	1224	3669	0.0	0.3336058871627146
chr1	SNHG12	28580424	28580558	0	135	1224	3699	1224	3564	0.0	0.3434343434343434
chr1	SNHG12	28581093	28581109	0	17	1224	3699	1224	3682	0.0	0.33242802824551876
chr1	SNHG12	28581589	28582088	1734	500	1224	3699	-510	3199	3.468	-0.1594248202563301
chr1	TAF12	28642654	28642990	0	337	1335	2346	1335	2009	0.0	0.664509706321553
chr1	PUM1	31059203	31059297	0	95	62	6646	62	6551	0.0	0.009464203938330026
chr1	PUM1	31065615	31065687	0	73	62	6646	62	6573	0.0	0.009432527004411988
chr1	PUM1	30950126	30950131	0	6	62	6646	62	6640	0.0	0.009337349397590362
chr1	PUM1	30941921	30941996	0	76	62	6646	62	6570	0.0	0.009436834094368341
chr1	SPOCD1	31796589	31796591	0	3	4424	6982	4424	6979	0.0	0.633901705115346
chr1	SPOCD1	31813950	31815346	2448	1397	4424	6982	1976	5585	1.7523264137437367	0.3538048343777977
chr1	SPOCD1	31815743	31815959	51	217	4424	6982	4373	6765	0.2350230414746544	0.6464153732446415
chr1	PTP4A2	31937754	31937776	0	23	357	6592	357	6569	0.0	0.0543461714111737
chr1	MTMR9LP	32239868	32239889	0	22	0	2789	0	2767	0.0	0.0
chr1	ZBTB8OS	32634701	32634766	0	66	30458	3541	30458	3475	0.0	8.764892086330935
chr1	ZBTB8OS	32650428	32650431	104	4	30458	3541	30354	3537	26.0	8.581849024597116
chr1	ZBTB8OS	32650401	32650431	702	31	30458	3541	29756	3510	22.64516129032258	8.477492877492878
chr1	PHC2	33334089	33334183	714	95	237987	4902	237273	4807	7.515789473684211	49.35989182442272
chr1	PHC2	33354837	33354839	0	3	237987	4902	237987	4899	0.0	48.5786895284752
chr1	SMIM12	34859651	34859675	0	25	0	8690	0	8665	0.0	0.0
chr1	SMIM12	34859454	34859675	0	222	0	8690	0	8468	0.0	0.0
chr1	SMIM12	34859454	34859650	0	197	0	8690	0	8493	0.0	0.0
chr1	ZMYM6	35031525	35031629	0	105	102	9585	102	9480	0.0	0.010759493670886076
chr1	KIAA0319L	35557206	35557360	0	155	53667	9295	53667	9140	0.0	5.871663019693655
chr1	KIAA0319L	35557047	35557205	45	159	53667	9295	53622	9136	0.2830188679245283	5.86930823117338
chr1	KIAA0319L	35557047	35557360	45	314	53667	9295	53622	8981	0.14331210191082802	5.970604609731656
chr1	KIAA0319L	35554788	35554898	3009	111	53667	9295	50658	9184	27.10810810810811	5.515897212543554
chr1	COL8A2	36100049	36100193	0	145	174310	4673	174310	4528	0.0	38.496024734982335
chr1	TRAPPC3	36149259	36149335	0	77	51	3533	51	3456	0.0	0.014756944444444444
chr1	TRAPPC3	36149091	36149335	0	245	51	3533	51	3288	0.0	0.01551094890510949
chr1	TRAPPC3	36149091	36149258	0	168	51	3533	51	3365	0.0	0.015156017830609212
chr1	STK40	36367847	36367850	284	4	47653	5632	47369	5628	71.0	8.416666666666666
chr1	SNIP1	37554005	37554190	0	186	0	5537	0	5351	0.0	0.0
chr1	RSPO1	37629567	37629887	0	321	0	3066	0	2745	0.0	0.0
chr1	C1ORF109	37689605	37689656	0	52	0	3992	0	3940	0.0	0.0
chr1	C1ORF109	37690215	37690332	0	118	0	3992	0	3874	0.0	0.0
chr1	C1ORF109	37690001	37690332	0	332	0	3992	0	3660	0.0	0.0
chr1	C1ORF109	37690001	37690214	0	214	0	3992	0	3778	0.0	0.0
chr1	EPHA10	37718375	37718376	0	2	0	8168	0	8166	0.0	0.0
chr1	EPHA10	37719413	37719506	0	94	0	8168	0	8074	0.0	0.0
chr1	INPP5B	37931672	37931911	255	240	2543	5821	2288	5581	1.0625	0.40996237233470706
chr1	FHL3	38005356	38005437	0	82	102	2010	102	1928	0.0	0.052904564315352696
chr1	PPIEL	39529015	39529053	0	39	16407	3504	16407	3465	0.0	4.735064935064935
chr1	PPIEL	39547578	39548860	0	1283	16407	3504	16407	2221	0.0	7.387212967131923
chr1	PPIEL	39523557	39523560	0	4	16407	3504	16407	3500	0.0	4.687714285714286
chr1	PABPC4	39561684	39561726	0	43	3670	8427	3670	8384	0.0	0.4377385496183206
chr1	PABPC4	39564685	39564699	0	15	3670	8427	3670	8412	0.0	0.43628150261531146
chr1	PABPC4	39564422	39564469	0	48	3670	8427	3670	8379	0.0	0.437999761308032
chr1	PABPC4	39563526	39563612	0	87	3670	8427	3670	8340	0.0	0.44004796163069543
chr1	PABPC4	39571096	39571232	1071	137	3670	8427	2599	8290	7.817518248175182	0.3135102533172497
chr1	TRIT1	39850118	39850121	0	4	12189	6546	12189	6542	0.0	1.8631916845001528
chr1	PPT1	40076729	40076840	0	112	3040	2932	3040	2820	0.0	1.0780141843971631
chr1	PPT1	40097110	40097113	0	4	3040	2932	3040	2928	0.0	1.0382513661202186
chr1	PPT1	40096808	40097113	0	306	3040	2932	3040	2626	0.0	1.1576542269611576
chr1	PPT1	40096808	40097109	0	302	3040	2932	3040	2630	0.0	1.155893536121673
chr1	SLFNL1	41021529	41021621	0	93	4044	3549	4044	3456	0.0	1.1701388888888888
chr1	SCMH1	41046406	41046416	0	11	23350	4464	23350	4453	0.0	5.2436559622726255
chr1	P3H1	42747252	42747270	0	19	648	4271	648	4252	0.0	0.1523988711194732
chr1	C1ORF210	43285443	43285551	703	109	58968	1525	58265	1416	6.4495412844036695	41.1475988700565
chr1	ELOVL1	43364541	43364617	0	77	0	2516	0	2439	0.0	0.0
chr1	ELOVL1	43364541	43364613	0	73	0	2516	0	2443	0.0	0.0
chr1	ELOVL1	43364614	43364617	0	4	0	2516	0	2512	0.0	0.0
chr1	HYI	43451797	43451826	0	30	2449	1686	2449	1656	0.0	1.478864734299517
chr1	HYI	43451409	43451426	0	18	2449	1686	2449	1668	0.0	1.4682254196642686
chr1	HYI	43453385	43453411	0	27	2449	1686	2449	1659	0.0	1.4761904761904763
chr1	SLC6A9	44010725	44010807	64623	83	104428	5268	39805	5185	778.5903614457832	7.67695274831244
chr1	MUTYH	45340218	45340221	0	4	35062	5148	35062	5144	0.0	6.8160964230171075
chr1	MUTYH	45331660	45332021	0	362	35062	5148	35062	4786	0.0	7.325950689511074
chr1	MUTYH	45339661	45339897	2747	237	35062	5148	32315	4911	11.59071729957806	6.5801262472001625
chr1	MUTYH	45340202	45340217	0	16	35062	5148	35062	5132	0.0	6.832034294621979
chr1	MUTYH	45340202	45340221	0	20	35062	5148	35062	5128	0.0	6.837363494539781
chr1	MUTYH	45338185	45338505	3621	321	35062	5148	31441	4827	11.280373831775702	6.513569504868448
chr1	CCDC163	45497298	45497302	0	5	1479	2764	1479	2759	0.0	0.5360637912287061
chr1	PRDX1	45521608	45521856	0	249	0	1470	0	1221	0.0	0.0
chr1	PRDX1	45521608	45521827	0	220	0	1470	0	1250	0.0	0.0
chr1	PRDX1	45521828	45521856	0	29	0	1470	0	1441	0.0	0.0
chr1	CCDC17	45620527	45620721	0	195	0	2792	0	2597	0.0	0.0
chr1	PIK3R3	46132698	46132782	0	85	78105	7408	78105	7323	0.0	10.665710774272839
chr1	POMGNT1	46189457	46189482	0	26	13905	5476	13905	5450	0.0	2.5513761467889906
chr1	POMGNT1	46196730	46196777	0	48	13905	5476	13905	5428	0.0	2.56171702284451
chr1	LINC01398	46449486	46449497	0	12	306	1768	306	1756	0.0	0.17425968109339407
chr1	MKNK1	46604184	46604225	0	42	1727	6721	1727	6679	0.0	0.2585716424614463
chr1	MKNK1	46604164	46604183	0	20	1727	6721	1727	6701	0.0	0.25772272795105206
chr1	MKNK1	46604164	46604225	0	62	1727	6721	1727	6659	0.0	0.25934825048806126
chr1	EFCAB14	46716290	46716293	2	4	81597	13320	81595	13316	0.5	6.127590868128567
chr1	SPATA6	48355669	48355716	0	48	0	5955	0	5907	0.0	0.0
chr1	SPATA6	48400772	48400788	0	17	0	5955	0	5938	0.0	0.0
chr1	LINC02808	50280034	50280083	0	50	102	3525	102	3475	0.0	0.02935251798561151
chr1	CALR4P	51567173	51567750	0	578	0	2713	0	2135	0.0	0.0
chr1	CC2D1B	52353517	52353601	0	85	1180	7104	1180	7019	0.0	0.16811511611340646
chr1	ECHDC2	52921482	52921551	0	70	72802	10086	72802	10016	0.0	7.268570287539936
chr1	SLC1A7	53102263	53103344	0	1082	998	3662	998	2580	0.0	0.3868217054263566
chr1	LRP8	53246917	53246954	0	38	88986	13559	88986	13521	0.0	6.58131794985578
chr1	LRP8	53246917	53246922	0	6	88986	13559	88986	13553	0.0	6.565778794362871
chr1	LRP8	53246923	53246954	0	32	88986	13559	88986	13527	0.0	6.5783987580394765
chr1	TMEM59	54052999	54053354	4080	356	24584	9158	20504	8802	11.460674157303371	2.329470574869348
chr1	AL357673.1	54144465	54144567	408	103	1713	3965	1305	3862	3.9611650485436893	0.3379078197824961
chr1	CYB5RL	54190737	54190746	0	10	612	8739	612	8729	0.0	0.07011112384007331
chr1	DHCR24	54886617	54886800	0	184	714	4979	714	4795	0.0	0.14890510948905109
chr1	AL590440.2	54979839	54979987	0	149	0	1589	0	1440	0.0	0.0
chr1	LINC01753	55921311	55921363	0	53	0	710	0	657	0.0	0.0
chr1	DAB1	57062883	57062888	6	6	6455	7577	6449	7571	1.0	0.8518029322414477
chr1	OMA1	58546663	58546701	0	39	0	3704	0	3665	0.0	0.0
chr1	OMA1	58546663	58546688	0	26	0	3704	0	3678	0.0	0.0
chr1	OMA1	58546689	58546701	0	13	0	3704	0	3691	0.0	0.0
chr1	OMA1	58546689	58546739	0	51	0	3704	0	3653	0.0	0.0
chr1	OMA1	58546634	58546701	0	68	0	3704	0	3636	0.0	0.0
chr1	OMA1	58546634	58546662	0	29	0	3704	0	3675	0.0	0.0
chr1	OMA1	58546634	58546688	0	55	0	3704	0	3649	0.0	0.0
chr1	LINC02777	58896546	58896648	0	103	0	1976	0	1873	0.0	0.0
chr1	HSD52	59133230	59133254	0	25	16576	6497	16576	6472	0.0	2.561186650185414
chr1	CYP2J2	59926520	59926535	0	16	0	2983	0	2967	0.0	0.0
chr1	LINC01748	60542289	60542295	0	7	51	15481	51	15474	0.0	0.0032958511050794883
chr1	LINC01748	60596125	60596247	0	123	51	15481	51	15358	0.0	0.0033207448886573773
chr1	LINC01748	60596125	60596167	0	43	51	15481	51	15438	0.0	0.003303536727555383
chr1	LINC01748	60596168	60596247	0	80	51	15481	51	15401	0.0	0.003311473280955782
chr1	TM2D1	61724901	61724918	0	18	51	5509	51	5491	0.0	0.009287925696594427
chr1	DOCK7	62513443	62513469	0	27	1869	19101	1869	19074	0.0	0.09798678829820698
chr1	ROR1-AS1	64111945	64111982	360	38	52009	4585	51649	4547	9.473684210526315	11.358917967890918
chr1	JAK1	64841450	64841554	0	105	78	11649	78	11544	0.0	0.006756756756756757
chr1	LINC01359	65002328	65002407	0	80	0	5118	0	5038	0.0	0.0
chr1	LINC01359	64993471	64993475	0	5	0	5118	0	5113	0.0	0.0
chr1	DNAI4	66890182	66891152	630	971	5213	6353	4583	5382	0.6488156539649845	0.8515421776291342
chr1	DEPDC1	68482045	68482639	0	595	102	5916	102	5321	0.0	0.019169329073482427
chr1	LRRIQ3	74041212	74041689	0	478	0	6363	0	5885	0.0	0.0
chr1	USP33	77759642	77759699	788	58	4377	6945	3589	6887	13.586206896551724	0.5211267605633803
chr1	ADGRL4	79006542	79006631	0	90	16274	5737	16274	5647	0.0	2.881884186293607
chr1	UOX	84372041	84372041	15	1	1985	2424	1970	2423	15.0	0.8130416838629798
chr1	CTBS	84573915	84574237	0	323	19992	6941	19992	6618	0.0	3.0208522212148687
chr1	SSX2IP	84671176	84671187	252	12	26681	8472	26429	8460	21.0	3.1239952718676123
chr1	SSX2IP	84690153	84690369	0	217	26681	8472	26681	8255	0.0	3.2321017565112053
chr1	MCOLN2	84996795	84997006	0	212	4914	3246	4914	3034	0.0	1.6196440342781806
chr1	MCOLN3	85047309	85047573	0	265	22642	6622	22642	6357	0.0	3.5617429605159665
chr1	BCL10	85274943	85276294	0	1352	0	2283	0	931	0.0	0.0
chr1	BCL10	85274943	85275161	0	219	0	2283	0	2064	0.0	0.0
chr1	SELENOF	86914027	86914313	0	287	0	2208	0	1921	0.0	0.0
chr1	SELENOF	86913805	86914026	0	222	0	2208	0	1986	0.0	0.0
chr1	PKN2-AS1	87903867	87903897	0	31	1827	16670	1827	16639	0.0	0.10980227177114009
chr1	GTF2B	88857205	88857371	0	167	0	2533	0	2366	0.0	0.0
chr1	GTF2B	88887260	88887274	0	15	0	2533	0	2518	0.0	0.0
chr1	GBP3	89013184	89013196	0	13	1617	4282	1617	4269	0.0	0.3787772312016866
chr1	GBP3	89020125	89020128	20	4	1617	4282	1597	4278	5.0	0.37330528284244974
chr1	GBP3	89014404	89014545	0	142	1617	4282	1617	4140	0.0	0.39057971014492754
chr1	GBP3	89020352	89020530	0	179	1617	4282	1617	4103	0.0	0.3941018766756032
chr1	LRRC8C-DT	89632015	89632018	0	4	6719	6795	6719	6791	0.0	0.9893977322927404
chr1	LINC02609	90851482	90851539	0	58	0	14100	0	14042	0.0	0.0
chr1	LINC02609	90835825	90836000	0	176	0	14100	0	13924	0.0	0.0
chr1	LINC02609	90834385	90834619	0	235	0	14100	0	13865	0.0	0.0
chr1	LINC02609	90834385	90834508	0	124	0	14100	0	13976	0.0	0.0
chr1	LINC02609	90834509	90834619	0	111	0	14100	0	13989	0.0	0.0
chr1	CCDC18-AS1	93337376	93339154	102	1779	36241	4958	36139	3179	0.05733558178752108	11.368040264234036
chr1	CCDC18-AS1	93345539	93345722	0	184	36241	4958	36241	4774	0.0	7.5913280268118974
chr1	CCDC18-AS1	93345539	93345644	0	106	36241	4958	36241	4852	0.0	7.469291014014839
chr1	CCDC18-AS1	93345645	93345722	0	78	36241	4958	36241	4880	0.0	7.426434426229508
chr1	SLC44A3-AS1	94623525	94623877	0	353	8896	10264	8896	9911	0.0	0.897588537988094
chr1	PLPPR5	98914785	98914799	0	15	204	4707	204	4692	0.0	0.043478260869565216
chr1	FRRS1	99710805	99710832	0	28	0	8643	0	8615	0.0	0.0
chr1	RTCA-AS1	100265814	100265827	0	14	153	7246	153	7232	0.0	0.021155973451327435
chr1	EXTL2	100878393	100878422	0	30	0	4022	0	3992	0.0	0.0
chr1	DPH5	101025664	101025681	0	18	0	2126	0	2108	0.0	0.0
chr1	DPH5	101025682	101025803	0	122	0	2126	0	2004	0.0	0.0
chr1	AMY1B	103696041	103696282	0	242	0	2346	0	2104	0.0	0.0
chr1	LINC01676	105618774	105618857	0	84	0	3046	0	2962	0.0	0.0
chr1	LINC01677	105992153	105992164	0	12	0	3134	0	3122	0.0	0.0
chr1	CLCC1	108963360	108963399	165	40	3798	6514	3633	6474	4.125	0.5611677479147359
chr1	CLCC1	108963360	108963379	81	20	3798	6514	3717	6494	4.05	0.5723744995380351
chr1	CLCC1	108934619	108934623	0	5	3798	6514	3798	6509	0.0	0.583499769549854
chr1	CLCC1	108934566	108934623	0	58	3798	6514	3798	6456	0.0	0.5882899628252788
chr1	CLCC1	108934566	108934618	0	53	3798	6514	3798	6461	0.0	0.5878347005107568
chr1	CLCC1	108963342	108963399	247	58	3798	6514	3551	6456	4.258620689655173	0.5500309789343246
chr1	CLCC1	108963342	108963359	82	18	3798	6514	3716	6496	4.555555555555555	0.5720443349753694
chr1	CLCC1	108963342	108963379	163	38	3798	6514	3635	6476	4.2894736842105265	0.5613032736256949
chr1	CLCC1	108962308	108963359	2898	1052	3798	6514	900	5462	2.7547528517110265	0.16477480776272427
chr1	CLCC1	108962308	108963399	3063	1092	3798	6514	735	5422	2.8049450549450547	0.13555883437845814
chr1	CLCC1	108962308	108963379	2979	1072	3798	6514	819	5442	2.778917910447761	0.15049614112458654
chr1	CLCC1	108963380	108963399	84	20	3798	6514	3714	6494	4.2	0.5719125346473668
chr1	WDR47	109013819	109013839	21	21	1982	4440	1961	4419	1.0	0.44376555781851096
chr1	PSRC1	109283062	109283072	0	11	816	2373	816	2362	0.0	0.3454699407281964
chr1	PSRC1	109283027	109283061	0	35	816	2373	816	2338	0.0	0.34901625320787
chr1	PSRC1	109283027	109283072	0	46	816	2373	816	2327	0.0	0.35066609368285345
chr1	LAMTOR5	110407032	110407584	408	553	204	1329	-204	776	0.7377938517179023	-0.26288659793814434
chr1	KCNA2	110603888	110603891	28	4	582650	18742	582622	18738	7.0	31.093072899989327
chr1	LRIF1	110951287	110952530	12001	1244	39586	3506	27585	2262	9.647106109324758	12.194960212201591
chr1	DRAM2	111139500	111139586	0	87	0	3309	0	3222	0.0	0.0
chr1	DRAM2	111139500	111140036	0	537	0	3309	0	2772	0.0	0.0
chr1	DRAM2	111140037	111140041	0	5	0	3309	0	3304	0.0	0.0
chr1	AL390195.1	111440691	111441136	51	446	51	863	0	417	0.11434977578475336	0.0
chr1	TMIGD3	111503004	111503497	0	494	11492	2276	11492	1782	0.0	6.448933782267115
chr1	LINC01160	111608135	111608211	0	77	51	1382	51	1305	0.0	0.03908045977011494
chr1	ST7L	112618783	112618907	0	125	0	7822	0	7697	0.0	0.0
chr1	RHOC	112705052	112705098	0	47	0	2792	0	2745	0.0	0.0
chr1	RHOC	112706731	112706831	0	101	0	2792	0	2691	0.0	0.0
chr1	RHOC	112706731	112707076	0	346	0	2792	0	2446	0.0	0.0
chr1	PPM1J	112714057	112714974	0	918	0	2461	0	1543	0.0	0.0
chr1	PPM1J	112714057	112714632	0	576	0	2461	0	1885	0.0	0.0
chr1	SLC16A1	112955275	112956033	255	759	983	5162	728	4403	0.3359683794466403	0.16534181240063592
chr1	AP4B1	113904920	113904940	0	21	144	5835	144	5814	0.0	0.02476780185758514
chr1	HIPK1-AS1	113928702	113929224	0	523	714	3093	714	2570	0.0	0.27782101167315176
chr1	HIPK1-AS1	113928702	113929207	0	506	714	3093	714	2587	0.0	0.2759953614224971
chr1	HIPK1-AS1	113929208	113929224	0	17	714	3093	714	3076	0.0	0.23211963589076723
chr1	SYT6	114097726	114097746	0	21	0	5075	0	5054	0.0	0.0
chr1	SYT6	114152622	114152764	0	143	0	5075	0	4932	0.0	0.0
chr1	DENND2C	114623506	114623558	0	53	146	7434	146	7381	0.0	0.019780517545048098
chr1	AMPD1	114695436	114695448	0	13	0	2917	0	2904	0.0	0.0
chr1	SIKE1	114780436	114780447	0	12	0	5899	0	5887	0.0	0.0
chr1	TRIM45	117118033	117118086	874	54	12397	4375	11523	4321	16.185185185185187	2.666743809303402
chr1	AL157902.1	117605556	117605644	42	89	42	1095	0	1006	0.47191011235955055	0.0
chr1	FAM72B	121183337	121183456	0	120	0	2555	0	2435	0.0	0.0
chr1	AL592494.1	121510355	121510454	0	100	0	548	0	448	0.0	0.0
chr1	AC245595.1	144288342	144288353	0	12	0	1488	0	1476	0.0	0.0
chr1	SRGAP2B	145095222	145095389	0	168	48409	7073	48409	6905	0.0	7.010716871832006
chr1	NBPF20	145400385	145400387	0	3	110512	19134	110512	19131	0.0	5.776592964298782
chr1	ANKRD34A	145962420	145962814	0	395	306	3458	306	3063	0.0	0.09990205680705191
chr1	HJV	146019174	146019696	0	523	615	2423	615	1900	0.0	0.3236842105263158
chr1	FMO5	147225276	147225285	0	10	0	5996	0	5986	0.0	0.0
chr1	FMO5	147225286	147225572	0	287	0	5996	0	5709	0.0	0.0
chr1	PDZK1P1	147996522	147996586	0	65	74286	3684	74286	3619	0.0	20.526664824537164
chr1	NBPF11	148151719	148151748	0	30	0	5942	0	5912	0.0	0.0
chr1	AC239809.3	148206494	148206600	0	107	49367	14907	49367	14800	0.0	3.335608108108108
chr1	AC239809.3	148226493	148226733	0	241	49367	14907	49367	14666	0.0	3.366084822037365
chr1	NBPF14	148595849	148595853	796	5	273751	12061	272955	12056	159.2	22.640593895155938
chr1	NBPF9	149065525	149065635	0	111	459	8033	459	7922	0.0	0.05793991416309013
chr1	NBPF9	149082271	149082275	0	5	459	8033	459	8028	0.0	0.05717488789237668
chr1	AC243772.3	149747616	149747692	0	77	0	3275	0	3198	0.0	0.0
chr1	MTMR11	149936581	149936709	0	129	15203	4455	15203	4326	0.0	3.514331946370781
chr1	AC244033.2	150066969	150067481	100	513	602	3080	502	2567	0.1949317738791423	0.19555901830931047
chr1	ENSA	150627311	150627465	0	155	1624	2646	1624	2491	0.0	0.6519470092332397
chr1	ENSA	150627397	150627465	0	69	1624	2646	1624	2577	0.0	0.6301901435778037
chr1	ENSA	150627311	150627396	0	86	1624	2646	1624	2560	0.0	0.634375
chr1	CTSK	150807129	150807247	1375	119	132919	7254	131544	7135	11.554621848739496	18.436440084092503
chr1	CDC42SE1	151056650	151056654	5	5	4651	4192	4646	4187	1.0	1.1096250298543109
chr1	SEMA6C	151137985	151138007	0	23	284779	3937	284779	3914	0.0	72.75907000510986
chr1	SEMA6C	151145023	151146431	1977	1409	284779	3937	282802	2528	1.4031227821149752	111.86787974683544
chr1	LYSMD1	151165078	151165745	204	668	9251	2511	9047	1843	0.30538922155688625	4.908844275637548
chr1	TMOD4	151175923	151175950	0	28	31318	1545	31318	1517	0.0	20.644693473961766
chr1	VPS72	151190004	151190122	3179	119	32875	1217	29696	1098	26.714285714285715	27.04553734061931
chr1	ZNF687-AS1	151281542	151281807	431	266	74193	725	73762	459	1.6203007518796992	160.70152505446623
chr1	PI4KB	151294017	151294047	0	31	162929	5088	162929	5057	0.0	32.2185089974293
chr1	RFX5	151346204	151346213	0	10	0	3082	0	3072	0.0	0.0
chr1	RFX5	151346481	151346487	0	7	0	3082	0	3075	0.0	0.0
chr1	RFX5	151346481	151346483	0	3	0	3082	0	3079	0.0	0.0
chr1	RFX5	151346481	151346577	0	97	0	3082	0	2985	0.0	0.0
chr1	RFX5	151346488	151346577	0	90	0	3082	0	2992	0.0	0.0
chr1	RFX5	151346484	151346487	0	4	0	3082	0	3078	0.0	0.0
chr1	RFX5	151346484	151346577	0	94	0	3082	0	2988	0.0	0.0
chr1	RFX5	151346421	151346480	0	60	0	3082	0	3022	0.0	0.0
chr1	RFX5	151346421	151346487	0	67	0	3082	0	3015	0.0	0.0
chr1	RFX5	151346421	151346483	0	63	0	3082	0	3019	0.0	0.0
chr1	RFX5	151346421	151346577	0	157	0	3082	0	2925	0.0	0.0
chr1	RFX5	151346754	151346938	0	185	0	3082	0	2897	0.0	0.0
chr1	RFX5	151347150	151347209	0	60	0	3082	0	3022	0.0	0.0
chr1	SELENBP1	151368999	151369002	0	4	60954	3236	60954	3232	0.0	18.859529702970296
chr1	MRPL9	151762949	151762988	92	40	12800	1368	12708	1328	2.3	9.569277108433734
chr1	MRPL9	151762949	151762953	36	5	12800	1368	12764	1363	7.2	9.36463683052091
chr1	MRPL9	151762954	151762988	56	35	12800	1368	12744	1333	1.6	9.560390097524381
chr1	MRPL9	151762104	151762111	0	8	12800	1368	12800	1360	0.0	9.411764705882353
chr1	TDRKH	151790379	151790397	0	19	153	4678	153	4659	0.0	0.032839665164198326
chr1	TDRKH	151790379	151790403	0	25	153	4678	153	4653	0.0	0.03288201160541586
chr1	TDRKH	151779950	151780049	0	100	153	4678	153	4578	0.0	0.033420707732634336
chr1	TDRKH	151790398	151790403	0	6	153	4678	153	4672	0.0	0.032748287671232876
chr1	SPRR2D	153041669	153041770	0	102	0	954	0	852	0.0	0.0
chr1	S100A6	153535788	153535947	675	160	2368	974	1693	814	4.21875	2.07985257985258
chr1	S100A16	153608898	153609176	55547	279	20474	1427	-35073	1148	199.09318996415772	-30.551393728222997
chr1	S100A14	153615828	153615866	6564	39	165204	1283	158640	1244	168.30769230769232	127.52411575562701
chr1	AL162258.1	153634213	153634241	6518	29	74825	1002	68307	973	224.75862068965517	70.20246659815005
chr1	GATAD2B	153817371	153817418	0	48	43559	9263	43559	9215	0.0	4.726966901790559
chr1	SLC39A1	153963494	153963595	11979	102	525691	3208	513712	3106	117.44117647058823	165.39343206696716
chr1	SLC39A1	153963058	153963175	0	118	525691	3208	525691	3090	0.0	170.12653721682847
chr1	SLC39A1	153967385	153967449	0	65	525691	3208	525691	3143	0.0	167.25771555838372
chr1	SLC39A1	153963001	153963175	0	175	525691	3208	525691	3033	0.0	173.3237718430597
chr1	SLC39A1	153963001	153963057	0	57	525691	3208	525691	3151	0.0	166.83306886702633
chr1	SLC39A1	153962869	153963057	0	189	525691	3208	525691	3019	0.0	174.1275256707519
chr1	SLC39A1	153962869	153963000	0	132	525691	3208	525691	3076	0.0	170.90084525357608
chr1	JTB	153977169	153977337	0	169	1530	1486	1530	1317	0.0	1.1617312072892938
chr1	AL592078.2	154567423	154567548	866	126	8395	1655	7529	1529	6.873015873015873	4.9241334205362985
chr1	AL592078.2	154567423	154567557	866	135	8395	1655	7529	1520	6.4148148148148145	4.953289473684211
chr1	AL592078.2	154567549	154567557	0	9	8395	1655	8395	1646	0.0	5.100243013365735
chr1	ADAR	154590183	154590340	0	158	24172	9646	24172	9488	0.0	2.5476391231028668
chr1	ADAR	154590183	154590260	0	78	24172	9646	24172	9568	0.0	2.5263377926421406
chr1	ADAR	154627854	154627952	51	99	24172	9646	24121	9547	0.5151515151515151	2.5265528438252853
chr1	ADAR	154590261	154590340	0	80	24172	9646	24172	9566	0.0	2.5268659836922436
chr1	PBXIP1	154948132	154948224	1609	93	419649	3603	418040	3510	17.301075268817204	119.0997150997151
chr1	SHC1	154965542	154965637	705	96	107291	4260	106586	4164	7.34375	25.59702209414025
chr1	KRTCAP2	155169786	155169789	2577	4	698428	3710	695851	3706	644.25	187.76335671883433
chr1	THBS3	155203085	155203091	1468	7	395854	4646	394386	4639	209.71428571428572	85.0153050226342
chr1	THBS3	155206192	155206198	11785	7	395854	4646	384069	4639	1683.5714285714287	82.79133433929726
chr1	GBAP1	155217518	155217962	71166	445	327187	3205	256021	2760	159.92359550561798	92.76123188405798
chr1	GBAP1	155217518	155217703	50707	186	327187	3205	276480	3019	272.6182795698925	91.57999337528983
chr1	GBAP1	155218387	155218454	0	68	327187	3205	327187	3137	0.0	104.29933057060886
chr1	SCAMP3	155257284	155257296	0	13	30923	2310	30923	2297	0.0	13.462342185459296
chr1	ASH1L	155562152	155562777	182	626	13459	13816	13277	13190	0.29073482428115016	1.0065959059893859
chr1	ASH1L	155440489	155440501	0	13	13459	13816	13459	13803	0.0	0.9750778816199377
chr1	ASH1L	155343591	155343602	0	12	13459	13816	13459	13804	0.0	0.9750072442770211
chr1	YY1AP1	155680381	155680414	151	34	7545	4688	7394	4654	4.4411764705882355	1.588740868070477
chr1	YY1AP1	155688620	155688657	931	38	7545	4688	6614	4650	24.5	1.4223655913978495
chr1	YY1AP1	155688578	155688619	168	42	7545	4688	7377	4646	4.0	1.5878174773999139
chr1	GON4L	155857146	155857157	0	12	76777	11036	76777	11024	0.0	6.964531930333817
chr1	RIT1	155911242	155911270	0	29	85181	4045	85181	4016	0.0	21.210408366533866
chr1	ARHGEF2	155950268	155950297	2523	30	574674	8670	572151	8640	84.1	66.22118055555555
chr1	SSR2	156018131	156018268	2289	138	137514	5038	135225	4900	16.58695652173913	27.596938775510203
chr1	SSR2	156018131	156018250	2217	120	137514	5038	135297	4918	18.475	27.510573403822693
chr1	SSR2	156020726	156020886	0	161	137514	5038	137514	4877	0.0	28.19643223293008
chr1	SSR2	156020675	156020725	0	51	137514	5038	137514	4987	0.0	27.574493683577302
chr1	SSR2	156012384	156012393	220	10	137514	5038	137294	5028	22.0	27.305887032617342
chr1	PAQR6	156246680	156246688	0	9	10381	2498	10381	2489	0.0	4.170751305745279
chr1	PAQR6	156244689	156244759	102	71	10381	2498	10279	2427	1.4366197183098592	4.235269880510919
chr1	PAQR6	156247914	156247955	0	42	10381	2498	10381	2456	0.0	4.226791530944626
chr1	GLMP	156295296	156295524	0	229	1184321	2595	1184321	2366	0.0	500.55832628909553
chr1	MIR9-1HG	156415396	156416767	1362	1372	67884	7374	66522	6002	0.9927113702623906	11.08330556481173
chr1	MIR9-1HG	156414055	156414082	0	28	67884	7374	67884	7346	0.0	9.24094745439695
chr1	ISG20L2	156728353	156728413	0	61	34664	4689	34664	4628	0.0	7.4900605012964565
chr1	MRPL24	156741011	156741051	0	41	21241	1703	21241	1662	0.0	12.780385078219012
chr1	MRPL24	156740930	156741010	0	81	21241	1703	21241	1622	0.0	13.095561035758323
chr1	MRPL24	156740930	156741051	0	122	21241	1703	21241	1581	0.0	13.43516761543327
chr1	HDGF	156752037	156752227	13359	191	23353	3683	9994	3492	69.94240837696336	2.861970217640321
chr1	FCRL3	157678594	157678741	0	148	4554	5345	4554	5197	0.0	0.8762747739080239
chr1	FCRL3	157700661	157700701	0	41	4554	5345	4554	5304	0.0	0.8585972850678733
chr1	LINC01704	158132573	158132576	0	4	10492	2018	10492	2014	0.0	5.209533267130089
chr1	CD1B	158329369	158329533	0	165	0	1401	0	1236	0.0	0.0
chr1	SNHG28	159840710	159840767	0	58	41503	3025	41503	2967	0.0	13.988203572632289
chr1	SNHG28	159854756	159854757	0	2	41503	3025	41503	3023	0.0	13.729077075752564
chr1	SNHG28	159854756	159854920	0	165	41503	3025	41503	2860	0.0	14.511538461538462
chr1	SNHG28	159854752	159854755	0	4	41503	3025	41503	3021	0.0	13.738166170142337
chr1	SNHG28	159854752	159854757	0	6	41503	3025	41503	3019	0.0	13.747267307055317
chr1	SNHG28	159838364	159840709	0	2346	41503	3025	41503	679	0.0	61.123711340206185
chr1	SNHG28	159838364	159840767	0	2404	41503	3025	41503	621	0.0	66.83252818035427
chr1	AL590560.2	159858089	159858167	90	79	37381	6349	37291	6270	1.139240506329114	5.947527910685805
chr1	SNHG28	159837916	159841124	0	3209	41503	3025	41503	-184	0.0	-225.55978260869566
chr1	SNHG28	159854758	159854920	0	163	41503	3025	41503	2862	0.0	14.501397624039134
chr1	SLAMF9	159953308	159953443	0	136	0	1007	0	871	0.0	0.0
chr1	KCNJ10	160041833	160042044	0	212	30640	4234	30640	4022	0.0	7.618100447538538
chr1	KCNJ10	160041335	160042044	0	710	30640	4234	30640	3524	0.0	8.69466515323496
chr1	KCNJ10	160041335	160041832	0	498	30640	4234	30640	3736	0.0	8.201284796573876
chr1	DCAF8	160262116	160262274	506	159	288469	6531	287963	6372	3.1823899371069184	45.19193345888261
chr1	DCAF8	160262116	160262447	114646	332	288469	6531	173823	6199	345.3192771084337	28.04049040167769
chr1	DCAF8	160262275	160262447	114140	173	288469	6531	174329	6358	659.7687861271677	27.41884240327147
chr1	COPA	160306353	160306453	3964	101	37797	7549	33833	7448	39.24752475247525	4.5425617615467235
chr1	CD84	160553359	160553376	0	18	51	9263	51	9245	0.0	0.005516495402920498
chr1	F11R	161001019	161001043	316	25	52530	5046	52214	5021	12.64	10.399123680541726
chr1	USF1	161041650	161041733	138	84	179	2093	41	2009	1.6428571428571428	0.02040816326530612
chr1	USF1	161041650	161041832	138	183	179	2093	41	1910	0.7540983606557377	0.021465968586387434
chr1	USF1	161042554	161042584	0	31	179	2093	179	2062	0.0	0.08680892337536372
chr1	USF1	161041734	161041832	0	99	179	2093	179	1994	0.0	0.08976930792377132
chr1	USF1	161043252	161043266	0	15	179	2093	179	2078	0.0	0.08614051973051011
chr1	DEDD	161122984	161123073	255	90	106125	2740	105870	2650	2.8333333333333335	39.950943396226414
chr1	DEDD	161124339	161124412	92	74	106125	2740	106033	2666	1.2432432432432432	39.77231807951988
chr1	APOA2	161223501	161223593	0	93	0	769	0	676	0.0	0.0
chr1	APOA2	161223501	161223517	0	17	0	769	0	752	0.0	0.0
chr1	NR1I3	161236458	161236528	0	71	0	2001	0	1930	0.0	0.0
chr1	MPZ	161306707	161306787	306	81	1235	2155	929	2074	3.7777777777777777	0.44792671166827386
chr1	RGS5	163152537	163152548	0	12	30943	9121	30943	9109	0.0	3.3969700296410146
chr1	TMCO1	165768681	165768757	0	77	8490	5337	8490	5260	0.0	1.6140684410646389
chr1	TMCO1	165768481	165768680	0	200	8490	5337	8490	5137	0.0	1.6527155927584194
chr1	TMCO1	165768481	165768757	0	277	8490	5337	8490	5060	0.0	1.6778656126482214
chr1	FAM78B	166069831	166069833	0	3	0	5592	0	5589	0.0	0.0
chr1	FAM78B	166069511	166069830	0	320	0	5592	0	5272	0.0	0.0
chr1	FAM78B	166069511	166069833	0	323	0	5592	0	5269	0.0	0.0
chr1	LINC01363	167195656	167195687	0	32	0	1348	0	1316	0.0	0.0
chr1	METTL18	169794814	169794868	0	55	6674	1578	6674	1523	0.0	4.382140512147078
chr1	BX284613.2	171247565	171247579	0	15	51	7890	51	7875	0.0	0.0064761904761904765
chr1	VAMP4	171710713	171710758	0	46	2080	4062	2080	4016	0.0	0.5179282868525896
chr1	DNM3OS	172144557	172144652	0	96	0	2594	0	2498	0.0	0.0
chr1	CENPL	173806438	173806457	0	20	146092	4921	146092	4901	0.0	29.80861048765558
chr1	CENPL	173824137	173824210	0	74	146092	4921	146092	4847	0.0	30.140705591087272
chr1	GAS5	173867959	173867979	0	21	12849	4337	12849	4316	0.0	2.977062094531974
chr1	GAS5	173864483	173864673	0	191	12849	4337	12849	4146	0.0	3.0991316931982635
chr1	GAS5	173865470	173865508	363	39	12849	4337	12486	4298	9.307692307692308	2.9050721265704977
chr1	GAS5	173865228	173865508	723	281	12849	4337	12126	4056	2.5729537366548043	2.989644970414201
chr1	GAS5	173867154	173867720	1693	567	12849	4337	11156	3770	2.9858906525573192	2.9591511936339523
chr1	MRPS14	175023271	175023362	0	92	23636	884	23636	792	0.0	29.843434343434343
chr1	COP1	176163814	176163825	0	12	10540	4200	10540	4188	0.0	2.516714422158548
chr1	CRYZL2P-SEC16B	177960341	177960789	0	449	270	6507	270	6058	0.0	0.04456916474083856
chr1	CRYZL2P	178026071	178026153	0	83	11241	5510	11241	5427	0.0	2.0713101160862353
chr1	RASAL2-AS1	178093533	178093559	0	27	0	716	0	689	0.0	0.0
chr1	LINC01344	182128294	182128403	0	110	0	6690	0	6580	0.0	0.0
chr1	GLUL	182386255	182386360	0	106	102	10959	102	10853	0.0	0.009398323044319543
chr1	GLUL	182390496	182391677	0	1182	102	10959	102	9777	0.0	0.010432648051549556
chr1	GLUL	182390496	182391173	0	678	102	10959	102	10281	0.0	0.009921213889699446
chr1	GLUL	182391174	182391677	0	504	102	10959	102	10455	0.0	0.00975609756097561
chr1	LINC01350	185563167	185563237	0	71	179	2415	179	2344	0.0	0.07636518771331058
chr1	UCHL5	193059184	193059411	26354	228	87807	6676	61453	6448	115.58771929824562	9.53055210918114
chr1	GLRX2	193105516	193105616	0	101	21064	6115	21064	6014	0.0	3.5024941802460923
chr1	DENND1B	197775138	197775350	0	213	2302	11873	2302	11660	0.0	0.1974271012006861
chr1	LINC00862	200373646	200373781	1	136	62556	3543	62555	3407	0.007352941176470588	18.360727913120048
chr1	TMEM9	201146739	201146769	0	31	2535	2290	2535	2259	0.0	1.1221779548472774
chr1	TMEM9	201153848	201153856	0	9	2535	2290	2535	2281	0.0	1.1113546690048224
chr1	TMEM9	201154147	201154360	0	214	2535	2290	2535	2076	0.0	1.2210982658959537
chr1	TMEM9	201153782	201153856	0	75	2535	2290	2535	2215	0.0	1.144469525959368
chr1	TMEM9	201153782	201153847	0	66	2535	2290	2535	2224	0.0	1.1398381294964028
chr1	TNNT2	201361912	201361949	0	38	0	5980	0	5942	0.0	0.0
chr1	TNNT2	201373196	201373204	0	9	0	5980	0	5971	0.0	0.0
chr1	TNNT2	201361213	201361277	0	65	0	5980	0	5915	0.0	0.0
chr1	TNNT2	201372026	201372143	0	118	0	5980	0	5862	0.0	0.0
chr1	TNNI1	201417746	201417781	0	36	2244	7068	2244	7032	0.0	0.3191126279863481
chr1	PTPN7	202160544	202161385	561	842	740	3851	179	3009	0.666270783847981	0.05948820206048521
chr1	UBE2T	202335641	202335644	0	4	102	1657	102	1653	0.0	0.06170598911070781
chr1	KDM5B	202741366	202741544	5	179	216426	17458	216421	17279	0.027932960893854747	12.525088257422304
chr1	KDM5B	202808101	202808115	0	15	216426	17458	216426	17443	0.0	12.407613369259876
chr1	LINC00303	204036968	204037254	0	287	2331	1992	2331	1705	0.0	1.3671554252199414
chr1	ETNK2	204141024	204141214	0	191	102	4420	102	4229	0.0	0.024119177110428
chr1	RBBP5	205094872	205094985	0	114	19108	4418	19108	4304	0.0	4.439591078066915
chr1	RAB29	205775272	205775372	0	101	62605	3871	62605	3770	0.0	16.606100795755967
chr1	RAB29	205774832	205775271	0	440	62605	3871	62605	3431	0.0	18.246866802681435
chr1	RAB29	205774832	205775127	0	296	62605	3871	62605	3575	0.0	17.511888111888112
chr1	FAM72A	206201873	206201992	0	120	27	3129	27	3009	0.0	0.00897308075772682
chr1	EIF2D	206608235	206608278	0	44	50585	5561	50585	5517	0.0	9.168932390792097
chr1	FCMR	206913758	206913860	0	103	371366	3427	371366	3324	0.0	111.72262334536703
chr1	PIGR	206939118	206939408	0	291	91	4383	91	4092	0.0	0.022238514173998046
chr1	AL137789.1	207606467	207606491	0	25	0	1513	0	1488	0.0	0.0
chr1	AC092810.2	209153505	209153663	0	159	0	3124	0	2965	0.0	0.0
chr1	AC092810.2	209153505	209153570	0	66	0	3124	0	3058	0.0	0.0
chr1	AC092810.2	209153571	209153663	0	93	0	3124	0	3031	0.0	0.0
chr1	SERTAD4-AS1	210233634	210233949	0	316	0	1007	0	691	0.0	0.0
chr1	KCNH1	211018782	211018862	0	81	51	4644	51	4563	0.0	0.011176857330703484
chr1	KCNH1	210683020	210683465	0	446	51	4644	51	4198	0.0	0.012148642210576465
chr1	KCNH1	210682620	210683019	0	400	51	4644	51	4244	0.0	0.012016965127238455
chr1	KCNH1	210682620	210683465	0	846	51	4644	51	3798	0.0	0.013428120063191154
chr1	INTS7	211952568	211952609	0	42	20889	5042	20889	5000	0.0	4.1778
chr1	LINC02773	212665318	212665334	0	17	0	1374	0	1357	0.0	0.0
chr1	ANGEL2	213015608	213015611	0	4	3570	7328	3570	7324	0.0	0.4874385581649372
chr1	PROX1-AS1	213895393	213895425	0	33	0	9778	0	9745	0.0	0.0
chr1	PROX1-AS1	213987472	213987502	0	31	0	9778	0	9747	0.0	0.0
chr1	PROX1-AS1	213987472	213987578	0	107	0	9778	0	9671	0.0	0.0
chr1	ESRRG	216723239	216723242	0	4	0	10959	0	10955	0.0	0.0
chr1	LYPLAL1-AS1	219411717	219411847	0	131	401	2629	401	2498	0.0	0.16052842273819054
chr1	BPNT1	220089643	220089684	0	42	0	2818	0	2776	0.0	0.0
chr1	LINC02817	221333901	221333914	0	14	0	2451	0	2437	0.0	0.0
chr1	LINC02817	221333834	221333900	0	67	0	2451	0	2384	0.0	0.0
chr1	LINC02817	221333834	221333914	0	81	0	2451	0	2370	0.0	0.0
chr1	AL513314.2	222504365	222504410	0	46	51	1548	51	1502	0.0	0.03395472703062583
chr1	WDR26	224431476	224431523	0	48	15285	10645	15285	10597	0.0	1.4423893554779654
chr1	CNIH3-AS2	224616020	224616073	0	54	1280	4139	1280	4085	0.0	0.31334149326805383
chr1	LINC02765	225464976	225465221	0	246	0	2015	0	1769	0.0	0.0
chr1	PYCR2	225924043	225924043	0	1	510	3483	510	3482	0.0	0.14646754738655945
chr1	LIN9	226309108	226309624	0	517	7584	4458	7584	3941	0.0	1.9243846739406243
chr1	PARP1	226386218	226386324	0	107	13862	16916	13862	16809	0.0	0.8246772562317806
chr1	JMJD4	227732880	227732927	0	48	0	3976	0	3928	0.0	0.0
chr1	C1ORF35	228103133	228103321	0	189	0	3912	0	3723	0.0	0.0
chr1	MRPL55	228108436	228108439	1	4	16924	1672	16923	1668	0.25	10.14568345323741
chr1	MRPL55	228108234	228108243	130	10	16924	1672	16794	1662	13.0	10.104693140794224
chr1	MRPL55	228109148	228109259	832	112	16924	1672	16092	1560	7.428571428571429	10.315384615384616
chr1	MRPL55	228108436	228108953	307	518	16924	1672	16617	1154	0.5926640926640927	14.39948006932409
chr1	AL353593.1	228273759	228275294	19240	1536	88017	9434	68777	7898	12.526041666666666	8.708153963028614
chr1	TRIM17	228416386	228416537	0	152	2182	3559	2182	3407	0.0	0.6404461402993836
chr1	BTNL10	228512182	228512217	0	36	0	734	0	698	0.0	0.0
chr1	AL162595.1	229267953	229268241	0	289	0	4970	0	4681	0.0	0.0
chr1	AL162595.1	229270959	229270974	0	16	0	4970	0	4954	0.0	0.0
chr1	AL445524.2	231462437	231462470	0	34	13219	3699	13219	3665	0.0	3.6068212824010915
chr1	AL445524.1	231527765	231528120	102	356	306	4123	204	3767	0.28651685393258425	0.05415449960180515
chr1	AL136171.2	231822679	231822723	0	45	102	5695	102	5650	0.0	0.018053097345132742
chr1	SIPA1L2	232608826	232608910	0	85	2796	8582	2796	8497	0.0	0.32905731434623986
chr1	LINC01354	234531015	234531024	0	10	100244	3246	100244	3236	0.0	30.977750309023484
chr1	IRF2BP2	234608446	234608493	1101	48	27950	4727	26849	4679	22.9375	5.738191921350716
chr1	AL391832.2	234962545	234962614	0	70	443	2943	443	2873	0.0	0.15419422206752523
chr1	AL391832.2	234962958	234963037	0	80	443	2943	443	2863	0.0	0.1547327977645826
chr1	AL391832.2	234962545	234962957	0	413	443	2943	443	2530	0.0	0.175098814229249
chr1	AL391832.2	234962615	234962957	0	343	443	2943	443	2600	0.0	0.17038461538461538
chr1	AL391832.2	234962615	234963037	0	423	443	2943	443	2520	0.0	0.1757936507936508
chr1	ARID4B	235213768	235213875	0	108	196	9671	196	9563	0.0	0.02049566035762836
chr1	ARID4B	235327768	235327934	0	167	196	9671	196	9504	0.0	0.020622895622895623
chr1	LYST	235766078	235766237	969	160	145623	19662	144654	19502	6.05625	7.4173930878884216
chr1	LINC01139	238485784	238485810	0	27	0	1865	0	1838	0.0	0.0
chr1	LINC01139	238486000	238486003	0	4	0	1865	0	1861	0.0	0.0
chr1	OPN3	241604259	241604418	0	160	0	3735	0	3575	0.0	0.0
chr1	PLD5	242265336	242265360	0	25	24240	9558	24240	9533	0.0	2.5427462498688764
chr1	PLD5	242348098	242348104	0	7	24240	9558	24240	9551	0.0	2.5379541409276514
chr1	CEP170	243142315	243142365	0	51	3504	8930	3504	8879	0.0	0.3946390359274693
chr1	CEP170	243255039	243255045	0	7	3504	8930	3504	8923	0.0	0.39269304045724535
chr1	CEP170	243142285	243142314	0	30	3504	8930	3504	8900	0.0	0.39370786516853934
chr1	CEP170	243142285	243142365	0	81	3504	8930	3504	8849	0.0	0.3959769465476325
chr1	CEP170	243185778	243186257	51	480	3504	8930	3453	8450	0.10625	0.4086390532544379
chr1	CEP170	243163157	243163271	0	115	3504	8930	3504	8815	0.0	0.39750425411230855
chr1	HNRNPU	244860334	244860356	23	23	46764	15411	46741	15388	1.0	3.0374967507148427
chr1	HNRNPU	244860334	244860351	18	18	46764	15411	46746	15393	1.0	3.0368349249658935
chr1	HNRNPU	244863616	244863672	396	57	46764	15411	46368	15354	6.947368421052632	3.019929660023447
chr1	HNRNPU	244860352	244860356	5	5	46764	15411	46759	15406	1.0	3.035116188497988
chr1	AHCTF1	246931128	246931306	11489	179	32040	9618	20551	9439	64.18435754189944	2.1772433520500054
chr1	ZNF695	246988120	246988123	0	4	1347	3762	1347	3758	0.0	0.3584353379457158
chr1	ZNF695	246999911	246999946	0	36	1347	3762	1347	3726	0.0	0.3615136876006441
chr1	ZNF669	247101986	247101989	8	4	2269	1726	2261	1722	2.0	1.3130081300813008
chr1	ZNF669	247103938	247104195	102	258	2269	1726	2167	1468	0.3953488372093023	1.4761580381471389
chr1	ZNF692	248856287	248856371	0	85	0	3751	0	3666	0.0	0.0
chr1	ZNF692	248858917	248859013	0	97	0	3751	0	3654	0.0	0.0
chr1	ZNF692	248855557	248855723	0	167	0	3751	0	3584	0.0	0.0
chr2	SH3YL1	230546	231021	4460	476	191528	8808	187068	8332	9.369747899159664	22.451752280364857
chr2	AC079779.3	307110	307111	0	2	255	3482	255	3480	0.0	0.07327586206896551
chr2	AC079779.3	308936	308970	0	35	255	3482	255	3447	0.0	0.07397737162750218
chr2	AC079779.3	307077	307109	0	33	255	3482	255	3449	0.0	0.0739344737605103
chr2	AC079779.3	307077	307111	0	35	255	3482	255	3447	0.0	0.07397737162750218
chr2	AC079779.3	306448	306482	0	35	255	3482	255	3447	0.0	0.07397737162750218
chr2	AC079779.3	308899	308970	0	72	255	3482	255	3410	0.0	0.0747800586510264
chr2	AC079779.3	308899	308935	0	37	255	3482	255	3445	0.0	0.07402031930333818
chr2	AC079779.3	312952	312955	0	4	255	3482	255	3478	0.0	0.07331799884991375
chr2	AC079779.3	313873	314241	0	369	255	3482	255	3113	0.0	0.08191455187921619
chr2	MYT1L	1903079	1903118	0	40	0	31707	0	31667	0.0	0.0
chr2	MYT1L	1922285	1922290	0	6	0	31707	0	31701	0.0	0.0
chr2	MYT1L	1801689	1801694	0	6	0	31707	0	31701	0.0	0.0
chr2	MYT1L	2324170	2324330	0	161	0	31707	0	31546	0.0	0.0
chr2	MYT1L	1842642	1842767	0	126	0	31707	0	31581	0.0	0.0
chr2	AC011995.2	2836918	2836958	0	41	0	8792	0	8751	0.0	0.0
chr2	ADI1	3500584	3500812	140	229	45817	5355	45677	5126	0.611353711790393	8.910846664065549
chr2	AC108488.1	3533107	3534111	0	1005	0	1197	0	192	0.0	0.0
chr2	RNASEH1	3557894	3558131	0	238	0	5954	0	5716	0.0	0.0
chr2	LINC01304	3959563	3959914	0	352	0	6379	0	6027	0.0	0.0
chr2	MIR7515HG	6639050	6639112	0	63	14908	7267	14908	7204	0.0	2.0694058856191004
chr2	MIR7515HG	6633612	6633667	0	56	14908	7267	14908	7211	0.0	2.067397032311746
chr2	MIR7515HG	6635390	6635434	0	45	14908	7267	14908	7222	0.0	2.0642481307117144
chr2	MIR7515HG	6634594	6634798	0	205	14908	7267	14908	7062	0.0	2.1110167091475502
chr2	MIR7515HG	6638966	6639049	0	84	14908	7267	14908	7183	0.0	2.0754559376305166
chr2	MIR7515HG	6637799	6638089	0	291	14908	7267	14908	6976	0.0	2.13704128440367
chr2	LINC00487	6731154	6731157	0	4	0	2205	0	2201	0.0	0.0
chr2	CMPK2	6866409	6866424	0	16	0	4311	0	4295	0.0	0.0
chr2	GRASLND	6916815	6916848	0	34	51	4549	51	4515	0.0	0.011295681063122924
chr2	GRASLND	6918284	6918400	0	117	51	4549	51	4432	0.0	0.011507220216606499
chr2	GRASLND	6918280	6918400	0	121	51	4549	51	4428	0.0	0.011517615176151762
chr2	GRASLND	6918280	6918283	0	4	51	4549	51	4545	0.0	0.011221122112211221
chr2	AC068481.1	7077370	7077702	0	333	51	2046	51	1713	0.0	0.0297723292469352
chr2	AC068481.1	7077346	7077369	0	24	51	2046	51	2022	0.0	0.025222551928783383
chr2	AC068481.1	7077346	7077702	0	357	51	2046	51	1689	0.0	0.03019538188277087
chr2	LINC00298	7979259	7979270	0	12	0	4416	0	4404	0.0	0.0
chr2	LINC01814	8583713	8583715	0	3	0	13537	0	13534	0.0	0.0
chr2	ID2-AS1	8675743	8675931	0	189	102	6592	102	6403	0.0	0.015930032797126348
chr2	ID2-AS1	8678740	8678757	0	18	102	6592	102	6574	0.0	0.015515667782172194
chr2	KIDINS220	8837468	8837478	0	11	216	14698	216	14687	0.0	0.014706883638591952
chr2	ITGB1BP1	9422478	9422964	0	487	510	6364	510	5877	0.0	0.08677896886166411
chr2	ITGB1BP1	9412067	9412267	0	201	510	6364	510	6163	0.0	0.0827519065390232
chr2	ITGB1BP1	9422478	9422800	0	323	510	6364	510	6041	0.0	0.08442310875682833
chr2	ITGB1BP1	9422801	9422964	0	164	510	6364	510	6200	0.0	0.08225806451612903
chr2	ADAM17	9543152	9543219	1404	68	51892	10467	50488	10399	20.647058823529413	4.855082219444177
chr2	YWHAQ	9630812	9630939	481	128	207098	2709	206617	2581	3.7578125	80.0530802014723
chr2	ODC1	10447473	10447626	0	154	5171	2804	5171	2650	0.0	1.951320754716981
chr2	AC062028.1	11131997	11132013	0	17	0	4225	0	4208	0.0	0.0
chr2	ROCK2	11218314	11218453	0	140	185	10233	185	10093	0.0	0.01832953532150996
chr2	AC064875.1	13002423	13003822	0	1400	3211	4174	3211	2774	0.0	1.1575342465753424
chr2	AC064875.1	13002423	13003779	0	1357	3211	4174	3211	2817	0.0	1.1398651047213348
chr2	AC064875.1	13003780	13003822	0	43	3211	4174	3211	4131	0.0	0.7772936335027838
chr2	SMC6	17752977	17753000	0	24	0	9859	0	9835	0.0	0.0
chr2	RDH14	18560179	18560628	0	450	0	1588	0	1138	0.0	0.0
chr2	NT5C1B	18586247	18586252	0	6	0	3862	0	3856	0.0	0.0
chr2	NT5C1B	18586942	18586992	0	51	0	3862	0	3811	0.0	0.0
chr2	WDR35	19932282	19932381	0	100	1071	7835	1071	7735	0.0	0.13846153846153847
chr2	WDR35	19935466	19935469	0	4	1071	7835	1071	7831	0.0	0.13676414251053506
chr2	PUM2	20350596	20350808	0	213	230963	6889	230963	6676	0.0	34.59601557819053
chr2	LDAH	20801291	20801308	0	18	2707	3421	2707	3403	0.0	0.7954745812518366
chr2	AC009411.1	21649272	21649450	0	179	0	1365	0	1186	0.0	0.0
chr2	AC009411.1	21649272	21649337	0	66	0	1365	0	1299	0.0	0.0
chr2	AC009411.1	21649338	21649450	0	113	0	1365	0	1252	0.0	0.0
chr2	AC018467.1	23027805	23027865	0	61	0	1777	0	1716	0.0	0.0
chr2	AC009242.1	23672697	23672724	0	28	102	2820	102	2792	0.0	0.036532951289398284
chr2	ATAD2B	23786026	23786040	0	15	765	10538	765	10523	0.0	0.07269789983844911
chr2	TP53I3	24082884	24082999	0	116	1805	2318	1805	2202	0.0	0.8197093551316984
chr2	HADHA	26244524	26244528	0	5	6003	4348	6003	4343	0.0	1.3822242689385218
chr2	HADHA	26210544	26210693	0	150	6003	4348	6003	4198	0.0	1.4299666507860886
chr2	CGREF1	27118774	27118844	0	71	0	3355	0	3284	0.0	0.0
chr2	PREB	27131671	27131672	0	2	0	2369	0	2367	0.0	0.0
chr2	PREB	27132203	27132228	0	26	0	2369	0	2343	0.0	0.0
chr2	SLC5A6	27211899	27212018	0	120	0	5118	0	4998	0.0	0.0
chr2	SLC5A6	27211710	27211765	0	56	0	5118	0	5062	0.0	0.0
chr2	EIF2B4	27367073	27367168	0	96	51	2597	51	2501	0.0	0.02039184326269492
chr2	EIF2B4	27370105	27370282	0	178	51	2597	51	2419	0.0	0.02108309218685407
chr2	IFT172	27453629	27453980	1836	352	664046	12448	662210	12096	5.215909090909091	54.74619708994709
chr2	IFT172	27471232	27472248	51	1017	664046	12448	663995	11431	0.05014749262536873	58.08721896596973
chr2	CCDC121	27628389	27628394	0	6	6730	2842	6730	2836	0.0	2.3730606488011285
chr2	SUPT7L	27663328	27663513	37884	186	233087	5317	195203	5131	203.67741935483872	38.043851101149876
chr2	SUPT7L	27660983	27662177	11881	1195	233087	5317	221206	4122	9.94225941422594	53.66472586123241
chr2	AC093690.1	28309764	28309935	0	172	0	3203	0	3031	0.0	0.0
chr2	TRMT61B	28851071	28851097	0	27	0	2045	0	2018	0.0	0.0
chr2	DPY30	32039592	32039731	0	140	0	2602	0	2462	0.0	0.0
chr2	NLRC4	32240941	32241031	1173	91	30209	3799	29036	3708	12.89010989010989	7.830636461704423
chr2	SULT6B1	37191156	37191219	0	64	2	1336	2	1272	0.0	0.0015723270440251573
chr2	RMDN2-AS1	37963091	37963094	0	4	16	3034	16	3030	0.0	0.005280528052805281
chr2	RMDN2-AS1	38029808	38029853	0	46	16	3034	16	2988	0.0	0.00535475234270415
chr2	CYP1B1	38075779	38076017	0	239	102	2987	102	2748	0.0	0.03711790393013101
chr2	CYP1B1	38075775	38075778	0	4	102	2987	102	2983	0.0	0.03419376466644318
chr2	CYP1B1	38075775	38076017	0	243	102	2987	102	2744	0.0	0.03717201166180758
chr2	LINC02613	38424385	38424420	0	36	51	5399	51	5363	0.0	0.009509602834234571
chr2	AC074366.1	38669338	38669448	0	111	0	1042	0	931	0.0	0.0
chr2	SRSF7	38748046	38748054	0	9	51	3873	51	3864	0.0	0.013198757763975156
chr2	SRSF7	38748046	38748078	0	33	51	3873	51	3840	0.0	0.01328125
chr2	SRSF7	38748055	38748078	0	24	51	3873	51	3849	0.0	0.013250194855806703
chr2	SOS1-IT1	38993391	38993408	0	18	0	1256	0	1238	0.0	0.0
chr2	THUMPD2	39769709	39769756	0	48	0	3435	0	3387	0.0	0.0
chr2	THUMPD2	39771504	39771513	0	10	0	3435	0	3425	0.0	0.0
chr2	COX7A2L	42360937	42361088	0	152	2494	5464	2494	5312	0.0	0.4695030120481928
chr2	KCNG3	42492836	42492868	0	33	102	3678	102	3645	0.0	0.027983539094650206
chr2	LINC01819	43032733	43033228	102	496	1358	3848	1256	3352	0.2056451612903226	0.3747016706443914
chr2	THADA	43595646	43595929	0	284	1676	14267	1676	13983	0.0	0.11985982979332047
chr2	LRPPRC	43995773	43995797	0	25	9894	10068	9894	10043	0.0	0.9851637956785821
chr2	PREPL	44361379	44361415	0	37	153	6296	153	6259	0.0	0.02444479948873622
chr2	PREPL	44361416	44361522	0	107	153	6296	153	6189	0.0	0.024721279689772176
chr2	PREPL	44361379	44361522	0	144	153	6296	153	6152	0.0	0.02486996098829649
chr2	LINC01820	46393112	46393221	0	110	0	640	0	530	0.0	0.0
chr2	PIGF	46616586	46616968	0	383	196039	3770	196039	3387	0.0	57.87983466194272
chr2	CALM2	47176235	47176439	0	205	1950	5477	1950	5272	0.0	0.36987860394537175
chr2	CALM2	47176235	47176275	0	41	1950	5477	1950	5436	0.0	0.358719646799117
chr2	CALM2	47176276	47176439	0	164	1950	5477	1950	5313	0.0	0.36702428006775834
chr2	FBXO11	47807993	47808193	0	201	0	7806	0	7605	0.0	0.0
chr2	NRXN1	49943703	49943711	0	9	0	25608	0	25599	0.0	0.0
chr2	NRXN1	51031980	51032404	0	425	0	25608	0	25183	0.0	0.0
chr2	NRXN1	49973964	49973966	0	3	0	25608	0	25605	0.0	0.0
chr2	NRXN1	50621204	50621224	0	21	0	25608	0	25587	0.0	0.0
chr2	NRXN1	51225506	51225520	0	15	0	25608	0	25593	0.0	0.0
chr2	NRXN1	51225464	51225505	0	42	0	25608	0	25566	0.0	0.0
chr2	NRXN1	51225464	51225520	0	57	0	25608	0	25551	0.0	0.0
chr2	NRXN1	51202927	51202989	0	63	0	25608	0	25545	0.0	0.0
chr2	ASB3	53786284	53786819	0	536	109	6051	109	5515	0.0	0.019764279238440617
chr2	RTN4	55049744	55050426	0	683	57	6380	57	5697	0.0	0.010005265929436546
chr2	CLHC1	55232222	55232234	0	13	488813	6648	488813	6635	0.0	73.67189148455162
chr2	CLHC1	55223995	55224189	0	195	488813	6648	488813	6453	0.0	75.74972880830622
chr2	MTIF2	55244028	55244153	0	126	15910	3390	15910	3264	0.0	4.8743872549019605
chr2	MTIF2	55269168	55269211	0	44	15910	3390	15910	3346	0.0	4.754931261207412
chr2	MTIF2	55268816	55269167	1428	352	15910	3390	14482	3038	4.056818181818182	4.766951942067149
chr2	MTIF2	55268816	55268990	0	175	15910	3390	15910	3215	0.0	4.948678071539658
chr2	MTIF2	55268991	55269167	1428	177	15910	3390	14482	3213	8.067796610169491	4.507314036725801
chr2	MTIF2	55268577	55268815	0	239	15910	3390	15910	3151	0.0	5.049190733100603
chr2	CCDC88A	55299827	55299837	0	11	11014	27139	11014	27128	0.0	0.4060011795930404
chr2	EFEMP1	55922570	55922608	0	39	1678	3973	1678	3934	0.0	0.42653787493645146
chr2	FANCL	58198578	58198592	0	15	0	2345	0	2330	0.0	0.0
chr2	AC007179.2	59240920	59240991	0	72	0	5116	0	5044	0.0	0.0
chr2	BCL11A	60460681	60462280	0	1600	0	10714	0	9114	0.0	0.0
chr2	BCL11A	60460529	60462280	0	1752	0	10714	0	8962	0.0	0.0
chr2	BCL11A	60460529	60460680	0	152	0	10714	0	10562	0.0	0.0
chr2	PUS10	61017144	61017147	0	4	6182	7352	6182	7348	0.0	0.8413173652694611
chr2	XPO1	61534422	61534556	0	135	11664	18326	11664	18191	0.0	0.6411961959210599
chr2	XPO1	61536869	61537017	0	149	11664	18326	11664	18177	0.0	0.6416900478626836
chr2	XPO1	61536709	61536868	0	160	11664	18326	11664	18166	0.0	0.6420786083892986
chr2	XPO1	61536709	61537017	0	309	11664	18326	11664	18017	0.0	0.6473885774546262
chr2	AC114752.1	64332632	64332767	324	136	441	554	117	418	2.3823529411764706	0.2799043062200957
chr2	AC012370.2	65456018	65456303	1990	286	4810	2484	2820	2198	6.958041958041958	1.2829845313921746
chr2	AC012370.2	65450232	65450474	171	243	4810	2484	4639	2241	0.7037037037037037	2.070058009817046
chr2	AC012370.2	65455511	65455658	2794	148	4810	2484	2016	2336	18.87837837837838	0.863013698630137
chr2	C1D	68062944	68062956	0	13	0	3571	0	3558	0.0	0.0
chr2	WDR92	68157260	68157372	0	113	0	3630	0	3517	0.0	0.0
chr2	NFU1	69437270	69437359	0	90	594	1756	594	1666	0.0	0.3565426170468187
chr2	AAK1	69643742	69643790	0	49	788333	21266	788333	21217	0.0	37.15572418343781
chr2	AAK1	69643574	69643790	0	217	788333	21266	788333	21049	0.0	37.4522780179581
chr2	AAK1	69643574	69643741	0	168	788333	21266	788333	21098	0.0	37.36529528865295
chr2	PCBP1-AS1	69964230	69964367	0	138	332385	25966	332385	25828	0.0	12.869172990552888
chr2	PCBP1-AS1	70086123	70086250	0	128	332385	25966	332385	25838	0.0	12.864192274943882
chr2	PCBP1-AS1	70086123	70086220	0	98	332385	25966	332385	25868	0.0	12.849273233338488
chr2	PCBP1-AS1	69996685	69996856	180	172	332385	25966	332205	25794	1.0465116279069768	12.879157943707838
chr2	PCBP1-AS1	70083506	70083536	0	31	332385	25966	332385	25935	0.0	12.81607865818392
chr2	PCBP1-AS1	70086054	70086122	0	69	332385	25966	332385	25897	0.0	12.834884349538557
chr2	PCBP1-AS1	70086054	70086250	0	197	332385	25966	332385	25769	0.0	12.898637898249834
chr2	PCBP1-AS1	70086054	70086220	0	167	332385	25966	332385	25799	0.0	12.883638900732587
chr2	PCBP1-AS1	70085815	70086122	0	308	332385	25966	332385	25658	0.0	12.954439161275236
chr2	PCBP1-AS1	70085815	70086053	0	239	332385	25966	332385	25727	0.0	12.919695261787227
chr2	PCBP1-AS1	70085815	70086250	0	436	332385	25966	332385	25530	0.0	13.019388954171562
chr2	PCBP1-AS1	70085815	70086220	0	406	332385	25966	332385	25560	0.0	13.004107981220658
chr2	PCBP1-AS1	70086251	70086341	0	91	332385	25966	332385	25875	0.0	12.845797101449275
chr2	PCBP1-AS1	70055655	70055712	0	58	332385	25966	332385	25908	0.0	12.829434923575729
chr2	PCBP1-AS1	70087072	70087279	0	208	332385	25966	332385	25758	0.0	12.90414628464943
chr2	PCBP1-AS1	70086221	70086250	0	30	332385	25966	332385	25936	0.0	12.81558451573103
chr2	PCBP1-AS1	70088429	70088596	4848	168	332385	25966	327537	25798	28.857142857142858	12.696216760989223
chr2	PCBP1-AS1	70018976	70019136	0	161	332385	25966	332385	25805	0.0	12.880643286184847
chr2	PCBP1-AS1	70085815	70086341	0	527	332385	25966	332385	25439	0.0	13.06596171233146
chr2	PCBP1-AS1	70088409	70088428	2693	20	332385	25966	329692	25946	134.65	12.706852694056888
chr2	PCBP1-AS1	70085546	70085666	0	121	332385	25966	332385	25845	0.0	12.860708067324435
chr2	C2ORF42	70182666	70182793	0	128	3172	3521	3172	3393	0.0	0.9348659003831418
chr2	C2ORF42	70190917	70190971	0	55	3172	3521	3172	3466	0.0	0.9151759953837276
chr2	C2ORF42	70190183	70190689	459	507	3172	3521	2713	3014	0.9053254437869822	0.9001327140013271
chr2	C2ORF42	70190183	70190541	441	359	3172	3521	2731	3162	1.2284122562674096	0.8636938646426312
chr2	C2ORF42	70190183	70190501	408	319	3172	3521	2764	3202	1.2789968652037618	0.863210493441599
chr2	C2ORF42	70190690	70190971	0	282	3172	3521	3172	3239	0.0	0.979314603272615
chr2	C2ORF42	70190690	70190916	0	227	3172	3521	3172	3294	0.0	0.9629629629629629
chr2	C2ORF42	70190690	70190779	0	90	3172	3521	3172	3431	0.0	0.924511804138735
chr2	C2ORF42	70190542	70190689	18	148	3172	3521	3154	3373	0.12162162162162163	0.9350726356359325
chr2	C2ORF42	70190542	70190916	18	375	3172	3521	3154	3146	0.048	1.0025429116338207
chr2	C2ORF42	70190542	70190779	18	238	3172	3521	3154	3283	0.07563025210084033	0.9607066707279927
chr2	C2ORF42	70190502	70190689	51	188	3172	3521	3121	3333	0.2712765957446808	0.9363936393639364
chr2	C2ORF42	70190502	70190541	33	40	3172	3521	3139	3481	0.825	0.9017523700086182
chr2	TIA1	70216752	70216884	0	133	4038	6250	4038	6117	0.0	0.6601275134870034
chr2	SNRPG	70292674	70293151	73	478	1223	1396	1150	918	0.15271966527196654	1.252723311546841
chr2	FAM136A	70301603	70301923	0	321	1224	3023	1224	2702	0.0	0.4529977794226499
chr2	FAM136A	70301603	70301668	0	66	1224	3023	1224	2957	0.0	0.41393304024349004
chr2	FAM136A	70301669	70301923	0	255	1224	3023	1224	2768	0.0	0.4421965317919075
chr2	MCEE	71124205	71124366	0	162	1027	1469	1027	1307	0.0	0.7857689364957919
chr2	MCEE	71129716	71130178	1027	463	1027	1469	0	1006	2.2181425485961124	0.0
chr2	SFXN5	73001524	73001527	0	4	4851	11003	4851	10999	0.0	0.44104009455405035
chr2	FBXO41	73284153	73284158	0	6	4684	8074	4684	8068	0.0	0.5805651958353991
chr2	TPRKB	73734428	73734526	0	99	2448	2011	2448	1912	0.0	1.2803347280334727
chr2	DGUOK-AS1	73981108	73981133	0	26	4931	1162	4931	1136	0.0	4.340669014084507
chr2	DCTN1	74380004	74380099	26885	96	173698	9854	146813	9758	280.0520833333333	15.045398647263784
chr2	DCTN1	74391482	74391792	1071	311	173698	9854	172627	9543	3.4437299035369775	18.089384889447764
chr2	MOGS	74463189	74463378	0	190	1581	3170	1581	2980	0.0	0.5305369127516778
chr2	MOGS	74464895	74465312	0	418	1581	3170	1581	2752	0.0	0.5744912790697675
chr2	MOGS	74464495	74464664	0	170	1581	3170	1581	3000	0.0	0.527
chr2	MOGS	74465081	74465312	0	232	1581	3170	1581	2938	0.0	0.5381211708645337
chr2	LBX2	74502666	74502834	0	169	459	2054	459	1885	0.0	0.24350132625994694
chr2	DQX1	74526135	74526138	0	4	1278	2764	1278	2760	0.0	0.46304347826086956
chr2	GCFC2	75702198	75702311	0	114	51	5480	51	5366	0.0	0.009504286246738726
chr2	GCFC2	75710443	75710589	0	147	51	5480	51	5333	0.0	0.009563097693605851
chr2	REG1B	79085405	79085490	0	86	0	2089	0	2003	0.0	0.0
chr2	LRRTM1	80304151	80304284	0	134	66	4963	66	4829	0.0	0.01366742596810934
chr2	LRRTM1	80304147	80304150	0	4	66	4963	66	4959	0.0	0.013309134906231096
chr2	LINC01815	81466573	81467026	0	454	0	1379	0	925	0.0	0.0
chr2	RETSAT	85345512	85345973	51	462	102	4060	51	3598	0.11038961038961038	0.014174541411895497
chr2	CAPG	85399135	85399179	0	45	9	2163	9	2118	0.0	0.00424929178470255
chr2	GGCX	85558439	85558537	0	99	1439744	6215	1439744	6116	0.0	235.4061478090255
chr2	GGCX	85558916	85558944	0	29	1439744	6215	1439744	6186	0.0	232.74232137083737
chr2	TMEM150A	85601305	85601433	0	129	5604	2915	5604	2786	0.0	2.0114860014357503
chr2	C2ORF68	85611667	85611742	0	76	23924	4700	23924	4624	0.0	5.173875432525952
chr2	ST3GAL5	85888227	85888275	0	49	136363	15937	136363	15888	0.0	8.582766868076536
chr2	ST3GAL5	85902388	85902464	0	77	136363	15937	136363	15860	0.0	8.597919293820933
chr2	POLR1A	86031329	86031511	0	183	10177	13555	10177	13372	0.0	0.7610679030810649
chr2	REEP1	86239921	86240019	0	99	61762	5860	61762	5761	0.0	10.720708210380142
chr2	PLGLB1	87017505	87017551	0	47	26690	2964	26690	2917	0.0	9.149811450119985
chr2	ZNF514	95158859	95159238	0	380	0	9390	0	9010	0.0	0.0
chr2	LINC00342	95813315	95814048	84406	734	277274	7663	192868	6929	114.99455040871935	27.834896810506567
chr2	GPAT2	96034816	96034851	0	36	3442	5194	3442	5158	0.0	0.6673129119813881
chr2	STARD7	96208144	96208537	0	394	9118	4283	9118	3889	0.0	2.3445615839547442
chr2	ANKRD23	96840786	96840825	0	40	507	3843	507	3803	0.0	0.1333158033131738
chr2	AC092683.1	97423788	97423796	0	9	61622	5579	61622	5570	0.0	11.063195691202873
chr2	AC092683.1	97423788	97423800	0	13	61622	5579	61622	5566	0.0	11.071146245059289
chr2	AC092683.1	97423797	97423800	0	4	61622	5579	61622	5575	0.0	11.053273542600897
chr2	AC092683.1	97425877	97426841	2407	965	61622	5579	59215	4614	2.494300518134715	12.833766796705678
chr2	AC092683.1	97422954	97423034	0	81	61622	5579	61622	5498	0.0	11.208075663877773
chr2	TSGA10	99141067	99141081	0	15	5321	5121	5321	5106	0.0	1.0421073247160204
chr2	TSGA10	99154692	99154835	0	144	5321	5121	5321	4977	0.0	1.069117942535664
chr2	MITD1	99180706	99180829	0	124	24944	2343	24944	2219	0.0	11.241099594411898
chr2	TXNDC9	99332983	99333020	0	38	834	2824	834	2786	0.0	0.29935391241923903
chr2	AFF3	100105194	100105333	0	140	17943	15102	17943	14962	0.0	1.1992380697767677
chr2	AFF3	100105671	100105778	0	108	17943	15102	17943	14994	0.0	1.1966786714685875
chr2	AFF3	100105671	100105715	0	45	17943	15102	17943	15057	0.0	1.1916716477385934
chr2	AFF3	100105779	100106038	0	260	17943	15102	17943	14842	0.0	1.2089341059156449
chr2	AFF3	100105716	100106038	0	323	17943	15102	17943	14779	0.0	1.2140875566682454
chr2	AFF3	100105716	100105778	0	63	17943	15102	17943	15039	0.0	1.1930979453421104
chr2	CHST10	100416847	100416987	0	141	0	4387	0	4246	0.0	0.0
chr2	CHST10	100416722	100416846	0	125	0	4387	0	4262	0.0	0.0
chr2	CHST10	100416722	100416987	0	266	0	4387	0	4121	0.0	0.0
chr2	TBC1D8	101090208	101090252	0	45	27861	6443	27861	6398	0.0	4.35464207564864
chr2	RFX8	101421699	101421722	0	24	0	3282	0	3258	0.0	0.0
chr2	MFSD9	102736529	102736644	0	116	64	2075	64	1959	0.0	0.03266972945380296
chr2	FHL2	105398841	105398968	0	128	0	6508	0	6380	0.0	0.0
chr2	FHL2	105389875	105390105	0	231	0	6508	0	6277	0.0	0.0
chr2	AC010978.1	105856961	105857131	0	171	102	1458	102	1287	0.0	0.07925407925407925
chr2	UXS1	106138174	106138488	0	315	255	6685	255	6370	0.0	0.040031397174254316
chr2	RGPD4-AS1	107826552	107826679	0	128	0	2376	0	2248	0.0	0.0
chr2	RGPD4-AS1	107826552	107826639	0	88	0	2376	0	2288	0.0	0.0
chr2	RGPD4-AS1	107826640	107826679	0	40	0	2376	0	2336	0.0	0.0
chr2	GCC2-AS1	108533828	108533931	0	104	68	698	68	594	0.0	0.11447811447811448
chr2	SEPTIN10	109545384	109545458	0	75	0	3956	0	3881	0.0	0.0
chr2	SEPTIN10	109593046	109593049	0	4	0	3956	0	3952	0.0	0.0
chr2	SEPTIN10	109613111	109613419	0	309	0	3956	0	3647	0.0	0.0
chr2	NPHP1	110164519	110164686	0	168	0	12937	0	12769	0.0	0.0
chr2	NPHP1	110164235	110164518	0	284	0	12937	0	12653	0.0	0.0
chr2	NPHP1	110164235	110164686	0	452	0	12937	0	12485	0.0	0.0
chr2	NPHP1	110125188	110125217	0	30	0	12937	0	12907	0.0	0.0
chr2	AC112229.1	110433435	110434563	0	1129	73	2891	73	1762	0.0	0.041430192962542564
chr2	BUB1	110676532	110676575	0	44	9267	6333	9267	6289	0.0	1.473525202734934
chr2	MIR4435-2HG	111365560	111367485	428	1926	30363	26838	29935	24912	0.2222222222222222	1.2016297366730893
chr2	MIR4435-2HG	111207719	111208486	0	768	30363	26838	30363	26070	0.0	1.1646720368239356
chr2	MIR4435-2HG	111469602	111469785	0	184	30363	26838	30363	26654	0.0	1.1391535979590306
chr2	AC017002.3	111611870	111611961	0	92	36	1314	36	1222	0.0	0.029459901800327332
chr2	RGPD8	112433381	112433620	0	240	51	8209	51	7969	0.0	0.006399799221985193
chr2	IL1B	112836679	112836706	0	28	2160	2980	2160	2952	0.0	0.7317073170731707
chr2	IL1B	112836470	112836678	663	209	2160	2980	1497	2771	3.172248803827751	0.5402381811620354
chr2	PAX8	113227098	113227153	0	56	4468	6861	4468	6805	0.0	0.6565760470242469
chr2	RPL23AP7	113626829	113627036	0	208	9139	2131	9139	1923	0.0	4.752470098803952
chr2	SLC35F5	113755854	113756368	0	515	3832	4957	3832	4442	0.0	0.8626744709590275
chr2	THORLNC	118186230	118186353	0	124	0	2777	0	2653	0.0	0.0
chr2	C2ORF76	119366356	119366434	0	79	0	1563	0	1484	0.0	0.0
chr2	ERCC3	127293856	127294052	0	197	0	6406	0	6209	0.0	0.0
chr2	ERCC3	127293794	127294052	0	259	0	6406	0	6147	0.0	0.0
chr2	ERCC3	127293794	127293855	0	62	0	6406	0	6344	0.0	0.0
chr2	ERCC3	127291911	127292608	0	698	0	6406	0	5708	0.0	0.0
chr2	ERCC3	127291911	127292082	0	172	0	6406	0	6234	0.0	0.0
chr2	ERCC3	127292083	127292608	0	526	0	6406	0	5880	0.0	0.0
chr2	IWS1	127526174	127526409	0	236	262	4167	262	3931	0.0	0.06664970745357415
chr2	IWS1	127526174	127526381	0	208	262	4167	262	3959	0.0	0.06617832786057085
chr2	IWS1	127526382	127526409	0	28	262	4167	262	4139	0.0	0.0633003140855279
chr2	LIMS2	127641988	127642047	0	60	153	7746	153	7686	0.0	0.01990632318501171
chr2	SAP130	128027091	128027256	102	166	73016	4395	72914	4229	0.6144578313253012	17.24142823362497
chr2	LINC02572	129877333	129877446	0	114	51	4097	51	3983	0.0	0.012804418779814211
chr2	CCDC74B	130144620	130144745	0	126	0	3013	0	2887	0.0	0.0
chr2	SMPD4	130154276	130154353	0	78	40	7065	40	6987	0.0	0.005724917704308
chr2	SMPD4	130156034	130156051	0	18	40	7065	40	7047	0.0	0.005676174258549737
chr2	SMPD4	130181295	130181528	0	234	40	7065	40	6831	0.0	0.005855658029571073
chr2	CCDC115	130342014	130342132	0	119	0	2582	0	2463	0.0	0.0
chr2	FAM168B	131093213	131093330	0	118	220370	5324	220370	5206	0.0	42.330003841721094
chr2	NF1P8	131197872	131197933	0	62	0	1606	0	1544	0.0	0.0
chr2	LYPD1	132669846	132669879	0	34	44	3984	44	3950	0.0	0.011139240506329114
chr2	MAP3K19	134983675	134983706	0	32	0	6971	0	6939	0.0	0.0
chr2	ZRANB3	135227811	135227816	0	6	33856	9098	33856	9092	0.0	3.7237131544214694
chr2	ZRANB3	135530497	135530524	0	28	33856	9098	33856	9070	0.0	3.7327453142227123
chr2	DARS1	135985793	135985811	0	19	15021	4752	15021	4733	0.0	3.17367420240862
chr2	ZEB2	144430537	144430743	0	207	37	21461	37	21254	0.0	0.001740848781405853
chr2	ZEB2	144519938	144520350	0	413	37	21461	37	21048	0.0	0.0017578867350817179
chr2	ZEB2	144517611	144517657	0	47	37	21461	37	21414	0.0	0.0017278415989539554
chr2	ZEB2	144517611	144517685	0	75	37	21461	37	21386	0.0	0.0017301038062283738
chr2	ZEB2	144517611	144517744	0	134	37	21461	37	21327	0.0	0.0017348900454822525
chr2	ZEB2	144517658	144517685	0	28	37	21461	37	21433	0.0	0.001726309895954836
chr2	ZEB2	144517686	144517744	0	59	37	21461	37	21402	0.0	0.0017288103915521914
chr2	ZEB2	144517658	144517744	0	87	37	21461	37	21374	0.0	0.001731075138018153
chr2	ORC4	148020607	148020631	0	25	0	8740	0	8715	0.0	0.0
chr2	RND3	150487548	150487633	0	86	0	3603	0	3517	0.0	0.0
chr2	ARL5A	151828130	151828387	0	258	204	6732	204	6474	0.0	0.03151065801668211
chr2	CACNB4	151869176	151870529	0	1354	255	14196	255	12842	0.0	0.019856720137050303
chr2	PRPF40A	152717229	152717354	0	126	99651	9227	99651	9101	0.0	10.949456103724865
chr2	LINC01876	156024469	156024483	0	15	0	2723	0	2708	0.0	0.0
chr2	LINC01876	156024469	156024495	0	27	0	2723	0	2696	0.0	0.0
chr2	LINC01876	156024465	156024468	0	4	0	2723	0	2719	0.0	0.0
chr2	LINC01876	156024465	156024483	0	19	0	2723	0	2704	0.0	0.0
chr2	LINC01876	156024465	156024495	0	31	0	2723	0	2692	0.0	0.0
chr2	LINC01876	156024484	156024495	0	12	0	2723	0	2711	0.0	0.0
chr2	NR4A2	156329322	156329912	0	591	153	3973	153	3382	0.0	0.0452395032525133
chr2	ERMN	157324117	157324145	0	29	3309	4361	3309	4332	0.0	0.7638504155124654
chr2	WDSUB1	159286359	159286581	0	223	51	1977	51	1754	0.0	0.029076396807297605
chr2	WDSUB1	159286359	159286426	0	68	51	1977	51	1909	0.0	0.02671555788370875
chr2	BAZ2B	159337461	159337565	0	105	22229	18526	22229	18421	0.0	1.206720590630259
chr2	ITGB6	160196215	160196387	0	173	2040	3902	2040	3729	0.0	0.5470635559131134
chr2	RBMS1	160286968	160286976	0	9	5415	9745	5415	9736	0.0	0.5561832374691865
chr2	AC009299.2	161250866	161250994	0	129	0	2835	0	2706	0.0	0.0
chr2	DPP4	162073839	162073974	0	136	25698	14461	25698	14325	0.0	1.7939267015706806
chr2	DPP4	162038944	162038947	0	4	25698	14461	25698	14457	0.0	1.7775472089645155
chr2	FAP	162173054	162173147	11938	94	27385	6864	15447	6770	127.0	2.2816838995568687
chr2	GRB14	164621118	164621233	0	116	0	3003	0	2887	0.0	0.0
chr2	COBLL1	164841709	164841737	0	29	40	17102	40	17073	0.0	0.0023428805716628593
chr2	SCN3A	165140650	165140700	0	51	102	11548	102	11497	0.0	0.008871879620770635
chr2	SCN3A	165140650	165140783	0	134	102	11548	102	11414	0.0	0.008936393902225337
chr2	SCN3A	165140650	165140796	0	147	102	11548	102	11401	0.0	0.008946583633014649
chr2	SCN3A	165140650	165140787	0	138	102	11548	102	11410	0.0	0.008939526730937774
chr2	SCN3A	165122793	165122814	0	22	102	11548	102	11526	0.0	0.008849557522123894
chr2	SCN3A	165140701	165140783	0	83	102	11548	102	11465	0.0	0.008896641953772351
chr2	SCN3A	165140701	165140796	0	96	102	11548	102	11452	0.0	0.00890674118057981
chr2	SCN3A	165140701	165140787	0	87	102	11548	102	11461	0.0	0.00889974696797836
chr2	SCN3A	165140784	165140796	0	13	102	11548	102	11535	0.0	0.008842652795838752
chr2	SCN3A	165140784	165140787	0	4	102	11548	102	11544	0.0	0.008835758835758836
chr2	SCN3A	165140788	165140796	0	9	102	11548	102	11539	0.0	0.008839587485917323
chr2	GALNT3	165761842	165761903	0	62	102	4440	102	4378	0.0	0.023298309730470534
chr2	SCN1A	166043668	166043700	0	33	305	18837	305	18804	0.0	0.0162199532014465
chr2	SCN1A	166043668	166043834	0	167	305	18837	305	18670	0.0	0.016336368505623994
chr2	SCN1A	166043668	166043751	0	84	305	18837	305	18753	0.0	0.01626406441636005
chr2	SCN1A	166043701	166043834	0	134	305	18837	305	18703	0.0	0.016307544244238893
chr2	SCN1A	166043701	166043751	0	51	305	18837	305	18786	0.0	0.016235494517193656
chr2	SCN1A	166041214	166041229	0	16	305	18837	305	18821	0.0	0.0162053025875352
chr2	SCN1A	166043752	166043834	0	83	305	18837	305	18754	0.0	0.01626319718460062
chr2	SCN9A	166284452	166284484	0	33	150	13972	150	13939	0.0	0.010761173685343281
chr2	SCN9A	166375696	166375702	0	7	150	13972	150	13965	0.0	0.010741138560687433
chr2	FASTKD1	169572995	169573667	0	673	0	5035	0	4362	0.0	0.0
chr2	METTL5	169824781	169824866	0	86	0	2425	0	2339	0.0	0.0
chr2	MYO3B-AS1	170343458	170343493	0	36	24637	5707	24637	5671	0.0	4.344383706577323
chr2	MYO3B-AS1	170340166	170340386	1230	221	24637	5707	23407	5486	5.5656108597285066	4.266678818811521
chr2	MYO3B-AS1	170341188	170341384	102	197	24637	5707	24535	5510	0.5177664974619289	4.452813067150635
chr2	MYO3B-AS1	170341329	170341384	0	56	24637	5707	24637	5651	0.0	4.359759334631039
chr2	MYO3B-AS1	170350735	170350877	1951	143	24637	5707	22686	5564	13.643356643356643	4.077282530553559
chr2	MYO3B-AS1	170350317	170350460	2396	144	24637	5707	22241	5563	16.63888888888889	3.9980226496494695
chr2	AC007405.1	170770693	170770700	8	8	1236	6575	1228	6567	1.0	0.1869955839805086
chr2	METTL8	171331764	171331802	0	39	51	9953	51	9914	0.0	0.005144240468025015
chr2	RAPGEF4-AS1	172678877	172678885	0	9	14288	5214	14288	5205	0.0	2.7450528338136406
chr2	CHN1	175004893	175005204	0	312	470752	9117	470752	8805	0.0	53.464168086314594
chr2	CHN1	174846308	174846313	0	6	470752	9117	470752	9111	0.0	51.66853254307979
chr2	LNPK	175995552	175995556	0	5	78533	9098	78533	9093	0.0	8.636643571978444
chr2	HAGLR	176177710	176178013	0	304	25	4973	25	4669	0.0	0.005354465624330691
chr2	HAGLR	176177710	176178001	0	292	25	4973	25	4681	0.0	0.005340739158299509
chr2	HAGLR	176178002	176178013	0	12	25	4973	25	4961	0.0	0.005039306591413021
chr2	LINC01116	176637136	176637460	0	325	306	2130	306	1805	0.0	0.16952908587257617
chr2	AC073636.1	176831230	176831394	0	165	385	3276	385	3111	0.0	0.12375441980070717
chr2	AC073636.1	176844832	176846208	51	1377	385	3276	334	1899	0.037037037037037035	0.17588204318062137
chr2	AC073636.1	176849250	176849273	0	24	385	3276	385	3252	0.0	0.11838868388683887
chr2	AC073636.1	176848574	176848818	0	245	385	3276	385	3031	0.0	0.12702078521939955
chr2	NFE2L2	177263402	177263435	0	34	0	4691	0	4657	0.0	0.0
chr2	NFE2L2	177263402	177263527	0	126	0	4691	0	4565	0.0	0.0
chr2	NFE2L2	177263436	177263527	0	92	0	4691	0	4599	0.0	0.0
chr2	AC019080.1	177287484	177287609	0	126	0	3664	0	3538	0.0	0.0
chr2	AC019080.1	177314795	177314915	0	121	0	3664	0	3543	0.0	0.0
chr2	PRKRA	178443266	178443288	0	23	102	10172	102	10149	0.0	0.010050251256281407
chr2	PRKRA	178447504	178447514	0	11	102	10172	102	10161	0.0	0.010038382049010924
chr2	PRKRA	178450241	178450364	0	124	102	10172	102	10048	0.0	0.010151273885350318
chr2	PRKRA	178447455	178447503	0	49	102	10172	102	10123	0.0	0.010076064407784253
chr2	PRKRA	178447455	178447514	0	60	102	10172	102	10112	0.0	0.010087025316455696
chr2	PRKRA	178450241	178450964	0	724	102	10172	102	9448	0.0	0.010795935647756138
chr2	SESTD1	179116573	179116666	0	94	459	11426	459	11332	0.0	0.040504765266501944
chr2	SESTD1	179263976	179264116	0	141	459	11426	459	11285	0.0	0.040673460345591494
chr2	CWC22	180006866	180007068	0	203	3607	3341	3607	3138	0.0	1.1494582536647546
chr2	CERKL	181656768	181656978	0	211	0	4691	0	4480	0.0	0.0
chr2	PDE1A	182523028	182523101	0	74	176	6343	176	6269	0.0	0.02807465305471367
chr2	ZSWIM2	186848694	186848964	0	271	510	2498	510	2227	0.0	0.22900763358778625
chr2	SLC40A1	189581707	189581900	0	194	150	4036	150	3842	0.0	0.039042165538781884
chr2	OSGEPL1	189762566	189762683	0	118	0	3437	0	3319	0.0	0.0
chr2	OSGEPL1	189762531	189762683	0	153	0	3437	0	3284	0.0	0.0
chr2	OSGEPL1	189762531	189762565	0	35	0	3437	0	3402	0.0	0.0
chr2	HIBCH	190250259	190250373	0	115	372	6477	372	6362	0.0	0.0584721785602012
chr2	NEMP2	190534011	190534107	138	97	599	6535	461	6438	1.422680412371134	0.07160608884746816
chr2	AC006460.2	190627877	190628067	714	191	90592	7821	89878	7630	3.738219895287958	11.779554390563565
chr2	STAT1	191014017	191014077	0	61	975	9766	975	9705	0.0	0.10046367851622875
chr2	AC013401.1	192645267	192645303	0	37	0	591	0	554	0.0	0.0
chr2	GTF3C3	196799454	196799508	0	55	0	7152	0	7097	0.0	0.0
chr2	GTF3C3	196799239	196799508	0	270	0	7152	0	6882	0.0	0.0
chr2	GTF3C3	196799239	196799453	0	215	0	7152	0	6937	0.0	0.0
chr2	SF3B1	197423807	197423892	0	86	561	10241	561	10155	0.0	0.05524372230428361
chr2	SF3B1	197418895	197420426	59	1532	561	10241	502	8709	0.038511749347258484	0.05764152026639109
chr2	HSPD1	197494656	197494661	0	6	102	6724	102	6718	0.0	0.01518309020541828
chr2	HSPD1	197498674	197498720	0	47	102	6724	102	6677	0.0	0.015276321701362887
chr2	HSPD1	197499553	197499604	0	52	102	6724	102	6672	0.0	0.015287769784172662
chr2	HSPD1	197499166	197499257	0	92	102	6724	102	6632	0.0	0.015379975874547648
chr2	HSPD1	197499141	197499165	0	25	102	6724	102	6699	0.0	0.01522615315718764
chr2	HSPD1	197499141	197499257	0	117	102	6724	102	6607	0.0	0.015438171636143484
chr2	HSPD1	197499998	197500158	0	161	102	6724	102	6563	0.0	0.015541673015389303
chr2	SATB2	199464835	199464919	0	85	0	10975	0	10890	0.0	0.0
chr2	FTCDNL1	199850739	199850757	0	19	0	2766	0	2747	0.0	0.0
chr2	AC097717.1	199910801	199911023	0	223	102	6765	102	6542	0.0	0.0155915622133904
chr2	AC097717.1	199910801	199911041	0	241	102	6765	102	6524	0.0	0.015634580012262415
chr2	AC097717.1	199910801	199911018	0	218	102	6765	102	6547	0.0	0.015579654803726898
chr2	AC097717.1	199894442	199894581	0	140	102	6765	102	6625	0.0	0.01539622641509434
chr2	AC097717.1	199911024	199911041	0	18	102	6765	102	6747	0.0	0.01511783014673188
chr2	AC097717.1	199908862	199908895	0	34	102	6765	102	6731	0.0	0.015153766156588916
chr2	AC097717.1	199910762	199910800	0	39	102	6765	102	6726	0.0	0.015165031222123104
chr2	AC097717.1	199910762	199911023	0	262	102	6765	102	6503	0.0	0.015685068429955405
chr2	AC097717.1	199910762	199911041	0	280	102	6765	102	6485	0.0	0.015728604471858133
chr2	AC097717.1	199910762	199911018	0	257	102	6765	102	6508	0.0	0.01567301782421635
chr2	AC097717.1	199911019	199911023	0	5	102	6765	102	6760	0.0	0.015088757396449704
chr2	AC097717.1	199911019	199911041	0	23	102	6765	102	6742	0.0	0.015129041827350934
chr2	TYW5	199948317	199948335	0	19	0	9858	0	9839	0.0	0.0
chr2	KCTD18	200504747	200504768	0	22	0	4917	0	4895	0.0	0.0
chr2	KCTD18	200509627	200510009	0	383	0	4917	0	4534	0.0	0.0
chr2	PPIL3	200888955	200889242	0	288	0	2472	0	2184	0.0	0.0
chr2	PPIL3	200888948	200888954	0	7	0	2472	0	2465	0.0	0.0
chr2	ORC2	200963048	200963217	0	170	0	5850	0	5680	0.0	0.0
chr2	CFLAR-AS1	201148715	201148732	0	18	102	4158	102	4140	0.0	0.02463768115942029
chr2	CFLAR-AS1	201148715	201149123	0	409	102	4158	102	3749	0.0	0.027207255268071485
chr2	CFLAR-AS1	201148733	201149123	0	391	102	4158	102	3767	0.0	0.027077249800902575
chr2	CFLAR-AS1	201145573	201145638	0	66	102	4158	102	4092	0.0	0.024926686217008796
chr2	CFLAR-AS1	201152821	201153309	102	489	102	4158	0	3669	0.2085889570552147	0.0
chr2	FLACC1	201356981	201357312	4029	332	9140	2497	5111	2165	12.135542168674698	2.360739030023095
chr2	ICA1L	202871160	202871189	0	30	209	10225	209	10195	0.0	0.02050024521824424
chr2	ICA1L	202870929	202871189	0	261	209	10225	209	9964	0.0	0.02097551184263348
chr2	NDUFS1	206149779	206149816	0	38	153	12182	153	12144	0.0	0.012598814229249012
chr2	NDUFS1	206159083	206159094	0	12	153	12182	153	12170	0.0	0.01257189811010682
chr2	MDH1B	206756897	206756910	0	14	0	2903	0	2889	0.0	0.0
chr2	KLF7	207123773	207123974	0	202	102	9124	102	8922	0.0	0.011432414256893073
chr2	KLF7	207123773	207124342	0	570	102	9124	102	8554	0.0	0.011924245966799158
chr2	KLF7	207123975	207124342	0	368	102	9124	102	8756	0.0	0.011649154865235267
chr2	METTL21A	207625061	207625263	0	203	1324	4067	1324	3864	0.0	0.34265010351966874
chr2	C2ORF80	208189873	208189951	0	79	0	1402	0	1323	0.0	0.0
chr2	LANCL1	210476708	210476720	0	13	77	5060	77	5047	0.0	0.015256588072122053
chr2	LANCL1	210476619	210476707	0	89	77	5060	77	4971	0.0	0.015489841078253873
chr2	LANCL1	210476619	210476645	0	27	77	5060	77	5033	0.0	0.015299026425591099
chr2	LANCL1	210476619	210476720	0	102	77	5060	77	4958	0.0	0.015530455828963292
chr2	IKZF2	213150143	213150179	0	37	0	12218	0	12181	0.0	0.0
chr2	IKZF2	213056832	213056909	0	78	0	12218	0	12140	0.0	0.0
chr2	BARD1	214780559	214780966	0	408	0	7585	0	7177	0.0	0.0
chr2	LINC00607	215624111	215624141	0	31	4518	6966	4518	6935	0.0	0.6514780100937275
chr2	DIRC3	217433756	217433946	0	191	4903	8277	4903	8086	0.0	0.6063566658421964
chr2	AAMP	218266054	218266062	0	9	60	2719	60	2710	0.0	0.02214022140221402
chr2	USP37	218562672	218562716	0	45	254	9311	254	9266	0.0	0.027412044031944745
chr2	RNF25	218668238	218668277	0	40	1750	1825	1750	1785	0.0	0.9803921568627451
chr2	PRKAG3	218830745	218830756	0	12	102	3347	102	3335	0.0	0.030584707646176913
chr2	CFAP65	219041422	219041486	0	65	145	10236	145	10171	0.0	0.014256218660898634
chr2	SLC23A3	219169520	219169556	0	37	844	3310	844	3273	0.0	0.25786739993889396
chr2	NHEJ1	219078073	219078087	0	15	36511	3122	36511	3107	0.0	11.751206952043772
chr2	SLC23A3	219169284	219169307	0	24	844	3310	844	3286	0.0	0.25684723067559345
chr2	SLC23A3	219168647	219168650	0	4	844	3310	844	3306	0.0	0.25529340592861466
chr2	SLC23A3	219169822	219169993	0	172	844	3310	844	3138	0.0	0.26896112173358827
chr2	ATG9A	219223868	219223926	8	59	210	4730	202	4671	0.13559322033898305	0.04324555769642475
chr2	ATG9A	219228423	219228432	0	10	210	4730	210	4720	0.0	0.04449152542372881
chr2	PTPRN	219309217	219309427	102	211	825	6977	723	6766	0.4834123222748815	0.10685781850428613
chr2	PTPRN	219308881	219308976	0	96	825	6977	825	6881	0.0	0.11989536404592356
chr2	DNPEP	219387575	219387757	51	183	3475	5992	3424	5809	0.2786885245901639	0.589430194525736
chr2	DNPEP	219399865	219399938	0	74	3475	5992	3475	5918	0.0	0.5871916187901318
chr2	OBSL1	219556453	219556576	0	124	231043	9151	231043	9027	0.0	25.594660463055277
chr2	OBSL1	219570220	219571392	0	1173	231043	9151	231043	7978	0.0	28.96001504136375
chr2	EPHA4	221426434	221426462	0	29	102	7576	102	7547	0.0	0.013515304094342123
chr2	EPHA4	221573849	221573959	0	111	102	7576	102	7465	0.0	0.013663764233087742
chr2	AP1S3	223777688	223777689	0	2	7778	5957	7778	5955	0.0	1.306129303106633
chr2	CUL3	224562699	224563192	0	494	11944	10494	11944	10000	0.0	1.1944
chr2	MFF-DT	227265838	227265873	0	36	0	11480	0	11444	0.0	0.0
chr2	C2ORF83	227642083	227642221	0	139	1482	3494	1482	3355	0.0	0.44172876304023845
chr2	SLC19A3	227695518	227695887	255	370	46205	5687	45950	5317	0.6891891891891891	8.64209140492759
chr2	SLC19A3	227706314	227706551	0	238	46205	5687	46205	5449	0.0	8.479537529821986
chr2	TRIP12	229807704	229807706	0	3	204	12692	204	12689	0.0	0.016076917014737173
chr2	AC010149.1	230579900	230579903	0	4	0	700	0	696	0.0	0.0
chr2	SPATA3-AS1	230995727	230995846	0	120	306	3752	306	3632	0.0	0.0842511013215859
chr2	NCL	231463700	231464141	0	442	0	6296	0	5854	0.0	0.0
chr2	NCL	231463700	231464158	0	459	0	6296	0	5837	0.0	0.0
chr2	NCL	231464142	231464158	0	17	0	6296	0	6279	0.0	0.0
chr2	LINC00471	231514081	231514095	0	15	0	1301	0	1286	0.0	0.0
chr2	ECEL1	232482850	232482855	0	6	1958	2995	1958	2989	0.0	0.6550685848109735
chr2	KCNJ13	232770902	232771137	0	236	0	1125	0	889	0.0	0.0
chr2	AC114812.1	233755006	233755142	0	137	1581	1042	1581	905	0.0	1.7469613259668508
chr2	AC012063.1	236952620	236953903	0	1284	2056	13105	2056	11821	0.0	0.173927755689028
chr2	RAB17	237585997	237586040	0	44	51	4078	51	4034	0.0	0.01264253842340109
chr2	RAB17	237585997	237586062	0	66	51	4078	51	4012	0.0	0.012711864406779662
chr2	RAB17	237586041	237586062	0	22	51	4078	51	4056	0.0	0.01257396449704142
chr2	ILKAP	238189852	238189861	0	10	2407	4683	2407	4673	0.0	0.515086668093302
chr2	ILKAP	238189852	238189857	0	6	2407	4683	2407	4677	0.0	0.5146461406884755
chr2	ILKAP	238189858	238189861	0	4	2407	4683	2407	4679	0.0	0.5144261594357769
chr2	LINC02610	238231200	238231332	0	133	0	3731	0	3598	0.0	0.0
chr2	HES6	238239486	238239525	0	40	2652	1138	2652	1098	0.0	2.4153005464480874
chr2	HES6	238239660	238239823	0	164	2652	1138	2652	974	0.0	2.722792607802875
chr2	HDAC4	239102775	239102789	672	15	78815	13056	78143	13041	44.8	5.992101832681543
chr2	NDUFA10	240018552	240018553	0	2	58376	18589	58376	18587	0.0	3.14068972938075
chr2	NDUFA10	240025226	240025228	0	3	58376	18589	58376	18586	0.0	3.1408587108576347
chr2	NDUFA10	240014738	240014839	0	102	58376	18589	58376	18487	0.0	3.157678368583329
chr2	NDUFA10	240014738	240014767	0	30	58376	18589	58376	18559	0.0	3.145428094186109
chr2	NDUFA10	239960954	239961021	0	68	58376	18589	58376	18521	0.0	3.1518816478591867
chr2	NDUFA10	240021086	240021195	0	110	58376	18589	58376	18479	0.0	3.1590454028897668
chr2	NDUFA10	240025226	240025246	0	21	58376	18589	58376	18568	0.0	3.1439034898750537
chr2	NDUFA10	240012331	240014737	3155	2407	58376	18589	55221	16182	1.3107602825093478	3.4124953652206154
chr2	NDUFA10	240012331	240014839	3155	2509	58376	18589	55221	16080	1.2574730968513352	3.4341417910447762
chr2	NDUFA10	240012331	240014693	3155	2363	58376	18589	55221	16226	1.3351671603893356	3.4032417108344633
chr2	NDUFA10	240012331	240012485	1459	155	58376	18589	56917	18434	9.412903225806451	3.0876098513616146
chr2	NDUFA10	240012331	240014767	3155	2437	58376	18589	55221	16152	1.2946245383668444	3.4188335809806834
chr2	NDUFA10	240014694	240014737	0	44	58376	18589	58376	18545	0.0	3.147802642221623
chr2	NDUFA10	240014694	240014839	0	146	58376	18589	58376	18443	0.0	3.165211733449005
chr2	NDUFA10	240014694	240014767	0	74	58376	18589	58376	18515	0.0	3.1529030515798
chr2	NDUFA10	240014768	240014839	0	72	58376	18589	58376	18517	0.0	3.15256251012583
chr2	NDUFA10	240018523	240018551	0	29	58376	18589	58376	18560	0.0	3.1452586206896553
chr2	COPS9	240136191	240136220	0	30	95	2013	95	1983	0.0	0.04790721129601614
chr2	ANKMY1	240560730	240561034	0	305	0	7366	0	7061	0.0	0.0
chr2	AQP12B	240677598	240678921	0	1324	0	1584	0	260	0.0	0.0
chr2	MAB21L4	240891872	240891928	6	57	2395	2563	2389	2506	0.10526315789473684	0.9533120510774142
chr2	MTERF4	241095129	241096391	0	1263	53932	9722	53932	8459	0.0	6.37569452653978
chr2	MTERF4	241090277	241090301	0	25	53932	9722	53932	9697	0.0	5.561720119624626
chr2	PASK	241115021	241115041	0	21	0	10561	0	10540	0.0	0.0
chr2	HDLBP	241262710	241262867	0	158	0	11245	0	11087	0.0	0.0
chr2	HDLBP	241267577	241267590	0	14	0	11245	0	11231	0.0	0.0
chr2	HDLBP	241268953	241268956	0	4	0	11245	0	11241	0.0	0.0
chr2	HDLBP	241269200	241269204	0	5	0	11245	0	11240	0.0	0.0
chr2	HDLBP	241268953	241269199	0	247	0	11245	0	10998	0.0	0.0
chr2	HDLBP	241268957	241269199	0	243	0	11245	0	11002	0.0	0.0
chr2	HDLBP	241268828	241268952	0	125	0	11245	0	11120	0.0	0.0
chr2	HDLBP	241268828	241269199	0	372	0	11245	0	10873	0.0	0.0
chr2	HDLBP	241268828	241268956	0	129	0	11245	0	11116	0.0	0.0
chr2	STK25	241501477	241501526	1240	50	60500	5262	59260	5212	24.8	11.36991557943208
chr2	STK25	241508442	241508503	3464	62	60500	5262	57036	5200	55.87096774193548	10.968461538461538
chr2	THAP4	241601814	241601894	0	81	0	2842	0	2761	0.0	0.0
chr2	DTYMK	241685768	241685805	0	38	51	2407	51	2369	0.0	0.021528070915998312
chr2	PDCD1	241852620	241852855	0	236	51	2102	51	1866	0.0	0.027331189710610933
chr2	AC079779.1	198616	199901	0	1286	0	4340	0	3054	0.0	0.0
chr2	AC105393.1	421162	421264	153	103	3870	2432	3717	2329	1.4854368932038835	1.595963933018463
chr2	AC093326.1	558278	558339	0	62	0	2562	0	2500	0.0	0.0
chr2	TPO	1413546	1413550	0	5	32	6780	32	6775	0.0	0.004723247232472325
chr2	TRAPPC12	3379840	3379876	0	37	41955	8700	41955	8663	0.0	4.843010504444188
chr2	TRAPPC12	3465696	3465708	338	13	41955	8700	41617	8687	26.0	4.790721768159319
chr2	RPS7	3575351	3575448	0	98	29198	1880	29198	1782	0.0	16.384960718294053
chr2	LINC01824	6496397	6496616	0	220	0	2026	0	1806	0.0	0.0
chr2	LINC01824	6496253	6496616	0	364	0	2026	0	1662	0.0	0.0
chr2	LINC01824	6496253	6496396	0	144	0	2026	0	1882	0.0	0.0
chr2	AC013460.1	7423036	7424012	0	977	0	5222	0	4245	0.0	0.0
chr2	AC013460.1	7428457	7428470	0	14	0	5222	0	5208	0.0	0.0
chr2	AC013460.1	7428895	7429273	0	379	0	5222	0	4843	0.0	0.0
chr2	U91324.1	8139485	8139501	0	17	0	1720	0	1703	0.0	0.0
chr2	AC093904.3	9111063	9111171	87	109	261	1221	174	1112	0.7981651376146789	0.1564748201438849
chr2	CPSF3	9423824	9424052	0	229	3420	3701	3420	3472	0.0	0.9850230414746544
chr2	CPSF3	9424053	9424960	0	908	3420	3701	3420	2793	0.0	1.2244897959183674
chr2	IAH1	9475148	9475217	0	70	64994	5393	64994	5323	0.0	12.2100319368777
chr2	GRHL1	9958857	9958964	0	108	2042	4949	2042	4841	0.0	0.421813674860566
chr2	GRHL1	9990748	9990773	0	26	2042	4949	2042	4923	0.0	0.4147877310582978
chr2	LINC00570	11391876	11391996	51	121	663	2182	612	2061	0.4214876033057851	0.29694323144104806
chr2	LPIN1	11724540	11724642	0	103	102	11894	102	11791	0.0	0.008650665762021881
chr2	TRIB2	12717011	12718577	0	1567	0	4331	0	2764	0.0	0.0
chr2	DDX1	15630108	15630110	0	3	561	8850	561	8847	0.0	0.06341132587317735
chr2	DDX1	15627146	15628839	0	1694	561	8850	561	7156	0.0	0.07839575181665735
chr2	GACAT3	16081091	16081185	0	95	0	3700	0	3605	0.0	0.0
chr2	LINC01808	19469081	19469430	0	350	1938	3067	1938	2717	0.0	0.7132867132867133
chr2	LINC01808	19479143	19479284	0	142	1938	3067	1938	2925	0.0	0.6625641025641026
chr2	LINC01884	22516632	22516767	0	136	0	1354	0	1218	0.0	0.0
chr2	FAM228A	24179228	24179297	0	70	0	2289	0	2219	0.0	0.0
chr2	CENPO	24793502	24793520	0	19	51	5526	51	5507	0.0	0.009260940621027784
chr2	DNAJC27-AS1	24972233	24972330	0	98	128132	5744	128132	5646	0.0	22.69429684732554
chr2	HADHB	26244991	26245139	0	149	1022	3812	1022	3663	0.0	0.279006279006279
chr2	HADHB	26245140	26245441	3	302	1022	3812	1019	3510	0.009933774834437087	0.2903133903133903
chr2	CENPA	26786081	26786296	0	216	0	1956	0	1740	0.0	0.0
chr2	MAPRE3	27024253	27024297	33	45	67149	3639	67116	3594	0.7333333333333333	18.674457429048413
chr2	EMILIN1	27084012	27084026	0	15	0	3913	0	3898	0.0	0.0
chr2	ATRAID	27212468	27212607	0	140	0	2026	0	1886	0.0	0.0
chr2	GTF3C2-AS1	27335721	27336088	3804	368	21231	3294	17427	2926	10.33695652173913	5.955912508544087
chr2	SNX17	27371344	27371468	0	125	0	3482	0	3357	0.0	0.0
chr2	SLC4A1AP	27664050	27664577	61009	528	106701	4778	45692	4250	115.54734848484848	10.751058823529412
chr2	PLB1	28626509	28626548	0	40	39334	8664	39334	8624	0.0	4.560992578849722
chr2	PPP1CB	28751784	28751820	0	37	624	5733	624	5696	0.0	0.10955056179775281
chr2	PPP1CB	28751821	28751924	0	104	624	5733	624	5629	0.0	0.11085450346420324
chr2	SPDYA	28810948	28811190	0	243	290	3497	290	3254	0.0	0.08912108174554395
chr2	CLIP4	29157348	29157402	21	55	4367	6993	4346	6938	0.38181818181818183	0.6264053041222254
chr2	YPEL5	30148306	30148541	0	236	0	3132	0	2896	0.0	0.0
chr2	YPEL5	30147966	30148091	0	126	0	3132	0	3006	0.0	0.0
chr2	LBH	30234508	30234511	0	4	0	4538	0	4534	0.0	0.0
chr2	LBH	30232207	30232594	0	388	0	4538	0	4150	0.0	0.0
chr2	LCLAT1	30447384	30447404	0	21	22	7528	22	7507	0.0	0.00293059810843213
chr2	LCLAT1	30447405	30447523	22	119	22	7528	0	7409	0.18487394957983194	0.0
chr2	BIRC6	32453943	32453954	0	12	124063	17804	124063	17792	0.0	6.972965377697841
chr2	BIRC6	32471125	32471151	0	27	124063	17804	124063	17777	0.0	6.978849074647016
chr2	TTC27	32628134	32628380	0	247	538	3468	538	3221	0.0	0.167028873020801
chr2	LINC00486	32927238	32927346	0	109	5408	7058	5408	6949	0.0	0.7782414735933227
chr2	LINC00486	32927347	32927662	0	316	5408	7058	5408	6742	0.0	0.8021358647285672
chr2	LTBP1	33262822	33262824	0	3	544	7385	544	7382	0.0	0.07369276618802492
chr2	LINC01320	34384210	34384241	0	32	264	10145	264	10113	0.0	0.026105013349154552
chr2	LINC01320	34722075	34722121	0	47	264	10145	264	10098	0.0	0.026143790849673203
chr2	LINC01320	34713774	34713777	0	4	264	10145	264	10141	0.0	0.02603293560792821
chr2	LINC01320	34722122	34722438	0	317	264	10145	264	9828	0.0	0.026862026862026864
chr2	LINC01320	34722075	34722438	0	364	264	10145	264	9781	0.0	0.026991105203966876
chr2	NDUFAF7	37237836	37237867	0	32	83	3663	83	3631	0.0	0.02285871660699532
chr2	NDUFAF7	37241638	37241791	0	154	83	3663	83	3509	0.0	0.02365346252493588
chr2	NDUFAF7	37231836	37231879	0	44	83	3663	83	3619	0.0	0.022934512296214425
chr2	NDUFAF7	37231880	37231989	0	110	83	3663	83	3553	0.0	0.023360540388404166
chr2	CYP1B1-AS1	38075790	38076068	0	279	0	8859	0	8580	0.0	0.0
chr2	GEMIN6	38779326	38779441	360	116	4133	4369	3773	4253	3.103448275862069	0.8871384904773101
chr2	MORN2	38876111	38876211	0	101	0	1374	0	1273	0.0	0.0
chr2	ARHGEF33	38960640	38960648	90	9	259460	5091	259370	5082	10.0	51.036993309720586
chr2	MAP4K3-DT	39587035	39587353	0	319	3188	10725	3188	10406	0.0	0.30636171439554105
chr2	MAP4K3-DT	39516542	39517152	0	611	3188	10725	3188	10114	0.0	0.31520664425548744
chr2	SLC8A1-AS1	39922890	39923018	0	129	159	8515	159	8386	0.0	0.0189601717147627
chr2	SLC8A1-AS1	40065473	40065855	0	383	159	8515	159	8132	0.0	0.01955238563698967
chr2	SLC8A1-AS1	40213219	40213479	0	261	159	8515	159	8254	0.0	0.019263387448509812
chr2	LINC01913	41877302	41877535	0	234	51	5091	51	4857	0.0	0.010500308832612723
chr2	MTA3	42709015	42709096	0	82	20274	10362	20274	10280	0.0	1.9721789883268483
chr2	SLC3A1	44313952	44313955	0	4	0	6140	0	6136	0.0	0.0
chr2	EPCAM	47369582	47369809	0	228	124007	2205	124007	1977	0.0	62.724835609509356
chr2	MSH6	47783232	47783493	0	262	37216	10902	37216	10640	0.0	3.4977443609022556
chr2	MSH6	47783471	47783493	0	23	37216	10902	37216	10879	0.0	3.420902656494163
chr2	GTF2A1L	48621291	48621317	0	27	6840	2063	6840	2036	0.0	3.3595284872298623
chr2	GTF2A1L	48621305	48621317	0	13	6840	2063	6840	2050	0.0	3.3365853658536584
chr2	GTF2A1L	48621291	48621304	0	14	6840	2063	6840	2049	0.0	3.3382137628111272
chr2	C2ORF73	54334851	54335024	0	174	0	2412	0	2238	0.0	0.0
chr2	EML6	54724671	54725258	0	588	180440	16043	180440	15455	0.0	11.675186023940473
chr2	RPS27A	55232519	55232708	0	190	30	2836	30	2646	0.0	0.011337868480725623
chr2	AC012358.2	55329520	55329713	0	194	15	4927	15	4733	0.0	0.003169237270230298
chr2	VRK2	58046822	58046868	0	47	0	3484	0	3437	0.0	0.0
chr2	LINC01122	58460993	58461125	0	133	0	11565	0	11432	0.0	0.0
chr2	PAPOLG	60756350	60756495	0	146	0	7983	0	7837	0.0	0.0
chr2	AHSA2P	61177619	61178384	0	766	960	8068	960	7302	0.0	0.1314708299096138
chr2	AHSA2P	61184801	61184924	0	124	960	8068	960	7944	0.0	0.12084592145015106
chr2	AHSA2P	61183663	61184022	0	360	960	8068	960	7708	0.0	0.12454592631032693
chr2	EHBP1	62948317	62949162	0	846	663	8254	663	7408	0.0	0.08949784017278618
chr2	EHBP1	62674084	62674093	0	10	663	8254	663	8244	0.0	0.08042212518195051
chr2	EHBP1	62705705	62705736	0	32	663	8254	663	8222	0.0	0.08063731452201411
chr2	EHBP1	62705737	62706052	0	316	663	8254	663	7938	0.0	0.0835222978080121
chr2	UGP2	63857643	63857718	0	76	0	6812	0	6736	0.0	0.0
chr2	UGP2	63857717	63857718	0	2	0	6812	0	6810	0.0	0.0
chr2	UGP2	63857643	63857716	0	74	0	6812	0	6738	0.0	0.0
chr2	AC012368.1	64251835	64251983	0	149	15209	7851	15209	7702	0.0	1.9746819008049856
chr2	AC012368.1	64228523	64228629	0	107	15209	7851	15209	7744	0.0	1.9639721074380165
chr2	AC012368.1	64228523	64229288	1326	766	15209	7851	13883	7085	1.731070496083551	1.9594918842625264
chr2	AC012368.1	64228630	64229288	1326	659	15209	7851	13883	7192	2.0121396054628224	1.9303392658509455
chr2	CEP68	65072570	65072980	0	411	102	6951	102	6540	0.0	0.015596330275229359
chr2	CEP68	65072981	65074178	0	1198	102	6951	102	5753	0.0	0.01772988006257605
chr2	CEP68	65072570	65074178	0	1609	102	6951	102	5342	0.0	0.019093972295020592
chr2	CEP68	65074150	65074178	0	29	102	6951	102	6922	0.0	0.01473562554175094
chr2	AC007389.1	65732935	65733389	0	455	1416	12371	1416	11916	0.0	0.11883182275931521
chr2	LINC01798	66691548	66691554	0	7	51	3925	51	3918	0.0	0.013016845329249618
chr2	LINC01828	67268545	67268638	0	94	0	8104	0	8010	0.0	0.0
chr2	LINC01828	67287819	67287823	0	5	0	8104	0	8099	0.0	0.0
chr2	LINC02831	67566885	67566972	0	88	0	3252	0	3164	0.0	0.0
chr2	LINC02831	67564887	67565423	0	537	0	3252	0	2715	0.0	0.0
chr2	APLF	68513681	68513684	0	4	2649	7146	2649	7142	0.0	0.3709045085410249
chr2	ANXA4	69806433	69806498	0	66	700	4497	700	4431	0.0	0.1579778830963665
chr2	ANXA4	69810674	69811456	0	783	700	4497	700	3714	0.0	0.1884760366182014
chr2	ANXA4	69807997	69808189	0	193	700	4497	700	4304	0.0	0.16263940520446096
chr2	VAX2	70963262	70963312	0	51	94	2993	94	2942	0.0	0.03195105370496261
chr2	ATP6V1B1	70961023	70961043	0	21	23	2671	23	2650	0.0	0.008679245283018867
chr2	NAGK	71068337	71068712	0	376	306	6678	306	6302	0.0	0.04855601396382101
chr2	NAGK	71075611	71075642	0	32	306	6678	306	6646	0.0	0.04604273247065904
chr2	NAGK	71068713	71069061	0	349	306	6678	306	6329	0.0	0.048348870279665036
chr2	ZNF638	71331866	71331875	0	10	41996	11438	41996	11428	0.0	3.674833741687084
chr2	SMYD5	73214706	73214749	20	44	2869	3320	2849	3276	0.45454545454545453	0.8696581196581197
chr2	ALMS1	73490159	73491498	19242	1340	234997	14807	215755	13467	14.359701492537313	16.021014331328434
chr2	ALMS1P1	73673049	73673050	0	2	0	4699	0	4697	0.0	0.0
chr2	STAMBP	73847573	73847753	0	181	8812	7527	8812	7346	0.0	1.1995643887830112
chr2	STAMBP	73828997	73829510	4424	514	8812	7527	4388	7013	8.607003891050583	0.625695137601597
chr2	STAMBP	73829071	73829510	4424	440	8812	7527	4388	7087	10.054545454545455	0.6191618456328489
chr2	STAMBP	73828997	73829070	0	74	8812	7527	8812	7453	0.0	1.182342680799678
chr2	ACTG2	73901438	73901480	0	43	51	3822	51	3779	0.0	0.01349563376554644
chr2	MTHFD2	74187121	74187457	51	337	4569	11414	4518	11077	0.1513353115727003	0.407872167554392
chr2	MTHFD2	74206414	74206606	102	193	4569	11414	4467	11221	0.5284974093264249	0.398092861598788
chr2	MTHFD2	74212110	74212128	0	19	4569	11414	4569	11395	0.0	0.40096533567354103
chr2	INO80B-WBP1	74457539	74457860	2295	322	3992	2048	1697	1726	7.127329192546584	0.9831981460023175
chr2	INO80B	74455937	74455950	0	14	2333	1446	2333	1432	0.0	1.6291899441340782
chr2	WBP1	74458538	74458671	357	134	2032	1671	1675	1537	2.6641791044776117	1.0897852960312298
chr2	WBP1	74459099	74459117	0	19	2032	1671	2032	1652	0.0	1.2300242130750605
chr2	TTC31	74491667	74491672	0	6	3002	4040	3002	4034	0.0	0.7441745166088249
chr2	DOK1	74555283	74555453	0	171	1848	2957	1848	2786	0.0	0.6633165829145728
chr2	AC012494.2	78088792	78088802	0	11	0	1400	0	1389	0.0	0.0
chr2	AC012494.2	78112101	78112130	0	30	0	1400	0	1370	0.0	0.0
chr2	KCMF1	84972241	84972245	0	5	97582	7740	97582	7735	0.0	12.615643180349062
chr2	ELMOD3	85355717	85357252	0	1536	3486	6400	3486	4864	0.0	0.7166940789473685
chr2	ELMOD3	85355599	85355716	0	118	3486	6400	3486	6282	0.0	0.5549188156638013
chr2	ELMOD3	85355599	85355896	0	298	3486	6400	3486	6102	0.0	0.5712881022615536
chr2	ELMOD3	85355717	85355896	0	180	3486	6400	3486	6220	0.0	0.5604501607717042
chr2	ELMOD3	85355785	85355896	0	112	3486	6400	3486	6288	0.0	0.5543893129770993
chr2	ELMOD3	85355599	85355784	0	186	3486	6400	3486	6214	0.0	0.5609913099452848
chr2	ELMOD3	85355717	85355784	0	68	3486	6400	3486	6332	0.0	0.5505369551484524
chr2	ELMOD3	85371210	85371562	1428	353	3486	6400	2058	6047	4.045325779036827	0.3403340499421201
chr2	SH2D6	85435817	85435824	0	8	83	2703	83	2695	0.0	0.03079777365491651
chr2	SH2D6	85431269	85431331	51	63	83	2703	32	2640	0.8095238095238095	0.012121212121212121
chr2	MAT2A	85539673	85540000	458	328	133999	4399	133541	4071	1.396341463414634	32.802996806681406
chr2	USP39	85616457	85616463	123	7	41083	3963	40960	3956	17.571428571428573	10.353892821031344
chr2	GNLY	85694924	85694996	0	73	132	2772	132	2699	0.0	0.04890700259355317
chr2	CYTOR	87480363	87480423	0	61	205	17288	205	17227	0.0	0.011899924537063912
chr2	CYTOR	87480363	87480607	0	245	205	17288	205	17043	0.0	0.012028398756087542
chr2	CYTOR	87480424	87480607	0	184	205	17288	205	17104	0.0	0.011985500467726848
chr2	CYTOR	87604158	87604160	0	3	205	17288	205	17285	0.0	0.011859994214636968
chr2	ANKRD36BP2	88784794	88784926	0	133	51	4231	51	4098	0.0	0.012445095168374817
chr2	PROM2	95277497	95277566	0	70	0	4716	0	4646	0.0	0.0
chr2	FAHD2A	95402873	95402992	0	120	51	5683	51	5563	0.0	0.009167715261549523
chr2	AC008268.1	95666404	95666424	0	21	0	2062	0	2041	0.0	0.0
chr2	FAHD2CP	96010733	96010851	0	119	2391	2143	2391	2024	0.0	1.1813241106719368
chr2	FER1L5	96686336	96686350	138	15	12131	7511	11993	7496	9.2	1.5999199573105656
chr2	FER1L5	96686264	96686350	343	87	12131	7511	11788	7424	3.942528735632184	1.587823275862069
chr2	FER1L5	96690584	96690589	0	6	12131	7511	12131	7505	0.0	1.6163890739506996
chr2	FER1L5	96686264	96686335	205	72	12131	7511	11926	7439	2.8472222222222223	1.6031724694179326
chr2	FER1L5	96687948	96687954	28	7	12131	7511	12103	7504	4.0	1.6128731343283582
chr2	FER1L5	96687954	96687954	4	1	12131	7511	12127	7510	4.0	1.614780292942743
chr2	FER1L5	96694465	96694631	0	167	12131	7511	12131	7344	0.0	1.6518246187363834
chr2	FER1L5	96652021	96652026	0	6	12131	7511	12131	7505	0.0	1.6163890739506996
chr2	FER1L5	96687948	96687953	24	6	12131	7511	12107	7505	4.0	1.6131912058627582
chr2	FER1L5	96694465	96694632	0	168	12131	7511	12131	7343	0.0	1.6520495710200191
chr2	FER1L5	96694632	96694632	0	1	12131	7511	12131	7510	0.0	1.615312916111851
chr2	FER1L5	96668969	96669004	0	36	12131	7511	12131	7475	0.0	1.622876254180602
chr2	AC159540.2	97285008	97285523	44834	516	27183	1980	-17651	1464	86.8875968992248	-12.056693989071038
chr2	AC159540.2	97284161	97284164	0	4	27183	1980	27183	1976	0.0	13.756578947368421
chr2	C2ORF92	97671482	97671499	0	18	101	6194	101	6176	0.0	0.01635362694300518
chr2	C2ORF92	97674558	97674561	0	4	101	6194	101	6190	0.0	0.01631663974151858
chr2	INPP4A	98555692	98555808	51	117	5482	13221	5431	13104	0.4358974358974359	0.414453601953602
chr2	NPAS2	100925295	100925300	0	6	162	11905	162	11899	0.0	0.01361458946129927
chr2	RPL31	101004284	101004361	0	78	9176	3899	9176	3821	0.0	2.401465584925412
chr2	MAP4K4	101867310	101867318	0	9	281104	11035	281104	11026	0.0	25.494649011427533
chr2	MAP4K4	101887238	101887261	0	24	281104	11035	281104	11011	0.0	25.529379711197894
chr2	LINC01127	101984705	101984937	0	233	0	3392	0	3159	0.0	0.0
chr2	IL1R1	102141919	102141999	0	81	31712	6249	31712	6168	0.0	5.141374837872893
chr2	IL1RL2	102187083	102187086	40	4	17154	2615	17114	2611	10.0	6.554576790501724
chr2	IL1RL1	102339023	102339047	0	25	1530	5719	1530	5694	0.0	0.26870389884088514
chr2	LINC01965	104051978	104052373	0	396	0	5510	0	5114	0.0	0.0
chr2	AC068535.1	104406776	104406791	0	16	0	2412	0	2396	0.0	0.0
chr2	LINC01102	104505939	104506303	0	365	0	7010	0	6645	0.0	0.0
chr2	LINC01102	104506187	104506303	0	117	0	7010	0	6893	0.0	0.0
chr2	LINC01102	104505967	104506303	0	337	0	7010	0	6673	0.0	0.0
chr2	LINC01102	104505945	104506303	0	359	0	7010	0	6651	0.0	0.0
chr2	LINC01102	104505939	104506186	0	248	0	7010	0	6762	0.0	0.0
chr2	LINC01102	104505967	104506186	0	220	0	7010	0	6790	0.0	0.0
chr2	LINC01102	104505945	104506186	0	242	0	7010	0	6768	0.0	0.0
chr2	LINC01102	104505939	104505966	0	28	0	7010	0	6982	0.0	0.0
chr2	LINC01102	104505945	104505966	0	22	0	7010	0	6988	0.0	0.0
chr2	LINC01102	104505939	104505944	0	6	0	7010	0	7004	0.0	0.0
chr2	LINC01102	104506701	104506836	0	136	0	7010	0	6874	0.0	0.0
chr2	LINC01102	104518097	104518401	0	305	0	7010	0	6705	0.0	0.0
chr2	GCC2	108449281	108449289	0	9	11349	10494	11349	10485	0.0	1.0824034334763948
chr2	CCDC138	108786805	108786915	0	111	0	5316	0	5205	0.0	0.0
chr2	AC013268.1	109936944	109938072	0	1129	0	3474	0	2345	0.0	0.0
chr2	BCL2L11	111123870	111124139	0	270	1338	6670	1338	6400	0.0	0.2090625
chr2	MERTK	111929305	111929540	0	236	17071	4566	17071	4330	0.0	3.9424942263279448
chr2	POLR1B	112564405	112564499	0	95	32490	8624	32490	8529	0.0	3.809356313753078
chr2	POLR1B	112542089	112542166	0	78	32490	8624	32490	8546	0.0	3.8017786098759654
chr2	CHCHD5	112584487	112584649	0	163	3666	1263	3666	1100	0.0	3.3327272727272725
chr2	PAX8-AS1	113250907	113250922	0	16	44812	13369	44812	13353	0.0	3.3559499737886616
chr2	PAX8-AS1	113236614	113236622	3	9	44812	13369	44809	13360	0.3333333333333333	3.3539670658682637
chr2	PAX8-AS1	113255550	113259584	33844	4035	44812	13369	10968	9334	8.387608426270136	1.1750589243625456
chr2	WASH2P	113596579	113596582	0	4	6646	2827	6646	2823	0.0	2.3542330853701734
chr2	RABL2A	113641451	113641480	0	30	2634	4010	2634	3980	0.0	0.6618090452261306
chr2	INSIG2	118096427	118096800	0	374	255	3957	255	3583	0.0	0.07116941110801005
chr2	DBI	119367061	119367090	0	30	0	2515	0	2485	0.0	0.0
chr2	DBI	119367464	119367528	0	65	0	2515	0	2450	0.0	0.0
chr2	DBI	119367091	119367214	0	124	0	2515	0	2391	0.0	0.0
chr2	DBI	119367091	119367463	0	373	0	2515	0	2142	0.0	0.0
chr2	TMEM177	119679226	119679617	0	392	51	2591	51	2199	0.0	0.023192360163710776
chr2	TMEM177	119679277	119679617	0	341	51	2591	51	2250	0.0	0.02266666666666667
chr2	TMEM177	119679226	119679276	0	51	51	2591	51	2540	0.0	0.020078740157480315
chr2	PTPN4	119915243	119916690	0	1448	253150	13306	253150	11858	0.0	21.348456738067128
chr2	NIFK-AS1	121649737	121650381	0	645	102	4745	102	4100	0.0	0.024878048780487806
chr2	NIFK-AS1	121649912	121650381	0	470	102	4745	102	4275	0.0	0.023859649122807018
chr2	NIFK-AS1	121649737	121649911	0	175	102	4745	102	4570	0.0	0.022319474835886213
chr2	TSN	121755846	121755953	0	108	0	4403	0	4295	0.0	0.0
chr2	TSN	121757334	121757434	0	101	0	4403	0	4302	0.0	0.0
chr2	LINC01823	121790456	121790519	0	64	0	3336	0	3272	0.0	0.0
chr2	LINC01823	121790504	121790519	0	16	0	3336	0	3320	0.0	0.0
chr2	LINC01823	121790456	121790503	0	48	0	3336	0	3288	0.0	0.0
chr2	LINC01823	121791454	121791503	0	50	0	3336	0	3286	0.0	0.0
chr2	TEX51	126899088	126899117	0	30	0	1165	0	1135	0.0	0.0
chr2	TEX51	126899064	126899117	0	54	0	1165	0	1111	0.0	0.0
chr2	TEX51	126901279	126901282	0	4	0	1165	0	1161	0.0	0.0
chr2	TEX51	126899064	126899087	0	24	0	1165	0	1141	0.0	0.0
chr2	MAP3K2-DT	127388312	127388384	0	73	0	3181	0	3108	0.0	0.0
chr2	AC010976.1	127455771	127455889	0	119	0	5506	0	5387	0.0	0.0
chr2	MYO7B	127620155	127620252	0	98	28	8008	28	7910	0.0	0.0035398230088495575
chr2	UGGT1	128091383	128091415	0	33	11215	11392	11215	11359	0.0	0.9873228277137072
chr2	UGGT1	128091383	128091596	0	214	11215	11392	11215	11178	0.0	1.0033100733583826
chr2	UGGT1	128091416	128091596	0	181	11215	11392	11215	11211	0.0	1.0003567924360004
chr2	MZT2B	130181798	130181830	0	33	0	1525	0	1492	0.0	0.0
chr2	MZT2B	130182447	130182452	0	6	0	1525	0	1519	0.0	0.0
chr2	IMP4	130342936	130342962	0	27	0	3208	0	3181	0.0	0.0
chr2	IMP4	130346250	130346274	0	25	0	3208	0	3183	0.0	0.0
chr2	IMP4	130344713	130344725	0	13	0	3208	0	3195	0.0	0.0
chr2	AMER3	130755675	130755805	0	131	3161	6441	3161	6310	0.0	0.5009508716323297
chr2	PLEKHB2	131132992	131133015	54	24	147761	6740	147707	6716	2.25	21.993299583085168
chr2	POTEE	131223711	131223740	0	30	0	4207	0	4177	0.0	0.0
chr2	LINC01120	131405361	131405447	0	87	0	4214	0	4127	0.0	0.0
chr2	CCDC74A	131528221	131528346	0	126	102	3085	102	2959	0.0	0.03447110510307536
chr2	C2ORF27A	131682558	131682599	0	42	204	7103	204	7061	0.0	0.028891091913326724
chr2	NCKAP5-AS2	133266297	133266436	0	140	0	1764	0	1624	0.0	0.0
chr2	CCNT2	134946147	134946465	0	319	51	8883	51	8564	0.0	0.0059551611396543675
chr2	CCNT2	134953269	134954379	0	1111	51	8883	51	7772	0.0	0.00656201749871333
chr2	CCNT2	134945976	134945982	0	7	51	8883	51	8876	0.0	0.005745831455610635
chr2	R3HDM1	135641605	135641790	0	186	2870	7930	2870	7744	0.0	0.3706095041322314
chr2	DARS-AS1	135993878	135993985	0	108	3342	5976	3342	5868	0.0	0.5695296523517382
chr2	LINC02631	138602442	138602484	0	43	0	2371	0	2328	0.0	0.0
chr2	TEX41	145172089	145172131	0	43	5870	26381	5870	26338	0.0	0.222871896119675
chr2	TEX41	145113338	145113443	0	106	5870	26381	5870	26275	0.0	0.22340627973358707
chr2	TEX41	145174993	145174996	0	4	5870	26381	5870	26377	0.0	0.22254236645562422
chr2	TEX41	145116511	145116821	0	311	5870	26381	5870	26070	0.0	0.22516302263137705
chr2	LINC01911	146838047	146838205	0	159	0	3576	0	3417	0.0	0.0
chr2	MBD5	148489501	148490594	204	1094	357	23435	153	22341	0.18647166361974407	0.0068483953269773065
chr2	MBD5	148483437	148484135	0	699	357	23435	357	22736	0.0	0.015701970443349755
chr2	MBD5	148490595	148490787	0	193	357	23435	357	23242	0.0	0.015360123913604681
chr2	MBD5	148489501	148490787	204	1287	357	23435	153	22148	0.1585081585081585	0.006908072963698754
chr2	KIF5C	148978551	148978741	0	191	3699	31919	3699	31728	0.0	0.11658472012102875
chr2	MMADHC-DT	149587851	149587873	0	23	0	7157	0	7134	0.0	0.0
chr2	MMADHC-DT	149587874	149588470	0	597	0	7157	0	6560	0.0	0.0
chr2	LINC02612	150629122	150629582	0	461	0	3285	0	2824	0.0	0.0
chr2	RIF1	151409940	151410033	0	94	459	13734	459	13640	0.0	0.03365102639296188
chr2	RIF1	151410034	151410527	0	494	459	13734	459	13240	0.0	0.034667673716012086
chr2	GALNT13	153872177	153872303	0	127	102	6628	102	6501	0.0	0.015689893862482696
chr2	MARCHF7	159712607	159712661	0	55	663	6301	663	6246	0.0	0.10614793467819404
chr2	TANK	161160485	161160486	0	2	3472	5607	3472	5605	0.0	0.6194469223907225
chr2	TANK	161232810	161232897	0	88	3472	5607	3472	5519	0.0	0.6290994745424896
chr2	PSMD14	161308605	161308786	0	182	459	7323	459	7141	0.0	0.06427671194510573
chr2	GCA	162319226	162319239	0	14	56552	5335	56552	5321	0.0	10.62807742905469
chr2	AC019197.1	164959330	164959360	0	31	0	10285	0	10254	0.0	0.0
chr2	SCN2A	165296091	165296302	0	212	51	23956	51	23744	0.0	0.002147911051212938
chr2	SCN2A	165326985	165328538	0	1554	51	23956	51	22402	0.0	0.002276582447995715
chr2	SCN2A	165296091	165296892	0	802	51	23956	51	23154	0.0	0.0022026431718061676
chr2	SCN2A	165296303	165296892	0	590	51	23956	51	23366	0.0	0.0021826585637250706
chr2	SCN1A-AS1	166015730	166016650	0	921	0	18935	0	18014	0.0	0.0
chr2	SCN1A-AS1	166248277	166249384	0	1108	0	18935	0	17827	0.0	0.0
chr2	PPIG	169636163	169636228	0	66	26866	10326	26866	10260	0.0	2.6185185185185187
chr2	PPIG	169584491	169584497	0	7	26866	10326	26866	10319	0.0	2.6035468553154377
chr2	PHOSPHO2	169694623	169694741	0	119	1235	1494	1235	1375	0.0	0.8981818181818182
chr2	UBR3	170007191	170007202	0	12	0	9972	0	9960	0.0	0.0
chr2	AC007405.3	170770535	170770679	841	145	1249	2602	408	2457	5.8	0.16605616605616605
chr2	AC007405.3	170771188	170771427	0	240	1249	2602	1249	2362	0.0	0.5287891617273497
chr2	GAD1	170817049	170817052	0	4	397	7161	397	7157	0.0	0.055470169065250804
chr2	GORASP2	170948381	170948430	0	50	414	4718	414	4668	0.0	0.08868894601542417
chr2	DCAF17	171434271	171434703	0	433	374	7673	374	7240	0.0	0.05165745856353591
chr2	SCRN3	174395818	174396293	25	476	236	4074	211	3598	0.052521008403361345	0.058643690939410784
chr2	SCRN3	174395990	174396293	0	304	236	4074	236	3770	0.0	0.06259946949602122
chr2	SCRN3	174396232	174396293	0	62	236	4074	236	4012	0.0	0.058823529411764705
chr2	SCRN3	174395818	174395989	25	172	236	4074	211	3902	0.14534883720930233	0.05407483341875961
chr2	SCRN3	174395818	174396231	25	414	236	4074	211	3660	0.06038647342995169	0.057650273224043716
chr2	SCRN3	174395990	174396231	0	242	236	4074	236	3832	0.0	0.061586638830897704
chr2	AC010894.1	174487530	174487827	0	298	0	802	0	504	0.0	0.0
chr2	AC010894.1	174487659	174487827	0	169	0	802	0	633	0.0	0.0
chr2	AC010894.1	174487530	174487658	0	129	0	802	0	673	0.0	0.0
chr2	HOXD12	176100376	176100403	0	28	0	2579	0	2551	0.0	0.0
chr2	LINC01117	176638008	176638008	0	1	1756	1745	1756	1744	0.0	1.0068807339449541
chr2	HNRNPA3	177212806	177212871	0	66	51	6245	51	6179	0.0	0.008253762744780709
chr2	HNRNPA3	177219157	177219159	0	3	51	6245	51	6242	0.0	0.008170458186478692
chr2	HNRNPA3	177219315	177221976	0	2662	51	6245	51	3583	0.0	0.014233882221602009
chr2	CHROMR	178426506	178426661	0	156	13808	7002	13808	6846	0.0	2.0169442009932808
chr2	CHROMR	178426662	178426680	0	19	13808	7002	13808	6983	0.0	1.9773736216525848
chr2	CHROMR	178426506	178426680	0	175	13808	7002	13808	6827	0.0	2.0225574923099456
chr2	CHROMR	178426662	178426703	0	42	13808	7002	13808	6960	0.0	1.9839080459770115
chr2	CHROMR	178426506	178426703	0	198	13808	7002	13808	6804	0.0	2.0293944738389182
chr2	CHROMR	178426681	178426703	0	23	13808	7002	13808	6979	0.0	1.9785069494196876
chr2	PJVK	178460421	178460446	0	26	0	3976	0	3950	0.0	0.0
chr2	PJVK	178451770	178451870	0	101	0	3976	0	3875	0.0	0.0
chr2	TTN-AS1	178583649	178583921	0	273	1173	21966	1173	21693	0.0	0.054072742359286406
chr2	TTN-AS1	178774516	178778755	0	4240	1173	21966	1173	17726	0.0	0.06617398172176464
chr2	TTN-AS1	178761015	178761026	0	12	1173	21966	1173	21954	0.0	0.05342989887947527
chr2	TTN-AS1	178528814	178529336	0	523	1173	21966	1173	21443	0.0	0.054703166534533415
chr2	TTN-AS1	178537448	178537530	0	83	1173	21966	1173	21883	0.0	0.05360325366723027
chr2	TTN-AS1	178539891	178539978	0	88	1173	21966	1173	21878	0.0	0.05361550415942956
chr2	UBE2E3	180980460	180980546	0	87	0	2985	0	2898	0.0	0.0
chr2	UBE2E3	180981386	180981477	0	92	0	2985	0	2893	0.0	0.0
chr2	LINC01934	181226536	181226539	0	4	153	15079	153	15075	0.0	0.010149253731343283
chr2	ITPRID2	181920651	181920662	0	12	2135	7648	2135	7636	0.0	0.2795966474594028
chr2	ITPRID2	181928200	181928278	0	79	2135	7648	2135	7569	0.0	0.2820716078742238
chr2	ITPRID2	181916428	181917005	306	578	2135	7648	1829	7070	0.5294117647058824	0.2586987270155587
chr2	PPP1R1C	182117302	182117468	0	167	0	4899	0	4732	0.0	0.0
chr2	ZC3H15	186502553	186502587	0	35	0	3040	0	3005	0.0	0.0
chr2	GULP1	188292167	188292219	0	53	51	5838	51	5785	0.0	0.00881590319792567
chr2	ASNSD1	189666154	189667596	0	1443	0	2491	0	1048	0.0	0.0
chr2	OSGEPL1-AS1	189762933	189762992	0	60	0	728	0	668	0.0	0.0
chr2	PMS1	189863975	189864228	40835	254	83096	4376	42261	4122	160.76771653543307	10.25254730713246
chr2	PMS1	189784565	189784770	0	206	83096	4376	83096	4170	0.0	19.927098321342925
chr2	PMS1	189784594	189784770	0	177	83096	4376	83096	4199	0.0	19.789473684210527
chr2	PMS1	189857406	189857504	0	99	83096	4376	83096	4277	0.0	19.428571428571427
chr2	C2ORF88	190181110	190181409	0	300	459	5627	459	5327	0.0	0.08616482072461047
chr2	C2ORF88	190181129	190181409	0	281	459	5627	459	5346	0.0	0.08585858585858586
chr2	C2ORF88	190181110	190181128	0	19	459	5627	459	5608	0.0	0.08184736091298145
chr2	INPP1	190343962	190344078	0	117	0	3107	0	2990	0.0	0.0
chr2	INPP1	190344075	190344078	0	4	0	3107	0	3103	0.0	0.0
chr2	INPP1	190343962	190344074	0	113	0	3107	0	2994	0.0	0.0
chr2	INPP1	190356618	190356808	0	191	0	3107	0	2916	0.0	0.0
chr2	MYO1B	191245612	191245626	0	15	11032	9318	11032	9303	0.0	1.1858540255831451
chr2	NABP1	191684279	191684296	0	18	459	17438	459	17420	0.0	0.02634902411021814
chr2	NABP1	191678242	191678705	0	464	459	17438	459	16974	0.0	0.02704135737009544
chr2	NABP1	191678397	191678705	0	309	459	17438	459	17129	0.0	0.026796660634012492
chr2	NABP1	191678242	191678396	0	155	459	17438	459	17283	0.0	0.026557889255337613
chr2	AC098872.1	191792838	191792921	762	84	923	930	161	846	9.071428571428571	0.19030732860520094
chr2	AC098872.1	191793460	191793559	8	100	923	930	915	830	0.08	1.1024096385542168
chr2	CAVIN2-AS1	192031492	192031603	0	112	1581	4592	1581	4480	0.0	0.3529017857142857
chr2	CAVIN2-AS1	192030681	192030707	0	27	1581	4592	1581	4565	0.0	0.34633077765607884
chr2	CCDC150	196719585	196719666	0	82	0	9384	0	9302	0.0	0.0
chr2	MOB4	197535606	197535630	0	25	1247	4091	1247	4066	0.0	0.30668962124938515
chr2	SPATS2L	200306161	200306292	0	132	51	10302	51	10170	0.0	0.005014749262536873
chr2	SPATS2L	200472993	200473052	0	60	51	10302	51	10242	0.0	0.00497949619214997
chr2	SPATS2L	200306293	200306601	0	309	51	10302	51	9993	0.0	0.005103572500750525
chr2	SPATS2L	200306161	200306601	0	441	51	10302	51	9861	0.0	0.0051718892607240646
chr2	SPATS2L	200306419	200306601	0	183	51	10302	51	10119	0.0	0.005040023717758672
chr2	SPATS2L	200306293	200306418	0	126	51	10302	51	10176	0.0	0.0050117924528301884
chr2	AOX3P	200731106	200731175	0	70	5593	4333	5593	4263	0.0	1.3119868637110017
chr2	BZW1	200811728	200811946	408	219	73292	8101	72884	7882	1.8630136986301369	9.24689165186501
chr2	BZW1	200811947	200811990	0	44	73292	8101	73292	8057	0.0	9.096686111455877
chr2	BZW1	200820019	200820120	270	102	73292	8101	73022	7999	2.6470588235294117	9.128891111388924
chr2	NIF3L1	200889392	200889652	0	261	0	2001	0	1740	0.0	0.0
chr2	CASP8	201233555	201233622	0	68	12967	7205	12967	7137	0.0	1.8168698332632758
chr2	CASP8	201258155	201258382	0	228	12967	7205	12967	6977	0.0	1.8585351870431417
chr2	CDK15	201806548	201806787	0	240	16037	6191	16037	5951	0.0	2.694841203159133
chr2	KIAA2012	202105911	202106015	791	105	72629	7680	71838	7575	7.533333333333333	9.483564356435643
chr2	CARF	202913103	202913114	0	12	1905	10132	1905	10120	0.0	0.18824110671936758
chr2	CARF	202912325	202913102	102	778	1905	10132	1803	9354	0.13110539845758354	0.1927517639512508
chr2	NBEAL1	203016428	203016435	0	8	29923	16436	29923	16428	0.0	1.821463355247139
chr2	CTLA4	203870649	203870933	0	285	421	2145	421	1860	0.0	0.22634408602150538
chr2	PARD3B	204546120	204546171	0	52	412	10729	412	10677	0.0	0.038587618244825324
chr2	NRP2	205766804	205766818	0	15	51	13919	51	13904	0.0	0.0036680092059838895
chr2	NRP2	205682579	205682905	0	327	51	13919	51	13592	0.0	0.003752207180694526
chr2	EEF1B2	206160019	206160059	0	41	0	1648	0	1607	0.0	0.0
chr2	ZDBF2	206275080	206275180	0	101	153	10892	153	10791	0.0	0.014178482068390326
chr2	FASTKD2	206765519	206765654	0	136	0	7236	0	7100	0.0	0.0
chr2	FASTKD2	206765655	206765762	0	108	0	7236	0	7128	0.0	0.0
chr2	FASTKD2	206765748	206765762	0	15	0	7236	0	7221	0.0	0.0
chr2	FASTKD2	206765655	206765747	0	93	0	7236	0	7143	0.0	0.0
chr2	CREB1	207530019	207530134	0	116	3519	10644	3519	10528	0.0	0.3342515197568389
chr2	IDH1-AS1	208255432	208255622	0	191	0	657	0	466	0.0	0.0
chr2	MAP2	209579439	209579755	0	317	51	11629	51	11312	0.0	0.004508486562942009
chr2	UNC80	209826039	209826053	0	15	561	17565	561	17550	0.0	0.03196581196581197
chr2	UNC80	209839431	209839436	0	6	561	17565	561	17559	0.0	0.031949427643943276
chr2	RPE	210002773	210002783	0	11	35	3448	35	3437	0.0	0.010183299389002037
chr2	RPE	210003458	210003468	0	11	35	3448	35	3437	0.0	0.010183299389002037
chr2	CPS1	210519671	210519784	0	114	10307	11064	10307	10950	0.0	0.9412785388127853
chr2	LINC01878	212817008	212817250	0	243	0	3201	0	2958	0.0	0.0
chr2	SPAG16	213296111	213296128	0	18	6354	8280	6354	8262	0.0	0.7690631808278867
chr2	AC072062.1	215029380	215029384	0	5	0	3513	0	3508	0.0	0.0
chr2	ATIC	215312162	215312390	0	229	0	3806	0	3577	0.0	0.0
chr2	ATIC	215312344	215312390	0	47	0	3806	0	3759	0.0	0.0
chr2	ATIC	215312162	215312343	0	182	0	3806	0	3624	0.0	0.0
chr2	AC012462.1	215453726	215453833	0	108	0	1648	0	1540	0.0	0.0
chr2	TMEM169	216081974	216081975	0	2	12	3631	12	3629	0.0	0.003306696059520529
chr2	TMEM169	216081974	216082232	0	259	12	3631	12	3372	0.0	0.0035587188612099642
chr2	TMEM169	216081976	216082232	0	257	12	3631	12	3374	0.0	0.0035566093657379964
chr2	TMEM169	216081980	216082232	0	253	12	3631	12	3378	0.0	0.003552397868561279
chr2	TMEM169	216081974	216081979	0	6	12	3631	12	3625	0.0	0.003310344827586207
chr2	TMEM169	216081976	216081979	0	4	12	3631	12	3627	0.0	0.0033085194375516956
chr2	SMARCAL1	216412604	216412648	0	45	144	5114	144	5069	0.0	0.02840797001380943
chr2	SMARCAL1	216412604	216412734	0	131	144	5114	144	4983	0.0	0.028898254063816978
chr2	SMARCAL1	216412649	216412734	0	86	144	5114	144	5028	0.0	0.028639618138424822
chr2	SMARCAL1	216412718	216412734	0	17	144	5114	144	5097	0.0	0.028251912889935255
chr2	SMARCAL1	216412604	216412717	0	114	144	5114	144	5000	0.0	0.0288
chr2	SMARCAL1	216412649	216412717	0	69	144	5114	144	5045	0.0	0.02854311199207136
chr2	SMARCAL1	216412799	216412936	0	138	144	5114	144	4976	0.0	0.028938906752411574
chr2	RPL37A	216499152	216499180	0	29	0	5245	0	5216	0.0	0.0
chr2	RUFY4	218073886	218073945	0	60	28	3777	28	3717	0.0	0.007532956685499058
chr2	CXCR2	218125711	218125781	0	71	0	3220	0	3149	0.0	0.0
chr2	ARPC2	218217255	218217544	0	290	28	6079	28	5789	0.0	0.0048367593712212815
chr2	SLC11A1	218383071	218383102	0	32	0	7083	0	7051	0.0	0.0
chr2	CTDSP1	218400898	218400953	0	56	153	4475	153	4419	0.0	0.034623217922606926
chr2	VIL1	218425800	218425811	0	12	0	6912	0	6900	0.0	0.0
chr2	PLCD4	218615960	218616062	0	103	0	5717	0	5614	0.0	0.0
chr2	BCS1L	218661521	218661545	0	25	0	2642	0	2617	0.0	0.0
chr2	BCS1L	218660219	218660245	0	27	0	2642	0	2615	0.0	0.0
chr2	BCS1L	218660167	218660245	0	79	0	2642	0	2563	0.0	0.0
chr2	BCS1L	218660167	218660218	0	52	0	2642	0	2590	0.0	0.0
chr2	BCS1L	218660422	218660482	0	61	0	2642	0	2581	0.0	0.0
chr2	BCS1L	218659744	218659800	0	57	0	2642	0	2585	0.0	0.0
chr2	BCS1L	218660246	218660421	0	176	0	2642	0	2466	0.0	0.0
chr2	BCS1L	218660219	218660421	0	203	0	2642	0	2439	0.0	0.0
chr2	BCS1L	218660167	218660421	0	255	0	2642	0	2387	0.0	0.0
chr2	BCS1L	218659801	218660421	0	621	0	2642	0	2021	0.0	0.0
chr2	TTLL4	218752848	218752973	0	126	50	7190	50	7064	0.0	0.007078142695356738
chr2	LINC00608	218976923	218977398	0	476	0	2164	0	1688	0.0	0.0
chr2	ZFAND2B	219207775	219207779	0	5	11050	2754	11050	2749	0.0	4.01964350672972
chr2	ANKZF1	219230351	219230405	0	55	204	4424	204	4369	0.0	0.04669260700389105
chr2	ANKZF1	219229901	219230350	11	450	204	4424	193	3974	0.024444444444444446	0.04856567689984902
chr2	ANKZF1	219229901	219229958	11	58	204	4424	193	4366	0.1896551724137931	0.04420522217132387
chr2	ANKZF1	219229901	219229980	11	80	204	4424	193	4344	0.1375	0.044429097605893184
chr2	ANKZF1	219229959	219229980	0	22	204	4424	204	4402	0.0	0.046342571558382555
chr2	STK16	219245523	219245796	0	274	51	4345	51	4071	0.0	0.012527634487840826
chr2	DNAJB2	219279450	219279518	0	69	751	5248	751	5179	0.0	0.14500868893608804
chr2	DNAJB2	219279519	219279687	51	169	751	5248	700	5079	0.30177514792899407	0.1378224059854302
chr2	SPEG	219444985	219445161	918	177	83704	14929	82786	14752	5.186440677966102	5.611849240780911
chr2	SPEG	219443151	219443440	1867	290	83704	14929	81837	14639	6.437931034482759	5.590340870278024
chr2	GMPPA	219498939	219499254	6866	316	45282	3037	38416	2721	21.727848101265824	14.118338846012495
chr2	GMPPA	219498972	219499254	6802	283	45282	3037	38480	2754	24.035335689045937	13.972403776325345
chr2	GMPPA	219498939	219498971	64	33	45282	3037	45218	3004	1.9393939393939394	15.0525965379494
chr2	STK11IP	219601441	219601554	0	114	57209	5318	57209	5204	0.0	10.993274404304382
chr2	STK11IP	219614547	219614871	9192	325	57209	5318	48017	4993	28.283076923076923	9.616863609052674
chr2	CT75	222320830	222321264	0	435	120	2002	120	1567	0.0	0.07657945118059988
chr2	CT75	222321009	222321264	0	256	120	2002	120	1746	0.0	0.06872852233676977
chr2	MFF	227329660	227329783	0	124	0	4113	0	3989	0.0	0.0
chr2	MFF	227329698	227329783	0	86	0	4113	0	4027	0.0	0.0
chr2	MFF	227325428	227325542	0	115	0	4113	0	3998	0.0	0.0
chr2	MFF	227329660	227329697	0	38	0	4113	0	4075	0.0	0.0
chr2	MFF	227328790	227328899	0	110	0	4113	0	4003	0.0	0.0
chr2	MFF	227325543	227325660	0	118	0	4113	0	3995	0.0	0.0
chr2	AC009950.1	230172194	230172515	0	322	134	5424	134	5102	0.0	0.026264210113680908
chr2	SP140	230245072	230245080	0	9	306	5515	306	5506	0.0	0.05557573556120596
chr2	SP100	230467207	230467215	0	9	2500	14166	2500	14157	0.0	0.17659108568199477
chr2	CAB39	230713803	230714058	0	256	432	5325	432	5069	0.0	0.08522391004142829
chr2	ITM2C	230865387	230865403	0	17	12364	2579	12364	2562	0.0	4.82591725214676
chr2	SPATA3	230996257	230996534	0	278	348	2820	348	2542	0.0	0.13690007867820614
chr2	C2ORF72	231037662	231038199	0	538	2249	3782	2249	3244	0.0	0.6932799013563502
chr2	PSMD1	231062676	231062693	0	18	7528	14058	7528	14040	0.0	0.5361823361823361
chr2	PTMA	231710585	231710676	0	92	161	2703	161	2611	0.0	0.06166219839142091
chr2	CHRND	232528340	232528371	0	32	153	3144	153	3112	0.0	0.04916452442159383
chr2	GIGYF2	232731235	232731258	0	24	333	15277	333	15253	0.0	0.021831770799187047
chr2	GIGYF2	232768260	232768405	0	146	333	15277	333	15131	0.0	0.022007798559249222
chr2	ATG16L1	233251941	233251942	0	2	1036	4235	1036	4233	0.0	0.24474368060477203
chr2	MROH2A	233822557	233822571	0	15	366	5773	366	5758	0.0	0.06356373740882251
chr2	MROH2A	233823665	233823682	0	18	366	5773	366	5755	0.0	0.06359687228496959
chr2	TRPM8	233983225	233983351	0	127	133	7914	133	7787	0.0	0.017079748298446128
chr2	SH3BP4	234978901	234978985	0	85	79	7085	79	7000	0.0	0.011285714285714286
chr2	LRRFIP1	237772183	237772198	0	16	140	13249	140	13233	0.0	0.010579611577117811
chr2	RBM44	237820287	237820351	0	65	0	6065	0	6000	0.0	0.0
chr2	SCLY	238061144	238061349	51	206	207	5749	156	5543	0.24757281553398058	0.02814360454627458
chr2	TRAF3IP1	238320786	238320813	0	28	2056	4631	2056	4603	0.0	0.4466652183358679
chr2	HDAC4-AS1	239401881	239401892	0	12	0	616	0	604	0.0	0.0
chr2	HDAC4-AS1	239401881	239401969	0	89	0	616	0	527	0.0	0.0
chr2	HDAC4-AS1	239401893	239401969	0	77	0	616	0	539	0.0	0.0
chr2	CAPN10	240591001	240591011	0	11	0	6540	0	6529	0.0	0.0
chr2	PPP1R7	241158532	241158549	0	18	0	3700	0	3682	0.0	0.0
chr2	PPP1R7	241149709	241150547	0	839	0	3700	0	2861	0.0	0.0
chr2	SEPTIN2	241316551	241316555	0	5	12	6771	12	6766	0.0	0.0017735737511084836
chr2	SEPTIN2	241316541	241316555	0	15	12	6771	12	6756	0.0	0.0017761989342806395
chr2	ATG4B	241671406	241671425	0	20	16	6287	16	6267	0.0	0.002553055688527206
chr2	ATG4B	241671426	241671441	0	16	16	6287	16	6271	0.0	0.002551427204592569
chr2	ATG4B	241671406	241671441	0	36	16	6287	16	6251	0.0	0.0025595904655255157
chr2	ING5	241711489	241711584	0	96	1050	6538	1050	6442	0.0	0.16299285936044708
chr2	D2HGDH	241748943	241749929	102	987	0	4764	-102	3777	0.1033434650455927	-0.027005559968228753
chr2	D2HGDH	241749400	241749929	0	530	0	4764	0	4234	0.0	0.0
chr2	D2HGDH	241749009	241749929	102	921	0	4764	-102	3843	0.11074918566775244	-0.02654176424668228
chr2	NEU4	241811455	241811461	0	7	0	2880	0	2873	0.0	0.0
chr2	NEU4	241813514	241813669	0	156	0	2880	0	2724	0.0	0.0
chr2	LINC01237	241881475	241881478	0	4	1726	1604	1726	1600	0.0	1.07875
chr2	LINC01881	242130813	242130866	0	54	40968	1821	40968	1767	0.0	23.185059422750424
chr3	LINC01986	11800	12659	0	860	0	2024	0	1164	0.0	0.0
chr3	CNTN6	1093121	1093129	0	9	0	5532	0	5523	0.0	0.0
chr3	TRNT1	3140579	3140648	0	70	51	5803	51	5733	0.0	0.008895866038723181
chr3	TRNT1	3146564	3146623	0	60	51	5803	51	5743	0.0	0.008880376110047014
chr3	TRNT1	3126991	3127289	0	299	51	5803	51	5504	0.0	0.009265988372093024
chr3	TRNT1	3127290	3128018	0	729	51	5803	51	5074	0.0	0.010051241623965314
chr3	ITPR1	4675222	4675248	0	27	11318	30866	11318	30839	0.0	0.36700282110314864
chr3	ITPR1	4814733	4814763	0	31	11318	30866	11318	30835	0.0	0.36705042970650237
chr3	ARL8B	5170557	5170583	0	27	2191	3554	2191	3527	0.0	0.6212078253473207
chr3	AC069277.1	6490943	6490946	0	4	408	6372	408	6368	0.0	0.06407035175879397
chr3	THUMPD3	9363333	9363525	0	193	5659	5167	5659	4974	0.0	1.1377161238439888
chr3	THUMPD3	9363128	9363525	0	398	5659	5167	5659	4769	0.0	1.1866219333193542
chr3	THUMPD3	9363128	9363332	0	205	5659	5167	5659	4962	0.0	1.1404675534058848
chr3	THUMPD3	9363526	9363728	0	203	5659	5167	5659	4964	0.0	1.1400080580177276
chr3	THUMPD3	9363333	9363728	0	396	5659	5167	5659	4771	0.0	1.1861245022007965
chr3	THUMPD3	9363128	9363728	0	601	5659	5167	5659	4566	0.0	1.2393780113885238
chr3	SETD5	9424527	9424539	572	13	382706	12159	382134	12146	44.0	31.46171579120698
chr3	MTMR14	9662286	9662375	0	90	1857	3678	1857	3588	0.0	0.5175585284280937
chr3	BRPF1	9742154	9742171	375	18	313869	6082	313494	6064	20.833333333333332	51.69755936675462
chr3	BRPF1	9743254	9743471	3576	218	313869	6082	310293	5864	16.40366972477064	52.91490450204638
chr3	ARPC4	9792706	9793124	59715	419	196242	3616	136527	3197	142.5178997613365	42.70472317797935
chr3	ARPC4	9793125	9793174	0	50	196242	3616	196242	3566	0.0	55.03140773976444
chr3	TTLL3	9827073	9827240	24998	168	460783	7028	435785	6860	148.79761904761904	63.525510204081634
chr3	TTLL3	9827149	9827240	1150	92	460783	7028	459633	6936	12.5	66.26773356401384
chr3	ARPC4	9793125	9793181	0	57	196242	3616	196242	3559	0.0	55.139645967968534
chr3	ARPC4	9793175	9793181	0	7	196242	3616	196242	3609	0.0	54.375727348295925
chr3	TTLL3	9809765	9809922	0	158	460783	7028	460783	6870	0.0	67.07176128093158
chr3	TTLL3	9809849	9809922	0	74	460783	7028	460783	6954	0.0	66.26157607132586
chr3	TTLL3	9809872	9809922	0	51	460783	7028	460783	6977	0.0	66.04314175146911
chr3	TTLL3	9809765	9809848	0	84	460783	7028	460783	6944	0.0	66.35699884792626
chr3	TTLL3	9809765	9809871	0	107	460783	7028	460783	6921	0.0	66.57751769975437
chr3	TTLL3	9809849	9809871	0	23	460783	7028	460783	7005	0.0	65.77915774446824
chr3	TTLL3	9833246	9833273	0	28	460783	7028	460783	7000	0.0	65.82614285714286
chr3	TTLL3	9827073	9827148	23848	76	460783	7028	436935	6952	313.7894736842105	62.850258918296895
chr3	IL17RC	9918599	9918609	0	11	11328	3519	11328	3508	0.0	3.2291904218928162
chr3	IL17RC	9924021	9924137	0	117	11328	3519	11328	3402	0.0	3.329805996472663
chr3	IL17RC	9917421	9917633	0	213	11328	3519	11328	3306	0.0	3.426497277676951
chr3	IL17RC	9918076	9918111	0	36	11328	3519	11328	3483	0.0	3.252368647717485
chr3	CRELD1	9941017	9941026	0	10	146828	3805	146828	3795	0.0	38.68985507246377
chr3	CRELD1	9943154	9943172	0	19	146828	3805	146828	3786	0.0	38.78182778658214
chr3	CRELD1	9933853	9933920	66	68	146828	3805	146762	3737	0.9705882352941176	39.27267861921327
chr3	CRELD1	9937673	9937710	266	38	146828	3805	146562	3767	7.0	38.9068224050969
chr3	FANCD2	10026474	10026626	135	153	196644	7736	196509	7583	0.8823529411764706	25.914413820387708
chr3	TATDN2	10279035	10279063	0	29	100650	5581	100650	5552	0.0	18.128602305475503
chr3	GHRLOS	10288103	10288106	110	4	12364	3170	12254	3166	27.5	3.870499052432091
chr3	SLC6A1	11017260	11017449	0	190	15	12472	15	12282	0.0	0.0012212994626282364
chr3	SLC6A1	11014185	11014874	0	690	15	12472	15	11782	0.0	0.001273128501103378
chr3	SLC6A1	11015734	11015790	0	57	15	12472	15	12415	0.0	0.0012082158679017317
chr3	ATG7	11272431	11272709	8	279	114598	8862	114590	8583	0.02867383512544803	13.350809740184085
chr3	TSEN2	12484518	12484880	0	363	49652	4706	49652	4343	0.0	11.432650241768362
chr3	TSEN2	12484629	12484880	0	252	49652	4706	49652	4454	0.0	11.147732375392906
chr3	TSEN2	12484518	12484628	0	111	49652	4706	49652	4595	0.0	10.805658324265506
chr3	MKRN2	12568998	12569003	0	6	133690	8723	133690	8717	0.0	15.336698405414706
chr3	MKRN2	12572110	12572373	11153	264	133690	8723	122537	8459	42.246212121212125	14.48599125192103
chr3	MKRN2	12570253	12570484	12767	232	133690	8723	120923	8491	55.0301724137931	14.24131433282299
chr3	MKRN2	12570485	12570583	0	99	133690	8723	133690	8624	0.0	15.50208719851577
chr3	MKRN2	12557526	12557876	785	351	133690	8723	132905	8372	2.2364672364672367	15.87494027711419
chr3	HDAC11	13480350	13480446	102	97	153	5097	51	5000	1.0515463917525774	0.0102
chr3	XPC-AS1	14145457	14145683	0	227	663	4026	663	3799	0.0	0.17451961042379574
chr3	XPC-AS1	14145684	14145964	0	281	663	4026	663	3745	0.0	0.17703604806408546
chr3	XPC-AS1	14145457	14145964	0	508	663	4026	663	3518	0.0	0.1884593519044912
chr3	SH3BP5-AS1	15260583	15260884	1224	302	20751	6880	19527	6578	4.052980132450331	2.9685314685314683
chr3	SH3BP5-AS1	15257607	15258183	102	577	20751	6880	20649	6303	0.17677642980935876	3.2760590195145167
chr3	BTD	15601648	15601770	408	123	316162	13089	315754	12966	3.317073170731707	24.352460280734228
chr3	BTD	15601771	15601894	459	124	316162	13089	315703	12965	3.7016129032258065	24.35040493636714
chr3	BTD	15601895	15602310	9462	416	316162	13089	306700	12673	22.745192307692307	24.201057366053814
chr3	BTD	15601771	15602310	9921	540	316162	13089	306241	12549	18.372222222222224	24.403617818152842
chr3	GALNT15	16195927	16195957	0	31	10914	6414	10914	6383	0.0	1.709854300485665
chr3	LINC00690	16536433	16536494	0	62	0	3568	0	3506	0.0	0.0
chr3	LINC00690	16536433	16536666	0	234	0	3568	0	3334	0.0	0.0
chr3	LINC00690	16536495	16536666	0	172	0	3568	0	3396	0.0	0.0
chr3	SATB1-AS1	18527247	18527326	0	80	46	12779	46	12699	0.0	0.0036223324671233953
chr3	SATB1-AS1	18530186	18530326	0	141	46	12779	46	12638	0.0	0.0036398164266497864
chr3	RAB5A	19947522	19947863	0	342	204	3774	204	3432	0.0	0.05944055944055944
chr3	SGO1-AS1	20186475	20186658	0	184	2361	6600	2361	6416	0.0	0.3679862842892768
chr3	RPL15	23917174	23917239	0	66	23156	6231	23156	6165	0.0	3.756042173560422
chr3	RPL15	23917174	23917295	21	122	23156	6231	23135	6109	0.1721311475409836	3.787035521361925
chr3	RPL15	23917240	23917295	21	56	23156	6231	23135	6175	0.375	3.746558704453441
chr3	RARB	25428532	25428888	0	357	0	3708	0	3351	0.0	0.0
chr3	LINC01980	27826165	27826211	0	47	51	4756	51	4709	0.0	0.010830324909747292
chr3	LINC01980	27802219	27802370	0	152	51	4756	51	4604	0.0	0.011077324066029539
chr3	LINC01980	27841824	27841925	0	102	51	4756	51	4654	0.0	0.01095831542758917
chr3	CMC1	28241813	28241901	0	89	9497	7283	9497	7194	0.0	1.320127884348068
chr3	GPD1L	32106759	32106817	0	59	0	4164	0	4105	0.0	0.0
chr3	CNOT10	32703898	32703962	0	65	43110	4488	43110	4423	0.0	9.746778204838344
chr3	FBXL2	33378742	33378834	51	93	8054	7427	8003	7334	0.5483870967741935	1.0912189800927188
chr3	LINC01811	34409350	34409361	0	12	51	7983	51	7971	0.0	0.00639819345126082
chr3	ARPP21	35642409	35642431	0	23	0	9631	0	9608	0.0	0.0
chr3	ARPP21	35679693	35679701	0	9	0	9631	0	9622	0.0	0.0
chr3	ARPP21	35717358	35717361	0	4	0	9631	0	9627	0.0	0.0
chr3	ARPP21	35721835	35721837	0	3	0	9631	0	9628	0.0	0.0
chr3	MLH1	37001049	37001053	0	5	53840	6920	53840	6915	0.0	7.785972523499638
chr3	MLH1	36993664	36993890	0	227	53840	6920	53840	6693	0.0	8.0442253100254
chr3	MLH1	36994904	36994953	0	50	53840	6920	53840	6870	0.0	7.836972343522562
chr3	MLH1	36993891	36994037	0	147	53840	6920	53840	6773	0.0	7.949210098922191
chr3	GOLGA4	37289290	37289291	14	2	133844	10768	133830	10766	7.0	12.43080066877206
chr3	MYD88	38140550	38140568	0	19	0	3206	0	3187	0.0	0.0
chr3	MYD88	38140569	38140592	0	24	0	3206	0	3182	0.0	0.0
chr3	MYD88	38140550	38140592	0	43	0	3206	0	3163	0.0	0.0
chr3	OXSR1	38165515	38165946	587	432	40019	6090	39432	5658	1.3587962962962963	6.969247083775185
chr3	EXOG	38497685	38497778	1342	94	42283	4763	40941	4669	14.27659574468085	8.768687085028914
chr3	EXOG	38497690	38497778	1228	89	42283	4763	41055	4674	13.797752808988765	8.78369704749679
chr3	TTC21A	39118154	39118177	0	24	331604	7452	331604	7428	0.0	44.64243403338718
chr3	TTC21A	39137254	39137387	14893	134	331604	7452	316711	7318	111.14179104477611	43.27835474173271
chr3	TTC21A	39110140	39110233	948	94	331604	7452	330656	7358	10.085106382978724	44.93829845066594
chr3	SLC25A38	39390460	39390507	0	48	255	2674	255	2626	0.0	0.09710586443259711
chr3	RPSA	39406765	39406834	0	70	764	3419	764	3349	0.0	0.2281277993430875
chr3	RPSA	39408725	39408739	0	15	764	3419	764	3404	0.0	0.2244418331374853
chr3	RPSA	39406765	39407082	0	318	764	3419	764	3101	0.0	0.24637213801999355
chr3	RPSA	39406835	39407082	0	248	764	3419	764	3171	0.0	0.24093345947650582
chr3	MOBP	39502877	39502914	0	38	4246	9245	4246	9207	0.0	0.46117084826762245
chr3	ENTPD3	40387262	40387391	0	130	93	3600	93	3470	0.0	0.02680115273775216
chr3	RPL14	40457364	40457474	0	111	461	8631	461	8520	0.0	0.05410798122065728
chr3	RPL14	40457475	40457747	0	273	461	8631	461	8358	0.0	0.05515673606125868
chr3	ZNF620	40506126	40506138	746	13	19106	3791	18360	3778	57.38461538461539	4.859714134462679
chr3	ZNF621	40525039	40525274	1679	236	74930	8951	73251	8715	7.114406779661017	8.405163511187608
chr3	CTNNB1	41199623	41199670	0	48	7901	9254	7901	9206	0.0	0.8582446230719096
chr3	CTNNB1	41224754	41224759	0	6	7901	9254	7901	9248	0.0	0.8543468858131488
chr3	CTNNB1	41199671	41199742	0	72	7901	9254	7901	9182	0.0	0.8604879111304726
chr3	CTNNB1	41199623	41199742	0	120	7901	9254	7901	9134	0.0	0.8650098532953799
chr3	CTNNB1	41199743	41199807	0	65	7901	9254	7901	9189	0.0	0.8598324083142889
chr3	VIPR1	42530913	42530932	0	20	0	7402	0	7382	0.0	0.0
chr3	CCDC13-AS1	42743067	42743272	0	206	102	2374	102	2168	0.0	0.0470479704797048
chr3	ZNF662	42906169	42906441	0	273	4641	5905	4641	5632	0.0	0.8240411931818182
chr3	GASK1A	42979365	42979645	0	281	0	4402	0	4121	0.0	0.0
chr3	ZKSCAN7	44555482	44555518	3	37	54	4213	51	4176	0.08108108108108109	0.01221264367816092
chr3	ZNF35	44648812	44648834	0	23	2784	2653	2784	2630	0.0	1.058555133079848
chr3	ZNF502	44712741	44712744	0	4	32313	3260	32313	3256	0.0	9.92414004914005
chr3	ZNF501	44729723	44730015	0	293	204	3914	204	3621	0.0	0.056338028169014086
chr3	EXOSC7	44975477	44975507	9	31	38136	3310	38127	3279	0.2903225806451613	11.627630375114364
chr3	SACM1L	45689498	45690387	3621	890	95271	7303	91650	6413	4.068539325842696	14.291283330734446
chr3	SACM1L	45689546	45690387	2977	842	95271	7303	92294	6461	3.53562945368171	14.284785636898313
chr3	SACM1L	45689498	45689545	644	48	95271	7303	94627	7255	13.416666666666666	13.043004824259132
chr3	CCR3	46264447	46264455	0	9	102	2535	102	2526	0.0	0.040380047505938245
chr3	CCRL2	46407642	46407694	0	53	0	2751	0	2698	0.0	0.0
chr3	PTH1R	46882267	46882464	0	198	992	2734	992	2536	0.0	0.3911671924290221
chr3	ZNF589	48268161	48270969	102	2809	153	5529	51	2720	0.03631185475258099	0.01875
chr3	ATRIP	48446800	48447092	148	293	107889	5446	107741	5153	0.5051194539249146	20.90840287211333
chr3	ARIH2	48924840	48924971	0	132	80206	7097	80206	6965	0.0	11.515577889447236
chr3	P4HTM	49001563	49001628	1212	66	122834	5894	121622	5828	18.363636363636363	20.86856554564173
chr3	WDR6	49008197	49008398	3994	202	137893	4997	133899	4795	19.77227722772277	27.924713242961417
chr3	KLHDC8B	49172802	49173145	30	344	305	2082	275	1738	0.0872093023255814	0.15822784810126583
chr3	DAG1	49510456	49510819	204	364	5155	6735	4951	6371	0.5604395604395604	0.7771150525820122
chr3	DAG1	49470275	49470433	0	159	5155	6735	5155	6576	0.0	0.7839111922141119
chr3	DAG1	49476901	49476905	0	5	5155	6735	5155	6730	0.0	0.7659732540861813
chr3	DAG1	49470275	49470573	0	299	5155	6735	5155	6436	0.0	0.8009633312616532
chr3	DAG1	49470434	49470573	0	140	5155	6735	5155	6595	0.0	0.7816527672479151
chr3	RNF123	49705183	49705186	0	4	575779	6716	575779	6712	0.0	85.78352205005959
chr3	RNF123	49712657	49712892	57010	236	575779	6716	518769	6480	241.5677966101695	80.05694444444444
chr3	RNF123	49689607	49689822	1787	216	575779	6716	573992	6500	8.273148148148149	88.30646153846153
chr3	RBM5	50093784	50093875	51	92	76129	8339	76078	8247	0.5543478260869565	9.22493027767673
chr3	RBM5	50089030	50089057	80	28	76129	8339	76049	8311	2.857142857142857	9.150403080255083
chr3	SEMA3F	50155565	50155843	26540	279	33572	4840	7032	4561	95.12544802867383	1.5417671563253672
chr3	U73166.1	50261317	50262535	0	1219	118	1848	118	629	0.0	0.1875993640699523
chr3	SEMA3B	50271178	50271181	0	4	36176	5099	36176	5095	0.0	7.100294406280668
chr3	SEMA3B	50273315	50273443	105	129	36176	5099	36071	4970	0.813953488372093	7.25774647887324
chr3	CYB561D2	50350985	50350988	0	4	20931	1930	20931	1926	0.0	10.867601246105918
chr3	Z84492.1	50365839	50365940	0	102	155899	1207	155899	1105	0.0	141.08506787330316
chr3	Z84492.1	50365858	50365940	0	83	155899	1207	155899	1124	0.0	138.70017793594306
chr3	Z84492.1	50365839	50365857	0	19	155899	1207	155899	1188	0.0	131.2281144781145
chr3	HEMK1	50571295	50571332	0	38	25305	17946	25305	17908	0.0	1.4130556176010722
chr3	HEMK1	50569546	50569574	0	29	25305	17946	25305	17917	0.0	1.4123458168220127
chr3	HEMK1	50569575	50569811	0	237	25305	17946	25305	17709	0.0	1.4289344401151958
chr3	MAPKAPK3	50617227	50617241	225	15	32564	3892	32339	3877	15.0	8.341243229301005
chr3	TEX264	51671289	51672301	23721	1013	55355	2470	31634	1457	23.416584402764066	21.711736444749484
chr3	TEX264	51671548	51672301	8919	754	55355	2470	46436	1716	11.828912466843502	27.060606060606062
chr3	TEX264	51671332	51672301	21063	970	55355	2470	34292	1500	21.71443298969072	22.861333333333334
chr3	TEX264	51672084	51672301	8919	218	55355	2470	46436	2252	40.91284403669725	20.619893428063943
chr3	TEX264	51671289	51671547	14802	259	55355	2470	40553	2211	57.15057915057915	18.34147444595206
chr3	TEX264	51671332	51671547	12144	216	55355	2470	43211	2254	56.22222222222222	19.17080745341615
chr3	AC097636.1	51827315	51827347	0	33	0	3372	0	3339	0.0	0.0
chr3	ABHD14A-ACY1	51987062	51987453	8959	392	22537	4173	13578	3781	22.854591836734695	3.5911134620470775
chr3	ABHD14A-ACY1	51987625	51988603	5628	979	22537	4173	16909	3194	5.748723186925434	5.2939887288666245
chr3	ABHD14A-ACY1	51986662	51987196	5158	535	22537	4173	17379	3638	9.641121495327102	4.7770753161077515
chr3	GLYCTK	52293175	52293192	0	18	921265	4647	921265	4629	0.0	199.02030676171958
chr3	PHF7	52422837	52422881	185	45	9997	2348	9812	2303	4.111111111111111	4.260529743812419
chr3	NISCH	52481038	52481109	0	72	125322	8309	125322	8237	0.0	15.214519849459755
chr3	SMIM4	52536774	52536906	0	133	602	2486	602	2353	0.0	0.25584360390990224
chr3	GNL3	52686106	52686202	0	97	2570	3110	2570	3013	0.0	0.8529704613342184
chr3	GNL3	52688193	52688206	0	14	2570	3110	2570	3096	0.0	0.8301033591731266
chr3	GNL3	52686203	52686425	0	223	2570	3110	2570	2887	0.0	0.8901974367855906
chr3	ITIH1	52779595	52779877	0	283	6419	4407	6419	4124	0.0	1.556498545101843
chr3	ITIH1	52779985	52780093	702	109	6419	4407	5717	4298	6.440366972477064	1.3301535597952536
chr3	PRKCD	53168812	53168820	0	9	22011	3643	22011	3634	0.0	6.056962025316456
chr3	LINC02030	55230854	55230857	0	4	0	2315	0	2311	0.0	0.0
chr3	CCDC66	56557235	56557253	0	19	7515	7437	7515	7418	0.0	1.0130763008897277
chr3	CCDC66	56566741	56566759	0	19	7515	7437	7515	7418	0.0	1.0130763008897277
chr3	SLMAP	57831531	57831536	0	6	104029	15102	104029	15096	0.0	6.891163222045575
chr3	FLNB	58141897	58141929	132	33	581746	14001	581614	13968	4.0	41.639032073310425
chr3	HTD2	58306418	58306651	408	234	9611	3707	9203	3473	1.7435897435897436	2.6498704290238986
chr3	AC126121.3	59050288	59050352	0	65	2845	3768	2845	3703	0.0	0.7682959762354847
chr3	AC126121.3	59050207	59050352	0	146	2845	3768	2845	3622	0.0	0.7854776366648261
chr3	AC126121.3	59050207	59050287	0	81	2845	3768	2845	3687	0.0	0.7716300515324112
chr3	AC126121.3	59119090	59119841	0	752	2845	3768	2845	3016	0.0	0.9433023872679045
chr3	C3ORF14	62319056	62319232	75960	177	114112	4396	38152	4219	429.1525423728813	9.042901161412656
chr3	SYNPR	63443278	63443469	0	192	0	4059	0	3867	0.0	0.0
chr3	ATXN7	63864689	63864999	752	311	341953	14346	341201	14035	2.418006430868167	24.31072319201995
chr3	PRICKLE2-DT	64448599	64448696	0	98	0	1807	0	1709	0.0	0.0
chr3	ADAMTS9-AS1	64568918	64569059	0	142	663	6303	663	6161	0.0	0.10761240058432073
chr3	ADAMTS9-AS1	64586938	64587251	0	314	663	6303	663	5989	0.0	0.11070295541826682
chr3	ADAMTS9-AS2	65008987	65009068	0	82	0	7987	0	7905	0.0	0.0
chr3	LINC02040	65189313	65189366	0	54	102	858	102	804	0.0	0.12686567164179105
chr3	LINC02040	65191564	65191567	0	4	102	858	102	854	0.0	0.11943793911007025
chr3	AC109587.1	69014061	69014201	0	141	5256	3711	5256	3570	0.0	1.4722689075630253
chr3	AC109587.1	69048305	69048831	0	527	5256	3711	5256	3184	0.0	1.650753768844221
chr3	MITF	69937882	69938049	0	168	0	7172	0	7004	0.0	0.0
chr3	MITF	69939147	69939181	0	35	0	7172	0	7137	0.0	0.0
chr3	SAMMSON	69999621	69999867	0	247	38635	15618	38635	15371	0.0	2.5134994470106045
chr3	LINC00870	72152919	72152998	0	80	2856	8768	2856	8688	0.0	0.3287292817679558
chr3	LINC02018	75435300	75435413	0	114	372	6501	372	6387	0.0	0.05824330671676844
chr3	ROBO2	77644896	77644904	0	9	51	13345	51	13336	0.0	0.0038242351529694063
chr3	LINC02025	84885046	84885123	0	78	0	477	0	399	0.0	0.0
chr3	CHMP2B	87245819	87245908	0	90	0	8249	0	8159	0.0	0.0
chr3	EPHA3	89472523	89472619	0	97	243	6594	243	6497	0.0	0.03740187778974911
chr3	LINC00879	94963007	94963096	0	90	51	6020	51	5930	0.0	0.008600337268128162
chr3	ST3GAL6	98763432	98763439	0	8	0	6312	0	6304	0.0	0.0
chr3	NIT2	100339936	100339954	0	19	51	9224	51	9205	0.0	0.005540467137425313
chr3	NIT2	100334799	100335112	0	314	51	9224	51	8910	0.0	0.005723905723905724
chr3	NIT2	100335098	100335112	0	15	51	9224	51	9209	0.0	0.005538060592898251
chr3	TFG	100736705	100736716	0	12	2007	6506	2007	6494	0.0	0.30905451185709887
chr3	TFG	100709432	100709588	0	157	2007	6506	2007	6349	0.0	0.3161127736651441
chr3	TFG	100709432	100709721	0	290	2007	6506	2007	6216	0.0	0.32287644787644787
chr3	TFG	100709589	100709721	0	133	2007	6506	2007	6373	0.0	0.3149223285736702
chr3	TFG	100709722	100709821	138	100	2007	6506	1869	6406	1.38	0.2917577271308149
chr3	NXPE3	101779901	101779934	0	34	0	9079	0	9045	0.0	0.0
chr3	AC106712.1	101994669	101994897	0	229	0	2160	0	1931	0.0	0.0
chr3	AC106712.1	101960463	101960731	0	269	0	2160	0	1891	0.0	0.0
chr3	DUBR	107240957	107241087	0	131	4208	13361	4208	13230	0.0	0.3180650037792895
chr3	DUBR	107246053	107246137	0	85	4208	13361	4208	13276	0.0	0.31696294064477254
chr3	DUBR	107246053	107247088	0	1036	4208	13361	4208	12325	0.0	0.34141987829614606
chr3	DUBR	107246138	107247088	0	951	4208	13361	4208	12410	0.0	0.33908138597904913
chr3	DUBR	107246210	107247088	0	879	4208	13361	4208	12482	0.0	0.33712546066335525
chr3	DUBR	107246053	107246209	0	157	4208	13361	4208	13204	0.0	0.31869130566495
chr3	DUBR	107246138	107246209	0	72	4208	13361	4208	13289	0.0	0.31665287079539467
chr3	DUBR	107285532	107286177	0	646	4208	13361	4208	12715	0.0	0.33094769956744
chr3	BBX	107798712	107798720	0	9	182956	11767	182956	11758	0.0	15.560129273686002
chr3	BBX	107525488	107525490	115	3	182956	11767	182841	11764	38.333333333333336	15.542417545052704
chr3	BBX	107645910	107646087	0	178	182956	11767	182956	11589	0.0	15.787039433945983
chr3	DZIP3	108634959	108634972	0	14	58	6978	58	6964	0.0	0.00832854681217691
chr3	C3ORF85	109148362	109148386	0	25	0	2477	0	2452	0.0	0.0
chr3	NECTIN3	111072178	111072510	0	333	0	7708	0	7375	0.0	0.0
chr3	CD96	111545329	111545402	0	74	20730	5571	20730	5497	0.0	3.77114789885392
chr3	AC112487.1	112327695	112327706	0	12	32302	1269	32302	1257	0.0	25.69769291964996
chr3	SLC35A5	112562240	112562273	0	34	0	4736	0	4702	0.0	0.0
chr3	BOC	113216275	113216278	0	4	1479	8933	1479	8929	0.0	0.16564004927763468
chr3	BOC	113216279	113216420	612	142	1479	8933	867	8791	4.309859154929577	0.09862359231031737
chr3	BOC	113216275	113216420	612	146	1479	8933	867	8787	4.191780821917808	0.09866848753840901
chr3	ATP6V1A	113747114	113747127	0	14	40516	5135	40516	5121	0.0	7.911735989064636
chr3	GRAMD1C	113890760	113891024	0	265	0	5906	0	5641	0.0	0.0
chr3	ZDHHC23	113948187	113948190	0	4	102	4793	102	4789	0.0	0.021298809772395073
chr3	QTRT2	114065279	114065457	0	179	531	8066	531	7887	0.0	0.06732597945987068
chr3	QTRT2	114057022	114057106	0	85	531	8066	531	7981	0.0	0.06653301591279288
chr3	ZBTB20-AS1	114366799	114366881	0	83	12	5834	12	5751	0.0	0.0020865936358894104
chr3	ZBTB20-AS1	114367029	114367221	0	193	12	5834	12	5641	0.0	0.002127282396738167
chr3	TUSC7	116709877	116710060	0	184	51	2806	51	2622	0.0	0.019450800915331808
chr3	TUSC7	116709877	116710421	51	545	51	2806	0	2261	0.09357798165137615	0.0
chr3	TUSC7	116712508	116712857	0	350	51	2806	51	2456	0.0	0.020765472312703582
chr3	TUSC7	116712600	116712857	0	258	51	2806	51	2548	0.0	0.020015698587127158
chr3	TUSC7	116712508	116712599	0	92	51	2806	51	2714	0.0	0.01879145173176124
chr3	POGLUT1	119469007	119469106	0	100	840	4635	840	4535	0.0	0.185226019845645
chr3	POGLUT1	119486933	119487036	0	104	840	4635	840	4531	0.0	0.1853895387331715
chr3	POGLUT1	119469007	119469258	0	252	840	4635	840	4383	0.0	0.19164955509924708
chr3	POGLUT1	119469107	119469258	0	152	840	4635	840	4483	0.0	0.18737452598706222
chr3	TIMMDC1	119498928	119498942	0	15	102	2722	102	2707	0.0	0.03768008865903214
chr3	TIMMDC1	119498928	119498933	0	6	102	2722	102	2716	0.0	0.03755522827687776
chr3	ADPRH	119579852	119580636	0	785	14329	4454	14329	3669	0.0	3.905423821204688
chr3	PLA1A	119608900	119608947	0	48	51	2183	51	2135	0.0	0.023887587822014052
chr3	CFAP91	119703223	119703271	26	49	4649	6291	4623	6242	0.5306122448979592	0.7406280038449214
chr3	NDUFB4	120596540	120596646	0	107	0	1312	0	1205	0.0	0.0
chr3	CD86	122077917	122078045	0	129	5610	3432	5610	3303	0.0	1.698455949137148
chr3	PARP14	122720389	122721653	0	1265	74	9853	74	8588	0.0	0.008616674429436423
chr3	SEC22A	123204785	123204813	0	29	1888	4714	1888	4685	0.0	0.40298826040554964
chr3	SEC22A	123202135	123202178	0	44	1888	4714	1888	4670	0.0	0.4042826552462527
chr3	MYLK-AS1	123585795	123585801	0	7	2670	4501	2670	4494	0.0	0.5941255006675568
chr3	KALRN	124395305	124395343	0	39	54659	24411	54659	24372	0.0	2.2426965370096834
chr3	UMPS	124738240	124738443	5343	204	25440	7521	20097	7317	26.191176470588236	2.7466174661746616
chr3	FAM86JP	125916720	125916817	0	98	0	2527	0	2429	0.0	0.0
chr3	ALDH1L1-AS2	126180366	126180544	56178	179	75064	2713	18886	2534	313.8435754189944	7.45303867403315
chr3	AC079848.2	126214115	126214861	0	747	0	3126	0	2379	0.0	0.0
chr3	AC079848.2	126214862	126215697	0	836	0	3126	0	2290	0.0	0.0
chr3	AC079848.2	126214115	126215697	0	1583	0	3126	0	1543	0.0	0.0
chr3	AC016924.1	126288124	126289853	1734	1730	4692	5692	2958	3962	1.0023121387283238	0.7465926299848561
chr3	ABTB1	127674419	127674453	0	35	816	3340	816	3305	0.0	0.24689863842662632
chr3	KBTBD12	127923548	127924131	0	584	1275	5361	1275	4777	0.0	0.2669039145907473
chr3	KBTBD12	127927835	127928034	969	200	1275	5361	306	5161	4.845	0.05929083510947491
chr3	GATA2-AS1	128489416	128489670	3570	255	6972	2908	3402	2653	14.0	1.2823218997361479
chr3	RAB7A	128806450	128806590	6996	141	20331	6281	13335	6140	49.61702127659574	2.1718241042345277
chr3	ACAD9	128879842	128880017	12461	176	49134	4320	36673	4144	70.80113636363636	8.849662162162161
chr3	COPG1	129250735	129250894	0	160	3618	4374	3618	4214	0.0	0.8585666824869482
chr3	HMCES	129279044	129279203	0	160	4774	2754	4774	2594	0.0	1.8404009252120277
chr3	HMCES	129279204	129279211	0	8	4774	2754	4774	2746	0.0	1.7385287691187181
chr3	HMCES	129279044	129279211	0	168	4774	2754	4774	2586	0.0	1.846094354215004
chr3	IFT122	129451973	129451998	0	26	2034	9056	2034	9030	0.0	0.22524916943521595
chr3	TMCC1-AS1	129893928	129894131	0	204	204	4285	204	4081	0.0	0.049987748100955645
chr3	TRH	129976016	129976027	0	12	0	1595	0	1583	0.0	0.0
chr3	ALG1L2	130094468	130094513	0	46	0	1509	0	1463	0.0	0.0
chr3	COL6A6	130594344	130594419	0	76	25788	9757	25788	9681	0.0	2.663774403470716
chr3	ATP2C1	131001315	131001344	0	30	302	8544	302	8514	0.0	0.03547098895936105
chr3	NUDT16P1	131362069	131362071	0	3	0	2312	0	2309	0.0	0.0
chr3	AC107027.1	131503003	131503084	0	82	0	1234	0	1152	0.0	0.0
chr3	AC107027.1	131503085	131503094	0	10	0	1234	0	1224	0.0	0.0
chr3	AC107027.1	131503003	131503094	0	92	0	1234	0	1142	0.0	0.0
chr3	AC107027.1	131503085	131503098	0	14	0	1234	0	1220	0.0	0.0
chr3	AC107027.1	131503095	131503098	0	4	0	1234	0	1230	0.0	0.0
chr3	DNAJC13	132484489	132484493	0	5	3886	9689	3886	9684	0.0	0.4012804626187526
chr3	UBA5	132660699	132661048	0	350	173	7275	173	6925	0.0	0.024981949458483754
chr3	CDV3	133574181	133574284	0	104	25	3245	25	3141	0.0	0.00795924864692773
chr3	CDV3	133574552	133574592	0	41	25	3245	25	3204	0.0	0.007802746566791511
chr3	CDV3	133574552	133574742	0	191	25	3245	25	3054	0.0	0.008185985592665358
chr3	CDV3	133574593	133574742	0	150	25	3245	25	3095	0.0	0.008077544426494346
chr3	CDV3	133574743	133574756	0	14	25	3245	25	3231	0.0	0.00773754255648406
chr3	TF	133748585	133748669	3012	85	5952	22311	2940	22226	35.43529411764706	0.13227751282282013
chr3	CEP63	134532901	134533030	0	130	51	8593	51	8463	0.0	0.006026231832683446
chr3	CEP63	134537212	134537268	0	57	51	8593	51	8536	0.0	0.005974695407685099
chr3	CEP63	134486053	134486202	0	150	51	8593	51	8443	0.0	0.006040506928816771
chr3	CEP63	134486162	134486202	0	41	51	8593	51	8552	0.0	0.005963517305893358
chr3	CEP63	134486053	134486161	0	109	51	8593	51	8484	0.0	0.006011315417256012
chr3	CEP63	134559306	134559429	0	124	51	8593	51	8469	0.0	0.0060219624512929506
chr3	EPHB1	134951719	134952052	0	334	98	6987	98	6653	0.0	0.014730196903652487
chr3	PCCB	136255385	136255533	0	149	258	7380	258	7231	0.0	0.03567971234960586
chr3	PCCB	136255418	136255533	0	116	258	7380	258	7264	0.0	0.03551762114537445
chr3	PCCB	136255385	136255417	0	33	258	7380	258	7347	0.0	0.03511637403021641
chr3	SLC35G2	136819215	136819628	0	414	0	3849	0	3435	0.0	0.0
chr3	NCK1	136862320	136862353	0	34	15	5120	15	5086	0.0	0.002949272512780181
chr3	LINC01210	137772131	137772282	7	152	5676	3221	5669	3069	0.046052631578947366	1.8471814923427827
chr3	ESYT3	138468882	138468885	0	4	21401	9838	21401	9834	0.0	2.176225340654871
chr3	FAIM	138622393	138622416	0	24	1128	4080	1128	4056	0.0	0.2781065088757396
chr3	FAIM	138621265	138621282	0	18	1128	4080	1128	4062	0.0	0.2776957163958641
chr3	AC046134.2	139389934	139390247	0	314	12	9175	12	8861	0.0	0.001354248956099763
chr3	AC046134.2	139390238	139390247	0	10	12	9175	12	9165	0.0	0.001309328968903437
chr3	AC046134.2	139389934	139390237	0	304	12	9175	12	8871	0.0	0.0013527223537368955
chr3	AC046134.2	139390248	139390429	0	182	12	9175	12	8993	0.0	0.0013343711775825643
chr3	AC046134.2	139390238	139390429	0	192	12	9175	12	8983	0.0	0.0013358566180563286
chr3	AC046134.2	139389934	139390429	0	496	12	9175	12	8679	0.0	0.00138264777048047
chr3	RASA2	141487183	141487216	0	34	11874	6023	11874	5989	0.0	1.982634830522625
chr3	RNF7	141738510	141738516	0	7	4080	2786	4080	2779	0.0	1.4681540122346168
chr3	AC021074.3	142936334	142936646	0	313	51	5484	51	5171	0.0	0.009862695803519629
chr3	AC021074.3	142936286	142936333	0	48	51	5484	51	5436	0.0	0.009381898454746136
chr3	U2SURP	143021383	143021385	0	3	51	10970	51	10967	0.0	0.004650314580103948
chr3	DIPK2A	143973256	143973562	0	307	0	5462	0	5155	0.0	0.0
chr3	ZIC1	147508048	147508052	0	5	0	6832	0	6827	0.0	0.0
chr3	AGTR1	148698128	148698149	0	22	117902	3461	117902	3439	0.0	34.283803431230005
chr3	AGTR1	148730238	148730509	0	272	117902	3461	117902	3189	0.0	36.97146440890561
chr3	GYG1	148996428	148996476	0	49	1722	7100	1722	7051	0.0	0.24422067791802582
chr3	GYG1	148996893	148996904	0	12	1722	7100	1722	7088	0.0	0.24294582392776523
chr3	RNF13	149813175	149813353	0	179	0	3524	0	3345	0.0	0.0
chr3	RNF13	149895561	149895570	0	10	0	3524	0	3514	0.0	0.0
chr3	RNF13	149814027	149814331	0	305	0	3524	0	3219	0.0	0.0
chr3	LINC01213	150238999	150239175	0	177	0	1723	0	1546	0.0	0.0
chr3	SELENOT	150618804	150618928	81	125	90	4144	9	4019	0.648	0.002239363025628266
chr3	SELENOT	150603500	150603686	0	187	90	4144	90	3957	0.0	0.022744503411675512
chr3	LINC02877	153486106	153486182	0	77	0	1290	0	1213	0.0	0.0
chr3	MME	155080296	155080466	0	171	0	9595	0	9424	0.0	0.0
chr3	MME	155080235	155080466	0	232	0	9595	0	9363	0.0	0.0
chr3	MME	155080235	155080295	0	61	0	9595	0	9534	0.0	0.0
chr3	LEKR1	156826377	156827109	0	733	0	5318	0	4585	0.0	0.0
chr3	LEKR1	156826881	156827109	0	229	0	5318	0	5089	0.0	0.0
chr3	LINC02029	157082580	157082918	0	339	96	2326	96	1987	0.0	0.04831404126824358
chr3	LINC02029	157088012	157088016	0	5	96	2326	96	2321	0.0	0.04136148211977596
chr3	RSRC1	158110198	158110211	0	14	67288	5081	67288	5067	0.0	13.27965265443063
chr3	RSRC1	158110212	158110223	0	12	67288	5081	67288	5069	0.0	13.274413099230618
chr3	RSRC1	158110198	158110223	0	26	67288	5081	67288	5055	0.0	13.311177052423343
chr3	MLF1	158571348	158571391	0	44	20	3749	20	3705	0.0	0.005398110661268556
chr3	MLF1	158593422	158593426	0	5	20	3749	20	3744	0.0	0.005341880341880342
chr3	GFM1	158644716	158644881	48	166	204	10963	156	10797	0.2891566265060241	0.014448457904973604
chr3	MFSD1	158802285	158802315	0	31	27	3754	27	3723	0.0	0.007252215954875101
chr3	MFSD1	158802568	158802615	0	48	27	3754	27	3706	0.0	0.007285483000539665
chr3	IQCJ-SCHIP1	159765100	159765138	0	39	1453	4426	1453	4387	0.0	0.3312058354228402
chr3	IQCJ-SCHIP1	159252800	159252807	0	8	1453	4426	1453	4418	0.0	0.32888184698958806
chr3	IQCJ-SCHIP1	159764225	159764350	0	126	1453	4426	1453	4300	0.0	0.33790697674418607
chr3	SMC4	160399698	160399749	0	52	306	7681	306	7629	0.0	0.04011010617381046
chr3	SMC4	160411978	160412084	0	107	306	7681	306	7574	0.0	0.040401373118563504
chr3	SMC4	160399750	160400965	102	1216	306	7681	204	6465	0.08388157894736842	0.03155452436194896
chr3	NMD3	161225019	161225064	0	46	0	4761	0	4715	0.0	0.0
chr3	NMD3	161221332	161221409	0	78	0	4761	0	4683	0.0	0.0
chr3	NMD3	161221332	161221724	0	393	0	4761	0	4368	0.0	0.0
chr3	NMD3	161221410	161221724	0	315	0	4761	0	4446	0.0	0.0
chr3	NMD3	161221725	161221735	0	11	0	4761	0	4750	0.0	0.0
chr3	LINC01322	165382908	165382959	0	52	0	14499	0	14447	0.0	0.0
chr3	LINC01322	165495267	165495290	0	24	0	14499	0	14475	0.0	0.0
chr3	LINC01322	165474238	165474241	0	4	0	14499	0	14495	0.0	0.0
chr3	SERPINI1	167735813	167735823	0	11	1372	2135	1372	2124	0.0	0.6459510357815442
chr3	SERPINI1	167735824	167736135	850	312	1372	2135	522	1823	2.7243589743589745	0.2863411958310477
chr3	SERPINI1	167735813	167736135	850	323	1372	2135	522	1812	2.6315789473684212	0.28807947019867547
chr3	LRRC77P	167877724	167877735	0	12	0	5364	0	5352	0.0	0.0
chr3	LRRC77P	167905953	167906055	0	103	0	5364	0	5261	0.0	0.0
chr3	LRRC77P	167917469	167917496	0	28	0	5364	0	5336	0.0	0.0
chr3	LRRC77P	167915156	167915203	0	48	0	5364	0	5316	0.0	0.0
chr3	SAMD7	169915442	169915464	0	23	4	2522	4	2499	0.0	0.001600640256102441
chr3	GPR160	170077417	170077923	22958	507	33204	4391	10246	3884	45.282051282051285	2.638002059732235
chr3	SKIL	170384628	170384765	0	138	511	7601	511	7463	0.0	0.06847112421278306
chr3	SLC7A14-AS1	170467292	170467396	0	105	4490	8751	4490	8646	0.0	0.5193152903076568
chr3	ECT2	172764414	172764500	0	87	0	5475	0	5388	0.0	0.0
chr3	ECT2	172752437	172752472	0	36	0	5475	0	5439	0.0	0.0
chr3	ECT2	172752273	172752472	0	200	0	5475	0	5275	0.0	0.0
chr3	ECT2	172752273	172752436	0	164	0	5475	0	5311	0.0	0.0
chr3	NLGN1	174275501	174275527	0	27	51	10163	51	10136	0.0	0.005031570639305446
chr3	TBL1XR1-AS1	177044985	177044996	0	12	255	859	255	847	0.0	0.3010625737898465
chr3	AC007953.1	177935337	177935484	0	148	153	3306	153	3158	0.0	0.04844838505383154
chr3	AC007620.2	179397942	179397993	0	52	51	1943	51	1891	0.0	0.026969857218402962
chr3	ACTL6A	179562974	179563165	0	192	0	3491	0	3299	0.0	0.0
chr3	ACTL6A	179563118	179563165	0	48	0	3491	0	3443	0.0	0.0
chr3	ACTL6A	179562974	179563117	0	144	0	3491	0	3347	0.0	0.0
chr3	LINC02053	180414397	180414457	0	61	0	2746	0	2685	0.0	0.0
chr3	TTC14	180607766	180608271	153	506	1518	5485	1365	4979	0.30237154150197626	0.2741514360313316
chr3	TTC14	180604310	180604338	0	29	1518	5485	1518	5456	0.0	0.2782258064516129
chr3	FXR1	180915529	180915631	0	103	103	11810	103	11707	0.0	0.008798154950029898
chr3	SOX2-OT	180989841	180989852	0	12	302	31226	302	31214	0.0	0.009675145767924649
chr3	SOX2-OT	181175268	181175378	0	111	302	31226	302	31115	0.0	0.009705929615940865
chr3	SOX2-OT	181778663	181778669	0	7	302	31226	302	31219	0.0	0.009673596207437778
chr3	LINC01206	182000446	182000506	0	61	51	11383	51	11322	0.0	0.0045045045045045045
chr3	LINC01206	182000470	182000506	0	37	51	11383	51	11346	0.0	0.004494976203067161
chr3	LINC01206	182001368	182001760	0	393	51	11383	51	10990	0.0	0.004640582347588717
chr3	LINC01206	182001463	182001760	0	298	51	11383	51	11085	0.0	0.004600811907983762
chr3	LINC01206	181971720	181971734	0	15	51	11383	51	11368	0.0	0.004486277269528501
chr3	LINC01206	181984432	181984491	0	60	51	11383	51	11323	0.0	0.004504106685507375
chr3	LINC01206	181953738	181953756	0	19	51	11383	51	11364	0.0	0.004487856388595565
chr3	LINC01206	182000507	182000508	0	2	51	11383	51	11381	0.0	0.004481152798523856
chr3	LINC01206	182000446	182000508	0	63	51	11383	51	11320	0.0	0.00450530035335689
chr3	LINC01206	182000470	182000508	0	39	51	11383	51	11344	0.0	0.004495768688293371
chr3	LINC01206	182000446	182000469	0	24	51	11383	51	11359	0.0	0.00448983185139537
chr3	LINC01206	182001368	182001462	0	95	51	11383	51	11288	0.0	0.004518072289156626
chr3	LINC01206	181952471	181952923	0	453	51	11383	51	10930	0.0	0.004666056724611162
chr3	LINC01206	181967553	181967946	0	394	51	11383	51	10989	0.0	0.004641004641004641
chr3	ATP11B	182880948	182880981	0	34	1320	9220	1320	9186	0.0	0.14369693011103854
chr3	B3GNT5	183253563	183253675	0	113	102	8058	102	7945	0.0	0.012838263058527376
chr3	B3GNT5	183265507	183265523	0	17	102	8058	102	8041	0.0	0.012684989429175475
chr3	LINC00888	183447766	183447947	102	182	5100	1843	4998	1661	0.5604395604395604	3.009030704394943
chr3	KLHL24	183635783	183635793	0	11	85262	8653	85262	8642	0.0	9.866003239990743
chr3	KLHL24	183635748	183635793	0	46	85262	8653	85262	8607	0.0	9.906122923202044
chr3	KLHL24	183635748	183635782	0	35	85262	8653	85262	8618	0.0	9.893478765374796
chr3	HTR3D	184036506	184036544	0	39	411438	1963	411438	1924	0.0	213.84511434511435
chr3	HTR3E	184104292	184104369	0	78	30	2479	30	2401	0.0	0.012494793835901708
chr3	EIF2B5	184140158	184140221	0	64	51	6302	51	6238	0.0	0.00817569733889067
chr3	EIF2B5	184140616	184140730	0	115	51	6302	51	6187	0.0	0.008243090350735413
chr3	EIF2B5	184142379	184142394	0	16	51	6302	51	6286	0.0	0.008113267578746421
chr3	EIF2B5	184135581	184135916	0	336	51	6302	51	5966	0.0	0.008548441166610795
chr3	EIF2B5	184135749	184135916	0	168	51	6302	51	6134	0.0	0.008314313661558527
chr3	EIF2B5	184140731	184140740	0	10	51	6302	51	6292	0.0	0.00810553083280356
chr3	EIF2B5	184140616	184140740	0	125	51	6302	51	6177	0.0	0.00825643516270034
chr3	EIF2B5	184135581	184135748	0	168	51	6302	51	6134	0.0	0.008314313661558527
chr3	AP2M1	184174960	184175110	0	151	204	4554	204	4403	0.0	0.04633204633204633
chr3	AP2M1	184180651	184180741	0	91	204	4554	204	4463	0.0	0.045709164239300916
chr3	ABCF3	184186637	184186654	0	18	153	4985	153	4967	0.0	0.03080330179182605
chr3	ECE2	184276568	184276705	0	138	103	4745	103	4607	0.0	0.022357282396353376
chr3	PSMD2	184299402	184299633	62	232	102	4392	40	4160	0.2672413793103448	0.009615384615384616
chr3	EIF4G1	184317432	184317497	0	66	255	7868	255	7802	0.0	0.03268392719815432
chr3	EIF4G1	184323219	184323241	0	23	255	7868	255	7845	0.0	0.032504780114722756
chr3	EIF4G1	184319802	184320297	0	496	255	7868	255	7372	0.0	0.03459034183396636
chr3	EIF4G1	184320502	184320537	0	36	255	7868	255	7832	0.0	0.03255873340143003
chr3	EIF4G1	184325952	184325957	0	6	255	7868	255	7862	0.0	0.03243449503943017
chr3	FAM131A	184337372	184337718	0	347	30	7862	30	7515	0.0	0.003992015968063872
chr3	FAM131A	184344805	184344913	0	109	30	7862	30	7753	0.0	0.0038694698826260802
chr3	POLR2H	184363566	184363574	0	9	51	3089	51	3080	0.0	0.016558441558441557
chr3	AC107294.2	184734101	184734240	0	140	102	3702	102	3562	0.0	0.028635597978663673
chr3	VPS8	184839753	184839758	0	6	5510	9433	5510	9427	0.0	0.5844913546197094
chr3	MAP3K13	185428947	185429056	15	110	86887	12248	86872	12138	0.13636363636363635	7.157027516889109
chr3	MAP3K13	185283028	185283119	368	92	86887	12248	86519	12156	4.0	7.117390589009543
chr3	NMRAL2P	185968650	185968708	0	59	0	2634	0	2575	0.0	0.0
chr3	NMRAL2P	185968650	185968717	0	68	0	2634	0	2566	0.0	0.0
chr3	NMRAL2P	185968709	185968717	0	9	0	2634	0	2625	0.0	0.0
chr3	LINC02020	186441122	186441179	0	58	51	3478	51	3420	0.0	0.014912280701754385
chr3	LINC02020	186440410	186440448	0	39	51	3478	51	3439	0.0	0.014829892410584472
chr3	LINC02020	186445250	186445953	0	704	51	3478	51	2774	0.0	0.018385003604902667
chr3	LINC02020	186445834	186445953	0	120	51	3478	51	3358	0.0	0.015187611673615247
chr3	LINC02020	186441180	186442081	51	902	51	3478	0	2576	0.0565410199556541	0.0
chr3	LINC02020	186441122	186442081	51	960	51	3478	0	2518	0.053125	0.0
chr3	LINC02020	186445250	186445833	0	584	51	3478	51	2894	0.0	0.017622667588113337
chr3	LINC02020	186440410	186440455	0	46	51	3478	51	3432	0.0	0.01486013986013986
chr3	LINC02020	186440449	186440455	0	7	51	3478	51	3471	0.0	0.014693171996542784
chr3	FETUB	186640686	186640689	0	4	400	2000	400	1996	0.0	0.20040080160320642
chr3	TP63	189868705	189868716	0	12	649	7496	649	7484	0.0	0.0867183324425441
chr3	AC073365.1	191559751	191559754	0	4	0	8311	0	8307	0.0	0.0
chr3	AC073365.1	191546112	191546115	0	4	0	8311	0	8307	0.0	0.0
chr3	AC073365.1	191557289	191557384	0	96	0	8311	0	8215	0.0	0.0
chr3	AC073365.1	191559755	191559969	0	215	0	8311	0	8096	0.0	0.0
chr3	AC073365.1	191559751	191559969	0	219	0	8311	0	8092	0.0	0.0
chr3	AC026320.1	192029907	192030039	0	133	0	906	0	773	0.0	0.0
chr3	OPA1	193655028	193655052	0	25	357	9079	357	9054	0.0	0.039430086149768055
chr3	AC024559.2	194078266	194078294	0	29	714	1312	714	1283	0.0	0.5565081839438816
chr3	AC024559.2	194070276	194070326	0	51	714	1312	714	1261	0.0	0.5662172878667724
chr3	LINC01968	194708539	194709147	0	609	1184	9041	1184	8432	0.0	0.14041745730550284
chr3	LINC01968	194708596	194709147	0	552	1184	9041	1184	8489	0.0	0.13947461420662033
chr3	LINC01968	194708539	194708595	0	57	1184	9041	1184	8984	0.0	0.13178984861976847
chr3	LINC01968	194769784	194769811	0	28	1184	9041	1184	9013	0.0	0.13136580494840785
chr3	MUC20-OT1	195663768	195663832	1800	65	188855	13794	187055	13729	27.692307692307693	13.624808798892854
chr3	MUC20-OT1	195701433	195701669	624	237	188855	13794	188231	13557	2.632911392405063	13.884413955889945
chr3	MUC20-OT1	195701496	195701669	172	174	188855	13794	188683	13620	0.9885057471264368	13.853377386196769
chr3	MUC20-OT1	195686619	195686718	6108	100	188855	13794	182747	13694	61.08	13.345041624068935
chr3	MUC20-OT1	195699179	195699207	0	29	188855	13794	188855	13765	0.0	13.719941881583727
chr3	MUC20-OT1	195686348	195686389	430	42	188855	13794	188425	13752	10.238095238095237	13.701643397324025
chr3	MUC20-OT1	195685940	195685947	826	8	188855	13794	188029	13786	103.25	13.639126650224865
chr3	MUC20-OT1	195708269	195708435	611	167	188855	13794	188244	13627	3.658682634730539	13.81404564467601
chr3	MUC20-OT1	195708388	195708435	60	48	188855	13794	188795	13746	1.25	13.734540957369417
chr3	MUC20-OT1	195708329	195708435	89	107	188855	13794	188766	13687	0.8317757009345794	13.7916270914006
chr3	MUC20-OT1	195701433	195701495	452	63	188855	13794	188403	13731	7.174603174603175	13.72099628577671
chr3	MUC20-OT1	195708269	195708387	551	119	188855	13794	188304	13675	4.630252100840337	13.769945155393053
chr3	MUC20-OT1	195708329	195708387	29	59	188855	13794	188826	13735	0.4915254237288136	13.747797597378959
chr3	MUC20-OT1	195708436	195708513	574	78	188855	13794	188281	13716	7.358974358974359	13.727107028288131
chr3	MUC20-OT1	195689439	195689608	4790	170	188855	13794	184065	13624	28.176470588235293	13.510349383440987
chr3	MUC20-OT1	195708269	195708328	522	60	188855	13794	188333	13734	8.7	13.712902286296782
chr3	MUC20-OT1	195708269	195708513	1185	245	188855	13794	187670	13549	4.836734693877551	13.851206731124067
chr3	MUC20-OT1	195708388	195708513	634	126	188855	13794	188221	13668	5.031746031746032	13.770924787825578
chr3	MUC20-OT1	195708329	195708513	663	185	188855	13794	188192	13609	3.5837837837837836	13.82849584833566
chr3	MUC20-OT1	195708436	195708555	626	120	188855	13794	188229	13674	5.216666666666667	13.765467310223782
chr3	MUC20-OT1	195708514	195708555	52	42	188855	13794	188803	13752	1.2380952380952381	13.72913030831879
chr3	LINC00885	196143001	196143270	102	270	374	2164	272	1894	0.37777777777777777	0.14361140443505807
chr3	LINC00885	196143001	196143409	102	409	374	2164	272	1755	0.24938875305623473	0.15498575498575498
chr3	LINC00885	196143271	196143409	0	139	374	2164	374	2025	0.0	0.18469135802469136
chr3	AC069257.1	196250663	196250689	0	27	0	431	0	404	0.0	0.0
chr3	FBXO45	196568788	196569302	0	515	7344	5979	7344	5464	0.0	1.3440702781844802
chr3	DLG1-AS1	197298382	197298610	0	229	1937	2141	1937	1912	0.0	1.0130753138075315
chr3	DLG1-AS1	197299093	197299439	0	347	1937	2141	1937	1794	0.0	1.0797101449275361
chr3	LRCH3	197835739	197835822	0	84	0	12658	0	12574	0.0	0.0
chr3	RPL35A	197950222	197950299	31	78	5798	2565	5767	2487	0.3974358974358974	2.3188580619219943
chr3	RPL35A	197951312	197951328	0	17	5798	2565	5798	2548	0.0	2.2755102040816326
chr3	LMLN	197960225	197960319	0	95	0	8699	0	8604	0.0	0.0
chr3	LMLN	197960320	197960440	0	121	0	8699	0	8578	0.0	0.0
chr3	LMLN	197960225	197960440	0	216	0	8699	0	8483	0.0	0.0
chr3	IL5RA	3109944	3109998	0	55	51	6583	51	6528	0.0	0.0078125
chr3	LMCD1-AS1	8494666	8494679	0	14	3629	11271	3629	11257	0.0	0.3223771875277605
chr3	SSUH2	8626913	8627696	0	784	515	6307	515	5523	0.0	0.09324642404490313
chr3	SSUH2	8623448	8623547	0	100	515	6307	515	6207	0.0	0.08297083937489931
chr3	OXTR	8769230	8769252	0	23	51	4518	51	4495	0.0	0.011345939933259178
chr3	RAD18	8947219	8947241	0	23	5501	6999	5501	6976	0.0	0.7885607798165137
chr3	THUMPD3-AS1	9393987	9395504	1581	1518	14563	6225	12982	4707	1.041501976284585	2.758019970257064
chr3	THUMPD3-AS1	9393987	9396558	6375	2572	14563	6225	8188	3653	2.478615863141524	2.2414453873528606
chr3	THUMPD3-AS1	9390884	9391677	5724	794	14563	6225	8839	5431	7.209068010075566	1.6275087460872768
chr3	THUMPD3-AS1	9390884	9391425	1535	542	14563	6225	13028	5683	2.8321033210332103	2.2924511701566073
chr3	THUMPD3-AS1	9390884	9391703	6779	820	14563	6225	7784	5405	8.267073170731708	1.4401480111008325
chr3	THUMPD3-AS1	9390884	9391105	0	222	14563	6225	14563	6003	0.0	2.425953689821756
chr3	THUMPD3-AS1	9390884	9391080	0	197	14563	6225	14563	6028	0.0	2.415892501658925
chr3	THUMPD3-AS1	9391678	9391703	1055	26	14563	6225	13508	6199	40.57692307692308	2.17906113889337
chr3	THUMPD3-AS1	9390279	9390288	0	10	14563	6225	14563	6215	0.0	2.3432019308125502
chr3	THUMPD3-AS1	9391426	9391677	4189	252	14563	6225	10374	5973	16.623015873015873	1.7368156705173279
chr3	THUMPD3-AS1	9391426	9391703	5244	278	14563	6225	9319	5947	18.863309352517987	1.5670085757524803
chr3	THUMPD3-AS1	9394174	9396558	6375	2385	14563	6225	8188	3840	2.6729559748427674	2.1322916666666667
chr3	THUMPD3-AS1	9394174	9395504	1581	1331	14563	6225	12982	4894	1.1878287002253944	2.6526358806702084
chr3	THUMPD3-AS1	9394174	9396546	6375	2373	14563	6225	8188	3852	2.686472819216182	2.1256490134994808
chr3	THUMPD3-AS1	9391106	9391677	5724	572	14563	6225	8839	5653	10.006993006993007	1.5635945515655405
chr3	THUMPD3-AS1	9391106	9391425	1535	320	14563	6225	13028	5905	4.796875	2.2062658763759524
chr3	THUMPD3-AS1	9391106	9391703	6779	598	14563	6225	7784	5627	11.336120401337793	1.383330371423494
chr3	THUMPD3-AS1	9396547	9396558	0	12	14563	6225	14563	6213	0.0	2.3439562208272977
chr3	THUMPD3-AS1	9391081	9391677	5724	597	14563	6225	8839	5628	9.587939698492463	1.570540156361052
chr3	THUMPD3-AS1	9391081	9391425	1535	345	14563	6225	13028	5880	4.449275362318841	2.2156462585034014
chr3	THUMPD3-AS1	9391081	9391703	6779	623	14563	6225	7784	5602	10.881219903691814	1.3895037486611925
chr3	THUMPD3-AS1	9391081	9391105	0	25	14563	6225	14563	6200	0.0	2.3488709677419353
chr3	RPUSD3	9838984	9839030	47	47	720622	5249	720575	5202	1.0	138.51883890811226
chr3	RPUSD3	9843724	9843888	0	165	720622	5249	720622	5084	0.0	141.74311565696303
chr3	CIDEC	9878743	9878777	0	35	66180	1418	66180	1383	0.0	47.85249457700651
chr3	AC022007.1	10010885	10011021	2771	137	396562	4728	393791	4591	20.226277372262775	85.77455891962535
chr3	CIDECP1	10023529	10023558	0	30	186157	3021	186157	2991	0.0	62.2390504847877
chr3	SEC13	10320508	10320869	125751	362	271117	4364	145366	4002	347.378453038674	36.32333833083458
chr3	SEC13	10320508	10321048	193175	541	271117	4364	77942	3823	357.0702402957486	20.38765367512425
chr3	SEC13	10320610	10321048	151210	439	271117	4364	119907	3925	344.4419134396355	30.549554140127388
chr3	SEC13	10320508	10320609	41965	102	271117	4364	229152	4262	411.421568627451	53.76630689816987
chr3	ATP2B2	10331910	10331981	302	72	555339	10290	555037	10218	4.194444444444445	54.319534155412015
chr3	LINC00606	10762763	10762830	0	68	0	3183	0	3115	0.0	0.0
chr3	VGLL4	11720393	11720686	0	294	29745	7253	29745	6959	0.0	4.274321023135508
chr3	VGLL4	11719416	11719577	0	162	29745	7253	29745	7091	0.0	4.1947539134113665
chr3	XPC	14178465	14178482	506	18	53769	4652	53263	4634	28.11111111111111	11.493957703927492
chr3	GRIP2	14555893	14555898	0	6	37952	9751	37952	9745	0.0	3.894510005130836
chr3	FGD5-AS1	14947086	14947112	0	27	102	5148	102	5121	0.0	0.01991798476859988
chr3	FGD5-AS1	14947086	14947108	0	23	102	5148	102	5125	0.0	0.019902439024390244
chr3	FGD5-AS1	14947109	14947112	0	4	102	5148	102	5144	0.0	0.01982892690513219
chr3	MRPS25	15053290	15053378	0	89	2775	4677	2775	4588	0.0	0.6048387096774194
chr3	RBSN	15099021	15099033	609	13	217482	7927	216873	7914	46.84615384615385	27.40371493555724
chr3	COL6A4P1	15169939	15169946	0	8	51	4580	51	4572	0.0	0.01115485564304462
chr3	EAF1-AS1	15440260	15440433	0	174	32265	4233	32265	4059	0.0	7.9490022172949
chr3	EAF1-AS1	15439789	15440433	0	645	32265	4233	32265	3588	0.0	8.99247491638796
chr3	EAF1-AS1	15443070	15443401	0	332	32265	4233	32265	3901	0.0	8.270956165085876
chr3	ANKRD28	15796395	15796403	0	9	169885	11300	169885	11291	0.0	15.046054379594366
chr3	SGO1	20174248	20175003	0	756	11442	3751	11442	2995	0.0	3.8203672787979968
chr3	SGO1	20183607	20183757	252	151	11442	3751	11190	3600	1.6688741721854305	3.1083333333333334
chr3	SGO1	20185947	20186057	0	111	11442	3751	11442	3640	0.0	3.1434065934065933
chr3	UBE2E2-AS1	23202391	23202423	0	33	0	800	0	767	0.0	0.0
chr3	NKIRAS1	23916783	23916859	0	77	7155	2968	7155	2891	0.0	2.474922172258734
chr3	THRB	24494651	24494685	0	35	1326	10954	1326	10919	0.0	0.12143969227951278
chr3	THRB	24494651	24494793	0	143	1326	10954	1326	10811	0.0	0.12265285357506243
chr3	THRB	24494686	24494793	0	108	1326	10954	1326	10846	0.0	0.12225705329153605
chr3	NGLY1	25720013	25720128	0	116	9869	6316	9869	6200	0.0	1.5917741935483871
chr3	NGLY1	25782892	25783258	5475	367	9869	6316	4394	5949	14.91825613079019	0.7386115313498067
chr3	SLC4A7	27433915	27433953	245	39	91932	9251	91687	9212	6.282051282051282	9.952996092053843
chr3	SLC4A7	27484066	27484077	0	12	91932	9251	91932	9239	0.0	9.95042753544756
chr3	EOMES	27721413	27722428	0	1016	255	3662	255	2646	0.0	0.0963718820861678
chr3	RBMS3-AS3	29274281	29274321	0	41	0	5926	0	5885	0.0	0.0
chr3	AC116035.1	30525054	30525210	0	157	0	1107	0	950	0.0	0.0
chr3	CLASP2	33645281	33645342	0	62	27199	15265	27199	15203	0.0	1.7890547918174045
chr3	LRRFIP2	37175817	37176058	0	242	409188	10009	409188	9767	0.0	41.89495239070339
chr3	ITGA9-AS1	37851423	37851445	7	23	6374	14074	6367	14051	0.30434782608695654	0.45313500818447083
chr3	ITGA9-AS1	37818679	37818808	0	130	6374	14074	6374	13944	0.0	0.45711417096959267
chr3	ACAA1	38126161	38126508	0	348	582	6653	582	6305	0.0	0.09230769230769231
chr3	SCN5A	38554278	38554373	0	96	29446	10059	29446	9963	0.0	2.9555354812807386
chr3	SCN11A	39051860	39051924	0	65	84	11921	84	11856	0.0	0.00708502024291498
chr3	GORASP1	39100746	39100786	0	41	45177	5965	45177	5924	0.0	7.62609723160027
chr3	GORASP1	39106987	39106991	0	5	45177	5965	45177	5960	0.0	7.5800335570469795
chr3	GORASP1	39102677	39102691	0	15	45177	5965	45177	5950	0.0	7.592773109243698
chr3	GORASP1	39106968	39106986	0	19	45177	5965	45177	5946	0.0	7.597880928355197
chr3	GORASP1	39106968	39106991	0	24	45177	5965	45177	5941	0.0	7.6042753745160745
chr3	EIF1B-AS1	40309322	40309326	0	5	19636	19255	19636	19250	0.0	1.020051948051948
chr3	ULK4	41937228	41937293	0	66	299444	6325	299444	6259	0.0	47.84214730787666
chr3	VIPR1-AS1	42530859	42530919	0	61	29	4487	29	4426	0.0	0.006552191595119747
chr3	VIPR1-AS1	42528548	42528601	0	54	29	4487	29	4433	0.0	0.006541845251522671
chr3	VIPR1-AS1	42519250	42519387	0	138	29	4487	29	4349	0.0	0.00666819958611175
chr3	HHATL	42701111	42701130	555	20	53252	2901	52697	2881	27.75	18.2912183269698
chr3	HHATL	42702578	42702615	553	38	53252	2901	52699	2863	14.552631578947368	18.406915822563743
chr3	ZDHHC3	44959126	44959129	32	4	12115	12129	12083	12125	8.0	0.9965360824742268
chr3	LIMD1-AS1	45688375	45689018	510	644	25398	4394	24888	3750	0.7919254658385093	6.6368
chr3	LINC02009	46421372	46421420	0	49	0	2956	0	2907	0.0	0.0
chr3	LTF	46448862	46448867	0	6	408	3990	408	3984	0.0	0.10240963855421686
chr3	ALS2CL	46681499	46681502	0	4	0	7062	0	7058	0.0	0.0
chr3	ALS2CL	46683129	46683132	0	4	0	7062	0	7058	0.0	0.0
chr3	ALS2CL	46693488	46693641	0	154	0	7062	0	6908	0.0	0.0
chr3	PRSS45P	46743966	46743969	0	4	0	1296	0	1292	0.0	0.0
chr3	MYL3	46866389	46866506	0	118	0	2814	0	2696	0.0	0.0
chr3	KIF9	47282139	47282493	848	355	19379	5311	18531	4956	2.388732394366197	3.7391041162227605
chr3	ELP6	47510148	47510182	124	35	6259	3043	6135	3008	3.5428571428571427	2.039561170212766
chr3	ELP6	47512991	47513319	1632	329	6259	3043	4627	2714	4.96048632218845	1.7048636698599853
chr3	ELP6	47512991	47513221	30	231	6259	3043	6229	2812	0.12987012987012986	2.215149359886202
chr3	ELP6	47512991	47513189	0	199	6259	3043	6259	2844	0.0	2.200773558368495
chr3	ELP6	47513222	47513319	1602	98	6259	3043	4657	2945	16.346938775510203	1.5813242784380306
chr3	ELP6	47513190	47513319	1632	130	6259	3043	4627	2913	12.553846153846154	1.5883968417439067
chr3	ELP6	47513190	47513221	30	32	6259	3043	6229	3011	0.9375	2.0687479242776488
chr3	CSPG5	47569070	47569150	0	81	0	3353	0	3272	0.0	0.0
chr3	CSPG5	47578596	47579888	153	1293	0	3353	-153	2060	0.11832946635730858	-0.07427184466019418
chr3	MAP4	47870812	47870856	0	45	814302	14847	814302	14802	0.0	55.01297122010539
chr3	MAP4	48088772	48088962	872	191	814302	14847	813430	14656	4.56544502617801	55.501501091703055
chr3	NME6	48301295	48301351	0	57	29559	6219	29559	6162	0.0	4.796981499513145
chr3	NME6	48301278	48301351	0	74	29559	6219	29559	6145	0.0	4.810252237591538
chr3	NME6	48301278	48301294	0	17	29559	6219	29559	6202	0.0	4.76604321186714
chr3	NME6	48300430	48300525	0	96	29559	6219	29559	6123	0.0	4.827535521803037
chr3	NME6	48301269	48301294	0	26	29559	6219	29559	6193	0.0	4.772969481672856
chr3	NME6	48301269	48301277	0	9	29559	6219	29559	6210	0.0	4.759903381642512
chr3	NME6	48301269	48301351	0	83	29559	6219	29559	6136	0.0	4.8173076923076925
chr3	NME6	48300276	48300429	0	154	29559	6219	29559	6065	0.0	4.873701566364386
chr3	NME6	48300276	48300525	0	250	29559	6219	29559	5969	0.0	4.952085776511979
chr3	PLXNB1	48415175	48415210	0	36	3101	9551	3101	9515	0.0	0.3259064634787178
chr3	CCDC51	48439987	48440094	0	108	1476	2415	1476	2307	0.0	0.6397919375812744
chr3	SHISA5	48501136	48501156	21	21	46564	4383	46543	4362	1.0	10.670105456212747
chr3	SHISA5	48503720	48504017	392	298	46564	4383	46172	4085	1.3154362416107384	11.30281517747858
chr3	SHISA5	48504018	48504421	3124	404	46564	4383	43440	3979	7.732673267326732	10.917315908519729
chr3	SHISA5	48504422	48504628	3941	207	46564	4383	42623	4176	19.03864734299517	10.206657088122606
chr3	PFKFB4	48535511	48535531	0	21	63246	6039	63246	6018	0.0	10.509471585244267
chr3	UQCRC1	48609496	48609550	0	55	13227	3165	13227	3110	0.0	4.253054662379421
chr3	SLC26A6	48631223	48631251	0	29	32383	4986	32383	4957	0.0	6.53278192455114
chr3	SLC26A6	48631648	48631761	0	114	32383	4986	32383	4872	0.0	6.6467569786535305
chr3	NCKIPSD	48678553	48678562	80	10	207177	3266	207097	3256	8.0	63.604729729729726
chr3	NCKIPSD	48682868	48682901	1368	34	207177	3266	205809	3232	40.23529411764706	63.678527227722775
chr3	IP6K2	48717057	48717155	31258	99	162572	5121	131314	5022	315.73737373737373	26.147749900438072
chr3	IP6K2	48715314	48715387	307	74	162572	5121	162265	5047	4.148648648648648	32.15078264315435
chr3	IP6K2	48694693	48695088	6781	396	162572	5121	155791	4725	17.123737373737374	32.971640211640214
chr3	IP6K2	48694693	48694700	132	8	162572	5121	162440	5113	16.5	31.769998044201056
chr3	DALRD3	49015803	49015817	4	15	342932	2755	342928	2740	0.26666666666666666	125.15620437956204
chr3	IMPDH2	49028198	49028246	149	49	74898	4064	74749	4015	3.0408163265306123	18.617434620174347
chr3	IMPDH2	49028721	49028756	984	36	74898	4064	73914	4028	27.333333333333332	18.35004965243297
chr3	QRICH1	49093893	49093910	0	18	83090	3888	83090	3870	0.0	21.470284237726098
chr3	QARS1	49098352	49098371	0	20	803	3938	803	3918	0.0	0.204951505870342
chr3	QARS1	49099329	49099342	0	14	803	3938	803	3924	0.0	0.204638124362895
chr3	QARS1	49099960	49099992	0	33	803	3938	803	3905	0.0	0.2056338028169014
chr3	QARS1	49104323	49104371	0	49	803	3938	803	3889	0.0	0.2064798148624325
chr3	QARS1	49104323	49104355	0	33	803	3938	803	3905	0.0	0.2056338028169014
chr3	QARS1	49104616	49104651	0	36	803	3938	803	3902	0.0	0.20579190158892877
chr3	QARS1	49097109	49097132	0	24	803	3938	803	3914	0.0	0.20516096065406234
chr3	QARS1	49104356	49104371	0	16	803	3938	803	3922	0.0	0.204742478327384
chr3	QARS1	49103555	49103629	0	75	803	3938	803	3863	0.0	0.2078695314522392
chr3	USP19	49117058	49117207	0	150	47512	5602	47512	5452	0.0	8.714600146735144
chr3	USP19	49117436	49117465	0	30	47512	5602	47512	5572	0.0	8.52692031586504
chr3	LAMB2	49125252	49125267	0	16	16368	6595	16368	6579	0.0	2.487916096671227
chr3	C3ORF62	49276426	49276574	0	149	51	3803	51	3654	0.0	0.013957307060755337
chr3	USP4	49302383	49302436	0	54	41665	7226	41665	7172	0.0	5.809397657557167
chr3	GPX1	49358026	49358163	5146	138	31050	1047	25904	909	37.289855072463766	28.497249724972498
chr3	AMT	49417817	49417931	4	115	2924	4678	2920	4563	0.034782608695652174	0.6399298706991015
chr3	AMT	49420210	49420213	0	4	2924	4678	2924	4674	0.0	0.6255883611467694
chr3	AC104452.1	49422981	49424225	8814	1245	8839	4975	25	3730	7.079518072289156	0.006702412868632708
chr3	AC104452.1	49422981	49423080	1734	100	8839	4975	7105	4875	17.34	1.4574358974358974
chr3	AMT	49422360	49422437	51	78	2924	4678	2873	4600	0.6538461538461539	0.6245652173913043
chr3	AMT	49417488	49417613	0	126	2924	4678	2924	4552	0.0	0.6423550087873462
chr3	AMT	49421959	49421980	10	22	2924	4678	2914	4656	0.45454545454545453	0.6258591065292096
chr3	MST1	49686946	49686949	0	4	3710	4051	3710	4047	0.0	0.9167284408203608
chr3	MST1	49688597	49689043	752	447	3710	4051	2958	3604	1.6823266219239374	0.8207547169811321
chr3	GMPPB	49721964	49721971	0	8	903145	6681	903145	6673	0.0	135.34317398471453
chr3	GMPPB	49722863	49722970	5737	108	903145	6681	897408	6573	53.120370370370374	136.52943861250571
chr3	IP6K1	49786353	49786478	1122	126	17474	2590	16352	2464	8.904761904761905	6.636363636363637
chr3	TRAIP	49848136	49848141	0	6	5766	3275	5766	3269	0.0	1.763842153563781
chr3	CAMKV	49862044	49862084	0	41	412	3414	412	3373	0.0	0.1221464571597984
chr3	CAMKV	49862293	49862330	0	38	412	3414	412	3376	0.0	0.12203791469194313
chr3	CAMKV	49861179	49861186	0	8	412	3414	412	3406	0.0	0.12096300645918967
chr3	MON1A	49929368	49929428	346	61	7714	6358	7368	6297	5.672131147540983	1.1700809909480705
chr3	IFRD2	50288408	50288425	0	18	514423	3353	514423	3335	0.0	154.24977511244379
chr3	IFRD2	50289446	50289710	10544	265	514423	3353	503879	3088	39.78867924528302	163.1732512953368
chr3	HYAL2	50321365	50321566	0	202	697	3005	697	2803	0.0	0.24866214769889405
chr3	HYAL2	50320881	50321036	0	156	697	3005	697	2849	0.0	0.24464724464724466
chr3	HYAL2	50320836	50320880	0	45	697	3005	697	2960	0.0	0.23547297297297298
chr3	TUSC2	50326356	50326383	15068	28	522386	2409	507318	2381	538.1428571428571	213.06929861402773
chr3	TUSC2	50327027	50327036	7857	10	522386	2409	514529	2399	785.7	214.47644852021676
chr3	ZMYND10	50345487	50345533	45	47	23495	2382	23450	2335	0.9574468085106383	10.042826552462527
chr3	NPRL2	50348684	50348709	0	26	40418	2878	40418	2852	0.0	14.17180925666199
chr3	NPRL2	50349930	50349931	24	2	40418	2878	40394	2876	12.0	14.045201668984701
chr3	NPRL2	50349912	50349929	332	18	40418	2878	40086	2860	18.444444444444443	14.016083916083916
chr3	C3ORF18	50565465	50565524	0	60	76	3252	76	3192	0.0	0.023809523809523808
chr3	DCAF1	51466802	51466804	238	3	156745	6874	156507	6871	79.33333333333333	22.777907145975842
chr3	IQCF6	51779172	51779208	0	37	0	502	0	465	0.0	0.0
chr3	IQCF6	51779152	51779171	0	20	0	502	0	482	0.0	0.0
chr3	IQCF6	51779152	51779208	0	57	0	502	0	445	0.0	0.0
chr3	PCBP4	51961748	51961939	700	192	5643	3664	4943	3472	3.6458333333333335	1.4236751152073732
chr3	PCBP4	51968309	51968342	34	34	5643	3664	5609	3630	1.0	1.5451790633608815
chr3	RPL29	51995662	51995729	2243	68	153287	1436	151044	1368	32.98529411764706	110.41228070175438
chr3	RPL29	51995662	51995767	2605	106	153287	1436	150682	1330	24.57547169811321	113.29473684210527
chr3	RPL29	51995662	51995738	2286	77	153287	1436	151001	1359	29.68831168831169	111.11184694628403
chr3	RPL29	51995662	51995777	2712	116	153287	1436	150575	1320	23.379310344827587	114.0719696969697
chr3	RPL29	51995662	51995763	2561	102	153287	1436	150726	1334	25.107843137254903	112.9880059970015
chr3	RPL29	51995730	51995855	1718	126	153287	1436	151569	1310	13.634920634920634	115.70152671755726
chr3	RPL29	51995730	51995767	362	38	153287	1436	152925	1398	9.526315789473685	109.38841201716738
chr3	RPL29	51995730	51995738	43	9	153287	1436	153244	1427	4.777777777777778	107.38892782060266
chr3	RPL29	51995730	51995777	469	48	153287	1436	152818	1388	9.770833333333334	110.09942363112393
chr3	RPL29	51995730	51995763	318	34	153287	1436	152969	1402	9.352941176470589	109.1077032810271
chr3	RPL29	51995768	51995777	107	10	153287	1436	153180	1426	10.7	107.41935483870968
chr3	RPL29	51995739	51995767	319	29	153287	1436	152968	1407	11.0	108.71926083866383
chr3	RPL29	51995739	51995777	426	39	153287	1436	152861	1397	10.923076923076923	109.42090193271295
chr3	RPL29	51995739	51995763	275	25	153287	1436	153012	1411	11.0	108.44223954642098
chr3	RPL29	51995764	51995767	44	4	153287	1436	153243	1432	11.0	107.01326815642459
chr3	RPL29	51995764	51995777	151	14	153287	1436	153136	1422	10.785714285714286	107.69057665260198
chr3	WDR82	52278139	52278199	50	61	23009	5730	22959	5669	0.819672131147541	4.049920620920798
chr3	NT5DC2	52528445	52528510	0	66	329452	4574	329452	4508	0.0	73.08163265306122
chr3	NT5DC2	52534350	52534531	0	182	329452	4574	329452	4392	0.0	75.01183970856103
chr3	PBRM1	52563282	52563362	53753	81	160620	9463	106867	9382	663.6172839506173	11.390641654231507
chr3	GLT8D1	52705446	52705697	0	252	6733	3420	6733	3168	0.0	2.1253156565656566
chr3	GLT8D1	52705446	52705701	0	256	6733	3420	6733	3164	0.0	2.1280025284450064
chr3	TKT	53231349	53231355	0	7	2460	8000	2460	7993	0.0	0.3077692981358689
chr3	DCP1A	53347382	53347420	0	39	13790	6113	13790	6074	0.0	2.2703325650312807
chr3	ARHGEF3	56774999	56775103	0	105	1550	6495	1550	6390	0.0	0.24256651017214398
chr3	PDHB	58428351	58428471	0	121	2805	4248	2805	4127	0.0	0.6796704628059123
chr3	ACOX2	58531250	58531291	0	42	835	3288	835	3246	0.0	0.2572396796056685
chr3	ACOX2	58534359	58534488	0	130	835	3288	835	3158	0.0	0.2644078530715643
chr3	ACOX2	58534489	58534574	0	86	835	3288	835	3202	0.0	0.2607745159275453
chr3	FAM107A	58626970	58627414	0	445	255	5329	255	4884	0.0	0.05221130221130221
chr3	CFAP20DC	59049610	59049933	0	324	13384	9238	13384	8914	0.0	1.5014583800762844
chr3	CFAP20DC	58870161	58870171	154	11	13384	9238	13230	9227	14.0	1.4338354828221525
chr3	CFAP20DC	58913697	58913706	0	10	13384	9238	13384	9228	0.0	1.4503684438664932
chr3	PTPRG-AS1	62369191	62369304	79	114	37526	7308	37447	7194	0.6929824561403509	5.205309980539338
chr3	PTPRG-AS1	62318790	62318864	0	75	37526	7308	37526	7233	0.0	5.188165353242085
chr3	CADPS	62536444	62536494	0	51	0	14019	0	13968	0.0	0.0
chr3	THOC7	63839655	63839681	0	27	448	1759	448	1732	0.0	0.2586605080831409
chr3	PSMD6	64023274	64023390	0	117	102	8946	102	8829	0.0	0.011552837240910635
chr3	PSMD6	64022642	64022737	0	96	102	8946	102	8850	0.0	0.01152542372881356
chr3	LRIG1	66383990	66384130	0	141	6010	7069	6010	6928	0.0	0.8674942263279446
chr3	TAFA4	68932239	68932320	0	82	79	3265	79	3183	0.0	0.024819352811812755
chr3	EOGT	69012514	69012601	0	88	0	5372	0	5284	0.0	0.0
chr3	EOGT	69012367	69012513	0	147	0	5372	0	5225	0.0	0.0
chr3	EOGT	69012367	69012601	0	235	0	5372	0	5137	0.0	0.0
chr3	TMF1	69047348	69047356	0	9	128522	7929	128522	7920	0.0	16.227525252525254
chr3	FRMD4B	69200370	69200810	0	441	0	11238	0	10797	0.0	0.0
chr3	FOXP1	70977642	70977645	0	4	30419	26565	30419	26561	0.0	1.1452505553254773
chr3	FOXP1	71581548	71581586	429	39	30419	26565	29990	26526	11.0	1.1305888562165423
chr3	FOXP1	71581398	71581547	22	150	30419	26565	30397	26415	0.14666666666666667	1.1507476812417188
chr3	LINC00877	72060509	72060801	0	293	0	8637	0	8344	0.0	0.0
chr3	FAM86DP	75434724	75434916	0	193	0	3442	0	3249	0.0	0.0
chr3	FAM86DP	75434724	75435013	0	290	0	3442	0	3152	0.0	0.0
chr3	FAM86DP	75434917	75435013	0	97	0	3442	0	3345	0.0	0.0
chr3	ROBO1	78668471	78668482	0	12	16876	11098	16876	11086	0.0	1.522280353599134
chr3	PROS1	93905783	93905827	0	45	0	5212	0	5167	0.0	0.0
chr3	DHFR2	94062745	94062867	0	123	0	3527	0	3404	0.0	0.0
chr3	RIOX2	97971913	97972379	0	467	0	6599	0	6132	0.0	0.0
chr3	CLDND1	98521132	98521328	1428	197	1935605	4629	1934177	4432	7.248730964467005	436.41177797833933
chr3	CLDND1	98517051	98517156	84606	106	1935605	4629	1850999	4523	798.1698113207547	409.2414326774265
chr3	CLDND1	98522541	98522847	10545	307	1935605	4629	1925060	4322	34.3485342019544	445.4095326237853
chr3	CLDND1	98522541	98522786	7678	246	1935605	4629	1927927	4383	31.211382113821138	439.8647045402692
chr3	ST3GAL6-AS1	98718418	98718422	0	5	918	9394	918	9389	0.0	0.09777399084034509
chr3	CBLB	105868735	105868910	102	176	1816	10339	1714	10163	0.5795454545454546	0.16865098888123586
chr3	CBLB	105671020	105671022	0	3	1816	10339	1816	10336	0.0	0.17569659442724458
chr3	CBLB	105681292	105681477	20	186	1816	10339	1796	10153	0.10752688172043011	0.17689352900620506
chr3	LINC00882	106913024	106913040	0	17	6851	18708	6851	18691	0.0	0.36654004601144935
chr3	LINC00882	107209461	107209645	0	185	6851	18708	6851	18523	0.0	0.36986449279274414
chr3	LINC00882	107240438	107240441	0	4	6851	18708	6851	18704	0.0	0.3662852865697177
chr3	AC063944.1	107322313	107322618	51	306	180	3050	129	2744	0.16666666666666666	0.04701166180758017
chr3	LINC00635	107848905	107849032	0	128	260	7071	260	6943	0.0	0.03744778914014115
chr3	LINC00635	107841895	107842103	0	209	260	7071	260	6862	0.0	0.037889828038472746
chr3	LINC00635	107845308	107845420	0	113	260	7071	260	6958	0.0	0.03736705949985628
chr3	LINC00635	107876434	107876453	0	20	260	7071	260	7051	0.0	0.0368742022408169
chr3	LINC00635	107845101	107845307	0	207	260	7071	260	6864	0.0	0.03787878787878788
chr3	LINC00635	107845101	107845420	0	320	260	7071	260	6751	0.0	0.038512812916604945
chr3	LINC00635	107845101	107846456	102	1356	260	7071	158	5715	0.0752212389380531	0.02764654418197725
chr3	LINC00635	107853872	107855128	0	1257	260	7071	260	5814	0.0	0.044719642242862054
chr3	IFT57	108222017	108222109	0	93	162	3544	162	3451	0.0	0.04694291509707331
chr3	GUCA1C	108916086	108916125	0	40	0	1168	0	1128	0.0	0.0
chr3	ATG3	112561456	112561844	0	389	0	4249	0	3860	0.0	0.0
chr3	CCDC80	112640326	112640922	0	597	255	12973	255	12376	0.0	0.020604395604395604
chr3	CCDC80	112640326	112640562	0	237	255	12973	255	12736	0.0	0.020021984924623117
chr3	CCDC80	112640563	112640922	0	360	255	12973	255	12613	0.0	0.020217236184888607
chr3	NEPRO	113013948	113013951	0	4	10550	6041	10550	6037	0.0	1.7475567334768924
chr3	SPICE1	113514896	113515078	1224	183	101763	7709	100539	7526	6.688524590163935	13.358889184161573
chr3	SPICE1	113514657	113514795	2716	139	101763	7709	99047	7570	19.53956834532374	13.084147952443857
chr3	SPICE1	113514407	113514895	3940	489	101763	7709	97823	7220	8.057259713701432	13.548891966759003
chr3	SPICE1	113514407	113514795	2716	389	101763	7709	99047	7320	6.982005141388175	13.531010928961749
chr3	SPICE1	113514407	113514656	0	250	101763	7709	101763	7459	0.0	13.642981632926666
chr3	NAA50	113723958	113723979	0	22	4491	1410	4491	1388	0.0	3.2355907780979827
chr3	CCDC191	114004386	114004635	0	250	832	5304	832	5054	0.0	0.16462208151958843
chr3	LINC02024	117688346	117688717	0	372	0	1048	0	676	0.0	0.0
chr3	IGSF11	118905595	118905666	0	72	2451	4915	2451	4843	0.0	0.5060912657443734
chr3	IGSF11	119112649	119112672	0	24	2451	4915	2451	4891	0.0	0.5011245144142302
chr3	B4GALT4	119218649	119218710	2391	62	185032	6991	182641	6929	38.564516129032256	26.358926251984414
chr3	B4GALT4	119240360	119240563	0	204	185032	6991	185032	6787	0.0	27.262708118461767
chr3	B4GALT4	119240764	119240848	0	85	185032	6991	185032	6906	0.0	26.792933680857224
chr3	POPDC2	119648118	119648258	0	141	765	1450	765	1309	0.0	0.5844155844155844
chr3	COX17	119676730	119676860	0	131	102	1920	102	1789	0.0	0.05701509223029626
chr3	GSK3B	119916039	119916042	0	4	11430	16821	11430	16817	0.0	0.6796693821728014
chr3	GPR156	120186657	120186668	0	12	10068	6196	10068	6184	0.0	1.6280724450194048
chr3	AC072026.2	120907504	120908027	66	524	51	4443	-15	3919	0.12595419847328243	-0.003827507017096198
chr3	GOLGB1	121669196	121669210	0	15	0	11889	0	11874	0.0	0.0
chr3	GOLGB1	121730847	121730874	0	28	0	11889	0	11861	0.0	0.0
chr3	IQCB1	121834248	121834389	0	142	109	3066	109	2924	0.0	0.037277701778385776
chr3	CCDC58	122383147	122383172	0	26	0	1716	0	1690	0.0	0.0
chr3	KPNA1	122514756	122514873	0	118	119957	8433	119957	8315	0.0	14.426578472639807
chr3	KPNA1	122514756	122514838	0	83	119957	8433	119957	8350	0.0	14.366107784431138
chr3	KPNA1	122514839	122514873	0	35	119957	8433	119957	8398	0.0	14.283996189568946
chr3	PARP9	122558328	122558432	0	105	67708	8949	67708	8844	0.0	7.655811849841701
chr3	SEMA5B	122912171	122912233	0	63	13443	8546	13443	8483	0.0	1.5846988093834729
chr3	SEMA5B	122913533	122913535	0	3	13443	8546	13443	8543	0.0	1.5735690038628116
chr3	SEMA5B	122911359	122911489	0	131	13443	8546	13443	8415	0.0	1.5975044563279857
chr3	ADCY5	123367899	123367903	351	5	17369	8233	17018	8228	70.2	2.068303354399611
chr3	CCDC14	123946802	123947278	0	477	0	7677	0	7200	0.0	0.0
chr3	CCDC14	123952594	123955841	0	3248	0	7677	0	4429	0.0	0.0
chr3	CCDC14	123952594	123956044	0	3451	0	7677	0	4226	0.0	0.0
chr3	CCDC14	123955842	123956044	0	203	0	7677	0	7474	0.0	0.0
chr3	CCDC14	123949383	123949463	0	81	0	7677	0	7596	0.0	0.0
chr3	ROPN1	123991921	123992042	0	122	0	4526	0	4404	0.0	0.0
chr3	ZNF148	125323308	125323386	0	79	6756	3608	6756	3529	0.0	1.9144233493907623
chr3	LINC02614	125888348	125888581	0	234	102	6139	102	5905	0.0	0.017273497036409822
chr3	SLC41A3	126026334	126026391	0	58	1590	5485	1590	5427	0.0	0.29297954671089
chr3	SLC41A3	126050897	126050941	0	45	1590	5485	1590	5440	0.0	0.2922794117647059
chr3	SLC41A3	126084053	126084091	0	39	1590	5485	1590	5446	0.0	0.2919573999265516
chr3	ALDH1L1	126180475	126180798	94617	324	222298	13574	127681	13250	292.02777777777777	9.636301886792452
chr3	ALDH1L1	126180311	126180474	37092	164	222298	13574	185206	13410	226.17073170731706	13.8110365398956
chr3	ALDH1L1	126180311	126180798	131709	488	222298	13574	90589	13086	269.8954918032787	6.922589026440471
chr3	ALDH1L1	126180799	126180960	32932	162	222298	13574	189366	13412	203.28395061728395	14.119147032508202
chr3	CCDC37-DT	126394298	126394687	0	390	0	912	0	522	0.0	0.0
chr3	CCDC37-DT	126394098	126394687	0	590	0	912	0	322	0.0	0.0
chr3	CCDC37-DT	126394098	126394297	0	200	0	912	0	712	0.0	0.0
chr3	LINC02016	127355864	127355888	0	25	29495	1615	29495	1590	0.0	18.550314465408807
chr3	LINC01471	127535185	127536482	0	1298	357	6875	357	5577	0.0	0.06401291016675632
chr3	LINC01471	127537644	127537671	0	28	357	6875	357	6847	0.0	0.05213962319263911
chr3	MGLL	127822308	127823082	204	775	119167	11869	118963	11094	0.2632258064516129	10.72318370290247
chr3	ISY1	129134827	129134830	0	4	14146	3885	14146	3881	0.0	3.6449368719402218
chr3	CNBP	129171633	129171653	836	21	31390	3452	30554	3431	39.80952380952381	8.905275429903819
chr3	CNBP	129171633	129171650	764	18	31390	3452	30626	3434	42.44444444444444	8.918462434478743
chr3	CNBP	129171651	129171653	72	3	31390	3452	31318	3449	24.0	9.080313134241809
chr3	RPL32P3	129399007	129399379	0	373	14	4487	14	4114	0.0	0.003403014098201264
chr3	MBD4	129432502	129432554	0	53	0	3360	0	3307	0.0	0.0
chr3	MBD4	129437719	129437806	0	88	0	3360	0	3272	0.0	0.0
chr3	MBD4	129436442	129436459	0	18	0	3360	0	3342	0.0	0.0
chr3	PLXND1	129559612	129559618	0	7	29247	9501	29247	9494	0.0	3.080577206656836
chr3	PIK3R4	130723693	130723809	1287	117	103379	5399	102092	5282	11.0	19.32828474062855
chr3	ASTE1	131026506	131026730	0	225	0	3157	0	2932	0.0	0.0
chr3	ASTE1	131026187	131026505	0	319	0	3157	0	2838	0.0	0.0
chr3	AC010210.1	131381281	131381331	0	51	0	6702	0	6651	0.0	0.0
chr3	MRPL3	131471170	131471171	0	2	0	2662	0	2660	0.0	0.0
chr3	MRPL3	131502729	131502847	0	119	0	2662	0	2543	0.0	0.0
chr3	MRPL3	131502729	131502781	0	53	0	2662	0	2609	0.0	0.0
chr3	MRPL3	131502729	131502793	0	65	0	2662	0	2597	0.0	0.0
chr3	MRPL3	131502782	131502847	0	66	0	2662	0	2596	0.0	0.0
chr3	CPNE4	132039524	132040189	51	666	821	5868	770	5202	0.07657657657657657	0.14801999231064975
chr3	NPHP3	132721962	132722255	51	294	150	9222	99	8928	0.17346938775510204	0.011088709677419355
chr3	RAB6B	133885534	133885569	0	36	63142	5656	63142	5620	0.0	11.23523131672598
chr3	AMOTL2	134370699	134371311	0	613	0	6413	0	5800	0.0	0.0
chr3	AMOTL2	134370699	134371188	0	490	0	6413	0	5923	0.0	0.0
chr3	AMOTL2	134371189	134371311	0	123	0	6413	0	6290	0.0	0.0
chr3	AMOTL2	134373515	134373684	0	170	0	6413	0	6243	0.0	0.0
chr3	ANAPC13	134485319	134485950	0	632	0	2113	0	1481	0.0	0.0
chr3	ANAPC13	134485319	134485699	0	381	0	2113	0	1732	0.0	0.0
chr3	ANAPC13	134485700	134485950	0	251	0	2113	0	1862	0.0	0.0
chr3	KY	134650824	134650877	0	54	0	9018	0	8964	0.0	0.0
chr3	AC092969.1	135379261	135379323	0	63	816	9666	816	9603	0.0	0.08497344579818807
chr3	MSL2	136194971	136196148	3346	1178	9158	4238	5812	3060	2.840407470288625	1.899346405228758
chr3	NCK1-DT	136861572	136861745	22	174	29	5008	7	4834	0.12643678160919541	0.0014480761274306992
chr3	NCK1-DT	136861572	136861613	0	42	29	5008	29	4966	0.0	0.005839710028191704
chr3	NCK1-DT	136861614	136861745	22	132	29	5008	7	4876	0.16666666666666666	0.001435602953240361
chr3	DZIP1L	138115327	138115458	0	132	7323	5033	7323	4901	0.0	1.4941848602326055
chr3	NME9	138329754	138329815	2352	62	6677	3719	4325	3657	37.935483870967744	1.1826633852884878
chr3	LINC01391	138942320	138942382	0	63	0	3830	0	3767	0.0	0.0
chr3	COPB2	139389547	139389629	0	83	3162	16215	3162	16132	0.0	0.19600793454004464
chr3	COPB2	139389468	139389546	0	79	3162	16215	3162	16136	0.0	0.1959593455627169
chr3	COPB2	139389468	139389629	0	162	3162	16215	3162	16053	0.0	0.1969725284993459
chr3	RBP1	139538320	139538779	0	460	204	3911	204	3451	0.0	0.059113300492610835
chr3	GK5	142204216	142204693	4170	478	36309	6036	32139	5558	8.723849372384937	5.782475710687297
chr3	XRN1	142356911	142356981	0	71	4053	12028	4053	11957	0.0	0.3389646232332525
chr3	ATR	142497012	142497132	0	121	123312	22010	123312	21889	0.0	5.63351455068756
chr3	ATR	142453116	142453126	2	11	123312	22010	123310	21999	0.18181818181818182	5.605254784308378
chr3	PLOD2	146160788	146160879	0	92	51	6735	51	6643	0.0	0.007677254252596718
chr3	PLSCR5	146600287	146600322	0	36	888	2149	888	2113	0.0	0.4202555608140085
chr3	CP	149176237	149176248	0	12	512	6555	512	6543	0.0	0.0782515665596821
chr3	TM4SF1	149375442	149375678	6646	237	14168	3498	7522	3261	28.042194092827003	2.306654400490647
chr3	WWTR1	149657683	149657763	0	81	29654	8192	29654	8111	0.0	3.6560226852422635
chr3	WWTR1	149657503	149657763	0	261	29654	8192	29654	7931	0.0	3.7389988652124573
chr3	WWTR1	149657503	149657682	0	180	29654	8192	29654	8012	0.0	3.7011982026959562
chr3	COMMD2	149751322	149751401	0	80	102	4899	102	4819	0.0	0.021166217057480806
chr3	ANKUB1	149780238	149780319	0	82	0	4884	0	4802	0.0	0.0
chr3	PFN2	149968357	149968401	0	45	2703	3425	2703	3380	0.0	0.7997041420118344
chr3	PFN2	149970724	149971050	0	327	2703	3425	2703	3098	0.0	0.8724983860555197
chr3	PFN2	149968353	149968356	0	4	2703	3425	2703	3421	0.0	0.7901198479976616
chr3	PFN2	149970618	149970723	0	106	2703	3425	2703	3319	0.0	0.8144019282916541
chr3	PFN2	149971051	149971151	0	101	2703	3425	2703	3324	0.0	0.8131768953068592
chr3	ERICH6	150703495	150703798	0	304	0	2089	0	1785	0.0	0.0
chr3	ERICH6	150703736	150703777	0	42	0	2089	0	2047	0.0	0.0
chr3	AC011317.1	150736341	150736349	0	9	0	1472	0	1463	0.0	0.0
chr3	MBNL1-AS1	152269427	152269437	0	11	0	3430	0	3419	0.0	0.0
chr3	SLC33A1	155853222	155853369	0	148	0	4422	0	4274	0.0	0.0
chr3	SLC33A1	155833467	155833855	0	389	0	4422	0	4033	0.0	0.0
chr3	SLC33A1	155853107	155853221	0	115	0	4422	0	4307	0.0	0.0
chr3	SSR3	156548865	156548903	0	39	19962	5187	19962	5148	0.0	3.8776223776223775
chr3	SSR3	156544293	156544306	112	14	19962	5187	19850	5173	8.0	3.8372317803982217
chr3	CCNL1	157151728	157151915	0	188	7688	6386	7688	6198	0.0	1.2404001290738949
chr3	CCNL1	157156935	157157009	0	75	7688	6386	7688	6311	0.0	1.2181904610996672
chr3	CCNL1	157156935	157157005	0	71	7688	6386	7688	6315	0.0	1.2174188440221694
chr3	CCNL1	157149679	157149834	51	156	7688	6386	7637	6230	0.3269230769230769	1.2258426966292135
chr3	CCNL1	157157006	157157009	0	4	7688	6386	7688	6382	0.0	1.2046380445001568
chr3	IFT80	160366042	160366091	0	50	4292	7073	4292	7023	0.0	0.611134842659832
chr3	IFT80	160384563	160384587	0	25	4292	7073	4292	7048	0.0	0.6089670828603859
chr3	TRIM59	160449471	160449715	0	245	51	7827	51	7582	0.0	0.006726457399103139
chr3	TRIM59	160449471	160449682	0	212	51	7827	51	7615	0.0	0.0066973079448456995
chr3	TRIM59	160449683	160449715	0	33	51	7827	51	7794	0.0	0.006543494996150885
chr3	TRIM59	160449444	160449470	0	27	51	7827	51	7800	0.0	0.006538461538461538
chr3	KPNA4	160564504	160564519	0	16	357	13663	357	13647	0.0	0.026159595515497912
chr3	B3GALNT1	161089943	161089958	0	16	51	6044	51	6028	0.0	0.008460517584605176
chr3	B3GALNT1	161086593	161086652	0	60	51	6044	51	5984	0.0	0.008522727272727272
chr3	B3GALNT1	161104784	161105001	0	218	51	6044	51	5826	0.0	0.008753861997940269
chr3	B3GALNT1	161104784	161105233	0	450	51	6044	51	5594	0.0	0.009116910976045764
chr3	B3GALNT1	161086263	161086592	0	330	51	6044	51	5714	0.0	0.008925446272313616
chr3	B3GALNT1	161086263	161086652	0	390	51	6044	51	5654	0.0	0.00902016271666077
chr3	B3GALNT1	161105002	161105233	0	232	51	6044	51	5812	0.0	0.008774948382656573
chr3	LINC01192	163303195	163303236	0	42	837	7521	837	7479	0.0	0.11191335740072202
chr3	LINC01192	163304615	163304660	0	46	837	7521	837	7475	0.0	0.11197324414715719
chr3	LINC01192	163304553	163304614	0	62	837	7521	837	7459	0.0	0.11221343343611744
chr3	WDR49	167554649	167554681	0	33	0	3913	0	3880	0.0	0.0
chr3	PDCD10	167734661	167734804	0	144	51	3179	51	3035	0.0	0.016803953871499175
chr3	PDCD10	167734431	167734457	4	27	51	3179	47	3152	0.14814814814814814	0.014911167512690355
chr3	MECOM	169146476	169146494	0	19	0	9118	0	9099	0.0	0.0
chr3	MECOM	169144996	169146224	0	1229	0	9118	0	7889	0.0	0.0
chr3	MECOM	169145317	169146224	0	908	0	9118	0	8210	0.0	0.0
chr3	MECOM	169145317	169145752	0	436	0	9118	0	8682	0.0	0.0
chr3	MECOM	169145753	169146224	0	472	0	9118	0	8646	0.0	0.0
chr3	LRRC34	169812409	169812568	2722	160	31149	2712	28427	2552	17.0125	11.1391065830721
chr3	PHC3	170171372	170171388	0	17	31803	16850	31803	16833	0.0	1.8893245410800215
chr3	PHC3	170181686	170181700	0	15	31803	16850	31803	16835	0.0	1.889100089100089
chr3	AC026316.5	170733682	170733845	0	164	0	1786	0	1622	0.0	0.0
chr3	NCEH1	172647861	172647884	0	24	0	4813	0	4789	0.0	0.0
chr3	LINC01209	176816173	176816824	7815	652	196	1750	-7619	1098	11.986196319018404	-6.9389799635701275
chr3	KCNMB2-AS1	178749045	178749108	0	64	2894	4760	2894	4696	0.0	0.6162691652470187
chr3	KCNMB3	179242808	179243131	0	324	0	5833	0	5509	0.0	0.0
chr3	DNAJC19	180986942	180986996	0	55	0	3243	0	3188	0.0	0.0
chr3	DNAJC19	180986942	180986946	0	5	0	3243	0	3238	0.0	0.0
chr3	DNAJC19	180986947	180986996	0	50	0	3243	0	3193	0.0	0.0
chr3	DCUN1D1	182965536	182965677	0	142	261	8289	261	8147	0.0	0.032036332392291644
chr3	DCUN1D1	182985791	182985819	0	29	261	8289	261	8260	0.0	0.03159806295399516
chr3	PARL	183884721	183884881	21065	161	926803	2279	905738	2118	130.8385093167702	427.63833805476867
chr3	PARL	183884721	183884885	21101	165	926803	2279	905702	2114	127.88484848484849	428.43046357615896
chr3	PARL	183884882	183884885	36	4	926803	2279	926767	2275	9.0	407.3701098901099
chr3	PARL	183862696	183862751	4512	56	926803	2279	922291	2223	80.57142857142857	414.88573999100316
chr3	ALG3	184248744	184248780	0	37	0	3286	0	3249	0.0	0.0
chr3	ALG3	184248989	184249224	0	236	0	3286	0	3050	0.0	0.0
chr3	CLCN2	184356992	184357035	0	44	0	7330	0	7286	0.0	0.0
chr3	CLCN2	184354903	184355372	0	470	0	7330	0	6860	0.0	0.0
chr3	CLCN2	184353541	184353660	0	120	0	7330	0	7210	0.0	0.0
chr3	EHHADH	185253825	185253947	0	123	2608	4538	2608	4415	0.0	0.5907134767836919
chr3	LINC02052	186456916	186457339	0	424	280	3834	280	3410	0.0	0.08211143695014662
chr3	LINC02052	186455435	186455646	0	212	280	3834	280	3622	0.0	0.07730535615681944
chr3	LINC02052	186456163	186456395	0	233	280	3834	280	3601	0.0	0.07775617883921133
chr3	LINC02052	186492664	186492679	0	16	280	3834	280	3818	0.0	0.07333682556312206
chr3	AC068631.1	186665462	186665577	114	116	14778	10018	14664	9902	0.9827586206896551	1.4809129468794182
chr3	AC068631.1	186743626	186743701	0	76	14778	10018	14778	9942	0.0	1.4864212432106216
chr3	AC068631.1	186757016	186757607	4868	592	14778	10018	9910	9426	8.222972972972974	1.0513473371525568
chr3	AC068631.1	186745614	186745728	102	115	14778	10018	14676	9903	0.8869565217391304	1.4819751590427144
chr3	RFC4	186806289	186806423	0	135	9373	2909	9373	2774	0.0	3.3788752703677
chr3	MASP1	187291627	187291687	0	61	51	9431	51	9370	0.0	0.0054429028815368196
chr3	LINC02013	190698048	190698077	0	30	0	1667	0	1637	0.0	0.0
chr3	FGF12	192727180	192727482	0	303	0	7205	0	6902	0.0	0.0
chr3	ATP13A4	193435647	193435674	0	28	14814	9023	14814	8995	0.0	1.6469149527515285
chr3	ATP13A4	193466024	193466080	0	57	14814	9023	14814	8966	0.0	1.652241802364488
chr3	ATP13A4	193440489	193440556	0	68	14814	9023	14814	8955	0.0	1.6542713567839196
chr3	LINC02028	194058353	194058409	0	57	2219	10141	2219	10084	0.0	0.22005156683855612
chr3	LINC02028	194057632	194057635	0	4	2219	10141	2219	10137	0.0	0.21890105553911413
chr3	LINC02028	194058059	194058352	102	294	2219	10141	2117	9847	0.3469387755102041	0.21498933685386412
chr3	LINC02028	194057636	194058058	0	423	2219	10141	2219	9718	0.0	0.22833916443712698
chr3	TMEM44	194604286	194604312	0	27	0	4577	0	4550	0.0	0.0
chr3	MUC4	195778288	195778301	1244	14	227788	19948	226544	19934	88.85714285714286	11.364703521621351
chr3	MUC4	195769021	195769048	0	28	227788	19948	227788	19920	0.0	11.435140562248996
chr3	TNK2	195876603	195876609	0	7	204	8460	204	8453	0.0	0.02413344374778185
chr3	TNK2	195882050	195882284	94	235	204	8460	110	8225	0.4	0.013373860182370821
chr3	TNK2	195876457	195876602	51	146	204	8460	153	8314	0.3493150684931507	0.018402694250661534
chr3	TNK2	195876457	195876609	51	153	204	8460	153	8307	0.3333333333333333	0.018418201516793065
chr3	TNK2	195876457	195876575	51	119	204	8460	153	8341	0.42857142857142855	0.01834312432562043
chr3	TNK2	195876576	195876602	0	27	204	8460	204	8433	0.0	0.024190679473496977
chr3	TNK2	195876576	195876609	0	34	204	8460	204	8426	0.0	0.024210776169000713
chr3	TNK2	195876443	195876456	0	14	204	8460	204	8446	0.0	0.024153445417949324
chr3	SDHAP1	195984491	195984592	1581	102	127316	3371	125735	3269	15.5	38.46283267054145
chr3	TFRC	196081830	196082041	6992	212	58199	7608	51207	7396	32.9811320754717	6.923607355327204
chr3	PCYT1A	196287531	196287613	0	83	40966	7356	40966	7273	0.0	5.632613776983363
chr3	TCTEX1D2	196318035	196318038	0	4	10438	1253	10438	1249	0.0	8.357085668534827
chr3	TM4SF19	196324270	196324273	0	4	102	1901	102	1897	0.0	0.05376910911966262
chr3	SMCO1	196515103	196515158	0	56	62781	1849	62781	1793	0.0	35.01450083658673
chr3	WDR53	196566876	196567189	0	314	13330	1801	13330	1487	0.0	8.964357767316745
chr3	WDR53	196566876	196566888	0	13	13330	1801	13330	1788	0.0	7.4552572706935125
chr3	WDR53	196566889	196567189	0	301	13330	1801	13330	1500	0.0	8.886666666666667
chr3	WDR53	196568438	196568517	0	80	13330	1801	13330	1721	0.0	7.745496804183614
chr3	NCBP2	196942159	196942368	0	210	0	4358	0	4148	0.0	0.0
chr3	NCBP2	196942369	196942424	0	56	0	4358	0	4302	0.0	0.0
chr3	NCBP2	196941934	196942158	0	225	0	4358	0	4133	0.0	0.0
chr3	NCBP2	196941934	196942424	0	491	0	4358	0	3867	0.0	0.0
chr3	NCBP2	196941934	196942368	0	435	0	4358	0	3923	0.0	0.0
chr3	NCBP2	196941486	196941707	0	222	0	4358	0	4136	0.0	0.0
chr3	DLG1	197298417	197298534	0	118	54021	16100	54021	15982	0.0	3.3801151295207106
chr3	DLG1	197138214	197138220	0	7	54021	16100	54021	16093	0.0	3.356801093643199
chr3	DLG1	197297543	197297671	0	129	54021	16100	54021	15971	0.0	3.3824431782605973
chr3	DLG1	197085295	197085578	51	284	54021	16100	53970	15816	0.1795774647887324	3.4123672230652504
chr3	DLG1	197297672	197297887	0	216	54021	16100	54021	15884	0.0	3.4009695290858724
chr3	DLG1	197297672	197298071	0	400	54021	16100	54021	15700	0.0	3.440828025477707
chr3	BDH1	197514152	197514262	357	111	284194	10256	283837	10145	3.2162162162162162	27.978018728437654
chr3	AC132008.2	197627571	197627778	0	208	41546	2727	41546	2519	0.0	16.493052798729654
chr3	IQCG	197949540	197949837	255	298	15762	4487	15507	4189	0.8557046979865772	3.7018381475292435
chr4	DGKQ	965927	966062	0	136	24861	5008	24861	4872	0.0	5.102832512315271
chr4	TMED11P	1123114	1123116	0	3	1479	758	1479	755	0.0	1.9589403973509933
chr4	SPON2	1201268	1201271	0	4	113227	5995	113227	5991	0.0	18.899515940577533
chr4	CTBP1	1214190	1214341	6173	152	226480	5959	220307	5807	40.61184210526316	37.93817806096091
chr4	FAM53A	1683693	1683956	714	264	5680	3942	4966	3678	2.7045454545454546	1.3501903208265362
chr4	POLN	2072967	2072993	0	27	27453	5714	27453	5687	0.0	4.827325479163004
chr4	POLN	2170678	2170680	0	3	27453	5714	27453	5711	0.0	4.807039047452285
chr4	HAUS3	2231834	2231943	2126	110	193335	9687	191209	9577	19.327272727272728	19.96543802861021
chr4	HAUS3	2241519	2242049	50021	531	193335	9687	143314	9156	94.2015065913371	15.652468326780253
chr4	ZFYVE28	2364485	2364691	0	207	10280	9633	10280	9426	0.0	1.0906004667939742
chr4	TNIP2	2755948	2756012	534	65	24921	2658	24387	2593	8.215384615384615	9.404936367142307
chr4	TNIP2	2755948	2755974	27	27	24921	2658	24894	2631	1.0	9.461801596351197
chr4	TNIP2	2755975	2756012	507	38	24921	2658	24414	2620	13.342105263157896	9.318320610687023
chr4	NOP14	2939534	2939537	160	4	88269	3568	88109	3564	40.0	24.721941638608307
chr4	HTT-AS	3074356	3074424	0	69	199	2254	199	2185	0.0	0.09107551487414188
chr4	AC226119.1	3921623	3921626	0	4	70	688	70	684	0.0	0.1023391812865497
chr4	FAM86EP	3947143	3948088	410	946	2101	2974	1691	2028	0.4334038054968288	0.8338264299802761
chr4	FAM86EP	3946625	3946767	588	143	2101	2974	1513	2831	4.111888111888112	0.5344401271635465
chr4	TMEM128	4247600	4248104	28006	505	45602	1753	17596	1248	55.45742574257426	14.099358974358974
chr4	LYAR	4289602	4290034	56	433	6260	1931	6204	1498	0.12933025404157045	4.141522029372497
chr4	LYAR	4289602	4289984	56	383	6260	1931	6204	1548	0.1462140992167102	4.007751937984496
chr4	EVC2	5640513	5640520	0	8	2586	5527	2586	5519	0.0	0.4685631454973727
chr4	AC116317.1	6303861	6303913	3636	53	49636	2334	46000	2281	68.60377358490567	20.166593599298555
chr4	PPP2R2C	6380996	6381039	0	44	17113	8702	17113	8658	0.0	1.9765534765534765
chr4	FBXL5	15659726	15659739	0	14	19735	4396	19735	4382	0.0	4.503651300775902
chr4	FBXL5	15681279	15681351	189	73	19735	4396	19546	4323	2.589041095890411	4.521397177885728
chr4	FBXL5	15681279	15681381	231	103	19735	4396	19504	4293	2.2427184466019416	4.54320987654321
chr4	PROM1	16083231	16083298	0	68	115	7501	115	7433	0.0	0.015471545809229114
chr4	LDB2	16508534	16508539	0	6	0	5476	0	5470	0.0	0.0
chr4	LCORL	18021597	18021600	0	4	164395	16931	164395	16927	0.0	9.711998582146865
chr4	ADGRA3	22444972	22445039	0	68	48549	9289	48549	9221	0.0	5.2650471749267975
chr4	SEPSECS	25159509	25159626	1419	118	69022	6251	67603	6133	12.025423728813559	11.02282732757215
chr4	SEL1L3	25863433	25863454	0	22	0	7498	0	7476	0.0	0.0
chr4	SEL1L3	25863606	25863619	0	14	0	7498	0	7484	0.0	0.0
chr4	STIM2-AS1	26860340	26860508	5403	169	29323	456	23920	287	31.97041420118343	83.34494773519164
chr4	ARAP2	36243608	36243689	0	82	30	12390	30	12308	0.0	0.0024374390640233994
chr4	LINC02505	36615417	36615452	0	36	0	2189	0	2153	0.0	0.0
chr4	LINC01258	38452572	38452575	0	4	0	2576	0	2572	0.0	0.0
chr4	TLR10	38775774	38776108	0	335	0	1194	0	859	0.0	0.0
chr4	TMEM156	38998639	38998722	0	84	1836	2572	1836	2488	0.0	0.7379421221864951
chr4	RFC1	39351347	39351430	0	84	28712	6752	28712	6668	0.0	4.305938812237552
chr4	RPL9	39458393	39458889	16865	497	694582	4943	677717	4446	33.93360160965795	152.43297345928926
chr4	UGDH	39527232	39527281	0	50	7903	3990	7903	3940	0.0	2.0058375634517764
chr4	RBM47	40629977	40630106	0	130	636	8557	636	8427	0.0	0.07547169811320754
chr4	APBB2	40856984	40857024	0	41	15471	11681	15471	11640	0.0	1.3291237113402061
chr4	APBB2	40830457	40830461	0	5	15471	11681	15471	11676	0.0	1.3250256937307296
chr4	BEND4	42120053	42120123	0	71	0	8482	0	8411	0.0	0.0
chr4	AC114757.1	43992592	43993011	0	420	0	9122	0	8702	0.0	0.0
chr4	GABRA2	46389210	46389231	0	22	0	16399	0	16377	0.0	0.0
chr4	GABRA2	46389210	46389221	0	12	0	16399	0	16387	0.0	0.0
chr4	GABRA2	46389210	46389226	0	17	0	16399	0	16382	0.0	0.0
chr4	GABRA2	46389222	46389231	0	10	0	16399	0	16389	0.0	0.0
chr4	GABRA2	46389222	46389226	0	5	0	16399	0	16394	0.0	0.0
chr4	GABRA2	46389227	46389231	0	5	0	16399	0	16394	0.0	0.0
chr4	GABRA4	46993338	46993405	0	68	0	11246	0	11178	0.0	0.0
chr4	NFXL1	47914364	47914548	0	185	3543	4518	3543	4333	0.0	0.8176782829448419
chr4	NFXL1	47914549	47914611	0	63	3543	4518	3543	4455	0.0	0.7952861952861953
chr4	SGCB	52031851	52031863	0	13	0	4365	0	4352	0.0	0.0
chr4	USP46	52656295	52656451	0	157	0	8909	0	8752	0.0	0.0
chr4	USP46	52598568	52598626	0	59	0	8909	0	8850	0.0	0.0
chr4	CHIC2	54048954	54049037	0	84	0	1239	0	1155	0.0	0.0
chr4	HOPX	56681254	56681651	0	398	0	3242	0	2844	0.0	0.0
chr4	HOPX	56656299	56656441	0	143	0	3242	0	3099	0.0	0.0
chr4	HOPX	56656299	56656342	0	44	0	3242	0	3198	0.0	0.0
chr4	HOPX	56656299	56656338	0	40	0	3242	0	3202	0.0	0.0
chr4	HOPX	56656343	56656441	0	99	0	3242	0	3143	0.0	0.0
chr4	HOPX	56656339	56656441	0	103	0	3242	0	3139	0.0	0.0
chr4	HOPX	56656339	56656342	0	4	0	3242	0	3238	0.0	0.0
chr4	SPINK2	56821457	56821606	0	150	56	732	56	582	0.0	0.09621993127147767
chr4	SPINK2	56821457	56821501	0	45	56	732	56	687	0.0	0.08151382823871907
chr4	SPINK2	56821502	56821606	0	105	56	732	56	627	0.0	0.08931419457735247
chr4	AC017091.1	58784035	58784133	0	99	382	2941	382	2842	0.0	0.13441238564391272
chr4	LINC02619	58988048	58988102	0	55	0	1391	0	1336	0.0	0.0
chr4	ADGRL3-AS1	62157322	62157367	0	46	0	958	0	912	0.0	0.0
chr4	AC104806.2	67419893	67420896	0	1004	0	2410	0	1406	0.0	0.0
chr4	CENPC	67492750	67492867	0	118	0	8516	0	8398	0.0	0.0
chr4	TMPRSS11A	67944509	67944517	0	9	83	3961	83	3952	0.0	0.021002024291497976
chr4	UGT2B4	69495140	69495391	0	252	0	2514	0	2262	0.0	0.0
chr4	GRSF1	70839227	70839469	0	243	17	7579	17	7336	0.0	0.002317339149400218
chr4	GRSF1	70839176	70839226	0	51	17	7579	17	7528	0.0	0.0022582359192348566
chr4	RCHY1	75508819	75508822	0	4	0	5692	0	5688	0.0	0.0
chr4	RCHY1	75514196	75514239	0	44	0	5692	0	5648	0.0	0.0
chr4	RCHY1	75514196	75514661	0	466	0	5692	0	5226	0.0	0.0
chr4	RCHY1	75491582	75491609	0	28	0	5692	0	5664	0.0	0.0
chr4	RCHY1	75514154	75514195	0	42	0	5692	0	5650	0.0	0.0
chr4	RCHY1	75514154	75514239	0	86	0	5692	0	5606	0.0	0.0
chr4	G3BP2	75672812	75672942	0	131	2760	11241	2760	11110	0.0	0.24842484248424843
chr4	G3BP2	75672943	75673017	0	75	2760	11241	2760	11166	0.0	0.24717893605588392
chr4	G3BP2	75673018	75673048	0	31	2760	11241	2760	11210	0.0	0.24620874219446923
chr4	G3BP2	75662212	75662380	0	169	2760	11241	2760	11072	0.0	0.24927745664739884
chr4	G3BP2	75673207	75673449	1808	243	2760	11241	952	10998	7.440329218106996	0.08656119294417167
chr4	G3BP2	75694792	75694796	0	5	2760	11241	2760	11236	0.0	0.2456390174439302
chr4	G3BP2	75662689	75662764	0	76	2760	11241	2760	11165	0.0	0.24720107478728168
chr4	G3BP2	75656918	75656922	0	5	2760	11241	2760	11236	0.0	0.2456390174439302
chr4	G3BP2	75656854	75656922	0	69	2760	11241	2760	11172	0.0	0.24704618689581095
chr4	G3BP2	75672505	75672588	0	84	2760	11241	2760	11157	0.0	0.24737832750739447
chr4	SDAD1	75990695	75990750	0	56	220	3458	220	3402	0.0	0.06466784244562022
chr4	SCARB2	76163224	76163285	0	62	102	15139	102	15077	0.0	0.0067652716057571135
chr4	SCARB2	76166168	76166248	0	81	102	15139	102	15058	0.0	0.006773807942621862
chr4	CNOT6L	77726166	77726304	0	139	0	9382	0	9243	0.0	0.0
chr4	CNOT6L	77819232	77819302	0	71	0	9382	0	9311	0.0	0.0
chr4	PRKG2	81142793	81142879	0	87	4318	5137	4318	5050	0.0	0.855049504950495
chr4	PRKG2	81214930	81214934	10	5	4318	5137	4308	5132	2.0	0.8394388152766953
chr4	TMEM150C	82496067	82496077	0	11	0	3507	0	3496	0.0	0.0
chr4	SEC31A	82842139	82842183	0	45	102	8631	102	8586	0.0	0.011879804332634521
chr4	SEC31A	82878729	82878856	0	128	102	8631	102	8503	0.0	0.011995766200164648
chr4	THAP9-AS1	82900333	82900370	0	38	0	4254	0	4216	0.0	0.0
chr4	SEC31A	82871367	82871942	0	576	102	8631	102	8055	0.0	0.01266294227188082
chr4	SEC31A	82890750	82891086	0	337	102	8631	102	8294	0.0	0.012298046780805401
chr4	SEC31A	82890694	82890749	0	56	102	8631	102	8575	0.0	0.011895043731778425
chr4	SEC31A	82890694	82890734	0	41	102	8631	102	8590	0.0	0.011874272409778813
chr4	SEC31A	82890735	82891086	0	352	102	8631	102	8279	0.0	0.012320328542094456
chr4	SEC31A	82890735	82890749	0	15	102	8631	102	8616	0.0	0.011838440111420613
chr4	LIN54	82984160	82984822	0	663	51	3486	51	2823	0.0	0.018065887353878853
chr4	LIN54	83010483	83010745	0	263	51	3486	51	3223	0.0	0.015823766677008997
chr4	HELQ	83455396	83455506	0	111	459	3602	459	3491	0.0	0.1314809510169006
chr4	ABRAXAS1	83484823	83484984	0	162	621	7552	621	7390	0.0	0.08403247631935047
chr4	MAPK10	86194308	86194334	0	27	87	36649	87	36622	0.0	0.0023756212112937577
chr4	MAPK10	86194308	86194317	0	10	87	36649	87	36639	0.0	0.0023745189552116597
chr4	MAPK10	86194318	86194334	0	17	87	36649	87	36632	0.0	0.0023749727014632017
chr4	MAPK10	86358080	86358206	51	127	87	36649	36	36522	0.4015748031496063	0.0009857072449482504
chr4	MAPK10	86593732	86593908	0	177	87	36649	87	36472	0.0	0.0023853915332309717
chr4	C4ORF36	86892182	86892280	0	99	0	1920	0	1821	0.0	0.0
chr4	C4ORF36	86892182	86892208	0	27	0	1920	0	1893	0.0	0.0
chr4	C4ORF36	86892182	86892197	0	16	0	1920	0	1904	0.0	0.0
chr4	C4ORF36	86892062	86892181	0	120	0	1920	0	1800	0.0	0.0
chr4	C4ORF36	86892062	86892280	0	219	0	1920	0	1701	0.0	0.0
chr4	C4ORF36	86892062	86892208	0	147	0	1920	0	1773	0.0	0.0
chr4	C4ORF36	86892062	86892197	0	136	0	1920	0	1784	0.0	0.0
chr4	C4ORF36	86892209	86892280	0	72	0	1920	0	1848	0.0	0.0
chr4	C4ORF36	86892198	86892280	0	83	0	1920	0	1837	0.0	0.0
chr4	C4ORF36	86892198	86892208	0	11	0	1920	0	1909	0.0	0.0
chr4	ABCG2	88158385	88158575	0	191	1553	5621	1553	5430	0.0	0.2860036832412523
chr4	PPM1K	88278143	88278534	10026	392	143848	10583	133822	10191	25.5765306122449	13.131390442547346
chr4	SNCA	89836961	89837096	0	136	745	6216	745	6080	0.0	0.1225328947368421
chr4	SNCA	89836742	89836960	0	219	745	6216	745	5997	0.0	0.12422878105719526
chr4	SNCA	89836742	89837096	0	355	745	6216	745	5861	0.0	0.12711141443439686
chr4	TSPAN5	98484384	98484397	0	14	176	5216	176	5202	0.0	0.03383314109957709
chr4	TSPAN5	98657524	98657538	0	15	176	5216	176	5201	0.0	0.03383964622188041
chr4	ADH5	99081974	99082000	0	27	68	4877	68	4850	0.0	0.014020618556701031
chr4	ADH4	99144196	99144203	0	8	0	2447	0	2439	0.0	0.0
chr4	TRMT10A	99563367	99563556	0	190	3291	4395	3291	4205	0.0	0.7826397146254459
chr4	H2AZ1	99950167	99950246	0	80	0	1512	0	1432	0.0	0.0
chr4	H2AZ1	99948810	99948812	0	3	0	1512	0	1509	0.0	0.0
chr4	PPP3CA	101346738	101347478	0	741	51	5231	51	4490	0.0	0.01135857461024499
chr4	MANBA	102671892	102672007	0	116	153	8306	153	8190	0.0	0.01868131868131868
chr4	UBE2D3	102827591	102827942	0	352	51	9483	51	9131	0.0	0.005585368524805607
chr4	UBE2D3	102827591	102827733	0	143	51	9483	51	9340	0.0	0.005460385438972162
chr4	UBE2D3	102825721	102825736	0	16	51	9483	51	9467	0.0	0.005387134255836062
chr4	UBE2D3	102825238	102825476	0	239	51	9483	51	9244	0.0	0.005517092167892687
chr4	AC105460.1	103556946	103556964	154	19	172282	2274	172128	2255	8.105263157894736	76.33170731707317
chr4	AC105460.1	103552500	103552506	0	7	172282	2274	172282	2267	0.0	75.99558888398765
chr4	PPA2	105456680	105456694	0	15	204	4491	204	4476	0.0	0.045576407506702415
chr4	INTS12	105707918	105708636	0	719	0	3907	0	3188	0.0	0.0
chr4	INTS12	105707918	105708150	0	233	0	3907	0	3674	0.0	0.0
chr4	INTS12	105708151	105708636	0	486	0	3907	0	3421	0.0	0.0
chr4	TBCK	106251865	106251981	0	117	2931	10864	2931	10747	0.0	0.2727272727272727
chr4	TBCK	106315926	106315929	0	4	2931	10864	2931	10860	0.0	0.26988950276243096
chr4	LEF1	108166271	108166656	0	386	102	5235	102	4849	0.0	0.021035265003093422
chr4	ETNPPL	108762820	108762841	0	22	303	2934	303	2912	0.0	0.10405219780219781
chr4	ETNPPL	108762192	108762384	0	193	303	2934	303	2741	0.0	0.1105435972272893
chr4	COL25A1	108846138	108846181	0	44	6537	6485	6537	6441	0.0	1.0149045179319982
chr4	COL25A1	109302168	109302301	0	134	6537	6485	6537	6351	0.0	1.0292867264997638
chr4	COL25A1	109302168	109302495	0	328	6537	6485	6537	6157	0.0	1.0617183693357155
chr4	PLA2G12A	109718682	109718687	0	6	4331	5225	4331	5219	0.0	0.8298524621575014
chr4	ZGRF1	112636694	112636849	0	156	0	9135	0	8979	0.0	0.0
chr4	CAMK2D	113457290	113457333	0	44	295	7387	295	7343	0.0	0.04017431567479232
chr4	LINC02262	117360543	117360562	0	20	0	2351	0	2331	0.0	0.0
chr4	METTL14-DT	118684838	118685303	0	466	102	7533	102	7067	0.0	0.014433281448988255
chr4	METTL14-DT	118678043	118680487	51	2445	102	7533	51	5088	0.020858895705521473	0.010023584905660377
chr4	NDNF	121071792	121071991	0	200	5	3580	5	3380	0.0	0.0014792899408284023
chr4	QRFPR	121332820	121332932	0	113	2754	2837	2754	2724	0.0	1.0110132158590308
chr4	ANXA5	121678351	121678413	0	63	1743	2700	1743	2637	0.0	0.6609783845278726
chr4	CETN4P	122732286	122732417	861	132	69025	3670	68164	3538	6.5227272727272725	19.26625211984172
chr4	NUDT6	122921928	122922333	0	406	0	1904	0	1498	0.0	0.0
chr4	NUDT6	122921928	122922022	0	95	0	1904	0	1809	0.0	0.0
chr4	NUDT6	122922023	122922333	0	311	0	1904	0	1593	0.0	0.0
chr4	MFSD8	127965071	127965241	0	171	204	7255	204	7084	0.0	0.028797289666854884
chr4	MFSD8	127920456	127920555	0	100	204	7255	204	7155	0.0	0.02851153039832285
chr4	MFSD8	127920452	127920555	0	104	204	7255	204	7151	0.0	0.028527478674311286
chr4	MFSD8	127920452	127920455	0	4	204	7255	204	7251	0.0	0.02813405047579644
chr4	PGRMC2	128287372	128288016	0	645	0	4427	0	3782	0.0	0.0
chr4	PGRMC2	128286668	128286714	0	47	0	4427	0	4380	0.0	0.0
chr4	SCLT1	129093069	129093141	0	73	19969	9011	19969	8938	0.0	2.2341687178339673
chr4	AC105383.1	133142605	133142709	0	105	51	11465	51	11360	0.0	0.00448943661971831
chr4	AC015631.1	134307540	134307588	0	49	51	8668	51	8619	0.0	0.005917159763313609
chr4	AC015631.1	134156377	134156425	0	49	51	8668	51	8619	0.0	0.005917159763313609
chr4	AC015631.1	134255274	134255455	0	182	51	8668	51	8486	0.0	0.0060098986566108886
chr4	LINC00613	135867835	135867844	0	10	0	541	0	531	0.0	0.0
chr4	PCDH18	137529601	137532253	0	2653	0	6690	0	4037	0.0	0.0
chr4	LINC00616	138130418	138130433	0	16	0	6060	0	6044	0.0	0.0
chr4	LINC00616	138130418	138130664	0	247	0	6060	0	5813	0.0	0.0
chr4	LINC00616	138130434	138130664	0	231	0	6060	0	5829	0.0	0.0
chr4	LINC00616	138097968	138098157	0	190	0	6060	0	5870	0.0	0.0
chr4	NDUFC1	139300601	139300962	0	362	0	2585	0	2223	0.0	0.0
chr4	NDUFC1	139300601	139302414	0	1814	0	2585	0	771	0.0	0.0
chr4	NDUFC1	139300601	139301290	0	690	0	2585	0	1895	0.0	0.0
chr4	MGAT4D	140456588	140456617	0	30	1367	2816	1367	2786	0.0	0.49066762383345297
chr4	RNF150	140967622	140967747	0	126	306	11023	306	10897	0.0	0.028081123244929798
chr4	INPP4B	142208424	142208445	0	22	2114	14202	2114	14180	0.0	0.14908321579689704
chr4	ANAPC10	145098119	145098129	0	11	10069	4412	10069	4401	0.0	2.287889116109975
chr4	ANAPC10	145097244	145097255	0	12	10069	4412	10069	4400	0.0	2.288409090909091
chr4	ANAPC10	145097886	145098118	0	233	10069	4412	10069	4179	0.0	2.4094280928451783
chr4	OTUD4	145165150	145165190	0	41	323	9541	323	9500	0.0	0.034
chr4	LINC02266	145338964	145339043	0	80	0	1730	0	1650	0.0	0.0
chr4	LINC02266	145338775	145338963	0	189	0	1730	0	1541	0.0	0.0
chr4	LINC02266	145338775	145339043	0	269	0	1730	0	1461	0.0	0.0
chr4	LINC02266	145343434	145343448	0	15	0	1730	0	1715	0.0	0.0
chr4	LINC02266	145337090	145337199	0	110	0	1730	0	1620	0.0	0.0
chr4	ZNF827	145885677	145886031	0	355	1041	16799	1041	16444	0.0	0.06330576502067624
chr4	ZNF827	145764974	145764986	0	13	1041	16799	1041	16786	0.0	0.062015965685690455
chr4	ZNF827	145764974	145764977	0	4	1041	16799	1041	16795	0.0	0.06198273295623698
chr4	ZNF827	145764978	145764986	0	9	1041	16799	1041	16790	0.0	0.0620011911852293
chr4	LINC01095	146113946	146114290	0	345	1784	3553	1784	3208	0.0	0.5561097256857855
chr4	LINC01095	146113641	146114290	0	650	1784	3553	1784	2903	0.0	0.6145366861867034
chr4	LINC01095	146113641	146113945	0	305	1784	3553	1784	3248	0.0	0.5492610837438424
chr4	NR3C2	148259965	148259976	0	12	0	6620	0	6608	0.0	0.0
chr4	AC002460.1	148941547	148941655	192	109	192	519	0	410	1.761467889908257	0.0
chr4	LRBA	150302624	150302626	0	3	1453	16823	1453	16820	0.0	0.08638525564803805
chr4	LRBA	150798076	150798079	0	4	1453	16823	1453	16819	0.0	0.08639039181877638
chr4	SH3D19	151176524	151176532	1111	9	60745	7208	59634	7199	123.44444444444444	8.283650507014864
chr4	FBXW7	152534940	152535125	0	186	21804	9870	21804	9684	0.0	2.251548946716233
chr4	PLRG1	154547010	154547036	0	27	3004	4940	3004	4913	0.0	0.6114390392835335
chr4	FGG	154612531	154612743	0	213	12	3404	12	3191	0.0	0.003760576621748668
chr4	MAP9	155376375	155376769	0	395	150	8872	150	8477	0.0	0.017694939247375252
chr4	PDGFC	156767772	156767960	0	189	1479	6013	1479	5824	0.0	0.2539491758241758
chr4	MARCHF1	164383186	164383868	51	683	28	10135	-23	9452	0.0746705710102489	-0.0024333474396953025
chr4	DDX60	168318621	168318734	0	114	0	6563	0	6449	0.0	0.0
chr4	DDX60L	168480376	168480389	0	14	254	12203	254	12189	0.0	0.020838460907375504
chr4	AADAT	170089611	170089622	0	12	51	2987	51	2975	0.0	0.017142857142857144
chr4	AADAT	170090143	170090160	0	18	51	2987	51	2969	0.0	0.017177500842034354
chr4	AADAT	170090161	170090223	0	63	51	2987	51	2924	0.0	0.01744186046511628
chr4	HMGB2	173334245	173334270	0	26	0	1802	0	1776	0.0	0.0
chr4	HMGB2	173334043	173334244	0	202	0	1802	0	1600	0.0	0.0
chr4	LINC02268	174120308	174120417	0	110	0	3430	0	3320	0.0	0.0
chr4	HPGD	174522358	174522622	0	265	0	5539	0	5274	0.0	0.0
chr4	GPM6A	175673679	175673690	0	12	0	7064	0	7052	0.0	0.0
chr4	DCTD	182917287	182917309	0	23	0	3477	0	3454	0.0	0.0
chr4	DCTD	182916672	182916721	0	50	0	3477	0	3427	0.0	0.0
chr4	DCTD	182916285	182916417	0	133	0	3477	0	3344	0.0	0.0
chr4	AC107214.1	183503666	183504174	0	509	0	1781	0	1272	0.0	0.0
chr4	LINC02362	184378498	184378963	0	466	94570	5072	94570	4606	0.0	20.53191489361702
chr4	IRF2	184473968	184473988	0	21	906	3036	906	3015	0.0	0.3004975124378109
chr4	CASP3	184648464	184648501	0	38	16697	2908	16697	2870	0.0	5.817770034843206
chr4	LINC01093	184897334	184897346	0	13	0	3158	0	3145	0.0	0.0
chr4	LINC01093	184898620	184898645	0	26	0	3158	0	3132	0.0	0.0
chr4	LINC01093	184897334	184898619	0	1286	0	3158	0	1872	0.0	0.0
chr4	LINC01093	184897334	184897668	0	335	0	3158	0	2823	0.0	0.0
chr4	LINC01093	184897347	184897668	0	322	0	3158	0	2836	0.0	0.0
chr4	CFAP97	185203784	185203896	0	113	0	6856	0	6743	0.0	0.0
chr4	UFSP2	185418586	185418610	0	25	265	2791	265	2766	0.0	0.09580621836587129
chr4	PDLIM3	185513556	185514268	115	713	408	9020	293	8307	0.16129032258064516	0.03527145780666907
chr4	SORBS2	185646667	185646698	0	32	207139	11677	207139	11645	0.0	17.787805925289824
chr4	SORBS2	185775226	185775229	0	4	207139	11677	207139	11673	0.0	17.74513835346526
chr4	SORBS2	185733997	185734097	0	101	207139	11677	207139	11576	0.0	17.89383206634416
chr4	FAT1	186596539	186597032	0	494	2966	16199	2966	15705	0.0	0.1888570518943012
chr4	FAT1	186628144	186628152	0	9	2966	16199	2966	16190	0.0	0.18319950586781963
chr4	LINC02492	187592742	187592882	0	141	5164	2773	5164	2632	0.0	1.9620060790273557
chr4	LINC02492	187558076	187558179	0	104	5164	2773	5164	2669	0.0	1.934807043836643
chr4	FRG1-DT	189939658	189940048	0	391	51	5113	51	4722	0.0	0.010800508259212199
chr4	FRG1-DT	189939658	189940168	0	511	51	5113	51	4602	0.0	0.01108213820078227
chr4	FRG1-DT	189940049	189940168	0	120	51	5113	51	4993	0.0	0.010214300020028039
chr4	ZNF718	124674	125296	28236	623	46304	5079	18068	4456	45.32263242375602	4.05475763016158
chr4	PIGG	499299	499489	62	191	262664	8690	262602	8499	0.32460732984293195	30.897987998588068
chr4	PIGG	521228	521273	2022	46	262664	8690	260642	8644	43.95652173913044	30.15293845441925
chr4	PIGG	521250	521273	1068	24	262664	8690	261596	8666	44.5	30.186475882760213
chr4	PIGG	521228	521249	954	22	262664	8690	261710	8668	43.36363636363637	30.192662667281958
chr4	PIGG	499490	499725	40744	236	262664	8690	221920	8454	172.64406779661016	26.25029571800331
chr4	PIGG	499299	499725	40806	427	262664	8690	221858	8263	95.56440281030444	26.84957037395619
chr4	PIGG	499490	500047	40744	558	262664	8690	221920	8132	73.0179211469534	27.289719626168225
chr4	PIGG	499299	500047	40806	749	262664	8690	221858	7941	54.48064085447263	27.93829492507241
chr4	PIGG	499726	500047	0	322	262664	8690	262664	8368	0.0	31.389101338432123
chr4	PIGG	521853	521941	2477	89	262664	8690	260187	8601	27.831460674157302	30.250784792465993
chr4	PIGG	525635	525837	6171	203	262664	8690	256493	8487	30.399014778325125	30.221868740426533
chr4	PDE6B	667942	668006	18215	65	56567	5076	38352	5011	280.2307692307692	7.65356216324087
chr4	MYL5	675454	675854	9966	401	16389	3390	6423	2989	24.85286783042394	2.1488792238206758
chr4	MYL5	674684	675854	13126	1171	16389	3390	3263	2219	11.20922288642186	1.4704821991888237
chr4	MYL5	674684	675453	3160	770	16389	3390	13229	2620	4.103896103896104	5.049236641221374
chr4	MYL5	679034	679173	1873	140	16389	3390	14516	3250	13.378571428571428	4.466461538461538
chr4	IDUA	987912	987949	794	38	22583	3973	21789	3935	20.894736842105264	5.53722998729352
chr4	FGFRL1	1012245	1012277	0	33	4634	4338	4634	4305	0.0	1.0764227642276423
chr4	MAEA	1312162	1312238	114	77	73349	6602	73235	6525	1.4805194805194806	11.22375478927203
chr4	MAEA	1309596	1309712	57	117	73349	6602	73292	6485	0.48717948717948717	11.3017733230532
chr4	UVSSA	1345794	1346569	2142	776	155249	15270	153107	14494	2.7603092783505154	10.563474541189457
chr4	UVSSA	1347230	1347760	1887	531	155249	15270	153362	14739	3.553672316384181	10.405183526697876
chr4	UVSSA	1347610	1347760	0	151	155249	15270	155249	15119	0.0	10.268470136913818
chr4	UVSSA	1347761	1347887	1588	127	155249	15270	153661	15143	12.503937007874017	10.147328798784917
chr4	FGFR3	1799801	1799812	0	12	9698	4866	9698	4854	0.0	1.9979398434281006
chr4	FGFR3	1801924	1802025	0	102	9698	4866	9698	4764	0.0	2.0356842989084805
chr4	FGFR3	1801987	1802025	0	39	9698	4866	9698	4827	0.0	2.0091153925833853
chr4	NSD2	1942433	1942565	3330	133	1092167	19329	1088837	19196	25.037593984962406	56.7220775161492
chr4	C4ORF48	2042069	2042175	0	107	192	544	192	437	0.0	0.43935926773455375
chr4	RNF4	2490412	2490502	0	91	262777	7130	262777	7039	0.0	37.331581190510015
chr4	RNF4	2469230	2469258	0	29	262777	7130	262777	7101	0.0	37.00563300943529
chr4	FAM193A	2695083	2695129	0	47	24520	6976	24520	6929	0.0	3.5387501804012125
chr4	FAM193A	2695130	2695142	0	13	24520	6976	24520	6963	0.0	3.52147063047537
chr4	FAM193A	2695083	2695142	0	60	24520	6976	24520	6916	0.0	3.545401966454598
chr4	SH3BP2	2823570	2823573	0	4	224879	12298	224879	12294	0.0	18.291768342280786
chr4	ADD1	2905016	2905108	1996	93	353863	11643	351867	11550	21.462365591397848	30.464675324675326
chr4	NOP14-AS1	2935736	2936890	7749	1155	446093	7475	438344	6320	6.709090909090909	69.35822784810127
chr4	NOP14-AS1	2936602	2936890	102	289	446093	7475	445991	7186	0.35294117647058826	62.06387419983301
chr4	HTT	3130000	3130047	0	48	159747	18141	159747	18093	0.0	8.829215718786271
chr4	HTT	3173132	3173331	0	200	159747	18141	159747	17941	0.0	8.904018728053062
chr4	HTT	3173219	3173331	0	113	159747	18141	159747	18028	0.0	8.861049478588862
chr4	HTT	3173132	3173218	0	87	159747	18141	159747	18054	0.0	8.848288467929544
chr4	DOK7	3476532	3476542	0	11	586	4047	586	4036	0.0	0.14519326065411298
chr4	ZBTB49	4290314	4290352	39	39	7860	2879	7821	2840	1.0	2.75387323943662
chr4	NSG1	4386644	4387173	0	530	1109	4365	1109	3835	0.0	0.2891786179921773
chr4	STX18-AS1	4542476	4542625	0	150	21734	21284	21734	21134	0.0	1.028390271600265
chr4	STX18-AS1	4542427	4542625	0	199	21734	21284	21734	21085	0.0	1.0307801754801993
chr4	STX18-AS1	4542427	4542475	0	49	21734	21284	21734	21235	0.0	1.0234989404285377
chr4	LINC01396	4847432	4847509	0	78	0	1303	0	1225	0.0	0.0
chr4	STK32B	5139779	5139817	0	39	2242	5226	2242	5187	0.0	0.43223443223443225
chr4	MRFAP1	6640709	6640755	646	47	295739	2186	295093	2139	13.74468085106383	137.95839177185601
chr4	AC093323.1	6674638	6674706	0	69	80864	2965	80864	2896	0.0	27.92265193370166
chr4	S100P	6693913	6694070	0	158	0	473	0	315	0.0	0.0
chr4	TADA2B	7043625	7043849	1738	225	207496	4547	205758	4322	7.724444444444444	47.60712633040259
chr4	SORCS2	7737173	7737214	0	42	22081	6346	22081	6304	0.0	3.5026967005076144
chr4	SH3TC1	8219450	8219530	0	81	0	8635	0	8554	0.0	0.0
chr4	GPR78	8580705	8581650	0	946	51	10176	51	9230	0.0	0.00552546045503792
chr4	CPZ	8599486	8599582	0	97	51	3293	51	3196	0.0	0.015957446808510637
chr4	AC005699.1	11770467	11770475	0	9	0	4472	0	4463	0.0	0.0
chr4	AC005699.1	11770476	11770688	0	213	0	4472	0	4259	0.0	0.0
chr4	CPEB2	15007587	15007595	0	9	189752	7383	189752	7374	0.0	25.732573908326554
chr4	CC2D2A	15576625	15577094	1428	470	16248	12486	14820	12016	3.0382978723404257	1.2333555259653795
chr4	FAM200B	15681785	15681901	2518	117	117523	3683	115005	3566	21.521367521367523	32.250420639371846
chr4	FAM200B	15681785	15681968	2542	184	117523	3683	114981	3499	13.815217391304348	32.86110317233495
chr4	FAM200B	15681902	15681968	24	67	117523	3683	117499	3616	0.3582089552238806	32.494192477876105
chr4	CD38	15824999	15825016	0	18	9741	6865	9741	6847	0.0	1.4226668613991529
chr4	NCAPG	17825562	17825567	0	6	34074	4868	34074	4862	0.0	7.008227067050597
chr4	PACRGL	20700612	20700787	0	176	124873	7747	124873	7571	0.0	16.493593977017568
chr4	PACRGL	20700748	20700787	0	40	124873	7747	124873	7707	0.0	16.202543142597637
chr4	PACRGL	20700579	20700787	0	209	124873	7747	124873	7538	0.0	16.565799946935527
chr4	PACRGL	20700707	20700787	0	81	124873	7747	124873	7666	0.0	16.289199060787894
chr4	PACRGL	20700618	20700787	0	170	124873	7747	124873	7577	0.0	16.480533192556422
chr4	PACRGL	20700579	20700617	0	39	124873	7747	124873	7708	0.0	16.200441100155683
chr4	PACRGL	20700579	20700706	0	128	124873	7747	124873	7619	0.0	16.389683685523035
chr4	PACRGL	20700579	20700611	0	33	124873	7747	124873	7714	0.0	16.187840290381125
chr4	PACRGL	20700612	20700747	0	136	124873	7747	124873	7611	0.0	16.406911049796346
chr4	PACRGL	20700579	20700747	0	169	124873	7747	124873	7578	0.0	16.47835840591185
chr4	PACRGL	20700707	20700747	0	41	124873	7747	124873	7706	0.0	16.204645730599534
chr4	PACRGL	20700618	20700747	0	130	124873	7747	124873	7617	0.0	16.393987134042273
chr4	PACRGL	20700618	20700706	0	89	124873	7747	124873	7658	0.0	16.30621572212066
chr4	PACRGL	20700612	20700706	0	95	124873	7747	124873	7652	0.0	16.31900156821746
chr4	PACRGL	20700612	20700617	0	6	124873	7747	124873	7741	0.0	16.131378374886964
chr4	AC097512.1	22997614	22997709	0	96	164	7737	164	7641	0.0	0.02146315927234655
chr4	ZCCHC4	25365073	25365166	0	94	5785	4425	5785	4331	0.0	1.3357192334333872
chr4	ANAPC4	25380446	25380479	0	34	81443	6012	81443	5978	0.0	13.623787219805955
chr4	ANAPC4	25405620	25405622	0	3	81443	6012	81443	6009	0.0	13.553503078715261
chr4	AC105290.1	25608902	25608936	0	35	12	793	12	758	0.0	0.0158311345646438
chr4	RBPJ	26320816	26321048	561	233	182912	9040	182351	8807	2.407725321888412	20.70523447257863
chr4	TBC1D19	26576798	26576829	0	32	4704	3917	4704	3885	0.0	1.2108108108108109
chr4	TBC1D19	26576820	26576829	0	10	4704	3917	4704	3907	0.0	1.2039928333759917
chr4	TBC1D19	26576798	26576819	0	22	4704	3917	4704	3895	0.0	1.2077021822849807
chr4	STIM2	26857683	26857768	0	86	82272	8406	82272	8320	0.0	9.888461538461538
chr4	LINC02364	28996727	28996871	0	145	0	1744	0	1599	0.0	0.0
chr4	LINC02497	31196416	31196461	0	46	0	646	0	600	0.0	0.0
chr4	LINC02616	37018668	37018694	0	27	0	3588	0	3561	0.0	0.0
chr4	LIAS	39459163	39459241	9739	79	222853	9122	213114	9043	123.27848101265823	23.566736702421764
chr4	LIAS	39467647	39468427	10201	781	222853	9122	212652	8341	13.06145966709347	25.494784797985854
chr4	AC108471.2	39639257	39639294	0	38	13909	3742	13909	3704	0.0	3.7551295896328294
chr4	AC108471.2	39639295	39639549	0	255	13909	3742	13909	3487	0.0	3.9888156008029827
chr4	AC108471.2	39639257	39639549	0	293	13909	3742	13909	3449	0.0	4.032763119744853
chr4	UBE2K	39698303	39698390	0	88	567672	5157	567672	5069	0.0	111.98895245610574
chr4	RHOH	40242835	40242846	0	12	2040	6620	2040	6608	0.0	0.30871670702179177
chr4	UCHL1	41264162	41264190	0	29	11536	2218	11536	2189	0.0	5.269986295111924
chr4	UCHL1	41257010	41257020	0	11	11536	2218	11536	2207	0.0	5.227004984141368
chr4	LIMCH1	41613099	41613104	0	6	0	10455	0	10449	0.0	0.0
chr4	TMEM33	41935263	41935310	0	48	236591	7774	236591	7726	0.0	30.622702562775046
chr4	AC080132.1	43763549	43763775	0	227	0	10484	0	10257	0.0	0.0
chr4	LINC02475	44017063	44017370	0	308	0	2986	0	2678	0.0	0.0
chr4	GUF1	44678586	44678787	0	202	43025	4473	43025	4271	0.0	10.07375321938656
chr4	NIPAL1	48016852	48016885	0	34	172	3240	172	3206	0.0	0.053649407361197755
chr4	OCIAD1	48831399	48831496	0	98	251287	3485	251287	3387	0.0	74.19161499852376
chr4	OCIAD1	48831250	48831496	0	247	251287	3485	251287	3238	0.0	77.60562075355158
chr4	OCIAD1	48831434	48831496	0	63	251287	3485	251287	3422	0.0	73.43278784336646
chr4	OCIAD1	48831254	48831496	0	243	251287	3485	251287	3242	0.0	77.50987045033929
chr4	OCIAD1	48831053	48831141	0	89	251287	3485	251287	3396	0.0	73.9949941107185
chr4	OCIAD1	48831250	48831398	0	149	251287	3485	251287	3336	0.0	75.32583932853717
chr4	OCIAD1	48831254	48831398	0	145	251287	3485	251287	3340	0.0	75.23562874251498
chr4	OCIAD1	48831399	48831433	0	35	251287	3485	251287	3450	0.0	72.8368115942029
chr4	OCIAD1	48831250	48831433	0	184	251287	3485	251287	3301	0.0	76.12450772493185
chr4	OCIAD1	48831254	48831433	0	180	251287	3485	251287	3305	0.0	76.03237518910741
chr4	OCIAD1	48831142	48831249	0	108	251287	3485	251287	3377	0.0	74.41131181522061
chr4	OCIAD1	48851976	48852020	82416	45	251287	3485	168871	3440	1831.4666666666667	49.090406976744184
chr4	OCIAD1	48831142	48831398	0	257	251287	3485	251287	3228	0.0	77.84603469640645
chr4	OCIAD1	48831142	48831496	0	355	251287	3485	251287	3130	0.0	80.28338658146964
chr4	OCIAD1	48831250	48831253	0	4	251287	3485	251287	3481	0.0	72.18816432059754
chr4	OCIAD1	48831142	48831253	0	112	251287	3485	251287	3373	0.0	74.49955529202491
chr4	OCIAD1	48832683	48832761	0	79	251287	3485	251287	3406	0.0	73.77774515560775
chr4	OCIAD1	48831497	48831531	0	35	251287	3485	251287	3450	0.0	72.8368115942029
chr4	OCIAD1	48831399	48831531	0	133	251287	3485	251287	3352	0.0	74.96628878281624
chr4	OCIAD1	48831434	48831531	0	98	251287	3485	251287	3387	0.0	74.19161499852376
chr4	DCUN1D4	51886639	51887244	0	606	0	6539	0	5933	0.0	0.0
chr4	SPATA18	52082511	52082560	0	50	0	4988	0	4938	0.0	0.0
chr4	DANCR	52713543	52713702	102	160	12541	7739	12439	7579	0.6375	1.6412455469059242
chr4	FIP1L1	53377836	53377923	0	88	12830	4818	12830	4730	0.0	2.712473572938689
chr4	FIP1L1	53453134	53453142	0	9	12830	4818	12830	4809	0.0	2.6679143273029737
chr4	GSX2	54100708	54100918	0	211	316	1780	316	1569	0.0	0.20140216698534097
chr4	KIT	54726039	54726050	0	12	102	5584	102	5572	0.0	0.01830581478822685
chr4	TMEM165	55417986	55418164	0	179	134	6798	134	6619	0.0	0.020244749962229944
chr4	EXOC1L	55820128	55820147	0	20	0	684	0	664	0.0	0.0
chr4	EXOC1	55853798	55853953	0	156	68	5360	68	5204	0.0	0.013066871637202153
chr4	PAICS	56435929	56435975	217	47	10980	7527	10763	7480	4.617021276595745	1.438903743315508
chr4	REST	56911090	56911536	0	447	3672	7466	3672	7019	0.0	0.5231514460749395
chr4	POLR2B	56977792	56977808	0	17	515	5303	515	5286	0.0	0.09742716609912978
chr4	IGFBP7-AS1	57201216	57201820	255	605	13558	3695	13303	3090	0.4214876033057851	4.305177993527508
chr4	UBA6-AS1	67720633	67721051	0	419	0	13708	0	13289	0.0	0.0
chr4	UGT2B10	68816486	68816737	0	252	0	2762	0	2510	0.0	0.0
chr4	DCK	70993927	70994017	0	91	0	2944	0	2853	0.0	0.0
chr4	ALB	73404337	73404406	0	70	0	3401	0	3331	0.0	0.0
chr4	EPGN	74309156	74309182	0	27	0	3305	0	3278	0.0	0.0
chr4	EPGN	74313045	74313170	0	126	0	3305	0	3179	0.0	0.0
chr4	THAP6	75542487	75542552	0	66	0	7138	0	7072	0.0	0.0
chr4	FAM47E	76268769	76268813	0	45	51	3721	51	3676	0.0	0.013873775843307944
chr4	LINC01094	78662973	78663011	0	39	7306	5306	7306	5267	0.0	1.3871273970001898
chr4	LINC00989	79492624	79492774	0	151	0	6191	0	6040	0.0	0.0
chr4	ENOPH1	82430885	82430913	0	29	0	2031	0	2002	0.0	0.0
chr4	THAP9	82904932	82904941	0	10	0	4341	0	4331	0.0	0.0
chr4	PTPN13	86764725	86764739	0	15	1623	9546	1623	9531	0.0	0.1702864337425244
chr4	NUDT9	87422618	87423012	0	395	0	3188	0	2793	0.0	0.0
chr4	NUDT9	87422676	87423012	0	337	0	3188	0	2851	0.0	0.0
chr4	NUDT9	87422618	87422675	0	58	0	3188	0	3130	0.0	0.0
chr4	MEPE	87840033	87840054	0	22	44311	2485	44311	2463	0.0	17.99066179455948
chr4	AC093866.1	89551460	89551570	0	111	2710	5989	2710	5878	0.0	0.46104117046614496
chr4	RAP1GDS1	98343262	98343319	0	58	0	5439	0	5381	0.0	0.0
chr4	METAP1	99005867	99005870	0	4	0	3921	0	3917	0.0	0.0
chr4	AP002026.1	99290949	99291005	0	57	4489	7378	4489	7321	0.0	0.6131676000546373
chr4	AP002026.1	99267765	99267836	0	72	4489	7378	4489	7306	0.0	0.6144264987681358
chr4	MTTP	99564238	99564426	0	189	3558	5317	3558	5128	0.0	0.6938377535101404
chr4	FLJ20021	101347836	101348009	0	174	0	780	0	606	0.0	0.0
chr4	AC004052.1	104230493	104230839	0	347	0	1642	0	1295	0.0	0.0
chr4	TET2	105190487	105190505	0	19	0	12501	0	12482	0.0	0.0
chr4	GSTCD	105709017	105709206	0	190	159	6140	159	5950	0.0	0.026722689075630253
chr4	GSTCD	105717779	105718039	0	261	159	6140	159	5879	0.0	0.027045415887055623
chr4	GSTCD	105710864	105710869	6	6	159	6140	153	6134	1.0	0.024942940984675577
chr4	GSTCD	105710864	105711040	50	177	159	6140	109	5963	0.2824858757062147	0.01827938956900889
chr4	GSTCD	105710870	105711040	44	171	159	6140	115	5969	0.2573099415204678	0.019266208745183446
chr4	AIMP1	106320890	106321451	4990	562	107291	8611	102301	8049	8.87900355871886	12.70977761212573
chr4	AIMP1	106316595	106316809	0	215	107291	8611	107291	8396	0.0	12.778823249166269
chr4	AIMP1	106316645	106316809	0	165	107291	8611	107291	8446	0.0	12.703173099692162
chr4	AIMP1	106316595	106320713	97358	4119	107291	8611	9933	4492	23.636319495023063	2.2112644701691897
chr4	AIMP1	106316810	106320713	97358	3904	107291	8611	9933	4707	24.93801229508197	2.110261312938177
chr4	AIMP1	106316645	106320713	97358	4069	107291	8611	9933	4542	23.92676333251413	2.1869220607661823
chr4	AIMP1	106316595	106316644	0	50	107291	8611	107291	8561	0.0	12.532531246349725
chr4	AIMP1	106320714	106321451	8110	738	107291	8611	99181	7873	10.989159891598916	12.597612091959864
chr4	AIMP1	106320714	106320889	3120	176	107291	8611	104171	8435	17.727272727272727	12.349851807943095
chr4	LINC02173	106433576	106434068	0	493	0	928	0	435	0.0	0.0
chr4	LINC02173	106433755	106434068	0	314	0	928	0	614	0.0	0.0
chr4	SGMS2	107893383	107893477	0	95	29	7647	29	7552	0.0	0.003840042372881356
chr4	SGMS2	107893383	107893658	0	276	29	7647	29	7371	0.0	0.003934337267670601
chr4	SGMS2	107893478	107893658	0	181	29	7647	29	7466	0.0	0.0038842753817305118
chr4	RPL34	108620601	108620712	0	112	23202	2419	23202	2307	0.0	10.057217165149545
chr4	LARP7	112644769	112644871	0	103	0	3712	0	3609	0.0	0.0
chr4	ANK2	113293098	113293299	0	202	41613	17468	41613	17266	0.0	2.4101123595505616
chr4	LINC02263	117361364	117361506	0	143	0	12565	0	12422	0.0	0.0
chr4	LINC02263	117372472	117372541	0	70	0	12565	0	12495	0.0	0.0
chr4	LINC02263	117371279	117371420	0	142	0	12565	0	12423	0.0	0.0
chr4	SNHG8	118278793	118279137	0	345	0	6609	0	6264	0.0	0.0
chr4	METTL14	118689405	118689457	0	53	0	6850	0	6797	0.0	0.0
chr4	SYNPO2	119031854	119032027	0	174	306	14453	306	14279	0.0	0.021430072133902935
chr4	USP53	119267436	119267482	0	47	357	9528	357	9481	0.0	0.03765425588018142
chr4	AC093752.1	119458078	119458170	357	93	28496	5140	28139	5047	3.838709677419355	5.575391321577174
chr4	AC093752.1	119460821	119460827	0	7	28496	5140	28496	5133	0.0	5.55152932008572
chr4	AC093752.1	119512921	119512970	219	50	28496	5140	28277	5090	4.38	5.555402750491159
chr4	EXOSC9	121810074	121810099	0	26	255	3262	255	3236	0.0	0.0788009888751545
chr4	KIAA1109	122209205	122209337	0	133	459	18530	459	18397	0.0	0.02494972006305376
chr4	KIAA1109	122334441	122334545	0	105	459	18530	459	18425	0.0	0.024911804613297152
chr4	ADAD1	122379446	122379684	0	239	0	2712	0	2473	0.0	0.0
chr4	ADAD1	122379586	122379684	0	99	0	2712	0	2613	0.0	0.0
chr4	ADAD1	122379446	122379585	0	140	0	2712	0	2572	0.0	0.0
chr4	IL21-AS1	122619485	122619492	0	8	1804	3485	1804	3477	0.0	0.5188380788035662
chr4	IL21-AS1	122624718	122624725	0	8	1804	3485	1804	3477	0.0	0.5188380788035662
chr4	LINC01091	123650330	123650332	0	3	23091	11515	23091	11512	0.0	2.0058200138985405
chr4	LINC01091	123827220	123827330	357	111	23091	11515	22734	11404	3.2162162162162162	1.9935110487548229
chr4	LINC01091	123894844	123895002	0	159	23091	11515	23091	11356	0.0	2.0333744276153576
chr4	LINC02379	126067421	126067480	0	60	0	1913	0	1853	0.0	0.0
chr4	PLK4	127886627	127886728	0	102	0	4400	0	4298	0.0	0.0
chr4	PLK4	127891116	127891196	0	81	0	4400	0	4319	0.0	0.0
chr4	JADE1	128810089	128810291	1148	203	29687	9067	28539	8864	5.655172413793103	3.2196525270758123
chr4	JADE1	128811397	128811403	0	7	29687	9067	29687	9060	0.0	3.276710816777042
chr4	SNHG27	131773693	131774369	0	677	0	4138	0	3461	0.0	0.0
chr4	AC107463.1	135097095	135097106	0	12	51	1126	51	1114	0.0	0.04578096947935368
chr4	LINC00499	138313325	138313401	0	77	153	20150	153	20073	0.0	0.007622179046480347
chr4	AC093766.1	138800108	138800155	0	48	0	2903	0	2855	0.0	0.0
chr4	AC093766.1	138790463	138790610	0	148	0	2903	0	2755	0.0	0.0
chr4	SCOC	140373545	140373717	0	173	3106	6302	3106	6129	0.0	0.5067710882688856
chr4	ELMOD2	140524281	140524661	0	381	48	5869	48	5488	0.0	0.008746355685131196
chr4	ZNF330	141221055	141221108	0	54	0	2504	0	2450	0.0	0.0
chr4	ZNF330	141221078	141221108	0	31	0	2504	0	2473	0.0	0.0
chr4	ZNF330	141221017	141221108	0	92	0	2504	0	2412	0.0	0.0
chr4	ZNF330	141222478	141222491	0	14	0	2504	0	2490	0.0	0.0
chr4	ZNF330	141221017	141221054	0	38	0	2504	0	2466	0.0	0.0
chr4	ZNF330	141221055	141221077	0	23	0	2504	0	2481	0.0	0.0
chr4	ZNF330	141221017	141221077	0	61	0	2504	0	2443	0.0	0.0
chr4	IL15	141636749	141637224	0	476	51	7886	51	7410	0.0	0.006882591093117409
chr4	AC107223.1	143978983	143979068	0	86	2083	15940	2083	15854	0.0	0.13138640090828813
chr4	AC107223.1	143912374	143912449	0	76	2083	15940	2083	15864	0.0	0.13130358043368634
chr4	AC107223.1	143970535	143970538	0	4	2083	15940	2083	15936	0.0	0.13071034136546184
chr4	AC107223.1	143977463	143977730	51	268	2083	15940	2032	15672	0.19029850746268656	0.1296579887697805
chr4	SMAD1	145481315	145481400	0	86	867	5209	867	5123	0.0	0.16923677532695686
chr4	SMAD1	145482821	145482868	0	48	867	5209	867	5161	0.0	0.16799069947684558
chr4	SMAD1	145482821	145483176	0	356	867	5209	867	4853	0.0	0.17865237997115185
chr4	SMAD1	145482869	145483176	0	308	867	5209	867	4901	0.0	0.17690267292389308
chr4	MMAA	145599305	145599354	0	50	23327	8168	23327	8118	0.0	2.873491007637349
chr4	MMAA	145639579	145639866	0	288	23327	8168	23327	7880	0.0	2.960279187817259
chr4	LSM6	146175812	146176437	102	626	153	3947	51	3321	0.16293929712460065	0.015356820234869015
chr4	AC097450.1	147071336	147071436	0	101	0	2638	0	2537	0.0	0.0
chr4	RPS3A	151103042	151103079	0	38	0	2240	0	2202	0.0	0.0
chr4	RPS3A	151099715	151099887	0	173	0	2240	0	2067	0.0	0.0
chr4	RPS3A	151099837	151099887	0	51	0	2240	0	2189	0.0	0.0
chr4	RPS3A	151099867	151099887	0	21	0	2240	0	2219	0.0	0.0
chr4	RPS3A	151099801	151099887	0	87	0	2240	0	2153	0.0	0.0
chr4	RPS3A	151099713	151099887	0	175	0	2240	0	2065	0.0	0.0
chr4	RPS3A	151101086	151101162	0	77	0	2240	0	2163	0.0	0.0
chr4	RPS3A	151101013	151101162	0	150	0	2240	0	2090	0.0	0.0
chr4	RPS3A	151099713	151099714	0	2	0	2240	0	2238	0.0	0.0
chr4	RPS3A	151101013	151101085	0	73	0	2240	0	2167	0.0	0.0
chr4	RPS3A	151099715	151099836	0	122	0	2240	0	2118	0.0	0.0
chr4	RPS3A	151099801	151099836	0	36	0	2240	0	2204	0.0	0.0
chr4	RPS3A	151099713	151099836	0	124	0	2240	0	2116	0.0	0.0
chr4	RPS3A	151099715	151099866	0	152	0	2240	0	2088	0.0	0.0
chr4	RPS3A	151099837	151099866	0	30	0	2240	0	2210	0.0	0.0
chr4	RPS3A	151099801	151099866	0	66	0	2240	0	2174	0.0	0.0
chr4	RPS3A	151099713	151099866	0	154	0	2240	0	2086	0.0	0.0
chr4	RPS3A	151099715	151099800	0	86	0	2240	0	2154	0.0	0.0
chr4	RPS3A	151099713	151099800	0	88	0	2240	0	2152	0.0	0.0
chr4	RPS3A	151099888	151099966	0	79	0	2240	0	2161	0.0	0.0
chr4	AC107074.1	151799498	151799617	0	120	255	2369	255	2249	0.0	0.11338372610048911
chr4	AC097375.3	151956255	151956256	0	2	0	3120	0	3118	0.0	0.0
chr4	ARFIP1	152780092	152780226	0	135	0	3791	0	3656	0.0	0.0
chr4	TRIM2	153294429	153294485	0	57	5256	14876	5256	14819	0.0	0.35467980295566504
chr4	TRIM2	153322779	153322816	0	38	5256	14876	5256	14838	0.0	0.3542256368782855
chr4	TRIM2	153152283	153152617	0	335	5256	14876	5256	14541	0.0	0.36146069733855996
chr4	TRIM2	153152613	153152617	0	5	5256	14876	5256	14871	0.0	0.35343958039136575
chr4	TRIM2	153322817	153322828	0	12	5256	14876	5256	14864	0.0	0.3536060279870829
chr4	TRIM2	153322779	153322828	0	50	5256	14876	5256	14826	0.0	0.3545123431808984
chr4	TRIM2	153322829	153324148	0	1320	5256	14876	5256	13556	0.0	0.38772499262319265
chr4	TRIM2	153322817	153324148	0	1332	5256	14876	5256	13544	0.0	0.3880685174246899
chr4	TRIM2	153222760	153223039	0	280	5256	14876	5256	14596	0.0	0.3600986571663469
chr4	TRIM2	153257608	153257766	0	159	5256	14876	5256	14717	0.0	0.35713800366922605
chr4	TRIM2	153257741	153257766	0	26	5256	14876	5256	14850	0.0	0.35393939393939394
chr4	TRIM2	153257608	153257740	0	133	5256	14876	5256	14743	0.0	0.3565081733704131
chr4	TLR2	153687989	153688047	0	59	2856	3469	2856	3410	0.0	0.8375366568914956
chr4	NPY2R	155209066	155209069	0	4	0	3524	0	3520	0.0	0.0
chr4	AC097467.3	155305092	155305151	0	60	64	5378	64	5318	0.0	0.012034599473486273
chr4	GUCY1A1	155666966	155667199	0	234	102	10473	102	10239	0.0	0.009961910342806914
chr4	GUCY1A1	155667200	155667220	0	21	102	10473	102	10452	0.0	0.00975889781859931
chr4	GUCY1B1	155772698	155772753	0	56	0	3961	0	3905	0.0	0.0
chr4	GRIA2	157221012	157221130	0	119	51	8804	51	8685	0.0	0.0058721934369602765
chr4	GRIA2	157362934	157363047	0	114	51	8804	51	8690	0.0	0.005868814729574223
chr4	GRIA2	157220726	157221130	0	405	51	8804	51	8399	0.0	0.0060721514466007855
chr4	TMEM144	158211575	158212220	0	646	0	7537	0	6891	0.0	0.0
chr4	TMEM144	158210587	158212220	0	1634	0	7537	0	5903	0.0	0.0
chr4	RXFP1	158572836	158572859	0	24	51	5710	51	5686	0.0	0.008969398522687301
chr4	RAPGEF2	159351134	159351181	0	48	233	13313	233	13265	0.0	0.017565020731247643
chr4	MSMO1	165327765	165327946	0	182	0	2856	0	2674	0.0	0.0
chr4	MSMO1	165327947	165328122	0	176	0	2856	0	2680	0.0	0.0
chr4	TLL1	165992885	165992922	428	38	8658	8130	8230	8092	11.263157894736842	1.0170538803756797
chr4	CLCN3	169620683	169621063	0	381	153	8113	153	7732	0.0	0.019787894464562857
chr4	LINC02431	171055393	171055417	0	25	107	1769	107	1744	0.0	0.06135321100917431
chr4	LINC02431	171040696	171040699	0	4	107	1769	107	1765	0.0	0.06062322946175638
chr4	HAND2-AS1	173530540	173530632	0	93	44	14033	44	13940	0.0	0.0031563845050215206
chr4	HAND2-AS1	173582879	173583162	0	284	44	14033	44	13749	0.0	0.003200232744199578
chr4	HAND2-AS1	173531782	173534122	0	2341	44	14033	44	11692	0.0	0.00376325692781389
chr4	LINC02269	173699198	173699238	0	41	0	3896	0	3855	0.0	0.0
chr4	LINC02269	173928618	173928644	0	27	0	3896	0	3869	0.0	0.0
chr4	CEP44	174283944	174284061	0	118	2356	6686	2356	6568	0.0	0.3587088915956151
chr4	CEP44	174283944	174284140	0	197	2356	6686	2356	6489	0.0	0.36307597472646014
chr4	CEP44	174284062	174284140	0	79	2356	6686	2356	6607	0.0	0.3565914938701377
chr4	LINC02509	176875803	176875853	0	51	0	1085	0	1034	0.0	0.0
chr4	WWC2	183261386	183261532	0	147	357	10028	357	9881	0.0	0.03612994636170428
chr4	WWC2	183280898	183280969	0	72	357	10028	357	9956	0.0	0.03585777420650864
chr4	CDKN2AIP	183445635	183445665	0	31	0	2937	0	2906	0.0	0.0
chr4	AC084871.3	184844204	184844468	0	265	0	1579	0	1314	0.0	0.0
chr4	HELT	185018956	185019087	0	132	0	1239	0	1107	0.0	0.0
chr4	LINC02436	185055238	185055341	0	104	0	7067	0	6963	0.0	0.0
chr4	LINC02436	185071721	185072073	0	353	0	7067	0	6714	0.0	0.0
chr4	LINC02436	185062592	185062816	0	225	0	7067	0	6842	0.0	0.0
chr4	LINC02436	185070031	185070049	0	19	0	7067	0	7048	0.0	0.0
chr4	LINC02436	185071680	185071720	0	41	0	7067	0	7026	0.0	0.0
chr4	LINC02436	185086347	185086726	0	380	0	7067	0	6687	0.0	0.0
chr4	SNX25	185264499	185264610	24	112	462	5091	438	4979	0.21428571428571427	0.08796947178148222
chr4	SNX25	185332714	185332759	0	46	462	5091	462	5045	0.0	0.09157581764122893
chr4	C4ORF47	185426397	185426421	0	25	0	1374	0	1349	0.0	0.0
chr4	FAM149A	186144273	186144332	0	60	850	5237	850	5177	0.0	0.16418775352520765
chr4	FAM149A	186144591	186144715	0	125	850	5237	850	5112	0.0	0.16627543035993742
chr4	AC097521.1	187650560	187650661	0	102	408	6484	408	6382	0.0	0.06392980256972736
chr4	LINC02434	188160103	188160119	0	17	0	1294	0	1277	0.0	0.0
chr4	LINC02434	188160120	188160123	0	4	0	1294	0	1290	0.0	0.0
chr4	LINC02434	188160103	188160123	0	21	0	1294	0	1273	0.0	0.0
chr4	LINC02434	188160120	188160332	0	213	0	1294	0	1081	0.0	0.0
chr4	FRG1	189942001	189942004	0	4	0	1559	0	1555	0.0	0.0
chr4	DUX4	190174251	190175056	0	806	0	2042	0	1236	0.0	0.0
chr5	PDCD6	306755	306760	12229	6	1215560	9301	1203331	9295	2038.1666666666667	129.4600322754169
chr5	AHRR	343965	343969	0	5	2250227	8659	2250227	8654	0.0	260.0216085047377
chr5	EXOC3	462308	462529	67464	222	1071961	8157	1004497	7935	303.8918918918919	126.59067422810334
chr5	SLC9A3-AS1	477337	477465	17810	129	689195	3334	671385	3205	138.06201550387595	209.4804992199688
chr5	AC124852.1	2114394	2114537	0	144	51	14286	51	14142	0.0	0.0036062791684344504
chr5	LINC01020	5034538	5034836	0	299	0	4734	0	4435	0.0	0.0
chr5	LINC01020	5059682	5060555	0	874	0	4734	0	3860	0.0	0.0
chr5	LINC01020	5034608	5034836	0	229	0	4734	0	4505	0.0	0.0
chr5	LINC01020	5034538	5034607	0	70	0	4734	0	4664	0.0	0.0
chr5	LINC01018	6582559	6582601	0	43	99762	7086	99762	7043	0.0	14.164702541530598
chr5	LINC01018	6582712	6582798	0	87	99762	7086	99762	6999	0.0	14.253750535790827
chr5	LINC01018	6583802	6583848	0	47	99762	7086	99762	7039	0.0	14.172751811336838
chr5	TENT4A	6714700	6715119	14519	420	817596	6281	803077	5861	34.569047619047616	137.0204743217881
chr5	TENT4A	6714943	6715119	151	177	817596	6281	817445	6104	0.8531073446327684	133.91956094364352
chr5	MTRR	7869190	7869215	0	26	169758	6426	169758	6400	0.0	26.5246875
chr5	MTRR	7873513	7873526	838	14	169758	6426	168920	6412	59.857142857142854	26.34435433562071
chr5	MTRR	7869299	7869718	788	420	169758	6426	168970	6006	1.8761904761904762	28.133533133533135
chr5	MIR4458HG	8451645	8451657	221	13	73512	7223	73291	7210	17.0	10.16518723994452
chr5	AC016576.1	13860516	13860555	0	40	0	3915	0	3875	0.0	0.0
chr5	TRIO	14487731	14488260	12457	530	1678705	17006	1666248	16476	23.50377358490566	101.1318281136198
chr5	OTULIN	14681608	14681624	5657	17	429298	8760	423641	8743	332.7647058823529	48.4548781882649
chr5	AC010491.2	14728973	14729015	0	43	3162	4580	3162	4537	0.0	0.6969363015208287
chr5	LINC02217	17404321	17404729	0	409	0	8721	0	8312	0.0	0.0
chr5	LINC02217	17404089	17404729	0	641	0	8721	0	8080	0.0	0.0
chr5	LINC02217	17404593	17404729	0	137	0	8721	0	8584	0.0	0.0
chr5	LINC02217	17404352	17404729	0	378	0	8721	0	8343	0.0	0.0
chr5	LINC02217	17404089	17404320	0	232	0	8721	0	8489	0.0	0.0
chr5	LINC02217	17404321	17404592	0	272	0	8721	0	8449	0.0	0.0
chr5	LINC02217	17404352	17404592	0	241	0	8721	0	8480	0.0	0.0
chr5	LINC02217	17404321	17404351	0	31	0	8721	0	8690	0.0	0.0
chr5	LINC02223	17807977	17808103	0	127	0	7967	0	7840	0.0	0.0
chr5	LINC02241	20807866	20807913	0	48	0	9146	0	9098	0.0	0.0
chr5	LINC02241	20936985	20937257	0	273	0	9146	0	8873	0.0	0.0
chr5	LINC02241	20612874	20613033	0	160	0	9146	0	8986	0.0	0.0
chr5	LINC02241	20737102	20737145	0	44	0	9146	0	9102	0.0	0.0
chr5	PURPL	27218049	27218333	0	285	210	4915	210	4630	0.0	0.04535637149028078
chr5	PURPL	27475696	27475781	6	86	210	4915	204	4829	0.06976744186046512	0.04224477117415614
chr5	PURPL	27472453	27472519	0	67	210	4915	210	4848	0.0	0.043316831683168314
chr5	LINC02109	29153734	29153800	0	67	0	5628	0	5561	0.0	0.0
chr5	LINC02109	29153621	29153800	0	180	0	5628	0	5448	0.0	0.0
chr5	LINC02109	29162569	29162589	0	21	0	5628	0	5607	0.0	0.0
chr5	LINC02109	29164985	29165046	0	62	0	5628	0	5566	0.0	0.0
chr5	LINC02109	29153621	29153733	0	113	0	5628	0	5515	0.0	0.0
chr5	LINC02109	29162590	29162590	0	1	0	5628	0	5627	0.0	0.0
chr5	LINC02109	29162569	29162590	0	22	0	5628	0	5606	0.0	0.0
chr5	C5ORF22	31534326	31534417	3202	92	251685	3849	248483	3757	34.80434782608695	66.13867447431461
chr5	TARS1	33440777	33440791	0	15	597830	4126	597830	4111	0.0	145.4220384334712
chr5	RAI14	34757583	34757598	729	16	301197	7612	300468	7596	45.5625	39.55608214849921
chr5	RAI14	34757599	34757614	670	16	301197	7612	300527	7596	41.875	39.56384939441811
chr5	RAI14	34757583	34757614	1399	32	301197	7612	299798	7580	43.71875	39.55118733509235
chr5	RAI14	34656476	34656696	1649	221	301197	7612	299548	7391	7.461538461538462	40.528751183872274
chr5	RAI14	34684716	34684775	0	60	301197	7612	301197	7552	0.0	39.88307733050848
chr5	TTC23L	34839197	34839259	0	63	1595	2550	1595	2487	0.0	0.6413349416968235
chr5	TTC23L	34839260	34839363	466	104	1595	2550	1129	2446	4.480769230769231	0.4615699100572363
chr5	SPEF2	35694349	35694363	0	15	48878	16187	48878	16172	0.0	3.022384368043532
chr5	SKP2	36170443	36170453	2266	11	447966	10355	445700	10344	206.0	43.087780355761794
chr5	NIPBL	37063979	37064019	163	41	104702	12568	104539	12527	3.975609756097561	8.345094595673345
chr5	EGFLAM	38448380	38448419	0	40	80	6208	80	6168	0.0	0.01297016861219196
chr5	OSMR	38846127	38846387	30007	261	1364715	7196	1334708	6935	114.96934865900383	192.4596971881759
chr5	AC025171.3	43024098	43024109	0	12	14106	1782	14106	1770	0.0	7.969491525423729
chr5	AC025171.3	43019317	43020098	495	782	14106	1782	13611	1000	0.6329923273657289	13.611
chr5	ZNF131	43161607	43161613	940	7	265777	8233	264837	8226	134.28571428571428	32.195113056163386
chr5	NNT	43602750	43602753	0	4	654496	10606	654496	10602	0.0	61.733257875872475
chr5	NNT	43602750	43602890	3791	141	654496	10606	650705	10465	26.886524822695037	62.17916865742953
chr5	NNT	43602754	43602890	3791	137	654496	10606	650705	10469	27.67153284671533	62.15541121406056
chr5	NNT	43602891	43603004	10654	114	654496	10606	643842	10492	93.45614035087719	61.36504003049943
chr5	NNT	43648183	43648440	1624	258	654496	10606	652872	10348	6.294573643410852	63.09161190568226
chr5	NNT	43613138	43613481	20877	344	654496	10606	633619	10262	60.68895348837209	61.744201909959074
chr5	NNT	43603295	43603487	5678	193	654496	10606	648818	10413	29.419689119170986	62.3084605781235
chr5	NNT	43613138	43613650	21273	513	654496	10606	633223	10093	41.46783625730994	62.73882889131081
chr5	NNT	43613482	43613650	396	169	654496	10606	654100	10437	2.3431952662721893	62.671265689374344
chr5	AC008966.1	53110149	53110405	0	257	0	7567	0	7310	0.0	0.0
chr5	LINC01033	54313603	54313750	48	148	48	3578	0	3430	0.32432432432432434	0.0
chr5	LINC01033	54401866	54403788	0	1923	48	3578	48	1655	0.0	0.029003021148036254
chr5	LINC01033	54400533	54400598	0	66	48	3578	48	3512	0.0	0.01366742596810934
chr5	SNX18	54519574	54519726	0	153	17695	6656	17695	6503	0.0	2.721051822235891
chr5	GPX8	55160244	55160396	213	153	5413	3883	5200	3730	1.392156862745098	1.3941018766756033
chr5	DDX4	55738190	55738340	0	151	0	3844	0	3693	0.0	0.0
chr5	DDX4	55767941	55768089	0	149	0	3844	0	3695	0.0	0.0
chr5	IL31RA	55908397	55908411	0	15	0	6391	0	6376	0.0	0.0
chr5	SETD9	56911503	56911536	0	34	0	2601	0	2567	0.0	0.0
chr5	PART1	60521644	60522966	0	1323	487	12711	487	11388	0.0	0.042764313312258516
chr5	NDUFAF2	60945383	60945428	0	46	0	6915	0	6869	0.0	0.0
chr5	C5ORF64	61748696	61748719	0	24	40911	22226	40911	22202	0.0	1.8426718313665436
chr5	C5ORF64	61750545	61751770	153	1226	40911	22226	40758	21000	0.12479608482871125	1.9408571428571428
chr5	KIF2A	62352654	62352710	0	57	357	12836	357	12779	0.0	0.027936458251819393
chr5	KIF2A	62306537	62306583	0	47	357	12836	357	12789	0.0	0.027914614121510674
chr5	IPO11	62404104	62404156	0	53	102	7579	102	7526	0.0	0.01355301621047037
chr5	SHISAL2B	64694183	64694199	0	17	488	1241	488	1224	0.0	0.39869281045751637
chr5	NLN	65792602	65792655	0	54	51	10957	51	10903	0.0	0.004677611666513803
chr5	ERBIN	66044299	66044310	0	12	135	10160	135	10148	0.0	0.013303113914071739
chr5	AC112206.2	67797493	67797507	0	15	278	5824	278	5809	0.0	0.047856773971423655
chr5	PIK3R1	68215950	68215953	0	4	592	10428	592	10424	0.0	0.056792018419033
chr5	CCNB1	69167284	69167485	0	202	408	2442	408	2240	0.0	0.18214285714285713
chr5	CENPH	69195751	69195791	0	41	5382	2227	5382	2186	0.0	2.462031107044831
chr5	MRPS36	69218112	69218115	0	4	2450	1563	2450	1559	0.0	1.5715202052597819
chr5	MRPS36	69217872	69218111	1409	240	2450	1563	1041	1323	5.870833333333334	0.7868480725623582
chr5	CDK7	69234908	69235041	0	134	4518	2383	4518	2249	0.0	2.0088928412627833
chr5	CDK7	69254668	69254669	2	2	4518	2383	4516	2381	1.0	1.8966820663586728
chr5	RAD17	69369934	69370284	8331	351	43435	4169	35104	3818	23.735042735042736	9.194342587742273
chr5	GTF2H2C	69560243	69560403	0	161	252	6782	252	6621	0.0	0.038060715903942
chr5	PTCD2	72320510	72321179	31	670	17955	11876	17924	11206	0.04626865671641791	1.5995002677137249
chr5	BTF3	73498559	73498799	0	241	0	5245	0	5004	0.0	0.0
chr5	UTP15	73565913	73566186	0	274	0	6337	0	6063	0.0	0.0
chr5	IQGAP2	76609180	76609230	0	51	206	7905	206	7854	0.0	0.026228673287496816
chr5	AGGF1	77030608	77030976	0	369	1938	5041	1938	4672	0.0	0.4148116438356164
chr5	ZBED3-AS1	77098670	77098747	0	78	51	16340	51	16262	0.0	0.0031361456155454435
chr5	TENT2	79612692	79612735	0	44	255	5274	255	5230	0.0	0.04875717017208413
chr5	TENT2	79612736	79612769	0	34	255	5274	255	5240	0.0	0.04866412213740458
chr5	TENT2	79612692	79612769	0	78	255	5274	255	5196	0.0	0.04907621247113164
chr5	THBS4	79998376	79998427	0	52	159	4635	159	4583	0.0	0.034693432249618156
chr5	CKMT2	81233378	81233381	4	4	294	2343	290	2339	1.0	0.12398460880718255
chr5	ZCCHC9	81301671	81301698	0	28	2870	5131	2870	5103	0.0	0.5624142661179699
chr5	ZCCHC9	81301671	81305141	2856	3471	2870	5131	14	1660	0.8228176318063959	0.008433734939759036
chr5	ZCCHC9	81301699	81305141	2856	3443	2870	5131	14	1688	0.8295091489979669	0.008293838862559242
chr5	ZCCHC9	81301699	81302055	0	357	2870	5131	2870	4774	0.0	0.6011730205278593
chr5	ZCCHC9	81301671	81302055	0	385	2870	5131	2870	4746	0.0	0.6047197640117994
chr5	ATG10	81972307	81972591	0	285	204	5459	204	5174	0.0	0.039427908774642445
chr5	XRCC4	83077616	83077662	0	47	2048	2656	2048	2609	0.0	0.7849750862399387
chr5	EDIL3-DT	84387937	84388163	0	227	0	8926	0	8699	0.0	0.0
chr5	COX7C	86619443	86619496	0	54	3162	1972	3162	1918	0.0	1.64859228362878
chr5	COX7C	86618054	86618130	0	77	3162	1972	3162	1895	0.0	1.6686015831134564
chr5	COX7C	86619497	86619878	1173	382	3162	1972	1989	1590	3.0706806282722514	1.2509433962264151
chr5	COX7C	86619443	86619878	1173	436	3162	1972	1989	1536	2.6903669724770642	1.294921875
chr5	LINC02059	86746952	86747067	0	116	0	885	0	769	0.0	0.0
chr5	RASA1	87268991	87269055	0	65	51	5265	51	5200	0.0	0.009807692307692307
chr5	TMEM161B-AS1	88269028	88269119	0	92	3060	27299	3060	27207	0.0	0.11247105524313596
chr5	TMEM161B-AS1	88269076	88269119	0	44	3060	27299	3060	27255	0.0	0.11227297743533296
chr5	TMEM161B-AS1	88269618	88269687	0	70	3060	27299	3060	27229	0.0	0.11238018289323883
chr5	TMEM161B-AS1	88270586	88270741	0	156	3060	27299	3060	27143	0.0	0.11273624875658549
chr5	MEF2C-AS1	88904161	88904203	0	43	0	7887	0	7844	0.0	0.0
chr5	POLR3G	90497707	90497735	0	29	0	4035	0	4006	0.0	0.0
chr5	ADGRV1	90690959	90691041	0	83	25342	33926	25342	33843	0.0	0.7488106846319771
chr5	AC114316.1	92329361	92329371	0	11	5304	7357	5304	7346	0.0	0.7220255921589981
chr5	RHOBTB3	95713591	95713711	0	121	0	7954	0	7833	0.0	0.0
chr5	CAST	96722699	96722718	0	20	1543	12297	1543	12277	0.0	0.12568216991121609
chr5	CAST	96703373	96703424	0	52	1543	12297	1543	12245	0.0	0.12601061657819518
chr5	ERAP2	96900190	96900245	0	56	0	6815	0	6759	0.0	0.0
chr5	ERAP2	96909765	96909809	0	45	0	6815	0	6770	0.0	0.0
chr5	PAM	102755349	102755469	0	121	6889	8786	6889	8665	0.0	0.7950375072129255
chr5	EPB41L4A-AS1	112160992	112161295	0	304	3774	3497	3774	3193	0.0	1.181960538678359
chr5	APC	112707650	112707882	0	233	0	12460	0	12227	0.0	0.0
chr5	COMMD10	116092696	116092700	0	5	30	2453	30	2448	0.0	0.012254901960784314
chr5	HSD17B4	119477493	119477501	0	9	153	10487	153	10478	0.0	0.01460202328688681
chr5	HSD17B4	119452634	119452821	0	188	153	10487	153	10299	0.0	0.014855811243810078
chr5	FAM170A	119634253	119634734	0	482	0	1383	0	901	0.0	0.0
chr5	ZNF474	122129684	122129704	0	21	42501	2086	42501	2065	0.0	20.581598062953994
chr5	SNCAIP	122311783	122311797	0	15	2999	7286	2999	7271	0.0	0.4124604593590978
chr5	SNCAIP	122311783	122311838	0	56	2999	7286	2999	7230	0.0	0.41479944674965424
chr5	SNCAIP	122311798	122311838	0	41	2999	7286	2999	7245	0.0	0.4139406487232574
chr5	SNX2	122775212	122775762	0	551	153	8164	153	7613	0.0	0.020097202154209903
chr5	SNX24	123002005	123002080	0	76	1464	3491	1464	3415	0.0	0.428696925329429
chr5	LMNB1	126777245	126777867	0	623	0	2990	0	2367	0.0	0.0
chr5	LMNB1	126777253	126777867	0	615	0	2990	0	2375	0.0	0.0
chr5	LMNB1	126777245	126777252	0	8	0	2990	0	2982	0.0	0.0
chr5	ISOC1	129095049	129095075	0	27	0	1945	0	1918	0.0	0.0
chr5	ADAMTS19	129526457	129526515	0	59	0	5416	0	5357	0.0	0.0
chr5	CDC42SE2	131359548	131359558	0	11	153	4667	153	4656	0.0	0.03286082474226804
chr5	RAD50	132575864	132575928	340	65	612	9711	272	9646	5.230769230769231	0.02819821687746216
chr5	RAD50	132557010	132557453	0	444	612	9711	612	9267	0.0	0.0660407898996439
chr5	RAD50	132557454	132557745	0	292	612	9711	612	9419	0.0	0.06497505042998195
chr5	UQCRQ	132866688	132866691	0	4	0	2072	0	2068	0.0	0.0
chr5	UQCRQ	132866688	132867035	0	348	0	2072	0	1724	0.0	0.0
chr5	TCF7	134115631	134115674	0	44	46149	7296	46149	7252	0.0	6.363623827909542
chr5	TCF7	134116034	134116086	231	53	46149	7296	45918	7243	4.3584905660377355	6.339638271434488
chr5	TCF7	134138165	134138237	0	73	46149	7296	46149	7223	0.0	6.389173473625918
chr5	JADE2	134525743	134526011	0	269	0	9892	0	9623	0.0	0.0
chr5	JADE2	134525997	134526011	0	15	0	9892	0	9877	0.0	0.0
chr5	JADE2	134576897	134577038	0	142	0	9892	0	9750	0.0	0.0
chr5	DDX46	134816604	134816606	0	3	51	9230	51	9227	0.0	0.005527256963259998
chr5	C5ORF24	134855163	134855327	0	165	0	3870	0	3705	0.0	0.0
chr5	TXNDC15	134874484	134874530	0	47	0	4783	0	4736	0.0	0.0
chr5	AC114296.1	135821947	135822151	0	205	0	2718	0	2513	0.0	0.0
chr5	TGFBI	136046496	136046556	0	61	0	5453	0	5392	0.0	0.0
chr5	SMAD5	136132963	136133959	0	997	175	8791	175	7794	0.0	0.022453169104439313
chr5	SMAD5	136133474	136133959	0	486	175	8791	175	8305	0.0	0.02107164358819988
chr5	AC109439.1	136753973	136753976	0	4	255	2609	255	2605	0.0	0.09788867562380038
chr5	MYOT	137870526	137871007	0	482	6914	2836	6914	2354	0.0	2.937128292268479
chr5	FAM53C	138341265	138341413	102	149	623	6668	521	6519	0.6845637583892618	0.0799202331645958
chr5	CTNNA1	138875598	138875738	5457	141	28977	8697	23520	8556	38.702127659574465	2.7489481065918655
chr5	CTNNA1	138875607	138875738	5457	132	28977	8697	23520	8565	41.34090909090909	2.7460595446584937
chr5	CTNNA1	138875598	138875606	0	9	28977	8697	28977	8688	0.0	3.3352900552486187
chr5	MATR3	139274162	139274165	0	4	765	12741	765	12737	0.0	0.060061238910261446
chr5	MATR3	139293773	139293805	0	33	765	12741	765	12708	0.0	0.06019830028328612
chr5	MATR3	139293773	139294028	0	256	765	12741	765	12485	0.0	0.06127352823388066
chr5	MATR3	139293806	139294028	0	223	765	12741	765	12518	0.0	0.061111998721840546
chr5	MATR3	139294029	139294100	0	72	765	12741	765	12669	0.0	0.060383613544873316
chr5	MATR3	139294617	139294842	0	226	765	12741	765	12515	0.0	0.06112664802237315
chr5	MATR3	139294843	139294997	0	155	765	12741	765	12586	0.0	0.060781821071031306
chr5	PAIP2	139342617	139343406	357	790	612	3154	255	2364	0.4518987341772152	0.10786802030456853
chr5	CXXC5	139675534	139675538	0	5	0	3537	0	3532	0.0	0.0
chr5	PSD2	139822785	139822787	0	3	15364	4547	15364	4544	0.0	3.381161971830986
chr5	PURA	140108101	140108219	0	119	0	12523	0	12404	0.0	0.0
chr5	AC011379.2	140167474	140167477	4	4	582	897	578	893	1.0	0.6472564389697648
chr5	SLC4A9	140365570	140365578	0	9	3012	3662	3012	3653	0.0	0.8245277853818779
chr5	ANKHD1	140538235	140538261	0	27	10723	11160	10723	11133	0.0	0.9631725500763496
chr5	TMCO6	140639564	140639608	0	45	186	3038	186	2993	0.0	0.062145005011693955
chr5	TMCO6	140639564	140639612	0	49	186	3038	186	2989	0.0	0.06222816995650719
chr5	TMCO6	140639609	140639612	0	4	186	3038	186	3034	0.0	0.061305207646671064
chr5	TMCO6	140644189	140644194	0	6	186	3038	186	3032	0.0	0.06134564643799472
chr5	TMCO6	140639852	140639864	0	13	186	3038	186	3025	0.0	0.06148760330578512
chr5	HARS2	140691516	140691756	0	241	454766	3423	454766	3182	0.0	142.91829038340666
chr5	HARS2	140691938	140692017	0	80	454766	3423	454766	3343	0.0	136.03529763685313
chr5	ZMAT2	140703992	140704004	0	13	71133	1716	71133	1703	0.0	41.76923076923077
chr5	PCDHA1	140787893	140788684	2149	792	101991	5444	99842	4652	2.7133838383838382	21.462166809974203
chr5	PCDHA6	140829694	140830485	0	792	98407	6033	98407	5241	0.0	18.776378553711123
chr5	PCDHA10	140857648	140858436	79698	789	638691	6271	558993	5482	101.01140684410646	101.9688070047428
chr5	PCDHA10	140984150	140984249	0	100	638691	6271	638691	6171	0.0	103.49878463782207
chr5	PCDHB12	141208943	141209072	0	130	0	3129	0	2999	0.0	0.0
chr5	PCDHGA11	141423106	141423660	0	555	244526	5633	244526	5078	0.0	48.15399763686491
chr5	PCDHGC3	141476147	141478546	102	2400	244169	5020	244067	2620	0.0425	93.15534351145038
chr5	RELL2	141637749	141638409	0	661	0	2590	0	1929	0.0	0.0
chr5	RNF14	141969168	141969234	0	67	6565	4992	6565	4925	0.0	1.332994923857868
chr5	RNF14	141969386	141969617	0	232	6565	4992	6565	4760	0.0	1.379201680672269
chr5	LINC01844	142757904	142757934	0	31	162	3613	162	3582	0.0	0.04522613065326633
chr5	LINC01844	142745719	142745722	0	4	162	3613	162	3609	0.0	0.04488778054862843
chr5	ARHGAP26	143207309	143207473	0	165	51	17199	51	17034	0.0	0.0029940119760479044
chr5	ARHGAP26	143214086	143214088	0	3	51	17199	51	17196	0.0	0.0029658060013956736
chr5	AC008700.1	145429926	145430633	0	708	0	2327	0	1619	0.0	0.0
chr5	FBXO38	148427723	148427947	0	225	6460	8747	6460	8522	0.0	0.7580380192443088
chr5	PCYOX1L	149358157	149358172	1	16	98121	4004	98120	3988	0.0625	24.60381143430291
chr5	CARMN	149420545	149421068	0	524	617006	14357	617006	13833	0.0	44.60391816670281
chr5	CARMN	149423310	149423639	207	330	617006	14357	616799	14027	0.6272727272727273	43.97226776930206
chr5	CARMN	149424245	149424397	0	153	617006	14357	617006	14204	0.0	43.43889045339341
chr5	TCOF1	150391658	150391795	0	138	5079	10045	5079	9907	0.0	0.5126678106389422
chr5	NDST1	150497980	150498239	0	260	7936	9532	7936	9272	0.0	0.8559102674719585
chr5	GPX3	151020855	151021253	0	399	52	2903	52	2504	0.0	0.020766773162939296
chr5	G3BP1	151771913	151771964	0	52	0	10115	0	10063	0.0	0.0
chr5	G3BP1	151771965	151771976	0	12	0	10115	0	10103	0.0	0.0
chr5	G3BP1	151771913	151771976	0	64	0	10115	0	10051	0.0	0.0
chr5	G3BP1	151795529	151795575	0	47	0	10115	0	10068	0.0	0.0
chr5	G3BP1	151800262	151800346	0	85	0	10115	0	10030	0.0	0.0
chr5	G3BP1	151771913	151772036	0	124	0	10115	0	9991	0.0	0.0
chr5	G3BP1	151772033	151772036	0	4	0	10115	0	10111	0.0	0.0
chr5	G3BP1	151803997	151804141	0	145	0	10115	0	9970	0.0	0.0
chr5	G3BP1	151771965	151772036	0	72	0	10115	0	10043	0.0	0.0
chr5	G3BP1	151771977	151772036	0	60	0	10115	0	10055	0.0	0.0
chr5	G3BP1	151804142	151804162	0	21	0	10115	0	10094	0.0	0.0
chr5	G3BP1	151803997	151804162	0	166	0	10115	0	9949	0.0	0.0
chr5	G3BP1	151771965	151772040	0	76	0	10115	0	10039	0.0	0.0
chr5	G3BP1	151771977	151772040	0	64	0	10115	0	10051	0.0	0.0
chr5	G3BP1	151772037	151772040	0	4	0	10115	0	10111	0.0	0.0
chr5	G3BP1	151772033	151772040	0	8	0	10115	0	10107	0.0	0.0
chr5	G3BP1	151800001	151800043	0	43	0	10115	0	10072	0.0	0.0
chr5	G3BP1	151771965	151772032	0	68	0	10115	0	10047	0.0	0.0
chr5	G3BP1	151771977	151772032	0	56	0	10115	0	10059	0.0	0.0
chr5	G3BP1	151772568	151772668	0	101	0	10115	0	10014	0.0	0.0
chr5	G3BP1	151790991	151791062	0	72	0	10115	0	10043	0.0	0.0
chr5	G3BP1	151804142	151804203	0	62	0	10115	0	10053	0.0	0.0
chr5	G3BP1	151804163	151804203	0	41	0	10115	0	10074	0.0	0.0
chr5	G3BP1	151803997	151804203	0	207	0	10115	0	9908	0.0	0.0
chr5	AC008571.2	152720629	152720650	0	22	0	4211	0	4189	0.0	0.0
chr5	MFAP3	154039012	154039308	0	297	15637	7808	15637	7511	0.0	2.0818799094661165
chr5	MFAP3	154039067	154039308	0	242	15637	7808	15637	7566	0.0	2.0667459688078247
chr5	MFAP3	154039303	154039308	0	6	15637	7808	15637	7802	0.0	2.0042296846962318
chr5	MFAP3	154039012	154039066	0	55	15637	7808	15637	7753	0.0	2.016896685154134
chr5	MFAP3	154039012	154039302	0	291	15637	7808	15637	7517	0.0	2.0802181721431423
chr5	MFAP3	154039067	154039302	0	236	15637	7808	15637	7572	0.0	2.065108293713682
chr5	LARP1	154793923	154794000	0	78	282	8718	282	8640	0.0	0.03263888888888889
chr5	CNOT8	154858769	154858816	0	48	0	3723	0	3675	0.0	0.0
chr5	CNOT8	154858798	154858816	0	19	0	3723	0	3704	0.0	0.0
chr5	CNOT8	154858802	154858816	0	15	0	3723	0	3708	0.0	0.0
chr5	CNOT8	154858526	154858543	0	18	0	3723	0	3705	0.0	0.0
chr5	CNOT8	154858769	154858797	0	29	0	3723	0	3694	0.0	0.0
chr5	CNOT8	154858769	154858801	0	33	0	3723	0	3690	0.0	0.0
chr5	CNOT8	154858798	154858801	0	4	0	3723	0	3719	0.0	0.0
chr5	CNOT8	154859838	154859873	0	36	0	3723	0	3687	0.0	0.0
chr5	CNOT8	154858769	154858833	0	65	0	3723	0	3658	0.0	0.0
chr5	CNOT8	154858817	154858833	0	17	0	3723	0	3706	0.0	0.0
chr5	CNOT8	154858798	154858833	0	36	0	3723	0	3687	0.0	0.0
chr5	CNOT8	154858802	154858833	0	32	0	3723	0	3691	0.0	0.0
chr5	CYFIP2	157266196	157266584	50	389	629	10488	579	10099	0.12853470437017994	0.057332409149420734
chr5	TTC1	160009191	160009193	0	3	0	1802	0	1799	0.0	0.0
chr5	GABRA6	161687524	161687561	0	38	51	3163	51	3125	0.0	0.01632
chr5	GABRA1	161847412	161847466	0	55	51	6688	51	6633	0.0	0.007688828584350972
chr5	GABRA1	161847714	161847786	0	73	51	6688	51	6615	0.0	0.007709750566893424
chr5	GABRA1	161848970	161849035	0	66	51	6688	51	6622	0.0	0.007701600724856539
chr5	GABRA1	161850668	161850685	0	18	51	6688	51	6670	0.0	0.007646176911544228
chr5	GABRA1	161850681	161850685	0	5	51	6688	51	6683	0.0	0.0076313033068981
chr5	GABRA1	161850668	161850680	0	13	51	6688	51	6675	0.0	0.007640449438202248
chr5	GABRG2	162067642	162068106	0	465	918	19638	918	19173	0.0	0.04787983101236113
chr5	GABRG2	162149314	162151753	0	2440	918	19638	918	17198	0.0	0.053378299802302596
chr5	CCNG1	163437751	163437804	0	54	0	2779	0	2725	0.0	0.0
chr5	HMMR	163460367	163460422	0	56	0	3950	0	3894	0.0	0.0
chr5	HMMR	163460423	163460738	0	316	0	3950	0	3634	0.0	0.0
chr5	WWC1	168408624	168408653	0	30	387	9685	387	9655	0.0	0.040082858622475404
chr5	RARS1	168492792	168492847	0	56	0	3434	0	3378	0.0	0.0
chr5	SLIT3-AS1	169018495	169018641	3273	147	46594	3135	43321	2988	22.26530612244898	14.498326639892905
chr5	SPDL1	169588491	169588575	0	85	8532	4769	8532	4684	0.0	1.821520068317677
chr5	LINC01366	170331484	170331577	0	94	0	2997	0	2903	0.0	0.0
chr5	LINC01366	170331555	170331577	0	23	0	2997	0	2974	0.0	0.0
chr5	LINC01366	170331559	170331577	0	19	0	2997	0	2978	0.0	0.0
chr5	LINC01366	170331484	170331554	0	71	0	2997	0	2926	0.0	0.0
chr5	LINC01366	170331484	170331558	0	75	0	2997	0	2922	0.0	0.0
chr5	LINC01366	170331555	170331558	0	4	0	2997	0	2993	0.0	0.0
chr5	NPM1	171391425	171391609	0	185	8229	6517	8229	6332	0.0	1.2995893872394189
chr5	NPM1	171392979	171392982	0	4	8229	6517	8229	6513	0.0	1.2634730538922156
chr5	RPL26L1	172959469	172959514	0	46	0	1071	0	1025	0.0	0.0
chr5	AC016573.1	173444161	173444294	0	134	1696	1709	1696	1575	0.0	1.076825396825397
chr5	MSX2	174725039	174725067	0	29	255	2226	255	2197	0.0	0.11606736458807465
chr5	SFXN1	175478640	175478667	0	28	102	7421	102	7393	0.0	0.013796834843771135
chr5	CPLX2	175871706	175872199	0	494	40972	7033	40972	6539	0.0	6.265789876127848
chr5	CPLX2	175878281	175878571	714	291	40972	7033	40258	6742	2.4536082474226806	5.971225155740137
chr5	FAM153B	176061269	176061343	0	75	29499	5362	29499	5287	0.0	5.579534707773785
chr5	FAM153B	176087206	176087255	0	50	29499	5362	29499	5312	0.0	5.553275602409639
chr5	AC139491.5	176124106	176124120	0	15	0	4570	0	4555	0.0	0.0
chr5	EIF4E1B	176642166	176642177	253	12	5546	3096	5293	3084	21.083333333333332	1.7162775616083008
chr5	EIF4E1B	176631052	176631064	0	13	5546	3096	5546	3083	0.0	1.7988971780733052
chr5	TSPAN17	176656126	176656134	0	9	714	4684	714	4675	0.0	0.15272727272727274
chr5	TSPAN17	176656925	176656956	0	32	714	4684	714	4652	0.0	0.1534823731728289
chr5	TSPAN17	176647703	176647713	2	11	714	4684	712	4673	0.18181818181818182	0.1523646479777445
chr5	FGFR4	177087019	177087033	0	15	6637	4774	6637	4759	0.0	1.3946207186383694
chr5	FGFR4	177093178	177093331	0	154	6637	4774	6637	4620	0.0	1.4365800865800866
chr5	FGFR4	177093502	177093551	22	50	6637	4774	6615	4724	0.44	1.4002963590177815
chr5	FGFR4	177087019	177087077	0	59	6637	4774	6637	4715	0.0	1.4076352067868505
chr5	FGFR4	177087034	177087077	0	44	6637	4774	6637	4730	0.0	1.403171247357294
chr5	NSD1	177169429	177169644	0	216	527	15548	527	15332	0.0	0.03437255413514219
chr5	NSD1	177266658	177266671	0	14	527	15548	527	15534	0.0	0.03392558259302176
chr5	NSD1	177266658	177266729	0	72	527	15548	527	15476	0.0	0.03405272680279142
chr5	NSD1	177266672	177266729	0	58	527	15548	527	15490	0.0	0.034021949644932215
chr5	TMED9	177593711	177593775	0	65	161	3066	161	3001	0.0	0.05364878373875375
chr5	AC106795.1	177882753	177882873	0	121	1917	3867	1917	3746	0.0	0.51174586225307
chr5	FAM153CP	178006986	178007060	0	75	112828	18718	112828	18643	0.0	6.052030252641742
chr5	RMND5B	178138259	178138396	37	138	7907	6205	7870	6067	0.26811594202898553	1.2971814735454097
chr5	RMND5B	178131055	178131376	0	322	7907	6205	7907	5883	0.0	1.34404215536291
chr5	HNRNPAB	178209433	178209447	0	15	0	2125	0	2110	0.0	0.0
chr5	HNRNPAB	178209442	178209447	0	6	0	2125	0	2119	0.0	0.0
chr5	HNRNPAB	178209433	178209441	0	9	0	2125	0	2116	0.0	0.0
chr5	ZNF454	178941387	178941444	82	58	13973	2668	13891	2610	1.4137931034482758	5.322222222222222
chr5	ZNF879	179023905	179023917	0	13	56635	3802	56635	3789	0.0	14.947215624175245
chr5	CANX	179698604	179698825	687	222	329794	6294	329107	6072	3.0945945945945947	54.20075757575758
chr5	CANX	179699006	179699049	0	44	329794	6294	329794	6250	0.0	52.76704
chr5	CANX	179699050	179699102	19	53	329794	6294	329775	6241	0.3584905660377358	52.840089729210064
chr5	CANX	179699006	179699102	19	97	329794	6294	329775	6197	0.1958762886597938	53.21526545102469
chr5	CNOT6	180564579	180564593	0	15	0	6531	0	6516	0.0	0.0
chr5	LINC00847	180830830	180830867	0	38	510	5657	510	5619	0.0	0.09076348104644955
chr5	LINC00847	180831230	180831941	204	712	510	5657	306	4945	0.28651685393258425	0.06188068756319515
chr5	LINC00847	180831807	180831941	153	135	510	5657	357	5522	1.1333333333333333	0.0646504889532778
chr5	LINC00847	180835003	180835090	0	88	510	5657	510	5569	0.0	0.0915783803196265
chr5	BTNL8	180947626	180947755	0	130	3087	3933	3087	3803	0.0	0.811727583486721
chr5	TRIM7-AS1	181198272	181198276	0	5	0	1489	0	1484	0.0	0.0
chr5	TRIM52-AS1	181263767	181263789	0	23	0	1413	0	1390	0.0	0.0
chr5	AC138035.1	181316487	181316497	0	11	0	1813	0	1802	0.0	0.0
chr5	ZDHHC11B	751132	751139	32	8	9851	5638	9819	5630	4.0	1.74404973357016
chr5	ZDHHC11	843599	843606	40	8	56961	4756	56921	4748	5.0	11.988416175231677
chr5	BRD9	892086	892507	4971	422	714915	9010	709944	8588	11.77962085308057	82.66697717745691
chr5	BRD9	892086	892419	4125	334	714915	9010	710790	8676	12.350299401197605	81.92600276625173
chr5	BRD9	892420	892507	846	88	714915	9010	714069	8922	9.613636363636363	80.03463349024882
chr5	SLC12A7	1075890	1076136	942	247	428489	6029	427547	5782	3.8137651821862346	73.94448287789692
chr5	CTD-3080P12.3	1175960	1175969	0	10	0	1766	0	1756	0.0	0.0
chr5	LINC01511	1379561	1379663	0	103	3308	3376	3308	3273	0.0	1.0106935533150014
chr5	SDHAP3	1574171	1574180	49	10	46314	3085	46265	3075	4.9	15.045528455284552
chr5	AC026412.1	1632643	1632843	1020	201	88401	3371	87381	3170	5.074626865671642	27.564984227129337
chr5	MRPL36	1799791	1799808	0	18	207891	1378	207891	1360	0.0	152.86102941176472
chr5	MRPL36	1799770	1799790	0	21	207891	1378	207891	1357	0.0	153.19896831245393
chr5	MRPL36	1799770	1799808	0	39	207891	1378	207891	1339	0.0	155.2584017923824
chr5	IRX4	1886861	1887060	0	200	663	2906	663	2706	0.0	0.24501108647450112
chr5	CTD-2297D10.2	5139118	5139249	0	132	648	6700	648	6568	0.0	0.09866017052375152
chr5	LINC02123	7347875	7347971	0	97	0	1581	0	1484	0.0	0.0
chr5	LINC02112	9903524	9903636	0	113	0	2631	0	2518	0.0	0.0
chr5	LINC02112	9870099	9870105	0	7	0	2631	0	2624	0.0	0.0
chr5	ATPSCKMT	10236477	10236520	28	44	107541	3292	107513	3248	0.6363636363636364	33.10129310344828
chr5	ATPSCKMT	10239041	10239065	0	25	107541	3292	107541	3267	0.0	32.917355371900825
chr5	CTNND2	11588734	11588744	0	11	0	7298	0	7287	0.0	0.0
chr5	MYO10	16711120	16711158	903	39	441108	13792	440205	13753	23.153846153846153	32.00792554351778
chr5	CDH18	19877993	19878030	0	38	181	6506	181	6468	0.0	0.027983920841063697
chr5	LINC02146	20615518	20616281	0	764	0	2293	0	1529	0.0	0.0
chr5	LINC02146	20615518	20616121	0	604	0	2293	0	1689	0.0	0.0
chr5	LINC02146	20616122	20616281	0	160	0	2293	0	2133	0.0	0.0
chr5	LINC02064	29384296	29384318	0	23	0	4274	0	4251	0.0	0.0
chr5	GOLPH3	32173745	32173808	0	64	1643853	2746	1643853	2682	0.0	612.920581655481
chr5	AMACR	33993947	33994076	0	130	146800	2515	146800	2385	0.0	61.55136268343816
chr5	C1QTNF3	34042822	34043040	0	219	13557	4201	13557	3982	0.0	3.404570567553993
chr5	UGT3A1	35954818	35955643	0	826	0	8317	0	7491	0.0	0.0
chr5	UGT3A1	35990964	35991145	0	182	0	8317	0	8135	0.0	0.0
chr5	NADK2	36241962	36242094	164	133	373813	5032	373649	4899	1.2330827067669172	76.27046335986937
chr5	AC008957.1	36705679	36705719	0	41	0	3903	0	3862	0.0	0.0
chr5	NUP155	37370665	37370819	89	155	405068	9160	404979	9005	0.5741935483870968	44.972681843420325
chr5	GDNF	37834645	37834722	0	78	131158	4634	131158	4556	0.0	28.787971905179983
chr5	EGFLAM-AS2	38403234	38403397	0	164	0	1411	0	1247	0.0	0.0
chr5	FYB1	39125971	39125996	0	26	4695	7176	4695	7150	0.0	0.6566433566433566
chr5	DAB2	39392203	39392363	654	161	367498	7579	366844	7418	4.062111801242236	49.45322189269345
chr5	OXCT1	41794421	41794539	0	119	647163	4120	647163	4001	0.0	161.75031242189453
chr5	AC008875.3	42990838	42991151	22150	314	103340	2687	81190	2373	70.54140127388536	34.21407501053519
chr5	PAIP1	43529785	43529795	0	11	289038	3400	289038	3389	0.0	85.2871053408085
chr5	PAIP1	43556581	43556817	5005	237	289038	3400	284033	3163	21.11814345991561	89.79860891558647
chr5	AC025180.1	52978251	52978266	114	16	969	2429	855	2413	7.125	0.3543307086614173
chr5	MOCS2	53109250	53109710	0	461	459	5555	459	5094	0.0	0.09010600706713781
chr5	AC034238.1	55023137	55023296	204	160	408	4159	204	3999	1.275	0.05101275318829707
chr5	CDC20B	55119800	55119811	0	12	51	4537	51	4525	0.0	0.011270718232044199
chr5	MCIDAS	55227018	55227204	0	187	74	1961	74	1774	0.0	0.04171364148816235
chr5	MCIDAS	55222946	55222949	4	4	74	1961	70	1957	1.0	0.03576903423607562
chr5	CCNO	55232766	55233141	43380	376	132921	1740	89541	1364	115.37234042553192	65.64589442815249
chr5	SLC38A9	55633694	55633752	0	59	833	8550	833	8491	0.0	0.09810387469084914
chr5	SLC38A9	55711351	55711450	0	100	833	8550	833	8450	0.0	0.09857988165680473
chr5	IL6ST	55948101	55948896	0	796	0	10136	0	9340	0.0	0.0
chr5	LINC01948	56481527	56481551	0	25	11171	4731	11171	4706	0.0	2.3737781555461113
chr5	MIER3	56952093	56952109	0	17	0	5712	0	5695	0.0	0.0
chr5	LINC02101	58122074	58122317	0	244	0	2551	0	2307	0.0	0.0
chr5	ELOVL7	60771902	60771947	0	46	4034	4475	4034	4429	0.0	0.9108150824113795
chr5	ERCC8	60903566	60903646	0	81	102	13538	102	13457	0.0	0.0075796982982834216
chr5	DIMT1	62398428	62398509	0	82	102	6179	102	6097	0.0	0.016729539117598818
chr5	ADAMTS6	65262803	65262815	0	13	52350	8581	52350	8568	0.0	6.109943977591036
chr5	CENPK	65561462	65561495	0	34	847	3192	847	3158	0.0	0.2682077264091197
chr5	TRIM23	65611602	65611755	0	154	102	3039	102	2885	0.0	0.03535528596187175
chr5	TRIM23	65591842	65591870	0	29	102	3039	102	3010	0.0	0.03388704318936877
chr5	CCDC125	69332648	69332763	1275	116	32914	7594	31639	7478	10.991379310344827	4.230944102701257
chr5	TAF9	69369164	69369226	1945	63	102134	2120	100189	2057	30.873015873015873	48.70636849781235
chr5	TAF9	69368824	69369226	4061	403	102134	2120	98073	1717	10.076923076923077	57.118811881188115
chr5	TAF9	69368824	69369163	2116	340	102134	2120	100018	1780	6.223529411764706	56.18988764044944
chr5	GTF2H2	71067493	71067653	0	161	0	5742	0	5581	0.0	0.0
chr5	GTF2H2	71067295	71067492	0	198	0	5742	0	5544	0.0	0.0
chr5	MRPS27	72320148	72320179	0	32	4552	5031	4552	4999	0.0	0.9105821164232847
chr5	MRPS27	72320148	72320232	0	85	4552	5031	4552	4946	0.0	0.9203396684189243
chr5	MRPS27	72320180	72320232	0	53	4552	5031	4552	4978	0.0	0.9144234632382483
chr5	AC063979.1	72770627	72770708	0	82	0	1828	0	1746	0.0	0.0
chr5	ENC1	74637493	74637563	0	71	59492	8243	59492	8172	0.0	7.279980420949584
chr5	FAM169A	74866750	74866818	0	69	0	6891	0	6822	0.0	0.0
chr5	ANKRD31	75236365	75236581	0	217	233	6335	233	6118	0.0	0.038084341288002616
chr5	CERT1	75385901	75385946	0	46	5	10692	5	10646	0.0	0.00046965996618448245
chr5	CERT1	75511111	75511427	0	317	5	10692	5	10375	0.0	0.00048192771084337347
chr5	CERT1	75381071	75381143	0	73	5	10692	5	10619	0.0	0.00047085412939071476
chr5	CERT1	75425291	75425359	0	69	5	10692	5	10623	0.0	0.0004706768332862656
chr5	CERT1	75425269	75425359	0	91	5	10692	5	10601	0.0	0.00047165361758324685
chr5	CERT1	75425269	75425290	0	22	5	10692	5	10670	0.0	0.00046860356138706655
chr5	POC5	75712375	75712378	0	4	0	3430	0	3426	0.0	0.0
chr5	F2RL2	76623166	76623295	0	130	306	3410	306	3280	0.0	0.09329268292682927
chr5	WDR41	77432892	77433083	0	192	19647	5048	19647	4856	0.0	4.045922570016474
chr5	WDR41	77489456	77489549	0	94	19647	5048	19647	4954	0.0	3.9658861526039564
chr5	WDR41	77459049	77459060	0	12	19647	5048	19647	5036	0.0	3.9013105639396346
chr5	WDR41	77492158	77492168	0	11	19647	5048	19647	5037	0.0	3.900536033353186
chr5	AP3B1	78294439	78294450	0	12	9270	5482	9270	5470	0.0	1.6946983546617915
chr5	AC008771.1	80487772	80487776	0	5	357	8624	357	8619	0.0	0.04142011834319527
chr5	CCNH	87412434	87412676	0	243	0	4875	0	4632	0.0	0.0
chr5	TMEM161B	88268720	88268786	0	67	11631	9091	11631	9024	0.0	1.2888962765957446
chr5	TMEM161B	88205800	88205812	0	13	11631	9091	11631	9078	0.0	1.2812293456708526
chr5	TMEM161B	88197668	88198974	918	1307	11631	9091	10713	7784	0.7023718439173681	1.376284686536485
chr5	TMEM161B	88205753	88205812	0	60	11631	9091	11631	9031	0.0	1.2878972428302513
chr5	TMEM161B	88205753	88205799	0	47	11631	9091	11631	9044	0.0	1.286045997346307
chr5	LINC00461	88672762	88672963	0	202	0	11943	0	11741	0.0	0.0
chr5	MEF2C	88751856	88751864	0	9	0	5849	0	5840	0.0	0.0
chr5	MEF2C	88882954	88883047	0	94	0	5849	0	5755	0.0	0.0
chr5	MEF2C	88877937	88877940	0	4	0	5849	0	5845	0.0	0.0
chr5	CETN3	90405684	90405687	0	4	50	3096	50	3092	0.0	0.016170763260025874
chr5	CETN3	90399357	90399470	0	114	50	3096	50	2982	0.0	0.01676727028839705
chr5	LUCAT1	91314079	91314163	0	85	0	15454	0	15369	0.0	0.0
chr5	LUCAT1	91313961	91314078	0	118	0	15454	0	15336	0.0	0.0
chr5	LUCAT1	91313961	91314163	0	203	0	15454	0	15251	0.0	0.0
chr5	LUCAT1	91311645	91312293	0	649	0	15454	0	14805	0.0	0.0
chr5	NR2F1-AS1	93581141	93581179	0	39	6927	22614	6927	22575	0.0	0.30684385382059803
chr5	NR2F1-AS1	93580466	93581179	0	714	6927	22614	6927	21900	0.0	0.3163013698630137
chr5	NR2F1-AS1	93580466	93581140	0	675	6927	22614	6927	21939	0.0	0.31573909476275125
chr5	NR2F1-AS1	93585328	93585382	0	55	6927	22614	6927	22559	0.0	0.307061483221774
chr5	NR2F1-AS1	93422250	93422253	0	4	6927	22614	6927	22610	0.0	0.3063688633348076
chr5	NR2F1-AS1	93422250	93422308	10	59	6927	22614	6917	22555	0.1694915254237288	0.3066725781423188
chr5	NR2F1-AS1	93422254	93422308	10	55	6927	22614	6917	22559	0.18181818181818182	0.306618201161399
chr5	NR2F1-AS1	93543616	93543687	0	72	6927	22614	6927	22542	0.0	0.30729305296779347
chr5	TTC37	95554880	95554934	0	55	29	10468	29	10413	0.0	0.0027849803130702007
chr5	SPATA9	95682793	95682817	0	25	0	2937	0	2912	0.0	0.0
chr5	RIOK2	97182800	97183124	0	325	0	4454	0	4129	0.0	0.0
chr5	LINC01846	98160946	98161146	0	201	0	1008	0	807	0.0	0.0
chr5	RGMB-AS1	98772621	98772965	0	345	0	963	0	618	0.0	0.0
chr5	SLCO6A1	102480176	102480343	0	168	564	2803	564	2635	0.0	0.2140417457305503
chr5	NUDT12	103560042	103560095	0	54	0	4307	0	4253	0.0	0.0
chr5	AC008505.1	103886340	103886373	0	34	0	4442	0	4408	0.0	0.0
chr5	AC099520.1	104773612	104773731	0	120	0	4954	0	4834	0.0	0.0
chr5	STARD4	111501001	111501084	25	84	705400	5691	705375	5607	0.2976190476190476	125.80256821829856
chr5	STARD4	111512384	111512389	0	6	705400	5691	705400	5685	0.0	124.08091468777485
chr5	NREP	111757319	111757376	0	58	51	9126	51	9068	0.0	0.0056241729157476845
chr5	NREP	111757319	111757327	0	9	51	9126	51	9117	0.0	0.005593945376768674
chr5	NREP	111757328	111757376	0	49	51	9126	51	9077	0.0	0.005618596452572436
chr5	NREP	111757931	111757943	0	13	51	9126	51	9113	0.0	0.0055964007461867665
chr5	TMED7	115625600	115625856	0	257	0	4059	0	3802	0.0	0.0
chr5	CDO1	115816227	115816582	0	356	1092	1902	1092	1546	0.0	0.7063389391979301
chr5	ATG12	115840817	115841388	0	572	2130	7572	2130	7000	0.0	0.30428571428571427
chr5	SEMA6A	116536297	116536381	0	85	24	10571	24	10486	0.0	0.0022887659736791914
chr5	AC010267.1	116825528	116825731	0	204	0	2512	0	2308	0.0	0.0
chr5	LINC02208	118521171	118522725	0	1555	5016	5937	5016	4382	0.0	1.1446827932450936
chr5	LOX	122076892	122077090	0	199	51	5516	51	5317	0.0	0.009591875117547489
chr5	LINC02201	122705007	122705424	0	418	13207	3758	13207	3340	0.0	3.954191616766467
chr5	CEP120	123388303	123388430	0	128	51	13045	51	12917	0.0	0.003948285205543083
chr5	CEP120	123422466	123422948	0	483	51	13045	51	12562	0.0	0.004059863079127528
chr5	CEP120	123403216	123403254	0	39	51	13045	51	13006	0.0	0.003921267107488851
chr5	LINC01170	124438388	124438393	0	6	0	3859	0	3853	0.0	0.0
chr5	ZNF608	124744083	124744411	0	329	0	6892	0	6563	0.0	0.0
chr5	AC011416.3	127229683	127229713	0	31	0	1800	0	1769	0.0	0.0
chr5	AC011416.3	127228850	127228859	0	10	0	1800	0	1790	0.0	0.0
chr5	AC011416.4	127290577	127290612	0	36	465	7226	465	7190	0.0	0.06467315716272601
chr5	LINC01184	128082734	128082968	0	235	204	12548	204	12313	0.0	0.01656785511248274
chr5	LINC01184	128062369	128062372	0	4	204	12548	204	12544	0.0	0.016262755102040817
chr5	HINT1	131165059	131165093	0	35	49	6082	49	6047	0.0	0.008103191665288573
chr5	HINT1	131162028	131162062	0	35	49	6082	49	6047	0.0	0.008103191665288573
chr5	RAPGEF6	131479512	131479611	0	100	2972	11266	2972	11166	0.0	0.2661651441877127
chr5	ACSL6	131994030	131994134	0	105	77879	15803	77879	15698	0.0	4.961077844311378
chr5	ACSL6	132011769	132011819	0	51	77879	15803	77879	15752	0.0	4.944070594210259
chr5	P4HA2	132226696	132227084	766	389	39997	9992	39231	9603	1.9691516709511567	4.085285848172446
chr5	P4HA2	132226696	132226930	51	235	39997	9992	39946	9757	0.2170212765957447	4.094086297017526
chr5	P4HA2	132227538	132227788	1647	251	39997	9992	38350	9741	6.561752988047809	3.9369674571399242
chr5	P4HA2	132226931	132227084	715	154	39997	9992	39282	9838	4.642857142857143	3.992884732669242
chr5	IRF1	132490001	132490048	0	48	102	5641	102	5593	0.0	0.0182370820668693
chr5	SEPTIN8	132777675	132777756	0	82	0	4865	0	4783	0.0	0.0
chr5	C5ORF15	133968445	133968524	22932	80	96813	2305	73881	2225	286.65	33.20494382022472
chr5	SKP1	134176685	134176853	520	169	90152	12086	89632	11917	3.076923076923077	7.521356045984728
chr5	SAR1B	134613009	134613074	0	66	204	10558	204	10492	0.0	0.019443385436523065
chr5	SAR1B	134613009	134613012	0	4	204	10558	204	10554	0.0	0.019329164297896533
chr5	SAR1B	134613013	134613074	0	62	204	10558	204	10496	0.0	0.019435975609756097
chr5	PITX1	135034501	135034567	0	67	0	3380	0	3313	0.0	0.0
chr5	PITX1	135034501	135034685	0	185	0	3380	0	3195	0.0	0.0
chr5	C5ORF66-AS1	135039595	135039599	0	5	0	840	0	835	0.0	0.0
chr5	MACROH2A1	135399748	135399784	308	37	1635588	10783	1635280	10746	8.324324324324325	152.17569328122093
chr5	MACROH2A1	135399748	135399803	308	56	1635588	10783	1635280	10727	5.5	152.445231658432
chr5	MACROH2A1	135350822	135350825	0	4	1635588	10783	1635588	10779	0.0	151.7383801836905
chr5	MACROH2A1	135399785	135399803	0	19	1635588	10783	1635588	10764	0.0	151.94983277591973
chr5	TRPC7	136274656	136274671	0	16	19	3780	19	3764	0.0	0.005047821466524973
chr5	BRD8	138177565	138177569	0	5	130379	6939	130379	6934	0.0	18.802855494663973
chr5	BRD8	138171344	138171359	320	16	130379	6939	130059	6923	20.0	18.78650873898599
chr5	CDC25C	138289479	138289499	0	21	808	3355	808	3334	0.0	0.24235152969406118
chr5	ETF1	138542633	138542831	46	199	4735	4549	4689	4350	0.23115577889447236	1.0779310344827586
chr5	ETF1	138542633	138542703	46	71	4735	4549	4689	4478	0.647887323943662	1.047119249665029
chr5	ETF1	138542704	138542831	0	128	4735	4549	4735	4421	0.0	1.0710246550554172
chr5	HSPA9	138573762	138573775	0	14	629	5786	629	5772	0.0	0.10897435897435898
chr5	HSPA9	138574770	138574992	0	223	629	5786	629	5563	0.0	0.11306848822577746
chr5	SIL1	139293273	139293421	0	149	3050	3852	3050	3703	0.0	0.8236564947339995
chr5	SLC23A1	139380552	139380563	0	12	298	3085	298	3073	0.0	0.09697364139277578
chr5	DNAJC18	139443680	139443683	0	4	72	2652	72	2648	0.0	0.027190332326283987
chr5	STING1	139482549	139482608	800	60	4462	4684	3662	4624	13.333333333333334	0.791955017301038
chr5	PSD2-AS1	139746193	139746199	0	7	0	1258	0	1251	0.0	0.0
chr5	PSD2-AS1	139745906	139746192	0	287	0	1258	0	971	0.0	0.0
chr5	PSD2-AS1	139745906	139746199	0	294	0	1258	0	964	0.0	0.0
chr5	MALINC1	140107098	140107407	0	310	34339	7192	34339	6882	0.0	4.989683231618716
chr5	APBB3	140564196	140564654	51	459	1560	3183	1509	2724	0.1111111111111111	0.5539647577092511
chr5	AC116353.6	140591063	140591072	0	10	5802	2107	5802	2097	0.0	2.7668097281831185
chr5	CD14	140633530	140633550	0	21	0	1651	0	1630	0.0	0.0
chr5	HARS1	140679001	140679060	0	60	3264	12088	3264	12028	0.0	0.27136681077485864
chr5	HARS1	140691214	140691300	0	87	3264	12088	3264	12001	0.0	0.27197733522206485
chr5	HARS1	140674669	140674677	0	9	3264	12088	3264	12079	0.0	0.27022104478847586
chr5	AC244517.11	141241407	141241451	0	45	0	1533	0	1488	0.0	0.0
chr5	DIAPH1	141524618	141524674	0	57	262484	7015	262484	6958	0.0	37.72405863753952
chr5	ARAP3	141671264	141671323	0	60	5221	6227	5221	6167	0.0	0.8466028863304687
chr5	AC005753.3	141825037	141825090	0	54	0	2037	0	1983	0.0	0.0
chr5	PCDH1	141868501	141868567	0	67	4131	5934	4131	5867	0.0	0.7041077211522072
chr5	GNPDA1	142011848	142011910	0	63	102	3613	102	3550	0.0	0.02873239436619718
chr5	GNPDA1	142012914	142012993	0	80	102	3613	102	3533	0.0	0.02887064817435607
chr5	GNPDA1	142012668	142012993	0	326	102	3613	102	3287	0.0	0.031031335564344387
chr5	SPRY4	142319732	142319742	0	11	255	6560	255	6549	0.0	0.03893724232707284
chr5	FGF1	142685498	142685512	0	15	4504	4780	4504	4765	0.0	0.9452256033578175
chr5	FGF1	142697621	142697911	0	291	4504	4780	4504	4489	0.0	1.003341501447984
chr5	ARHGAP26-AS1	142860001	142860011	0	11	0	996	0	985	0.0	0.0
chr5	NR3C1	143313998	143314000	0	3	102	9176	102	9173	0.0	0.011119590101384498
chr5	YIPF5	144170283	144170533	0	251	0	3704	0	3453	0.0	0.0
chr5	LARS1	146144623	146144661	0	39	0	16674	0	16635	0.0	0.0
chr5	LARS1	146149621	146149656	0	36	0	16674	0	16638	0.0	0.0
chr5	LARS1	146182487	146182560	0	74	0	16674	0	16600	0.0	0.0
chr5	LARS1	146182487	146182620	0	134	0	16674	0	16540	0.0	0.0
chr5	LARS1	146142855	146142870	0	16	0	16674	0	16658	0.0	0.0
chr5	LARS1	146149551	146149620	0	70	0	16674	0	16604	0.0	0.0
chr5	LARS1	146149551	146149656	0	106	0	16674	0	16568	0.0	0.0
chr5	LARS1	146182561	146182620	0	60	0	16674	0	16614	0.0	0.0
chr5	PPP2R2B	146878590	146878699	0	110	60	13227	60	13117	0.0	0.004574216665396051
chr5	PPP2R2B	147081256	147081320	0	65	60	13227	60	13162	0.0	0.00455857772375019
chr5	AC011346.1	148290251	148290919	0	669	5439	13969	5439	13300	0.0	0.4089473684210526
chr5	SH3TC2	149041415	149041472	0	58	4883	12652	4883	12594	0.0	0.3877243131649992
chr5	CSNK1A1	149505446	149505481	0	36	1936	8524	1936	8488	0.0	0.22808671065032987
chr5	TIGD6	149999927	150000472	0	546	102	3973	102	3427	0.0	0.029763641669098336
chr5	CSF1R	150061490	150061594	0	105	117437	5174	117437	5069	0.0	23.16768593410929
chr5	PDGFRB	150134715	150134748	176	34	8543	6271	8367	6237	5.176470588235294	1.3415103415103415
chr5	CAMK2A	150222959	150222987	0	29	108	6094	108	6065	0.0	0.017807089859851608
chr5	ARSI	150339199	150339276	0	78	0	3224	0	3146	0.0	0.0
chr5	RPS14	150449485	150449490	42	6	73367	2968	73325	2962	7.0	24.75523295070898
chr5	DCTN4	150758115	150758304	0	190	357	6234	357	6044	0.0	0.059066843150231634
chr5	CCDC69	151185421	151185445	3225	25	678938	4952	675713	4927	129.0	137.14491577024558
chr5	FAM114A2	154038292	154038855	0	564	867	6540	867	5976	0.0	0.14508032128514056
chr5	FAM114A2	154038292	154038386	0	95	867	6540	867	6445	0.0	0.13452288595810705
chr5	FAM114A2	154038292	154038825	0	534	867	6540	867	6006	0.0	0.14435564435564435
chr5	FAM114A2	154038292	154038834	0	543	867	6540	867	5997	0.0	0.14457228614307155
chr5	FAM114A2	154038826	154038855	0	30	867	6540	867	6510	0.0	0.13317972350230414
chr5	FAM114A2	154038826	154038834	0	9	867	6540	867	6531	0.0	0.13275149288011023
chr5	FAM114A2	154038835	154038855	0	21	867	6540	867	6519	0.0	0.1329958582604694
chr5	FAM114A2	154038387	154038855	0	469	867	6540	867	6071	0.0	0.14281008071157963
chr5	FAM114A2	154038387	154038825	0	439	867	6540	867	6101	0.0	0.14210785117193903
chr5	FAM114A2	154038387	154038834	0	448	867	6540	867	6092	0.0	0.1423177938279711
chr5	SAP30L-AS1	154445595	154445736	0	142	1785	9072	1785	8930	0.0	0.19988801791713326
chr5	FAXDC2	154823307	154823385	0	79	18	6073	18	5994	0.0	0.003003003003003003
chr5	FNDC9	157345380	157345539	0	160	0	2245	0	2085	0.0	0.0
chr5	ADAM19	157513423	157513432	0	10	75	7729	75	7719	0.0	0.00971628449280995
chr5	CLINT1	157858952	157859038	0	87	2703	6158	2703	6071	0.0	0.4452314281008071
chr5	CLINT1	157858929	157858951	0	23	2703	6158	2703	6135	0.0	0.44058679706601467
chr5	CLINT1	157858929	157859038	0	110	2703	6158	2703	6048	0.0	0.4469246031746032
chr5	EBF1	158823175	158823198	0	24	110148	6353	110148	6329	0.0	17.403697266550797
chr5	RNF145	159168872	159168990	0	119	38	4087	38	3968	0.0	0.009576612903225807
chr5	RNF145	159207884	159207886	0	3	38	4087	38	4084	0.0	0.00930460333006856
chr5	CCNJL	160254128	160255547	51	1420	204	9249	153	7829	0.03591549295774648	0.019542725763188145
chr5	SLU7	160418595	160419021	0	427	0	4786	0	4359	0.0	0.0
chr5	ATP10B	160785558	160785734	0	177	0	9107	0	8930	0.0	0.0
chr5	GABRB2	161547888	161548057	0	170	0	17158	0	16988	0.0	0.0
chr5	AC113414.1	162558852	162558935	0	84	51	8813	51	8729	0.0	0.005842593653339443
chr5	LINC01938	165241358	165241627	0	270	0	3198	0	2928	0.0	0.0
chr5	LINC01938	165241505	165241627	0	123	0	3198	0	3075	0.0	0.0
chr5	SLIT3	168685686	168685715	0	30	0	14307	0	14277	0.0	0.0
chr5	INSYN2B	169980276	169980294	0	19	0	5700	0	5681	0.0	0.0
chr5	AC139493.2	176182619	176182683	0	65	71	3034	71	2969	0.0	0.023913775682047826
chr5	KIAA1191	176359461	176359479	0	19	2475	3822	2475	3803	0.0	0.6508019984222981
chr5	SNCB	176629808	176629887	0	80	102	1869	102	1789	0.0	0.05701509223029626
chr5	UIMC1	176968554	176969051	3672	498	212848	3988	209176	3490	7.373493975903615	59.935816618911176
chr5	UIMC1	176969596	176969599	20	4	212848	3988	212828	3984	5.0	53.420682730923694
chr5	RAB24	177303406	177303409	0	4	74260	1931	74260	1927	0.0	38.53658536585366
chr5	DOK3	177509757	177509800	0	44	102	4236	102	4192	0.0	0.02433206106870229
chr5	DOK3	177510149	177510258	0	110	102	4236	102	4126	0.0	0.024721279689772176
chr5	DDX41	177514553	177514699	51	147	80	3376	29	3229	0.3469387755102041	0.00898110870238464
chr5	DDX41	177514553	177514592	0	40	80	3376	80	3336	0.0	0.023980815347721823
chr5	FAM193B	177531952	177532154	0	203	11948	5341	11948	5138	0.0	2.32541845075905
chr5	FAM193B	177523158	177523161	0	4	11948	5341	11948	5337	0.0	2.238710886265692
chr5	FAM153A	177750908	177750957	0	50	16362	8568	16362	8518	0.0	1.920873444470533
chr5	FAM153A	177782742	177782816	0	75	16362	8568	16362	8493	0.0	1.9265277287177676
chr5	PHYKPL	178211760	178211888	0	129	23	7715	23	7586	0.0	0.003031900870023728
chr5	HNRNPH1	179616868	179616897	0	30	255	5593	255	5563	0.0	0.04583857630774762
chr5	HNRNPH1	179617050	179617058	0	9	255	5593	255	5584	0.0	0.04566618911174785
chr5	HNRNPH1	179621241	179621369	0	129	255	5593	255	5464	0.0	0.04666910688140556
chr5	HNRNPH1	179623594	179623634	0	41	255	5593	255	5552	0.0	0.045929394812680116
chr5	HNRNPH1	179616859	179616867	0	9	255	5593	255	5584	0.0	0.04566618911174785
chr5	HNRNPH1	179616859	179616897	0	39	255	5593	255	5554	0.0	0.04591285559956788
chr5	HNRNPH1	179623635	179624095	0	461	255	5593	255	5132	0.0	0.04968823070927514
chr5	HNRNPH1	179623635	179624315	0	681	255	5593	255	4912	0.0	0.05191368078175896
chr5	HNRNPH1	179623635	179623976	0	342	255	5593	255	5251	0.0	0.0485621786326414
chr5	HNRNPH1	179624096	179624315	0	220	255	5593	255	5373	0.0	0.047459519821328865
chr5	HNRNPH1	179623280	179623593	0	314	255	5593	255	5279	0.0	0.04830460314453495
chr5	HNRNPH1	179623280	179623634	0	355	255	5593	255	5238	0.0	0.04868270332187858
chr5	HNRNPH1	179623977	179624095	0	119	255	5593	255	5474	0.0	0.046583850931677016
chr5	C5ORF60	179644798	179644943	0	146	0	2531	0	2385	0.0	0.0
chr5	MGAT4B	179798927	179799063	0	137	77	5408	77	5271	0.0	0.014608233731739707
chr5	MRNIP	179853196	179853376	0	181	1734	7454	1734	7273	0.0	0.23841605939777258
chr5	MGAT1	180803601	180803811	0	211	612	11216	612	11005	0.0	0.055611085870059064
chr5	MGAT1	180815413	180815423	0	11	612	11216	612	11205	0.0	0.05461847389558233
chr5	MGAT1	180808501	180808646	0	146	612	11216	612	11070	0.0	0.055284552845528454
chr5	MGAT1	180795655	180795836	0	182	612	11216	612	11034	0.0	0.05546492659053834
chr5	ZFP62	180861214	180861217	0	4	51	3131	51	3127	0.0	0.016309561880396548
chr5	TRIM7	181203744	181204020	0	277	0	7345	0	7068	0.0	0.0
chr5	TRIM7	181203476	181203543	0	68	0	7345	0	7277	0.0	0.0
chr5	RACK1	181242173	181242284	0	112	0	5102	0	4990	0.0	0.0
chr5	RACK1	181243679	181243690	0	12	0	5102	0	5090	0.0	0.0
chr5	RACK1	181242169	181242172	0	4	0	5102	0	5098	0.0	0.0
chr5	RACK1	181242169	181242284	0	116	0	5102	0	4986	0.0	0.0
chr5	RACK1	181242553	181243284	0	732	0	5102	0	4370	0.0	0.0
chr5	RACK1	181242553	181243252	0	700	0	5102	0	4402	0.0	0.0
chr5	RACK1	181243253	181243284	0	32	0	5102	0	5070	0.0	0.0
chr6	DUSP22	311915	311962	2536	48	241469	4077	238933	4029	52.833333333333336	59.303301067262346
chr6	BPHL	3118563	3118847	0	285	456303	5789	456303	5504	0.0	82.90388808139535
chr6	BPHL	3137423	3137493	0	71	456303	5789	456303	5718	0.0	79.80115424973766
chr6	PRPF4B	4060645	4060686	227	42	332939	7279	332712	7237	5.404761904761905	45.973746027359404
chr6	PRPF4B	4062634	4062760	5052	127	332939	7279	327887	7152	39.77952755905512	45.84549776286354
chr6	RREB1	7181159	7181246	0	88	335847	16690	335847	16602	0.0	20.229309721720274
chr6	RREB1	7181247	7181289	0	43	335847	16690	335847	16647	0.0	20.174626058749325
chr6	RREB1	7181159	7181289	0	131	335847	16690	335847	16559	0.0	20.281840690862975
chr6	RREB1	7108061	7108064	0	4	335847	16690	335847	16686	0.0	20.127472132326503
chr6	DSP	7579773	7581569	9517	1797	119478	10072	109961	8275	5.2960489705063996	13.28833836858006
chr6	HULC	8788947	8788964	0	18	31525	47611	31525	47593	0.0	0.6623873258672494
chr6	HULC	8785218	8785271	0	54	31525	47611	31525	47557	0.0	0.6628887440334756
chr6	HULC	8652391	8653136	181	746	31525	47611	31344	46865	0.24262734584450402	0.6688146804651659
chr6	HULC	9091072	9091080	0	9	31525	47611	31525	47602	0.0	0.6622620898281585
chr6	HULC	9041661	9042162	0	502	31525	47611	31525	47109	0.0	0.6691927232588253
chr6	HULC	9041696	9042162	0	467	31525	47611	31525	47144	0.0	0.668695910402172
chr6	HULC	9041661	9041695	0	35	31525	47611	31525	47576	0.0	0.6626240121069447
chr6	GCNT2	10528842	10529836	23118	995	115853	8968	92735	7973	23.23417085427136	11.631130063965886
chr6	ELOVL2-AS1	11043761	11043825	0	65	5592	2521	5592	2456	0.0	2.2768729641693812
chr6	ELOVL2-AS1	11044769	11044814	0	46	5592	2521	5592	2475	0.0	2.2593939393939393
chr6	ELOVL2-AS1	11044769	11044966	51	198	5592	2521	5541	2323	0.25757575757575757	2.385277658200603
chr6	ELOVL2-AS1	11044815	11044966	51	152	5592	2521	5541	2369	0.3355263157894737	2.338961587167581
chr6	AL445430.1	11417553	11417579	0	27	0	1436	0	1409	0.0	0.0
chr6	AL445430.1	11417580	11417590	0	11	0	1436	0	1425	0.0	0.0
chr6	AL445430.1	11417553	11417590	0	38	0	1436	0	1398	0.0	0.0
chr6	PHACTR1	12717554	12717743	0	190	1122	11593	1122	11403	0.0	0.09839515916863983
chr6	PHACTR1	12957752	12958037	0	286	1122	11593	1122	11307	0.0	0.09923056513664102
chr6	SIRT5	13574625	13574744	0	120	226203	6538	226203	6418	0.0	35.245091928949826
chr6	KDM1B	18217881	18217885	0	5	321267	5642	321267	5637	0.0	56.99254922831293
chr6	E2F3	20402381	20402625	1237	245	786246	5150	785009	4905	5.048979591836734	160.04260958205913
chr6	CASC15	22110819	22110920	0	102	2767	32553	2767	32451	0.0	0.08526701796554806
chr6	CASC15	21665014	21665138	0	125	2767	32553	2767	32428	0.0	0.08532749475761688
chr6	CASC15	21977928	21977953	0	26	2767	32553	2767	32527	0.0	0.08506778983613614
chr6	CASC15	22147071	22147156	0	86	2767	32553	2767	32467	0.0	0.08522499768996211
chr6	CASC15	22147157	22147292	0	136	2767	32553	2767	32417	0.0	0.08535644877687633
chr6	CASC15	22147071	22147292	0	222	2767	32553	2767	32331	0.0	0.0855834957161857
chr6	CASC15	22147157	22147379	0	223	2767	32553	2767	32330	0.0	0.08558614290133003
chr6	CASC15	22147293	22147379	0	87	2767	32553	2767	32466	0.0	0.0852276227437935
chr6	CASC15	22147071	22147379	0	309	2767	32553	2767	32244	0.0	0.08581441508497704
chr6	CASC15	22214409	22215702	306	1294	2767	32553	2461	31259	0.23647604327666152	0.07872932595412521
chr6	ALDH5A1	24502607	24502763	94	157	120531	7575	120437	7418	0.5987261146496815	16.2357778376921
chr6	GMNN	24775113	24775244	4420	132	200199	2484	195779	2352	33.484848484848484	83.23937074829932
chr6	GMNN	24775503	24775824	1466	322	200199	2484	198733	2162	4.552795031055901	91.9209065679926
chr6	SLC17A4	25776960	25777788	0	829	0	4570	0	3741	0.0	0.0
chr6	U91328.1	25998012	25998285	5834	274	73081	3639	67247	3365	21.291970802919707	19.984249628528975
chr6	U91328.1	25998286	25998290	190	5	73081	3639	72891	3634	38.0	20.05806274078151
chr6	U91328.1	25998012	25998290	6024	279	73081	3639	67057	3360	21.591397849462364	19.957440476190477
chr6	H2AC6	26124634	26124749	14113	116	161985	1612	147872	1496	121.66379310344827	98.84491978609626
chr6	BTN3A2	26365218	26365352	0	135	133873	5358	133873	5223	0.0	25.63143787095539
chr6	BTN2A2	26383182	26383299	0	118	206870	4365	206870	4247	0.0	48.70967741935484
chr6	BTN2A2	26383245	26383299	0	55	206870	4365	206870	4310	0.0	47.99767981438515
chr6	BTN2A2	26383182	26383244	0	63	206870	4365	206870	4302	0.0	48.08693630869363
chr6	BTN2A2	26383300	26383313	0	14	206870	4365	206870	4351	0.0	47.54539186393932
chr6	BTN2A2	26383245	26383313	0	69	206870	4365	206870	4296	0.0	48.15409683426443
chr6	BTN2A3P	26423278	26423759	23619	482	113609	4185	89990	3703	49.00207468879668	24.301917364299218
chr6	BTN3A3	26440649	26440719	0	71	36900	3974	36900	3903	0.0	9.454265949269793
chr6	LINC01012	27694227	27694506	0	280	0	3778	0	3498	0.0	0.0
chr6	H2BC15	27839039	27839065	0	27	1508	4640	1508	4613	0.0	0.32690223282029046
chr6	ZKSCAN8	28148825	28148838	0	14	40	7588	40	7574	0.0	0.0052812252442566675
chr6	ZSCAN9	28225269	28225330	0	62	1785	3599	1785	3537	0.0	0.5046649703138253
chr6	ZSCAN9	28225331	28225366	0	36	1785	3599	1785	3563	0.0	0.5009823182711198
chr6	ZSCAN9	28227838	28228365	1785	528	1785	3599	0	3071	3.3806818181818183	0.0
chr6	ZSCAN26	28271935	28272339	0	405	5382	2938	5382	2533	0.0	2.124753257007501
chr6	ZSCAN26	28272337	28272339	0	3	5382	2938	5382	2935	0.0	1.8337308347529813
chr6	ZSCAN26	28271935	28272336	0	402	5382	2938	5382	2536	0.0	2.1222397476340693
chr6	OR2I1P	29550601	29550857	0	257	0	5367	0	5110	0.0	0.0
chr6	HLA-A	29944617	29944634	18	18	459	2718	441	2700	1.0	0.16333333333333333
chr6	POLR1H	30061390	30061398	0	9	0	1070	0	1061	0.0	0.0
chr6	POLR1H	30061390	30061413	0	24	0	1070	0	1046	0.0	0.0
chr6	POLR1H	30061399	30061413	0	15	0	1070	0	1055	0.0	0.0
chr6	PPP1R11	30067626	30067664	55	39	510	2327	455	2288	1.4102564102564104	0.19886363636363635
chr6	TRIM39	30326888	30326995	0	108	0	4237	0	4129	0.0	0.0
chr6	RPP21	30345229	30345398	0	170	0	1107	0	937	0.0	0.0
chr6	RPP21	30346558	30346564	0	7	0	1107	0	1100	0.0	0.0
chr6	ATAT1	30626993	30627274	9742	282	1239687	3818	1229945	3536	34.54609929078014	347.8351244343891
chr6	C6ORF136	30647304	30647846	18921	543	474596	2035	455675	1492	34.84530386740332	305.41219839142093
chr6	C6ORF136	30651083	30651100	101	18	474596	2035	474495	2017	5.611111111111111	235.24789291026278
chr6	C6ORF136	30652718	30652728	13059	11	474596	2035	461537	2024	1187.1818181818182	228.03211462450594
chr6	TUBB	30721899	30722262	0	364	51	3213	51	2849	0.0	0.0179010179010179
chr6	TUBB	30722215	30722262	0	48	51	3213	51	3165	0.0	0.016113744075829384
chr6	TUBB	30721899	30722214	0	316	51	3213	51	2897	0.0	0.017604418363824648
chr6	DDR1	30888981	30889010	323	30	224154	8326	223831	8296	10.766666666666667	26.98059305689489
chr6	DDR1	30882984	30883165	7030	182	224154	8326	217124	8144	38.62637362637363	26.660609037328094
chr6	DDR1	30883242	30883323	0	82	224154	8326	224154	8244	0.0	27.189956331877728
chr6	DDR1	30883888	30883929	295	42	224154	8326	223859	8284	7.023809523809524	27.023056494447125
chr6	DDR1	30885232	30885354	62	123	224154	8326	224092	8203	0.5040650406504065	27.31829818359137
chr6	DDR1	30885355	30885388	0	34	224154	8326	224154	8292	0.0	27.03256150506512
chr6	DDR1	30885764	30885811	779	48	224154	8326	223375	8278	16.229166666666668	26.98417492147862
chr6	GTF2H4	30908379	30908403	0	25	0	2148	0	2123	0.0	0.0
chr6	VARS2	30914345	30915037	0	693	0	6416	0	5723	0.0	0.0
chr6	VARS2	30914345	30914469	0	125	0	6416	0	6291	0.0	0.0
chr6	MUC21	30984020	30984161	0	142	153	3796	153	3654	0.0	0.04187192118226601
chr6	HCG27	31197881	31197882	0	2	0	2520	0	2518	0.0	0.0
chr6	MICA	31400764	31400783	0	20	0	3859	0	3839	0.0	0.0
chr6	NFKBIL1	31557805	31557849	0	45	1224	1758	1224	1713	0.0	0.7145359019264448
chr6	LTA	31572303	31572446	0	144	51	1740	51	1596	0.0	0.03195488721804511
chr6	AIF1	31615294	31615354	0	61	307753	994	307753	933	0.0	329.8531618435155
chr6	CSNK2B	31668655	31668692	111	38	56959	2558	56848	2520	2.9210526315789473	22.55873015873016
chr6	CSNK2B	31666397	31666487	0	91	56959	2558	56959	2467	0.0	23.088366436967977
chr6	MSH5	31740063	31740220	0	158	246797	5859	246797	5701	0.0	43.29012453955446
chr6	MSH5	31761866	31761955	459	90	246797	5859	246338	5769	5.1	42.70029467845381
chr6	MSH5-SAPCD1	31762571	31763168	33066	598	199233	3610	166167	3012	55.2943143812709	55.168326693227094
chr6	SNHG32	31834769	31835200	0	432	0	1649	0	1217	0.0	0.0
chr6	SNHG32	31835058	31835200	0	143	0	1649	0	1506	0.0	0.0
chr6	SNHG32	31835452	31835455	0	4	0	1649	0	1645	0.0	0.0
chr6	C2	31928165	31928192	0	28	524436	5539	524436	5511	0.0	95.16167664670658
chr6	SKIV2L	31969317	31969420	735	104	15115	4787	14380	4683	7.0673076923076925	3.0706811872731157
chr6	STK19	31978999	31979010	0	12	6986	3774	6986	3762	0.0	1.85699096225412
chr6	STK19	31979009	31979010	0	2	6986	3774	6986	3772	0.0	1.852067868504772
chr6	STK19	31978999	31979008	0	10	6986	3774	6986	3764	0.0	1.8560042507970245
chr6	C4B	32032248	32032298	0	51	51	6663	51	6612	0.0	0.007713248638838476
chr6	PPT2	32154395	32154404	30	10	197343	2809	197313	2799	3.0	70.49410503751339
chr6	PPT2	32154247	32154404	6678	158	197343	2809	190665	2651	42.265822784810126	71.92191625801584
chr6	EGFL8	32167626	32167656	0	31	102	1546	102	1515	0.0	0.06732673267326733
chr6	PPT2	32154247	32154394	6648	148	197343	2809	190695	2661	44.91891891891892	71.66290868094701
chr6	PPT2-EGFL8	32164658	32164681	0	24	233123	5532	233123	5508	0.0	42.32443718228032
chr6	PPT2-EGFL8	32166233	32166266	0	34	233123	5532	233123	5498	0.0	42.40141869770826
chr6	AL662789.1	32718148	32718440	0	293	0	1019	0	726	0.0	0.0
chr6	PSMB8-AS1	32844275	32844870	0	596	0	1878	0	1282	0.0	0.0
chr6	BRD2	32970995	32971197	0	203	0	7303	0	7100	0.0	0.0
chr6	HLA-DPB1	33085890	33085906	0	17	51	5226	51	5209	0.0	0.009790746784411596
chr6	SLC39A7	33200939	33201656	51	718	102	2852	51	2134	0.07103064066852367	0.023898781630740395
chr6	PFDN6	33289621	33289628	1734	8	93724	2612	91990	2604	216.75	35.32642089093702
chr6	PHF1	33410888	33411215	56821	328	216149	3035	159328	2707	173.234756097561	58.85777613594385
chr6	SYNGAP1	33447933	33447933	0	1	39613	8100	39613	8099	0.0	4.891097666378565
chr6	ZBTB9	33454632	33454775	0	144	153	2863	153	2719	0.0	0.05627068775285031
chr6	GGNBP1	33584071	33584074	0	4	59	1748	59	1744	0.0	0.0338302752293578
chr6	GGNBP1	33585722	33585780	0	59	59	1748	59	1689	0.0	0.03493191237418591
chr6	AL138889.1	33896084	33896487	0	404	0	14456	0	14052	0.0	0.0
chr6	HMGA1	34236964	34237317	51	354	9948	2333	9897	1979	0.1440677966101695	5.001010611419909
chr6	HMGA1	34240883	34240915	0	33	9948	2333	9948	2300	0.0	4.3252173913043475
chr6	ARMC12	35737272	35737352	0	81	62	1424	62	1343	0.0	0.04616530156366344
chr6	BRPF3	36197498	36197620	3612	123	62744	6627	59132	6504	29.365853658536587	9.091635916359163
chr6	PNPLA1	36291553	36291555	0	3	0	3044	0	3041	0.0	0.0
chr6	CDKN1A	36678799	36678939	0	141	7	3000	7	2859	0.0	0.002448408534452606
chr6	PI16	36963034	36963612	765	579	7884	2259	7119	1680	1.3212435233160622	4.2375
chr6	FGD2	37009066	37009081	0	16	44300	9807	44300	9791	0.0	4.524563374527627
chr6	RNF8	37354119	37354275	3559	157	4296	6384	737	6227	22.668789808917197	0.1183555484181789
chr6	CMTR1	37475413	37475916	0	504	2645	4978	2645	4474	0.0	0.5911935628073313
chr6	AL353597.1	37549184	37549215	10	32	51	1152	41	1120	0.3125	0.03660714285714286
chr6	TDRG1	40378513	40378572	0	60	0	2534	0	2474	0.0	0.0
chr6	TDRG1	40378896	40378897	0	2	0	2534	0	2532	0.0	0.0
chr6	TSPO2	41042779	41042808	0	30	4508	1079	4508	1049	0.0	4.297426120114395
chr6	ADCY10P1	41111322	41111356	0	35	7723	5583	7723	5548	0.0	1.3920331651045421
chr6	ADCY10P1	41140070	41140205	0	136	7723	5583	7723	5447	0.0	1.4178446851477877
chr6	MDFI	41638486	41638652	0	167	3447	2542	3447	2375	0.0	1.4513684210526316
chr6	AL096814.2	42155486	42155593	0	108	64368	2281	64368	2173	0.0	29.621721122871605
chr6	AL096814.2	42163096	42163466	1167	371	64368	2281	63201	1910	3.1455525606469004	33.08952879581152
chr6	KLC4	43060187	43060238	0	52	20930	5760	20930	5708	0.0	3.666783461807989
chr6	KLC4	43060183	43060238	0	56	20930	5760	20930	5704	0.0	3.6693548387096775
chr6	KLC4	43060160	43060238	0	79	20930	5760	20930	5681	0.0	3.6842105263157894
chr6	KLC4	43060183	43060186	0	4	20930	5760	20930	5756	0.0	3.636205698401668
chr6	KLC4	43060160	43060186	0	27	20930	5760	20930	5733	0.0	3.6507936507936507
chr6	KLC4	43060160	43060182	0	23	20930	5760	20930	5737	0.0	3.648248213351926
chr6	KLC4	43060239	43060605	464	367	20930	5760	20466	5393	1.2643051771117166	3.7949193398850363
chr6	KLC4	43060187	43060605	464	419	20930	5760	20466	5341	1.107398568019093	3.831866691630781
chr6	KLC4	43060183	43060605	464	423	20930	5760	20466	5337	1.0969267139479906	3.8347386172006743
chr6	KLC4	43060160	43060605	464	446	20930	5760	20466	5314	1.0403587443946187	3.8513360933383516
chr6	PTK7	43132688	43132765	0	78	637106	8336	637106	8258	0.0	77.15015742310487
chr6	PTK7	43142499	43142502	44	4	637106	8336	637062	8332	11.0	76.45967354776764
chr6	CUL9	43216386	43216503	0	118	55009	10593	55009	10475	0.0	5.25145584725537
chr6	SLC22A7	43299782	43299790	90	9	110630	3540	110540	3531	10.0	31.305579156046445
chr6	SLC22A7	43299098	43299274	0	177	110630	3540	110630	3363	0.0	32.89622360987214
chr6	ABCC10	43427700	43427757	0	58	31483	7712	31483	7654	0.0	4.113274105043114
chr6	TJAP1	43477629	43477632	0	4	247335	6659	247335	6655	0.0	37.16528925619835
chr6	TJAP1	43503707	43504667	2172	961	247335	6659	245163	5698	2.260145681581686	43.026149526149524
chr6	POLR1C	43519839	43519905	320	67	73457	5100	73137	5033	4.776119402985074	14.531492151798131
chr6	VEGFA	43782053	43782087	0	35	0	7921	0	7886	0.0	0.0
chr6	VEGFA	43780786	43780854	0	69	0	7921	0	7852	0.0	0.0
chr6	VEGFA	43780804	43780854	0	51	0	7921	0	7870	0.0	0.0
chr6	VEGFA	43780786	43780803	0	18	0	7921	0	7903	0.0	0.0
chr6	C6ORF223	44000701	44001143	204	443	1428	5569	1224	5126	0.4604966139954853	0.2387826765509169
chr6	MYMX	44216969	44216994	232	26	2571475	856	2571243	830	8.923076923076923	3097.8831325301203
chr6	SLC29A1	44223926	44223955	899	30	715395	4176	714496	4146	29.966666666666665	172.33381572600098
chr6	SPATS1	44342761	44342768	8	8	23524	4590	23516	4582	1.0	5.132256656481886
chr6	RUNX2	45328461	45328495	0	35	666	8204	666	8169	0.0	0.08152772677194271
chr6	AL035670.1	46492128	46492245	0	118	0	5437	0	5319	0.0	0.0
chr6	ADGRF4	47698707	47698794	0	88	0	3403	0	3315	0.0	0.0
chr6	AL121974.1	49803058	49803073	0	16	0	1303	0	1287	0.0	0.0
chr6	AL121974.1	49803058	49803105	0	48	0	1303	0	1255	0.0	0.0
chr6	AL121974.1	49803074	49803105	0	32	0	1303	0	1271	0.0	0.0
chr6	AL121974.1	49817492	49817524	0	33	0	1303	0	1270	0.0	0.0
chr6	AL121974.1	49817497	49817524	0	28	0	1303	0	1275	0.0	0.0
chr6	AL121974.1	49817492	49817496	0	5	0	1303	0	1298	0.0	0.0
chr6	EFHC1	52424082	52424167	0	86	19269	16238	19269	16152	0.0	1.1929791976225854
chr6	EFHC1	52438455	52438591	0	137	19269	16238	19269	16101	0.0	1.1967579653437674
chr6	EFHC1	52423815	52423828	0	14	19269	16238	19269	16224	0.0	1.1876849112426036
chr6	TRAM2-AS1	52577612	52577651	0	40	51	8437	51	8397	0.0	0.006073597713469096
chr6	TRAM2-AS1	52578394	52578594	0	201	51	8437	51	8236	0.0	0.006192326372025255
chr6	AL109918.1	52666519	52666548	0	30	0	3559	0	3529	0.0	0.0
chr6	AL445250.1	57961743	57962248	0	506	1122	10037	1122	9531	0.0	0.11772112055398175
chr6	AL445250.1	58038490	58038556	0	67	1122	10037	1122	9970	0.0	0.11253761283851554
chr6	LINC01626	71453095	71453688	0	594	102	1157	102	563	0.0	0.1811722912966252
chr6	MTO1	73461795	73462071	0	277	3330	11827	3330	11550	0.0	0.2883116883116883
chr6	MTO1	73462072	73462173	0	102	3330	11827	3330	11725	0.0	0.28400852878464816
chr6	MTO1	73461795	73462173	0	379	3330	11827	3330	11448	0.0	0.2908805031446541
chr6	CD109	73811097	73811147	0	51	3997	9817	3997	9766	0.0	0.4092770837599836
chr6	MYO6	75892691	75892693	0	3	3867	9887	3867	9884	0.0	0.391238365034399
chr6	MYO6	75844978	75844982	0	5	3867	9887	3867	9882	0.0	0.39131754705525196
chr6	TTK	80004714	80004831	0	118	0	4604	0	4486	0.0	0.0
chr6	TBX18-AS1	84689562	84689736	0	175	51	2085	51	1910	0.0	0.026701570680628273
chr6	TBX18-AS1	84689596	84689736	0	141	51	2085	51	1944	0.0	0.026234567901234566
chr6	TBX18-AS1	84689562	84689595	0	34	51	2085	51	2051	0.0	0.024865919063871283
chr6	SMIM8	87330713	87330950	0	238	283	7986	283	7748	0.0	0.03652555498193082
chr6	SMIM8	87391836	87391877	0	42	283	7986	283	7944	0.0	0.03562437059415911
chr6	PNRC1	89080974	89081434	0	461	0	2995	0	2534	0.0	0.0
chr6	ANKRD6	89629224	89629238	0	15	1355	8004	1355	7989	0.0	0.16960821129052447
chr6	ANKRD6	89562899	89562923	0	25	1355	8004	1355	7979	0.0	0.16982077954630906
chr6	CASP8AP2	89829935	89830067	0	133	289086	8157	289086	8024	0.0	36.02766699900299
chr6	CASP8AP2	89830068	89830106	0	39	289086	8157	289086	8118	0.0	35.61049519586105
chr6	AL132996.1	90346088	90346121	8389	34	208783	8959	200394	8925	246.73529411764707	22.45310924369748
chr6	AL589740.1	97423567	97423662	0	96	17226	12047	17226	11951	0.0	1.4413856581039244
chr6	AL589740.1	97769699	97769702	0	4	17226	12047	17226	12043	0.0	1.4303744914057959
chr6	PRDM13	99607179	99607206	0	28	0	3177	0	3149	0.0	0.0
chr6	MCHR2-AS1	99994002	99994061	0	60	4418	1443	4418	1383	0.0	3.1945046999276934
chr6	MCHR2-AS1	99994062	99994204	1683	143	4418	1443	2735	1300	11.76923076923077	2.103846153846154
chr6	BVES-AS1	105137312	105137332	0	21	0	6708	0	6687	0.0	0.0
chr6	BVES-AS1	105137333	105137478	0	146	0	6708	0	6562	0.0	0.0
chr6	BVES-AS1	105137312	105137478	0	167	0	6708	0	6541	0.0	0.0
chr6	PRDM1	106086474	106086595	0	122	0	6762	0	6640	0.0	0.0
chr6	PRDM1	106087908	106087930	0	23	0	6762	0	6739	0.0	0.0
chr6	MTRES1	107028272	107028797	51	526	10548	2300	10497	1774	0.09695817490494296	5.9171364148816235
chr6	OSTM1-AS1	108123735	108123775	0	41	0	3512	0	3471	0.0	0.0
chr6	CEP57L1	109095252	109095575	0	324	15055	16746	15055	16422	0.0	0.9167580075508465
chr6	CEP57L1	109160717	109160730	0	14	15055	16746	15055	16732	0.0	0.8997728902701411
chr6	CEP57L1	109159103	109159153	0	51	15055	16746	15055	16695	0.0	0.9017669961066187
chr6	FIG4	109788914	109788956	512	43	543882	19865	543370	19822	11.906976744186046	27.412470991827263
chr6	FIG4	109786450	109788956	79438	2507	543882	19865	464444	17358	31.68647786198644	26.75676921304298
chr6	MFSD4B	111259551	111259727	0	177	34765	13087	34765	12910	0.0	2.692873741285825
chr6	MFSD4B	111273423	111273429	0	7	34765	13087	34765	13080	0.0	2.657874617737003
chr6	TRAF3IP2-AS1	111574659	111574802	0	144	27070	4826	27070	4682	0.0	5.781717214865442
chr6	CCN6	112054135	112054161	0	27	0	1796	0	1769	0.0	0.0
chr6	CCN6	112054162	112054170	0	9	0	1796	0	1787	0.0	0.0
chr6	CCN6	112054135	112054170	0	36	0	1796	0	1760	0.0	0.0
chr6	CCN6	112061289	112061395	0	107	0	1796	0	1689	0.0	0.0
chr6	FAM229B	112087710	112087720	0	11	1377	2508	1377	2497	0.0	0.5514617541049259
chr6	LAMA4-AS1	112283168	112283192	0	25	0	4143	0	4118	0.0	0.0
chr6	HDAC2-AS2	113992015	113992018	0	4	43589	8080	43589	8076	0.0	5.3973501733531455
chr6	HDAC2-AS2	113992019	113992120	0	102	43589	8080	43589	7978	0.0	5.46365003760341
chr6	HDAC2-AS2	113992015	113992120	0	106	43589	8080	43589	7974	0.0	5.4663907700025085
chr6	HDAC2-AS2	113970279	113970323	0	45	43589	8080	43589	8035	0.0	5.424891101431238
chr6	HDAC2-AS2	113971616	113971775	0	160	43589	8080	43589	7920	0.0	5.503661616161616
chr6	HDAC2-AS2	113992019	113992187	0	169	43589	8080	43589	7911	0.0	5.509922892175452
chr6	HDAC2-AS2	113992015	113992187	0	173	43589	8080	43589	7907	0.0	5.512710256734539
chr6	HDAC2-AS2	113992121	113992187	0	67	43589	8080	43589	8013	0.0	5.439785348808186
chr6	HDAC2-AS2	113995252	113995495	0	244	43589	8080	43589	7836	0.0	5.562659520163349
chr6	HDAC2-AS2	114230324	114230346	0	23	43589	8080	43589	8057	0.0	5.41007819287576
chr6	DSE	116254296	116254383	0	88	21321	19215	21321	19127	0.0	1.1147069587494118
chr6	CALHM4	116529136	116529190	0	55	14243	1903	14243	1848	0.0	7.707251082251083
chr6	GJA1	121435661	121435832	0	172	1563	3399	1563	3227	0.0	0.48435079020762317
chr6	TPD52L1	125257159	125257180	0	22	102	4105	102	4083	0.0	0.024981631153563555
chr6	TRMT11	126021266	126021280	0	15	3018	5422	3018	5407	0.0	0.5581653412243388
chr6	TRMT11	125986623	125986773	0	151	3018	5422	3018	5271	0.0	0.5725668753557199
chr6	TRMT11	125986691	125986773	0	83	3018	5422	3018	5339	0.0	0.5652743959542985
chr6	TRMT11	125986623	125986690	0	68	3018	5422	3018	5354	0.0	0.5636906985431454
chr6	CENPW	126340400	126340444	0	45	1390	857	1390	812	0.0	1.7118226600985222
chr6	RNF146	127266926	127267095	0	170	0	3139	0	2969	0.0	0.0
chr6	RNF146	127267045	127267095	0	51	0	3139	0	3088	0.0	0.0
chr6	RNF146	127266926	127267044	0	119	0	3139	0	3020	0.0	0.0
chr6	ENPP3	131674282	131674410	0	129	0	3912	0	3783	0.0	0.0
chr6	LINC01013	132154710	132154777	0	68	0	6796	0	6728	0.0	0.0
chr6	LINC01013	132160915	132161006	0	92	0	6796	0	6704	0.0	0.0
chr6	LINC00326	132954518	132954600	0	83	2601	6021	2601	5938	0.0	0.43802627147187606
chr6	LINC00326	133088932	133090069	0	1138	2601	6021	2601	4883	0.0	0.5326643456891256
chr6	LINC00326	133098319	133098369	0	51	2601	6021	2601	5970	0.0	0.435678391959799
chr6	LINC00326	133098319	133098520	0	202	2601	6021	2601	5819	0.0	0.4469840178724867
chr6	LINC00326	133098370	133098520	0	151	2601	6021	2601	5870	0.0	0.4431005110732538
chr6	LINC00326	133098383	133098520	0	138	2601	6021	2601	5883	0.0	0.44212136664966856
chr6	LINC00326	133098375	133098520	0	146	2601	6021	2601	5875	0.0	0.44272340425531914
chr6	LINC00326	133098319	133098382	0	64	2601	6021	2601	5957	0.0	0.4366291757596105
chr6	LINC00326	133098370	133098382	0	13	2601	6021	2601	6008	0.0	0.4329227696404794
chr6	LINC00326	133098375	133098382	0	8	2601	6021	2601	6013	0.0	0.4325627806419425
chr6	LINC00326	133098319	133098374	0	56	2601	6021	2601	5965	0.0	0.43604358759430006
chr6	LINC00326	133098370	133098374	0	5	2601	6021	2601	6016	0.0	0.4323470744680851
chr6	EYA4	133468732	133468749	0	18	153	7266	153	7248	0.0	0.021109271523178808
chr6	LINC01010	134475669	134475726	0	58	648	4158	648	4100	0.0	0.15804878048780488
chr6	MYB	135194452	135194460	0	9	1476	5517	1476	5508	0.0	0.2679738562091503
chr6	MYB	135195918	135196002	0	85	1476	5517	1476	5432	0.0	0.27172312223858613
chr6	MYB	135195955	135196002	0	48	1476	5517	1476	5469	0.0	0.26988480526604497
chr6	MYB	135202670	135202673	0	4	1476	5517	1476	5513	0.0	0.26773081806638854
chr6	MYB	135200416	135200674	0	259	1476	5517	1476	5258	0.0	0.2807151007987828
chr6	MYB	135200558	135200674	0	117	1476	5517	1476	5400	0.0	0.2733333333333333
chr6	MYB	135196909	135197323	0	415	1476	5517	1476	5102	0.0	0.2892983143865151
chr6	MYB	135195918	135195954	0	37	1476	5517	1476	5480	0.0	0.26934306569343064
chr6	MYB	135200416	135200557	0	142	1476	5517	1476	5375	0.0	0.2746046511627907
chr6	LINC00271	135518643	135518830	0	188	15968	13702	15968	13514	0.0	1.18158946277934
chr6	TNFAIP3	137867519	137867542	0	24	87	4800	87	4776	0.0	0.01821608040201005
chr6	TNFAIP3	137867495	137867542	0	48	87	4800	87	4752	0.0	0.018308080808080808
chr6	TNFAIP3	137867495	137867518	0	24	87	4800	87	4776	0.0	0.01821608040201005
chr6	HEBP2	138406034	138406151	0	118	367022	10358	367022	10240	0.0	35.8419921875
chr6	FILNC1	139854952	139854977	0	26	204	1857	204	1831	0.0	0.11141452758055707
chr6	AL357146.1	140083229	140083257	0	29	0	2548	0	2519	0.0	0.0
chr6	AL357146.1	140087990	140088007	0	18	0	2548	0	2530	0.0	0.0
chr6	AL357146.1	140086757	140086761	0	5	0	2548	0	2543	0.0	0.0
chr6	ADGRG6	142370229	142370793	0	565	30	8466	30	7901	0.0	0.003796987723073029
chr6	FBXO30-DT	145828421	145828456	0	36	0	8517	0	8481	0.0	0.0
chr6	GRM1	146027793	146027828	0	36	1632	7383	1632	7347	0.0	0.22213148223764803
chr6	ADGB	146784674	146784794	0	121	0	7809	0	7688	0.0	0.0
chr6	SASH1	148519894	148520382	0	489	120	10733	120	10244	0.0	0.011714174150722375
chr6	PCMT1	149802370	149802416	0	47	3162	2845	3162	2798	0.0	1.1300929235167978
chr6	IYD	150389476	150389543	0	68	0	9466	0	9398	0.0	0.0
chr6	IYD	150395455	150395566	0	112	0	9466	0	9354	0.0	0.0
chr6	AL080276.2	152988015	152988022	0	8	0	3400	0	3392	0.0	0.0
chr6	AL080276.2	152983806	152984250	0	445	0	3400	0	2955	0.0	0.0
chr6	OPRM1	154010560	154011018	0	459	255	20919	255	20460	0.0	0.012463343108504398
chr6	OPRM1	154087786	154087804	0	19	255	20919	255	20900	0.0	0.012200956937799042
chr6	SCAF8	154733504	154733550	0	47	12424	5450	12424	5403	0.0	2.2994632611512125
chr6	ZDHHC14	157628375	157628486	0	112	5763	11143	5763	11031	0.0	0.5224367691052488
chr6	C6ORF99	158869966	158870310	6346	345	6553	1833	207	1488	18.394202898550724	0.13911290322580644
chr6	C6ORF99	158869978	158870310	6346	333	6553	1833	207	1500	19.057057057057058	0.138
chr6	C6ORF99	158869970	158870310	6346	341	6553	1833	207	1492	18.609970674486803	0.13873994638069706
chr6	C6ORF99	158869966	158869977	0	12	6553	1833	6553	1821	0.0	3.5985722130697417
chr6	C6ORF99	158869970	158869977	0	8	6553	1833	6553	1825	0.0	3.5906849315068494
chr6	C6ORF99	158869966	158869969	0	4	6553	1833	6553	1829	0.0	3.582832148715145
chr6	WTAP	159748370	159750010	0	1641	0	6422	0	4781	0.0	0.0
chr6	PNLDC1	159803311	159803388	0	78	0	2094	0	2016	0.0	0.0
chr6	PNLDC1	159800380	159800383	0	4	0	2094	0	2090	0.0	0.0
chr6	AL109933.1	160698501	160698535	0	35	0	329	0	294	0.0	0.0
chr6	PLG	160741369	160741417	0	49	1024	6148	1024	6099	0.0	0.1678963764551566
chr6	PLG	160706543	160706593	0	51	1024	6148	1024	6097	0.0	0.16795145153354107
chr6	AL139393.2	160928017	160928093	0	77	0	1292	0	1215	0.0	0.0
chr6	MAP3K4	161093840	161093851	0	12	237	7415	237	7403	0.0	0.03201404835877347
chr6	QKI	163423214	163423592	2550	379	2805	12507	255	12128	6.728232189973615	0.021025725593667548
chr6	AL078602.1	163759366	163759429	0	64	1479	6195	1479	6131	0.0	0.24123307780133746
chr6	AL078602.1	163759389	163759429	0	41	1479	6195	1479	6154	0.0	0.24033149171270718
chr6	AL078602.1	163759366	163759388	0	23	1479	6195	1479	6172	0.0	0.2396305897602074
chr6	AL078602.1	163671697	163671893	0	197	1479	6195	1479	5998	0.0	0.24658219406468823
chr6	AL450345.1	164829982	164830071	0	90	0	2884	0	2794	0.0	0.0
chr6	AL450345.1	164827964	164828019	0	56	0	2884	0	2828	0.0	0.0
chr6	LNCDAT	166168704	166168770	0	67	0	2158	0	2091	0.0	0.0
chr6	AL022069.3	166342727	166343147	0	421	0	3906	0	3485	0.0	0.0
chr6	AFDN	167943192	167943194	0	3	51	13403	51	13400	0.0	0.0038059701492537314
chr6	AFDN	167965854	167966045	0	192	51	13403	51	13211	0.0	0.003860419347513436
chr6	AFDN	167966046	167966270	0	225	51	13403	51	13178	0.0	0.003870086507816057
chr6	AFDN	167966271	167966276	0	6	51	13403	51	13397	0.0	0.0038068224229305067
chr6	AL109924.2	169067983	169068299	0	317	51	772	51	455	0.0	0.11208791208791209
chr6	AL596442.1	170160640	170160696	0	57	39967	765	39967	708	0.0	56.45056497175141
chr6	TBP	170569741	170569779	0	39	0	2328	0	2289	0.0	0.0
chr6	LINC01600	2633573	2633603	0	31	1030	3082	1030	3051	0.0	0.33759423139954114
chr6	SERPINB6	2971490	2971531	7460	42	530962	6054	523502	6012	177.61904761904762	87.07618097139056
chr6	SERPINB6	2971247	2971531	29911	285	530962	6054	501051	5769	104.95087719298246	86.8523140925637
chr6	SERPINB6	2971247	2971489	22451	243	530962	6054	508511	5811	92.39094650205762	87.50834623988986
chr6	SERPINB6	2971247	2971590	31027	344	530962	6054	499935	5710	90.19476744186046	87.55429071803853
chr6	SERPINB6	2966399	2968777	47259	2379	530962	6054	483703	3675	19.865069356872635	131.61986394557823
chr6	SERPINB6	2966399	2970694	100545	4296	530962	6054	430417	1758	23.404329608938546	244.83333333333334
chr6	SERPINB6	2968778	2968797	160	20	530962	6054	530802	6034	8.0	87.96851176665562
chr6	SERPINB6	2971116	2971246	1622	131	530962	6054	529340	5923	12.381679389312977	89.3702515617086
chr6	SERPINB6	2970695	2970756	2399	62	530962	6054	528563	5992	38.693548387096776	88.21144859813084
chr6	SLC22A23	3323833	3323885	0	53	97638	6133	97638	6080	0.0	16.058881578947368
chr6	AL033523.1	3653220	3653599	0	380	2499	14663	2499	14283	0.0	0.17496324301617308
chr6	AL033523.1	3631925	3632027	0	103	2499	14663	2499	14560	0.0	0.17163461538461539
chr6	PXDC1	3738056	3738060	50	5	609321	2168	609271	2163	10.0	281.6786870087841
chr6	ECI2	4135311	4135509	2046	199	260689	4584	258643	4385	10.28140703517588	58.98358038768529
chr6	ECI2	4135114	4135310	2780	197	260689	4584	257909	4387	14.111675126903553	58.78937770686118
chr6	SSR1	7295384	7295390	0	7	180513	2851	180513	2844	0.0	63.471518987341774
chr6	CAGE1	7368687	7368752	0	66	357	3526	357	3460	0.0	0.10317919075144509
chr6	CAGE1	7378616	7378620	0	5	357	3526	357	3521	0.0	0.10139165009940358
chr6	CAGE1	7389201	7389281	0	81	357	3526	357	3445	0.0	0.10362844702467344
chr6	SLC35B3	8435076	8435341	3136	266	79418	3823	76282	3557	11.789473684210526	21.44560022490863
chr6	SLC35B3	8435076	8435226	2408	151	79418	3823	77010	3672	15.947019867549669	20.97222222222222
chr6	SLC35B3	8435227	8435341	728	115	79418	3823	78690	3708	6.3304347826086955	21.22168284789644
chr6	MAK	10838341	10838480	0	140	37465	4411	37465	4271	0.0	8.771950362912667
chr6	MAK	10838481	10838501	0	21	37465	4411	37465	4390	0.0	8.534168564920273
chr6	TBC1D7	13328295	13328454	0	160	21281	6125	21281	5965	0.0	3.567644593461861
chr6	TBC1D7	13328295	13328314	0	20	21281	6125	21281	6105	0.0	3.485831285831286
chr6	TBC1D7	13307595	13307598	0	4	21281	6125	21281	6121	0.0	3.476719490279366
chr6	TBC1D7	13328315	13328454	0	140	21281	6125	21281	5985	0.0	3.5557226399331663
chr6	TBC1D7	13327832	13328294	0	463	21281	6125	21281	5662	0.0	3.7585658777817024
chr6	TBC1D7	13327832	13328314	0	483	21281	6125	21281	5642	0.0	3.771889400921659
chr6	LNC-LBCS	19534886	19534906	0	21	32612	12676	32612	12655	0.0	2.577005136309759
chr6	LNC-LBCS	19538327	19538361	0	35	32612	12676	32612	12641	0.0	2.5798591883553517
chr6	LNC-LBCS	19538312	19538361	0	50	32612	12676	32612	12626	0.0	2.5829241248217962
chr6	LNC-LBCS	19538312	19538326	0	15	32612	12676	32612	12661	0.0	2.575783903325172
chr6	LNC-LBCS	19804170	19804673	1173	504	32612	12676	31439	12172	2.3273809523809526	2.5828951692408806
chr6	TDP2	24666118	24666524	1989	407	295263	2852	293274	2445	4.886977886977887	119.94846625766871
chr6	CMAHP	25261123	25261408	0	286	2811	7466	2811	7180	0.0	0.3915041782729805
chr6	SLC17A2	25914544	25914578	0	35	0	2580	0	2545	0.0	0.0
chr6	AL031777.2	26198858	26198947	0	90	10288	1606	10288	1516	0.0	6.786279683377309
chr6	H2BC11	27132366	27132523	0	158	0	839	0	681	0.0	0.0
chr6	ZSCAN31	28335829	28336080	10874	252	33084	3678	22210	3426	43.15079365079365	6.482778750729714
chr6	ZSCAN31	28337755	28337797	0	43	33084	3678	33084	3635	0.0	9.101513067400274
chr6	GABBR1	29630457	29630520	0	64	191883	8494	191883	8430	0.0	22.761921708185053
chr6	ZNRD1ASP	30060740	30060960	0	221	55898	9881	55898	9660	0.0	5.7865424430641825
chr6	ZNRD1ASP	30060740	30061077	0	338	55898	9881	55898	9543	0.0	5.857487163365818
chr6	ZNRD1ASP	30060961	30061077	0	117	55898	9881	55898	9764	0.0	5.724907824662024
chr6	HCG18	30294470	30294851	5201	382	130230	15541	125029	15159	13.615183246073299	8.247839567253777
chr6	HCG18	30326353	30326858	0	506	130230	15541	130230	15035	0.0	8.661789158629864
chr6	HCG18	30326150	30326352	0	203	130230	15541	130230	15338	0.0	8.49067675055418
chr6	HCG18	30291536	30294469	26797	2934	130230	15541	103433	12607	9.1332651670075	8.204410248274767
chr6	HCG18	30326008	30326149	0	142	130230	15541	130230	15399	0.0	8.457042665108125
chr6	HCG18	30326008	30326352	0	345	130230	15541	130230	15196	0.0	8.570018425901553
chr6	DHX16	30672634	30672954	70842	321	387082	3677	316240	3356	220.69158878504672	94.23122765196662
chr6	PPP1R18	30684407	30687112	10205	2706	37109	4135	26904	1429	3.771249076127125	18.827151854443667
chr6	MDC1	30717244	30717247	0	4	1238783	7574	1238783	7570	0.0	163.6437252311757
chr6	MDC1	30716881	30717082	0	202	1238783	7574	1238783	7372	0.0	168.03893109061312
chr6	FLOT1	30741613	30741660	0	48	2151	3108	2151	3060	0.0	0.7029411764705882
chr6	FLOT1	30742383	30742465	0	83	2151	3108	2151	3025	0.0	0.7110743801652892
chr6	CCHCR1	31145165	31145186	91	22	11185	4266	11094	4244	4.136363636363637	2.614043355325165
chr6	CCHCR1	31158166	31158169	4	4	11185	4266	11181	4262	1.0	2.6234162365086813
chr6	CCHCR1	31157998	31158009	0	12	11185	4266	11185	4254	0.0	2.6292900799247767
chr6	CCHCR1	31157357	31157383	0	27	11185	4266	11185	4239	0.0	2.6385940080207595
chr6	CCHCR1	31157884	31157997	51	114	11185	4266	11134	4152	0.4473684210526316	2.6815992292870905
chr6	CCHCR1	31157884	31158009	51	126	11185	4266	11134	4140	0.40476190476190477	2.6893719806763285
chr6	ATP6V1G2	31546477	31546630	0	154	945	2151	945	1997	0.0	0.4732098147220831
chr6	NCR3	31592678	31592855	0	178	37533	1155	37533	977	0.0	38.41658137154555
chr6	BAG6	31652423	31652511	0	89	67628	5364	67628	5275	0.0	12.82047393364929
chr6	BAG6	31652234	31652245	0	12	67628	5364	67628	5352	0.0	12.636023916292974
chr6	BAG6	31651901	31652078	0	178	67628	5364	67628	5186	0.0	13.040493636714231
chr6	BAG6	31651901	31652059	0	159	67628	5364	67628	5205	0.0	12.992891450528338
chr6	BAG6	31652399	31652422	0	24	67628	5364	67628	5340	0.0	12.66441947565543
chr6	BAG6	31652399	31652511	0	113	67628	5364	67628	5251	0.0	12.879070653208913
chr6	BAG6	31651865	31651900	0	36	67628	5364	67628	5328	0.0	12.692942942942944
chr6	BAG6	31652060	31652078	0	19	67628	5364	67628	5345	0.0	12.652572497661366
chr6	GPANK1	31665558	31665572	136	15	17812	3249	17676	3234	9.066666666666666	5.465677179962894
chr6	LY6G5C	31680158	31680251	0	94	0	2627	0	2533	0.0	0.0
chr6	VWA7	31775963	31776162	0	200	115585	3689	115585	3489	0.0	33.12840355402694
chr6	VARS1	31782284	31782400	153	117	980472	5586	980319	5469	1.3076923076923077	179.25013713658805
chr6	NEU1	31860041	31860045	10	5	122609	4728	122599	4723	2.0	25.957865763286048
chr6	NELFE	31958307	31958370	0	64	2391	2493	2391	2429	0.0	0.9843557019349527
chr6	NELFE	31958579	31958669	0	91	2391	2493	2391	2402	0.0	0.9954204829308909
chr6	DXO	31971319	31971927	0	609	1708	1879	1708	1270	0.0	1.3448818897637795
chr6	ATF6B	32128116	32128124	0	9	45098	3646	45098	3637	0.0	12.399780038493263
chr6	AL662884.3	32154237	32154287	1882	51	288164	1064	286282	1013	36.90196078431372	282.6080947680158
chr6	AL662884.3	32154168	32154236	6158	69	288164	1064	282006	995	89.2463768115942	283.42311557788946
chr6	AL662884.3	32154168	32154287	8040	120	288164	1064	280124	944	67.0	296.74152542372883
chr6	AGER	32183275	32183322	0	48	0	1715	0	1667	0.0	0.0
chr6	AGER	32183554	32183566	0	13	0	1715	0	1702	0.0	0.0
chr6	TSBP1	32323590	32323591	0	2	49583	2235	49583	2233	0.0	22.204657411553963
chr6	BTNL2	32396038	32396041	0	4	0	1377	0	1373	0.0	0.0
chr6	BTNL2	32405174	32405178	0	5	0	1377	0	1372	0.0	0.0
chr6	HLA-DRB6	32554618	32554688	0	71	0	1332	0	1261	0.0	0.0
chr6	HLA-DMA	32949270	32949272	222	3	68150	2526	67928	2523	74.0	26.9235037653587
chr6	HLA-DOA	33007310	33007352	0	43	0	3854	0	3811	0.0	0.0
chr6	VPS52	33263771	33263781	1148	11	1417843	3958	1416695	3947	104.36363636363636	358.92956675956424
chr6	VPS52	33271136	33271584	73861	449	1417843	3958	1343982	3509	164.5011135857461	383.00997435166715
chr6	VPS52	33271136	33271689	94778	554	1417843	3958	1323065	3404	171.07942238267148	388.6794947121034
chr6	VPS52	33271585	33271689	20917	105	1417843	3958	1396926	3853	199.2095238095238	362.5554113677654
chr6	WDR46	33280673	33280813	0	141	1115493	2584	1115493	2443	0.0	456.6078591895211
chr6	CUTA	33417958	33418085	4792	128	154924	1281	150132	1153	37.4375	130.20988725065047
chr6	CUTA	33417868	33417957	8557	90	154924	1281	146367	1191	95.07777777777778	122.8942065491184
chr6	CUTA	33417868	33418085	13349	218	154924	1281	141575	1063	61.23394495412844	133.18438381937912
chr6	CUTA	33417246	33417249	221	4	154924	1281	154703	1277	55.25	121.14565387627252
chr6	LEMD2	33788380	33788773	0	394	408	6568	408	6174	0.0	0.06608357628765792
chr6	MLN	33795502	33795522	0	21	19	536	19	515	0.0	0.036893203883495145
chr6	LINC01016	33892695	33892706	0	12	0	1879	0	1867	0.0	0.0
chr6	LINC01016	33892316	33892694	0	379	0	1879	0	1500	0.0	0.0
chr6	LINC01016	33896585	33896817	0	233	0	1879	0	1646	0.0	0.0
chr6	SMIM29	34247680	34247739	7513	60	161731	1694	154218	1634	125.21666666666667	94.38066095471237
chr6	SMIM29	34248726	34248977	49204	252	161731	1694	112527	1442	195.25396825396825	78.03536754507628
chr6	RPS10	34425515	34425556	0	42	153	2123	153	2081	0.0	0.0735223450264296
chr6	RPS10	34425557	34425581	0	25	153	2123	153	2098	0.0	0.07292659675881792
chr6	TCP11	35140746	35140813	0	68	0	3084	0	3016	0.0	0.0
chr6	FKBP5	35688731	35688802	0	72	153	10641	153	10569	0.0	0.014476298609139937
chr6	SRPK1	35920986	35921042	0	57	17256	6252	17256	6195	0.0	2.7854721549636805
chr6	SRPK1	35920064	35920466	0	403	17256	6252	17256	5849	0.0	2.9502479056248934
chr6	SLC26A8	36024329	36024418	0	90	301	5043	301	4953	0.0	0.0607712497476277
chr6	SLC26A8	36024419	36024502	0	84	301	5043	301	4959	0.0	0.060697721314781204
chr6	SLC26A8	35954819	35955150	0	332	301	5043	301	4711	0.0	0.0638930163447251
chr6	ETV7	36375829	36375869	0	41	0	2383	0	2342	0.0	0.0
chr6	MTCH1	36972651	36972701	0	51	0	3138	0	3087	0.0	0.0
chr6	TMEM217	37218425	37218473	0	49	839	2617	839	2568	0.0	0.3267133956386293
chr6	TMEM217	37257562	37257566	0	5	839	2617	839	2612	0.0	0.32120980091883616
chr6	MDGA1	37646197	37646266	0	70	306	12747	306	12677	0.0	0.024138203044884437
chr6	MOCS1	39909039	39909053	0	15	0	5101	0	5086	0.0	0.0
chr6	MOCS1	39927183	39927327	0	145	0	5101	0	4956	0.0	0.0
chr6	AL033380.1	40517303	40517410	0	108	0	1346	0	1238	0.0	0.0
chr6	OARD1	41072235	41072317	199	83	491684	6234	491485	6151	2.397590361445783	79.90326776133962
chr6	OARD1	41072235	41072333	199	99	491684	6234	491485	6135	2.01010101010101	80.1116544417278
chr6	OARD1	41072318	41072333	0	16	491684	6234	491684	6218	0.0	79.07430041814088
chr6	TFEB	41732648	41733662	0	1015	51	5743	51	4728	0.0	0.010786802030456852
chr6	TFEB	41732648	41734083	51	1436	51	5743	0	4307	0.035515320334261836	0.0
chr6	USP49	41798723	41798873	0	151	31836	10934	31836	10783	0.0	2.952425113604748
chr6	MED20	41909268	41909343	13193	76	47397	3286	34204	3210	173.5921052631579	10.655451713395639
chr6	CCND3	41940951	41941450	0	500	83971	5772	83971	5272	0.0	15.927731411229136
chr6	TRERF1	42263259	42263318	0	60	28107	7750	28107	7690	0.0	3.6550065019505853
chr6	TRERF1	42362946	42362995	0	50	28107	7750	28107	7700	0.0	3.6502597402597403
chr6	MEA1	43013785	43013896	15248	112	179301	2648	164053	2536	136.14285714285714	64.68966876971609
chr6	MEA1	43016419	43016793	0	375	179301	2648	179301	2273	0.0	78.88297404311483
chr6	CUL7	43053621	43053709	0	89	66403	6126	66403	6037	0.0	10.99933741924797
chr6	CUL7	43052112	43052207	0	96	66403	6126	66403	6030	0.0	11.012106135986732
chr6	MRPL2	43059179	43059284	0	106	2127	1897	2127	1791	0.0	1.187604690117253
chr6	DNPH1	43229050	43229259	0	210	0	1250	0	1040	0.0	0.0
chr6	DLK2	43453004	43453021	142	18	1413	2243	1271	2225	7.888888888888889	0.5712359550561797
chr6	YIPF3	43515594	43515604	0	11	57826	2603	57826	2592	0.0	22.309413580246915
chr6	XPO5	43527633	43527669	26	37	104719	7753	104693	7716	0.7027027027027027	13.568299637117677
chr6	XPO5	43573397	43573478	0	82	104719	7753	104719	7671	0.0	13.65128405683744
chr6	MRPS18A	43675201	43675492	0	292	0	1390	0	1098	0.0	0.0
chr6	LINC02537	43852069	43852175	0	107	0	2071	0	1964	0.0	0.0
chr6	AL035701.1	46129503	46129588	0	86	20	1897	20	1811	0.0	0.011043622308117063
chr6	AL591242.1	46687599	46687673	0	75	0	578	0	503	0.0	0.0
chr6	RHAG	49606728	49606846	0	119	0	2083	0	1964	0.0	0.0
chr6	CRISP2	49713474	49713499	0	26	51	1529	51	1503	0.0	0.033932135728542916
chr6	CILK1	53013640	53013660	0	21	816	6317	816	6296	0.0	0.12960609911054638
chr6	AL033397.1	53569422	53569478	0	57	0	3858	0	3801	0.0	0.0
chr6	MLIP-AS1	54047291	54047488	0	198	0	4048	0	3850	0.0	0.0
chr6	DST	56573678	56573730	0	53	19950	43263	19950	43210	0.0	0.4616986808609118
chr6	LINC00680	57948872	57948916	0	45	153	2185	153	2140	0.0	0.07149532710280374
chr6	AL713998.1	67886967	67886985	0	19	102	5335	102	5316	0.0	0.019187358916478554
chr6	AL713998.1	67883603	67883704	0	102	102	5335	102	5233	0.0	0.019491687368622206
chr6	LMBRD1	69796413	69796489	0	77	0	8302	0	8225	0.0	0.0
chr6	LMBRD1	69708849	69709155	0	307	0	8302	0	7995	0.0	0.0
chr6	LMBRD1	69796378	69796412	0	35	0	8302	0	8267	0.0	0.0
chr6	LMBRD1	69796378	69796489	0	112	0	8302	0	8190	0.0	0.0
chr6	LMBRD1	69755472	69755556	0	85	0	8302	0	8217	0.0	0.0
chr6	B3GAT2	70955838	70956053	0	216	0	6375	0	6159	0.0	0.0
chr6	LINC00472	71346164	71346172	0	9	31399	11340	31399	11331	0.0	2.771070514517695
chr6	FO393414.3	72619438	72619978	0	541	0	4482	0	3941	0.0	0.0
chr6	KHDC1	73262773	73262932	0	160	0	2448	0	2288	0.0	0.0
chr6	EEF1A1	73519882	73519890	0	9	3254	6341	3254	6332	0.0	0.5138976626658244
chr6	EEF1A1	73520999	73521505	0	507	3254	6341	3254	5834	0.0	0.5577648268769283
chr6	EEF1A1	73521506	73521730	0	225	3254	6341	3254	6116	0.0	0.5320470896010464
chr6	EEF1A1	73523446	73523723	0	278	3254	6341	3254	6063	0.0	0.5366980042883062
chr6	EEF1A1	73520361	73520998	0	638	3254	6341	3254	5703	0.0	0.5705768893564791
chr6	EEF1A1	73520361	73520908	0	548	3254	6341	3254	5793	0.0	0.5617124115311583
chr6	COX7A2	75241122	75241174	0	53	0	1928	0	1875	0.0	0.0
chr6	COX7A2	75240276	75240299	0	24	0	1928	0	1904	0.0	0.0
chr6	TMEM30A	75284401	75284495	0	95	357	5513	357	5418	0.0	0.06589147286821706
chr6	HMGN3	79202275	79202315	0	41	0	1021	0	980	0.0	0.0
chr6	LCA5	79537164	79537241	0	78	0	5972	0	5894	0.0	0.0
chr6	LINC01621	79805252	79805894	0	643	0	1477	0	834	0.0	0.0
chr6	TENT5A	81752430	81752567	0	138	0	1863	0	1725	0.0	0.0
chr6	TENT5A	81752375	81752429	0	55	0	1863	0	1808	0.0	0.0
chr6	TENT5A	81752375	81752567	0	193	0	1863	0	1670	0.0	0.0
chr6	LINC02542	82101559	82101643	0	85	447	2815	447	2730	0.0	0.16373626373626374
chr6	IBTK	82227163	82227190	224	28	1972	7325	1748	7297	8.0	0.23955050020556393
chr6	UBE3D	83022452	83022477	0	26	4308	6416	4308	6390	0.0	0.6741784037558686
chr6	UBE3D	83065641	83065678	0	38	4308	6416	4308	6378	0.0	0.6754468485418627
chr6	PGM3	83170300	83170303	0	4	51	5939	51	5935	0.0	0.008593091828138163
chr6	PGM3	83192961	83193177	0	217	51	5939	51	5722	0.0	0.008912967493883258
chr6	PGM3	83193104	83193177	0	74	51	5939	51	5865	0.0	0.008695652173913044
chr6	SNAP91	83708844	83709120	0	277	4577	6360	4577	6083	0.0	0.752424790399474
chr6	SNAP91	83708844	83709042	0	199	4577	6360	4577	6161	0.0	0.7428988800519396
chr6	SNAP91	83709121	83709324	13	204	4577	6360	4564	6156	0.06372549019607843	0.7413905133203379
chr6	SNAP91	83709043	83709120	0	78	4577	6360	4577	6282	0.0	0.7285896211397644
chr6	SNAP91	83708664	83708843	0	180	4577	6360	4577	6180	0.0	0.7406148867313915
chr6	SNAP91	83708345	83708361	0	17	4577	6360	4577	6343	0.0	0.7215828472331705
chr6	SNAP91	83708362	83708663	1480	302	4577	6360	3097	6058	4.900662251655629	0.5112248266754704
chr6	SNAP91	83708362	83708415	0	54	4577	6360	4577	6306	0.0	0.7258166825245798
chr6	SNAP91	83708416	83708663	1480	248	4577	6360	3097	6112	5.967741935483871	0.5067081151832461
chr6	SNX14	85547111	85547114	0	4	337	7137	337	7133	0.0	0.047245198373755785
chr6	SNX14	85593578	85593832	0	255	337	7137	337	6882	0.0	0.04896832316187155
chr6	SYNCRIP	85614980	85615017	0	38	0	9811	0	9773	0.0	0.0
chr6	SYNCRIP	85622481	85622585	0	105	0	9811	0	9706	0.0	0.0
chr6	SYNCRIP	85637242	85637267	0	26	0	9811	0	9785	0.0	0.0
chr6	SNHG5	85663673	85663685	0	13	51	7815	51	7802	0.0	0.006536785439630864
chr6	SNHG5	85663475	85663672	0	198	51	7815	51	7617	0.0	0.00669554942890902
chr6	SNHG5	85663475	85663685	0	211	51	7815	51	7604	0.0	0.006706996317727512
chr6	SNHG5	85678693	85678696	0	4	51	7815	51	7811	0.0	0.006529253616694405
chr6	SNHG5	85676984	85677091	0	108	51	7815	51	7707	0.0	0.006617360840794083
chr6	SNHG5	85677423	85677793	0	371	51	7815	51	7444	0.0	0.006851155292853304
chr6	SNHG5	85677423	85677952	0	530	51	7815	51	7285	0.0	0.0070006863417982155
chr6	SNHG5	85677423	85678134	0	712	51	7815	51	7103	0.0	0.007180064761368436
chr6	SNHG5	85677794	85677952	0	159	51	7815	51	7656	0.0	0.0066614420062695925
chr6	SNHG5	85677794	85678134	0	341	51	7815	51	7474	0.0	0.006823655338506824
chr6	SNHG5	85677790	85677793	0	4	51	7815	51	7811	0.0	0.006529253616694405
chr6	SNHG5	85677953	85678134	0	182	51	7815	51	7633	0.0	0.0066815144766146995
chr6	SNHG5	85678402	85678692	0	291	51	7815	51	7524	0.0	0.006778309409888357
chr6	SNHG5	85678402	85678696	0	295	51	7815	51	7520	0.0	0.0067819148936170215
chr6	SNHG5	85678402	85678496	0	95	51	7815	51	7720	0.0	0.006606217616580311
chr6	SNHG5	85678497	85678692	0	196	51	7815	51	7619	0.0	0.0066937918361989765
chr6	SNHG5	85678497	85678696	0	200	51	7815	51	7615	0.0	0.0066973079448456995
chr6	SNHG5	85677790	85677952	0	163	51	7815	51	7652	0.0	0.006664924202822792
chr6	CGA	87088093	87088111	0	19	0	1990	0	1971	0.0	0.0
chr6	AL353135.2	89145633	89145691	0	59	0	1763	0	1704	0.0	0.0
chr6	AL353135.2	89143665	89143745	0	81	0	1763	0	1682	0.0	0.0
chr6	LYRM2	89637724	89637740	0	17	7888	8685	7888	8668	0.0	0.9100138440239963
chr6	UFL1-AS1	96398908	96398913	0	6	0	6546	0	6540	0.0	0.0
chr6	UFL1-AS1	96460439	96460484	0	46	0	6546	0	6500	0.0	0.0
chr6	MMS22L	97282986	97283043	0	58	3267	18577	3267	18519	0.0	0.17641341325125548
chr6	MMS22L	97282986	97283076	0	91	3267	18577	3267	18486	0.0	0.17672833495618306
chr6	MMS22L	97282986	97283094	0	109	3267	18577	3267	18468	0.0	0.17690058479532164
chr6	MMS22L	97283044	97283076	0	33	3267	18577	3267	18544	0.0	0.1761755823986195
chr6	MMS22L	97283044	97283094	0	51	3267	18577	3267	18526	0.0	0.1763467559106121
chr6	MMS22L	97283077	97283094	0	18	3267	18577	3267	18559	0.0	0.1760331914435045
chr6	PNISR	99403828	99404601	0	774	0	5565	0	4791	0.0	0.0
chr6	CCNC	99558496	99558499	0	4	0	5627	0	5623	0.0	0.0
chr6	CCNC	99544178	99544204	0	27	0	5627	0	5600	0.0	0.0
chr6	CCNC	99568495	99568716	0	222	0	5627	0	5405	0.0	0.0
chr6	MCHR2	99993935	99994173	1683	239	5519	3789	3836	3550	7.041841004184101	1.08056338028169
chr6	LIN28B-AS1	104940837	104940978	0	142	69	5056	69	4914	0.0	0.014041514041514042
chr6	POPDC3	105161424	105161794	0	371	0	2285	0	1914	0.0	0.0
chr6	LINC02532	106787258	106787281	0	24	17855	11311	17855	11287	0.0	1.5819083901833968
chr6	LINC02532	106787258	106787481	0	224	17855	11311	17855	11087	0.0	1.6104446649228827
chr6	LINC02532	106787282	106787481	0	200	17855	11311	17855	11111	0.0	1.6069660696606967
chr6	CD24	106975133	106975367	765	235	762	1798	-3	1563	3.25531914893617	-0.0019193857965451055
chr6	SNX3	108260759	108260824	0	66	10784	1833	10784	1767	0.0	6.102999434069043
chr6	CD164	109381503	109381708	0	206	1466	6868	1466	6662	0.0	0.22005403782647853
chr6	MICAL1	109455610	109455717	0	108	7794	5222	7794	5114	0.0	1.5240516229956982
chr6	WASF1	110179438	110179839	561	402	168	3135	-393	2733	1.3955223880597014	-0.1437980241492865
chr6	SLC22A16	110456537	110456898	324	362	7510	2809	7186	2447	0.8950276243093923	2.936657131181038
chr6	SLC22A16	110476257	110476314	0	58	7510	2809	7510	2751	0.0	2.7299163940385314
chr6	TRAF3IP2	111566997	111567048	0	52	18262	7884	18262	7832	0.0	2.3317160367722165
chr6	TRAF3IP2	111566997	111567110	0	114	18262	7884	18262	7770	0.0	2.35032175032175
chr6	TRAF3IP2	111567049	111567214	0	166	18262	7884	18262	7718	0.0	2.366157035501425
chr6	TRAF3IP2	111567049	111567110	0	62	18262	7884	18262	7822	0.0	2.3346970084377396
chr6	TRAF3IP2	111567111	111567214	0	104	18262	7884	18262	7780	0.0	2.3473007712082263
chr6	FYN	111719804	111719854	0	51	11959	6971	11959	6920	0.0	1.728179190751445
chr6	FYN	111758833	111759038	0	206	11959	6971	11959	6765	0.0	1.7677753141167776
chr6	LINC02527	111908925	111908948	0	24	0	1146	0	1122	0.0	0.0
chr6	LAMA4	112189109	112189129	0	21	851	11935	851	11914	0.0	0.07142857142857142
chr6	LAMA4	112254441	112254457	0	17	851	11935	851	11918	0.0	0.07140459808692734
chr6	LAMA4	112254441	112254594	47	154	851	11935	804	11781	0.3051948051948052	0.06824548001018589
chr6	LAMA4	112150435	112150509	867	75	851	11935	-16	11860	11.56	-0.0013490725126475548
chr6	LAMA4	112254401	112254457	0	57	851	11935	851	11878	0.0	0.07164505809058765
chr6	LAMA4	112254401	112254440	0	40	851	11935	851	11895	0.0	0.07154266498528794
chr6	LINC02541	113627469	113627519	0	51	51	2418	51	2367	0.0	0.021546261089987327
chr6	HDAC2	113970254	113970478	0	225	1989	12521	1989	12296	0.0	0.16175992192582953
chr6	GPRC6A	116806369	116806893	0	525	102	2914	102	2389	0.0	0.04269568857262453
chr6	FAM184A	118961760	118961927	98	168	1644	7735	1546	7567	0.5833333333333334	0.20430818025637637
chr6	RNF217-AS1	124648252	124648582	0	331	102	11186	102	10855	0.0	0.009396591432519577
chr6	ECHDC1	127342960	127343334	0	375	0	5138	0	4763	0.0	0.0
chr6	ECHDC1	127326997	127327000	0	4	0	5138	0	5134	0.0	0.0
chr6	KIAA0408	127446407	127446870	0	464	1020	8707	1020	8243	0.0	0.12374135630231711
chr6	AL096711.2	127475292	127475300	0	9	1336	11476	1336	11467	0.0	0.11650824103950466
chr6	SOGA3	127518533	127518577	0	45	1234	4333	1234	4288	0.0	0.28777985074626866
chr6	AL355581.1	130142683	130142750	0	68	0	3172	0	3104	0.0	0.0
chr6	AL355581.1	130137635	130137943	0	309	0	3172	0	2863	0.0	0.0
chr6	SAMD3	130215796	130215882	0	87	66	6681	66	6594	0.0	0.010009099181073703
chr6	EPB41L2	130858130	130858134	0	5	45	10058	45	10053	0.0	0.004476275738585497
chr6	EPB41L2	131063141	131063153	0	13	45	10058	45	10045	0.0	0.004479840716774514
chr6	EPB41L2	130869562	130869810	0	249	45	10058	45	9809	0.0	0.004587623610969518
chr6	VNN2	132752460	132752671	0	212	102	2606	102	2394	0.0	0.042606516290726815
chr6	TARID	133568189	133568192	0	4	0	8097	0	8093	0.0	0.0
chr6	SGK1	134317391	134317813	0	423	0	6257	0	5834	0.0	0.0
chr6	CT69	134447933	134447934	0	2	306	3481	306	3479	0.0	0.08795630928427708
chr6	AL078590.2	134539898	134540087	1	190	431	3122	430	2932	0.005263157894736842	0.1466575716234652
chr6	ALDH8A1	134929053	134929094	0	42	51	2824	51	2782	0.0	0.01833213515456506
chr6	HBS1L	135026853	135027065	0	213	0	10065	0	9852	0.0	0.0
chr6	AHI1	135495312	135495537	0	226	48565	8731	48565	8505	0.0	5.7101704879482655
chr6	MTFR2	136249975	136250262	0	288	513	2171	513	1883	0.0	0.272437599575146
chr6	NHEG1	136990053	136990060	0	8	510	1360	510	1352	0.0	0.3772189349112426
chr6	IFNGR1	137218671	137218982	0	312	8577	2945	8577	2633	0.0	3.257500949487277
chr6	IFNGR1	137218671	137219241	0	571	8577	2945	8577	2374	0.0	3.612889637742207
chr6	IFNGR1	137218671	137219092	0	422	8577	2945	8577	2523	0.0	3.399524375743163
chr6	REPS1	138926400	138929975	561	3576	1246	6039	685	2463	0.1568791946308725	0.2781161185546082
chr6	LINC01625	139474501	139474564	0	64	3820	7136	3820	7072	0.0	0.540158371040724
chr6	PHACTR2-AS1	143561166	143561828	0	663	0	2119	0	1456	0.0	0.0
chr6	PLAGL1	143960468	143960471	0	4	1173	8363	1173	8359	0.0	0.1403277904055509
chr6	PLAGL1	143964786	143966156	0	1371	1173	8363	1173	6992	0.0	0.16776315789473684
chr6	PLAGL1	143965849	143966156	0	308	1173	8363	1173	8055	0.0	0.14562383612662944
chr6	PLAGL1	143965107	143965178	0	72	1173	8363	1173	8291	0.0	0.14147871185622965
chr6	PLAGL1	144064450	144064466	0	17	1173	8363	1173	8346	0.0	0.14054636951833213
chr6	EPM2A	145735197	145735243	0	47	0	17587	0	17540	0.0	0.0
chr6	EPM2A	145671238	145671263	0	26	0	17587	0	17561	0.0	0.0
chr6	EPM2A	145686899	145686919	0	21	0	17587	0	17566	0.0	0.0
chr6	EPM2A	145686843	145686898	0	56	0	17587	0	17531	0.0	0.0
chr6	EPM2A	145686843	145686919	0	77	0	17587	0	17510	0.0	0.0
chr6	SHPRH	145963730	145964155	0	426	3736	17722	3736	17296	0.0	0.2160037002775208
chr6	SHPRH	145933049	145933055	0	7	3736	17722	3736	17715	0.0	0.21089472198701664
chr6	SHPRH	145934905	145934905	0	1	3736	17722	3736	17721	0.0	0.21082331696856837
chr6	STXBP5-AS1	146844282	146844317	0	36	683	11664	683	11628	0.0	0.058737530099759204
chr6	RAET1E	149889884	149889989	33	106	3804	3011	3771	2905	0.3113207547169811	1.2981067125645438
chr6	RMND1	151436419	151436444	0	26	1072083	4190	1072083	4164	0.0	257.46469740634006
chr6	SYNE1	152354658	152354723	0	66	534	42788	534	42722	0.0	0.012499414821403492
chr6	SYNE1	152352026	152352166	0	141	534	42788	534	42647	0.0	0.012521396581236664
chr6	SYNE1	152135025	152135102	0	78	534	42788	534	42710	0.0	0.012502926715055021
chr6	LINC02840	152759979	152759980	0	2	0	8955	0	8953	0.0	0.0
chr6	MTRF1L	152995243	152995261	0	19	0	4304	0	4285	0.0	0.0
chr6	MTRF1L	152995135	152995242	0	108	0	4304	0	4196	0.0	0.0
chr6	MTRF1L	152995135	152995261	0	127	0	4304	0	4177	0.0	0.0
chr6	IPCEF1	154247069	154247189	0	121	51	3968	51	3847	0.0	0.013257083441642838
chr6	SOD2	159692530	159692659	6104	130	28748	6793	22644	6663	46.95384615384615	3.3984691580369204
chr6	SOD2	159727128	159727264	0	137	28748	6793	28748	6656	0.0	4.319110576923077
chr6	LPAL2	160482661	160482686	10766	26	886038	4767	875272	4741	414.0769230769231	184.61759122547986
chr6	LPAL2	160477128	160477128	1	1	886038	4767	886037	4766	1.0	185.90788921527485
chr6	AL391361.2	160918401	160918435	0	35	0	897	0	862	0.0	0.0
chr6	PACRG-AS3	163187672	163190906	0	3235	204	8368	204	5133	0.0	0.03974284044418469
chr6	PACRG-AS3	163191880	163191948	0	69	204	8368	204	8299	0.0	0.024581274852391855
chr6	AL031121.2	163346352	163346377	0	26	0	7004	0	6978	0.0	0.0
chr6	AL031121.2	163340754	163343106	0	2353	0	7004	0	4651	0.0	0.0
chr6	TBXT	166168327	166168581	0	255	0	2612	0	2357	0.0	0.0
chr6	RNASET2	166948565	166948568	0	4	483	14460	483	14456	0.0	0.03341173215273935
chr6	RNASET2	166956948	166957124	0	177	483	14460	483	14283	0.0	0.033816425120772944
chr6	TCP10L3	167376970	167377953	2907	984	23875	8397	20968	7413	2.9542682926829267	2.8285444489410496
chr6	TCP10L3	167384165	167384379	0	215	23875	8397	23875	8182	0.0	2.9179907113175263
chr6	TCP10L3	167376545	167377953	4983	1409	23875	8397	18892	6988	3.5365507452093685	2.703491700057241
chr6	KIF25-AS1	167996205	167996236	0	32	0	3093	0	3061	0.0	0.0
chr6	FRMD1	168064870	168064903	0	34	0	7718	0	7684	0.0	0.0
chr6	THBS2	169248416	169248455	0	40	2550	5550	2550	5510	0.0	0.4627949183303085
chr6	THBS2	169237609	169237623	0	15	2550	5550	2550	5535	0.0	0.46070460704607047
chr6	THBS2	169221419	169221428	0	10	2550	5550	2550	5540	0.0	0.4602888086642599
chr7	AC093627.4	150133	152547	42266	2415	143313	3520	101047	1105	17.50144927536232	91.44524886877828
chr7	HRAT92	522704	523316	0	613	0	1853	0	1240	0.0	0.0
chr7	ZFAND2A-DT	1160624	1163495	1500	2872	897	2348	-603	-524	0.5222841225626741	1.150763358778626
chr7	ZFAND2A-DT	1163208	1163217	0	10	897	2348	897	2338	0.0	0.38366124893071
chr7	PSMG3-AS1	1570280	1570533	2934	254	7766	5168	4832	4914	11.551181102362206	0.9833129833129833
chr7	NUDT1	2242976	2243048	12	73	5928	2013	5916	1940	0.1643835616438356	3.049484536082474
chr7	CHST12	2403646	2403673	11	28	145519	3713	145508	3685	0.39285714285714285	39.48656716417911
chr7	RNF216P1	4985076	4985130	0	55	1139	3552	1139	3497	0.0	0.32570774949957104
chr7	RNF216P1	4993814	4995582	44	1769	1139	3552	1095	1783	0.0248728094968909	0.6141334828939988
chr7	OR10AH1P	5116773	5116783	0	11	10845	3539	10845	3528	0.0	3.0739795918367347
chr7	WIPI2	5229706	5229738	0	33	22245	7716	22245	7683	0.0	2.89535337758688
chr7	FSCN1	5594821	5594896	0	76	1296	3567	1296	3491	0.0	0.37124033228301345
chr7	ZDHHC4	6577499	6577720	0	222	0	3565	0	3343	0.0	0.0
chr7	ZDHHC4	6578721	6578746	0	26	0	3565	0	3539	0.0	0.0
chr7	RSPH10B2	6754175	6754509	845	335	50333	4899	49488	4564	2.5223880597014925	10.843120070113935
chr7	RSPH10B2	6764085	6764101	0	17	50333	4899	50333	4882	0.0	10.309913969684555
chr7	RSPH10B2	6781477	6781574	634	98	50333	4899	49699	4801	6.469387755102041	10.351801707977504
chr7	MIOS	7567073	7567484	0	412	25795	6728	25795	6316	0.0	4.0840721975934136
chr7	UMAD1	7868534	7868608	0	75	2546	3764	2546	3689	0.0	0.6901599349417187
chr7	GLCCI1	8060110	8060248	0	139	174	6051	174	5912	0.0	0.02943166441136671
chr7	AC007128.2	8303797	8304155	0	359	102	919	102	560	0.0	0.18214285714285713
chr7	TMEM106B	12211426	12211547	0	122	0	13848	0	13726	0.0	0.0
chr7	AC011287.1	13717897	13718235	0	339	8	12535	8	12196	0.0	0.0006559527714004591
chr7	AC011287.1	13718236	13719907	0	1672	8	12535	8	10863	0.0	0.0007364448126668507
chr7	AC011287.1	13717897	13719907	0	2011	8	12535	8	10524	0.0	0.0007601672367920942
chr7	CRPPA-AS1	16237353	16237410	0	58	0	2784	0	2726	0.0	0.0
chr7	BZW2	16646289	16646304	0	16	9881	3675	9881	3659	0.0	2.7004646078163432
chr7	HDAC9	18591637	18591642	0	6	782	16740	782	16734	0.0	0.046731205928050676
chr7	HDAC9	18495855	18496023	0	169	782	16740	782	16571	0.0	0.04719087562609378
chr7	AC099342.1	20296760	20296818	0	59	0	2149	0	2090	0.0	0.0
chr7	AC099342.1	20298398	20298466	0	69	0	2149	0	2080	0.0	0.0
chr7	DNAH11	21616293	21616307	0	15	76	16261	76	16246	0.0	0.004678074602979195
chr7	SNHG26	22858796	22858830	138	35	152555	5723	152417	5688	3.942857142857143	26.796237693389592
chr7	SNHG26	22858831	22858976	714	146	152555	5723	151841	5577	4.890410958904109	27.226286533978843
chr7	SNHG26	22858796	22858976	852	181	152555	5723	151703	5542	4.707182320441989	27.37333092746301
chr7	NUP42	23197231	23197247	0	17	6885	3660	6885	3643	0.0	1.8899258852594016
chr7	GPNMB	23236759	23236823	1407	65	9312	5924	7905	5859	21.646153846153847	1.3492063492063493
chr7	FAM221A	23688324	23688987	0	664	1331	5529	1331	4865	0.0	0.2735868448098664
chr7	STK31	23710336	23710770	0	435	22765	5113	22765	4678	0.0	4.866395895681915
chr7	STK31	23710743	23710770	0	28	22765	5113	22765	5085	0.0	4.476892822025565
chr7	STK31	23710739	23710770	0	32	22765	5113	22765	5081	0.0	4.48041724070065
chr7	STK31	23710336	23710742	0	407	22765	5113	22765	4706	0.0	4.837441563960901
chr7	STK31	23710739	23710742	0	4	22765	5113	22765	5109	0.0	4.455862203953807
chr7	CBX3	26201827	26202609	2244	783	14902	4587	12658	3804	2.8659003831417627	3.3275499474237646
chr7	SNX10	26292087	26292133	0	47	2755	3619	2755	3572	0.0	0.7712765957446809
chr7	AC004540.1	26398739	26399021	0	283	477	6357	477	6074	0.0	0.07853144550543299
chr7	HOXA-AS2	27115572	27116343	0	772	1908	4914	1908	4142	0.0	0.4606470304200869
chr7	HOXA-AS2	27123639	27124610	51	972	1908	4914	1857	3942	0.05246913580246913	0.4710806697108067
chr7	HOXA11-AS	27185604	27185632	0	29	204	3018	204	2989	0.0	0.06825025092004015
chr7	HOXA11-AS	27185633	27186263	0	631	204	3018	204	2387	0.0	0.0854629241726016
chr7	EVX1	27243403	27243457	0	55	0	3173	0	3118	0.0	0.0
chr7	TAX1BP1	27816395	27816520	0	126	26589	9188	26589	9062	0.0	2.9341205032001767
chr7	JAZF1-AS1	28217345	28217349	0	5	0	4249	0	4244	0.0	0.0
chr7	CHN2	29480222	29480356	0	135	54	6384	54	6249	0.0	0.008641382621219395
chr7	AC006978.2	30411955	30412073	3130	119	12185	670	9055	551	26.30252100840336	16.433756805807622
chr7	LINC01176	30403023	30403180	0	158	5662	981	5662	823	0.0	6.879708383961118
chr7	GARS1	30594953	30595143	1233	191	127003	11228	125770	11037	6.455497382198953	11.395306695660052
chr7	GARS1	30631542	30631559	294	18	127003	11228	126709	11210	16.333333333333332	11.30321141837645
chr7	GARS1	30601201	30601224	1378	24	127003	11228	125625	11204	57.416666666666664	11.212513388075687
chr7	GARS1	30594940	30594952	0	13	127003	11228	127003	11215	0.0	11.32438698172091
chr7	AQP1	30923609	30923653	0	45	12888	3284	12888	3239	0.0	3.979005866008027
chr7	AQP1	30921625	30921838	2288	214	12888	3284	10600	3070	10.69158878504673	3.452768729641694
chr7	GHRHR	30972096	30972141	0	46	647	3152	647	3106	0.0	0.20830650354153252
chr7	ITPRID1	31577991	31578434	0	444	326	7265	326	6821	0.0	0.04779357865415628
chr7	ITPRID1	31514121	31514205	0	85	326	7265	326	7180	0.0	0.04540389972144847
chr7	BBS9	33152852	33152855	0	4	6982	8800	6982	8796	0.0	0.7937698954070032
chr7	BBS9	33129553	33130041	1938	489	6982	8800	5044	8311	3.96319018404908	0.6069065094453134
chr7	BBS9	33129682	33130041	1463	360	6982	8800	5519	8440	4.063888888888889	0.6539099526066351
chr7	AC018647.1	35716869	35717128	1071	260	15970	6731	14899	6471	4.119230769230769	2.30242620924123
chr7	SEPTIN7	35832894	35832900	0	7	32142	11676	32142	11669	0.0	2.754477675893393
chr7	AC083864.2	36001448	36001701	0	254	0	1141	0	887	0.0	0.0
chr7	AC083864.3	36095377	36095498	0	122	0	2590	0	2468	0.0	0.0
chr7	ANLN	36406567	36406570	56	4	14132	5237	14076	5233	14.0	2.6898528568698645
chr7	NME8	37849057	37849123	0	67	229	2400	229	2333	0.0	0.09815687955422203
chr7	LINC00265	39781886	39781896	0	11	5202	6805	5202	6794	0.0	0.7656755961142184
chr7	MRPL32	42935137	42937241	5789	2105	30802	3362	25013	1257	2.7501187648456056	19.898965791567225
chr7	UBE2D4	43943032	43943103	3314	72	55691	4694	52377	4622	46.02777777777778	11.33210731285158
chr7	DBNL	44052942	44052951	264	10	73320	12166	73056	12156	26.4	6.009871668311945
chr7	DBNL	44044821	44044866	940	46	73320	12166	72380	12120	20.434782608695652	5.971947194719472
chr7	DBNL	44044843	44044866	612	24	73320	12166	72708	12142	25.5	5.988140339318069
chr7	DBNL	44044821	44044842	328	22	73320	12166	72992	12144	14.909090909090908	6.010540184453228
chr7	AEBP1	44111631	44111772	1577	142	166796	4990	165219	4848	11.105633802816902	34.07982673267327
chr7	ZMIZ2	44761906	44761918	0	13	11588	6855	11588	6842	0.0	1.693656825489623
chr7	PPIA	44798815	44798904	7343	90	570720	5460	563377	5370	81.58888888888889	104.91191806331472
chr7	PPIA	44797622	44798006	7150	385	570720	5460	563570	5075	18.571428571428573	111.04827586206896
chr7	CCM2	45027267	45027797	2094	531	12818	7220	10724	6689	3.943502824858757	1.6032291822394977
chr7	RAMP3	45183409	45183420	0	12	102	1431	102	1419	0.0	0.07188160676532769
chr7	UPP1	48101871	48101982	0	112	204	4559	204	4447	0.0	0.04587362266696649
chr7	ABCA13	48234152	48234227	0	76	74	19141	74	19065	0.0	0.003881458169420404
chr7	ABCA13	48507957	48508049	0	93	74	19141	74	19048	0.0	0.0038849223015539687
chr7	IKZF1	50304115	50304359	0	245	0	10578	0	10333	0.0	0.0
chr7	NIPSNAP2	55965151	55965209	7	59	5693	3190	5686	3131	0.11864406779661017	1.8160332162248483
chr7	SUMF2	56074640	56074736	11	97	56386	3936	56375	3839	0.1134020618556701	14.684813753581661
chr7	SUMF2	56068639	56068647	0	9	56386	3936	56386	3927	0.0	14.358543417366947
chr7	AC237221.1	57404370	57404434	0	65	0	4007	0	3942	0.0	0.0
chr7	AC237221.1	57407551	57407558	0	8	0	4007	0	3999	0.0	0.0
chr7	AC006455.5	63349549	63351014	0	1466	0	2294	0	828	0.0	0.0
chr7	ZNF273	64903367	64903419	0	53	452	8661	452	8608	0.0	0.0525092936802974
chr7	AC073210.3	64947858	64947955	0	98	0	1180	0	1082	0.0	0.0
chr7	CRCP	66114915	66114970	0	56	55628	3326	55628	3270	0.0	17.011620795107035
chr7	GS1-124K5.4	66494022	66494025	0	4	51	1212	51	1208	0.0	0.042218543046357616
chr7	GS1-124K5.4	66494026	66494364	0	339	51	1212	51	873	0.0	0.058419243986254296
chr7	GS1-124K5.4	66494022	66494364	0	343	51	1212	51	869	0.0	0.05868814729574223
chr7	GS1-124K5.4	66494213	66494364	0	152	51	1212	51	1060	0.0	0.048113207547169815
chr7	GS1-124K5.4	66494026	66494212	0	187	51	1212	51	1025	0.0	0.04975609756097561
chr7	GS1-124K5.4	66494022	66494212	0	191	51	1212	51	1021	0.0	0.04995102840352596
chr7	KCTD7	66638392	66638431	0	40	10236	3297	10236	3257	0.0	3.142769419711391
chr7	KCTD7	66638930	66639228	0	299	10236	3297	10236	2998	0.0	3.4142761841227487
chr7	TMEM248	66930715	66930868	0	154	102	5095	102	4941	0.0	0.020643594414086218
chr7	AUTS2	70766335	70766355	0	21	2648	24173	2648	24152	0.0	0.1096389532957933
chr7	AUTS2	70777175	70777217	0	43	2648	24173	2648	24130	0.0	0.10973891421467054
chr7	SBDSP1	72829784	72829976	8178	193	16984	1244	8806	1051	42.373056994818654	8.378686964795433
chr7	FKBP6	73328315	73328485	3	171	204	4736	201	4565	0.017543859649122806	0.04403066812705367
chr7	FKBP6	73329450	73329834	0	385	204	4736	204	4351	0.0	0.04688577338542864
chr7	BUD23	73683805	73683923	0	119	7144	5292	7144	5173	0.0	1.3810168180939493
chr7	BUD23	73683902	73683923	0	22	7144	5292	7144	5270	0.0	1.355597722960152
chr7	BUD23	73683805	73683901	0	97	7144	5292	7144	5195	0.0	1.3751684311838306
chr7	BUD23	73683924	73684000	0	77	7144	5292	7144	5215	0.0	1.369894534995206
chr7	BUD23	73683805	73684000	0	196	7144	5292	7144	5096	0.0	1.401883830455259
chr7	BUD23	73683902	73684000	0	99	7144	5292	7144	5193	0.0	1.3756980550741382
chr7	ELN	74056358	74056435	0	78	1129	6338	1129	6260	0.0	0.1803514376996805
chr7	ELN	74035415	74035688	102	274	1129	6338	1027	6064	0.3722627737226277	0.16936015831134565
chr7	ELN	74060502	74060600	0	99	1129	6338	1129	6239	0.0	0.18095848693700914
chr7	EIF4H	74194879	74195059	0	181	47241	4839	47241	4658	0.0	10.141906397595534
chr7	LAT2	74214918	74215010	78	93	4986	4561	4908	4468	0.8387096774193549	1.098478066248881
chr7	LAT2	74214941	74215010	78	70	4986	4561	4908	4491	1.1142857142857143	1.0928523714094855
chr7	LAT2	74216835	74216864	0	30	4986	4561	4986	4531	0.0	1.100419333480468
chr7	LAT2	74215011	74215099	225	89	4986	4561	4761	4472	2.5280898876404496	1.0646243291592128
chr7	LAT2	74214918	74215099	303	182	4986	4561	4683	4379	1.664835164835165	1.0694222425211235
chr7	LAT2	74214941	74215099	303	159	4986	4561	4683	4402	1.9056603773584906	1.0638346206269877
chr7	LAT2	74214918	74214940	0	23	4986	4561	4986	4538	0.0	1.0987219039224327
chr7	CLIP2	74386598	74386604	4	7	2272	6823	2268	6816	0.5714285714285714	0.33274647887323944
chr7	NCF1	74785262	74785299	48	38	31538	3153	31490	3115	1.263157894736842	10.109149277688603
chr7	GTF2IRD2B	75143979	75143993	1362	15	33435	6408	32073	6393	90.8	5.016893477240732
chr7	NSUN5P1	75410727	75410834	0	108	217	2136	217	2028	0.0	0.10700197238658778
chr7	NSUN5P1	75410727	75411574	51	848	217	2136	166	1288	0.060141509433962265	0.12888198757763975
chr7	NSUN5P1	75415771	75415778	0	8	217	2136	217	2128	0.0	0.10197368421052631
chr7	POR	75972462	75972764	0	303	43202	5746	43202	5443	0.0	7.937167003490722
chr7	POR	75915180	75915666	19069	487	43202	5746	24133	5259	39.15605749486653	4.588895227229512
chr7	POR	75915210	75915666	19069	457	43202	5746	24133	5289	41.72647702407002	4.562866326337682
chr7	POR	75915667	75915767	2196	101	43202	5746	41006	5645	21.742574257425744	7.264127546501329
chr7	POR	75980489	75980722	2283	234	43202	5746	40919	5512	9.756410256410257	7.423621190130624
chr7	POR	75968129	75968277	0	149	43202	5746	43202	5597	0.0	7.718777916741112
chr7	HSPB1	76303845	76303865	0	21	0	1152	0	1131	0.0	0.0
chr7	HSPB1	76303866	76303888	0	23	0	1152	0	1129	0.0	0.0
chr7	HSPB1	76303845	76303888	0	44	0	1152	0	1108	0.0	0.0
chr7	HSPB1	76303883	76303888	0	6	0	1152	0	1146	0.0	0.0
chr7	HSPB1	76303077	76303080	0	4	0	1152	0	1148	0.0	0.0
chr7	HSPB1	76303077	76303111	0	35	0	1152	0	1117	0.0	0.0
chr7	HSPB1	76303866	76303882	0	17	0	1152	0	1135	0.0	0.0
chr7	HSPB1	76303845	76303882	0	38	0	1152	0	1114	0.0	0.0
chr7	HSPB1	76303657	76303727	0	71	0	1152	0	1081	0.0	0.0
chr7	CCDC146	77286856	77286926	18	71	48415	4481	48397	4410	0.2535211267605634	10.974376417233561
chr7	MAGI2-AS3	79454245	79455007	0	763	0	16832	0	16069	0.0	0.0
chr7	MAGI2-AS3	79455008	79458730	0	3723	0	16832	0	13109	0.0	0.0
chr7	MAGI2-AS3	79456181	79458730	0	2550	0	16832	0	14282	0.0	0.0
chr7	MAGI2-AS3	79455375	79458730	0	3356	0	16832	0	13476	0.0	0.0
chr7	MAGI2-AS3	79455008	79455374	0	367	0	16832	0	16465	0.0	0.0
chr7	MAGI2-AS3	79454245	79455374	0	1130	0	16832	0	15702	0.0	0.0
chr7	GNAI1	80135274	80135278	0	5	102	23932	102	23927	0.0	0.004262966523174656
chr7	GNAI1	80134569	80134588	0	20	102	23932	102	23912	0.0	0.00426564068250251
chr7	GNAI1	80134049	80134068	0	20	102	23932	102	23912	0.0	0.00426564068250251
chr7	GRM3	86644873	86644971	0	99	19283	4481	19283	4382	0.0	4.400502053856687
chr7	DMTF1	87163287	87163332	0	46	0	7275	0	7229	0.0	0.0
chr7	DMTF1	87152556	87152795	0	240	0	7275	0	7035	0.0	0.0
chr7	DBF4	87878134	87878225	0	92	320	4607	320	4515	0.0	0.07087486157253599
chr7	ADAM22	88179043	88179129	0	87	0	12235	0	12148	0.0	0.0
chr7	CFAP69	90262051	90262056	0	6	561	4519	561	4513	0.0	0.12430755594947929
chr7	CFAP69	90268331	90268384	0	54	561	4519	561	4465	0.0	0.12564389697648376
chr7	CLDN12	90412050	90412061	0	12	0	6484	0	6472	0.0	0.0
chr7	CLDN12	90405609	90405612	0	4	0	6484	0	6480	0.0	0.0
chr7	CLDN12	90469932	90469953	0	22	0	6484	0	6462	0.0	0.0
chr7	CDK14	90709396	90709610	0	215	248	6964	248	6749	0.0	0.036746184619943695
chr7	CDK14	90709611	90709957	0	347	248	6964	248	6617	0.0	0.03747922019041862
chr7	AC079760.2	91496602	91496646	0	45	768	2663	768	2618	0.0	0.293353705118411
chr7	AKAP9	92070183	92070206	0	24	262565	18331	262565	18307	0.0	14.342328071229584
chr7	RBM48	92528925	92529183	0	259	2091	6833	2091	6574	0.0	0.31807118953452995
chr7	CDK6-AS1	92854954	92854999	0	46	0	671	0	625	0.0	0.0
chr7	VPS50	93239935	93239950	464	16	4654	9328	4190	9312	29.0	0.44995704467353953
chr7	PEG10	94656581	94656591	0	11	0	3432	0	3421	0.0	0.0
chr7	PPP1R9A	95284217	95284330	0	114	153	11218	153	11104	0.0	0.013778818443804035
chr7	DYNC1I1	95804363	95804374	0	12	10847	4540	10847	4528	0.0	2.3955388692579507
chr7	TRRAP	98983460	98983492	0	33	966981	20054	966981	20021	0.0	48.29833674641626
chr7	ARPC1B	99377440	99377455	0	16	0	3642	0	3626	0.0	0.0
chr7	BUD31	99409005	99409245	51	241	204	2378	153	2137	0.21161825726141079	0.07159569489939167
chr7	ZNF655	99559008	99559017	0	10	3254	7216	3254	7206	0.0	0.4515681376630586
chr7	ZNF655	99559018	99559021	0	4	3254	7216	3254	7212	0.0	0.4511924570160843
chr7	ZNF655	99559008	99559021	0	14	3254	7216	3254	7202	0.0	0.45181893918356014
chr7	TMEM225B	99598373	99598381	0	9	0	1436	0	1427	0.0	0.0
chr7	ZSCAN25	99616990	99617016	0	27	270865	5715	270865	5688	0.0	47.62042897327707
chr7	ZSCAN25	99619994	99619997	28	4	270865	5715	270837	5711	7.0	47.423743652600244
chr7	CYP3A43	99847602	99847659	0	58	427	2652	427	2594	0.0	0.1646106399383192
chr7	CYP3A43	99847615	99847659	0	45	427	2652	427	2607	0.0	0.1637897967011891
chr7	CYP3A43	99847602	99847614	0	13	427	2652	427	2639	0.0	0.16180371352785147
chr7	COPS6	100089054	100089066	0	13	1284	2424	1284	2411	0.0	0.53255910410618
chr7	COPS6	100091308	100091330	18	23	1284	2424	1266	2401	0.782608695652174	0.5272802998750521
chr7	AP4M1	100102747	100102781	0	35	0	4601	0	4566	0.0	0.0
chr7	AP4M1	100101969	100101989	0	21	0	4601	0	4580	0.0	0.0
chr7	MBLAC1	100127065	100127133	0	69	41	1297	41	1228	0.0	0.033387622149837134
chr7	LAMTOR4	100149566	100149579	0	14	3842	1452	3842	1438	0.0	2.6717663421418636
chr7	STAG3	100177906	100177972	0	67	80708	8611	80708	8544	0.0	9.446161048689138
chr7	STAG3	100177906	100178005	38	100	80708	8611	80670	8511	0.38	9.478322171307719
chr7	STAG3	100177973	100178005	38	33	80708	8611	80670	8578	1.1515151515151516	9.40429004429937
chr7	STAG3	100177973	100178062	102	90	80708	8611	80606	8521	1.1333333333333333	9.459687830066894
chr7	STAG3	100178006	100178062	64	57	80708	8611	80644	8554	1.1228070175438596	9.42763619359364
chr7	STAG3L5P	100336221	100336337	0	117	456	2779	456	2662	0.0	0.17129977460555973
chr7	PILRB	100353484	100354012	0	529	102	3977	102	3448	0.0	0.029582366589327145
chr7	PILRB	100356884	100356938	0	55	102	3977	102	3922	0.0	0.026007139214686385
chr7	FBXO24	100590316	100590357	0	42	0	3344	0	3302	0.0	0.0
chr7	FBXO24	100592861	100593017	0	157	0	3344	0	3187	0.0	0.0
chr7	FBXO24	100589644	100589793	0	150	0	3344	0	3194	0.0	0.0
chr7	PCOLCE	100604189	100604217	0	29	0	2816	0	2787	0.0	0.0
chr7	ZAN	100792480	100792544	0	65	248129	8919	248129	8854	0.0	28.02450869663429
chr7	SLC12A9	100852836	100852839	20	4	1283128	7409	1283108	7405	5.0	173.27589466576637
chr7	SRRT	100885763	100885774	165	12	494088	4638	493923	4626	13.75	106.77107652399481
chr7	PRKRIP1	102364207	102364411	0	205	6871	3465	6871	3260	0.0	2.1076687116564417
chr7	LRWD1	102465161	102465178	0	18	4604	2902	4604	2884	0.0	1.596393897364771
chr7	FAM185A	102749637	102749658	0	22	1970	2732	1970	2710	0.0	0.7269372693726938
chr7	FAM185A	102749044	102749658	770	615	1970	2732	1200	2117	1.2520325203252032	0.5668398677373642
chr7	FAM185A	102749418	102749658	0	241	1970	2732	1970	2491	0.0	0.79084704937776
chr7	FAM185A	102749044	102749636	770	593	1970	2732	1200	2139	1.2984822934232716	0.5610098176718092
chr7	FAM185A	102749418	102749636	0	219	1970	2732	1970	2513	0.0	0.7839235972940708
chr7	FAM185A	102749044	102749417	770	374	1970	2732	1200	2358	2.0588235294117645	0.5089058524173028
chr7	ARMC10	103083831	103084062	0	232	102	4585	102	4353	0.0	0.02343211578221916
chr7	PMPCB	103299530	103299533	0	4	0	5146	0	5142	0.0	0.0
chr7	PMPCB	103297559	103297953	0	395	0	5146	0	4751	0.0	0.0
chr7	PSMC2	103344343	103344525	0	183	0	7122	0	6939	0.0	0.0
chr7	AC007384.1	104941671	104941745	23	75	380	2440	357	2365	0.30666666666666664	0.15095137420718815
chr7	RINT1	105536613	105536749	255	137	11000	3420	10745	3283	1.8613138686131387	3.2729211087420045
chr7	CDHR3	106001583	106001610	0	28	190585	9741	190585	9713	0.0	19.621641099557294
chr7	PIK3CG	106865351	106865426	0	76	1126	7778	1126	7702	0.0	0.14619579330044144
chr7	HBP1	107169028	107169185	0	158	8	6030	8	5872	0.0	0.0013623978201634877
chr7	DUS4L-BCAP29	107564060	107564209	0	150	365323	7282	365323	7132	0.0	51.223079080201906
chr7	DUS4L-BCAP29	107564210	107564676	122117	467	365323	7282	243206	6815	261.4925053533191	35.686867204695524
chr7	DUS4L-BCAP29	107573822	107573883	0	62	365323	7282	365323	7220	0.0	50.59875346260388
chr7	DUS4L-BCAP29	107564210	107564247	376	38	365323	7282	364947	7244	9.894736842105264	50.37921038100497
chr7	DUS4L-BCAP29	107564060	107564247	376	188	365323	7282	364947	7094	2.0	51.44446010713279
chr7	BCAP29	107580578	107580645	32301	68	461039	5519	428738	5451	475.0147058823529	78.65309117593102
chr7	ZNF277	112340918	112341046	0	129	0	4755	0	4626	0.0	0.0
chr7	AC002463.1	112622408	112622619	0	212	91636	5157	91636	4945	0.0	18.53104145601618
chr7	AC002463.1	112622589	112622619	0	31	91636	5157	91636	5126	0.0	17.87670698400312
chr7	AC002463.1	112622408	112622588	0	181	91636	5157	91636	4976	0.0	18.415594855305468
chr7	AC002463.1	112635923	112635992	0	70	91636	5157	91636	5087	0.0	18.013760566149006
chr7	CAV1	116525784	116525805	0	22	86789	3435	86789	3413	0.0	25.428948139466744
chr7	CAV1	116525093	116525805	51	713	86789	3435	86738	2722	0.07152875175315568	31.865540044085233
chr7	ST7	117209923	117209937	0	15	51	6497	51	6482	0.0	0.00786794199321197
chr7	CFTR	117627571	117627770	0	200	2221	9870	2221	9670	0.0	0.2296794208893485
chr7	PTPRZ1	122011310	122013889	0	2580	108	8512	108	5932	0.0	0.01820633850303439
chr7	PTPRZ1	122012822	122013889	0	1068	108	8512	108	7444	0.0	0.014508328855454057
chr7	AC004594.1	122328509	122328565	0	57	0	3479	0	3422	0.0	0.0
chr7	SPAM1	123925353	123925531	0	179	6	3041	6	2862	0.0	0.0020964360587002098
chr7	AC006148.1	124360199	124360252	0	54	0	17199	0	17145	0.0	0.0
chr7	AC006148.1	124376390	124376396	0	7	0	17199	0	17192	0.0	0.0
chr7	AC006148.1	124389557	124389560	0	4	0	17199	0	17195	0.0	0.0
chr7	AC006148.1	124334391	124334431	0	41	0	17199	0	17158	0.0	0.0
chr7	FSCN3	127593753	127593997	2091	245	2331	3131	240	2886	8.534693877551021	0.08316008316008316
chr7	HILPDA	128455910	128456023	1866	114	6171	2072	4305	1958	16.36842105263158	2.1986721144024517
chr7	FAM71F2	128683256	128683309	80	54	1104	3056	1024	3002	1.4814814814814814	0.34110592938041306
chr7	FAM71F1	128714075	128714132	0	58	51	2436	51	2378	0.0	0.02144659377628259
chr7	FAM71F1	128714010	128714132	0	123	51	2436	51	2313	0.0	0.02204928664072633
chr7	FAM71F1	128714010	128714074	0	65	51	2436	51	2371	0.0	0.021509911429776464
chr7	CCDC136	128801474	128801509	0	36	53458	6127	53458	6091	0.0	8.776555573797406
chr7	IRF5	128937695	128937834	0	140	1077	4365	1077	4225	0.0	0.2549112426035503
chr7	IRF5	128946007	128946034	0	28	1077	4365	1077	4337	0.0	0.24832833756052572
chr7	IRF5	128941392	128941424	0	33	1077	4365	1077	4332	0.0	0.24861495844875348
chr7	CPA4	130304567	130304579	0	13	0	3971	0	3958	0.0	0.0
chr7	CPA5	130345206	130345330	0	125	7470	2962	7470	2837	0.0	2.6330630948184703
chr7	CPA5	130345897	130345909	0	13	7470	2962	7470	2949	0.0	2.533062054933876
chr7	CPA5	130345206	130345896	0	691	7470	2962	7470	2271	0.0	3.2892998678996035
chr7	MEST	130486396	130486519	0	124	0	4491	0	4367	0.0	0.0
chr7	CALD1	134933391	134934077	0	687	3978	9452	3978	8765	0.0	0.45385054192812324
chr7	STRA8	135245330	135245527	0	198	7329	1267	7329	1069	0.0	6.855940130963518
chr7	NUP205	135606211	135606226	0	16	234194	7667	234194	7651	0.0	30.609593517187296
chr7	CHRM2	136869118	136869173	0	56	627	8329	627	8273	0.0	0.07578871026229904
chr7	TRIM24	138554865	138554966	510	102	35330	9323	34820	9221	5.0	3.7761631059538012
chr7	TTC26	139134722	139134792	0	71	581	5017	581	4946	0.0	0.11746866154468256
chr7	FMC1	139340600	139340619	0	20	96	1292	96	1272	0.0	0.07547169811320754
chr7	TBXAS1	139875638	139875666	0	29	3843	6297	3843	6268	0.0	0.6131142310146778
chr7	AGK	141614179	141614582	0	404	358	9243	358	8839	0.0	0.0405023192668854
chr7	AGK	141551435	141551499	0	65	358	9243	358	9178	0.0	0.03900631945957725
chr7	SSBP1	141738411	141738593	0	183	51	4961	51	4778	0.0	0.010673922143156132
chr7	SSBP1	141738504	141738593	0	90	51	4961	51	4871	0.0	0.01047012933689181
chr7	SSBP1	141738576	141738593	0	18	51	4961	51	4943	0.0	0.010317620878009305
chr7	SSBP1	141738411	141738503	0	93	51	4961	51	4868	0.0	0.01047658175842235
chr7	SSBP1	141738411	141738575	0	165	51	4961	51	4796	0.0	0.010633861551292744
chr7	SSBP1	141738504	141738575	0	72	51	4961	51	4889	0.0	0.010431581100429535
chr7	SSBP1	141738679	141738944	14	266	51	4961	37	4695	0.05263157894736842	0.007880724174653887
chr7	SSBP1	141738679	141738998	51	320	51	4961	0	4641	0.159375	0.0
chr7	SSBP1	141738945	141738998	37	54	51	4961	14	4907	0.6851851851851852	0.0028530670470756064
chr7	PRSS1	142752551	142752567	0	17	0	1218	0	1201	0.0	0.0
chr7	PRSS2	142774039	142774055	0	17	0	1266	0	1249	0.0	0.0
chr7	GSTK1	143265093	143265296	0	204	423	3842	423	3638	0.0	0.11627267729521715
chr7	TMEM139	143284975	143284998	0	24	1326	2569	1326	2545	0.0	0.5210216110019646
chr7	TMEM139	143284975	143285445	0	471	1326	2569	1326	2098	0.0	0.6320305052430887
chr7	ZYX	143381410	143381779	0	370	0	3134	0	2764	0.0	0.0
chr7	EPHA1-AS1	143407887	143407890	0	4	102	5322	102	5318	0.0	0.01918014291086875
chr7	ARHGEF5	144362854	144365823	0	2970	46	5833	46	2863	0.0	0.01606706252183025
chr7	CUL1	148698260	148698278	0	19	20100	4022	20100	4003	0.0	5.021234074444167
chr7	CUL1	148698713	148698763	0	51	20100	4022	20100	3971	0.0	5.061697305464619
chr7	ZNF398	149154318	149154340	0	23	86791	6316	86791	6293	0.0	13.791673287780073
chr7	ZNF212	149239803	149240056	969	254	20782	3185	19813	2931	3.8149606299212597	6.7598089389286935
chr7	ZNF783	149293843	149294016	0	174	1489	6739	1489	6565	0.0	0.22680883472962682
chr7	ZNF783	149294902	149295183	0	282	1489	6739	1489	6457	0.0	0.23060244695679108
chr7	AC004890.2	149290039	149290083	0	45	935	4299	935	4254	0.0	0.21979313587212035
chr7	KRBA1	149730569	149730713	0	145	0	5309	0	5164	0.0	0.0
chr7	ZNF862	149838462	149838635	0	174	169	8432	169	8258	0.0	0.020465003632840883
chr7	ATP6V0E2	149878747	149878790	0	44	0	6761	0	6717	0.0	0.0
chr7	AC092666.1	150040655	150040715	802	61	7134	5281	6332	5220	13.147540983606557	1.2130268199233716
chr7	AC092666.1	150040655	150040910	1122	256	7134	5281	6012	5025	4.3828125	1.1964179104477612
chr7	AC092666.1	150040716	150040910	320	195	7134	5281	6814	5086	1.641025641025641	1.3397561934722768
chr7	AC092666.1	150042623	150043239	0	617	7134	5281	7134	4664	0.0	1.5295883361921099
chr7	REPIN1	150368942	150369033	0	92	153	4590	153	4498	0.0	0.034015117830146734
chr7	REPIN1	150369014	150369033	0	20	153	4590	153	4570	0.0	0.03347921225382932
chr7	REPIN1	150368942	150369013	0	72	153	4590	153	4518	0.0	0.03386454183266932
chr7	AC073111.3	150407864	150408488	190	625	408	4340	218	3715	0.304	0.058681022880215344
chr7	GIMAP4	150569960	150570001	0	42	0	2102	0	2060	0.0	0.0
chr7	GIMAP4	150567438	150567520	0	83	0	2102	0	2019	0.0	0.0
chr7	TMEM176A	150800829	150800968	496	140	11121	2191	10625	2051	3.5428571428571427	5.180399804973184
chr7	TMEM176A	150801567	150801724	3459	158	11121	2191	7662	2033	21.89240506329114	3.7688145597638956
chr7	TMEM176A	150804473	150804485	0	13	11121	2191	11121	2178	0.0	5.106060606060606
chr7	ABCB8	151044147	151044221	0	75	140171	9139	140171	9064	0.0	15.464585172109444
chr7	ABCB8	151028853	151028911	0	59	140171	9139	140171	9080	0.0	15.437334801762114
chr7	ABCB8	151040635	151040644	20	10	140171	9139	140151	9129	2.0	15.35228393033191
chr7	ASIC3	151052238	151052474	0	237	27069	2756	27069	2519	0.0	10.745930924970226
chr7	SLC4A2	151058712	151059188	1785	477	204335	6826	202550	6349	3.742138364779874	31.902661836509687
chr7	SLC4A2	151074100	151074293	23254	194	204335	6826	181081	6632	119.8659793814433	27.30413148371532
chr7	SLC4A2	151061271	151061521	51	251	204335	6826	204284	6575	0.20318725099601595	31.06980988593156
chr7	SLC4A2	151062664	151063189	3417	526	204335	6826	200918	6300	6.496197718631179	31.89174603174603
chr7	AGAP3	151087073	151087204	0	132	306	10457	306	10325	0.0	0.02963680387409201
chr7	AGAP3	151120568	151120745	0	178	306	10457	306	10279	0.0	0.02976943282420469
chr7	CHPF2	151232815	151234274	51	1460	51	4210	0	2750	0.03493150684931507	0.0
chr7	NUB1	151374202	151374243	0	42	562	5427	562	5385	0.0	0.10436397400185701
chr7	NUB1	151341847	151341965	0	119	562	5427	562	5308	0.0	0.10587792012057272
chr7	GALNTL5	151956457	151956609	0	153	414	3335	414	3182	0.0	0.13010685103708358
chr7	FABP5P3	152437029	152437124	129	96	231	1353	102	1257	1.34375	0.081145584725537
chr7	PAXIP1-AS2	154944399	154944620	0	222	153	6944	153	6722	0.0	0.02276108301100863
chr7	INSIG1	155297960	155298027	0	68	0	3328	0	3260	0.0	0.0
chr7	RNF32	156640956	156641004	0	49	3429	4235	3429	4186	0.0	0.8191591017677974
chr7	RNF32	156640812	156641004	0	193	3429	4235	3429	4042	0.0	0.8483424047501237
chr7	RNF32	156640812	156640955	0	144	3429	4235	3429	4091	0.0	0.8381813737472501
chr7	DNAJB6	157337145	157337150	0	6	2601	10917	2601	10911	0.0	0.23838328292548805
chr7	DNAJB6	157410002	157415529	2550	5528	2601	10917	51	5389	0.46128798842257596	0.00946372239747634
chr7	DNAJB6	157337629	157337811	0	183	2601	10917	2601	10734	0.0	0.24231414197875908
chr7	AC006372.1	157501516	157501936	0	421	0	1692	0	1271	0.0	0.0
chr7	AC093627.5	149306	149327	0	22	105236	4819	105236	4797	0.0	21.937877840316865
chr7	PRKAR1B	712847	712920	0	74	1694	4510	1694	4436	0.0	0.3818755635707845
chr7	PRKAR1B	712921	713053	1173	133	1694	4510	521	4377	8.819548872180452	0.1190312999771533
chr7	C7ORF50	1138188	1138216	0	29	5370	4970	5370	4941	0.0	1.0868245294474803
chr7	C7ORF50	1137314	1138187	3213	874	5370	4970	2157	4096	3.6762013729977117	0.526611328125
chr7	C7ORF50	1137314	1138216	3213	903	5370	4970	2157	4067	3.558139534883721	0.530366363412835
chr7	INTS1	1472242	1472271	0	30	39649	8865	39649	8835	0.0	4.487719298245614
chr7	TMEM184A	1555956	1556112	0	157	7166	4053	7166	3896	0.0	1.8393223819301847
chr7	AC074389.1	1694178	1694258	0	81	0	1217	0	1136	0.0	0.0
chr7	GNA12	2762591	2763074	11379	484	19771	5912	8392	5428	23.510330578512395	1.5460574797347089
chr7	RSPH10B	5943225	5943322	0	98	30874	5015	30874	4917	0.0	6.2790319300386415
chr7	RSPH10B	5960690	5960706	40	17	30874	5015	30834	4998	2.3529411764705883	6.169267707082833
chr7	RSPH10B	5970282	5970616	991	335	30874	5015	29883	4680	2.9582089552238804	6.38525641025641
chr7	CYTH3	6170531	6170533	21	3	13337	5824	13316	5821	7.0	2.2875794537021132
chr7	FAM220A	6348572	6348824	102	253	357	2397	255	2144	0.4031620553359684	0.11893656716417911
chr7	DAGLB	6416258	6416625	357	368	26976	5365	26619	4997	0.970108695652174	5.326996197718631
chr7	ZNF12	6697684	6697687	76	4	121432	5328	121356	5324	19.0	22.794139744552968
chr7	RPA3	7640319	7640721	357	403	1202	3101	845	2698	0.8858560794044665	0.31319495922905854
chr7	ICA1	8138839	8138841	0	3	21696	4842	21696	4839	0.0	4.483570985740855
chr7	ICA1	8236805	8236808	0	4	21696	4842	21696	4838	0.0	4.4844977263331955
chr7	AC004852.2	9189559	9189575	0	17	0	3367	0	3350	0.0	0.0
chr7	VWDE	12353814	12354348	0	535	3	6744	3	6209	0.0	0.00048316959252697695
chr7	ETV1	13989267	13989561	0	295	484	9310	484	9015	0.0	0.053688297282307264
chr7	DGKB	14757654	14757688	0	35	51	9521	51	9486	0.0	0.005376344086021506
chr7	ANKMY2	16644625	16644683	0	59	827	2863	827	2804	0.0	0.2949358059914408
chr7	AGR2	16804934	16804951	0	18	51	2720	51	2702	0.0	0.018874907475943746
chr7	AGR2	16794850	16794934	0	85	51	2720	51	2635	0.0	0.01935483870967742
chr7	AC019117.1	17457339	17457457	0	119	110	3525	110	3406	0.0	0.03229594832648268
chr7	AC019117.1	17457333	17457457	0	125	110	3525	110	3400	0.0	0.03235294117647059
chr7	AC019117.1	17457333	17457338	0	6	110	3525	110	3519	0.0	0.0312588803637397
chr7	AC019117.1	17456677	17456680	0	4	110	3525	110	3521	0.0	0.031241124680488497
chr7	AC019117.1	17457319	17457457	0	139	110	3525	110	3386	0.0	0.032486709982279975
chr7	AC019117.1	17457319	17457338	0	20	110	3525	110	3505	0.0	0.03138373751783167
chr7	AC019117.1	17457319	17457332	0	14	110	3525	110	3511	0.0	0.031330105383081744
chr7	TMEM196	19772549	19773565	0	1017	0	3555	0	2538	0.0	0.0
chr7	TMEM196	19772549	19773100	0	552	0	3555	0	3003	0.0	0.0
chr7	AC005062.1	19968136	19968152	0	17	45	3126	45	3109	0.0	0.014474107430041815
chr7	FAM126A	22946951	22947031	216	81	47076	7672	46860	7591	2.6666666666666665	6.173099723356606
chr7	KLHL7-DT	23105552	23105557	0	6	51	3587	51	3581	0.0	0.014241831890533371
chr7	IGF2BP3	23347599	23347647	3705	49	126079	8233	122374	8184	75.61224489795919	14.952834799608993
chr7	TRA2A	23522131	23522352	2664	222	25245	3350	22581	3128	12.0	7.218989769820972
chr7	OSBPL3	24834086	24834484	0	399	34494	8114	34494	7715	0.0	4.471030460142579
chr7	OSBPL3	24917956	24918045	0	90	34494	8114	34494	8024	0.0	4.298853439680957
chr7	CYCS	25124995	25125198	153	204	5263	5795	5110	5591	0.75	0.9139688785548202
chr7	C7ORF31	25179661	25180068	0	408	4131	3683	4131	3275	0.0	1.2613740458015268
chr7	C7ORF31	25179661	25179969	0	309	4131	3683	4131	3374	0.0	1.2243627741553054
chr7	C7ORF31	25179970	25180068	0	99	4131	3683	4131	3584	0.0	1.1526227678571428
chr7	HNRNPA2B1	26193574	26193597	0	24	1337	8930	1337	8906	0.0	0.15012351223894005
chr7	HNRNPA2B1	26190992	26192493	622	1502	1337	8930	715	7428	0.4141145139813582	0.0962574044157243
chr7	HNRNPA2B1	26173593	26174669	0	1077	1337	8930	1337	7853	0.0	0.17025340634152553
chr7	HNRNPA2B1	26190992	26191054	0	63	1337	8930	1337	8867	0.0	0.15078380512010828
chr7	HNRNPA2B1	26191421	26192299	357	879	1337	8930	980	8051	0.4061433447098976	0.12172400943982115
chr7	HOXA9	27165140	27165143	0	4	0	2899	0	2895	0.0	0.0
chr7	HOXA9	27165108	27165139	0	32	0	2899	0	2867	0.0	0.0
chr7	HOXA9	27165108	27165143	0	36	0	2899	0	2863	0.0	0.0
chr7	EVX1-AS	27242467	27242628	0	162	0	1205	0	1043	0.0	0.0
chr7	CPVL	29146340	29146427	0	88	0	3356	0	3268	0.0	0.0
chr7	SCRN1	29989942	29990180	1275	239	2341	6059	1066	5820	5.334728033472803	0.1831615120274914
chr7	NOD1	30446966	30447013	0	48	11994	6096	11994	6048	0.0	1.9831349206349207
chr7	GARS1-DT	30563722	30563729	0	8	50780	12139	50780	12131	0.0	4.185969829362789
chr7	PDE1C	32070978	32071204	0	227	22527	14157	22527	13930	0.0	1.6171572146446518
chr7	LSM5	32490130	32490318	0	189	0	4281	0	4092	0.0	0.0
chr7	LSM5	32490024	32490318	0	295	0	4281	0	3986	0.0	0.0
chr7	LSM5	32490024	32490129	0	106	0	4281	0	4175	0.0	0.0
chr7	LSM5	32494990	32495228	0	239	0	4281	0	4042	0.0	0.0
chr7	KBTBD2	32879434	32879699	213	266	6635	2943	6422	2677	0.8007518796992481	2.3989540530444526
chr7	DPY19L2P1	35106040	35106042	0	3	9964	7663	9964	7660	0.0	1.3007832898172325
chr7	DPY19L2P1	35141023	35141031	0	9	9964	7663	9964	7654	0.0	1.3018029788345964
chr7	DPY19L2P1	35141848	35141880	0	33	9964	7663	9964	7630	0.0	1.3058977719528178
chr7	SEPTIN7-DT	35800485	35800516	0	32	478	4118	478	4086	0.0	0.11698482623592756
chr7	KIAA0895	36366915	36367109	102	195	6796	4862	6694	4667	0.5230769230769231	1.4343261195628885
chr7	KIAA0895	36366703	36366914	0	212	6796	4862	6796	4650	0.0	1.461505376344086
chr7	KIAA0895	36366703	36367109	102	407	6796	4862	6694	4455	0.25061425061425063	1.5025813692480359
chr7	ELMO1	37448674	37448858	0	185	57	9599	57	9414	0.0	0.006054811982154238
chr7	GLI3	42151234	42152351	0	1118	3268	13825	3268	12707	0.0	0.2571810812937751
chr7	AC010132.3	42911914	42912096	0	183	4840	3926	4840	3743	0.0	1.2930804167779855
chr7	AC010132.3	42911914	42912057	0	144	4840	3926	4840	3782	0.0	1.2797461660497091
chr7	AC010132.3	42912097	42912222	51	126	4840	3926	4789	3800	0.40476190476190477	1.2602631578947368
chr7	AC010132.3	42912058	42912096	0	39	4840	3926	4840	3887	0.0	1.2451762284538204
chr7	AC010132.3	42912058	42912222	51	165	4840	3926	4789	3761	0.3090909090909091	1.2733315607551183
chr7	AC010132.3	42911914	42912222	51	309	4840	3926	4789	3617	0.1650485436893204	1.324025435443738
chr7	COA1	43650492	43650610	432	119	227059	11833	226627	11714	3.630252100840336	19.34667918729725
chr7	RASA4CP	44033932	44034010	731	79	86609	4067	85878	3988	9.253164556962025	21.53410230692076
chr7	RASA4CP	44033932	44034174	1267	243	86609	4067	85342	3824	5.2139917695473255	22.317468619246863
chr7	RASA4CP	44034011	44034174	536	164	86609	4067	86073	3903	3.268292682926829	22.05303612605688
chr7	POLM	44078739	44078754	109	16	24049	4453	23940	4437	6.8125	5.395537525354969
chr7	POLM	44074130	44074396	10	267	24049	4453	24039	4186	0.03745318352059925	5.7427138079311995
chr7	POLM	44078553	44078738	1286	186	24049	4453	22763	4267	6.913978494623656	5.334661354581673
chr7	POLM	44078553	44078754	1395	202	24049	4453	22654	4251	6.905940594059406	5.329099035521054
chr7	MYL7	44139421	44139519	0	99	33	1463	33	1364	0.0	0.024193548387096774
chr7	DDX56	44572562	44572572	0	11	669	3948	669	3937	0.0	0.16992633985267971
chr7	DDX56	44569983	44570013	0	31	669	3948	669	3917	0.0	0.1707939749808527
chr7	MYO1G	44968919	44969411	0	493	88	8668	88	8175	0.0	0.010764525993883792
chr7	MYO1G	44975475	44975482	0	8	88	8668	88	8660	0.0	0.010161662817551964
chr7	SNHG15	44985881	44986019	0	139	0	3016	0	2877	0.0	0.0
chr7	SNHG15	44984356	44986019	0	1664	0	3016	0	1352	0.0	0.0
chr7	TBRG4	45108826	45108930	480	105	76990	5038	76510	4933	4.571428571428571	15.509831745388201
chr7	TBRG4	45111642	45111662	194	21	76990	5038	76796	5017	9.238095238095237	15.307155670719553
chr7	TBRG4	45111663	45111875	1224	213	76990	5038	75766	4825	5.746478873239437	15.70279792746114
chr7	TBRG4	45102280	45102345	0	66	76990	5038	76990	4972	0.0	15.484714400643604
chr7	IGFBP3	45920719	45920736	0	18	0	4277	0	4259	0.0	0.0
chr7	HUS1	47979409	47979466	0	58	0	2928	0	2870	0.0	0.0
chr7	HUS1	47979409	47979419	0	11	0	2928	0	2917	0.0	0.0
chr7	HUS1	47979420	47979466	0	47	0	2928	0	2881	0.0	0.0
chr7	SUN3	48007152	48007163	0	12	11847	1742	11847	1730	0.0	6.847976878612717
chr7	ZPBP	50092862	50093066	0	205	0	2640	0	2435	0.0	0.0
chr7	FIGNL1	50449555	50449561	0	7	0	1093	0	1086	0.0	0.0
chr7	FIGNL1	50449555	50449577	0	23	0	1093	0	1070	0.0	0.0
chr7	FIGNL1	50449562	50449577	0	16	0	1093	0	1077	0.0	0.0
chr7	FIGNL1	50449117	50449554	0	438	0	1093	0	655	0.0	0.0
chr7	FIGNL1	50449117	50449561	0	445	0	1093	0	648	0.0	0.0
chr7	FIGNL1	50449117	50449577	0	461	0	1093	0	632	0.0	0.0
chr7	FIGNL1	50449117	50449543	0	427	0	1093	0	666	0.0	0.0
chr7	FIGNL1	50449117	50449498	0	382	0	1093	0	711	0.0	0.0
chr7	FIGNL1	50449544	50449554	0	11	0	1093	0	1082	0.0	0.0
chr7	FIGNL1	50449544	50449561	0	18	0	1093	0	1075	0.0	0.0
chr7	FIGNL1	50449544	50449577	0	34	0	1093	0	1059	0.0	0.0
chr7	FIGNL1	50449499	50449554	0	56	0	1093	0	1037	0.0	0.0
chr7	FIGNL1	50449499	50449561	0	63	0	1093	0	1030	0.0	0.0
chr7	FIGNL1	50449499	50449577	0	79	0	1093	0	1014	0.0	0.0
chr7	FIGNL1	50449499	50449543	0	45	0	1093	0	1048	0.0	0.0
chr7	LINC01446	53811507	53811658	0	152	0	7300	0	7148	0.0	0.0
chr7	SEC61G	54759157	54759160	0	4	0	1847	0	1843	0.0	0.0
chr7	SEC61G	54759037	54759160	0	124	0	1847	0	1723	0.0	0.0
chr7	SEC61G	54759037	54759156	0	120	0	1847	0	1727	0.0	0.0
chr7	VOPP1	55537500	55537557	0	58	71485	5361	71485	5303	0.0	13.480105600603432
chr7	PSPH	56051137	56051312	0	176	160693	2748	160693	2572	0.0	62.47783825816485
chr7	AC092447.4	56482094	56482282	0	189	0	2681	0	2492	0.0	0.0
chr7	AC092447.4	56482974	56483711	0	738	0	2681	0	1943	0.0	0.0
chr7	AC092447.5	56537856	56538047	0	192	51	4893	51	4701	0.0	0.010848755583918315
chr7	GUSB	65979726	65979832	0	107	1598	3830	1598	3723	0.0	0.4292237442922374
chr7	GUSB	65979385	65979397	52	13	1598	3830	1546	3817	4.0	0.40503012837306784
chr7	AC006001.3	66573384	66573387	0	4	13688	5901	13688	5897	0.0	2.321180261149737
chr7	AC006001.3	66542085	66542501	0	417	13688	5901	13688	5484	0.0	2.4959883296863605
chr7	GTF2IRD1P1	66832269	66832398	0	130	1771	3191	1771	3061	0.0	0.5785690950669716
chr7	GTF2IRD1P1	66844589	66844674	0	86	1771	3191	1771	3105	0.0	0.5703703703703704
chr7	SBDS	66994211	66994218	0	8	0	1720	0	1712	0.0	0.0
chr7	STAG3L3	73005575	73005691	0	117	429	3267	429	3150	0.0	0.1361904761904762
chr7	TBL2	73573937	73573959	0	23	148	4171	148	4148	0.0	0.03567984570877531
chr7	TBL2	73577972	73578244	0	273	148	4171	148	3898	0.0	0.03796818881477681
chr7	TBL2	73578245	73578288	0	44	148	4171	148	4127	0.0	0.03586140053307487
chr7	TBL2	73578245	73578283	0	39	148	4171	148	4132	0.0	0.03581800580832527
chr7	TBL2	73578284	73578288	0	5	148	4171	148	4166	0.0	0.035525684109457514
chr7	TBL2	73577972	73578288	0	317	148	4171	148	3854	0.0	0.038401660612350806
chr7	TBL2	73577972	73578283	0	312	148	4171	148	3859	0.0	0.038351904638507385
chr7	MLXIPL	73607135	73607329	8005	195	67917	4671	59912	4476	41.05128205128205	13.385165326184094
chr7	STX1A	73702729	73702843	0	115	6951	3703	6951	3588	0.0	1.9372909698996656
chr7	ABHD11	73738327	73738331	0	5	286	2293	286	2288	0.0	0.125
chr7	RFC2	74237288	74237360	2954	73	6726	2224	3772	2151	40.465753424657535	1.7536029753602975
chr7	STAG3L2	74890270	74890386	0	117	648	2335	648	2218	0.0	0.2921550946798918
chr7	PMS2P3	75527564	75527769	0	206	5260	1455	5260	1249	0.0	4.211369095276221
chr7	PMS2P3	75527564	75528104	0	541	5260	1455	5260	914	0.0	5.75492341356674
chr7	STYXL1	76047661	76047810	51	150	5727	1888	5676	1738	0.34	3.2658227848101267
chr7	APTR	77695895	77696170	0	276	153	5920	153	5644	0.0	0.02710843373493976
chr7	MAGI2	78194873	78194878	0	6	284	25254	284	25248	0.0	0.011248415716096324
chr7	AC004862.1	80373811	80373814	198	4	129213	3489	129015	3485	49.5	37.020086083213776
chr7	AC004862.1	80383902	80384046	908	145	129213	3489	128305	3344	6.2620689655172415	38.36872009569378
chr7	AC008163.1	81586879	81586945	225	67	22673	5496	22448	5429	3.3582089552238807	4.134831460674158
chr7	PCLO	82847138	82847145	0	8	654	21068	654	21060	0.0	0.031054131054131053
chr7	ELAPOR2	86965808	86965812	0	5	0	7850	0	7845	0.0	0.0
chr7	AC005076.1	87151749	87152300	102	552	102	910	0	358	0.18478260869565216	0.0
chr7	TMEM243	87220216	87220359	0	144	0	3277	0	3133	0.0	0.0
chr7	TP53TG1	87345042	87345303	0	262	0	5876	0	5614	0.0	0.0
chr7	TP53TG1	87345042	87345232	0	191	0	5876	0	5685	0.0	0.0
chr7	TP53TG1	87341354	87341521	0	168	0	5876	0	5708	0.0	0.0
chr7	TP53TG1	87345233	87345303	0	71	0	5876	0	5805	0.0	0.0
chr7	AC002456.1	90595727	90595731	0	5	0	620	0	615	0.0	0.0
chr7	MTERF1	91880642	91880655	0	14	51422	4878	51422	4864	0.0	10.571957236842104
chr7	MTERF1	91880054	91880655	0	602	51422	4878	51422	4276	0.0	12.025724976613658
chr7	KRIT1	92235402	92235532	18209	131	208648	5947	190439	5816	139.0	32.74398211829436
chr7	KRIT1	92245789	92245904	0	116	208648	5947	208648	5831	0.0	35.7825415880638
chr7	LRRD1	92178971	92179005	0	35	121453	4457	121453	4422	0.0	27.465626413387607
chr7	KRIT1	92245426	92245463	0	38	208648	5947	208648	5909	0.0	35.31020477238111
chr7	KRIT1	92245789	92245842	0	54	208648	5947	208648	5893	0.0	35.40607500424232
chr7	KRIT1	92245789	92245820	0	32	208648	5947	208648	5915	0.0	35.27438715131023
chr7	KRIT1	92245464	92245788	0	325	208648	5947	208648	5622	0.0	37.112771255780864
chr7	KRIT1	92245464	92245904	0	441	208648	5947	208648	5506	0.0	37.8946603705049
chr7	KRIT1	92245426	92245788	0	363	208648	5947	208648	5584	0.0	37.365329512893986
chr7	KRIT1	92245843	92245904	0	62	208648	5947	208648	5885	0.0	35.45420560747664
chr7	KRIT1	92245821	92245842	0	22	208648	5947	208648	5925	0.0	35.21485232067511
chr7	KRIT1	92245821	92245904	0	84	208648	5947	208648	5863	0.0	35.587242026266416
chr7	KRIT1	92245464	92245842	0	379	208648	5947	208648	5568	0.0	37.47270114942529
chr7	KRIT1	92245464	92245820	0	357	208648	5947	208648	5590	0.0	37.3252236135957
chr7	PEX1	92489713	92489717	0	5	1034	7210	1034	7205	0.0	0.1435114503816794
chr7	FAM133B	92566009	92566012	0	4	89	4492	89	4488	0.0	0.019830659536541888
chr7	FAM133B	92589859	92589874	0	16	89	4492	89	4476	0.0	0.019883824843610367
chr7	SAMD9L	93146882	93147086	0	205	0	2461	0	2256	0.0	0.0
chr7	TFPI2	93889016	93889033	0	18	0	2212	0	2194	0.0	0.0
chr7	SGCE	94587777	94588687	0	911	695	11980	695	11069	0.0	0.06278796639262806
chr7	SGCE	94597748	94597928	0	181	695	11980	695	11799	0.0	0.058903296889566914
chr7	SGCE	94597748	94597922	0	175	695	11980	695	11805	0.0	0.058873358746293944
chr7	SGCE	94622515	94622544	0	30	695	11980	695	11950	0.0	0.05815899581589958
chr7	SGCE	94597923	94597928	0	6	695	11980	695	11974	0.0	0.05804242525471855
chr7	PON2	95409900	95409952	0	53	153	3559	153	3506	0.0	0.043639475185396466
chr7	PON2	95416171	95416240	0	70	153	3559	153	3489	0.0	0.043852106620808254
chr7	DLX6-AS1	96978346	96979488	0	1143	459	16178	459	15035	0.0	0.0305287662121716
chr7	DLX6-AS1	96978346	96979082	0	737	459	16178	459	15441	0.0	0.029726054012045852
chr7	DLX6-AS1	97003276	97003507	0	232	459	16178	459	15946	0.0	0.028784648187633263
chr7	DLX6-AS1	97011824	97012179	0	356	459	16178	459	15822	0.0	0.02901023890784983
chr7	DLX6-AS1	96979083	96979488	0	406	459	16178	459	15772	0.0	0.029102206441795588
chr7	ASNS	97871718	97872039	0	322	18578	4867	18578	4545	0.0	4.0875687568756875
chr7	ASNS	97871680	97871717	0	38	18578	4867	18578	4829	0.0	3.847173327811141
chr7	TECPR1	98251393	98251417	0	25	0	8184	0	8159	0.0	0.0
chr7	TECPR1	98251789	98251899	0	111	0	8184	0	8073	0.0	0.0
chr7	PTCD1	99438550	99438565	0	16	0	5697	0	5681	0.0	0.0
chr7	PTCD1	99438566	99438690	0	125	0	5697	0	5572	0.0	0.0
chr7	ATP5MF	99466110	99466127	0	18	0	2117	0	2099	0.0	0.0
chr7	ZNF3	100077228	100077301	0	74	194299	5432	194299	5358	0.0	36.26334453154162
chr7	TAF6	100113615	100113678	0	64	120	3852	120	3788	0.0	0.03167898627243928
chr7	TAF6	100114053	100114082	0	30	120	3852	120	3822	0.0	0.03139717425431711
chr7	TAF6	100119203	100119327	0	125	120	3852	120	3727	0.0	0.03219747786423397
chr7	TAF6	100118879	100119202	0	324	120	3852	120	3528	0.0	0.034013605442176874
chr7	TAF6	100118879	100119327	0	449	120	3852	120	3403	0.0	0.03526300323244196
chr7	TAF6	100119203	100119230	0	28	120	3852	120	3824	0.0	0.03138075313807531
chr7	MAP11	100158088	100158587	408	500	8804	2975	8396	2475	0.816	3.3923232323232324
chr7	MAP11	100157292	100157371	0	80	8804	2975	8804	2895	0.0	3.041105354058722
chr7	CASTOR3	100212952	100213045	923	94	43848	4870	42925	4776	9.819148936170214	8.987646566164154
chr7	PMS2P1	100335674	100335836	0	163	0	5373	0	5210	0.0	0.0
chr7	PMS2P1	100335656	100335673	0	18	0	5373	0	5355	0.0	0.0
chr7	PMS2P1	100335656	100335836	0	181	0	5373	0	5192	0.0	0.0
chr7	PMS2P1	100334971	100335204	204	234	0	5373	-204	5139	0.8717948717948718	-0.0396964389959136
chr7	ZCWPW1	100419001	100419109	50	109	267160	3336	267110	3227	0.45871559633027525	82.77347381468857
chr7	PCOLCE-AS1	100603837	100604002	0	166	0	3274	0	3108	0.0	0.0
chr7	EPHB4	100817191	100817260	90	70	973180	6454	973090	6384	1.2857142857142858	152.42637844611528
chr7	ACHE	100892333	100892685	215	353	31893	3736	31678	3383	0.6090651558073654	9.363878214602424
chr7	PLOD3	101216162	101216195	0	34	51	5401	51	5367	0.0	0.009502515371716043
chr7	PLOD3	101211540	101211589	0	50	51	5401	51	5351	0.0	0.009530928798355447
chr7	FIS1	101244897	101244958	0	62	0	1800	0	1738	0.0	0.0
chr7	POLR2J	102478807	102478809	0	3	152	1356	152	1353	0.0	0.1123429416112343
chr7	RASA4B	102517543	102517644	0	102	284	7327	284	7225	0.0	0.03930795847750865
chr7	RASA4	102594446	102594490	0	45	0	8099	0	8054	0.0	0.0
chr7	RASA4	102616522	102616623	0	102	0	8099	0	7997	0.0	0.0
chr7	NAPEPLD	103148810	103149042	0	233	51	6140	51	5907	0.0	0.008633824276282377
chr7	NAPEPLD	103148810	103148921	0	112	51	6140	51	6028	0.0	0.008460517584605176
chr7	NAPEPLD	103148922	103149042	0	121	51	6140	51	6019	0.0	0.008473168300382123
chr7	DPY19L2P2	103274069	103275538	0	1470	51	5606	51	4136	0.0	0.012330754352030947
chr7	DPY19L2P2	103279832	103280136	51	305	51	5606	0	5301	0.16721311475409836	0.0
chr7	ORC5	104202376	104202409	0	34	106	3741	106	3707	0.0	0.028594550849743727
chr7	PUS7	105470687	105470759	0	73	135	4451	135	4378	0.0	0.03083599817268159
chr7	SYPL1	106092547	106092562	0	16	0	2483	0	2467	0.0	0.0
chr7	AC004917.1	106572947	106572962	0	16	25	2096	25	2080	0.0	0.01201923076923077
chr7	SLC26A4-AS1	107654610	107654642	0	33	204	8534	204	8501	0.0	0.02399717680272909
chr7	AC002467.1	107743932	107744057	0	126	0	3959	0	3833	0.0	0.0
chr7	SLC26A3	107803110	107803120	0	11	0	3403	0	3392	0.0	0.0
chr7	LAMB1	108001998	108002125	0	128	51	15924	51	15796	0.0	0.0032286654849328945
chr7	LAMB1	108001946	108001997	0	52	51	15924	51	15872	0.0	0.0032132056451612905
chr7	LAMB1	108001946	108002125	0	180	51	15924	51	15744	0.0	0.0032393292682926828
chr7	LAMB1	107975229	107975232	0	4	51	15924	51	15920	0.0	0.0032035175879396986
chr7	PNPLA8	108487758	108487943	0	186	0	5688	0	5502	0.0	0.0
chr7	PNPLA8	108526028	108526048	0	21	0	5688	0	5667	0.0	0.0
chr7	THAP5	108565829	108565950	0	122	0	5062	0	4940	0.0	0.0
chr7	IMMP2L	111562443	111562462	0	20	0	3465	0	3445	0.0	0.0
chr7	SMIM30	113118439	113118526	0	88	0	1844	0	1756	0.0	0.0
chr7	AC073130.2	116243841	116243876	0	36	720	922	720	886	0.0	0.8126410835214447
chr7	COMETT	116573440	116573545	0	106	0	1698	0	1592	0.0	0.0
chr7	CTTNBP2	117791127	117791289	0	163	51	6668	51	6505	0.0	0.007840122982321292
chr7	TSPAN12	120858203	120858232	0	30	0	3274	0	3244	0.0	0.0
chr7	TSPAN12	120857038	120857084	0	47	0	3274	0	3227	0.0	0.0
chr7	FAM3C	121396161	121396297	0	137	206	3406	206	3269	0.0	0.06301621290914652
chr7	AASS	122098744	122098747	0	4	0	6223	0	6219	0.0	0.0
chr7	IQUB	123532375	123532787	0	413	0	4300	0	3887	0.0	0.0
chr7	NDUFA5	123557624	123557773	0	150	408	7705	408	7555	0.0	0.05400397088021178
chr7	NDUFA5	123557403	123557623	0	221	408	7705	408	7484	0.0	0.05451630144307857
chr7	NDUFA5	123546582	123546656	0	75	408	7705	408	7630	0.0	0.05347313237221494
chr7	NDUFA5	123544729	123544733	0	5	408	7705	408	7700	0.0	0.052987012987012985
chr7	POT1	124858956	124859044	0	89	0	8237	0	8148	0.0	0.0
chr7	POT1	124823796	124823969	0	174	0	8237	0	8063	0.0	0.0
chr7	POT1	124929558	124929792	0	235	0	8237	0	8002	0.0	0.0
chr7	POT1	124929457	124929792	0	336	0	8237	0	7901	0.0	0.0
chr7	POT1	124929457	124929557	0	101	0	8237	0	8136	0.0	0.0
chr7	POT1	124827200	124827212	0	13	0	8237	0	8224	0.0	0.0
chr7	GRM8	126446070	126446124	0	55	306	6186	306	6131	0.0	0.04991029195889741
chr7	ZNF800	127392157	127392257	0	101	152307	5296	152307	5195	0.0	29.317998075072186
chr7	ZNF800	127392157	127392546	0	390	152307	5296	152307	4906	0.0	31.04504688136975
chr7	ZNF800	127392059	127392156	0	98	152307	5296	152307	5198	0.0	29.301077337437476
chr7	ZNF800	127392059	127392257	0	199	152307	5296	152307	5097	0.0	29.881695114773397
chr7	ZNF800	127392059	127392546	0	488	152307	5296	152307	4808	0.0	31.677828618968388
chr7	ZNF800	127392059	127392063	0	5	152307	5296	152307	5291	0.0	28.786051786051786
chr7	PRRT4	128361305	128361559	2128	255	2536	3551	408	3296	8.345098039215687	0.12378640776699029
chr7	IMPDH1	128400816	128400830	0	15	1343013	3677	1343013	3662	0.0	366.7430365920262
chr7	KCP	128874295	128874314	0	20	7674	12575	7674	12555	0.0	0.6112305854241338
chr7	KCP	128869622	128869954	0	333	7674	12575	7674	12242	0.0	0.6268583564776997
chr7	UBE2H	129880878	129880893	0	16	69967	6527	69967	6511	0.0	10.745968361234834
chr7	TMEM209	130204966	130205371	0	406	0	4570	0	4164	0.0	0.0
chr7	TMEM209	130204966	130205081	0	116	0	4570	0	4454	0.0	0.0
chr7	CEP41	130404563	130404638	0	76	2981	12794	2981	12718	0.0	0.23439220003145148
chr7	CEP41	130440933	130441031	0	99	2981	12794	2981	12695	0.0	0.2348168570303269
chr7	CEP41	130400697	130400705	0	9	2981	12794	2981	12785	0.0	0.23316386390301133
chr7	CEP41	130426628	130426644	0	17	2981	12794	2981	12777	0.0	0.23330985364326523
chr7	CEP41	130440533	130440932	0	400	2981	12794	2981	12394	0.0	0.2405196062610941
chr7	COPG2	130508561	130508567	0	7	16549	4163	16549	4156	0.0	3.981953801732435
chr7	TSGA13	130686261	130686442	0	182	428	2204	428	2022	0.0	0.21167161226508407
chr7	MKLN1-AS	131324251	131324301	0	51	0	7684	0	7633	0.0	0.0
chr7	MKLN1-AS	131324251	131324299	0	49	0	7684	0	7635	0.0	0.0
chr7	MKLN1-AS	131324300	131324301	0	2	0	7684	0	7682	0.0	0.0
chr7	AKR1B1	134447460	134447978	0	519	26	3065	26	2546	0.0	0.01021209740769835
chr7	AKR1B1	134458996	134459120	0	125	26	3065	26	2940	0.0	0.008843537414965987
chr7	CYREN	135168930	135168967	0	38	4768	5206	4768	5168	0.0	0.9226006191950464
chr7	CYREN	135168748	135168929	0	182	4768	5206	4768	5024	0.0	0.9490445859872612
chr7	CYREN	135168748	135168784	0	37	4768	5206	4768	5169	0.0	0.922422131940414
chr7	CYREN	135168748	135168967	0	220	4768	5206	4768	4986	0.0	0.9562775772162053
chr7	CYREN	135170275	135170397	0	123	4768	5206	4768	5083	0.0	0.9380287231949636
chr7	CYREN	135170398	135170650	0	253	4768	5206	4768	4953	0.0	0.9626488996567737
chr7	CYREN	135168785	135168929	0	145	4768	5206	4768	5061	0.0	0.9421063031021537
chr7	CYREN	135168785	135168967	0	183	4768	5206	4768	5023	0.0	0.9492335257814055
chr7	CYREN	135168744	135168929	0	186	4768	5206	4768	5020	0.0	0.949800796812749
chr7	CYREN	135168744	135168747	0	4	4768	5206	4768	5202	0.0	0.9165705497885429
chr7	CYREN	135168744	135168784	0	41	4768	5206	4768	5165	0.0	0.9231364956437561
chr7	CYREN	135168744	135168967	0	224	4768	5206	4768	4982	0.0	0.9570453633079085
chr7	CNOT4	135410514	135410522	0	9	12728	5584	12728	5575	0.0	2.2830493273542602
chr7	FAM180A	135733645	135733675	0	31	0	2505	0	2474	0.0	0.0
chr7	AC078842.1	137354274	137354360	0	87	0	2157	0	2070	0.0	0.0
chr7	SVOPL	138659863	138663072	6368	3210	12971	3244	6603	34	1.9838006230529595	194.2058823529412
chr7	ZC3HAV1	139079103	139079468	714	366	170601	8254	169887	7888	1.9508196721311475	21.537398580121703
chr7	MKRN1	140455789	140455855	0	67	9992	5678	9992	5611	0.0	1.7807877383710569
chr7	MKRN1	140478599	140478835	0	237	9992	5678	9992	5441	0.0	1.8364271273662929
chr7	WEE2-AS1	141727496	141727552	0	57	0	5092	0	5035	0.0	0.0
chr7	KEL	142962114	142962202	50244	89	97643	3546	47399	3457	564.5393258426966	13.711021116575065
chr7	FAM131B	143358826	143358841	0	16	0	6306	0	6290	0.0	0.0
chr7	FAM131B	143362575	143362633	0	59	0	6306	0	6247	0.0	0.0
chr7	AC099548.2	143833246	143833727	0	482	0	3634	0	3152	0.0	0.0
chr7	TCAF1	143901960	143902025	0	66	51	6256	51	6190	0.0	0.008239095315024232
chr7	TCAF1	143901960	143902072	0	113	51	6256	51	6143	0.0	0.008302132508546313
chr7	TCAF1	143857073	143857098	0	26	51	6256	51	6230	0.0	0.008186195826645265
chr7	TCAF1	143902026	143902072	0	47	51	6256	51	6209	0.0	0.008213883072958608
chr7	AC074386.1	144254433	144254602	0	170	0	2197	0	2027	0.0	0.0
chr7	NOBOX	144400109	144400204	0	96	51	2124	51	2028	0.0	0.02514792899408284
chr7	EZH2	148846469	148846495	0	27	18876	4102	18876	4075	0.0	4.632147239263804
chr7	EZH2	148826453	148826467	597	15	18876	4102	18279	4087	39.8	4.472473697088329
chr7	ZNF425	149126129	149126194	714	66	714	3551	0	3485	10.818181818181818	0.0
chr7	ZNF767P	149551573	149551653	0	81	68206	4017	68206	3936	0.0	17.328760162601625
chr7	RARRES2	150341577	150341608	0	32	0	736	0	704	0.0	0.0
chr7	ATG9B	151015359	151015416	0	58	74	5653	74	5595	0.0	0.01322609472743521
chr7	FASTK	151078841	151078921	0	81	252	3292	252	3211	0.0	0.07848022422921208
chr7	TMUB1	151082763	151083081	94	319	2313	1960	2219	1641	0.2946708463949843	1.352224253503961
chr7	TMUB1	151082763	151082916	94	154	2313	1960	2219	1806	0.6103896103896104	1.2286821705426356
chr7	IQCA1L	151193196	151193289	686	94	17329	2846	16643	2752	7.297872340425532	6.047601744186046
chr7	SMARCD3	151242704	151242719	0	16	13016	4505	13016	4489	0.0	2.899532189797282
chr7	CRYGN	151437838	151437994	0	157	255	3188	255	3031	0.0	0.08413064995051138
chr7	PRKAG2	151781125	151781150	100	26	26240	14143	26140	14117	3.8461538461538463	1.8516682014592336
chr7	KMT2C	152145152	152145163	0	12	42832	18723	42832	18711	0.0	2.289134733579178
chr7	KMT2C	152180710	152182155	51	1446	42832	18723	42781	17277	0.035269709543568464	2.476182207559183
chr7	LINC01287	153411581	153411584	0	4	0	9603	0	9599	0.0	0.0
chr7	AC009403.2	155482716	155482833	0	118	3581	7213	3581	7095	0.0	0.5047216349541931
chr7	AC009403.1	155644213	155644360	0	148	0	2036	0	1888	0.0	0.0
chr7	LINC01006	156480664	156481375	86547	712	146491	11122	59944	10410	121.55477528089888	5.758309317963497
chr7	LMBR1	156833738	156833751	0	14	26429	8530	26429	8516	0.0	3.103452325035228
chr7	LMBR1	156836808	156836811	0	4	26429	8530	26429	8526	0.0	3.099812338728595
chr7	MNX1	157008527	157008996	1008	470	26154	2760	25146	2290	2.1446808510638298	10.980786026200873
chr7	VIPR2	159144297	159144719	0	423	0	4724	0	4301	0.0	0.0
chr8	MCPH1-AS1	6621344	6621421	0	78	52401	9929	52401	9851	0.0	5.319358440767434
chr8	MCPH1-AS1	6620991	6621343	0	353	52401	9929	52401	9576	0.0	5.472117794486215
chr8	MCPH1-AS1	6620991	6621421	0	431	52401	9929	52401	9498	0.0	5.517056222362602
chr8	FAM66B	7348972	7349081	0	110	0	6754	0	6644	0.0	0.0
chr8	MIR124-1HG	9900544	9900553	0	10	0	4885	0	4875	0.0	0.0
chr8	PRSS51	10498615	10498726	0	112	0	3044	0	2932	0.0	0.0
chr8	PRSS51	10496599	10496633	0	35	0	3044	0	3009	0.0	0.0
chr8	PINX1	10839707	10839736	0	30	102	2814	102	2784	0.0	0.036637931034482756
chr8	CTSB	11867969	11867999	0	31	0	8249	0	8218	0.0	0.0
chr8	CTSB	11861299	11861404	0	106	0	8249	0	8143	0.0	0.0
chr8	CTSB	11861299	11861359	0	61	0	8249	0	8188	0.0	0.0
chr8	CTSB	11868646	11868669	0	24	0	8249	0	8225	0.0	0.0
chr8	CTSB	11867253	11867968	0	716	0	8249	0	7533	0.0	0.0
chr8	CTSB	11867253	11867999	0	747	0	8249	0	7502	0.0	0.0
chr8	CTSB	11868876	11868920	0	45	0	8249	0	8204	0.0	0.0
chr8	CTSB	11861360	11861404	0	45	0	8249	0	8204	0.0	0.0
chr8	FAM86B1	12193579	12193609	0	31	0	4142	0	4111	0.0	0.0
chr8	FAM86B1	12193876	12193973	0	98	0	4142	0	4044	0.0	0.0
chr8	FAM86B1	12185233	12185374	0	142	0	4142	0	4000	0.0	0.0
chr8	FAM86B1	12186351	12186698	0	348	0	4142	0	3794	0.0	0.0
chr8	FAM86B2	12436149	12436246	0	98	51	1374	51	1276	0.0	0.039968652037617555
chr8	MTUS1	17722420	17722567	0	148	197	12042	197	11894	0.0	0.016562972927526485
chr8	ASAH1	18067219	18067248	0	30	6243	9281	6243	9251	0.0	0.6748459625986379
chr8	ASAH1	18071299	18071329	0	31	6243	9281	6243	9250	0.0	0.6749189189189189
chr8	ASAH1	18084586	18084674	0	89	6243	9281	6243	9192	0.0	0.679177545691906
chr8	ASAH1	18084586	18084670	0	85	6243	9281	6243	9196	0.0	0.678882122662027
chr8	ASAH1	18083980	18084674	0	695	6243	9281	6243	8586	0.0	0.7271139063591894
chr8	ASAH1	18083980	18084585	0	606	6243	9281	6243	8675	0.0	0.7196541786743516
chr8	ASAH1	18083980	18084285	0	306	6243	9281	6243	8975	0.0	0.6955988857938719
chr8	ASAH1	18083980	18084460	0	481	6243	9281	6243	8800	0.0	0.7094318181818182
chr8	ASAH1	18083980	18084670	0	691	6243	9281	6243	8590	0.0	0.7267753201396974
chr8	ASAH1	18084286	18084674	0	389	6243	9281	6243	8892	0.0	0.7020917678812416
chr8	ASAH1	18084286	18084585	0	300	6243	9281	6243	8981	0.0	0.695134172141187
chr8	ASAH1	18084286	18084460	0	175	6243	9281	6243	9106	0.0	0.6855919174170876
chr8	ASAH1	18084286	18084670	0	385	6243	9281	6243	8896	0.0	0.7017760791366906
chr8	ASAH1	18084461	18084674	0	214	6243	9281	6243	9067	0.0	0.6885408624682916
chr8	ASAH1	18084461	18084585	0	125	6243	9281	6243	9156	0.0	0.6818479685452162
chr8	ASAH1	18084461	18084670	0	210	6243	9281	6243	9071	0.0	0.6882372395546247
chr8	ASAH1	18083916	18083979	0	64	6243	9281	6243	9217	0.0	0.6773353585765434
chr8	ASAH1	18083916	18083939	0	24	6243	9281	6243	9257	0.0	0.6744085556875877
chr8	ASAH1	18083940	18083979	0	40	6243	9281	6243	9241	0.0	0.6755762363380586
chr8	ASAH1	18083898	18083979	0	82	6243	9281	6243	9199	0.0	0.6786607239917383
chr8	ASAH1	18083898	18083939	0	42	6243	9281	6243	9239	0.0	0.675722480787964
chr8	ASAH1	18083898	18083915	0	18	6243	9281	6243	9263	0.0	0.6739717154269675
chr8	ASAH1	18084671	18084674	0	4	6243	9281	6243	9277	0.0	0.6729546189500917
chr8	CSGALNACT1	19601991	19602400	0	410	10068	6602	10068	6192	0.0	1.625968992248062
chr8	GFRA2	21788119	21788632	256	514	748	5482	492	4968	0.4980544747081712	0.09903381642512077
chr8	REEP4	22140606	22140623	0	18	204	2273	204	2255	0.0	0.09046563192904657
chr8	ENTPD4	23441568	23441591	0	24	5545694	7070	5545694	7046	0.0	787.0698268521147
chr8	AC024958.1	24514407	24514573	0	167	19	1151	19	984	0.0	0.019308943089430895
chr8	KCTD9	25446079	25446127	0	49	0	4398	0	4349	0.0	0.0
chr8	SDAD1P1	26382310	26382386	0	77	0	3781	0	3704	0.0	0.0
chr8	PNMA2	26509547	26509599	45	53	748385	5265	748340	5212	0.8490566037735849	143.5801995395242
chr8	CHRNA2	27469760	27469804	0	45	400214	5067	400214	5022	0.0	79.69215452011152
chr8	CHRNA2	27469528	27469759	204	232	400214	5067	400010	4835	0.8793103448275862	82.7321613236815
chr8	CHRNA2	27469528	27469804	204	277	400214	5067	400010	4790	0.7364620938628159	83.50939457202506
chr8	CLU	27611109	27611144	0	36	25263	5788	25263	5752	0.0	4.392037552155772
chr8	CLU	27611074	27611144	0	71	25263	5788	25263	5717	0.0	4.418926010145181
chr8	CLU	27611074	27611108	0	35	25263	5788	25263	5753	0.0	4.391274117851555
chr8	CLU	27613577	27614171	0	595	25263	5788	25263	5193	0.0	4.864818024263432
chr8	PBK	27837651	27837708	0	58	510	2156	510	2098	0.0	0.2430886558627264
chr8	PBK	27833041	27833054	0	14	510	2156	510	2142	0.0	0.23809523809523808
chr8	EXTL3-AS1	28699440	28699904	82	465	204	2726	122	2261	0.17634408602150536	0.05395842547545334
chr8	EXTL3-AS1	28699440	28699903	81	464	204	2726	123	2262	0.17456896551724138	0.054376657824933686
chr8	EXTL3-AS1	28699904	28699904	1	1	204	2726	203	2725	1.0	0.0744954128440367
chr8	INTS9	28889841	28889872	0	32	5830	4789	5830	4757	0.0	1.2255623291990752
chr8	SARAF	30065987	30066026	0	40	0	1698	0	1658	0.0	0.0
chr8	FUT10	33461371	33461486	0	116	51	4267	51	4151	0.0	0.012286196097325945
chr8	FUT10	33461371	33461410	0	40	51	4267	51	4227	0.0	0.0120652945351313
chr8	FUT10	33461411	33461486	0	76	51	4267	51	4191	0.0	0.012168933428775949
chr8	TTI2	33512959	33513080	0	122	473	3568	473	3446	0.0	0.13726059199071386
chr8	AC091182.1	37331766	37331792	0	27	102	4222	102	4195	0.0	0.024314660309892728
chr8	BRF2	37847273	37847301	0	29	51	2723	51	2694	0.0	0.01893095768374165
chr8	RAB11FIP1	37899070	37899302	51	233	255	8656	204	8423	0.21888412017167383	0.024219399263920218
chr8	LSM1	38176274	38176551	5419	278	9117	1222	3698	944	19.492805755395683	3.917372881355932
chr8	PLPP5	38268822	38268880	5956	59	118166	3045	112210	2986	100.94915254237289	37.57870060281313
chr8	PLPP5	38269081	38269124	5373	44	118166	3045	112793	3001	122.11363636363636	37.58513828723759
chr8	NSD3	38281466	38281498	2225	33	1646248	15273	1644023	15240	67.42424242424242	107.87552493438321
chr8	FGFR1	38419532	38419537	0	6	510	11651	510	11645	0.0	0.043795620437956206
chr8	FGFR1	38428345	38428350	0	6	510	11651	510	11645	0.0	0.043795620437956206
chr8	AC069120.1	38552620	38552957	0	338	0	2688	0	2350	0.0	0.0
chr8	TM2D2	38996212	38996417	51	206	395	4042	344	3836	0.24757281553398058	0.08967674661105318
chr8	ADAM3A	39465844	39465847	0	4	0	3023	0	3019	0.0	0.0
chr8	ANK1	41661800	41661874	0	75	68560	10404	68560	10329	0.0	6.637622228676542
chr8	KAT6A	41942786	41942791	0	6	643	16866	643	16860	0.0	0.038137603795966785
chr8	KAT6A	42049575	42049618	0	44	643	16866	643	16822	0.0	0.038223754607062184
chr8	KAT6A	41978620	41978640	0	21	643	16866	643	16845	0.0	0.038171564262392405
chr8	SLC20A2	42501030	42501185	0	156	1838	6168	1838	6012	0.0	0.30572188955422486
chr8	RNF170	42887727	42887847	549	121	25060	5835	24511	5714	4.537190082644628	4.289639481974099
chr8	RNF170	42896253	42896482	0	230	25060	5835	25060	5605	0.0	4.471008028545941
chr8	ST18	52180121	52180124	0	4	295	12096	295	12092	0.0	0.024396295071121402
chr8	ST18	52217745	52217811	0	67	295	12096	295	12029	0.0	0.024524066838473687
chr8	ST18	52217741	52217744	0	4	295	12096	295	12092	0.0	0.024396295071121402
chr8	ST18	52217741	52217811	0	71	295	12096	295	12025	0.0	0.024532224532224534
chr8	RB1CC1	52628031	52628039	0	9	2851	6657	2851	6648	0.0	0.4288507821901324
chr8	ATP6V1H	53832983	53833059	0	77	0	3871	0	3794	0.0	0.0
chr8	ATP6V1H	53842870	53843032	0	163	0	3871	0	3708	0.0	0.0
chr8	ATP6V1H	53842870	53842954	0	85	0	3871	0	3786	0.0	0.0
chr8	ATP6V1H	53842503	53842869	0	367	0	3871	0	3504	0.0	0.0
chr8	TCEA1	54022062	54022264	0	203	0	4334	0	4131	0.0	0.0
chr8	TMEM68	55773226	55773267	0	42	0	6607	0	6565	0.0	0.0
chr8	TMEM68	55763421	55763635	0	215	0	6607	0	6392	0.0	0.0
chr8	RPS20	56074059	56074379	0	321	0	6105	0	5784	0.0	0.0
chr8	RPS20	56074253	56074379	0	127	0	6105	0	5978	0.0	0.0
chr8	SDR16C6P	56381941	56381953	0	13	102	1094	102	1081	0.0	0.09435707678075855
chr8	LINC00968	56559452	56559556	0	105	0	3316	0	3211	0.0	0.0
chr8	AC092819.1	58259747	58259946	0	200	0	2277	0	2077	0.0	0.0
chr8	AC092819.1	58271869	58272002	0	134	0	2277	0	2143	0.0	0.0
chr8	AC092819.1	58259743	58259746	0	4	0	2277	0	2273	0.0	0.0
chr8	AC092819.1	58259743	58259946	0	204	0	2277	0	2073	0.0	0.0
chr8	LINC01301	60412493	60412592	0	100	153	9536	153	9436	0.0	0.016214497668503604
chr8	AC023866.1	61300819	61300919	0	101	255	682	255	581	0.0	0.4388984509466437
chr8	AC011124.1	63469978	63469981	0	4	0	3217	0	3213	0.0	0.0
chr8	ARMC1	65633718	65633996	0	279	0	3427	0	3148	0.0	0.0
chr8	PDE7A	65841848	65842080	0	233	918	10619	918	10386	0.0	0.08838821490467938
chr8	PPP1R42	66970980	66971092	0	113	237	2092	237	1979	0.0	0.11975745325922182
chr8	COPS5	67060320	67060495	0	176	969	6172	969	5996	0.0	0.1616077384923282
chr8	LINC01603	69447586	69447816	0	231	0	1560	0	1329	0.0	0.0
chr8	NCOA2	70141178	70141182	0	5	22	9572	22	9567	0.0	0.0022995714435037106
chr8	TRAM1	70608076	70608261	0	186	0	4144	0	3958	0.0	0.0
chr8	C8ORF89	73256972	73257039	0	68	0	662	0	594	0.0	0.0
chr8	AC111149.1	73369456	73369488	0	33	0	1738	0	1705	0.0	0.0
chr8	ELOC	73972041	73972075	0	35	38657	4943	38657	4908	0.0	7.8763243683781585
chr8	JPH1	74320908	74321272	0	365	12226	2128	12226	1763	0.0	6.934770277935337
chr8	CASC9	75324220	75324563	0	344	24791	3373	24791	3029	0.0	8.184549356223176
chr8	ZFHX4-AS1	76614792	76615151	0	360	0	5260	0	4900	0.0	0.0
chr8	IL7	78798071	78798126	0	56	0	3129	0	3073	0.0	0.0
chr8	HEY1	79767390	79767417	0	28	1020	4811	1020	4783	0.0	0.21325527911352707
chr8	HEY1	79767574	79767602	0	29	1020	4811	1020	4782	0.0	0.21329987452948557
chr8	HEY1	79766202	79766365	0	164	1020	4811	1020	4647	0.0	0.21949644932214332
chr8	HEY1	79766996	79767007	0	12	1020	4811	1020	4799	0.0	0.2125442800583455
chr8	HEY1	79767418	79767602	0	185	1020	4811	1020	4626	0.0	0.2204928664072633
chr8	HEY1	79767418	79767573	0	156	1020	4811	1020	4655	0.0	0.21911922663802363
chr8	HEY1	79766992	79767007	0	16	1020	4811	1020	4795	0.0	0.2127215849843587
chr8	HEY1	79766992	79766995	0	4	1020	4811	1020	4807	0.0	0.21219055543998336
chr8	MRPS28	80029760	80029903	0	144	0	1805	0	1661	0.0	0.0
chr8	FABP4	81483094	81483097	0	4	1212	1373	1212	1369	0.0	0.885317750182615
chr8	FABP12	81529375	81529436	0	62	0	617	0	555	0.0	0.0
chr8	IMPA1P1	81626883	81626885	0	3	0	986	0	983	0.0	0.0
chr8	ZFAND1	81721226	81721247	0	22	970	2569	970	2547	0.0	0.38084020416175896
chr8	ZFAND1	81721069	81721225	0	157	970	2569	970	2412	0.0	0.4021558872305141
chr8	ZFAND1	81721065	81721225	0	161	970	2569	970	2408	0.0	0.40282392026578073
chr8	ZFAND1	81721065	81721247	0	183	970	2569	970	2386	0.0	0.4065381391450126
chr8	ZFAND1	81721065	81721068	0	4	970	2569	970	2565	0.0	0.37816764132553604
chr8	SNX16	81841697	81841927	0	231	0	4619	0	4388	0.0	0.0
chr8	LINC02839	82160416	82160528	0	113	0	1168	0	1055	0.0	0.0
chr8	RBIS	85219235	85219321	0	87	0	2119	0	2032	0.0	0.0
chr8	RBIS	85218706	85219234	0	529	0	2119	0	1590	0.0	0.0
chr8	CA3-AS1	85462931	85463176	0	246	0	3418	0	3172	0.0	0.0
chr8	SLC7A13	86229592	86229618	0	27	0	2215	0	2188	0.0	0.0
chr8	AF117829.1	89725505	89725516	0	12	3411	13611	3411	13599	0.0	0.25082726671078753
chr8	OTUD6B-AS1	91068935	91069577	102	643	13024	9837	12922	9194	0.15863141524105753	1.405481835979987
chr8	AC091096.1	92653937	92653940	0	4	0	2349	0	2345	0.0	0.0
chr8	TRIQK	92965807	92966005	0	199	710	4946	710	4747	0.0	0.14956814830419213
chr8	RBM12B	93740862	93740879	0	18	0	5969	0	5951	0.0	0.0
chr8	GEM	94262089	94262203	0	115	0	2654	0	2539	0.0	0.0
chr8	UQCRB	96231225	96231377	0	153	1377	9892	1377	9739	0.0	0.14139028647705104
chr8	RPL30	98044826	98044941	0	116	456	3856	456	3740	0.0	0.12192513368983957
chr8	VPS13B-DT	99012868	99012889	0	22	2745	3622	2745	3600	0.0	0.7625
chr8	COX6C	99893318	99893441	192	124	1285	2597	1093	2473	1.5483870967741935	0.4419733117670845
chr8	RGS22	100071368	100071403	0	36	9270	6401	9270	6365	0.0	1.4564021995286724
chr8	FBXO43	100145006	100145049	0	44	6677	3937	6677	3893	0.0	1.7151297200102749
chr8	ANKRD46	100559037	100559384	0	348	51	5482	51	5134	0.0	0.009933774834437087
chr8	ANKRD46	100559037	100559530	0	494	51	5482	51	4988	0.0	0.010224538893344026
chr8	ANKRD46	100559531	100559709	0	179	51	5482	51	5303	0.0	0.009617197812558929
chr8	PABPC1	100715461	100715469	0	9	51	8827	51	8818	0.0	0.0057836244046269
chr8	PABPC1	100718086	100718181	0	96	51	8827	51	8731	0.0	0.005841255297216814
chr8	PABPC1	100718086	100718229	0	144	51	8827	51	8683	0.0	0.00587354600944374
chr8	PABPC1	100721029	100721111	0	83	51	8827	51	8744	0.0	0.005832570905763952
chr8	PABPC1	100720804	100721111	0	308	51	8827	51	8519	0.0	0.0059866181476699145
chr8	PABPC1	100720804	100721028	0	225	51	8827	51	8602	0.0	0.005928853754940711
chr8	PABPC1	100720804	100721389	0	586	51	8827	51	8241	0.0	0.006188569348380051
chr8	PABPC1	100720804	100721727	0	924	51	8827	51	7903	0.0	0.0064532456029355945
chr8	PABPC1	100721390	100721727	0	338	51	8827	51	8489	0.0	0.006007774767345977
chr8	PABPC1	100721728	100721732	0	5	51	8827	51	8822	0.0	0.005781002040353661
chr8	PABPC1	100704279	100704295	17	17	51	8827	34	8810	1.0	0.0038592508513053347
chr8	PABPC1	100718182	100718229	0	48	51	8827	51	8779	0.0	0.005809317689941907
chr8	PABPC1	100721712	100721727	0	16	51	8827	51	8811	0.0	0.005788219271365339
chr8	PABPC1	100721712	100721732	0	21	51	8827	51	8806	0.0	0.005791505791505791
chr8	YWHAZ	100951185	100951233	0	49	102	5869	102	5820	0.0	0.01752577319587629
chr8	ZNF706	101202332	101204648	8160	2317	13259	4818	5099	2501	3.521795425118688	2.0387844862055178
chr8	UBR5	102289452	102289527	0	76	8	13803	8	13727	0.0	0.0005827930356232243
chr8	ZFPM2-AS1	105927641	105927649	0	9	0	2451	0	2442	0.0	0.0
chr8	ANGPT1	107321895	107321897	0	3	43212	7136	43212	7133	0.0	6.058040095331558
chr8	RSPO2	108082923	108083195	0	273	0	4366	0	4093	0.0	0.0
chr8	RSPO2	108083196	108083472	0	277	0	4366	0	4089	0.0	0.0
chr8	EIF3E	108236160	108236161	0	2	51	27596	51	27594	0.0	0.0018482278756251358
chr8	EIF3E	108241798	108241884	0	87	51	27596	51	27509	0.0	0.0018539387109673198
chr8	EIF3E	108202982	108202988	0	7	51	27596	51	27589	0.0	0.0018485628330131574
chr8	EIF3E	108443364	108443368	0	5	51	27596	51	27591	0.0	0.0018484288354898336
chr8	SYBU	109642727	109643235	0	509	52	6757	52	6248	0.0	0.008322663252240717
chr8	SYBU	109586016	109586058	0	43	52	6757	52	6714	0.0	0.0077450104259755735
chr8	RAD21	116874309	116874361	0	53	0	4938	0	4885	0.0	0.0
chr8	RAD21	116874249	116874308	0	60	0	4938	0	4878	0.0	0.0
chr8	RAD21	116874205	116874308	0	104	0	4938	0	4834	0.0	0.0
chr8	RAD21	116874205	116874248	0	44	0	4938	0	4894	0.0	0.0
chr8	SAMD12	118439831	118439860	0	30	426	15396	426	15366	0.0	0.027723545490042953
chr8	SAMD12	118621803	118621937	0	135	426	15396	426	15261	0.0	0.027914291330843326
chr8	ENPP2	119582417	119582428	0	12	1440	6760	1440	6748	0.0	0.21339656194427978
chr8	ENPP2	119626564	119626617	0	54	1440	6760	1440	6706	0.0	0.21473307485833582
chr8	MRPL13	120444947	120445066	0	120	121	4217	121	4097	0.0	0.029533805223334146
chr8	C8ORF76	123231299	123231720	0	422	0	2444	0	2022	0.0	0.0
chr8	ZHX1	123274121	123274215	0	95	0	6740	0	6645	0.0	0.0
chr8	ATAD2	123348182	123348185	0	4	0	7131	0	7127	0.0	0.0
chr8	ATAD2	123396182	123396185	0	4	0	7131	0	7127	0.0	0.0
chr8	TATDN1	124504270	124504273	0	4	286290	4793	286290	4789	0.0	59.78074754646064
chr8	TATDN1	124538927	124539023	1390	97	286290	4793	284900	4696	14.329896907216495	60.66865417376491
chr8	TATDN1	124518741	124518816	71346	76	286290	4793	214944	4717	938.7631578947369	45.56794572821709
chr8	WASHC5	125083712	125083833	0	122	4	4792	4	4670	0.0	0.0008565310492505353
chr8	LINC00861	125950913	125951184	0	272	102	8777	102	8505	0.0	0.01199294532627866
chr8	CASC19	127187784	127187795	0	12	51	18096	51	18084	0.0	0.002820172528201725
chr8	CASC19	127218809	127218813	0	5	51	18096	51	18091	0.0	0.0028190813111491904
chr8	CASC19	127187780	127187783	0	4	51	18096	51	18092	0.0	0.002818925491930135
chr8	CASC19	127191661	127191664	0	4	51	18096	51	18092	0.0	0.002818925491930135
chr8	CASC19	127227398	127227517	0	120	51	18096	51	17976	0.0	0.0028371161548731644
chr8	CCDC26	128965906	128965941	0	36	37930	49644	37930	49608	0.0	0.7645944202547976
chr8	CCDC26	129574638	129574880	0	243	37930	49644	37930	49401	0.0	0.7677982227080423
chr8	CCDC26	129399513	129399529	0	17	37930	49644	37930	49627	0.0	0.7643016906119653
chr8	CCDC26	129402166	129402214	0	49	37930	49644	37930	49595	0.0	0.7647948381893336
chr8	CCDC26	129360173	129360661	0	489	37930	49644	37930	49155	0.0	0.7716407283084121
chr8	CCDC26	129554803	129554908	0	106	37930	49644	37930	49538	0.0	0.7656748354798336
chr8	CCDC26	129554667	129554908	0	242	37930	49644	37930	49402	0.0	0.767782680863123
chr8	CCDC26	129554667	129554802	0	136	37930	49644	37930	49508	0.0	0.7661388058495596
chr8	CYRIB	129896671	129896747	0	77	82	7461	82	7384	0.0	0.011105092091007584
chr8	ADCY8	130990392	130990437	0	46	47505	4463	47505	4417	0.0	10.75503735567127
chr8	KCNQ3	132134289	132134324	0	36	0	11790	0	11754	0.0	0.0
chr8	SLA	133074852	133074861	0	10	0	7510	0	7500	0.0	0.0
chr8	NDRG1	133296736	133297132	0	397	137	10313	137	9916	0.0	0.01381605486083098
chr8	NDRG1	133296736	133297002	0	267	137	10313	137	10046	0.0	0.013637268564602827
chr8	NDRG1	133296736	133297023	0	288	137	10313	137	10025	0.0	0.013665835411471322
chr8	NDRG1	133246595	133246614	0	20	137	10313	137	10293	0.0	0.013310016516078889
chr8	NDRG1	133256725	133256775	0	51	137	10313	137	10262	0.0	0.013350224127850321
chr8	NDRG1	133297003	133297023	0	21	137	10313	137	10292	0.0	0.01331130975514963
chr8	NDRG1	133288259	133288365	0	107	137	10313	137	10206	0.0	0.01342347638643935
chr8	NDRG1	133279965	133280230	0	266	137	10313	137	10047	0.0	0.01363591121727879
chr8	KCNK9	139616385	139618256	0	1872	0	6793	0	4921	0.0	0.0
chr8	PTK2	140675429	140675458	0	30	8105	12062	8105	12032	0.0	0.6736203457446809
chr8	PTK2	140925561	140925659	0	99	8105	12062	8105	11963	0.0	0.677505642397392
chr8	SLC45A4	141212196	141212202	0	7	4488	8610	4488	8603	0.0	0.5216784842496803
chr8	MROH5	141479138	141479205	0	68	2018	4795	2018	4727	0.0	0.426909244764121
chr8	MROH5	141474001	141474130	663	130	2018	4795	1355	4665	5.1	0.2904608788853162
chr8	JRK	142669931	142669939	0	9	0	6936	0	6927	0.0	0.0
chr8	AC083841.3	142834647	142834675	0	29	0	380	0	351	0.0	0.0
chr8	NAPRT	143575190	143575228	0	39	0	2597	0	2558	0.0	0.0
chr8	NAPRT	143577815	143577859	0	45	0	2597	0	2552	0.0	0.0
chr8	EEF1D	143581228	143581284	0	57	0	8812	0	8755	0.0	0.0
chr8	EEF1D	143596878	143597346	0	469	0	8812	0	8343	0.0	0.0
chr8	EEF1D	143596878	143596911	0	34	0	8812	0	8778	0.0	0.0
chr8	EEF1D	143590607	143590643	0	37	0	8812	0	8775	0.0	0.0
chr8	EEF1D	143593874	143593891	0	18	0	8812	0	8794	0.0	0.0
chr8	EEF1D	143592646	143592713	0	68	0	8812	0	8744	0.0	0.0
chr8	EEF1D	143596854	143597346	0	493	0	8812	0	8319	0.0	0.0
chr8	EEF1D	143596912	143597346	0	435	0	8812	0	8377	0.0	0.0
chr8	GFUS	143617427	143617472	0	46	0	3184	0	3138	0.0	0.0
chr8	GFUS	143617421	143617426	0	6	0	3184	0	3178	0.0	0.0
chr8	SCRIB	143804933	143804953	241	21	163329	6452	163088	6431	11.476190476190476	25.3596641268854
chr8	PLEC	143935010	143935021	0	12	153	17036	153	17024	0.0	0.008987312030075188
chr8	PLEC	143946349	143946383	0	35	153	17036	153	17001	0.0	0.008999470619375331
chr8	PARP10	143983166	143983310	0	145	0	5815	0	5670	0.0	0.0
chr8	PARP10	143984007	143984033	0	27	0	5815	0	5788	0.0	0.0
chr8	PARP10	143986054	143986356	0	303	0	5815	0	5512	0.0	0.0
chr8	PARP10	143987078	143987134	0	57	0	5815	0	5758	0.0	0.0
chr8	PARP10	143986914	143987077	0	164	0	5815	0	5651	0.0	0.0
chr8	PARP10	143990605	143991031	0	427	0	5815	0	5388	0.0	0.0
chr8	PARP10	143986754	143986913	0	160	0	5815	0	5655	0.0	0.0
chr8	SHARPIN	144103552	144104023	153935	472	666188	2512	512253	2040	326.13347457627117	251.10441176470587
chr8	SHARPIN	144103552	144103845	153884	294	666188	2512	512304	2218	523.4149659863946	230.97565374211
chr8	SHARPIN	144103846	144104023	51	178	666188	2512	666137	2334	0.28651685393258425	285.4057412167952
chr8	FBXL6	144357438	144357455	784	18	235802	3250	235018	3232	43.55555555555556	72.71596534653466
chr8	VPS28	144425874	144426024	0	151	51	3187	51	3036	0.0	0.016798418972332016
chr8	VPS28	144425874	144425920	0	47	51	3187	51	3140	0.0	0.01624203821656051
chr8	VPS28	144425921	144426024	0	104	51	3187	51	3083	0.0	0.016542328900421666
chr8	CYHR1	144465352	144465408	398	57	105660	9265	105262	9208	6.982456140350878	11.431581233709817
chr8	CYHR1	144465207	144465351	1082	145	105660	9265	104578	9120	7.462068965517242	11.466885964912281
chr8	CYHR1	144465207	144465408	1480	202	105660	9265	104180	9063	7.326732673267327	11.495089926073044
chr8	CYHR1	144465409	144465569	3331	161	105660	9265	102329	9104	20.68944099378882	11.24000439367311
chr8	AC084125.2	144498751	144498898	0	148	6457	3372	6457	3224	0.0	2.002791563275434
chr8	RECQL4	144513217	144513414	0	198	153	4192	153	3994	0.0	0.038307461191787684
chr8	RECQL4	144511901	144511909	0	9	153	4192	153	4183	0.0	0.03657661965096821
chr8	ZNF34	144780227	144780230	0	4	49890	3115	49890	3111	0.0	16.036644165863066
chr8	RPL8	144792244	144792364	0	121	408	1672	408	1551	0.0	0.26305609284332687
chr8	RPL8	144792244	144792264	0	21	408	1672	408	1651	0.0	0.2471229557843731
chr8	RPL8	144792265	144792364	0	100	408	1672	408	1572	0.0	0.2595419847328244
chr8	COMMD5	144852725	144852991	918	267	4489	2540	3571	2273	3.438202247191011	1.5710514738231411
chr8	COMMD5	144852725	144852837	162	113	4489	2540	4327	2427	1.4336283185840708	1.7828594973217964
chr8	COMMD5	144852838	144852991	756	154	4489	2540	3733	2386	4.909090909090909	1.5645431684828164
chr8	ZNF250	144901336	144901397	1034	62	79516	3889	78482	3827	16.677419354838708	20.507447086490725
chr8	ZNF16	144947939	144947955	0	17	924	5242	924	5225	0.0	0.17684210526315788
chr8	AC144568.2	72674	72701	0	28	0	974	0	946	0.0	0.0
chr8	ZNF596	232268	232415	0	148	1690	4549	1690	4401	0.0	0.3840036355373779
chr8	ZNF596	243806	243858	0	53	1690	4549	1690	4496	0.0	0.3758896797153025
chr8	ZNF596	232416	232624	0	209	1690	4549	1690	4340	0.0	0.38940092165898615
chr8	ZNF596	232625	232694	0	70	1690	4549	1690	4479	0.0	0.3773163652601027
chr8	CLN8	1763812	1763941	0	130	12320	8418	12320	8288	0.0	1.4864864864864864
chr8	CLN8	1763886	1763941	0	56	12320	8418	12320	8362	0.0	1.4733317388184646
chr8	CLN8	1763926	1763941	0	16	12320	8418	12320	8402	0.0	1.4663175434420377
chr8	CLN8	1763812	1763885	0	74	12320	8418	12320	8344	0.0	1.476510067114094
chr8	CLN8	1763812	1763925	0	114	12320	8418	12320	8304	0.0	1.4836223506743738
chr8	CLN8	1763886	1763925	0	40	12320	8418	12320	8378	0.0	1.470518023394605
chr8	FAM86B3P	8228701	8228797	0	97	6501	3972	6501	3875	0.0	1.6776774193548387
chr8	FAM86B3P	8241681	8242432	279	752	6501	3972	6222	3220	0.37101063829787234	1.9322981366459628
chr8	FAM86B3P	8241963	8242432	0	470	6501	3972	6501	3502	0.0	1.8563677898343804
chr8	FAM86B3P	8241681	8241962	279	282	6501	3972	6222	3690	0.9893617021276596	1.686178861788618
chr8	AC022784.1	9189587	9189597	0	11	17392	16960	17392	16949	0.0	1.026137235235117
chr8	AC022784.1	9155077	9155149	0	73	17392	16960	17392	16887	0.0	1.029904660389649
chr8	LINCR-0001	10477284	10477294	0	11	51	2704	51	2693	0.0	0.018937987374675083
chr8	PRSS55	10531546	10531712	0	167	51	3158	51	2991	0.0	0.017051153460381142
chr8	NEIL2	11771586	11771590	0	5	294	3371	294	3366	0.0	0.0873440285204991
chr8	NEIL2	11769792	11770335	102	544	294	3371	192	2827	0.1875	0.06791651927838699
chr8	FDFT1	11802911	11802931	0	21	290	4998	290	4977	0.0	0.05826803295157726
chr8	FDFT1	11803226	11803518	0	293	290	4998	290	4705	0.0	0.061636556854410204
chr8	FAM66D	12115902	12116325	0	424	0	7125	0	6701	0.0	0.0
chr8	FAM66D	12122051	12122160	0	110	0	7125	0	7015	0.0	0.0
chr8	TRMT9B	12991001	12991031	0	31	141	12257	141	12226	0.0	0.011532798953050875
chr8	TRMT9B	13012794	13012857	0	64	141	12257	141	12193	0.0	0.01156401213811203
chr8	PDGFRL	17576757	17576760	0	4	408	2178	408	2174	0.0	0.18767249310027598
chr8	PCM1	17991677	17991700	0	24	248465	12520	248465	12496	0.0	19.883562740076826
chr8	AC124242.1	18084940	18085485	0	546	0	3569	0	3023	0.0	0.0
chr8	AC124242.1	18085198	18085485	0	288	0	3569	0	3281	0.0	0.0
chr8	INTS10	19818343	19818473	0	131	0	6356	0	6225	0.0	0.0
chr8	INTS10	19823982	19824044	0	63	0	6356	0	6293	0.0	0.0
chr8	AC015468.1	20954076	20954079	0	4	0	1056	0	1052	0.0	0.0
chr8	LINC02153	20974523	20974653	0	131	0	2753	0	2622	0.0	0.0
chr8	LINC02153	20974523	20974712	0	190	0	2753	0	2563	0.0	0.0
chr8	LINC02153	20974654	20974712	0	59	0	2753	0	2694	0.0	0.0
chr8	AC103719.1	21027289	21027297	0	9	102	1919	102	1910	0.0	0.05340314136125655
chr8	XPO7	21971942	21971968	0	27	87890	6949	87890	6922	0.0	12.697197341808726
chr8	NPM2	22024831	22025306	0	476	16819	1896	16819	1420	0.0	11.8443661971831
chr8	NPM2	22024258	22024623	1824	366	16819	1896	14995	1530	4.983606557377049	9.800653594771243
chr8	SFTPC	22158826	22159081	0	256	0	2654	0	2398	0.0	0.0
chr8	SFTPC	22164052	22164059	0	8	0	2654	0	2646	0.0	0.0
chr8	POLR3D	22245184	22245220	32	37	14274	5592	14242	5555	0.8648648648648649	2.563816381638164
chr8	SLC39A14	22367370	22367408	0	39	45476	6745	45476	6706	0.0	6.781389800178944
chr8	PDLIM2	22579210	22579527	0	318	102	7319	102	7001	0.0	0.014569347236109127
chr8	PDLIM2	22579225	22579527	0	303	102	7319	102	7016	0.0	0.014538198403648802
chr8	PDLIM2	22579210	22579224	0	15	102	7319	102	7304	0.0	0.013964950711938665
chr8	PDLIM2	22580267	22580411	0	145	102	7319	102	7174	0.0	0.014218009478672985
chr8	AC037441.1	22878152	22878166	3903	15	469879	4016	465976	4001	260.2	116.46488377905524
chr8	CHMP7	23246825	23246994	2417	170	261325	3469	258908	3299	14.217647058823529	78.4807517429524
chr8	SLC25A37	23566337	23566813	0	477	153	7785	153	7308	0.0	0.020935960591133004
chr8	ADAM28	24343585	24343588	0	4	24	9346	24	9342	0.0	0.002569043031470777
chr8	DOCK5	25368688	25368725	649	38	159276	16044	158627	16006	17.07894736842105	9.910471073347495
chr8	AC009623.1	25670685	25671686	0	1002	0	3660	0	2658	0.0	0.0
chr8	AC009623.1	25688095	25688109	0	15	0	3660	0	3645	0.0	0.0
chr8	PPP2R2A	26293741	26293860	0	120	216728	7726	216728	7606	0.0	28.494346568498553
chr8	BNIP3L	26383479	26383496	0	18	15055	4159	15055	4141	0.0	3.6355952668437577
chr8	PTK2B	27433514	27433552	0	39	11526	7538	11526	7499	0.0	1.5370049339911989
chr8	ELP3	28093234	28093360	0	127	51	5184	51	5057	0.0	0.01008503065058335
chr8	AC025871.1	28449032	28449106	0	75	0	736	0	661	0.0	0.0
chr8	EXTL3	28716898	28718207	9668	1310	35537	7671	25869	6361	7.3801526717557255	4.066813394120421
chr8	LINC02099	29791383	29791881	0	499	0	5547	0	5048	0.0	0.0
chr8	RBPMS	30545221	30545465	0	245	84569	8416	84569	8171	0.0	10.349895973565047
chr8	UBXN8	30754750	30754787	0	38	0	4037	0	3999	0.0	0.0
chr8	UBXN8	30744278	30744460	0	183	0	4037	0	3854	0.0	0.0
chr8	NRG1	32648315	32648384	0	70	19289	19683	19289	19613	0.0	0.983480344669352
chr8	AC090204.1	33041744	33041771	0	28	0	1787	0	1759	0.0	0.0
chr8	AC090204.1	32996317	32996355	0	39	0	1787	0	1748	0.0	0.0
chr8	AC090204.1	32928315	32928349	0	35	0	1787	0	1752	0.0	0.0
chr8	UNC5D	35722357	35722395	0	39	153	10818	153	10779	0.0	0.014194266629557473
chr8	AC124067.3	37560602	37560626	0	25	153	3546	153	3521	0.0	0.04345356432831582
chr8	AC138356.3	37717778	37717996	4944	219	15830	1216	10886	997	22.575342465753426	10.918756268806419
chr8	ERLIN2	37737008	37737262	0	255	10706	8103	10706	7848	0.0	1.3641692150866462
chr8	ERLIN2	37737115	37737262	0	148	10706	8103	10706	7955	0.0	1.3458202388434946
chr8	PLPBP	37762701	37762758	0	58	51	2899	51	2841	0.0	0.01795142555438226
chr8	DDHD2	38234511	38234584	0	74	361665	7507	361665	7433	0.0	48.65666621821607
chr8	DDHD2	38231747	38231859	0	113	361665	7507	361665	7394	0.0	48.913308087638626
chr8	LETM2	38386381	38386568	0	188	104	5024	104	4836	0.0	0.021505376344086023
chr8	LETM2	38386569	38387182	0	614	104	5024	104	4410	0.0	0.023582766439909298
chr8	LETM2	38387183	38387234	0	52	104	5024	104	4972	0.0	0.02091713596138375
chr8	TACC1	38827289	38827375	1957	87	902221	12557	900264	12470	22.49425287356322	72.1943865276664
chr8	TACC1	38788247	38788291	45	45	902221	12557	902176	12512	1.0	72.10485933503837
chr8	PLEKHA2	38901893	38902069	0	177	8441	5592	8441	5415	0.0	1.5588180978762696
chr8	ADAM9	39018882	39018918	0	37	23735	17281	23735	17244	0.0	1.3764207840408258
chr8	ADAM9	39071404	39071413	0	10	23735	17281	23735	17271	0.0	1.3742690058479532
chr8	IDO1	39923587	39923590	0	4	0	3502	0	3498	0.0	0.0
chr8	GOLGA7	41490567	41490617	0	51	8006	2480	8006	2429	0.0	3.2960065870728696
chr8	GINS4	41529389	41529396	0	8	27369	5344	27369	5336	0.0	5.129122938530735
chr8	IKBKB	42293513	42293568	0	56	64940	8552	64940	8496	0.0	7.643596986817326
chr8	IKBKB	42271470	42272205	51	736	64940	8552	64889	7816	0.06929347826086957	8.302072671443193
chr8	SMIM19	42541706	42542373	0	668	0	3977	0	3309	0.0	0.0
chr8	SMIM19	42542156	42542373	0	218	0	3977	0	3759	0.0	0.0
chr8	FNTA	43077365	43080441	0	3077	300022	8702	300022	5625	0.0	53.337244444444444
chr8	FNTA	43056508	43056546	22609	39	300022	8702	277413	8663	579.7179487179487	32.02274039016507
chr8	POMK	43103789	43103830	0	42	26862	8233	26862	8191	0.0	3.279453058234648
chr8	POMK	43102555	43102600	0	46	26862	8233	26862	8187	0.0	3.281055331623305
chr8	LINC00293	46836799	46836819	0	21	102	8452	102	8431	0.0	0.012098208990629819
chr8	LINC00293	46848902	46848968	0	67	102	8452	102	8385	0.0	0.012164579606440072
chr8	LINC00293	46850527	46850560	0	34	102	8452	102	8418	0.0	0.012116892373485389
chr8	LINC00293	46848902	46849530	0	629	102	8452	102	7823	0.0	0.013038476287869104
chr8	LINC00293	46848969	46849530	0	562	102	8452	102	7890	0.0	0.012927756653992395
chr8	LINC00293	46840936	46840940	0	5	102	8452	102	8447	0.0	0.012075293003433171
chr8	LINC00293	46848902	46849035	0	134	102	8452	102	8318	0.0	0.012262563116133687
chr8	LINC00293	46848969	46849035	0	67	102	8452	102	8385	0.0	0.012164579606440072
chr8	LINC00293	46849531	46850560	0	1030	102	8452	102	7422	0.0	0.0137429264349232
chr8	LINC00293	46849531	46850526	0	996	102	8452	102	7456	0.0	0.013680257510729614
chr8	LINC00293	46853105	46853161	0	57	102	8452	102	8395	0.0	0.012150089338892198
chr8	SPIDR	47279981	47280017	0	37	51	7208	51	7171	0.0	0.007111978803514154
chr8	MCM4	47966276	47966407	0	132	0	6523	0	6391	0.0	0.0
chr8	MCM4	47961015	47961214	0	200	0	6523	0	6323	0.0	0.0
chr8	MCM4	47961215	47961426	0	212	0	6523	0	6311	0.0	0.0
chr8	UBE2V2	48008471	48008571	0	101	327	6598	327	6497	0.0	0.05033092196398338
chr8	AC044893.1	49193196	49193257	0	62	89	2165	89	2103	0.0	0.04232049453162149
chr8	SNTG1	50402325	50402344	0	20	37	9266	37	9246	0.0	0.00400173047804456
chr8	SNTG1	49911045	49912231	37	1187	37	9266	0	8079	0.031171019376579612	0.0
chr8	AC064807.1	51899847	51900207	57	361	255	4817	198	4456	0.15789473684210525	0.044434470377019746
chr8	AC009646.2	53178004	53178050	0	47	0	845	0	798	0.0	0.0
chr8	LYN	55941929	55941991	0	63	0	6179	0	6116	0.0	0.0
chr8	CHCHD7	56216507	56216531	0	25	204	3872	204	3847	0.0	0.05302833376657135
chr8	CHCHD7	56212890	56212909	0	20	204	3872	204	3852	0.0	0.0529595015576324
chr8	CHCHD7	56211838	56212174	0	337	204	3872	204	3535	0.0	0.05770862800565771
chr8	LINC01606	57219524	57219623	0	100	39	8839	39	8739	0.0	0.004462753175420529
chr8	LINC01606	57226608	57226625	39	18	39	8839	0	8821	2.1666666666666665	0.0
chr8	LINC01606	57193690	57193716	0	27	39	8839	39	8812	0.0	0.00442578302315025
chr8	AC068075.1	57347395	57347408	0	14	35	3224	35	3210	0.0	0.010903426791277258
chr8	SDCBP	58565067	58565084	0	18	51	4744	51	4726	0.0	0.01079136690647482
chr8	AC087664.2	59619739	59619829	0	91	0	1743	0	1652	0.0	0.0
chr8	CHD7	60781051	60781430	0	380	102	15978	102	15598	0.0	0.006539299910244903
chr8	CLVS1	61300279	61300282	0	4	17223	7405	17223	7401	0.0	2.3271179570328333
chr8	CLVS1	61288139	61288234	0	96	17223	7405	17223	7309	0.0	2.3564099055958407
chr8	YTHDF3	63169009	63169111	0	103	467	6172	467	6069	0.0	0.07694842642939528
chr8	YTHDF3	63169106	63169111	0	6	467	6172	467	6166	0.0	0.0757379176127149
chr8	MIR124-2HG	64378234	64378489	0	256	0	3786	0	3530	0.0	0.0
chr8	MIR124-2HG	64378383	64378489	0	107	0	3786	0	3679	0.0	0.0
chr8	MIR124-2HG	64378234	64378382	0	149	0	3786	0	3637	0.0	0.0
chr8	MIR124-2HG	64377482	64377528	0	47	0	3786	0	3739	0.0	0.0
chr8	AC084082.1	66112900	66113096	0	197	0	2787	0	2590	0.0	0.0
chr8	AC084082.1	66112900	66113107	0	208	0	2787	0	2579	0.0	0.0
chr8	AC084082.1	66113097	66113107	0	11	0	2787	0	2776	0.0	0.0
chr8	CSPP1	67064497	67064538	0	42	2130	22998	2130	22956	0.0	0.09278619968635651
chr8	CSPP1	67064527	67064538	0	12	2130	22998	2130	22986	0.0	0.09266510049595406
chr8	CSPP1	67112066	67112075	0	10	2130	22998	2130	22988	0.0	0.092657038454846
chr8	CSPP1	67064497	67064526	0	30	2130	22998	2130	22968	0.0	0.09273772204806688
chr8	CSPP1	67113863	67115264	0	1402	2130	22998	2130	21596	0.0	0.09862937581033525
chr8	CSPP1	67114371	67115264	0	894	2130	22998	2130	22104	0.0	0.09636264929424539
chr8	CSPP1	67118370	67118385	0	16	2130	22998	2130	22982	0.0	0.09268122878774693
chr8	AC079089.1	69834194	69834206	0	13	0	1954	0	1941	0.0	0.0
chr8	XKR9	70669475	70669538	0	64	465	3941	465	3877	0.0	0.11993809646633995
chr8	AC111149.2	73358828	73359227	0	400	0	2366	0	1966	0.0	0.0
chr8	AC111149.2	73359046	73359227	0	182	0	2366	0	2184	0.0	0.0
chr8	TMEM70	73972622	73972993	0	372	43748	2988	43748	2616	0.0	16.723241590214066
chr8	TMEM70	73978862	73978875	979	14	43748	2988	42769	2974	69.92857142857143	14.380968392737055
chr8	GDAP1	74320919	74320961	0	43	21694	20769	21694	20726	0.0	1.0467046222136447
chr8	GDAP1	74360150	74360310	0	161	21694	20769	21694	20608	0.0	1.0526979813664596
chr8	GDAP1	74351322	74351466	0	145	21694	20769	21694	20624	0.0	1.0518813033359193
chr8	GDAP1	74351419	74351466	0	48	21694	20769	21694	20721	0.0	1.0469571931856572
chr8	GDAP1	74350531	74350578	0	48	21694	20769	21694	20721	0.0	1.0469571931856572
chr8	GDAP1	74351322	74351418	0	97	21694	20769	21694	20672	0.0	1.0494388544891642
chr8	CRISPLD1	74986118	74986245	0	128	0	4446	0	4318	0.0	0.0
chr8	LINC02235	81842672	81842890	0	219	10036	4148	10036	3929	0.0	2.5543395265970985
chr8	RALYL	84183579	84184424	0	846	0	4551	0	3705	0.0	0.0
chr8	RALYL	84185015	84185233	0	219	0	4551	0	4332	0.0	0.0
chr8	LRRCC1	85107400	85107718	0	319	0	5020	0	4701	0.0	0.0
chr8	E2F5	85206221	85206224	0	4	0	2856	0	2852	0.0	0.0
chr8	CPNE3	86514542	86514573	0	32	3	6676	3	6644	0.0	0.0004515352197471403
chr8	CPNE3	86514574	86514722	0	149	3	6676	3	6527	0.0	0.00045962923241918186
chr8	AC090578.1	88328997	88329052	0	56	0	9713	0	9657	0.0	0.0
chr8	AC090578.1	88542760	88542830	0	71	0	9713	0	9642	0.0	0.0
chr8	AC090578.1	88542811	88542830	0	20	0	9713	0	9693	0.0	0.0
chr8	OSGIN2	89901912	89902125	0	214	0	4662	0	4448	0.0	0.0
chr8	DECR1	90005732	90005845	0	114	0	4418	0	4304	0.0	0.0
chr8	AC106038.1	90646634	90646883	0	250	0	1936	0	1686	0.0	0.0
chr8	CIBAR1	93700674	93700723	0	50	0	6800	0	6750	0.0	0.0
chr8	CIBAR1	93700674	93701057	0	384	0	6800	0	6416	0.0	0.0
chr8	CIBAR1	93700724	93701057	0	334	0	6800	0	6466	0.0	0.0
chr8	TMEM67	93755867	93755908	0	42	357	7387	357	7345	0.0	0.04860449285228046
chr8	PDP1	93916937	93917079	0	143	1530	5612	1530	5469	0.0	0.2797586396050466
chr8	PDP1	93917080	93917218	0	139	1530	5612	1530	5473	0.0	0.2795541750411109
chr8	AC023632.2	94568536	94568621	0	86	255	2479	255	2393	0.0	0.1065608023401588
chr8	ESRP1	94674495	94674506	0	12	0	4621	0	4609	0.0	0.0
chr8	INTS8	94823302	94823561	663	260	8392	7694	7729	7434	2.55	1.0396825396825398
chr8	INTS8	94865691	94865700	0	10	8392	7694	8392	7684	0.0	1.0921395106715253
chr8	INTS8	94866352	94866353	0	2	8392	7694	8392	7692	0.0	1.0910036401456058
chr8	NDUFAF6	95032095	95032098	0	4	1292	6433	1292	6429	0.0	0.20096438015243429
chr8	C8ORF37-AS1	95800555	95800655	48	101	101716	4839	101668	4738	0.4752475247524752	21.457999155761925
chr8	SDC2	96494044	96494331	0	288	0	4095	0	3807	0.0	0.0
chr8	POP1	98117331	98117390	0	60	51	4870	51	4810	0.0	0.010602910602910603
chr8	OSR2	98948309	98948421	0	113	561	2479	561	2366	0.0	0.2371090448013525
chr8	OSR2	98948422	98948686	0	265	561	2479	561	2214	0.0	0.25338753387533874
chr8	AP001205.1	100618646	100618764	0	119	0	451	0	332	0.0	0.0
chr8	FLJ42969	101052422	101052836	0	415	0	3136	0	2721	0.0	0.0
chr8	GRHL2	101492790	101492849	0	60	2016	6069	2016	6009	0.0	0.3354967548676985
chr8	GASAL1	102807714	102808553	0	840	0	2294	0	1454	0.0	0.0
chr8	GASAL1	102808554	102808799	0	246	0	2294	0	2048	0.0	0.0
chr8	ATP6V1C1	103021183	103021225	0	43	0	5864	0	5821	0.0	0.0
chr8	OXR1	106658086	106658185	0	100	102	6705	102	6605	0.0	0.015442846328538986
chr8	OXR1	106726258	106726309	0	52	102	6705	102	6653	0.0	0.01533142943033218
chr8	ENY2	109334403	109334474	0	72	0	6789	0	6717	0.0	0.0
chr8	ENY2	109334407	109334474	0	68	0	6789	0	6721	0.0	0.0
chr8	ENY2	109334403	109334406	0	4	0	6789	0	6785	0.0	0.0
chr8	AC064802.1	114284515	114284533	0	19	51	1196	51	1177	0.0	0.04333050127442651
chr8	AC023590.1	118282161	118282330	0	170	0	2885	0	2715	0.0	0.0
chr8	HAS2-AS1	121641364	121641446	0	83	102	5667	102	5584	0.0	0.018266475644699142
chr8	HAS2-AS1	121641447	121641454	0	8	102	5667	102	5659	0.0	0.018024385933910585
chr8	HAS2-AS1	121641364	121641454	0	91	102	5667	102	5576	0.0	0.018292682926829267
chr8	HAS2-AS1	121639386	121640168	0	783	102	5667	102	4884	0.0	0.020884520884520884
chr8	NTAQ1	123441350	123441497	0	148	51	4939	51	4791	0.0	0.010644959298685034
chr8	NTAQ1	123416857	123416932	0	76	51	4939	51	4863	0.0	0.010487353485502776
chr8	FAM91A1	123780076	123780082	0	7	0	7289	0	7282	0.0	0.0
chr8	AC090192.2	124276237	124276394	0	158	1615	2469	1615	2311	0.0	0.6988316745997404
chr8	NDUFB9	124549834	124550501	2365	668	998395	14277	996030	13609	3.5404191616766467	73.18906605922551
chr8	LINC00964	124847783	124848172	0	390	348	10517	348	10127	0.0	0.03436358250222178
chr8	LINC00964	124940547	124940634	0	88	348	10517	348	10429	0.0	0.03336849170582031
chr8	LINC00964	124944798	124945051	0	254	348	10517	348	10263	0.0	0.03390821397252265
chr8	LINC00964	124942725	124943269	0	545	348	10517	348	9972	0.0	0.03489771359807461
chr8	LINC00964	124942891	124943269	0	379	348	10517	348	10138	0.0	0.03432629710001973
chr8	LINC00964	124942725	124942890	0	166	348	10517	348	10351	0.0	0.033619940102405564
chr8	LINC00964	124943384	124943501	0	118	348	10517	348	10399	0.0	0.03346475622656025
chr8	LINC00964	124943502	124945051	102	1550	348	10517	246	8967	0.06580645161290323	0.0274339243894279
chr8	LINC00964	124943384	124945051	102	1668	348	10517	246	8849	0.06115107913669065	0.027799751384337212
chr8	LINC00964	124942725	124943383	0	659	348	10517	348	9858	0.0	0.03530127814972611
chr8	LINC00964	124943270	124943383	0	114	348	10517	348	10403	0.0	0.03345188887820821
chr8	LINC00964	124942891	124943383	0	493	348	10517	348	10024	0.0	0.03471667996807662
chr8	LINC00964	124944798	124945746	0	949	348	10517	348	9568	0.0	0.036371237458193977
chr8	LINC00964	124945052	124945746	0	695	348	10517	348	9822	0.0	0.0354306658521686
chr8	LINC00964	124945052	124945281	0	230	348	10517	348	10287	0.0	0.03382910469524643
chr8	LINC00964	124944798	124945281	0	484	348	10517	348	10033	0.0	0.03468553772550583
chr8	LINC00964	124943270	124943501	0	232	348	10517	348	10285	0.0	0.033835683033544
chr8	SQLE	124998606	124999694	0	1089	51	4200	51	3111	0.0	0.01639344262295082
chr8	NSMCE2	125091901	125091958	0	58	33	3005	33	2947	0.0	0.011197828299966068
chr8	TRIB1	125433610	125433768	0	159	0	4104	0	3945	0.0	0.0
chr8	AC087667.1	126325522	126325557	0	36	0	899	0	863	0.0	0.0
chr8	PCAT1	126713675	126713806	0	132	153	16754	153	16622	0.0	0.009204668511611117
chr8	PVT1	127796009	127796071	2	63	30944	23370	30942	23307	0.031746031746031744	1.3275839876431974
chr8	PVT1	128070273	128070361	0	89	30944	23370	30944	23281	0.0	1.3291525278123792
chr8	PVT1	127795163	127795294	0	132	30944	23370	30944	23238	0.0	1.3316120148033395
chr8	PVT1	127854796	127855319	0	524	30944	23370	30944	22846	0.0	1.3544602993959556
chr8	PVT1	128049442	128049748	0	307	30944	23370	30944	23063	0.0	1.3417161687551489
chr8	AC104257.1	131312730	131312748	0	19	612	989	612	970	0.0	0.6309278350515464
chr8	EFR3A	131940576	131940644	0	69	3134	6184	3134	6115	0.0	0.5125102207686018
chr8	EFR3A	131939945	131940219	0	275	3134	6184	3134	5909	0.0	0.5303773904213911
chr8	TG	132868224	132868254	0	31	4998	11185	4998	11154	0.0	0.4480903711672942
chr8	TG	133017867	133017997	0	131	4998	11185	4998	11054	0.0	0.4521440202641578
chr8	LINC01591	135234515	135234589	0	75	0	1348	0	1273	0.0	0.0
chr8	AC138647.1	141514764	141514775	290	12	10355	662	10065	650	24.166666666666668	15.484615384615385
chr8	ZFP41	143247143	143247749	0	607	0	6806	0	6199	0.0	0.0
chr8	ZNF696	143291611	143291767	0	157	0	5403	0	5246	0.0	0.0
chr8	ZNF707	143691200	143691232	0	33	2091	6052	2091	6019	0.0	0.34739990031566703
chr8	ZNF707	143684756	143685067	0	312	2091	6052	2091	5740	0.0	0.36428571428571427
chr8	GRINA	143991950	143992078	0	129	0	2462	0	2333	0.0	0.0
chr8	GRINA	143990200	143990311	0	112	0	2462	0	2350	0.0	0.0
chr8	EXOSC4	144080022	144080149	0	128	261	869	261	741	0.0	0.3522267206477733
chr8	GPAA1	144083425	144083500	0	76	1150	2761	1150	2685	0.0	0.42830540037243947
chr8	MAF1	144105150	144105460	0	311	2166	2299	2166	1988	0.0	1.0895372233400402
chr8	SLC52A2	144359321	144359423	0	103	156854	3711	156854	3608	0.0	43.4739467849224
chr8	SLC52A2	144358611	144358900	88654	290	156854	3711	68200	3421	305.70344827586206	19.935691318327976
chr8	SLC52A2	144358784	144358900	36847	117	156854	3711	120007	3594	314.9316239316239	33.39092932665554
chr8	SLC52A2	144358659	144358900	72198	242	156854	3711	84656	3469	298.3388429752066	24.403574517151917
chr8	SLC52A2	144358611	144358783	51807	173	156854	3711	105047	3538	299.46242774566474	29.691068400226115
chr8	SLC52A2	144358659	144358783	35351	125	156854	3711	121503	3586	282.808	33.88259899609593
chr8	SLC52A2	144358659	144359065	84797	407	156854	3711	72057	3304	208.34643734643734	21.80901937046005
chr8	SLC52A2	144358901	144359065	12599	165	156854	3711	144255	3546	76.35757575757576	40.68104906937394
chr8	SLC52A2	144358611	144359065	101253	455	156854	3711	55601	3256	222.53406593406592	17.076474201474202
chr8	SLC52A2	144358784	144359065	49446	282	156854	3711	107408	3429	175.3404255319149	31.32341790609507
chr8	SLC52A2	144359727	144359747	0	21	156854	3711	156854	3690	0.0	42.50785907859078
chr8	SLC52A2	144359424	144359521	0	98	156854	3711	156854	3613	0.0	43.413783559368945
chr8	SLC52A2	144359321	144359521	0	201	156854	3711	156854	3510	0.0	44.68774928774929
chr9	DOCK8	368136	368300	0	165	408	12921	408	12756	0.0	0.03198494825964252
chr9	DMRT2	1050483	1050775	0	293	0	3147	0	2854	0.0	0.0
chr9	SMARCA2	2086898	2087071	20420	174	536632	15566	516212	15392	117.35632183908046	33.53768191268191
chr9	SMARCA2	2016144	2016213	0	70	536632	15566	536632	15496	0.0	34.630356220960245
chr9	SMARCA2	2017498	2017502	5	5	536632	15566	536627	15561	1.0	34.485380116959064
chr9	SMARCA2	2017498	2017799	280	302	536632	15566	536352	15264	0.9271523178807947	35.138364779874216
chr9	SMARCA2	2017503	2017799	275	297	536632	15566	536357	15269	0.9259259259259259	35.12718580129675
chr9	SMARCA2	2159905	2159909	38	5	536632	15566	536594	15561	7.6	34.483259430627854
chr9	SMARCA2	2158554	2158594	646	41	536632	15566	535986	15525	15.75609756097561	34.52405797101449
chr9	SMARCA2	2158588	2158594	0	7	536632	15566	536632	15559	0.0	34.490134327398934
chr9	SMARCA2	2158497	2158594	1683	98	536632	15566	534949	15468	17.1734693877551	34.58423842772175
chr9	SMARCA2	2158497	2158553	1037	57	536632	15566	535595	15509	18.19298245614035	34.53446385969437
chr9	SMARCA2	2158554	2158587	646	34	536632	15566	535986	15532	19.0	34.508498583569406
chr9	SMARCA2	2158497	2158587	1683	91	536632	15566	534949	15475	18.494505494505493	34.56859450726979
chr9	SMARCA2	2158595	2158978	1063	384	536632	15566	535569	15182	2.7682291666666665	35.276577526017654
chr9	SMARCA2	2158554	2158978	1709	425	536632	15566	534923	15141	4.021176470588236	35.32943662902054
chr9	SMARCA2	2158588	2158978	1063	391	536632	15566	535569	15175	2.7186700767263425	35.292850082372325
chr9	SMARCA2	2158497	2158978	2746	482	536632	15566	533886	15084	5.6970954356846475	35.394192521877486
chr9	SMARCA2	2160620	2161035	0	416	536632	15566	536632	15150	0.0	35.42125412541254
chr9	LINC01231	3181890	3182447	0	558	0	5272	0	4714	0.0	0.0
chr9	CD274	5465540	5465606	3415	67	99950	4115	96535	4048	50.97014925373134	23.8475790513834
chr9	MLANA	5890937	5891302	0	366	3314	2885	3314	2519	0.0	1.315601429138547
chr9	MLANA	5891200	5891302	0	103	3314	2885	3314	2782	0.0	1.1912293314162472
chr9	UHRF2	6497269	6497360	18357	92	1005741	9898	987384	9806	199.5326086956522	100.69182133387721
chr9	LINC02851	6704344	6704366	0	23	0	540	0	517	0.0	0.0
chr9	CCDC171	16042887	16042920	27	34	15905	12235	15878	12201	0.7941176470588235	1.3013687402671912
chr9	CNTLN	17457629	17457715	0	87	257952	11092	257952	11005	0.0	23.43952748750568
chr9	FOCAD	20821062	20821071	299	10	131614	9254	131315	9244	29.9	14.205430549545651
chr9	MTAP	21802782	21802950	811	169	1046096	13923	1045285	13754	4.798816568047338	75.99861858368475
chr9	MTAP	21815520	21815544	0	25	1046096	13923	1046096	13898	0.0	75.2695351849187
chr9	TEK	27205063	27205065	0	3	5049	4828	5049	4825	0.0	1.0464248704663213
chr9	ACO1	32386439	32386442	0	4	689337	7577	689337	7573	0.0	91.02561732470619
chr9	AL356218.2	33401720	33401822	0	103	0	1471	0	1368	0.0	0.0
chr9	CYP4F26P	33603551	33604403	51	853	2147	3903	2096	3050	0.059788980070339975	0.6872131147540984
chr9	CYP4F26P	33604404	33604570	0	167	2147	3903	2147	3736	0.0	0.574678800856531
chr9	CNTFR-AS1	34569617	34569746	0	130	131	2607	131	2477	0.0	0.05288655631812677
chr9	IL11RA	34654000	34654019	390	20	208711	4224	208321	4204	19.5	49.55304471931494
chr9	DNAJB5	34990612	34990812	0	201	82612	3656	82612	3455	0.0	23.910853835021708
chr9	C9ORF131	35041157	35041440	2097	284	21650	3828	19553	3544	7.383802816901408	5.517212189616253
chr9	C9ORF131	35042381	35042485	454	105	21650	3828	21196	3723	4.3238095238095235	5.693258125167875
chr9	C9ORF131	35042486	35042565	2654	80	21650	3828	18996	3748	33.175	5.068303094983992
chr9	ATP8B5P	35433766	35433799	0	34	41844	6309	41844	6275	0.0	6.668366533864542
chr9	ATP8B5P	35409004	35409007	0	4	41844	6309	41844	6305	0.0	6.636637589214909
chr9	ATP8B5P	35471105	35471228	0	124	41844	6309	41844	6185	0.0	6.765400161681487
chr9	AL133410.1	35786776	35788036	2734	1261	14228	3404	11494	2143	2.1681205392545597	5.363509099393374
chr9	TMEM8B	35829320	35829391	139	72	221485	16232	221346	16160	1.9305555555555556	13.697153465346535
chr9	AL450267.2	36781894	36781897	0	4	0	5670	0	5666	0.0	0.0
chr9	EBLN3P	37080035	37080536	52811	502	1040114	7939	987303	7437	105.2011952191235	132.75554659136748
chr9	EBLN3P	37080031	37080536	52899	506	1040114	7939	987215	7433	104.54347826086956	132.81514866137496
chr9	EBLN3P	37080039	37080536	52779	498	1040114	7939	987335	7441	105.98192771084338	132.68848273081576
chr9	EBLN3P	37080031	37080034	88	4	1040114	7939	1040026	7935	22.0	131.06817895400127
chr9	EBLN3P	37080035	37080038	32	4	1040114	7939	1040082	7935	8.0	131.07523629489603
chr9	EBLN3P	37080031	37080038	120	8	1040114	7939	1039994	7931	15.0	131.13024839238432
chr9	EBLN3P	37080537	37084292	63392	3756	1040114	7939	976722	4183	16.877529286474974	233.49796796557496
chr9	EBLN3P	37080035	37084292	116203	4258	1040114	7939	923911	3681	27.290511977454205	250.9945666938332
chr9	EBLN3P	37080031	37084292	116291	4262	1040114	7939	923823	3677	27.28554669169404	251.2436769105249
chr9	EBLN3P	37080039	37084292	116171	4254	1040114	7939	923943	3685	27.30865068171133	250.73080054274084
chr9	EBLN3P	37081866	37084292	35134	2427	1040114	7939	1004980	5512	14.476308199423157	182.32583454281567
chr9	ZCCHC7	37120624	37120894	3370	271	304427	3974	301057	3703	12.435424354243542	81.30083715906022
chr9	GRHPR	37422806	37422833	24047	28	2994806	5783	2970759	5755	858.8214285714286	516.2048653344917
chr9	TRMT10B	37763754	37763865	4109	112	276821	2875	272712	2763	36.6875	98.7014115092291
chr9	BX664727.3	40284478	40284613	0	136	51	5288	51	5152	0.0	0.009899068322981366
chr9	FAM95B1	40324086	40324182	0	97	1333	2302	1333	2205	0.0	0.6045351473922902
chr9	FRG1HP	40992480	40992775	0	296	0	1712	0	1416	0.0	0.0
chr9	BX255923.1	41073854	41073973	0	120	0	658	0	538	0.0	0.0
chr9	ANKRD20A7P	42834196	42834260	0	65	0	7916	0	7851	0.0	0.0
chr9	ANKRD20A7P	42917413	42917416	0	4	0	7916	0	7912	0.0	0.0
chr9	FAM27C	62073111	62073117	0	7	0	12969	0	12962	0.0	0.0
chr9	FAM27C	62075752	62075755	0	4	0	12969	0	12965	0.0	0.0
chr9	FAM27C	61972564	61972670	0	107	0	12969	0	12862	0.0	0.0
chr9	BX005266.2	62532933	62533113	0	181	0	1733	0	1552	0.0	0.0
chr9	CBWD5	65695045	65695049	0	5	612	10606	612	10601	0.0	0.05773040279218942
chr9	CBWD5	65704415	65704547	0	133	612	10606	612	10473	0.0	0.0584359782297336
chr9	ZNF658	66900837	66901079	0	243	0	4852	0	4609	0.0	0.0
chr9	CBWD3	68260997	68261001	0	5	9568	10070	9568	10065	0.0	0.9506209637357178
chr9	TJP2	69205110	69205233	52	124	28876	10925	28824	10801	0.41935483870967744	2.668641792426627
chr9	TJP2	69205234	69205314	15	81	28876	10925	28861	10844	0.18518518518518517	2.6614717816303948
chr9	TJP2	69205234	69206261	11292	1028	28876	10925	17584	9897	10.98443579766537	1.776700010104072
chr9	TJP2	69205315	69206261	11277	947	28876	10925	17599	9978	11.908130939809926	1.7637803166967327
chr9	GDA	72248339	72248406	0	68	51	5582	51	5514	0.0	0.009249183895538629
chr9	ANXA1	73154341	73154342	0	2	0	4467	0	4465	0.0	0.0
chr9	VPS13A	77407608	77407659	0	52	51	20179	51	20127	0.0	0.0025339096735728125
chr9	CEP78	78236604	78236659	0	56	0	12902	0	12846	0.0	0.0
chr9	TLE4	79652795	79652798	0	4	51	8082	51	8078	0.0	0.006313443921762813
chr9	AL354733.2	83859326	83859335	0	10	0	3124	0	3114	0.0	0.0
chr9	AL354733.1	83837144	83837299	0	156	102	2486	102	2330	0.0	0.04377682403433476
chr9	RMI1	83980892	83981004	0	113	0	3416	0	3303	0.0	0.0
chr9	DAPK1	87497773	87498107	0	335	0	8937	0	8602	0.0	0.0
chr9	CTSL	87726254	87726308	0	55	0	5954	0	5899	0.0	0.0
chr9	CTSL	87725838	87726308	0	471	0	5954	0	5483	0.0	0.0
chr9	CTSL	87726250	87726308	0	59	0	5954	0	5895	0.0	0.0
chr9	CTSL	87725838	87726253	0	416	0	5954	0	5538	0.0	0.0
chr9	CTSL	87726250	87726253	0	4	0	5954	0	5950	0.0	0.0
chr9	CTSL	87725838	87726249	0	412	0	5954	0	5542	0.0	0.0
chr9	CTSL	87726254	87727729	0	1476	0	5954	0	4478	0.0	0.0
chr9	CTSL	87726254	87726398	0	145	0	5954	0	5809	0.0	0.0
chr9	CTSL	87726309	87726398	0	90	0	5954	0	5864	0.0	0.0
chr9	CTSL	87727396	87727468	0	73	0	5954	0	5881	0.0	0.0
chr9	CTSL	87726250	87726398	0	149	0	5954	0	5805	0.0	0.0
chr9	CTSL	87729736	87730498	0	763	0	5954	0	5191	0.0	0.0
chr9	CTSL	87726309	87727395	0	1087	0	5954	0	4867	0.0	0.0
chr9	CTSL	87726254	87727395	0	1142	0	5954	0	4812	0.0	0.0
chr9	CTSL	87726399	87727395	0	997	0	5954	0	4957	0.0	0.0
chr9	CTSL	87728810	87729085	0	276	0	5954	0	5678	0.0	0.0
chr9	CTSL3P	87772999	87773004	0	6	0	962	0	956	0.0	0.0
chr9	AL772337.3	87864229	87864349	0	121	0	689	0	568	0.0	0.0
chr9	S1PR3	88991185	88991241	0	57	866	13705	866	13648	0.0	0.06345252051582649
chr9	AL355607.2	90997121	90997124	0	4	6111	1533	6111	1529	0.0	3.99672988881622
chr9	PTPDC1	94084769	94084774	0	6	1428	6381	1428	6375	0.0	0.224
chr9	PCAT7	94555311	94555345	0	35	255	5914	255	5879	0.0	0.04337472359244769
chr9	AL449403.1	96093096	96093162	0	67	0	2230	0	2163	0.0	0.0
chr9	AL589843.1	96687146	96687324	0	179	51	2839	51	2660	0.0	0.019172932330827067
chr9	STRA6LP	97313337	97313345	0	9	706	7167	706	7158	0.0	0.09863090248672814
chr9	STRA6LP	97323904	97323938	0	35	706	7167	706	7132	0.0	0.09899046550757151
chr9	STRA6LP	97307372	97307551	0	180	706	7167	706	6987	0.0	0.10104479748103622
chr9	STX17	99907298	99907393	0	96	6048	8893	6048	8797	0.0	0.6875071046947823
chr9	STX17	99907099	99907393	0	295	6048	8893	6048	8598	0.0	0.7034193998604327
chr9	STX17	99907099	99907297	0	199	6048	8893	6048	8694	0.0	0.6956521739130435
chr9	RNF20	101533915	101533968	0	54	113840	4712	113840	4658	0.0	24.439673679690856
chr9	FKTN	105574279	105574332	0	54	191	17148	191	17094	0.0	0.011173511173511173
chr9	FKTN	105620062	105620092	0	31	191	17148	191	17117	0.0	0.01115849740024537
chr9	LINC01505	106588941	106589013	0	73	0	12891	0	12818	0.0	0.0
chr9	LINC01505	106500506	106500637	0	132	0	12891	0	12759	0.0	0.0
chr9	ZNF462	106924193	106929759	0	5567	0	9293	0	3726	0.0	0.0
chr9	ZNF462	106927165	106929759	0	2595	0	9293	0	6698	0.0	0.0
chr9	C9ORF43	113411002	113411138	0	137	0	2250	0	2113	0.0	0.0
chr9	COL27A1	114231859	114231866	0	8	47529	14073	47529	14065	0.0	3.3792392463562035
chr9	COL27A1	114252647	114252653	0	7	47529	14073	47529	14066	0.0	3.3789990046921656
chr9	ATP6V1G1	114592653	114592657	0	5	434	3459	434	3454	0.0	0.12565141864504922
chr9	ATP6V1G1	114587921	114588118	0	198	434	3459	434	3261	0.0	0.1330880098129408
chr9	CUTALP	120845474	120845620	59347	147	3518025	7206	3458678	7059	403.72108843537416	489.9671341549795
chr9	CUTALP	120845474	120845887	59477	414	3518025	7206	3458548	6792	143.66425120772948	509.2090694935218
chr9	CUTALP	120845621	120845887	130	267	3518025	7206	3517895	6939	0.4868913857677903	506.9743478887448
chr9	CUTALP	120845827	120845887	0	61	3518025	7206	3518025	7145	0.0	492.3757872638208
chr9	CUTALP	120846804	120846861	0	58	3518025	7206	3518025	7148	0.0	492.1691382204813
chr9	CNTRL	121150306	121150483	0	178	0	9472	0	9294	0.0	0.0
chr9	GSN	121326683	121326792	0	110	0	7205	0	7095	0.0	0.0
chr9	MRRF	122265546	122265780	0	235	204	11044	204	10809	0.0	0.01887316125451013
chr9	PTGS1	122386622	122386732	102	111	102	5785	0	5674	0.918918918918919	0.0
chr9	RABGAP1	123065462	123065601	0	140	117	7090	117	6950	0.0	0.01683453237410072
chr9	NEK6	124261580	124261583	0	4	1580	4451	1580	4447	0.0	0.35529570496964247
chr9	ADGRD2	124455098	124455127	0	30	2969	4523	2969	4493	0.0	0.6608056977520588
chr9	ADGRD2	124452155	124452158	0	4	2969	4523	2969	4519	0.0	0.6570037618942244
chr9	GAPVD1	125321500	125321562	0	63	467	13657	467	13594	0.0	0.034353391202000885
chr9	GAPVD1	125332018	125332060	0	43	467	13657	467	13614	0.0	0.03430292346114294
chr9	GAPVD1	125346942	125346995	0	54	467	13657	467	13603	0.0	0.034330662353892524
chr9	LMX1B	126693813	126693845	0	33	6380	6353	6380	6320	0.0	1.009493670886076
chr9	LMX1B	126695983	126696003	0	21	6380	6353	6380	6332	0.0	1.0075805432722678
chr9	RALGPS1	126914976	126915012	0	37	120190	10527	120190	10490	0.0	11.457578646329837
chr9	RALGPS1	126914998	126915012	0	15	120190	10527	120190	10512	0.0	11.433599695585997
chr9	RALGPS1	126914976	126914997	0	22	120190	10527	120190	10505	0.0	11.441218467396478
chr9	GARNL3	127224639	127224691	0	53	331	6297	331	6244	0.0	0.053010890454836646
chr9	GARNL3	127243250	127243253	0	4	331	6297	331	6293	0.0	0.0525981249006833
chr9	ZNF79	127424804	127424910	255	107	5481	2308	5226	2201	2.383177570093458	2.3743752839618355
chr9	LRSAM1	127455041	127455054	0	14	17882	8123	17882	8109	0.0	2.205204094216303
chr9	LRSAM1	127495415	127495418	48	4	17882	8123	17834	8119	12.0	2.1965759329966743
chr9	LRSAM1	127497335	127497362	0	28	17882	8123	17882	8095	0.0	2.209017912291538
chr9	LRSAM1	127485836	127485840	12	5	17882	8123	17870	8118	2.4	2.2012811037201283
chr9	STXBP1	127611857	127612047	0	191	109863	8749	109863	8558	0.0	12.837462023837345
chr9	CFAP157	127711931	127711950	0	20	38262	3233	38262	3213	0.0	11.908496732026144
chr9	AL162586.1	127818386	127818389	0	4	7762	2158	7762	2154	0.0	3.603528319405757
chr9	AL157935.1	127938125	127938274	0	150	6465	2525	6465	2375	0.0	2.7221052631578946
chr9	AL157935.1	127938125	127938213	0	89	6465	2525	6465	2436	0.0	2.6539408866995076
chr9	AL157935.1	127938275	127938662	51	388	6465	2525	6414	2137	0.13144329896907217	3.00140383715489
chr9	DNM1	128226087	128226173	0	87	7108	9109	7108	9022	0.0	0.7878519175349147
chr9	ODF2	128455229	128455336	1184	108	21668	6418	20484	6310	10.962962962962964	3.2462757527733754
chr9	ODF2	128461011	128461067	0	57	21668	6418	21668	6361	0.0	3.4063826442383274
chr9	ODF2	128496142	128496297	0	156	21668	6418	21668	6262	0.0	3.4602363462152668
chr9	SPTAN1	128553363	128553382	0	20	7922	15464	7922	15444	0.0	0.512950012950013
chr9	SPTAN1	128624488	128624824	1326	337	7922	15464	6596	15127	3.934718100890208	0.43604151517154754
chr9	PHYHD1	128921602	128921668	0	67	0	2479	0	2412	0.0	0.0
chr9	PHYHD1	128937779	128937944	0	166	0	2479	0	2313	0.0	0.0
chr9	MIGA2	129068333	129068975	0	643	12	6138	12	5495	0.0	0.002183803457688808
chr9	PTPA	129120611	129120628	0	18	3929	5645	3929	5627	0.0	0.698240625555358
chr9	PTPA	129142083	129142117	0	35	3929	5645	3929	5610	0.0	0.7003565062388591
chr9	PTPA	129142083	129142177	0	95	3929	5645	3929	5550	0.0	0.7079279279279279
chr9	PTPA	129142118	129142177	0	60	3929	5645	3929	5585	0.0	0.7034914950760967
chr9	LINC00963	129502520	129503139	0	620	201	11349	201	10729	0.0	0.01873427160033554
chr9	LINC00963	129503140	129503672	0	533	201	11349	201	10816	0.0	0.018583579881656806
chr9	NTMT1	129632802	129632865	0	64	2598	3032	2598	2968	0.0	0.8753369272237197
chr9	NTMT1	129634222	129634306	0	85	2598	3032	2598	2947	0.0	0.8815744825246012
chr9	NTMT1	129626296	129626321	0	26	2598	3032	2598	3006	0.0	0.8642714570858283
chr9	USP20	129835500	129835597	51	98	127	5449	76	5351	0.5204081632653061	0.014202952719117921
chr9	GPR107	130077375	130077378	0	4	9323	8332	9323	8328	0.0	1.1194764649375601
chr9	HMCN2	130393303	130393309	0	7	114869	18709	114869	18702	0.0	6.142070366805689
chr9	ASS1	130444996	130445198	1608	203	64071	2714	62463	2511	7.921182266009852	24.87574671445639
chr9	LAMC3	131085700	131085723	2354	24	388821	8969	386467	8945	98.08333333333333	43.2048071548351
chr9	AIF1L	131114595	131114618	0	24	145827	4638	145827	4614	0.0	31.605331599479843
chr9	AIF1L	131117848	131117918	786	71	145827	4638	145041	4567	11.070422535211268	31.75848478213269
chr9	NUP214	131197417	131199015	29380	1599	263360	12057	233980	10458	18.3739837398374	22.373302734748517
chr9	NUP214	131190173	131190480	2805	308	263360	12057	260555	11749	9.107142857142858	22.176781002638524
chr9	POMT1	131509997	131510062	46	66	54510	6345	54464	6279	0.696969696969697	8.673992673992673
chr9	POMT1	131503074	131503313	15872	240	54510	6345	38638	6105	66.13333333333334	6.328910728910729
chr9	POMT1	131511468	131511472	0	5	54510	6345	54510	6340	0.0	8.597791798107256
chr9	POMT1	131504341	131504649	0	309	54510	6345	54510	6036	0.0	9.030815109343937
chr9	RPL7A	133348389	133348573	0	185	867	1678	867	1493	0.0	0.5807099799062291
chr9	RPL7A	133348574	133348817	0	244	867	1678	867	1434	0.0	0.604602510460251
chr9	RPL7A	133348389	133348817	0	429	867	1678	867	1249	0.0	0.6941553242594075
chr9	ADAMTS13	133455436	133455603	709	168	15942	5712	15233	5544	4.220238095238095	2.7476551226551225
chr9	ADAMTS13	133430102	133430181	0	80	15942	5712	15942	5632	0.0	2.8306107954545454
chr9	AL353611.1	134937191	134937433	0	243	0	1323	0	1080	0.0	0.0
chr9	OLFM1	135087728	135088139	0	412	51	6137	51	5725	0.0	0.00890829694323144
chr9	AL353615.1	135353309	135353328	0	20	0	515	0	495	0.0	0.0
chr9	AL353615.1	135352718	135352755	0	38	0	515	0	477	0.0	0.0
chr9	PAEP	135565802	135565830	3937	29	96857	1461	92920	1432	135.75862068965517	64.88826815642459
chr9	PTGDS	136979300	136979401	0	102	549	2391	549	2289	0.0	0.2398427260812582
chr9	MAN1B1	137087219	137087363	0	145	0	7364	0	7219	0.0	0.0
chr9	GRIN1	137164216	137164987	0	772	102	9609	102	8837	0.0	0.011542378635283467
chr9	SSNA1	137189152	137189265	0	114	0	1156	0	1042	0.0	0.0
chr9	NDOR1	137216167	137216188	0	22	78	2822	78	2800	0.0	0.027857142857142858
chr9	SLC34A3	137230939	137231044	0	106	51	2317	51	2211	0.0	0.023066485753052916
chr9	SLC34A3	137230939	137231079	0	141	51	2317	51	2176	0.0	0.0234375
chr9	SLC34A3	137231045	137231079	0	35	51	2317	51	2282	0.0	0.022348816827344433
chr9	STPG3	137252056	137252135	0	80	408	1512	408	1432	0.0	0.2849162011173184
chr9	ARRDC1	137614899	137615000	0	102	1137	2585	1137	2483	0.0	0.45791381393475633
chr9	ARRDC1	137613007	137613510	51	504	1137	2585	1086	2081	0.10119047619047619	0.5218644882268141
chr9	EHMT1	137728530	137728593	192	64	49991	18118	49799	18054	3.0	2.758336102802703
chr9	EHMT1	137717183	137717273	0	91	49991	18118	49991	18027	0.0	2.7731181006268377
chr9	TUBBP5	138175712	138175901	0	190	0	2496	0	2306	0.0	0.0
chr9	CBWD1	150508	150640	25	133	126699	10402	126674	10269	0.18796992481203006	12.335573084039341
chr9	AL161725.1	454438	454505	0	68	51	4028	51	3960	0.0	0.012878787878787878
chr9	AL161725.1	466687	466898	0	212	51	4028	51	3816	0.0	0.013364779874213837
chr9	VLDLR-AS1	2493074	2493238	0	165	57440	6797	57440	6632	0.0	8.661037394451146
chr9	VLDLR-AS1	2506358	2506417	0	60	57440	6797	57440	6737	0.0	8.526050170699124
chr9	SPATA6L	4625216	4625325	0	110	30426	5395	30426	5285	0.0	5.757048249763481
chr9	ERMP1	5832453	5832688	0	236	656103	6309	656103	6073	0.0	108.03606125473407
chr9	RANBP6	6015412	6015470	2213	59	17635	1015	15422	956	37.50847457627118	16.131799163179917
chr9	GLDC	6622784	6622917	173	134	390166	8660	389993	8526	1.291044776119403	45.74161388693408
chr9	AL589678.1	12159029	12159115	0	87	0	566	0	479	0.0	0.0
chr9	MPDZ	13219558	13219654	290	97	174452	9138	174162	9041	2.9896907216494846	19.26357703793828
chr9	MPDZ	13139904	13139985	0	82	174452	9138	174452	9056	0.0	19.2636925795053
chr9	LINC01235	13416299	13416397	0	99	0	3029	0	2930	0.0	0.0
chr9	NFIB	14306988	14307212	8539	225	384508	12775	375969	12550	37.95111111111111	29.95768924302789
chr9	NFIB	14116180	14116206	30	27	384508	12775	384478	12748	1.1111111111111112	30.159868214621902
chr9	NFIB	14307907	14307918	0	12	384508	12775	384508	12763	0.0	30.12677270234271
chr9	TTC39B	15224339	15224358	0	20	67502	12232	67502	12212	0.0	5.527513920733704
chr9	RPS6	19380087	19380188	11178	102	14400135	2232	14388957	2130	109.58823529411765	6755.378873239437
chr9	MIR31HG	21559488	21559746	1009	259	130177	2820	129168	2561	3.8957528957528957	50.43654822335025
chr9	CDKN2A	21970901	21970974	356944	74	2467635	3894	2110691	3820	4823.5675675675675	552.5369109947644
chr9	CDKN2A	21974403	21974676	42	274	2467635	3894	2467593	3620	0.15328467153284672	681.6555248618785
chr9	CDKN2A	21971328	21971333	6	6	2467635	3894	2467629	3888	1.0	634.6782407407408
chr9	CDKN2B	22008674	22008796	138	123	263504	4002	263366	3879	1.1219512195121952	67.89533384893014
chr9	CAAP1	26892258	26892411	4732	154	294218	3168	289486	3014	30.727272727272727	96.04711347047113
chr9	C9ORF72	27573708	27573785	46	78	66856	5415	66810	5337	0.5897435897435898	12.518268690275436
chr9	C9ORF72	27573708	27573722	30	15	66856	5415	66826	5400	2.0	12.375185185185185
chr9	APTX	32988082	32988090	1771	9	512100	14598	510329	14589	196.77777777777777	34.98039618890945
chr9	APTX	32987543	32987758	47289	216	512100	14598	464811	14382	218.93055555555554	32.31894034209429
chr9	APTX	33001515	33001565	2409	51	512100	14598	509691	14547	47.23529411764706	35.03753351206434
chr9	APTX	33024803	33025021	3377	219	512100	14598	508723	14379	15.420091324200913	35.3795813338897
chr9	APTX	33024803	33024998	2744	196	512100	14598	509356	14402	14.0	35.36703235661714
chr9	APTX	33001332	33001514	3234	183	512100	14598	508866	14415	17.672131147540984	35.301144640998956
chr9	APTX	33001332	33001565	5643	234	512100	14598	506457	14364	24.115384615384617	35.25877192982456
chr9	APTX	33024999	33025021	633	23	512100	14598	511467	14575	27.52173913043478	35.09207547169812
chr9	BAG1	33264223	33264274	22498	52	652968	7084	630470	7032	432.65384615384613	89.65728100113766
chr9	BAG1	33264205	33264222	529	18	652968	7084	652439	7066	29.38888888888889	92.33498443249363
chr9	BAG1	33264205	33264274	23027	70	652968	7084	629941	7014	328.95714285714286	89.81194753350442
chr9	AQP7	33393796	33394125	0	330	0	3491	0	3161	0.0	0.0
chr9	AQP3	33443178	33443319	0	142	0	2489	0	2347	0.0	0.0
chr9	UBAP2	34048824	34048876	4576	53	1026072	8530	1021496	8477	86.33962264150944	120.50206440957886
chr9	C9ORF24	34380896	34381054	247	159	675	1424	428	1265	1.5534591194968554	0.3383399209486166
chr9	C9ORF24	34380896	34380900	0	5	675	1424	675	1419	0.0	0.47568710359408034
chr9	C9ORF24	34380901	34381054	247	154	675	1424	428	1270	1.603896103896104	0.33700787401574805
chr9	FAM219A	34405864	34405914	1372	51	537607	3788	536235	3737	26.901960784313726	143.4934439389885
chr9	FAM219A	34458203	34458235	6493	33	537607	3788	531114	3755	196.75757575757575	141.44181091877496
chr9	RPP25L	34611859	34612062	16793	204	322840	890	306047	686	82.31862745098039	446.1326530612245
chr9	SIGMAR1	34637219	34637265	49348	47	1881737	1897	1832389	1850	1049.9574468085107	990.4805405405406
chr9	FAM205C	34892658	34893048	0	391	0	1362	0	971	0.0	0.0
chr9	VCP	35072276	35072335	3197	60	5212149	8455	5208952	8395	53.28333333333333	620.4826682549136
chr9	PIGO	35096154	35096559	2717	406	837939	4627	835222	4221	6.692118226600985	197.87301587301587
chr9	FAM214B	35115670	35115803	2934	134	615439	3855	612505	3721	21.895522388059703	164.6076323568933
chr9	CD72	35618221	35618270	0	50	50728	2901	50728	2851	0.0	17.793055068397052
chr9	SPAG8	35812103	35812108	0	6	101098	2480	101098	2474	0.0	40.864187550525465
chr9	SPAG8	35811181	35811922	9078	742	101098	2480	92020	1738	12.234501347708894	52.945914844649025
chr9	SPAG8	35811181	35811755	8976	575	101098	2480	92122	1905	15.610434782608696	48.35800524934383
chr9	SPAG8	35809403	35810245	83313	843	101098	2480	17785	1637	98.82918149466192	10.864386072083079
chr9	SPAG8	35811756	35811922	102	167	101098	2480	100996	2313	0.6107784431137725	43.66450497189797
chr9	HINT2	35814898	35815005	3447	108	397866	1114	394419	1006	31.916666666666668	392.0666003976143
chr9	FAM221B	35819196	35819373	0	178	0	3950	0	3772	0.0	0.0
chr9	AL512604.2	37114544	37114883	0	340	842	1825	842	1485	0.0	0.567003367003367
chr9	TOMM5	37588752	37588809	111204	58	1084230	3610	973026	3552	1917.3103448275863	273.9375
chr9	TOMM5	37592309	37592410	7538	102	1084230	3610	1076692	3508	73.90196078431373	306.9247434435576
chr9	TOMM5	37592252	37592308	507	57	1084230	3610	1083723	3553	8.894736842105264	305.0163242330425
chr9	TOMM5	37592252	37592410	8045	159	1084230	3610	1076185	3451	50.59748427672956	311.8472906403941
chr9	TOMM5	37592252	37592289	24	38	1084230	3610	1084206	3572	0.631578947368421	303.5291153415454
chr9	TOMM5	37592290	37592308	483	19	1084230	3610	1083747	3591	25.42105263157895	301.7953216374269
chr9	TOMM5	37592290	37592410	8021	121	1084230	3610	1076209	3489	66.2892561983471	308.4577242762969
chr9	SLC25A51	37903530	37904066	10008	537	407808	3402	397800	2865	18.636871508379887	138.84816753926702
chr9	FAM95C	38541288	38541454	4280	167	137254	3767	132974	3600	25.62874251497006	36.937222222222225
chr9	CNTNAP3	39103713	39103742	145	30	319969	8468	319824	8438	4.833333333333333	37.90282057359564
chr9	AQP7P5	40491214	40491225	0	12	0	1056	0	1044	0.0	0.0
chr9	AQP7P5	40497565	40497567	0	3	0	1056	0	1053	0.0	0.0
chr9	BX255923.2	41103684	41104466	357	783	408	4157	51	3374	0.4559386973180077	0.015115589804386485
chr9	CBWD6	41160804	41160936	0	133	0	9106	0	8973	0.0	0.0
chr9	CBWD6	41170278	41170282	0	5	0	9106	0	9101	0.0	0.0
chr9	CNTNAP3B	41908556	41908608	0	53	7500	11751	7500	11698	0.0	0.6411352367926141
chr9	LERFS	62897418	62897527	0	110	0	5599	0	5489	0.0	0.0
chr9	LERFS	62869076	62869188	0	113	0	5599	0	5486	0.0	0.0
chr9	LERFS	62869096	62869188	0	93	0	5599	0	5506	0.0	0.0
chr9	LERFS	62869076	62869095	0	20	0	5599	0	5579	0.0	0.0
chr9	PGM5-AS1	68357602	68357721	0	120	0	2358	0	2238	0.0	0.0
chr9	C9ORF135-DT	69820552	69820648	0	97	0	2093	0	1996	0.0	0.0
chr9	C9ORF135-DT	69820556	69820648	0	93	0	2093	0	2000	0.0	0.0
chr9	TRPM3	70590994	70591029	0	36	5456	14073	5456	14037	0.0	0.38868704139061055
chr9	CEMIP2	71730704	71730737	0	34	7737	9281	7737	9247	0.0	0.8367037958256732
chr9	LINC01474	72874015	72874066	1247	52	5702	1268	4455	1216	23.98076923076923	3.663651315789474
chr9	AL512634.1	79136626	79137030	0	405	102	2916	102	2511	0.0	0.04062126642771804
chr9	LNCARSR	79567627	79567630	0	4	1428	4277	1428	4273	0.0	0.3341914345892815
chr9	TLE1	81613376	81613420	0	45	0	5206	0	5161	0.0	0.0
chr9	TLE1	81615981	81616019	0	39	0	5206	0	5167	0.0	0.0
chr9	TLE1	81652183	81652212	0	30	0	5206	0	5176	0.0	0.0
chr9	AL158154.3	81973940	81974080	0	141	0	2213	0	2072	0.0	0.0
chr9	AL583827.1	85401454	85402545	0	1092	140	4823	140	3731	0.0	0.0375234521575985
chr9	AL583827.1	85401454	85401683	0	230	140	4823	140	4593	0.0	0.0304811669932506
chr9	AL353743.2	85803437	85804573	0	1137	255	7271	255	6134	0.0	0.04157156830779263
chr9	AL353743.2	85787825	85787882	0	58	255	7271	255	7213	0.0	0.035352835158741165
chr9	AL353743.2	85803269	85803436	0	168	255	7271	255	7103	0.0	0.03590032380684218
chr9	AL353743.2	85804256	85804573	0	318	255	7271	255	6953	0.0	0.03667481662591687
chr9	AL353743.2	85786283	85786436	0	154	255	7271	255	7117	0.0	0.0358297035267669
chr9	AL353743.2	85791482	85791485	0	4	255	7271	255	7267	0.0	0.03509013348011559
chr9	AL353743.2	85803269	85804573	0	1305	255	7271	255	5966	0.0	0.04274220583305397
chr9	C9ORF153	86227543	86227853	0	311	2196	2935	2196	2624	0.0	0.836890243902439
chr9	LINC02843	88647222	88647345	0	124	6570	1616	6570	1492	0.0	4.403485254691689
chr9	LINC02843	88647214	88647221	0	8	6570	1616	6570	1608	0.0	4.085820895522388
chr9	LINC02843	88647214	88647345	0	132	6570	1616	6570	1484	0.0	4.42722371967655
chr9	LINC01501	90501591	90501637	0	47	14093	4017	14093	3970	0.0	3.549874055415617
chr9	DIRAS2	90625875	90626056	17	182	272	4446	255	4264	0.09340659340659341	0.05980300187617261
chr9	ROR2	91757271	91757427	0	157	11603	5898	11603	5741	0.0	2.02107646751437
chr9	IARS1	92293440	92293609	0	170	51	7080	51	6910	0.0	0.007380607814761216
chr9	NOL8	92325305	92325316	0	12	0	7731	0	7719	0.0	0.0
chr9	NOL8	92325317	92325567	0	251	0	7731	0	7480	0.0	0.0
chr9	NOL8	92324905	92325304	0	400	0	7731	0	7331	0.0	0.0
chr9	NOL8	92324905	92325316	0	412	0	7731	0	7319	0.0	0.0
chr9	NOL8	92324905	92325178	0	274	0	7731	0	7457	0.0	0.0
chr9	NOL8	92324022	92324607	0	586	0	7731	0	7145	0.0	0.0
chr9	NOL8	92325179	92325304	0	126	0	7731	0	7605	0.0	0.0
chr9	NOL8	92325179	92325316	0	138	0	7731	0	7593	0.0	0.0
chr9	ZNF484	92877819	92877888	0	70	0	4816	0	4746	0.0	0.0
chr9	FAM120AOS	93452146	93452738	0	593	102	9563	102	8970	0.0	0.01137123745819398
chr9	FAM120AOS	93450741	93450943	0	203	102	9563	102	9360	0.0	0.010897435897435897
chr9	FANCC	95316795	95316830	0	36	13019	11365	13019	11329	0.0	1.1491746844381676
chr9	PTCH1	95507933	95507949	432	17	103303	17222	102871	17205	25.41176470588235	5.97913397268236
chr9	PTCH1	95516468	95516621	510	154	103303	17222	102793	17068	3.311688311688312	6.022556831497539
chr9	PTCH1	95507228	95507230	0	3	103303	17222	103303	17219	0.0	5.999361170799698
chr9	LINC00476	95874979	95875863	57469	885	105348	6299	47879	5414	64.9367231638418	8.843553749538234
chr9	LINC00476	95874508	95874978	12497	471	105348	6299	92851	5828	26.532908704883226	15.93188057652711
chr9	LINC00092	96027664	96027872	0	209	0	4626	0	4417	0.0	0.0
chr9	PRXL2C	96655089	96655250	0	162	0	2942	0	2780	0.0	0.0
chr9	ZNF510	96777581	96778032	0	452	0	5475	0	5023	0.0	0.0
chr9	TSTD2	97627305	97627396	864	92	2179	5679	1315	5587	9.391304347826088	0.2353678181492751
chr9	XPA	97697120	97697222	969	103	4232	1824	3263	1721	9.407766990291263	1.8959907030796048
chr9	PTCSC2	97805361	97805486	0	126	1348	2293	1348	2167	0.0	0.6220581449007845
chr9	PTCSC2	97805361	97805838	0	478	1348	2293	1348	1815	0.0	0.7426997245179063
chr9	TRMO	97910917	97912871	13882	1955	15565	4155	1683	2200	7.10076726342711	0.765
chr9	ANKS6	98736495	98736525	0	31	27296	8688	27296	8657	0.0	3.153055330946055
chr9	AL136084.1	98870802	98870889	0	88	0	4560	0	4472	0.0	0.0
chr9	AL136084.1	98869964	98869979	0	16	0	4560	0	4544	0.0	0.0
chr9	AL136084.1	98872062	98872187	0	126	0	4560	0	4434	0.0	0.0
chr9	AL136084.1	98871957	98872187	0	231	0	4560	0	4329	0.0	0.0
chr9	NAMA	99360387	99360388	0	2	1825	5398	1825	5396	0.0	0.33821349147516677
chr9	NAMA	99370853	99371011	0	159	1825	5398	1825	5239	0.0	0.3483489215499141
chr9	TEX10	100346693	100347165	0	473	86	6807	86	6334	0.0	0.01357751815598358
chr9	BAAT	101362880	101362921	0	42	5763	4742	5763	4700	0.0	1.2261702127659575
chr9	CT70	104990811	104990815	0	5	0	2692	0	2687	0.0	0.0
chr9	CT70	104991683	104991684	0	2	0	2692	0	2690	0.0	0.0
chr9	CT70	104991653	104991684	0	32	0	2692	0	2660	0.0	0.0
chr9	CT70	104991653	104991682	0	30	0	2692	0	2662	0.0	0.0
chr9	ELP1	108896890	108896951	0	62	379	16260	379	16198	0.0	0.023397950364242498
chr9	ELP1	108881662	108881703	0	42	379	16260	379	16218	0.0	0.023369096066099396
chr9	TMEM245	109073247	109073354	0	108	51	9521	51	9413	0.0	0.005418038882396685
chr9	PTPN3	109383306	109383421	0	116	0	7175	0	7059	0.0	0.0
chr9	ECPAS	111483984	111484114	0	131	139	7307	139	7176	0.0	0.019370122630992196
chr9	LRRC37A5P	111612997	111613512	0	516	23555	2329	23555	1813	0.0	12.992277992277993
chr9	AL138756.1	112036650	112036681	0	32	10	7126	10	7094	0.0	0.00140964195094446
chr9	PTBP3	112297831	112297839	0	9	12773	8252	12773	8243	0.0	1.549557200048526
chr9	SLC46A2	112889552	112889723	0	172	0	2297	0	2125	0.0	0.0
chr9	WDR31	113331906	113331976	0	71	102	4343	102	4272	0.0	0.023876404494382022
chr9	AL691420.1	115742814	115742951	37	138	3702	2999	3665	2861	0.26811594202898553	1.281020622160084
chr9	ASTN2	116686696	116687064	0	369	49233	8314	49233	7945	0.0	6.196727501573316
chr9	ASTN2	116425854	116425874	0	21	49233	8314	49233	8293	0.0	5.936693597009526
chr9	CDK5RAP2	120571973	120571975	0	3	0	9012	0	9009	0.0	0.0
chr9	PHF19	120862587	120862611	0	25	0	6613	0	6588	0.0	0.0
chr9	LHX6	122227799	122228305	0	507	0	5315	0	4808	0.0	0.0
chr9	RC3H2	122851080	122851098	0	19	102	11585	102	11566	0.0	0.008818952100985648
chr9	RPL35	124858275	124858456	0	182	0	1186	0	1004	0.0	0.0
chr9	MAPKAP1	125672315	125672398	24	84	1878	6398	1854	6314	0.2857142857142857	0.29363319607222044
chr9	TOR2A	127732563	127733383	102	821	816	2500	714	1679	0.12423873325213154	0.4252531268612269
chr9	SH2D3C	127778590	127778594	0	5	1211	4525	1211	4520	0.0	0.2679203539823009
chr9	SH2D3C	127755078	127755083	0	6	1211	4525	1211	4519	0.0	0.2679796415136092
chr9	SH2D3C	127762120	127762390	798	271	1211	4525	413	4254	2.944649446494465	0.09708509637987776
chr9	SH2D3C	127762120	127762130	0	11	1211	4525	1211	4514	0.0	0.268276473194506
chr9	ST6GALNAC6	127890636	127890654	0	19	18767	5316	18767	5297	0.0	3.542948838965452
chr9	PIP5KL1	127921221	127921371	28	151	2124	2806	2096	2655	0.18543046357615894	0.7894538606403013
chr9	PIP5KL1	127925866	127925956	0	91	2124	2806	2124	2715	0.0	0.7823204419889502
chr9	PTGES2	128123701	128123724	0	24	118958	4049	118958	4025	0.0	29.554782608695653
chr9	PTGES2	128125895	128126228	8829	334	118958	4049	110129	3715	26.434131736526947	29.64441453566622
chr9	CIZ1	128169051	128169074	0	24	42315	7924	42315	7900	0.0	5.35632911392405
chr9	CIZ1	128179072	128179242	0	171	42315	7924	42315	7753	0.0	5.457887269444086
chr9	CIZ1	128178988	128179071	0	84	42315	7924	42315	7840	0.0	5.397321428571429
chr9	CIZ1	128178988	128179242	0	255	42315	7924	42315	7669	0.0	5.517668535663059
chr9	CIZ1	128204067	128204184	280	118	42315	7924	42035	7806	2.3728813559322033	5.38496028695875
chr9	CIZ1	128191279	128191430	0	152	42315	7924	42315	7772	0.0	5.444544518785383
chr9	ZDHHC12	128723951	128723992	44	42	4995	1337	4951	1295	1.0476190476190477	3.8231660231660234
chr9	ZER1	128771580	128771813	0	234	0	4387	0	4153	0.0	0.0
chr9	CRAT	129095997	129096068	0	72	492	3826	492	3754	0.0	0.13106020245071923
chr9	FAM78A	131270275	131270458	290	184	333931	4484	333641	4300	1.576086956521739	77.59093023255814
chr9	UCK1	131531066	131531092	0	27	4342	2576	4342	2549	0.0	1.7034131031777167
chr9	TSC1	132897422	132897426	1265	5	755473	16580	754208	16575	253.0	45.50274509803921
chr9	TSC1	132901588	132901629	6323	42	755473	16580	749150	16538	150.54761904761904	45.29870601040029
chr9	TSC1	132944542	132944570	0	29	755473	16580	755473	16551	0.0	45.64515739230258
chr9	TSC1	132944542	132944545	0	4	755473	16580	755473	16576	0.0	45.57631515444015
chr9	TSC1	132944546	132944570	0	25	755473	16580	755473	16555	0.0	45.634128662035636
chr9	TSC1	132911409	132911451	0	43	755473	16580	755473	16537	0.0	45.683799963717725
chr9	MED22	133345171	133345188	0	18	2808	7240	2808	7222	0.0	0.38881196344502905
chr9	MED22	133347921	133347940	0	20	2808	7240	2808	7220	0.0	0.3889196675900277
chr9	MED22	133347921	133348033	0	113	2808	7240	2808	7127	0.0	0.39399466816332257
chr9	MED22	133347159	133347562	0	404	2808	7240	2808	6836	0.0	0.41076653013458164
chr9	MED22	133347941	133348033	0	93	2808	7240	2808	7147	0.0	0.39289212256891004
chr9	MED22	133347913	133347920	0	8	2808	7240	2808	7232	0.0	0.38827433628318586
chr9	MED22	133347913	133347940	0	28	2808	7240	2808	7212	0.0	0.389351081530782
chr9	SLC2A6	133476232	133476235	0	4	20983	2985	20983	2981	0.0	7.038913116403891
chr9	TMEM250	136117865	136118070	0	206	51	3403	51	3197	0.0	0.01595245542696278
chr9	ENTR1	136405090	136405116	0	27	0	2733	0	2706	0.0	0.0
chr9	ENTR1	136409873	136410088	0	216	0	2733	0	2517	0.0	0.0
chr9	SEC16A	136463462	136463584	0	123	0	10006	0	9883	0.0	0.0
chr9	LINC01451	136614123	136615093	0	971	2295	1669	2295	698	0.0	3.2879656160458453
chr9	AL590226.1	136660320	136660323	0	4	11647	1360	11647	1356	0.0	8.589233038348082
chr9	LCN10	136741655	136741879	0	225	3162	3360	3162	3135	0.0	1.0086124401913876
chr9	FBXW5	136941754	136942044	0	291	116248	3222	116248	2931	0.0	39.661548959399525
chr9	FBXW5	136941754	136942098	0	345	116248	3222	116248	2877	0.0	40.40597844977407
chr9	FBXW5	136942045	136942098	0	54	116248	3222	116248	3168	0.0	36.69444444444444
chr9	ABCA2	137010192	137010618	171	427	786526	10294	786355	9867	0.40046838407494145	79.69544947805818
chr9	DPP7	137111872	137111939	0	68	0	2550	0	2482	0.0	0.0
chr9	TMEM210	137171881	137171938	0	58	0	790	0	732	0.0	0.0
chr9	EXD3	137354566	137354698	0	133	9659	7522	9659	7389	0.0	1.3072134253620247
chr9	DPH7	137577469	137577575	1530	107	1648	4023	118	3916	14.299065420560748	0.03013278855975485
chr10	TUBB8	48614	48717	0	104	0	2879	0	2775	0.0	0.0
chr10	TUBB8	48718	48802	0	85	0	2879	0	2794	0.0	0.0
chr10	TUBB8	48424	48613	0	190	0	2879	0	2689	0.0	0.0
chr10	TUBB8	48424	48717	0	294	0	2879	0	2585	0.0	0.0
chr10	TUBB8	48614	48802	0	189	0	2879	0	2690	0.0	0.0
chr10	LARP4B	814636	814740	0	105	68343	8723	68343	8618	0.0	7.930262241819448
chr10	IDI1	1048263	1048862	204	600	8799	4349	8595	3749	0.34	2.2926113630301415
chr10	LINC02645	2447286	2447293	0	8	0	5534	0	5526	0.0	0.0
chr10	PITRM1	3147149	3147161	185	13	1624774	11641	1624589	11628	14.23076923076923	139.71353629170966
chr10	PITRM1	3158039	3158043	0	5	1624774	11641	1624774	11636	0.0	139.633379168099
chr10	PITRM1	3166935	3166976	3334	42	1624774	11641	1621440	11599	79.38095238095238	139.79136132425208
chr10	PITRM1	3148167	3148169	0	3	1624774	11641	1624774	11638	0.0	139.6093830555078
chr10	PITRM1	3172181	3172715	11028	535	1624774	11641	1613746	11106	20.613084112149533	145.30397983072214
chr10	PITRM1	3170733	3170776	1739	44	1624774	11641	1623035	11597	39.52272727272727	139.95300508752263
chr10	PITRM1	3171760	3172715	244522	956	1624774	11641	1380252	10685	255.77615062761507	129.17660271408516
chr10	PITRM1	3171760	3172180	233494	421	1624774	11641	1391280	11220	554.6175771971497	124.0
chr10	KLF6	3781640	3781793	22	154	29	4846	7	4692	0.14285714285714285	0.0014919011082693947
chr10	AL732437.3	5550643	5550999	0	357	0	1372	0	1015	0.0	0.0
chr10	LASTR	5610107	5610312	0	206	2244	4818	2244	4612	0.0	0.4865568083261058
chr10	IL2RA	6021477	6021503	0	27	72	3971	72	3944	0.0	0.018255578093306288
chr10	GATA3-AS1	8051248	8051272	3863	25	14313	1741	10450	1716	154.52	6.089743589743589
chr10	GATA3-AS1	8053122	8053184	0	63	14313	1741	14313	1678	0.0	8.52979737783075
chr10	LINC00708	8260645	8260778	0	134	0	824	0	690	0.0	0.0
chr10	LINC00708	8260635	8260778	0	144	0	824	0	680	0.0	0.0
chr10	LINC00708	8260635	8260644	0	10	0	824	0	814	0.0	0.0
chr10	SFTA1P	10794838	10794875	0	38	0	1202	0	1164	0.0	0.0
chr10	SFTA1P	10794697	10794837	0	141	0	1202	0	1061	0.0	0.0
chr10	SFTA1P	10794697	10794875	0	179	0	1202	0	1023	0.0	0.0
chr10	LINC00710	10935052	10935232	0	181	0	6504	0	6323	0.0	0.0
chr10	LINC00710	10946785	10947444	0	660	0	6504	0	5844	0.0	0.0
chr10	LINC00710	10951893	10951936	0	44	0	6504	0	6460	0.0	0.0
chr10	LINC00710	10951893	10951923	0	31	0	6504	0	6473	0.0	0.0
chr10	LINC00710	10951924	10951936	0	13	0	6504	0	6491	0.0	0.0
chr10	LINC00710	10951795	10951936	0	142	0	6504	0	6362	0.0	0.0
chr10	LINC00710	10951795	10951892	0	98	0	6504	0	6406	0.0	0.0
chr10	LINC00710	10951795	10951923	0	129	0	6504	0	6375	0.0	0.0
chr10	LINC00710	10936623	10937436	0	814	0	6504	0	5690	0.0	0.0
chr10	LINC00710	10948240	10948251	0	12	0	6504	0	6492	0.0	0.0
chr10	CELF2-AS2	11105449	11105467	0	19	0	4185	0	4166	0.0	0.0
chr10	NUDT5	12179028	12179081	0	54	38616	4491	38616	4437	0.0	8.703177822853279
chr10	PHYH	13291824	13291829	0	6	204	3388	204	3382	0.0	0.06031933767001774
chr10	BEND7	13499738	13499776	0	39	0	5715	0	5676	0.0	0.0
chr10	FRMD4A	13707275	13707344	5	70	103572	13266	103567	13196	0.07142857142857142	7.848363140345559
chr10	FAM107B	14571762	14571922	1053	161	1566	6879	513	6718	6.540372670807454	0.07636201250372135
chr10	FAM107B	14571762	14571989	1053	228	1566	6879	513	6651	4.618421052631579	0.07713125845737483
chr10	FAM107B	14571923	14571989	0	67	1566	6879	1566	6812	0.0	0.22988843217850852
chr10	CDNF	14825478	14825492	0	15	51	1710	51	1695	0.0	0.03008849557522124
chr10	RSU1	16816972	16817313	0	342	1923	4135	1923	3793	0.0	0.5069865541787504
chr10	CUBN	16907507	16907678	0	172	39637	13334	39637	13162	0.0	3.0114724206047714
chr10	AC069549.2	20099449	20099486	0	38	0	2430	0	2392	0.0	0.0
chr10	NEBL	20817597	20817598	0	2	204	16049	204	16047	0.0	0.012712656571321743
chr10	ARHGAP21	24590205	24590452	0	248	88	9962	88	9714	0.0	0.009059089973234506
chr10	ACBD5	27210813	27210920	0	108	1481	11777	1481	11669	0.0	0.12691747364812753
chr10	MPP7	28059515	28059648	0	134	0	6190	0	6056	0.0	0.0
chr10	WAC-AS1	28525867	28525946	0	80	0	3391	0	3311	0.0	0.0
chr10	LINC00837	28795772	28795892	0	121	1683	4864	1683	4743	0.0	0.3548387096774194
chr10	LINC00837	28795661	28795771	0	111	1683	4864	1683	4753	0.0	0.3540921523248475
chr10	LINC00837	28795661	28795892	0	232	1683	4864	1683	4632	0.0	0.3633419689119171
chr10	SVIL	29735750	29735753	24	4	1861	12477	1837	12473	6.0	0.14727812074080013
chr10	SVIL	29634419	29634525	0	107	1861	12477	1861	12370	0.0	0.15044462409054163
chr10	MTPAP	30369045	30369071	0	27	570	8335	570	8308	0.0	0.068608570052961
chr10	ITGB1	32957010	32957224	51	215	3849	12473	3798	12258	0.2372093023255814	0.30983847283406757
chr10	ITGB1	32957225	32957757	0	533	3849	12473	3849	11940	0.0	0.32236180904522616
chr10	ITGB1	32936241	32936348	0	108	3849	12473	3849	12365	0.0	0.31128184391427416
chr10	ITGB1	32932505	32932513	0	9	3849	12473	3849	12464	0.0	0.30880937098844674
chr10	ITGB1	32932505	32932509	0	5	3849	12473	3849	12468	0.0	0.30871029836381136
chr10	ITGB1	32933350	32933480	0	131	3849	12473	3849	12342	0.0	0.31186193485658725
chr10	ITGB1	32932510	32932513	0	4	3849	12473	3849	12469	0.0	0.3086855401395461
chr10	NRP1	33202890	33202910	0	21	344357	9558	344357	9537	0.0	36.10747614553843
chr10	LINC00838	33772182	33772611	0	430	0	3582	0	3152	0.0	0.0
chr10	PARD3	34337274	34337363	0	90	3679	6541	3679	6451	0.0	0.5702991784219501
chr10	PARD3	34337274	34337276	0	3	3679	6541	3679	6538	0.0	0.5627103089629856
chr10	PARD3	34347955	34347963	0	9	3679	6541	3679	6532	0.0	0.5632271892222903
chr10	PARD3	34337277	34337363	0	87	3679	6541	3679	6454	0.0	0.5700340873876666
chr10	CUL2	35090178	35090428	1143	251	3374	5181	2231	4930	4.553784860557769	0.45253549695740364
chr10	CUL2	35074078	35074190	64	113	3374	5181	3310	5068	0.5663716814159292	0.6531176006314128
chr10	ZNF248	37857764	37858003	0	240	1173	6037	1173	5797	0.0	0.20234604105571846
chr10	CCNYL2	42471804	42472192	0	389	0	3845	0	3456	0.0	0.0
chr10	ZNF37BP	42551572	42551575	0	4	0	2664	0	2660	0.0	0.0
chr10	RSU1P2	45106996	45106999	0	4	0	2552	0	2548	0.0	0.0
chr10	ZFAND4	45672249	45672677	0	429	0	6248	0	5819	0.0	0.0
chr10	ZFAND4	45672249	45672270	0	22	0	6248	0	6226	0.0	0.0
chr10	ZFAND4	45672271	45672677	0	407	0	6248	0	5841	0.0	0.0
chr10	AL591684.2	47553328	47553477	0	150	0	1637	0	1487	0.0	0.0
chr10	LINC02675	47590138	47590164	0	27	0	2441	0	2414	0.0	0.0
chr10	ARHGAP22	48455001	48455052	7	52	7	6564	0	6512	0.1346153846153846	0.0
chr10	ARHGAP22	48479587	48479634	0	48	7	6564	7	6516	0.0	0.001074278698588091
chr10	TMEM273	49166444	49166867	0	424	0	3704	0	3280	0.0	0.0
chr10	SGMS1	50341216	50341298	0	83	0	6440	0	6357	0.0	0.0
chr10	LNCAROD	52755305	52755308	0	4	51	2115	51	2111	0.0	0.024159166271909047
chr10	LINC02672	53029891	53029909	0	19	153	1620	153	1601	0.0	0.09556527170518427
chr10	PCDH15	53810546	53810554	0	9	133	15436	133	15427	0.0	0.008621248460491346
chr10	ZWINT	56360017	56360178	0	162	0	2184	0	2022	0.0	0.0
chr10	ZWINT	56358804	56358907	0	104	0	2184	0	2080	0.0	0.0
chr10	ANK3	60068636	60073870	102	5235	54213	22486	54111	17251	0.019484240687679084	3.136687728247638
chr10	ANK3	60068636	60069976	0	1341	54213	22486	54213	21145	0.0	2.563868526838496
chr10	ANK3	60068636	60068647	0	12	54213	22486	54213	22474	0.0	2.4122541603630863
chr10	ANK3	60080536	60080571	0	36	54213	22486	54213	22450	0.0	2.414832962138085
chr10	RUFY2	68345701	68345829	0	129	222	8004	222	7875	0.0	0.02819047619047619
chr10	RUFY2	68406753	68406904	0	152	222	8004	222	7852	0.0	0.028273051451859398
chr10	RUFY2	68406753	68407184	0	432	222	8004	222	7572	0.0	0.029318541996830427
chr10	DNA2	68416706	68416707	0	2	0	4023	0	4021	0.0	0.0
chr10	TYSND1	70145420	70146531	10742	1112	56925	4625	46183	3513	9.660071942446043	13.146313692001138
chr10	LRRC20	70382493	70382547	0	55	305	3632	305	3577	0.0	0.08526698350573106
chr10	ASCC1	72215781	72215834	0	54	12963	5932	12963	5878	0.0	2.2053419530452536
chr10	ASCC1	72215776	72215834	0	59	12963	5932	12963	5873	0.0	2.207219478971565
chr10	ASCC1	72215776	72215780	0	5	12963	5932	12963	5927	0.0	2.187109836342163
chr10	ASCC1	72215781	72216205	0	425	12963	5932	12963	5507	0.0	2.353913201380062
chr10	DNAJB12	72335779	72335832	0	54	2359	5577	2359	5523	0.0	0.42712294043092525
chr10	MRPS16	73252469	73252530	0	62	0	2703	0	2641	0.0	0.0
chr10	CFAP70	73291225	73291348	0	124	0	3807	0	3683	0.0	0.0
chr10	USP54	73505307	73505321	0	15	494560	9532	494560	9517	0.0	51.965955658295684
chr10	AC022400.4	73713197	73713202	0	6	0	1195	0	1189	0.0	0.0
chr10	BMS1P4	73730438	73730457	0	20	2540	2675	2540	2655	0.0	0.9566854990583804
chr10	BMS1P4	73730315	73730437	153	123	2540	2675	2387	2552	1.2439024390243902	0.9353448275862069
chr10	BMS1P4	73730315	73730457	153	143	2540	2675	2387	2532	1.06993006993007	0.9427330173775671
chr10	NDST2	73802971	73803007	0	37	51	4670	51	4633	0.0	0.011007986186056551
chr10	CAMK2G	73825278	73825319	0	42	544	6806	544	6764	0.0	0.08042578356002365
chr10	DUSP13	75095574	75095726	0	153	590	2053	590	1900	0.0	0.3105263157894737
chr10	DUSP13	75103893	75103991	0	99	590	2053	590	1954	0.0	0.30194472876151485
chr10	DUSP13	75099030	75099427	0	398	590	2053	590	1655	0.0	0.3564954682779456
chr10	COMTD1	75235615	75235618	0	4	31843	1822	31843	1818	0.0	17.515401540154016
chr10	NUTM2B-AS1	79808758	79808761	104	4	1990601	19359	1990497	19355	26.0	102.8414879876001
chr10	DYDC1	80356352	80356710	0	359	0	1245	0	886	0.0	0.0
chr10	ADIRF-AS1	86967768	86969040	0	1273	255	4083	255	2810	0.0	0.09074733096085409
chr10	NUTM2A-AS1	87330891	87330894	0	4	0	19888	0	19884	0.0	0.0
chr10	FAM245A	87398019	87398045	0	27	0	2032	0	2005	0.0	0.0
chr10	ACTA2	88990938	88991020	0	83	36622	2903	36622	2820	0.0	12.986524822695035
chr10	HTR7	90748833	90748837	0	5	0	3476	0	3471	0.0	0.0
chr10	TNKS2-AS1	91797812	91798235	0	424	49	961	49	537	0.0	0.09124767225325885
chr10	CPEB3	92192476	92192544	0	69	0	7930	0	7861	0.0	0.0
chr10	PLCE1-AS2	94107710	94107730	0	21	53606	4224	53606	4203	0.0	12.754223173923387
chr10	PLCE1-AS2	94105574	94106019	1360	446	53606	4224	52246	3778	3.0493273542600896	13.82901005823187
chr10	PLCE1-AS2	94108357	94108716	3232	360	53606	4224	50374	3864	8.977777777777778	13.036749482401657
chr10	CYP2C8	95069196	95069233	1058	38	4825	2543	3767	2505	27.842105263157894	1.5037924151696607
chr10	SORBS1	95351208	95351214	0	7	3498	10991	3498	10984	0.0	0.31846321922796794
chr10	ALDH18A1	95633490	95633495	0	6	408	3778	408	3772	0.0	0.10816542948038176
chr10	ENTPD1-AS1	95907662	95907776	300	115	15646	22304	15346	22189	2.608695652173913	0.6916039479021137
chr10	SLIT1	97002157	97002280	51	124	53395	8050	53344	7926	0.4112903225806452	6.730254857431239
chr10	ARHGAP19	97265859	97266077	0	219	204	6182	204	5963	0.0	0.03421096763374141
chr10	EXOSC1	97438662	97438668	0	7	9554	1956	9554	1949	0.0	4.902001026167265
chr10	MMS19	97480894	97480940	0	47	35	4976	35	4929	0.0	0.007100831811726517
chr10	ERLIN1	100185903	100185960	143	58	34007	3502	33864	3444	2.4655172413793105	9.832752613240418
chr10	CHUK	100193297	100193387	1717	91	317037	5240	315320	5149	18.86813186813187	61.23907554865022
chr10	PKD2L1	100329868	100329907	0	40	51	2864	51	2824	0.0	0.018059490084985835
chr10	NDUFB8	100529766	100529856	0	91	0	2005	0	1914	0.0	0.0
chr10	NDUFB8	100529365	100529378	0	14	0	2005	0	1991	0.0	0.0
chr10	MRPL43	100983947	100984032	0	86	51	2672	51	2586	0.0	0.019721577726218097
chr10	MRPL43	100986686	100986747	0	62	51	2672	51	2610	0.0	0.01954022988505747
chr10	TLX1NB	101130756	101130784	0	29	0	1894	0	1865	0.0	0.0
chr10	POLL	101584601	101584876	291	276	6760	5429	6469	5153	1.0543478260869565	1.2553852124975742
chr10	POLL	101587884	101588202	1224	319	6760	5429	5536	5110	3.8369905956112853	1.0833659491193737
chr10	POLL	101587821	101587883	48	63	6760	5429	6712	5366	0.7619047619047619	1.2508386134923593
chr10	POLL	101587821	101588202	1272	382	6760	5429	5488	5047	3.329842931937173	1.087378640776699
chr10	FBXW4	101694380	101695238	15	859	3128	5048	3113	4189	0.017462165308498253	0.7431367868226307
chr10	AC010789.1	101729716	101729751	0	36	1916	918	1916	882	0.0	2.1723356009070294
chr10	FGF8	101775541	101775738	0	198	0	1427	0	1229	0.0	0.0
chr10	LDB1	102109028	102109033	0	6	129266	3788	129266	3782	0.0	34.17927022739291
chr10	NT5C2	103111692	103111743	0	52	4866	8572	4866	8520	0.0	0.5711267605633803
chr10	XPNPEP1	109915010	109915021	0	12	474	6715	474	6703	0.0	0.07071460540056691
chr10	ADD3-AS1	109951843	109953754	0	1912	0	7304	0	5392	0.0	0.0
chr10	GPAM	112183673	112183691	0	19	36	7897	36	7878	0.0	0.00456968773800457
chr10	GUCY2GP	112327186	112327188	0	3	12891	3290	12891	3287	0.0	3.921813203529054
chr10	AL157786.1	112409013	112409405	0	393	0	2873	0	2480	0.0	0.0
chr10	AL157786.1	112409013	112409210	0	198	0	2873	0	2675	0.0	0.0
chr10	AL157786.1	112409013	112409481	0	469	0	2873	0	2404	0.0	0.0
chr10	AL157786.1	112409211	112409405	0	195	0	2873	0	2678	0.0	0.0
chr10	AL157786.1	112409211	112409481	0	271	0	2873	0	2602	0.0	0.0
chr10	ZDHHC6	112446586	112446703	0	118	83	3644	83	3526	0.0	0.023539421440726037
chr10	AFAP1L2	114297219	114297230	0	12	173	5809	173	5797	0.0	0.029843022252889425
chr10	ABLIM1	114526638	114526658	0	21	6431	10244	6431	10223	0.0	0.6290717010662232
chr10	HSPA12A	116683790	116683830	0	41	23844	21134	23844	21093	0.0	1.1304224150192006
chr10	EMX2OS	117476356	117476454	0	99	51	4904	51	4805	0.0	0.010613943808532778
chr10	SFXN4	119165201	119165535	0	335	0	1930	0	1595	0.0	0.0
chr10	MCMBP	119843247	119843252	0	6	5615	6013	5615	6007	0.0	0.9347428000665889
chr10	WDR11-AS1	120850693	120851105	0	413	47252	6721	47252	6308	0.0	7.490805326569435
chr10	FGFR2	121515116	121515121	0	6	89910	7609	89910	7603	0.0	11.82559515980534
chr10	FGFR2	121565437	121565635	0	199	89910	7609	89910	7410	0.0	12.133603238866396
chr10	AC063960.2	122152481	122152508	0	28	0	4404	0	4376	0.0	0.0
chr10	EEF1AKMT2	124789038	124789041	0	4	30241	5827	30241	5823	0.0	5.193371114545767
chr10	CTBP2	125026081	125027956	0	1876	924	9202	924	7326	0.0	0.12612612612612611
chr10	EDRF1-AS1	125751943	125751983	0	41	51	1922	51	1881	0.0	0.02711323763955343
chr10	EDRF1-AS1	125751915	125751983	0	69	51	1922	51	1853	0.0	0.027522935779816515
chr10	EDRF1-AS1	125751915	125751942	0	28	51	1922	51	1894	0.0	0.02692713833157339
chr10	UROS	125802949	125802987	0	39	2142	8118	2142	8079	0.0	0.26513182324545115
chr10	ADAM12	126155217	126155225	0	9	82497	9886	82497	9877	0.0	8.352434949883568
chr10	EBF3	129873451	129873477	0	27	5757	5469	5757	5442	0.0	1.057883131201764
chr10	AL451069.1	132518093	132518115	0	23	0	2470	0	2447	0.0	0.0
chr10	ZMYND11	134787	134892	0	106	565	5345	565	5239	0.0	0.10784500858942546
chr10	IDI2-AS1	1035423	1035506	204	84	41195	3053	40991	2969	2.4285714285714284	13.806332098349612
chr10	WDR37	1056565	1056968	3388	404	90087	6299	86699	5895	8.386138613861386	14.707209499575912
chr10	PFKP	3109481	3109609	0	129	6806	6142	6806	6013	0.0	1.1318809246632298
chr10	PFKP	3068649	3068742	0	94	6806	6142	6806	6048	0.0	1.125330687830688
chr10	PFKP	3068743	3068921	0	179	6806	6142	6806	5963	0.0	1.1413717927217844
chr10	LINC02660	3912047	3912176	0	130	36	1114	36	984	0.0	0.036585365853658534
chr10	LINC02660	3934628	3934974	0	347	36	1114	36	767	0.0	0.0469361147327249
chr10	AC025822.1	4025357	4025457	0	101	51	3739	51	3638	0.0	0.014018691588785047
chr10	AKR1E2	4841841	4841857	0	17	0	2430	0	2413	0.0	0.0
chr10	AKR1E2	4847231	4847299	0	69	0	2430	0	2361	0.0	0.0
chr10	AKR1E2	4826278	4826363	0	86	0	2430	0	2344	0.0	0.0
chr10	AKR1E2	4833467	4833476	0	10	0	2430	0	2420	0.0	0.0
chr10	LINC02649	6331604	6331834	0	231	6617	5103	6617	4872	0.0	1.3581691297208538
chr10	LINC02649	6331307	6331834	51	528	6617	5103	6566	4575	0.09659090909090909	1.4351912568306011
chr10	PRKCQ-AS1	6583919	6584195	0	277	102	5311	102	5034	0.0	0.02026221692491061
chr10	LINC00707	6838009	6838652	0	644	89	9845	89	9201	0.0	0.009672861645473319
chr10	LINC00707	6812369	6812556	0	188	89	9845	89	9657	0.0	0.009216112664388527
chr10	CELF2	11314259	11314270	0	12	0	9833	0	9821	0.0	0.0
chr10	ECHDC3	11742747	11742905	0	159	0	2128	0	1969	0.0	0.0
chr10	AL157392.3	13645075	13645136	0	62	14329	9029	14329	8967	0.0	1.5979703356752537
chr10	AL157392.3	13631364	13631484	0	121	14329	9029	14329	8908	0.0	1.6085541086663673
chr10	AL157392.3	13631821	13631973	0	153	14329	9029	14329	8876	0.0	1.614353312302839
chr10	AL157392.3	13637095	13637187	0	93	14329	9029	14329	8936	0.0	1.6035138764547896
chr10	AL157392.3	13646687	13646780	0	94	14329	9029	14329	8935	0.0	1.6036933407946279
chr10	AL157392.3	13652883	13652929	42	47	14329	9029	14287	8982	0.8936170212765957	1.5906256958361167
chr10	AL157392.3	13649335	13649637	0	303	14329	9029	14329	8726	0.0	1.6421040568416228
chr10	AL157392.3	13652883	13653148	144	266	14329	9029	14185	8763	0.5413533834586466	1.6187378751569097
chr10	AL157392.3	13652930	13653148	102	219	14329	9029	14227	8810	0.4657534246575342	1.6148694665153236
chr10	AL158168.1	14652752	14652833	0	82	0	1254	0	1172	0.0	0.0
chr10	SUV39H2	14896978	14897517	0	540	6896	3572	6896	3032	0.0	2.2744063324538257
chr10	SUV39H2	14878920	14878960	1190	41	6896	3572	5706	3531	29.024390243902438	1.6159728122344945
chr10	SUV39H2	14878920	14879127	2924	208	6896	3572	3972	3364	14.057692307692308	1.1807372175980975
chr10	SUV39H2	14878961	14879127	1734	167	6896	3572	5162	3405	10.383233532934131	1.5160058737151247
chr10	OLAH	15047321	15047383	0	63	564	2300	564	2237	0.0	0.2521233795261511
chr10	RPP38	15097410	15097766	0	357	587	1880	587	1523	0.0	0.3854235062376888
chr10	LINC02654	16277697	16278093	0	397	0	2554	0	2157	0.0	0.0
chr10	VIM	17228525	17228676	0	152	5885	4730	5885	4578	0.0	1.2854958497160331
chr10	CACNB2	18140857	18141215	0	359	104	11186	104	10827	0.0	0.009605615590652997
chr10	MLLT10	21534495	21534520	0	26	306	8958	306	8932	0.0	0.03425884460367219
chr10	SPAG6	22345819	22346046	0	228	1248	3848	1248	3620	0.0	0.3447513812154696
chr10	PTF1A	23192678	23193314	0	637	0	1388	0	751	0.0	0.0
chr10	THNSL1	25016693	25016789	0	97	0	3837	0	3740	0.0	0.0
chr10	FAM238B	26650658	26650791	0	134	0	1292	0	1158	0.0	0.0
chr10	RAB18	27504413	27504437	15	25	13784	6111	13769	6086	0.6	2.262405520867565
chr10	WAC	28534035	28534182	0	148	102	10128	102	9980	0.0	0.010220440881763528
chr10	WAC	28533583	28533620	0	38	102	10128	102	10090	0.0	0.010109018830525273
chr10	SVIL-AS1	29409659	29409683	0	25	918	5005	918	4980	0.0	0.18433734939759036
chr10	SVIL2P	30693669	30693799	0	131	0	3253	0	3122	0.0	0.0
chr10	ZEB1	31319134	31319292	26	159	1468	8673	1442	8514	0.16352201257861634	0.16936809960065774
chr10	CCDC7	32446398	32446631	0	234	9680	8667	9680	8433	0.0	1.1478714573698565
chr10	ITGB1-DT	32958904	32958971	0	68	5245	3238	5245	3170	0.0	1.6545741324921135
chr10	LINC02635	34969955	34969966	73	12	6120	1177	6047	1165	6.083333333333333	5.1905579399141635
chr10	CREM	35196100	35196142	0	43	170	5551	170	5508	0.0	0.030864197530864196
chr10	ZNF33A	38017016	38017020	0	5	4490	7554	4490	7549	0.0	0.5947807656643264
chr10	ZNF37A	38095630	38095633	0	4	124847	13019	124847	13015	0.0	9.592547061083366
chr10	LINC00839	42475881	42475964	0	84	94	8183	94	8099	0.0	0.011606371156932955
chr10	LINC00839	42476489	42476530	0	42	94	8183	94	8141	0.0	0.01154649305982066
chr10	ZNF487	43436936	43437155	0	220	0	3028	0	2808	0.0	0.0
chr10	ZNF487	43437156	43437262	0	107	0	3028	0	2921	0.0	0.0
chr10	ZNF485	43606542	43606546	0	5	0	2391	0	2386	0.0	0.0
chr10	ZNF485	43606547	43606563	0	17	0	2391	0	2374	0.0	0.0
chr10	ZNF485	43606542	43606563	0	22	0	2391	0	2369	0.0	0.0
chr10	LINC00840	43845408	43845602	0	195	28801	7297	28801	7102	0.0	4.055336524922557
chr10	LINC00840	43846686	43846882	0	197	28801	7297	28801	7100	0.0	4.056478873239437
chr10	FAM245B	46750223	46750253	15	31	6437	1278	6422	1247	0.4838709677419355	5.149959903769045
chr10	BMS1P1	46795946	46795953	0	8	132	4572	132	4564	0.0	0.028921998247151623
chr10	ASAH2B	50739984	50740002	0	19	2104	5888	2104	5869	0.0	0.35849378088260353
chr10	LINC00844	59001315	59001349	0	35	0	6009	0	5974	0.0	0.0
chr10	LINC00844	59000504	59000512	0	9	0	6009	0	6000	0.0	0.0
chr10	LINC00844	59000246	59000512	0	267	0	6009	0	5742	0.0	0.0
chr10	CDK1	60778460	60778570	0	111	0	3548	0	3437	0.0	0.0
chr10	CDK1	60778571	60778668	0	98	0	3548	0	3450	0.0	0.0
chr10	LINC01515	65585568	65585802	0	235	419	17753	419	17518	0.0	0.023918255508619705
chr10	LINC01515	65570546	65570759	211	214	419	17753	208	17539	0.985981308411215	0.01185928502195108
chr10	LINC01515	65570546	65571579	368	1034	419	17753	51	16719	0.35589941972920697	0.003050421675937556
chr10	HNRNPH3	68331855	68332216	0	362	0	3045	0	2683	0.0	0.0
chr10	HNRNPH3	68338643	68338687	0	45	0	3045	0	3000	0.0	0.0
chr10	CCAR1	68721157	68721282	0	126	80	6086	80	5960	0.0	0.013422818791946308
chr10	CCAR1	68721283	68721406	0	124	80	6086	80	5962	0.0	0.01341831600134183
chr10	CCAR1	68721289	68721406	0	118	80	6086	80	5968	0.0	0.013404825737265416
chr10	CCAR1	68721283	68721288	0	6	80	6086	80	6080	0.0	0.013157894736842105
chr10	CCAR1	68721283	68721663	0	381	80	6086	80	5705	0.0	0.014022787028921999
chr10	CCAR1	68721407	68721663	0	257	80	6086	80	5829	0.0	0.013724481043060559
chr10	CCAR1	68721289	68721663	0	375	80	6086	80	5711	0.0	0.014008054631413063
chr10	STOX1	68884460	68886618	153	2159	153	3919	0	1760	0.07086614173228346	0.0
chr10	STOX1	68827934	68828269	0	336	153	3919	153	3583	0.0	0.042701646664806026
chr10	KIFBP	68989213	68989258	0	46	0	6370	0	6324	0.0	0.0
chr10	KIFBP	68989743	68989859	0	117	0	6370	0	6253	0.0	0.0
chr10	HK1	69282651	69282704	0	54	31	6322	31	6268	0.0	0.004945756222080409
chr10	HK1	69319011	69319177	0	167	31	6322	31	6155	0.0	0.00503655564581641
chr10	COL13A1	69919702	69919727	0	26	32571	9922	32571	9896	0.0	3.2913298302344383
chr10	MACROH2A2	70091842	70091954	24426	113	1089514	11836	1065088	11723	216.15929203539824	90.8545594131195
chr10	MACROH2A2	70083071	70083179	0	109	1089514	11836	1089514	11727	0.0	92.90645518888036
chr10	ADAMTS14	70730250	70730258	0	9	117512	5588	117512	5579	0.0	21.06327298799068
chr10	SLC29A3	71319311	71319731	0	421	408	5448	408	5027	0.0	0.08116172667594987
chr10	ANAPC16	72216073	72216138	0	66	985	4329	985	4263	0.0	0.23105794041754632
chr10	MCU	72834429	72834432	0	4	51	4536	51	4532	0.0	0.011253309796999117
chr10	FAM149B1	73228161	73228184	0	24	0	6573	0	6549	0.0	0.0
chr10	FAM149B1	73233164	73233197	0	34	0	6573	0	6539	0.0	0.0
chr10	PPP3CB-AS1	73496484	73496906	0	423	459	5347	459	4924	0.0	0.09321689683184403
chr10	SEC24C	73767932	73768007	3257	76	320641	5320	317384	5244	42.85526315789474	60.52326468344775
chr10	ZSWIM8	73793699	73793719	0	21	1000	7868	1000	7847	0.0	0.12743723716069835
chr10	ZSWIM8	73800171	73800194	0	24	1000	7868	1000	7844	0.0	0.12748597654258031
chr10	ZSWIM8	73797606	73797609	0	4	1000	7868	1000	7864	0.0	0.1271617497456765
chr10	PLAU	73911613	73911925	51	313	5488	2962	5437	2649	0.16293929712460065	2.052472631181578
chr10	KAT6B	74825357	74825360	0	4	113903	24867	113903	24863	0.0	4.5812251136226525
chr10	KAT6B	74975455	74976330	1616	876	113903	24867	112287	23991	1.8447488584474885	4.6803801425534575
chr10	KAT6B	74975782	74976330	1616	549	113903	24867	112287	24318	2.9435336976320583	4.617443868739206
chr10	KAT6B	74838753	74838783	0	31	113903	24867	113903	24836	0.0	4.586205508133355
chr10	KAT6B	74825536	74825674	0	139	113903	24867	113903	24728	0.0	4.606235846004529
chr10	KAT6B	74975455	74975781	0	327	113903	24867	113903	24540	0.0	4.641524042379788
chr10	KAT6B	74825675	74825766	0	92	113903	24867	113903	24775	0.0	4.597497477295661
chr10	KAT6B	74826470	74826785	0	316	113903	24867	113903	24551	0.0	4.639444421815812
chr10	SAMD8	75111723	75111778	0	56	420735	7145	420735	7089	0.0	59.35040203131612
chr10	ZNF503-AS1	75358708	75359049	0	342	19920	5296	19920	4954	0.0	4.020993136859103
chr10	ZNF503-AS1	75343331	75343340	0	10	19920	5296	19920	5286	0.0	3.76844494892168
chr10	ZNF503-AS2	75403084	75403351	0	268	0	3233	0	2965	0.0	0.0
chr10	ZNF503-AS2	75403947	75404057	0	111	0	3233	0	3122	0.0	0.0
chr10	RPS24	78037983	78037993	0	11	0	7223	0	7212	0.0	0.0
chr10	LINC00595	78301789	78302121	0	333	36	10323	36	9990	0.0	0.0036036036036036037
chr10	ZMIZ1	79299189	79299191	72	3	4953	6896	4881	6893	24.0	0.708109676483389
chr10	PPIF	79351584	79351714	321	131	3228	2677	2907	2546	2.450381679389313	1.1417910447761195
chr10	TMEM254	80081735	80081741	0	7	102	3006	102	2999	0.0	0.03401133711237079
chr10	LINC00857	80208232	80208241	0	10	0	2511	0	2501	0.0	0.0
chr10	NRG3	81878021	81878095	0	75	51	5209	51	5134	0.0	0.009933774834437087
chr10	CDHR1	84212293	84212407	0	115	51	7747	51	7632	0.0	0.0066823899371069185
chr10	LINC00858	84280066	84280109	0	44	0	4591	0	4547	0.0	0.0
chr10	LINC00858	84288672	84288696	0	25	0	4591	0	4566	0.0	0.0
chr10	LINC01520	85450177	85450206	0	30	0	1531	0	1501	0.0	0.0
chr10	LINC00863	87343138	87343405	0	268	0	5495	0	5227	0.0	0.0
chr10	AL157400.2	89645458	89645499	0	42	347	2086	347	2044	0.0	0.1697651663405088
chr10	AL157400.2	89648999	89649021	253	23	347	2086	94	2063	11.0	0.045564711585070285
chr10	KIF20B	89701681	89701717	0	37	55382	6904	55382	6867	0.0	8.064948303480413
chr10	RPP30	90872069	90872134	0	66	51	4432	51	4366	0.0	0.01168117269812185
chr10	LGI1	93758360	93758368	0	9	50608	8705	50608	8696	0.0	5.819687212511499
chr10	LGI1	93758365	93758368	0	4	50608	8705	50608	8701	0.0	5.816342949086312
chr10	LGI1	93758009	93758368	1485	360	50608	8705	49123	8345	4.125	5.886518873576992
chr10	LGI1	93758277	93758368	0	92	50608	8705	50608	8613	0.0	5.875769186114014
chr10	LGI1	93790171	93790233	850	63	50608	8705	49758	8642	13.492063492063492	5.7576949780143485
chr10	LGI1	93758009	93758359	1485	351	50608	8705	49123	8354	4.230769230769231	5.880177160641609
chr10	LGI1	93758277	93758359	0	83	50608	8705	50608	8622	0.0	5.869635815356066
chr10	LGI1	93758360	93758364	0	5	50608	8705	50608	8700	0.0	5.817011494252873
chr10	LGI1	93758009	93758364	1485	356	50608	8705	49123	8349	4.171348314606742	5.883698646544496
chr10	LGI1	93758277	93758364	0	88	50608	8705	50608	8617	0.0	5.873041661831264
chr10	LGI1	93758009	93758276	1485	268	50608	8705	49123	8437	5.541044776119403	5.822330212160721
chr10	LGI1	93758832	93759291	860	460	50608	8705	49748	8245	1.8695652173913044	6.033717404487568
chr10	SLC35G1	93894161	93894211	72	51	1661	5890	1589	5839	1.411764705882353	0.2721356396643261
chr10	PLCE1	94089146	94089376	800	231	14181	13715	13381	13484	3.463203463203463	0.9923613171165826
chr10	PLCE1	94282833	94282940	0	108	14181	13715	14181	13607	0.0	1.042184169912545
chr10	HELLS	94545908	94545952	0	45	574	8582	574	8537	0.0	0.06723673421576666
chr10	ACSM6	95202186	95202195	0	10	42573	2819	42573	2809	0.0	15.155927376290494
chr10	LCOR	96832396	96832399	0	4	913	26377	913	26373	0.0	0.03461873886171463
chr10	LCOR	96955455	96955834	0	380	913	26377	913	25997	0.0	0.03511943685809901
chr10	LCOR	96955672	96955834	0	163	913	26377	913	26214	0.0	0.034828717479209584
chr10	LCOR	96955835	96955957	0	123	913	26377	913	26254	0.0	0.03477565323379295
chr10	LCOR	96955455	96955957	0	503	913	26377	913	25874	0.0	0.03528638787972482
chr10	LCOR	96955672	96955957	0	286	913	26377	913	26091	0.0	0.034992909432371315
chr10	LCOR	96833115	96833122	0	8	913	26377	913	26369	0.0	0.034623990291630324
chr10	LCOR	96833119	96833122	0	4	913	26377	913	26373	0.0	0.03461873886171463
chr10	LCOR	96833115	96833479	0	365	913	26377	913	26012	0.0	0.03509918499154237
chr10	LCOR	96833123	96833479	0	357	913	26377	913	26020	0.0	0.03508839354342813
chr10	LCOR	96833119	96833479	0	361	913	26377	913	26016	0.0	0.03509378843788438
chr10	LCOR	96955455	96955671	0	217	913	26377	913	26160	0.0	0.03490061162079511
chr10	LCOR	96833115	96833118	0	4	913	26377	913	26373	0.0	0.03461873886171463
chr10	ZFYVE27	97737322	97737325	0	4	357	3913	357	3909	0.0	0.09132770529547199
chr10	CUTC	99732410	99732560	0	151	0	1803	0	1652	0.0	0.0
chr10	ABCC2	99794000	99794109	0	110	397	7721	397	7611	0.0	0.05216134542110104
chr10	OLMALINC	100374013	100374134	0	122	0	12654	0	12532	0.0	0.0
chr10	OLMALINC	100374081	100374134	0	54	0	12654	0	12600	0.0	0.0
chr10	OLMALINC	100381449	100381452	0	4	0	12654	0	12650	0.0	0.0
chr10	OLMALINC	100374013	100374083	0	71	0	12654	0	12583	0.0	0.0
chr10	OLMALINC	100374081	100374083	0	3	0	12654	0	12651	0.0	0.0
chr10	OLMALINC	100374013	100374080	0	68	0	12654	0	12586	0.0	0.0
chr10	HIF1AN	100536051	100536135	0	85	131	13903	131	13818	0.0	0.009480387899840787
chr10	PAX2	100781342	100781365	0	24	306	6389	306	6365	0.0	0.04807541241162608
chr10	SEMA4G	100969592	100969924	51	333	51	4726	0	4393	0.15315315315315314	0.0
chr10	SEMA4G	100983809	100984357	0	549	51	4726	51	4177	0.0	0.01220971989466124
chr10	SEMA4G	100980983	100980997	0	15	51	4726	51	4711	0.0	0.010825727021863723
chr10	TWNK	100991011	100991054	0	44	0	3960	0	3916	0.0	0.0
chr10	TWNK	100987614	100989453	0	1840	0	3960	0	2120	0.0	0.0
chr10	TWNK	100987881	100989453	0	1573	0	3960	0	2387	0.0	0.0
chr10	TWNK	100990544	100990663	0	120	0	3960	0	3840	0.0	0.0
chr10	NOLC1	102159309	102159338	0	30	116	3983	116	3953	0.0	0.029344801416645586
chr10	GBF1	102245782	102245880	0	99	12004	19267	12004	19168	0.0	0.6262520868113522
chr10	GBF1	102358695	102358729	0	35	12004	19267	12004	19232	0.0	0.6241680532445923
chr10	GBF1	102362629	102362664	0	36	12004	19267	12004	19231	0.0	0.6242005095938848
chr10	GBF1	102365556	102365599	0	44	12004	19267	12004	19223	0.0	0.6244602819539093
chr10	GBF1	102375480	102375584	0	105	12004	19267	12004	19162	0.0	0.6264481786869847
chr10	GBF1	102376426	102376432	0	7	12004	19267	12004	19260	0.0	0.6232606438213915
chr10	GBF1	102376422	102376432	0	11	12004	19267	12004	19256	0.0	0.6233901121728292
chr10	GBF1	102376785	102376800	0	16	12004	19267	12004	19251	0.0	0.6235520232715184
chr10	GBF1	102376789	102376800	0	12	12004	19267	12004	19255	0.0	0.6234224876655414
chr10	GBF1	102377129	102377140	0	12	12004	19267	12004	19255	0.0	0.6234224876655414
chr10	GBF1	102379430	102379434	0	5	12004	19267	12004	19262	0.0	0.6231959298099886
chr10	GBF1	102379652	102379729	0	78	12004	19267	12004	19189	0.0	0.6255667309396008
chr10	GBF1	102354445	102354468	0	24	12004	19267	12004	19243	0.0	0.6238112560411578
chr10	GBF1	102376422	102376425	0	4	12004	19267	12004	19263	0.0	0.6231635778435343
chr10	GBF1	102376785	102376788	0	4	12004	19267	12004	19263	0.0	0.6231635778435343
chr10	GBF1	102376801	102376804	0	4	12004	19267	12004	19263	0.0	0.6231635778435343
chr10	GBF1	102376785	102376804	0	20	12004	19267	12004	19247	0.0	0.6236816127188652
chr10	GBF1	102376789	102376804	0	16	12004	19267	12004	19251	0.0	0.6235520232715184
chr10	GBF1	102379556	102379651	0	96	12004	19267	12004	19171	0.0	0.6261540869020917
chr10	NFKB2	102394556	102394600	0	45	51	4681	51	4636	0.0	0.01100086281276963
chr10	NFKB2	102394556	102394774	0	219	51	4681	51	4462	0.0	0.011429852084267144
chr10	NFKB2	102394601	102394774	0	174	51	4681	51	4507	0.0	0.011315731084978922
chr10	RPARP-AS1	102450331	102450360	0	30	0	4289	0	4259	0.0	0.0
chr10	SFXN2	102726778	102726797	0	20	236054	7940	236054	7920	0.0	29.80479797979798
chr10	SFXN2	102714682	102714995	326	314	236054	7940	235728	7626	1.0382165605095541	30.911093627065302
chr10	ADD3	110125925	110125945	0	21	102	6311	102	6290	0.0	0.016216216216216217
chr10	MXI1	110244858	110244873	0	16	129	5912	129	5896	0.0	0.021879240162822253
chr10	MXI1	110226284	110226386	0	103	129	5912	129	5809	0.0	0.02220692029609227
chr10	MXI1	110226351	110226386	0	36	129	5912	129	5876	0.0	0.02195371000680735
chr10	MXI1	110226284	110226350	0	67	129	5912	129	5845	0.0	0.022070145423438835
chr10	MXI1	110226819	110226852	0	34	129	5912	129	5878	0.0	0.021946240217761145
chr10	MXI1	110226831	110226852	0	22	129	5912	129	5890	0.0	0.021901528013582344
chr10	MXI1	110226835	110226852	0	18	129	5912	129	5894	0.0	0.02188666440447913
chr10	MXI1	110226819	110226830	0	12	129	5912	129	5900	0.0	0.021864406779661016
chr10	MXI1	110226819	110226834	0	16	129	5912	129	5896	0.0	0.021879240162822253
chr10	MXI1	110226831	110226834	0	4	129	5912	129	5908	0.0	0.02183480027081923
chr10	MXI1	110226853	110226885	0	33	129	5912	129	5879	0.0	0.021942507229120597
chr10	MXI1	110226875	110226885	0	11	129	5912	129	5901	0.0	0.021860701576004067
chr10	MXI1	110227101	110227118	0	18	129	5912	129	5894	0.0	0.02188666440447913
chr10	MXI1	110227143	110227162	0	20	129	5912	129	5892	0.0	0.02189409368635438
chr10	MXI1	110227203	110227213	0	11	129	5912	129	5901	0.0	0.021860701576004067
chr10	MXI1	110227338	110227354	0	17	129	5912	129	5895	0.0	0.02188295165394402
chr10	MXI1	110227355	110227398	0	44	129	5912	129	5868	0.0	0.02198364008179959
chr10	MXI1	110227338	110227398	0	61	129	5912	129	5851	0.0	0.022047513245599042
chr10	MXI1	110227378	110227398	0	21	129	5912	129	5891	0.0	0.021897810218978103
chr10	MXI1	110227387	110227398	0	12	129	5912	129	5900	0.0	0.021864406779661016
chr10	MXI1	110227355	110227406	0	52	129	5912	129	5860	0.0	0.022013651877133104
chr10	MXI1	110227399	110227406	0	8	129	5912	129	5904	0.0	0.02184959349593496
chr10	MXI1	110227378	110227406	0	29	129	5912	129	5883	0.0	0.021927587965323816
chr10	MXI1	110227387	110227406	0	20	129	5912	129	5892	0.0	0.02189409368635438
chr10	MXI1	110227355	110227377	0	23	129	5912	129	5889	0.0	0.021905247070809986
chr10	MXI1	110227378	110227386	0	9	129	5912	129	5903	0.0	0.021853294934778927
chr10	MXI1	110227543	110227785	0	243	129	5912	129	5669	0.0	0.022755336038101957
chr10	MXI1	110227786	110227882	0	97	129	5912	129	5815	0.0	0.022184006878761823
chr10	MXI1	110280086	110280147	0	62	129	5912	129	5850	0.0	0.02205128205128205
chr10	TCF7L2	113144014	113144025	0	12	0	6478	0	6466	0.0	0.0
chr10	TCF7L2	113129373	113129987	0	615	0	6478	0	5863	0.0	0.0
chr10	TCF7L2	113129815	113129987	0	173	0	6478	0	6305	0.0	0.0
chr10	PLEKHS1	113774994	113775035	0	42	0	5610	0	5568	0.0	0.0
chr10	PLEKHS1	113755306	113755405	0	100	0	5610	0	5510	0.0	0.0
chr10	VWA2	114284971	114284974	0	4	364	6367	364	6363	0.0	0.05720572057205721
chr10	AL137025.1	114764969	114764992	0	24	153	2927	153	2903	0.0	0.052704099207716154
chr10	AL137025.1	114776162	114776165	0	4	153	2927	153	2923	0.0	0.052343482723229556
chr10	AL137025.1	114776162	114776292	0	131	153	2927	153	2796	0.0	0.05472103004291846
chr10	AL137025.1	114776166	114776292	0	127	153	2927	153	2800	0.0	0.054642857142857146
chr10	ATRNL1	115093637	115094043	0	407	495	9992	495	9585	0.0	0.051643192488262914
chr10	PNLIPRP1	116590996	116591039	0	44	23701	4644	23701	4600	0.0	5.152391304347826
chr10	LINC02674	117735094	117735122	0	29	0	1050	0	1021	0.0	0.0
chr10	AL354863.1	118241683	118241745	0	63	428	3474	428	3411	0.0	0.12547639988273235
chr10	AL354863.1	118241887	118242093	0	207	428	3474	428	3267	0.0	0.1310070400979492
chr10	DENND10	119105007	119105022	0	16	8052	5796	8052	5780	0.0	1.3930795847750865
chr10	INPP5F	119792212	119792213	0	2	6573	7441	6573	7439	0.0	0.8835865035623067
chr10	INPP5F	119819540	119819834	0	295	6573	7441	6573	7146	0.0	0.9198152812762385
chr10	AC023282.1	120819829	120821102	68023	1274	220573	6283	152550	5009	53.393249607535324	30.455180674785385
chr10	WDR11	120851507	120851527	0	21	11519	7675	11519	7654	0.0	1.5049647243271491
chr10	WDR11	120851528	120851591	0	64	11519	7675	11519	7611	0.0	1.5134673498883195
chr10	WDR11	120851507	120851591	0	85	11519	7675	11519	7590	0.0	1.5176548089591568
chr10	TACC2	122211423	122211708	0	286	9656	18193	9656	17907	0.0	0.5392304685318591
chr10	TACC2	122088592	122088738	0	147	9656	18193	9656	18046	0.0	0.5350770253795855
chr10	TACC2	122216829	122216921	3869	93	9656	18193	5787	18100	41.60215053763441	0.31972375690607735
chr10	PLEKHA1	122374807	122374847	0	41	0	22851	0	22810	0.0	0.0
chr10	PLEKHA1	122428317	122428420	0	104	0	22851	0	22747	0.0	0.0
chr10	DMBT1L1	122820396	122820550	0	155	191	8183	191	8028	0.0	0.023791728948679623
chr10	C10ORF88B	122880757	122880873	0	117	0	2143	0	2026	0.0	0.0
chr10	ACADSB	123009068	123009071	0	4	0	6246	0	6242	0.0	0.0
chr10	LINC02641	123489011	123489045	0	35	1377	5335	1377	5300	0.0	0.25981132075471697
chr10	FANK1	125973594	125973767	0	174	51	3163	51	2989	0.0	0.01706256273001004
chr10	PTPRE	128070902	128071741	1224	840	36915	9038	35691	8198	1.457142857142857	4.353622834837766
chr10	LINC01163	128181157	128181212	0	56	80	3197	80	3141	0.0	0.025469595670168738
chr10	LINC02667	128912918	128912982	0	65	0	1874	0	1809	0.0	0.0
chr10	JAKMIP3	132142043	132142048	0	6	97	12408	97	12402	0.0	0.00782131914207386
chr10	JAKMIP3	132150036	132150041	0	6	97	12408	97	12402	0.0	0.00782131914207386
chr10	JAKMIP3	132065290	132066061	0	772	97	12408	97	11636	0.0	0.008336198006187694
chr10	JAKMIP3	132169933	132171255	0	1323	97	12408	97	11085	0.0	0.008750563824988724
chr10	JAKMIP3	132170253	132171255	0	1003	97	12408	97	11405	0.0	0.008505041648399825
chr10	JAKMIP3	132170916	132171255	0	340	97	12408	97	12068	0.0	0.008037785880013259
chr10	JAKMIP3	132169933	132170252	0	320	97	12408	97	12088	0.0	0.008024487094639312
chr10	JAKMIP3	132169933	132170915	0	983	97	12408	97	11425	0.0	0.00849015317286652
chr10	JAKMIP3	132170253	132170915	0	663	97	12408	97	11745	0.0	0.008258833546189868
chr10	PWWP2B	132405987	132406289	0	303	0	2650	0	2347	0.0	0.0
chr10	INPP5A	132781898	132781948	0	51	0	3756	0	3705	0.0	0.0
chr10	ADGRA1	133127329	133127331	0	3	83	6521	83	6518	0.0	0.012733967474685486
chr10	PRAP1	133352114	133352140	0	27	0	754	0	727	0.0	0.0
chr10	PAOX	133391429	133391491	0	63	51	2260	51	2197	0.0	0.02321347291761493
chr11	PSMD13	244706	244761	71434	56	941344	2848	869910	2792	1275.607142857143	311.5723495702006
chr11	PSMD13	251937	251945	0	9	941344	2848	941344	2839	0.0	331.5759070095104
chr11	AC136475.3	288800	288811	0	12	0	738	0	726	0.0	0.0
chr11	PKP3	393518	393534	0	17	53186	3762	53186	3745	0.0	14.201869158878505
chr11	LMNTD2-AS1	559477	559683	865	207	17783	1123	16918	916	4.178743961352657	18.46943231441048
chr11	RASSF7	561034	561477	318	444	117621	2441	117303	1997	0.7162162162162162	58.73960941412118
chr11	RASSF7	563318	563478	9479	161	117621	2441	108142	2280	58.87577639751553	47.430701754385964
chr11	PHRF1	581598	581606	612	9	502902	5803	502290	5794	68.0	86.69140490162236
chr11	TMEM80	695823	695846	103	24	199972	2241	199869	2217	4.291666666666667	90.15290933694182
chr11	EPS8L2	721188	721206	154	19	52484	4588	52330	4569	8.105263157894736	11.453272050776976
chr11	EPS8L2	706802	706813	0	12	52484	4588	52484	4576	0.0	11.469405594405595
chr11	TALDO1	763941	763944	3780	4	1197190	2916	1193410	2912	945.0	409.8248626373626
chr11	RPLP2	810322	810357	227920	36	3499802	1421	3271882	1385	6331.111111111111	2362.3696750902527
chr11	RPLP2	810049	810357	624755	309	3499802	1421	2875047	1112	2021.8608414239482	2585.4739208633096
chr11	CRACR2B	827319	827459	0	141	34138	3193	34138	3052	0.0	11.185452162516382
chr11	CD151	837613	837618	22022	6	1920102	3539	1898080	3533	3670.3333333333335	537.2431361449193
chr11	CD151	833023	833026	7007	4	1920102	3539	1913095	3535	1751.75	541.1867043847242
chr11	CD151	834592	834745	207	154	1920102	3539	1919895	3385	1.344155844155844	567.1772525849335
chr11	CD151	834592	834803	377	212	1920102	3539	1919725	3327	1.778301886792453	577.0138262699128
chr11	CD151	834746	834803	170	58	1920102	3539	1919932	3481	2.9310344827586206	551.5461074403906
chr11	BRSK2	1459237	1459239	0	3	1980	6414	1980	6411	0.0	0.3088441740758072
chr11	SYT8	1834602	1834617	0	16	99	3521	99	3505	0.0	0.0282453637660485
chr11	LSP1	1870566	1871412	0	847	0	6021	0	5174	0.0	0.0
chr11	LSP1	1870662	1871412	0	751	0	6021	0	5270	0.0	0.0
chr11	LSP1	1870974	1871412	0	439	0	6021	0	5582	0.0	0.0
chr11	LSP1	1870566	1870661	0	96	0	6021	0	5925	0.0	0.0
chr11	MRPL23	1955718	1955781	0	64	357	2986	357	2922	0.0	0.12217659137577003
chr11	TSPAN32	2302216	2302222	0	7	0	2972	0	2965	0.0	0.0
chr11	TSPAN32	2313709	2313755	0	47	0	2972	0	2925	0.0	0.0
chr11	TSSC4	2401980	2402147	0	168	914	2556	914	2388	0.0	0.38274706867671693
chr11	TSSC2	3406611	3406715	713	105	7071	3680	6358	3575	6.79047619047619	1.7784615384615385
chr11	TRPC2	3636237	3636240	0	4	0	3280	0	3276	0.0	0.0
chr11	PGAP2	3824365	3824376	0	12	2848	3571	2848	3559	0.0	0.8002247822422028
chr11	PGAP2	3824377	3824455	0	79	2848	3571	2848	3492	0.0	0.8155784650630011
chr11	PGAP2	3824365	3824455	0	91	2848	3571	2848	3480	0.0	0.8183908045977012
chr11	PGAP2	3824450	3824455	0	6	2848	3571	2848	3565	0.0	0.7988779803646564
chr11	PGAP2	3797983	3798100	0	118	2848	3571	2848	3453	0.0	0.8247900376484216
chr11	PGAP2	3824377	3824449	0	73	2848	3571	2848	3498	0.0	0.8141795311606632
chr11	PGAP2	3824365	3824449	0	85	2848	3571	2848	3486	0.0	0.816982214572576
chr11	STIM1	4086544	4086861	0	318	25535	6805	25535	6487	0.0	3.936334206875289
chr11	STIM1	3947668	3947724	0	57	25535	6805	25535	6748	0.0	3.7840841730883223
chr11	RRM1	4119929	4119970	0	42	89423	4257	89423	4215	0.0	21.215421115065244
chr11	TRIM6	5604630	5604797	0	168	50	3973	50	3805	0.0	0.013140604467805518
chr11	CCKBR	6270804	6270818	0	15	0	2398	0	2383	0.0	0.0
chr11	SMPD1	6392157	6392196	0	40	44	2455	44	2415	0.0	0.018219461697722567
chr11	SMPD1	6391504	6392196	0	693	44	2455	44	1762	0.0	0.024971623155505107
chr11	SMPD1	6391504	6392156	0	653	44	2455	44	1802	0.0	0.0244173140954495
chr11	DNHD1	6534174	6534229	0	56	213785	18420	213785	18364	0.0	11.641526900457416
chr11	DNHD1	6563132	6563255	352	124	213785	18420	213433	18296	2.838709677419355	11.665555312636641
chr11	ZNF215	6926686	6926861	51	176	102	5918	51	5742	0.2897727272727273	0.008881922675026124
chr11	ZNF215	6926729	6926861	40	133	102	5918	62	5785	0.3007518796992481	0.010717372515125324
chr11	ZNF215	6926686	6926728	11	43	102	5918	91	5875	0.2558139534883721	0.01548936170212766
chr11	OLFML1	7488151	7488415	0	265	204	3439	204	3174	0.0	0.06427221172022685
chr11	PPFIBP2	7655449	7655498	0	50	0	8897	0	8847	0.0	0.0
chr11	PPFIBP2	7641066	7641083	0	18	0	8897	0	8879	0.0	0.0
chr11	EIF3F	7991852	7991971	0	120	3111	8989	3111	8869	0.0	0.3507723531401511
chr11	AMPD3	10493544	10493702	0	159	2361	6622	2361	6463	0.0	0.3653102274485533
chr11	ZBED5-AS1	10858352	10858366	0	15	40898	4558	40898	4543	0.0	9.002421307506053
chr11	ZBED5-AS1	10858280	10858366	0	87	40898	4558	40898	4471	0.0	9.147394318944308
chr11	ZBED5-AS1	10858280	10858351	0	72	40898	4558	40898	4486	0.0	9.116807846633971
chr11	ZBED5-AS1	10858367	10858942	0	576	40898	4558	40898	3982	0.0	10.2707182320442
chr11	ZBED5-AS1	10858352	10858942	0	591	40898	4558	40898	3967	0.0	10.309553819006807
chr11	ZBED5-AS1	10858280	10858942	0	663	40898	4558	40898	3895	0.0	10.50012836970475
chr11	ZBED5-AS1	10858943	10859112	0	170	40898	4558	40898	4388	0.0	9.320419325432999
chr11	MICAL2	12138461	12138464	0	4	42984	16154	42984	16150	0.0	2.6615479876160992
chr11	MICAL2	12161533	12161576	0	44	42984	16154	42984	16110	0.0	2.6681564245810057
chr11	MICAL2	12262538	12262635	268	98	42984	16154	42716	16056	2.7346938775510203	2.6604384653712008
chr11	LINC02548	13845096	13845186	0	91	0	2483	0	2392	0.0	0.0
chr11	PDE3B	14786533	14786685	0	153	649	11644	649	11491	0.0	0.05647898355234531
chr11	LINC02682	15922652	15922655	0	4	0	3435	0	3431	0.0	0.0
chr11	NUCB2	17276829	17276848	0	20	181799	9053	181799	9033	0.0	20.126093213771725
chr11	SAA1	18269334	18269364	0	31	0	714	0	683	0.0	0.0
chr11	SAA1	18266297	18266443	0	147	0	714	0	567	0.0	0.0
chr11	GTF2H1	18326020	18326153	0	134	15245	6442	15245	6308	0.0	2.4167723525681675
chr11	LDHA	18394637	18394641	0	5	969	4566	969	4561	0.0	0.212453409340057
chr11	LDHA	18394642	18394886	0	245	969	4566	969	4321	0.0	0.22425364498958575
chr11	LDHA	18394637	18394886	0	250	969	4566	969	4316	0.0	0.22451343836886006
chr11	LDHC	18412409	18412462	0	54	612	2097	612	2043	0.0	0.29955947136563876
chr11	SPTY2D1OS	18601165	18601180	0	16	10334	2291	10334	2275	0.0	4.542417582417582
chr11	HTATIP2	20363750	20363798	0	49	51	2801	51	2752	0.0	0.018531976744186048
chr11	HTATIP2	20363750	20363912	0	163	51	2801	51	2638	0.0	0.019332827899924184
chr11	HTATIP2	20363799	20363912	0	114	51	2801	51	2687	0.0	0.018980275400074433
chr11	PRMT3	20387775	20388154	1581	380	6588	5499	5007	5119	4.160526315789474	0.9781207267044345
chr11	BBOX1	27041020	27041028	0	9	51	2152	51	2143	0.0	0.02379841343910406
chr11	BDNF-AS	27658463	27658544	0	82	113219	12372	113219	12290	0.0	9.212286411716843
chr11	BDNF-AS	27658463	27658620	0	158	113219	12372	113219	12214	0.0	9.269608645816277
chr11	BDNF-AS	27658545	27658620	0	76	113219	12372	113219	12296	0.0	9.207791151594014
chr11	LINC02546	29594407	29594441	0	35	0	2969	0	2934	0.0	0.0
chr11	LINC02546	29622914	29623076	0	163	0	2969	0	2806	0.0	0.0
chr11	LINC02546	29618860	29619001	0	142	0	2969	0	2827	0.0	0.0
chr11	FSHB	30231049	30231078	0	30	0	1956	0	1926	0.0	0.0
chr11	DNAJC24	31426356	31426480	0	125	663	6529	663	6404	0.0	0.10352904434728295
chr11	ELP4	31594902	31594905	0	4	15568	23173	15568	23169	0.0	0.6719323233631145
chr11	TCP11L1	33039793	33041316	0	1524	4875	5147	4875	3623	0.0	1.3455699696384211
chr11	TCP11L1	33040203	33041316	0	1114	4875	5147	4875	4033	0.0	1.2087775849243738
chr11	TCP11L1	33040207	33041316	0	1110	4875	5147	4875	4037	0.0	1.2075798860540006
chr11	TCP11L1	33040388	33041316	0	929	4875	5147	4875	4218	0.0	1.1557610241820768
chr11	TCP11L1	33040203	33040206	0	4	4875	5147	4875	5143	0.0	0.947890336379545
chr11	TCP11L1	33040203	33040387	0	185	4875	5147	4875	4962	0.0	0.9824667472793228
chr11	TCP11L1	33040207	33040387	0	181	4875	5147	4875	4966	0.0	0.981675392670157
chr11	KIAA1549L	33542147	33544336	51	2190	36880	13519	36829	11329	0.023287671232876714	3.250860623179451
chr11	KIAA1549L	33544337	33544354	0	18	36880	13519	36880	13501	0.0	2.731649507443893
chr11	CD44	35189973	35190065	188	93	2905450	9710	2905262	9617	2.021505376344086	302.0964957887075
chr11	IFTAP	36594593	36594761	0	169	502	10397	502	10228	0.0	0.049080954243253816
chr11	IFTAP	36594642	36594761	0	120	502	10397	502	10277	0.0	0.04884693976841491
chr11	IFTAP	36594593	36594915	0	323	502	10397	502	10074	0.0	0.04983124875918205
chr11	IFTAP	36594762	36594915	0	154	502	10397	502	10243	0.0	0.04900907937127794
chr11	IFTAP	36594642	36594915	0	274	502	10397	502	10123	0.0	0.04959004247752642
chr11	IFTAP	36594593	36594641	0	49	502	10397	502	10348	0.0	0.048511789717819866
chr11	LINC01493	38648841	38648934	0	94	0	2429	0	2335	0.0	0.0
chr11	HSD17B12	43680805	43680987	0	183	0	4696	0	4513	0.0	0.0
chr11	HSD17B12	43680805	43681183	0	379	0	4696	0	4317	0.0	0.0
chr11	HSD17B12	43680988	43681183	0	196	0	4696	0	4500	0.0	0.0
chr11	ALKBH3	43881180	43881446	2824	267	30827	2155	28003	1888	10.576779026217228	14.83209745762712
chr11	ACCS	44067775	44067778	0	4	25	4458	25	4454	0.0	0.005612932195779075
chr11	ACCS	44067779	44067915	0	137	25	4458	25	4321	0.0	0.005785697755149271
chr11	ACCS	44067775	44067915	0	141	25	4458	25	4317	0.0	0.0057910586055130876
chr11	ACCS	44066323	44066701	0	379	25	4458	25	4079	0.0	0.006128953174797744
chr11	CD82	44565737	44566000	0	264	3357	3641	3357	3377	0.0	0.9940775836541309
chr11	AC044839.1	45722379	45722457	0	79	0	6744	0	6665	0.0	0.0
chr11	AC044839.1	45723573	45723582	0	10	0	6744	0	6734	0.0	0.0
chr11	AC044839.1	45722458	45722833	0	376	0	6744	0	6368	0.0	0.0
chr11	AC044839.1	45722532	45722833	0	302	0	6744	0	6442	0.0	0.0
chr11	AC044839.1	45722458	45722531	0	74	0	6744	0	6670	0.0	0.0
chr11	SLC35C1	45804421	45804517	0	97	0	3372	0	3275	0.0	0.0
chr11	AC024475.3	46171989	46172024	0	36	204	1637	204	1601	0.0	0.127420362273579
chr11	DGKZ	46366527	46366984	0	458	18415	8820	18415	8362	0.0	2.2022243482420474
chr11	MDK	46381184	46381328	255	145	16293	2201	16038	2056	1.7586206896551724	7.8005836575875485
chr11	MDK	46381289	46381328	0	40	16293	2201	16293	2161	0.0	7.539565016196206
chr11	MDK	46381184	46381288	255	105	16293	2201	16038	2096	2.4285714285714284	7.651717557251908
chr11	MDK	46381759	46382133	2726	375	16293	2201	13567	1826	7.269333333333333	7.429901423877327
chr11	MDK	46381759	46381885	1177	127	16293	2201	15116	2074	9.26771653543307	7.288331726133076
chr11	MDK	46382749	46383193	2903	445	16293	2201	13390	1756	6.523595505617978	7.625284738041002
chr11	ATG13	46668577	46668690	0	114	7415	5435	7415	5321	0.0	1.3935350498026686
chr11	F2	46728721	46728837	0	117	54337	2547	54337	2430	0.0	22.360905349794237
chr11	F2	46719315	46719415	0	101	54337	2547	54337	2446	0.0	22.214636140637776
chr11	DDB2	47215264	47215272	9	9	14186	4822	14177	4813	1.0	2.945564097236651
chr11	NR1H3	47257636	47257735	5600	100	337523	4063	331923	3963	56.0	83.7554882664648
chr11	NR1H3	47258130	47258165	2389	36	337523	4063	335134	4027	66.36111111111111	83.22175316612864
chr11	NR1H3	47258130	47259259	62401	1130	337523	4063	275122	2933	55.22212389380531	93.80225025571087
chr11	MADD	47285066	47285194	0	129	89108	8408	89108	8279	0.0	10.763135644401498
chr11	MADD	47295568	47295579	0	12	89108	8408	89108	8396	0.0	10.613149118627918
chr11	MADD	47295577	47295579	0	3	89108	8408	89108	8405	0.0	10.601784651992862
chr11	MADD	47269751	47269906	786	156	89108	8408	88322	8252	5.038461538461538	10.70310227823558
chr11	MADD	47295568	47295576	0	9	89108	8408	89108	8399	0.0	10.60935825693535
chr11	SLC39A13	47414906	47414909	0	4	102	3873	102	3869	0.0	0.026363401395709484
chr11	NDUFS3	47579335	47579338	0	4	6233	4322	6233	4318	0.0	1.4434923575729504
chr11	P2RX3	57368101	57368102	0	2	154	4446	154	4444	0.0	0.034653465346534656
chr11	P2RX3	57348264	57348354	0	91	154	4446	154	4355	0.0	0.035361653272101036
chr11	SMTNL1	57543342	57543374	0	33	6900	1577	6900	1544	0.0	4.4689119170984455
chr11	CLP1	57659891	57660082	0	192	0	2176	0	1984	0.0	0.0
chr11	SELENOH	57742228	57742247	0	20	0	1851	0	1831	0.0	0.0
chr11	CTNND1	57762047	57762119	0	73	1432	9351	1432	9278	0.0	0.15434360853632248
chr11	CTNND1	57762069	57762119	0	51	1432	9351	1432	9300	0.0	0.15397849462365593
chr11	CTNND1	57762047	57762068	0	22	1432	9351	1432	9329	0.0	0.15349983921106228
chr11	CTNND1	57762120	57762318	0	199	1432	9351	1432	9152	0.0	0.15646853146853146
chr11	GLYATL1	58947069	58947165	0	97	8773	4761	8773	4664	0.0	1.8810034305317325
chr11	FAM111A	59144897	59145856	0	960	153	6384	153	5424	0.0	0.02820796460176991
chr11	FAM111A	59142947	59142969	0	23	153	6384	153	6361	0.0	0.024052821883351675
chr11	FAM111A	59144897	59144900	0	4	153	6384	153	6380	0.0	0.023981191222570534
chr11	OR5AN1	59359273	59360093	745	821	162570	8504	161825	7683	0.9074299634591961	21.062735910451647
chr11	AP000442.1	59635533	59635536	0	4	1412	1810	1412	1806	0.0	0.7818383167220376
chr11	MS4A7	60378617	60378664	0	48	357	3914	357	3866	0.0	0.09234350750129333
chr11	MS4A14	60397981	60398171	0	191	3	4014	3	3823	0.0	0.0007847240387130526
chr11	MS4A12	60492829	60493032	51	204	51	1846	0	1642	0.25	0.0
chr11	MS4A8	60708729	60708781	484	53	54978	2227	54494	2174	9.132075471698114	25.06623735050598
chr11	MS4A18	60729787	60729792	0	6	0	1427	0	1421	0.0	0.0
chr11	TMEM132A	60924544	60924733	342	190	6731	5092	6389	4902	1.8	1.3033455732354142
chr11	TKFC	61333313	61333329	0	17	0	7716	0	7699	0.0	0.0
chr11	TMEM138	61364316	61364518	0	203	51	4888	51	4685	0.0	0.010885805763073639
chr11	TMEM216	61392666	61392679	0	14	40	1687	40	1673	0.0	0.023909145248057383
chr11	SDHAF2	61438114	61438120	0	7	2	1702	2	1695	0.0	0.0011799410029498525
chr11	AP003108.1	61499328	61499333	0	6	3841	1619	3841	1613	0.0	2.381277123372598
chr11	AP003108.1	61499836	61499896	0	61	3841	1619	3841	1558	0.0	2.4653401797175865
chr11	AP002754.1	61588475	61588615	1147	141	5625	2760	4478	2619	8.134751773049645	1.7098129056891944
chr11	DAGLA	61720868	61720890	0	23	2317179	5819	2317179	5796	0.0	399.7893374741201
chr11	MYRF	61783926	61784027	204	102	4886	9103	4682	9001	2.0	0.5201644261748695
chr11	FEN1	61793029	61793210	0	182	51	1594	51	1412	0.0	0.03611898016997167
chr11	FADS2	61816427	61816696	0	270	3024	8306	3024	8036	0.0	0.37630662020905925
chr11	BEST1	61958299	61958501	0	203	521	5587	521	5384	0.0	0.09676820208023774
chr11	INCENP	62124056	62124163	51	108	6496	3753	6445	3645	0.4722222222222222	1.7681755829903978
chr11	ROM1	62611921	62612091	0	171	0	1647	0	1476	0.0	0.0
chr11	ROM1	62613776	62613871	0	96	0	1647	0	1551	0.0	0.0
chr11	TTC9C	62728228	62728736	0	509	0	2634	0	2125	0.0	0.0
chr11	POLR2G	62761615	62761660	0	46	0	1552	0	1506	0.0	0.0
chr11	POLR2G	62761905	62762184	0	280	0	1552	0	1272	0.0	0.0
chr11	POLR2G	62762867	62763026	0	160	0	1552	0	1392	0.0	0.0
chr11	SLC3A2	62881316	62881447	0	132	0	3522	0	3390	0.0	0.0
chr11	SLC22A10	63302405	63302543	0	139	0	3299	0	3160	0.0	0.0
chr11	MARK2	63904148	63904354	0	207	9035	8854	9035	8647	0.0	1.044871053544582
chr11	MARK2	63906115	63907567	1071	1453	9035	8854	7964	7401	0.7370956641431521	1.0760708012430753
chr11	OTUB1	63986951	63987038	0	88	211324	4956	211324	4868	0.0	43.41084634346754
chr11	NUDT22	64226298	64226427	0	130	0	3038	0	2908	0.0	0.0
chr11	FKBP2	64241748	64241994	0	247	7	1259	7	1012	0.0	0.00691699604743083
chr11	PPP1R14B-AS1	64246090	64246248	0	159	0	849	0	690	0.0	0.0
chr11	GPR137	64285263	64285380	0	118	51	3606	51	3488	0.0	0.014621559633027524
chr11	GPR137	64285565	64285607	0	43	51	3606	51	3563	0.0	0.014313780522031996
chr11	ESRRA	64306449	64306846	0	398	0	3109	0	2711	0.0	0.0
chr11	CCDC88B	64354029	64354170	0	142	102	6744	102	6602	0.0	0.015449863677673432
chr11	RPS6KA4	64359404	64359449	0	46	0	3824	0	3778	0.0	0.0
chr11	SLC22A12	64593458	64593559	0	102	2830	2982	2830	2880	0.0	0.9826388888888888
chr11	SNX15	65027625	65027636	0	12	26853	4844	26853	4832	0.0	5.5573261589403975
chr11	SNX15	65032204	65032271	533	68	26853	4844	26320	4776	7.838235294117647	5.510887772194305
chr11	SAC3D1	65041867	65041928	0	62	1071	1673	1071	1611	0.0	0.664804469273743
chr11	ZFPL1	65084783	65084800	0	18	32052	2401	32052	2383	0.0	13.450272765421737
chr11	ZFPL1	65084361	65084378	12	18	32052	2401	32040	2383	0.6666666666666666	13.445237096097356
chr11	ZFPL1	65085227	65085314	0	88	32052	2401	32052	2313	0.0	13.857328145265889
chr11	VPS51	65109496	65109591	51	96	222656	4595	222605	4499	0.53125	49.478773060680155
chr11	TM7SF2	65111891	65112067	1022	177	161869	2460	160847	2283	5.7740112994350286	70.45422689443714
chr11	TM7SF2	65111982	65112067	929	86	161869	2460	160940	2374	10.80232558139535	67.79275484414491
chr11	TM7SF2	65111891	65111981	93	91	161869	2460	161776	2369	1.021978021978022	68.28872942169691
chr11	TM7SF2	65112866	65112894	0	29	161869	2460	161869	2431	0.0	66.58535582064994
chr11	MRPL49	65122341	65122424	0	84	4682	2385	4682	2301	0.0	2.034767492394611
chr11	MRPL49	65122425	65122464	0	40	4682	2385	4682	2345	0.0	1.996588486140725
chr11	CAPN1	65181783	65181786	0	4	117620	5821	117620	5817	0.0	20.22004469657899
chr11	CAPN1	65181783	65181806	0	24	117620	5821	117620	5797	0.0	20.289805071588752
chr11	CAPN1	65181787	65181806	0	20	117620	5821	117620	5801	0.0	20.275814514738837
chr11	CAPN1	65181783	65181843	0	61	117620	5821	117620	5760	0.0	20.42013888888889
chr11	CAPN1	65181787	65181843	0	57	117620	5821	117620	5764	0.0	20.405968077723802
chr11	CAPN1	65181807	65181843	0	37	117620	5821	117620	5784	0.0	20.335408022130014
chr11	CAPN1	65182014	65182308	51	295	117620	5821	117569	5526	0.17288135593220338	21.275606225117627
chr11	CAPN1	65182481	65182562	561	82	117620	5821	117059	5739	6.841463414634147	20.39710751001917
chr11	CAPN1	65182542	65182562	132	21	117620	5821	117488	5800	6.285714285714286	20.256551724137932
chr11	CAPN1	65182481	65182541	429	61	117620	5821	117191	5760	7.032786885245901	20.345659722222223
chr11	CAPN1	65182481	65182579	577	99	117620	5821	117043	5722	5.828282828282828	20.45491087032506
chr11	CAPN1	65182563	65182579	16	17	117620	5821	117604	5804	0.9411764705882353	20.262577532736046
chr11	CAPN1	65182542	65182579	148	38	117620	5821	117472	5783	3.8947368421052633	20.313332180529137
chr11	NEAT1	65423114	65423212	41497	99	831545	21017	790048	20918	419.16161616161617	37.76881154986136
chr11	NEAT1	65423213	65423219	4716	7	831545	21017	826829	21010	673.7142857142857	39.35406949071871
chr11	NEAT1	65423658	65423678	84	21	831545	21017	831461	20996	4.0	39.60092398552105
chr11	ZNRD2	65570740	65570755	0	16	598	1874	598	1858	0.0	0.3218514531754575
chr11	EHBP1L1	65582017	65583765	14285	1749	34886	5816	20601	4067	8.167524299599771	5.065404475043029
chr11	SIPA1	65638183	65638420	9657	238	69636	4641	59979	4403	40.575630252100844	13.622302975244152
chr11	KAT5	65713056	65713058	0	3	25	3659	25	3656	0.0	0.006838074398249453
chr11	KAT5	65718750	65718775	0	26	25	3659	25	3633	0.0	0.006881365262868153
chr11	SNX32	65834074	65834101	553	28	78434	3148	77881	3120	19.75	24.961858974358975
chr11	SNX32	65849541	65849582	36	42	78434	3148	78398	3106	0.8571428571428571	25.24082421120412
chr11	SNX32	65834084	65834101	163	18	78434	3148	78271	3130	9.055555555555555	25.00670926517572
chr11	MUS81	65863658	65863721	0	64	3891	4721	3891	4657	0.0	0.8355164268842602
chr11	TSGA10IP	65945823	65945866	0	44	1250	2069	1250	2025	0.0	0.6172839506172839
chr11	BANF1	66003330	66003373	1347	44	46760	1298	45413	1254	30.613636363636363	36.21451355661882
chr11	BANF1	66003040	66003070	0	31	46760	1298	46760	1267	0.0	36.9060773480663
chr11	BANF1	66002514	66002570	72	57	46760	1298	46688	1241	1.263157894736842	37.62127316680097
chr11	KLC2	66257731	66257871	0	141	41538	3969	41538	3828	0.0	10.851097178683386
chr11	CNIH2	66282328	66282353	175	26	28071	1769	27896	1743	6.730769230769231	16.004589787722317
chr11	RBM4	66638753	66638893	3263	141	13881	6217	10618	6076	23.141843971631207	1.7475312705727453
chr11	C11ORF80	66788270	66788273	0	4	6159	3974	6159	3970	0.0	1.5513853904282116
chr11	C11ORF80	66801103	66801161	252	59	6159	3974	5907	3915	4.271186440677966	1.5088122605363985
chr11	KDM2A	67250347	67250798	45101	452	873496	10408	828395	9956	99.78097345132744	83.20560466050622
chr11	ANKRD13D	67300124	67300499	0	376	333	4350	333	3974	0.0	0.08379466532460997
chr11	RAD9A	67396172	67396175	0	4	149038	3780	149038	3776	0.0	39.469809322033896
chr11	TBC1D10C	67406693	67406738	0	46	38	4302	38	4256	0.0	0.008928571428571428
chr11	RPS6KB2	67433195	67433216	0	22	452	2864	452	2842	0.0	0.15904292751583393
chr11	CABP4	67456418	67456442	0	25	51	5137	51	5112	0.0	0.009976525821596244
chr11	GSTP1	67586212	67586273	0	62	52	1247	52	1185	0.0	0.04388185654008439
chr11	AP003385.3	67605793	67606044	255	252	0	557	-255	305	1.0119047619047619	-0.8360655737704918
chr11	NDUFV1	67607050	67607076	0	27	408	3785	408	3758	0.0	0.10856838744012773
chr11	NDUFV1	67607056	67607076	0	21	408	3785	408	3764	0.0	0.10839532412327312
chr11	NDUFV1	67608458	67608478	0	21	408	3785	408	3764	0.0	0.10839532412327312
chr11	NDUFV1	67607050	67607055	0	6	408	3785	408	3779	0.0	0.10796507012437152
chr11	NDUFS8	68032337	68032523	42	187	23298	3779	23256	3592	0.22459893048128343	6.474387527839643
chr11	NDUFS8	68030878	68030961	913	84	23298	3779	22385	3695	10.869047619047619	6.058186738836265
chr11	TCIRG1	68041347	68041388	0	42	22032	4293	22032	4251	0.0	5.182780522230064
chr11	TCIRG1	68043032	68043497	4489	466	22032	4293	17543	3827	9.633047210300429	4.584008361640972
chr11	PPP6R3	68505250	68505271	549	22	357012	8173	356463	8151	24.954545454545453	43.732425469267575
chr11	IGHMBP2	68906136	68906238	0	103	2932	8643	2932	8540	0.0	0.3433255269320843
chr11	IGHMBP2	68906201	68906238	0	38	2932	8643	2932	8605	0.0	0.3407321324811156
chr11	IGHMBP2	68915018	68915023	0	6	2932	8643	2932	8637	0.0	0.3394697232835475
chr11	IGHMBP2	68906239	68906242	0	4	2932	8643	2932	8639	0.0	0.33939113323301306
chr11	IGHMBP2	68906136	68906242	0	107	2932	8643	2932	8536	0.0	0.3434864104967198
chr11	IGHMBP2	68906201	68906242	0	42	2932	8643	2932	8601	0.0	0.34089059411696315
chr11	IGHMBP2	68906239	68906384	0	146	2932	8643	2932	8497	0.0	0.3450629633988467
chr11	IGHMBP2	68906243	68906384	0	142	2932	8643	2932	8501	0.0	0.34490059992942007
chr11	IGHMBP2	68906136	68906384	0	249	2932	8643	2932	8394	0.0	0.349297116988325
chr11	IGHMBP2	68906201	68906384	0	184	2932	8643	2932	8459	0.0	0.34661307483154036
chr11	IGHMBP2	68911604	68911992	0	389	2932	8643	2932	8254	0.0	0.3552217106857281
chr11	IGHMBP2	68911604	68912169	0	566	2932	8643	2932	8077	0.0	0.36300606660888945
chr11	IGHMBP2	68911993	68912169	0	177	2932	8643	2932	8466	0.0	0.346326482400189
chr11	IGHMBP2	68906136	68906200	0	65	2932	8643	2932	8578	0.0	0.3418046164607135
chr11	IGHMBP2	68936784	68936823	0	40	2932	8643	2932	8603	0.0	0.3408113448796931
chr11	ANO1	70085543	70085670	0	128	11966	6051	11966	5923	0.0	2.0202600033766673
chr11	PPFIA1	70338435	70338453	0	19	17946	10724	17946	10705	0.0	1.6764128911723493
chr11	PPFIA1	70339307	70339311	0	5	17946	10724	17946	10719	0.0	1.674223341729639
chr11	CTTN	70435556	70435744	0	189	67	5771	67	5582	0.0	0.012002866356144752
chr11	NADSYN1	71458545	71458556	0	12	13864	14232	13864	14220	0.0	0.9749648382559775
chr11	UNC93B6	71605466	71605467	10	2	1818	1146	1808	1144	5.0	1.5804195804195804
chr11	ENPP7P8	71722309	71722311	57	3	115211	1440	115154	1437	19.0	80.13500347947112
chr11	FAM86C1P	71796167	71796308	2277	142	50228	3381	47951	3239	16.035211267605632	14.804260574251312
chr11	IL18BP	72001425	72001552	9233	128	136972	3492	127739	3364	72.1328125	37.97235434007134
chr11	IL18BP	71999371	71999662	425	292	136972	3492	136547	3200	1.4554794520547945	42.6709375
chr11	LRTOMT	72080763	72080885	0	123	1479	3353	1479	3230	0.0	0.45789473684210524
chr11	FOLR2	72216920	72216925	0	6	0	1197	0	1191	0.0	0.0
chr11	FOLR2	72216897	72216925	0	29	0	1197	0	1168	0.0	0.0
chr11	FOLR2	72216897	72216919	0	23	0	1197	0	1174	0.0	0.0
chr11	ATG16L2	72822962	72823797	760	836	4485	7660	3725	6824	0.9090909090909091	0.5458675263774913
chr11	PLEKHB1	73647739	73647895	0	157	8649	3884	8649	3727	0.0	2.320633217064663
chr11	PLEKHB1	73647867	73647895	0	29	8649	3884	8649	3855	0.0	2.243579766536965
chr11	PLEKHB1	73647739	73647866	0	128	8649	3884	8649	3756	0.0	2.3027156549520766
chr11	PAAF1	73877069	73877306	255	238	6238	5654	5983	5416	1.0714285714285714	1.1046898079763663
chr11	POLD3	74592719	74593037	175	319	14741	5517	14566	5198	0.54858934169279	2.8022316275490575
chr11	POLD3	74592932	74593037	0	106	14741	5517	14741	5411	0.0	2.7242653853261873
chr11	POLD3	74592719	74592931	175	213	14741	5517	14566	5304	0.8215962441314554	2.7462292609351433
chr11	SLCO2B1	75159873	75159929	0	57	2807	6153	2807	6096	0.0	0.46046587926509186
chr11	SLCO2B1	75159905	75159929	0	25	2807	6153	2807	6128	0.0	0.45806135770234985
chr11	SLCO2B1	75159873	75159904	0	32	2807	6153	2807	6121	0.0	0.4585851984969776
chr11	RPS3	75400778	75400824	0	47	0	4632	0	4585	0.0	0.0
chr11	RPS3	75401706	75401725	0	20	0	4632	0	4612	0.0	0.0
chr11	RPS3	75402380	75402446	0	67	0	4632	0	4565	0.0	0.0
chr11	SERPINH1	75569172	75570797	0	1626	6864	5453	6864	3827	0.0	1.7935719885027437
chr11	SERPINH1	75562320	75562341	0	22	6864	5453	6864	5431	0.0	1.2638556435278954
chr11	SERPINH1	75562320	75562378	0	59	6864	5453	6864	5394	0.0	1.2725250278086764
chr11	SERPINH1	75562342	75562378	0	37	6864	5453	6864	5416	0.0	1.2673559822747416
chr11	SERPINH1	75562379	75563770	7006	1392	6864	5453	-142	4061	5.033045977011494	-0.03496675695641468
chr11	SERPINH1	75562885	75563770	6904	886	6864	5453	-40	4567	7.792325056433409	-0.00875848478213269
chr11	SERPINH1	75562885	75563016	5508	132	6864	5453	1356	5321	41.72727272727273	0.2548393159180605
chr11	GVQW3	76382211	76382293	0	83	51	20105	51	20022	0.0	0.0025471980821096794
chr11	GVQW3	76381375	76382904	51	1530	51	20105	0	18575	0.03333333333333333	0.0
chr11	GVQW3	76382294	76382904	0	611	51	20105	51	19494	0.0	0.0026161895967990153
chr11	GVQW3	76382211	76382904	0	694	51	20105	51	19411	0.0	0.0026273762299726957
chr11	GVQW3	76381375	76382293	51	919	51	20105	0	19186	0.055495103373231776	0.0
chr11	GVQW3	76381375	76382210	51	836	51	20105	0	19269	0.061004784688995214	0.0
chr11	ACER3	76861063	76861079	0	17	71423	8264	71423	8247	0.0	8.660482599733236
chr11	ACER3	76868157	76868267	0	111	71423	8264	71423	8153	0.0	8.760333619526554
chr11	MYO7A	77211932	77211937	0	6	2747	9808	2747	9802	0.0	0.2802489287900429
chr11	AAMDC	77821181	77821241	38	61	15957	1874	15919	1813	0.6229508196721312	8.780474351902923
chr11	AAMDC	77821238	77821241	0	4	15957	1874	15957	1870	0.0	8.533155080213904
chr11	USP35	78206036	78206039	0	4	1599	5765	1599	5761	0.0	0.27755597986460684
chr11	LINC02734	82791696	82791724	713	29	2838	1211	2125	1182	24.586206896551722	1.7978003384094754
chr11	DDIAS	82914032	82914170	0	139	18255	5351	18255	5212	0.0	3.5024942440521873
chr11	RAB30-DT	83072703	83072804	0	102	225	6987	225	6885	0.0	0.032679738562091505
chr11	RAB30-DT	83072147	83072181	0	35	225	6987	225	6952	0.0	0.03236478711162256
chr11	PCF11	83167506	83167898	0	393	51	9968	51	9575	0.0	0.005326370757180157
chr11	ANKRD42	83194035	83194728	0	694	51	6726	51	6032	0.0	0.008454907161803714
chr11	ANKRD42	83198559	83198642	0	84	51	6726	51	6642	0.0	0.0076784101174345075
chr11	ANKRD42	83210417	83210419	0	3	51	6726	51	6723	0.0	0.007585899152164213
chr11	TMEM126B	85634177	85634279	0	103	102	2156	102	2053	0.0	0.04968339016074038
chr11	TMEM126B	85629204	85629262	0	59	102	2156	102	2097	0.0	0.04864091559370529
chr11	TMEM126A	85654235	85654256	0	22	625	976	625	954	0.0	0.6551362683438156
chr11	NAALAD2	90134837	90134840	0	4	68	6651	68	6647	0.0	0.010230179028132993
chr11	DISC1FP1	90844950	90844957	0	8	1152	3223	1152	3215	0.0	0.3583203732503888
chr11	LINC02756	91795413	91795461	0	49	0	2679	0	2630	0.0	0.0
chr11	DEUP1	93408408	93408427	0	20	4174	4161	4174	4141	0.0	1.007969089591886
chr11	DEUP1	93330093	93330241	51	149	4174	4161	4123	4012	0.3422818791946309	1.027666999002991
chr11	DEUP1	93330773	93330778	0	6	4174	4161	4174	4155	0.0	1.0045728038507822
chr11	CEP295	93696855	93700186	137	3332	722	8943	585	5611	0.04111644657863145	0.10425949028693637
chr11	CEP295	93695635	93695673	0	39	722	8943	722	8904	0.0	0.08108715184186882
chr11	C11ORF54	93742067	93742094	0	28	51	5944	51	5916	0.0	0.008620689655172414
chr11	C11ORF54	93742067	93742141	0	75	51	5944	51	5869	0.0	0.008689725677287442
chr11	C11ORF54	93742095	93742141	0	47	51	5944	51	5897	0.0	0.008648465321349838
chr11	MED17	93807636	93809876	0	2241	0	8731	0	6490	0.0	0.0
chr11	MED17	93784764	93784933	0	170	0	8731	0	8561	0.0	0.0
chr11	AP002784.1	94214209	94214251	0	43	118269	5352	118269	5309	0.0	22.277076662271615
chr11	IZUMO1R	94306702	94306722	0	21	0	831	0	810	0.0	0.0
chr11	ANKRD49	94496952	94497077	0	126	0	3004	0	2878	0.0	0.0
chr11	ANKRD49	94496829	94497077	0	249	0	3004	0	2755	0.0	0.0
chr11	ANKRD49	94497057	94497077	0	21	0	3004	0	2983	0.0	0.0
chr11	ANKRD49	94497078	94497118	0	41	0	3004	0	2963	0.0	0.0
chr11	ANKRD49	94496952	94497118	0	167	0	3004	0	2837	0.0	0.0
chr11	ANKRD49	94496829	94497118	0	290	0	3004	0	2714	0.0	0.0
chr11	ANKRD49	94497057	94497118	0	62	0	3004	0	2942	0.0	0.0
chr11	ANKRD49	94496829	94496951	0	123	0	3004	0	2881	0.0	0.0
chr11	ANKRD49	94496952	94497056	0	105	0	3004	0	2899	0.0	0.0
chr11	ANKRD49	94496829	94497056	0	228	0	3004	0	2776	0.0	0.0
chr11	ANKRD49	94494036	94494170	0	135	0	3004	0	2869	0.0	0.0
chr11	ANKRD49	94497078	94497261	0	184	0	3004	0	2820	0.0	0.0
chr11	ANKRD49	94497119	94497261	0	143	0	3004	0	2861	0.0	0.0
chr11	ANKRD49	94496952	94497261	0	310	0	3004	0	2694	0.0	0.0
chr11	ANKRD49	94496829	94497261	0	433	0	3004	0	2571	0.0	0.0
chr11	ANKRD49	94497057	94497261	0	205	0	3004	0	2799	0.0	0.0
chr11	LINC02700	94648103	94648108	0	6	2800	3099	2800	3093	0.0	0.9052699644358229
chr11	LINC02700	94644135	94644153	0	19	2800	3099	2800	3080	0.0	0.9090909090909091
chr11	AP000787.1	95151503	95151748	0	246	0	6723	0	6477	0.0	0.0
chr11	AP000787.1	95151749	95152024	0	276	0	6723	0	6447	0.0	0.0
chr11	AP000787.1	95151749	95152255	0	507	0	6723	0	6216	0.0	0.0
chr11	AP000787.1	95152025	95152255	0	231	0	6723	0	6492	0.0	0.0
chr11	YAP1	102206075	102206086	0	12	7041	6322	7041	6310	0.0	1.1158478605388273
chr11	BIRC2	102347377	102347845	0	469	153	3556	153	3087	0.0	0.04956268221574344
chr11	WTAPP1	102747121	102747205	0	85	202	3131	202	3046	0.0	0.06631648063033486
chr11	DYNC2H1	103321238	103321241	12	4	1780	15101	1768	15097	3.0	0.11710935947539246
chr11	GRIA4	105974445	105974557	0	113	2307	10106	2307	9993	0.0	0.23086160312218554
chr11	ACAT1	108134297	108134316	0	20	5056	5827	5056	5807	0.0	0.8706733252970553
chr11	LINC02732	110366535	110366538	0	4	0	2329	0	2325	0.0	0.0
chr11	COLCA2	111299891	111300017	0	127	0	2014	0	1887	0.0	0.0
chr11	AP002008.2	111457222	111457398	0	177	11992	5357	11992	5180	0.0	2.315057915057915
chr11	LAYN	111557644	111557647	0	4	4454	3154	4454	3150	0.0	1.4139682539682539
chr11	DLAT	112025625	112025751	0	127	1911	4265	1911	4138	0.0	0.4618173030449492
chr11	NKAPD1	112074359	112074916	51	558	204	4338	153	3780	0.0913978494623656	0.04047619047619048
chr11	NKAPD1	112075644	112075684	0	41	204	4338	204	4297	0.0	0.0474749825459623
chr11	NKAPD1	112075651	112075684	0	34	204	4338	204	4304	0.0	0.047397769516728624
chr11	NKAPD1	112075644	112075650	0	7	204	4338	204	4331	0.0	0.04710228584622489
chr11	SDHD	112089005	112089011	7	7	3181	2799	3174	2792	1.0	1.1368194842406876
chr11	BCO2	112214927	112214944	0	18	102	6492	102	6474	0.0	0.015755329008341055
chr11	BCO2	112214860	112214944	0	85	102	6492	102	6407	0.0	0.015920087404401435
chr11	BCO2	112193686	112193697	0	12	102	6492	102	6480	0.0	0.01574074074074074
chr11	BCO2	112199770	112199827	0	58	102	6492	102	6434	0.0	0.015853279452906436
chr11	BCO2	112179483	112179569	0	87	102	6492	102	6405	0.0	0.01592505854800937
chr11	BCO2	112214860	112214926	0	67	102	6492	102	6425	0.0	0.015875486381322957
chr11	NCAM1	113273049	113273748	0	700	10388	12494	10388	11794	0.0	0.8807868407664914
chr11	TTC12	113314619	113315200	0	582	46	4931	46	4349	0.0	0.01057714417107381
chr11	TTC12	113315167	113315200	0	34	46	4931	46	4897	0.0	0.009393506228303043
chr11	NNMT	114298136	114298158	0	23	68146	2458	68146	2435	0.0	27.986036960985626
chr11	LINC02702	116653054	116653375	816	322	178561	1108	177745	786	2.5341614906832297	226.1386768447837
chr11	SIDT2	117181515	117181537	0	23	31773	6733	31773	6710	0.0	4.735171385991058
chr11	TAGLN	117203173	117203193	0	21	36934	4328	36934	4307	0.0	8.575342465753424
chr11	TAGLN	117199433	117199829	510	397	36934	4328	36424	3931	1.2846347607052897	9.265835665225133
chr11	RNF214	117238647	117239111	3426	465	76777	4317	73351	3852	7.367741935483871	19.042315680166148
chr11	CEP164	117382905	117382942	0	38	102	12616	102	12578	0.0	0.008109397360470663
chr11	CEP164	117409005	117409028	0	24	102	12616	102	12592	0.0	0.008100381194409149
chr11	TMPRSS4	118099035	118099098	0	64	51	7122	51	7058	0.0	0.007225843015018419
chr11	TMPRSS4	118094856	118094865	0	10	51	7122	51	7112	0.0	0.007170978627671541
chr11	CD3G	118349051	118349171	0	121	14626	3315	14626	3194	0.0	4.579211020663744
chr11	UBE4A	118372667	118372687	0	21	163316	6582	163316	6561	0.0	24.891937204694408
chr11	ATP5MG	118406977	118407097	96	121	48072	2122	47976	2001	0.7933884297520661	23.976011994003
chr11	KMT2A	118491310	118491318	0	9	412881	22794	412881	22785	0.0	18.12073732718894
chr11	TMEM25	118531527	118531601	0	75	51	4816	51	4741	0.0	0.010757224214300781
chr11	PHLDB1	118644175	118644691	0	517	202332	19655	202332	19138	0.0	10.572264604451876
chr11	UPK2	118957315	118957346	0	32	86090	1131	86090	1099	0.0	78.33484986351229
chr11	CENATAC	119011284	119011311	0	28	15981	4795	15981	4767	0.0	3.352422907488987
chr11	TRAPPC4	119019189	119019317	0	129	4219	4642	4219	4513	0.0	0.9348548637270109
chr11	TRAPPC4	119019318	119019424	0	107	4219	4642	4219	4535	0.0	0.9303197353914002
chr11	TRAPPC4	119019189	119019424	0	236	4219	4642	4219	4406	0.0	0.9575578756241488
chr11	HMBS	119088708	119088848	0	141	730	3568	730	3427	0.0	0.2130142982200175
chr11	HMBS	119085067	119085157	0	91	730	3568	730	3477	0.0	0.2099511072763877
chr11	HMBS	119085540	119085893	264	354	730	3568	466	3214	0.7457627118644068	0.1449906658369633
chr11	HMBS	119092164	119092523	0	360	730	3568	730	3208	0.0	0.2275561097256858
chr11	C2CD2L	119106775	119106878	63	104	7653	8904	7590	8800	0.6057692307692307	0.8625
chr11	ABCG4	119149281	119149363	9908	83	34256	5345	24348	5262	119.37349397590361	4.627137970353478
chr11	NLRX1	119168434	119168447	0	14	688243	4706	688243	4692	0.0	146.68435635123615
chr11	NLRX1	119168448	119168522	0	75	688243	4706	688243	4631	0.0	148.61649751673505
chr11	NLRX1	119168434	119168522	0	89	688243	4706	688243	4617	0.0	149.06714316655837
chr11	NLRX1	119168895	119169042	357	148	688243	4706	687886	4558	2.4121621621621623	150.91838525669152
chr11	NLRX1	119168922	119169042	357	121	688243	4706	687886	4585	2.950413223140496	150.02966194111232
chr11	NLRX1	119169043	119169302	22409	260	688243	4706	665834	4446	86.18846153846154	149.76023391812865
chr11	NLRX1	119168895	119169302	22766	408	688243	4706	665477	4298	55.799019607843135	154.83410888785482
chr11	NLRX1	119168922	119169302	22766	381	688243	4706	665477	4325	59.75328083989501	153.86751445086705
chr11	NLRX1	119168895	119168921	0	27	688243	4706	688243	4679	0.0	147.0918999786279
chr11	PDZD3	119186166	119186241	0	76	78752	3455	78752	3379	0.0	23.306303640130217
chr11	PDZD3	119187659	119187700	19	42	78752	3455	78733	3413	0.4523809523809524	23.068561382947554
chr11	PDZD3	119185511	119185628	17802	118	78752	3455	60950	3337	150.864406779661	18.264908600539407
chr11	TBCEL	121024155	121024291	0	137	54	6539	54	6402	0.0	0.008434864104967198
chr11	TBCEL	121035945	121036314	0	370	54	6539	54	6169	0.0	0.008753444642567677
chr11	TECTA	121189881	121190108	0	228	0	8334	0	8106	0.0	0.0
chr11	SORL1	121577039	121577138	0	100	83	17061	83	16961	0.0	0.0048935793880077825
chr11	GRAMD1B	123560528	123560652	0	125	50106	14786	50106	14661	0.0	3.4176386331082464
chr11	AP000866.1	124800895	124801045	0	151	3753	5561	3753	5410	0.0	0.6937153419593346
chr11	AP000866.1	124800719	124801045	0	327	3753	5561	3753	5234	0.0	0.7170424149789836
chr11	AP000866.1	124800942	124801045	0	104	3753	5561	3753	5457	0.0	0.6877405167674546
chr11	AP000866.1	124800719	124800894	0	176	3753	5561	3753	5385	0.0	0.6969359331476324
chr11	AP000866.1	124801046	124801256	0	211	3753	5561	3753	5350	0.0	0.7014953271028037
chr11	AP000866.1	124800895	124801256	0	362	3753	5561	3753	5199	0.0	0.7218695903058281
chr11	AP000866.1	124800719	124801256	0	538	3753	5561	3753	5023	0.0	0.7471630499701374
chr11	AP000866.1	124800942	124801256	0	315	3753	5561	3753	5246	0.0	0.7154022112085399
chr11	AP000866.1	124800719	124800941	0	223	3753	5561	3753	5338	0.0	0.7030723117272387
chr11	AP000866.1	124800895	124800941	0	47	3753	5561	3753	5514	0.0	0.6806311207834603
chr11	SLC37A2	125063352	125063426	0	75	0	6174	0	6099	0.0	0.0
chr11	EI24	125569515	125569573	0	59	545	3327	545	3268	0.0	0.16676866585067318
chr11	STT3A	125608244	125608289	0	46	1079	7052	1079	7006	0.0	0.15401084784470453
chr11	CHEK1	125626821	125626833	0	13	94	4401	94	4388	0.0	0.021422060164083864
chr11	CHEK1	125626013	125626029	0	17	94	4401	94	4384	0.0	0.02144160583941606
chr11	CHEK1	125626013	125626034	0	22	94	4401	94	4379	0.0	0.02146608814797899
chr11	CHEK1	125626030	125626034	0	5	94	4401	94	4396	0.0	0.021383075523202913
chr11	CHEK1	125626576	125626642	0	67	94	4401	94	4334	0.0	0.02168897092754961
chr11	FAM118B	126229294	126229336	0	43	5794	3544	5794	3501	0.0	1.6549557269351614
chr11	FOXRED1	126269292	126269415	0	124	99240	4405	99240	4281	0.0	23.181499649614576
chr11	TIRAP	126289818	126289833	0	16	945	3600	945	3584	0.0	0.263671875
chr11	ST3GAL4	126406546	126406557	0	12	231	5834	231	5822	0.0	0.03967708691171419
chr11	ST3GAL4	126403428	126403486	0	59	231	5834	231	5775	0.0	0.04
chr11	AP001993.1	127073269	127073296	0	28	0	9479	0	9451	0.0	0.0
chr11	AP001993.1	127080568	127080589	0	22	0	9479	0	9457	0.0	0.0
chr11	AP001993.1	127021908	127022046	0	139	0	9479	0	9340	0.0	0.0
chr11	APLP2	130070015	130070082	0	68	23145	7164	23145	7096	0.0	3.261696730552424
chr11	APLP2	130070038	130070082	0	45	23145	7164	23145	7119	0.0	3.251158870627897
chr11	APLP2	130070015	130070037	0	23	23145	7164	23145	7141	0.0	3.2411426971012465
chr11	LINC02730	134027035	134027066	0	32	125590	2090	125590	2058	0.0	61.02526724975704
chr11	LINC02730	134027280	134027366	0	87	125590	2090	125590	2003	0.0	62.7009485771343
chr11	LINC02706	134712778	134713214	0	437	0	2836	0	2399	0.0	0.0
chr11	LINC02706	134712778	134714780	0	2003	0	2836	0	833	0.0	0.0
chr11	LINC02706	134713215	134714780	0	1566	0	2836	0	1270	0.0	0.0
chr11	LINC02706	134714781	134714828	0	48	0	2836	0	2788	0.0	0.0
chr11	SIRT3	236047	236192	13247	146	344499	5564	331252	5418	90.73287671232876	61.1391657438169
chr11	SIRT3	218777	218830	2193	54	344499	5564	342306	5510	40.611111111111114	62.12450090744102
chr11	SIGIRR	406141	406347	1538	207	145538	2873	144000	2666	7.429951690821256	54.01350337584396
chr11	SIGIRR	407816	407850	0	35	145538	2873	145538	2838	0.0	51.281888653981675
chr11	SIGIRR	417293	417323	0	31	145538	2873	145538	2842	0.0	51.20971147079521
chr11	MIR210HG	568330	568350	0	21	46102	2323	46102	2302	0.0	20.026933101650737
chr11	CDHR5	624817	624916	0	100	3232	3877	3232	3777	0.0	0.855705586444268
chr11	CDHR5	624817	624968	0	152	3232	3877	3232	3725	0.0	0.8676510067114094
chr11	DEAF1	694678	694757	1509	80	296301	4162	294792	4082	18.8625	72.21754042136207
chr11	GATD1	773427	773520	844	94	580940	5390	580096	5296	8.97872340425532	109.53474320241692
chr11	SLC25A22	794457	794468	1311	12	193737	4564	192426	4552	109.25	42.272847100175746
chr11	SLC25A22	796042	796202	2193	161	193737	4564	191544	4403	13.621118012422361	43.503066091301385
chr11	SLC25A22	796042	796085	85	44	193737	4564	193652	4520	1.9318181818181819	42.84336283185841
chr11	SLC25A22	796042	796106	931	65	193737	4564	192806	4499	14.323076923076924	42.85530117803957
chr11	SLC25A22	796042	796112	1183	71	193737	4564	192554	4493	16.661971830985916	42.85644335633207
chr11	SLC25A22	797611	797890	918	280	193737	4564	192819	4284	3.2785714285714285	45.00910364145658
chr11	SLC25A22	794452	794456	0	5	193737	4564	193737	4559	0.0	42.49550339986839
chr11	SLC25A22	794452	794468	1311	17	193737	4564	192426	4547	77.11764705882354	42.319331427314715
chr11	SLC25A22	796086	796106	846	21	193737	4564	192891	4543	40.285714285714285	42.458947831829185
chr11	SLC25A22	796086	796112	1098	27	193737	4564	192639	4537	40.666666666666664	42.45955477187569
chr11	SLC25A22	795263	795338	357	76	193737	4564	193380	4488	4.697368421052632	43.088235294117645
chr11	SLC25A22	795339	795407	0	69	193737	4564	193737	4495	0.0	43.10055617352614
chr11	SLC25A22	796107	796112	252	6	193737	4564	193485	4558	42.0	42.449539271610355
chr11	SLC25A22	796113	796202	1010	90	193737	4564	192727	4474	11.222222222222221	43.077112203844436
chr11	PIDD1	800332	800382	1933	51	186579	4982	184646	4931	37.90196078431372	37.44595416751166
chr11	PIDD1	800984	801016	1272	33	186579	4982	185307	4949	38.54545454545455	37.44332188320873
chr11	PIDD1	800984	801000	533	17	186579	4982	186046	4965	31.352941176470587	37.47150050352467
chr11	PIDD1	801001	801016	739	16	186579	4982	185840	4966	46.1875	37.422472815142974
chr11	CHID1	883147	883198	23049	52	713739	4078	690690	4026	443.25	171.55737704918033
chr11	CHID1	869213	869856	20993	644	713739	4078	692746	3434	32.59782608695652	201.73150844496215
chr11	CHID1	902147	902196	130	50	713739	4078	713609	4028	2.6	177.1621151936445
chr11	CHID1	903655	903702	0	48	713739	4078	713739	4030	0.0	177.10645161290321
chr11	CHID1	910640	910773	459	134	713739	4078	713280	3944	3.425373134328358	180.85192697768764
chr11	CHID1	914522	914743	0	222	713739	4078	713739	3856	0.0	185.09828838174275
chr11	CHID1	914303	914743	0	441	713739	4078	713739	3637	0.0	196.24388232059388
chr11	CHID1	914303	914521	0	219	713739	4078	713739	3859	0.0	184.95439232961908
chr11	IFITM10	1747666	1747755	0	90	51	4795	51	4705	0.0	0.010839532412327312
chr11	IFITM10	1749014	1749017	0	4	51	4795	51	4791	0.0	0.010644959298685034
chr11	CTSD	1754905	1754922	0	18	1673	3467	1673	3449	0.0	0.4850681356915048
chr11	CTSD	1761308	1761328	0	21	1673	3467	1673	3446	0.0	0.4854904236796286
chr11	H19	1995875	1996077	102	203	937	2821	835	2618	0.5024630541871922	0.3189457601222307
chr11	IGF2	2137187	2137190	0	4	357	6266	357	6262	0.0	0.057010539763653785
chr11	INS	2161141	2161166	0	26	0	654	0	628	0.0	0.0
chr11	TH	2171684	2171695	0	12	0	3044	0	3032	0.0	0.0
chr11	TRPM5	2421025	2421030	0	6	927941	3986	927941	3980	0.0	233.15100502512564
chr11	CDKN1C	2884669	2885200	0	532	0	2316	0	1784	0.0	0.0
chr11	NAP1L4	2992228	2992252	0	25	14900	5136	14900	5111	0.0	2.9152807669731953
chr11	CARS1	3001961	3001968	0	8	77499	7131	77499	7123	0.0	10.880106696616593
chr11	OSBPL5	3120420	3120542	51	123	14893	7227	14842	7104	0.4146341463414634	2.0892454954954953
chr11	OSBPL5	3165215	3165221	0	7	14893	7227	14893	7220	0.0	2.0627423822714683
chr11	ZNF195	3370942	3370973	0	32	2796	7243	2796	7211	0.0	0.38774095132436553
chr11	ART5	3639641	3639844	0	204	102	1502	102	1298	0.0	0.07858243451463791
chr11	CHRNA10	3669733	3669794	0	62	204	2708	204	2646	0.0	0.07709750566893424
chr11	NUP98	3685972	3686062	0	91	172072	9424	172072	9333	0.0	18.436944176577736
chr11	NUP98	3702462	3702770	0	309	172072	9424	172072	9115	0.0	18.87789358200768
chr11	NUP98	3760487	3760537	0	51	172072	9424	172072	9373	0.0	18.358263096127175
chr11	NUP98	3760487	3760561	0	75	172072	9424	172072	9349	0.0	18.40539095090384
chr11	NUP98	3778872	3778982	51	111	172072	9424	172021	9313	0.4594594594594595	18.471061956405027
chr11	NUP98	3760538	3760561	0	24	172072	9424	172072	9400	0.0	18.305531914893617
chr11	NUP98	3760387	3760486	0	100	172072	9424	172072	9324	0.0	18.454740454740456
chr11	NUP98	3760387	3760537	0	151	172072	9424	172072	9273	0.0	18.556238542003666
chr11	NUP98	3760387	3760561	0	175	172072	9424	172072	9249	0.0	18.604389663747433
chr11	HBB	5226929	5226944	0	16	0	1309	0	1293	0.0	0.0
chr11	HBG1	5249712	5249749	0	38	0	1431	0	1393	0.0	0.0
chr11	HBG2	5254636	5254673	0	38	0	807	0	769	0.0	0.0
chr11	TRIM5	5684867	5685014	3747	148	19046	4811	15299	4663	25.31756756756757	3.28093502037315
chr11	FAM160A2	6218557	6218598	0	42	5441	4696	5441	4654	0.0	1.1691018478727977
chr11	APBB1	6405132	6405385	0	254	5158	5258	5158	5004	0.0	1.030775379696243
chr11	TRIM3	6456296	6456574	17	279	10824	6639	10807	6360	0.06093189964157706	1.6992138364779874
chr11	TRIM3	6458064	6458068	0	5	10824	6639	10824	6634	0.0	1.6315948145914982
chr11	ARFIP2	6478737	6478857	153	121	47035	5066	46882	4945	1.2644628099173554	9.480687563195147
chr11	TPP1	6617300	6617352	792	53	33334	5275	32542	5222	14.943396226415095	6.231711987744159
chr11	TPP1	6617300	6617357	902	58	33334	5275	32432	5217	15.551724137931034	6.216599578301706
chr11	TPP1	6617353	6617357	110	5	33334	5275	33224	5270	22.0	6.304364326375712
chr11	TPP1	6618775	6619194	2147	420	33334	5275	31187	4855	5.1119047619047615	6.423686920700309
chr11	AC107884.1	7427872	7428007	0	136	0	5841	0	5705	0.0	0.0
chr11	AC107884.1	7461232	7461237	0	6	0	5841	0	5835	0.0	0.0
chr11	CYB5R2	7673717	7673950	0	234	0	5718	0	5484	0.0	0.0
chr11	CYB5R2	7673717	7674110	0	394	0	5718	0	5324	0.0	0.0
chr11	CYB5R2	7673951	7674110	0	160	0	5718	0	5558	0.0	0.0
chr11	CYB5R2	7673951	7674224	0	274	0	5718	0	5444	0.0	0.0
chr11	CYB5R2	7673606	7673716	0	111	0	5718	0	5607	0.0	0.0
chr11	OR10A6	7930808	7930859	0	52	1637	2982	1637	2930	0.0	0.558703071672355
chr11	LMO1	8263337	8263670	0	334	330	1428	330	1094	0.0	0.3016453382084095
chr11	STK33	8480482	8480532	0	51	306	7588	306	7537	0.0	0.040599708106673744
chr11	DENND2B	8810516	8810611	0	96	290490	10617	290490	10521	0.0	27.610493299116055
chr11	DENND2B	8718358	8718426	31	69	290490	10617	290459	10548	0.4492753623188406	27.53687902919985
chr11	DENND2B	8835603	8835622	0	20	290490	10617	290490	10597	0.0	27.41247522883835
chr11	DENND2B	8870953	8871332	51	380	290490	10617	290439	10237	0.13421052631578947	28.371495555338477
chr11	DENND5A	9141939	9141972	0	34	163642	7876	163642	7842	0.0	20.867380770211682
chr11	IRAG1	10693461	10693534	0	74	106	7711	106	7637	0.0	0.013879795731308105
chr11	EIF4G2	10800089	10800242	874	154	51732	7294	50858	7140	5.675324675324675	7.12296918767507
chr11	EIF4G2	10807548	10807743	0	196	51732	7294	51732	7098	0.0	7.288250211327134
chr11	EIF4G2	10807533	10807547	0	15	51732	7294	51732	7279	0.0	7.107020195081742
chr11	EIF4G2	10807533	10807743	0	211	51732	7294	51732	7083	0.0	7.303684879288437
chr11	EIF4G2	10808173	10808275	0	103	51732	7294	51732	7191	0.0	7.193992490613266
chr11	ZBED5	10857222	10857594	0	373	347616	7125	347616	6752	0.0	51.48341232227488
chr11	DKK3	12008869	12009037	0	169	45069	4948	45069	4779	0.0	9.430634023854363
chr11	DKK3	12009038	12009170	75	133	45069	4948	44994	4815	0.5639097744360902	9.344548286604361
chr11	LINC00958	12984225	12984228	0	4	119200	5127	119200	5123	0.0	23.267616630880344
chr11	BTBD10	13417157	13417245	0	89	4389	3285	4389	3196	0.0	1.373279098873592
chr11	BTBD10	13439883	13440097	0	215	4389	3285	4389	3070	0.0	1.429641693811075
chr11	BTBD10	13463091	13463098	0	8	4389	3285	4389	3277	0.0	1.3393347574000611
chr11	RRAS2	14358237	14358255	0	19	1673	3469	1673	3450	0.0	0.48492753623188406
chr11	COPB1	14499608	14499705	57	98	23965	5086	23908	4988	0.5816326530612245	4.793103448275862
chr11	COPB1	14499608	14499740	473	133	23965	5086	23492	4953	3.556390977443609	4.742984050070664
chr11	COPB1	14499706	14499740	416	35	23965	5086	23549	5051	11.885714285714286	4.662245099980202
chr11	COPB1	14499602	14499607	18	6	23965	5086	23947	5080	3.0	4.713976377952756
chr11	COPB1	14499602	14499705	75	104	23965	5086	23890	4982	0.7211538461538461	4.795262946607788
chr11	COPB1	14499602	14499740	491	139	23965	5086	23474	4947	3.5323741007194243	4.745098039215686
chr11	PSMA1	14519904	14520295	0	392	10106	2912	10106	2520	0.0	4.01031746031746
chr11	PSMA1	14519904	14520191	0	288	10106	2912	10106	2624	0.0	3.8513719512195124
chr11	PSMA1	14520192	14520295	0	104	10106	2912	10106	2808	0.0	3.599002849002849
chr11	PSMA1	14519872	14520295	0	424	10106	2912	10106	2488	0.0	4.061897106109325
chr11	PSMA1	14519872	14519903	0	32	10106	2912	10106	2880	0.0	3.509027777777778
chr11	PSMA1	14519872	14520191	0	320	10106	2912	10106	2592	0.0	3.8989197530864197
chr11	CYP2R1	14891152	14891362	729	211	3682	4037	2953	3826	3.4549763033175354	0.7718243596445373
chr11	CYP2R1	14890899	14891362	755	464	3682	4037	2927	3573	1.6271551724137931	0.8191995521970333
chr11	CALCA	14972220	14972243	0	24	0	2106	0	2082	0.0	0.0
chr11	SOX6	16049712	16049753	0	42	530	19677	530	19635	0.0	0.026992615227909345
chr11	SOX6	16402658	16402798	0	141	530	19677	530	19536	0.0	0.02712940212940213
chr11	ABCC8	17461582	17461584	0	3	76870	9821	76870	9818	0.0	7.829496842534121
chr11	ABCC8	17463437	17463457	0	21	76870	9821	76870	9800	0.0	7.843877551020408
chr11	ABCC8	17396877	17396914	1008	38	76870	9821	75862	9783	26.526315789473685	7.754472043340488
chr11	ABCC8	17413393	17413477	0	85	76870	9821	76870	9736	0.0	7.8954396055875105
chr11	ABCC8	17443163	17443176	0	14	76870	9821	76870	9807	0.0	7.838278780462935
chr11	SERGEF	18012850	18012949	0	100	8276	3044	8276	2944	0.0	2.811141304347826
chr11	SERGEF	18012501	18012849	0	349	8276	3044	8276	2695	0.0	3.0708719851576993
chr11	SERGEF	18010070	18010073	4	4	8276	3044	8272	3040	1.0	2.721052631578947
chr11	SAAL1	18086861	18086864	0	4	3173	2752	3173	2748	0.0	1.1546579330422124
chr11	SAAL1	18086856	18086864	0	9	3173	2752	3173	2743	0.0	1.1567626686110097
chr11	SAAL1	18086856	18086860	0	5	3173	2752	3173	2747	0.0	1.1550782672005824
chr11	SAA2	18248455	18248601	0	147	0	2249	0	2102	0.0	0.0
chr11	HPS5	18321945	18322131	102	187	18293	6458	18191	6271	0.5454545454545454	2.900813267421464
chr11	HPS5	18321945	18322075	102	131	18293	6458	18191	6327	0.7786259541984732	2.875138296190928
chr11	HPS5	18322076	18322131	0	56	18293	6458	18293	6402	0.0	2.857388316151203
chr11	E2F8	19241406	19241495	0	90	51	4148	51	4058	0.0	0.012567767373090193
chr11	SLC5A12	26692484	26692487	0	4	0	7588	0	7584	0.0	0.0
chr11	BBOX1-AS1	27219686	27220045	0	360	0	1350	0	990	0.0	0.0
chr11	BDNF	27699381	27699481	213	101	87154	7518	86941	7417	2.108910891089109	11.721855197519213
chr11	BDNF	27700163	27700180	136	18	87154	7518	87018	7500	7.555555555555555	11.6024
chr11	BDNF	27720428	27720642	0	215	87154	7518	87154	7303	0.0	11.933999726139943
chr11	BDNF	27720345	27720427	810	83	87154	7518	86344	7435	9.759036144578314	11.613180901143242
chr11	BDNF	27720345	27720642	810	298	87154	7518	86344	7220	2.7181208053691277	11.959002770083103
chr11	DCDC1	30903481	30903489	0	9	51	12605	51	12596	0.0	0.0040489044140997145
chr11	DCDC1	31103643	31103646	0	4	51	12605	51	12601	0.0	0.004047297833505277
chr11	IMMP1L	31469739	31469756	0	18	19280	3848	19280	3830	0.0	5.033942558746737
chr11	PAX6	31801560	31801667	0	108	77755	17695	77755	17587	0.0	4.421163359299483
chr11	PAX6	31801560	31801760	0	201	77755	17695	77755	17494	0.0	4.444666742883275
chr11	PAX6	31811114	31811211	4451	98	77755	17695	73304	17597	45.41836734693877	4.165710064215491
chr11	PAX6	31812092	31812147	78	56	77755	17695	77677	17639	1.3928571428571428	4.403707693179886
chr11	PAX6	31801229	31801559	0	331	77755	17695	77755	17364	0.0	4.477942870306381
chr11	PAX6	31801229	31801667	0	439	77755	17695	77755	17256	0.0	4.505968938340287
chr11	PAX6	31801229	31801760	0	532	77755	17695	77755	17163	0.0	4.530385130804638
chr11	PAX6	31801668	31801760	0	93	77755	17695	77755	17602	0.0	4.4173957504829
chr11	PAX6	31812092	31812570	5559	479	77755	17695	72196	17216	11.605427974947808	4.193540892193308
chr11	PAX6	31803397	31803582	612	186	77755	17695	77143	17509	3.2903225806451615	4.4059055342966476
chr11	PAX6	31803583	31803950	0	368	77755	17695	77755	17327	0.0	4.4875050499220865
chr11	PAX6	31811112	31811211	4637	100	77755	17695	73118	17595	46.37	4.15561238988349
chr11	PAX6	31811112	31811113	186	2	77755	17695	77569	17693	93.0	4.38416322839541
chr11	WT1	32391971	32391979	0	9	67	6874	67	6865	0.0	0.009759650400582666
chr11	WT1	32417423	32417575	0	153	67	6874	67	6721	0.0	0.009968754649605713
chr11	CD59	33709905	33710204	0	300	189225	10567	189225	10267	0.0	18.430408103633
chr11	CD59	33722570	33722634	127	65	189225	10567	189098	10502	1.9538461538461538	18.0059036374024
chr11	FBXO3	33753110	33753341	0	232	16851	5200	16851	4968	0.0	3.3919082125603865
chr11	LMO2	33869709	33869823	0	115	0	2903	0	2788	0.0	0.0
chr11	SLC1A2	35419907	35419934	0	28	12847629	13109	12847629	13081	0.0	982.1595443773411
chr11	SLC1A2	35419907	35419918	0	12	12847629	13109	12847629	13097	0.0	980.9596854241429
chr11	SLC1A2	35419919	35419934	0	16	12847629	13109	12847629	13093	0.0	981.2593752386772
chr11	SLC1A2	35360042	35360046	0	5	12847629	13109	12847629	13104	0.0	980.4356684981685
chr11	TP53I11	44936802	44936878	0	77	0	7153	0	7076	0.0	0.0
chr11	TP53I11	44950676	44950875	0	200	0	7153	0	6953	0.0	0.0
chr11	TP53I11	44939113	44939164	0	52	0	7153	0	7101	0.0	0.0
chr11	TP53I11	44937108	44937302	0	195	0	7153	0	6958	0.0	0.0
chr11	AC103855.2	45532648	45532990	0	343	51	4073	51	3730	0.0	0.013672922252010724
chr11	PEX16	45917699	45917772	0	74	286	2915	286	2841	0.0	0.10066877859908482
chr11	PEX16	45917587	45917698	0	112	286	2915	286	2803	0.0	0.10203353549768106
chr11	PEX16	45917587	45917772	0	186	286	2915	286	2729	0.0	0.10480029314767314
chr11	ARFGAP2	47167908	47167974	30	67	49923	5269	49893	5202	0.44776119402985076	9.591118800461361
chr11	ARFGAP2	47171425	47171451	253	27	49923	5269	49670	5242	9.37037037037037	9.47539107210988
chr11	ARFGAP2	47175850	47175870	0	21	49923	5269	49923	5248	0.0	9.512766768292684
chr11	ARFGAP2	47176515	47176780	13253	266	49923	5269	36670	5003	49.82330827067669	7.329602238656806
chr11	PSMC3	47424045	47424107	0	63	46	1859	46	1796	0.0	0.025612472160356347
chr11	PSMC3	47426116	47426131	0	16	46	1859	46	1843	0.0	0.024959305480195332
chr11	PSMC3	47426116	47426203	0	88	46	1859	46	1771	0.0	0.025974025974025976
chr11	PSMC3	47426132	47426203	0	72	46	1859	46	1787	0.0	0.02574146614437605
chr11	CELF1	47523247	47523598	4828	352	48316	9012	43488	8660	13.715909090909092	5.021709006928407
chr11	KBTBD4	47578827	47578931	0	105	9470	2798	9470	2693	0.0	3.5165243223171183
chr11	KBTBD4	47578827	47578910	0	84	9470	2798	9470	2714	0.0	3.4893146647015474
chr11	KBTBD4	47578540	47578683	0	144	9470	2798	9470	2654	0.0	3.5681989449886964
chr11	KBTBD4	47578911	47578931	0	21	9470	2798	9470	2777	0.0	3.4101548433561395
chr11	MTCH2	47642378	47642399	20	22	14660	2894	14640	2872	0.9090909090909091	5.0974930362116995
chr11	AGBL2	47714841	47715173	0	333	157052	5082	157052	4749	0.0	33.070541166561384
chr11	AGBL2	47714841	47715106	0	266	157052	5082	157052	4816	0.0	32.61046511627907
chr11	AGBL2	47715107	47715173	0	67	157052	5082	157052	5015	0.0	31.31645064805583
chr11	FOLH1	49207763	49207866	0	104	0	5358	0	5254	0.0	0.0
chr11	TNKS1BP1	57320064	57320077	0	14	61969	7163	61969	7149	0.0	8.668205343404672
chr11	PRG2	57389009	57389041	0	33	0	1737	0	1704	0.0	0.0
chr11	PRG2	57390482	57390594	0	113	0	1737	0	1624	0.0	0.0
chr11	SLC43A3	57427371	57427406	745	36	33133	4537	32388	4501	20.694444444444443	7.195734281270829
chr11	TIMM10	57530657	57530725	0	69	495	779	495	710	0.0	0.6971830985915493
chr11	UBE2L6	57567009	57567025	51	17	12004	2068	11953	2051	3.0	5.8278888347147735
chr11	YPEL4	57647383	57647471	0	89	51	2700	51	2611	0.0	0.019532746074301034
chr11	OR9I1	58125273	58125429	0	157	0	3187	0	3030	0.0	0.0
chr11	LPXN	58577985	58578017	0	33	0	2445	0	2412	0.0	0.0
chr11	CBLIF	59845260	59845373	0	114	120	2390	120	2276	0.0	0.05272407732864675
chr11	MS4A6A	60175401	60175504	0	104	51	3986	51	3882	0.0	0.01313755795981453
chr11	MS4A6A	60182977	60183134	0	158	51	3986	51	3828	0.0	0.013322884012539185
chr11	MS4A6A	60184319	60184540	0	222	51	3986	51	3764	0.0	0.01354941551540914
chr11	MS4A6A	60184272	60184318	0	47	51	3986	51	3939	0.0	0.012947448591012947
chr11	MS4A6A	60184272	60184302	0	31	51	3986	51	3955	0.0	0.012895069532237674
chr11	MS4A6A	60184303	60184318	0	16	51	3986	51	3970	0.0	0.012846347607052897
chr11	VWCE	61282788	61282791	0	4	825	4782	825	4778	0.0	0.1726663876098786
chr11	CYB561A3	61357202	61357310	0	109	204	8318	204	8209	0.0	0.02485077354123523
chr11	CYB561A3	61352955	61352983	0	29	204	8318	204	8289	0.0	0.024610930148389432
chr11	CPSF7	61419921	61419947	0	27	2096	4905	2096	4878	0.0	0.42968429684296844
chr11	CPSF7	61420469	61420545	0	77	2096	4905	2096	4828	0.0	0.43413421706710853
chr11	CPSF7	61429756	61429885	0	130	2096	4905	2096	4775	0.0	0.4389528795811518
chr11	CPSF7	61429756	61429839	0	84	2096	4905	2096	4821	0.0	0.43476457166562954
chr11	CPSF7	61429886	61429912	0	27	2096	4905	2096	4878	0.0	0.42968429684296844
chr11	CPSF7	61429840	61429912	0	73	2096	4905	2096	4832	0.0	0.4337748344370861
chr11	CPSF7	61429840	61429885	0	46	2096	4905	2096	4859	0.0	0.4313644782877135
chr11	TMEM258	61790374	61790421	0	48	0	1996	0	1948	0.0	0.0
chr11	TMEM258	61789715	61789783	0	69	0	1996	0	1927	0.0	0.0
chr11	TMEM258	61791462	61792554	102	1093	0	1996	-102	903	0.09332113449222323	-0.11295681063122924
chr11	FADS1	61812470	61812475	0	6	481	9399	481	9393	0.0	0.051208346641115725
chr11	FADS1	61816554	61816990	51	437	481	9399	430	8962	0.11670480549199085	0.04798036152644499
chr11	FADS1	61814795	61814962	0	168	481	9399	481	9231	0.0	0.052107030657566895
chr11	FADS1	61814795	61815072	0	278	481	9399	481	9121	0.0	0.052735445674816354
chr11	FADS1	61814795	61814855	0	61	481	9399	481	9338	0.0	0.051509959306061254
chr11	FADS1	61814963	61815072	0	110	481	9399	481	9289	0.0	0.05178167725266444
chr11	FADS1	61815926	61815941	0	16	481	9399	481	9383	0.0	0.05126292230629863
chr11	FADS1	61814856	61814962	0	107	481	9399	481	9292	0.0	0.051764959104606115
chr11	FADS1	61814856	61815072	0	217	481	9399	481	9182	0.0	0.05238510128512307
chr11	FADS3	61876358	61876369	0	12	6793	5230	6793	5218	0.0	1.3018397853583747
chr11	FADS3	61879311	61879394	0	84	6793	5230	6793	5146	0.0	1.3200544111931598
chr11	FTH1	61967311	61967400	0	90	0	1914	0	1824	0.0	0.0
chr11	EEF1G	62571539	62571622	897	84	198814	2649	197917	2565	10.678571428571429	77.1606237816764
chr11	TUT1	62591403	62591518	4420	116	36425	3550	32005	3434	38.10344827586207	9.320034944670939
chr11	EML3	62612435	62612572	0	138	200687	4849	200687	4711	0.0	42.599660369348335
chr11	EML3	62612164	62612223	0	60	200687	4849	200687	4789	0.0	41.90582585090833
chr11	GANAB	62639626	62639629	0	4	11212	5054	11212	5050	0.0	2.2201980198019804
chr11	LBHD1	62669640	62671562	224	1923	224	2716	0	793	0.11648465938637545	0.0
chr11	LBHD1	62669640	62669880	224	241	224	2716	0	2475	0.9294605809128631	0.0
chr11	UBXN1	62677926	62677937	0	12	537	1724	537	1712	0.0	0.31366822429906543
chr11	BSCL2	62705300	62705466	0	167	353	3676	353	3509	0.0	0.1005984611000285
chr11	BSCL2	62709146	62709262	0	117	353	3676	353	3559	0.0	0.0991851643720146
chr11	BSCL2	62706202	62706257	0	56	353	3676	353	3620	0.0	0.09751381215469614
chr11	BSCL2	62705915	62706201	306	287	353	3676	47	3389	1.0662020905923344	0.013868397757450576
chr11	BSCL2	62705915	62706001	54	87	353	3676	299	3589	0.6206896551724138	0.08331011423794929
chr11	BSCL2	62706002	62706201	252	200	353	3676	101	3476	1.26	0.02905638665132336
chr11	ZBTB3	62753963	62754124	0	162	0	2168	0	2006	0.0	0.0
chr11	NXF1	62798538	62800375	0	1838	1354	5978	1354	4140	0.0	0.32705314009661834
chr11	NXF1	62803791	62803798	0	8	1354	5978	1354	5970	0.0	0.22680067001675042
chr11	STX5	62825024	62825034	0	11	147	2433	147	2422	0.0	0.06069364161849711
chr11	WDR74	62839506	62839539	0	34	102	4116	102	4082	0.0	0.024987751102400785
chr11	SNHG1	62852810	62853073	0	264	0	3736	0	3472	0.0	0.0
chr11	SNHG1	62854887	62855131	0	245	0	3736	0	3491	0.0	0.0
chr11	SNHG1	62855423	62855863	0	441	0	3736	0	3295	0.0	0.0
chr11	SNHG1	62855132	62855422	0	291	0	3736	0	3445	0.0	0.0
chr11	SNHG1	62854017	62854517	0	501	0	3736	0	3235	0.0	0.0
chr11	SNHG1	62854518	62855131	0	614	0	3736	0	3122	0.0	0.0
chr11	SLC22A6	62977144	62977182	0	39	0	2403	0	2364	0.0	0.0
chr11	PLAAT5	63466109	63466158	10	50	5149	3274	5139	3224	0.2	1.593982630272953
chr11	TRPT1	64224794	64224799	0	6	0	1812	0	1806	0.0	0.0
chr11	TRPT1	64226049	64226189	0	141	0	1812	0	1671	0.0	0.0
chr11	NRXN2	64676992	64677012	0	21	137031	9747	137031	9726	0.0	14.089142504626773
chr11	RASGRP2	64744002	64744028	0	27	544	5724	544	5697	0.0	0.09548885378269265
chr11	SF1	64777986	64778360	0	375	0	5987	0	5612	0.0	0.0
chr11	SF1	64767566	64767569	0	4	0	5987	0	5983	0.0	0.0
chr11	SF1	64777498	64777519	0	22	0	5987	0	5965	0.0	0.0
chr11	MEN1	64807890	64807994	35623	105	272834	4392	237211	4287	339.26666666666665	55.332633543270354
chr11	MEN1	64809649	64809663	22	15	272834	4392	272812	4377	1.4666666666666666	62.328535526616406
chr11	MEN1	64810267	64810512	3927	246	272834	4392	268907	4146	15.963414634146341	64.85938253738543
chr11	MEN1	64810267	64810524	4375	258	272834	4392	268459	4134	16.95736434108527	64.9392839864538
chr11	MEN1	64810267	64810456	1824	190	272834	4392	271010	4202	9.6	64.49547834364589
chr11	MEN1	64810513	64810524	448	12	272834	4392	272386	4380	37.333333333333336	62.18858447488584
chr11	MEN1	64810267	64810628	8551	362	272834	4392	264283	4030	23.62154696132597	65.57890818858561
chr11	MEN1	64806082	64806230	33744	149	272834	4392	239090	4243	226.46979865771812	56.34928116898421
chr11	MEN1	64810457	64810512	2103	56	272834	4392	270731	4336	37.55357142857143	62.437961254612546
chr11	EHD1	64879601	64879610	0	10	1212940	6786	1212940	6776	0.0	179.00531286894923
chr11	ATG2A	64902509	64902514	0	6	845747	7297	845747	7291	0.0	115.99876560142641
chr11	MAJIN	64954042	64954755	31657	714	63057	2337	31400	1623	44.3375350140056	19.346888478126925
chr11	BATF2	64990073	64990191	0	119	0	898	0	779	0.0	0.0
chr11	TMEM262	65088650	65088681	98	32	13933	697	13835	665	3.0625	20.804511278195488
chr11	FAU	65122035	65122088	0	54	629	821	629	767	0.0	0.8200782268578879
chr11	FAU	65121940	65122088	0	149	629	821	629	672	0.0	0.9360119047619048
chr11	FAU	65121940	65122034	0	95	629	821	629	726	0.0	0.8663911845730028
chr11	SLC25A45	65381874	65381913	48	40	323669	4923	323621	4883	1.2	66.2750358386238
chr11	LINC02736	65487885	65487888	684	4	145644	1397	144960	1393	171.0	104.06317300789662
chr11	LTBP3	65557628	65557631	0	4	468724	10116	468724	10112	0.0	46.35324367088607
chr11	MAP3K11	65613017	65614008	8296	992	40796	6397	32500	5405	8.362903225806452	6.012950971322849
chr11	RELA	65662664	65662708	1720	45	2335268	4483	2333548	4438	38.22222222222222	525.8107255520505
chr11	RELA	65662378	65662663	17022	286	2335268	4483	2318246	4197	59.51748251748252	552.357874672385
chr11	RELA	65662378	65662708	18742	331	2335268	4483	2316526	4152	56.62235649546828	557.9301541425818
chr11	RNASEH2C	65717244	65719679	255	2436	102	4492	-153	2056	0.10467980295566502	-0.07441634241245136
chr11	RNASEH2C	65717244	65717661	153	418	102	4492	-51	4074	0.3660287081339713	-0.012518409425625921
chr11	CFL1	65856884	65856929	0	46	697189	5673	697189	5627	0.0	123.90065754398437
chr11	CFL1	65861256	65861369	502	114	697189	5673	696687	5559	4.4035087719298245	125.32595790609822
chr11	EFEMP2	65866809	65866843	0	35	13553	4066	13553	4031	0.0	3.362193004217316
chr11	EFEMP2	65866809	65867019	0	211	13553	4066	13553	3855	0.0	3.515693904020752
chr11	EFEMP2	65866809	65866864	0	56	13553	4066	13553	4010	0.0	3.3798004987531174
chr11	EFEMP2	65868294	65868304	0	11	13553	4066	13553	4055	0.0	3.3422934648581997
chr11	EFEMP2	65866844	65867019	0	176	13553	4066	13553	3890	0.0	3.4840616966580975
chr11	EFEMP2	65866844	65866864	0	21	13553	4066	13553	4045	0.0	3.350556242274413
chr11	EFEMP2	65866865	65867019	0	155	13553	4066	13553	3911	0.0	3.4653541293786754
chr11	FIBP	65888333	65888341	9	9	5769	3155	5760	3146	1.0	1.8308963763509218
chr11	FIBP	65885508	65885528	76	21	5769	3155	5693	3134	3.619047619047619	1.8165283982131462
chr11	FIBP	65884310	65884390	0	81	5769	3155	5769	3074	0.0	1.8767078724788548
chr11	EIF1AD	66000052	66000097	0	46	117777	3333	117777	3287	0.0	35.83115302707636
chr11	EIF1AD	66001909	66002038	0	130	117777	3333	117777	3203	0.0	36.770839837652204
chr11	YIF1A	66284868	66284871	0	4	27940	2353	27940	2349	0.0	11.894423158790975
chr11	BRMS1	66341205	66341211	0	7	255	2375	255	2368	0.0	0.10768581081081081
chr11	MRPL11	66438631	66438708	449	78	77584	2546	77135	2468	5.756410256410256	31.254051863857374
chr11	MRPL11	66436801	66436814	42	14	77584	2546	77542	2532	3.0	30.62480252764613
chr11	CTSF	66564087	66564094	0	8	48495	3628	48495	3620	0.0	13.396408839779005
chr11	CTSF	66567890	66567982	0	93	48495	3628	48495	3535	0.0	13.718528995756719
chr11	PC	66852742	66852745	0	4	5619	7336	5619	7332	0.0	0.766366612111293
chr11	PC	66957739	66957867	102	129	5619	7336	5517	7207	0.7906976744186046	0.7655057582905509
chr11	POLD4	67353302	67353537	9129	236	1134864	2477	1125735	2241	38.682203389830505	502.3360107095047
chr11	POLD4	67353302	67353362	1090	61	1134864	2477	1133774	2416	17.868852459016395	469.2773178807947
chr11	POLD4	67353293	67353301	119	9	1134864	2477	1134745	2468	13.222222222222221	459.7832252836305
chr11	POLD4	67353293	67353362	1209	70	1134864	2477	1133655	2407	17.271428571428572	470.9825508932281
chr11	POLD4	67353293	67353537	9248	245	1134864	2477	1125616	2232	37.7469387755102	504.30824372759855
chr11	PPP1CA	67419407	67419442	0	36	816	3928	816	3892	0.0	0.20966084275436794
chr11	CORO1B	67440117	67440139	0	23	0	5227	0	5204	0.0	0.0
chr11	TMEM134	67467164	67467310	0	147	0	1799	0	1652	0.0	0.0
chr11	TMEM134	67468016	67468026	0	11	0	1799	0	1788	0.0	0.0
chr11	CDK2AP2	67507859	67507999	0	141	51	2022	51	1881	0.0	0.02711323763955343
chr11	CABP2	67522541	67522544	0	4	630	1496	630	1492	0.0	0.4222520107238606
chr11	ALDH3B2	67674435	67674435	0	1	12	3617	12	3616	0.0	0.00331858407079646
chr11	ALDH3B2	67674435	67674691	0	257	12	3617	12	3360	0.0	0.0035714285714285713
chr11	CHKA	68061492	68061598	0	107	2055	3785	2055	3678	0.0	0.5587275693311582
chr11	C11ORF24	68271645	68271855	164	211	521	3139	357	2928	0.7772511848341233	0.12192622950819672
chr11	MRPL21	68900534	68900546	0	13	663	2831	663	2818	0.0	0.23527324343506031
chr11	MRPL21	68893321	68893401	189	81	663	2831	474	2750	2.3333333333333335	0.17236363636363636
chr11	MRPL21	68896468	68896513	0	46	663	2831	663	2785	0.0	0.23806104129263914
chr11	LINC02753	70063682	70063921	0	240	408	1997	408	1757	0.0	0.23221400113830393
chr11	DHCR7	71448289	71448311	0	23	51	3448	51	3425	0.0	0.01489051094890511
chr11	DHCR7	71448276	71448288	0	13	51	3448	51	3435	0.0	0.014847161572052401
chr11	DHCR7	71448276	71448311	0	36	51	3448	51	3412	0.0	0.014947245017584994
chr11	AP002495.1	71928364	71928447	0	84	0	3091	0	3007	0.0	0.0
chr11	NUMA1	72080319	72080456	0	138	152128	15188	152128	15050	0.0	10.108172757475083
chr11	NUMA1	72068078	72068103	52	26	152128	15188	152076	15162	2.0	10.030075187969924
chr11	ANAPC15	72111411	72111440	0	30	0	2872	0	2842	0.0	0.0
chr11	ANAPC15	72112649	72112732	0	84	0	2872	0	2788	0.0	0.0
chr11	ANAPC15	72112215	72112272	0	58	0	2872	0	2814	0.0	0.0
chr11	ANAPC15	72111923	72112214	0	292	0	2872	0	2580	0.0	0.0
chr11	CLPB	72434071	72434382	0	312	16540	12455	16540	12143	0.0	1.362101622333855
chr11	PDE2A	72605137	72605197	0	61	21413	7220	21413	7159	0.0	2.9910602039390977
chr11	ARAP1	72686041	72686093	0	53	14621	8718	14621	8665	0.0	1.6873629544143105
chr11	ARAP1	72710384	72710432	0	49	14621	8718	14621	8669	0.0	1.6865843811281578
chr11	STARD10	72780974	72781111	0	138	2030	2748	2030	2610	0.0	0.7777777777777778
chr11	STARD10	72780974	72781060	0	87	2030	2748	2030	2661	0.0	0.7628711010898158
chr11	STARD10	72781061	72781111	0	51	2030	2748	2030	2697	0.0	0.7526881720430108
chr11	P4HA3	74304269	74304302	0	34	51	3632	51	3598	0.0	0.014174541411895497
chr11	LIPT2	74493237	74493465	0	229	0	2223	0	1994	0.0	0.0
chr11	LIPT2	74493199	74493236	0	38	0	2223	0	2185	0.0	0.0
chr11	XRRA1	74933800	74933823	0	24	102	8801	102	8777	0.0	0.011621282898484676
chr11	MAP6	75667464	75668528	0	1065	860	6344	860	5279	0.0	0.1629096419776473
chr11	AP002360.1	76444204	76444276	0	73	0	986	0	913	0.0	0.0
chr11	LINC02757	76630190	76630193	0	4	0	1768	0	1764	0.0	0.0
chr11	AP003119.2	76782990	76783001	0	12	0	350	0	338	0.0	0.0
chr11	AP003119.2	76782984	76783001	0	18	0	350	0	332	0.0	0.0
chr11	AP003119.2	76782984	76782989	0	6	0	350	0	344	0.0	0.0
chr11	RSF1	77700720	77700728	0	9	87388	15757	87388	15748	0.0	5.549149098298197
chr11	INTS4	77924749	77924778	1835	30	34195	5755	32360	5725	61.166666666666664	5.652401746724891
chr11	INTS4	77924705	77924748	1266	44	34195	5755	32929	5711	28.772727272727273	5.765890386972509
chr11	INTS4	77924705	77924778	3101	74	34195	5755	31094	5681	41.9054054054054	5.473332159831016
chr11	INTS4	77987528	77987602	0	75	34195	5755	34195	5680	0.0	6.020246478873239
chr11	ALG8	78139493	78139527	0	35	510	3191	510	3156	0.0	0.16159695817490494
chr11	KCTD21	78188523	78188571	0	49	10614	3974	10614	3925	0.0	2.704203821656051
chr11	NARS2	78574347	78574827	0	481	0	3161	0	2680	0.0	0.0
chr11	MIR4300HG	82717581	82717787	0	207	51	4311	51	4104	0.0	0.012426900584795321
chr11	PRCP	82901570	82901591	150	22	16386	13162	16236	13140	6.818181818181818	1.2356164383561643
chr11	PRCP	82901458	82901591	5260	134	16386	13162	11126	13028	39.25373134328358	0.8540067546822229
chr11	PRCP	82900650	82900780	460	131	16386	13162	15926	13031	3.5114503816793894	1.2221625354922876
chr11	PRCP	82901458	82901487	1423	30	16386	13162	14963	13132	47.43333333333333	1.1394303990252816
chr11	RAB30	82987586	82987589	0	4	121151	11843	121151	11839	0.0	10.23321226454937
chr11	RAB30	83034126	83034170	0	45	121151	11843	121151	11798	0.0	10.26877436853704
chr11	CCDC90B	83285872	83286098	0	227	0	5909	0	5682	0.0	0.0
chr11	CCDC90B	83285552	83285871	0	320	0	5909	0	5589	0.0	0.0
chr11	CCDC90B	83285552	83286098	0	547	0	5909	0	5362	0.0	0.0
chr11	CCDC90B	83285126	83285871	0	746	0	5909	0	5163	0.0	0.0
chr11	CCDC90B	83285126	83285551	0	426	0	5909	0	5483	0.0	0.0
chr11	DLG2	85626586	85626597	0	12	67	16296	67	16284	0.0	0.0041144681896339965
chr11	DLG2	85627217	85627687	0	471	67	16296	67	15825	0.0	0.004233807266982623
chr11	CREBZF	85663697	85663813	0	117	0	4015	0	3898	0.0	0.0
chr11	SYTL2	85724031	85727894	48181	3864	191629	11277	143448	7413	12.469202898550725	19.350870093079724
chr11	SYTL2	85718989	85719059	70	71	191629	11277	191559	11206	0.9859154929577465	17.094324469034447
chr11	SYTL2	85719060	85719185	357	126	191629	11277	191272	11151	2.8333333333333335	17.152901085104475
chr11	ME3	86672297	86672322	0	26	1256	3801	1256	3775	0.0	0.3327152317880795
chr11	ME3	86672273	86672322	0	50	1256	3801	1256	3751	0.0	0.3348440415889096
chr11	ME3	86672273	86672296	0	24	1256	3801	1256	3777	0.0	0.33253905215779717
chr11	RAB38	88175182	88175236	0	55	1144	1435	1144	1380	0.0	0.8289855072463768
chr11	CTSC	88312387	88312448	0	62	51	15798	51	15736	0.0	0.003240976105744789
chr11	CTSC	88312387	88312425	0	39	51	15798	51	15759	0.0	0.003236245954692557
chr11	CTSC	88337500	88337706	0	207	51	15798	51	15591	0.0	0.003271117952664999
chr11	CTSC	88337500	88337545	0	46	51	15798	51	15752	0.0	0.0032376841036058914
chr11	CTSC	88337546	88337706	0	161	51	15798	51	15637	0.0	0.0032614951717081283
chr11	CTSC	88312426	88312448	0	23	51	15798	51	15775	0.0	0.0032329635499207606
chr11	CTSC	88337172	88337499	0	328	51	15798	51	15470	0.0	0.0032967032967032967
chr11	CTSC	88337172	88337706	0	535	51	15798	51	15263	0.0	0.003341413876695276
chr11	CTSC	88337172	88337545	0	374	51	15798	51	15424	0.0	0.0033065352697095435
chr11	NOX4	89340062	89340124	0	63	51	6122	51	6059	0.0	0.008417230566100017
chr11	CHORDC1	90222528	90222889	0	362	0	7182	0	6820	0.0	0.0
chr11	SLC36A4	93182805	93182833	0	29	204	9722	204	9693	0.0	0.021046115753636643
chr11	TAF1D	93736140	93736288	0	149	51	5700	51	5551	0.0	0.009187533777697713
chr11	MRE11	94492641	94492780	0	140	204	7556	204	7416	0.0	0.02750809061488673
chr11	MRE11	94493683	94493789	51	107	204	7556	153	7449	0.4766355140186916	0.02053966975432944
chr11	MRE11	94493683	94493719	18	37	204	7556	186	7519	0.4864864864864865	0.024737332092033514
chr11	MRE11	94493720	94493789	33	70	204	7556	171	7486	0.4714285714285714	0.02284263959390863
chr11	SESN3	95232156	95232411	0	256	612	10592	612	10336	0.0	0.05921052631578947
chr11	FAM76B	95789391	95789681	0	291	2301	5340	2301	5049	0.0	0.45573380867498514
chr11	FAM76B	95788858	95788867	0	10	2301	5340	2301	5330	0.0	0.4317073170731707
chr11	MTMR2	95857551	95857554	0	4	6134	10675	6134	10671	0.0	0.5748289757286102
chr11	MTMR2	95865439	95865599	0	161	6134	10675	6134	10514	0.0	0.5834125927334982
chr11	MTMR2	95865439	95865589	0	151	6134	10675	6134	10524	0.0	0.5828582288103382
chr11	MTMR2	95923620	95923690	0	71	6134	10675	6134	10604	0.0	0.5784609581290079
chr11	MTMR2	95923691	95923873	0	183	6134	10675	6134	10492	0.0	0.5846359130766298
chr11	MTMR2	95865590	95865599	0	10	6134	10675	6134	10665	0.0	0.5751523675574308
chr11	MTMR2	95850207	95850598	0	392	6134	10675	6134	10283	0.0	0.5965185257220655
chr11	MTMR2	95866383	95866401	0	19	6134	10675	6134	10656	0.0	0.5756381381381381
chr11	CCDC82	96364979	96365125	0	147	0	14215	0	14068	0.0	0.0
chr11	CCDC82	96388382	96389363	0	982	0	14215	0	13233	0.0	0.0
chr11	CCDC82	96388382	96388693	0	312	0	14215	0	13903	0.0	0.0
chr11	LINC02713	97918837	97918840	0	4	0	1903	0	1899	0.0	0.0
chr11	PGR	101127433	101129426	0	1994	102	14342	102	12348	0.0	0.00826044703595724
chr11	MMP3	102843441	102843469	0	29	0	1836	0	1807	0.0	0.0
chr11	DCUN1D5	103091515	103091785	51	271	2073	12866	2022	12595	0.1881918819188192	0.16053989678443828
chr11	DCUN1D5	103091515	103091682	0	168	2073	12866	2073	12698	0.0	0.1632540557568121
chr11	DCUN1D5	103091683	103091785	51	103	2073	12866	2022	12763	0.49514563106796117	0.15842670218600644
chr11	LINC02552	104566859	104568864	0	2006	0	15741	0	13735	0.0	0.0
chr11	LINC02552	104572075	104572555	0	481	0	15741	0	15260	0.0	0.0
chr11	CASP12	104891169	104891196	0	28	51	1795	51	1767	0.0	0.028862478777589132
chr11	CASP4LP	104906449	104906975	0	527	0	3314	0	2787	0.0	0.0
chr11	CASP4LP	104906449	104906958	0	510	0	3314	0	2804	0.0	0.0
chr11	CASP4LP	104906959	104906975	0	17	0	3314	0	3297	0.0	0.0
chr11	CASP1	105034207	105034422	0	216	0	3706	0	3490	0.0	0.0
chr11	MSANTD4	106020961	106022193	0	1233	0	3428	0	2195	0.0	0.0
chr11	MSANTD4	106020961	106022120	0	1160	0	3428	0	2268	0.0	0.0
chr11	MSANTD4	106020961	106021834	0	874	0	3428	0	2554	0.0	0.0
chr11	MSANTD4	106022121	106022193	0	73	0	3428	0	3355	0.0	0.0
chr11	MSANTD4	106021835	106022193	0	359	0	3428	0	3069	0.0	0.0
chr11	MSANTD4	106021835	106022120	0	286	0	3428	0	3142	0.0	0.0
chr11	ALKBH8	107565600	107565628	0	29	51	4215	51	4186	0.0	0.012183468705207836
chr11	NPAT	108160879	108161319	0	441	16211	7108	16211	6667	0.0	2.431528423578821
chr11	LINC02715	109823619	109823754	0	136	0	1299	0	1163	0.0	0.0
chr11	ALG9	111870774	111870939	0	166	2564	7995	2564	7829	0.0	0.3275003193255844
chr11	ALG9	111870227	111870230	0	4	2564	7995	2564	7991	0.0	0.3208609685896634
chr11	CRYAB	111910633	111910694	0	62	57088	3377	57088	3315	0.0	17.221116138763197
chr11	CRYAB	111910633	111910669	0	37	57088	3377	57088	3340	0.0	17.092215568862276
chr11	CRYAB	111913104	111913137	0	34	57088	3377	57088	3343	0.0	17.076877056536045
chr11	CRYAB	111910695	111910831	0	137	57088	3377	57088	3240	0.0	17.619753086419752
chr11	CRYAB	111911907	111911917	0	11	57088	3377	57088	3366	0.0	16.960190136660724
chr11	CRYAB	111913597	111913704	605	108	57088	3377	56483	3269	5.601851851851852	17.278372591006423
chr11	CRYAB	111910670	111910694	0	25	57088	3377	57088	3352	0.0	17.031026252983292
chr11	PIH1D2	112073929	112073978	0	50	4591	3232	4591	3182	0.0	1.4428032683846637
chr11	AP000802.1	112961258	112961365	0	108	255	2957	255	2849	0.0	0.08950508950508951
chr11	TMPRSS5	113699961	113700064	15981	104	34722	2681	18741	2577	153.66346153846155	7.272409778812572
chr11	TMPRSS5	113696835	113696856	0	22	34722	2681	34722	2659	0.0	13.058292591199699
chr11	NXPE1	114553687	114554312	0	626	0	4399	0	3773	0.0	0.0
chr11	NXPE4	114582287	114582750	0	464	0	2193	0	1729	0.0	0.0
chr11	LINC00900	115759992	115760028	0	37	0	5016	0	4979	0.0	0.0
chr11	BUD13	116762552	116762953	1298	402	3011	2205	1713	1803	3.228855721393035	0.9500831946755408
chr11	ZPR1	116787819	116787846	0	28	5743	5417	5743	5389	0.0	1.0656893672295416
chr11	APOA1	116837527	116837557	0	31	0	980	0	949	0.0	0.0
chr11	APOA1	116837558	116837603	0	46	0	980	0	934	0.0	0.0
chr11	PCSK7	117231786	117232025	0	240	135275	20140	135275	19900	0.0	6.797738693467337
chr11	BACE1	117295130	117295261	0	132	2550	7202	2550	7070	0.0	0.3606789250353607
chr11	BACE1	117295130	117295317	0	188	2550	7202	2550	7014	0.0	0.3635585970915312
chr11	BACE1	117295262	117295317	0	56	2550	7202	2550	7146	0.0	0.35684298908480266
chr11	FXYD6	117840318	117840342	0	25	102	4097	102	4072	0.0	0.02504911591355599
chr11	FXYD6	117840236	117840317	0	82	102	4097	102	4015	0.0	0.025404732254047324
chr11	FXYD6	117840236	117840342	0	107	102	4097	102	3990	0.0	0.02556390977443609
chr11	SCN4B	118143832	118143985	0	154	0	5655	0	5501	0.0	0.0
chr11	JAML	118205881	118205913	0	33	239	6176	239	6143	0.0	0.03890607195181507
chr11	JAML	118212904	118212913	0	10	239	6176	239	6166	0.0	0.038760947129419396
chr11	JAML	118197967	118197996	0	30	239	6176	239	6146	0.0	0.038887081028311093
chr11	AP001267.3	118521245	118521264	1285	20	9938	2698	8653	2678	64.25	3.231142643764003
chr11	RPS25	119017924	119017956	0	33	0	944	0	911	0.0	0.0
chr11	SLC37A4	119030231	119030546	42	316	2971	4259	2929	3943	0.13291139240506328	0.7428354045143292
chr11	SLC37A4	119029221	119029390	0	170	2971	4259	2971	4089	0.0	0.7265835167522622
chr11	HYOU1	119057019	119057151	0	133	136486	6178	136486	6045	0.0	22.578329197684038
chr11	HYOU1	119057019	119057073	0	55	136486	6178	136486	6123	0.0	22.290707169688062
chr11	HYOU1	119057019	119057025	0	7	136486	6178	136486	6171	0.0	22.11732296224275
chr11	HYOU1	119056804	119057018	0	215	136486	6178	136486	5963	0.0	22.88881435519034
chr11	HYOU1	119056804	119056999	0	196	136486	6178	136486	5982	0.0	22.816115011701772
chr11	HYOU1	119057026	119057073	0	48	136486	6178	136486	6130	0.0	22.2652528548124
chr11	HYOU1	119057000	119057018	0	19	136486	6178	136486	6159	0.0	22.16041565189154
chr11	HYOU1	119057000	119057151	0	152	136486	6178	136486	6026	0.0	22.649518752074343
chr11	HYOU1	119057000	119057073	0	74	136486	6178	136486	6104	0.0	22.360091743119266
chr11	HYOU1	119057000	119057025	0	26	136486	6178	136486	6152	0.0	22.18563068920676
chr11	DPAGT1	119097444	119097462	24	19	589	3974	565	3955	1.263157894736842	0.14285714285714285
chr11	C1QTNF5	119340183	119340290	0	108	2435	1540	2435	1432	0.0	1.7004189944134078
chr11	MFRP	119342854	119342871	0	18	3768	4110	3768	4092	0.0	0.9208211143695014
chr11	TRIM29	120185209	120185248	0	40	51	7755	51	7715	0.0	0.00661049902786779
chr11	MIR100HG	122064954	122066134	0	1181	189	24445	189	23264	0.0	0.00812414030261348
chr11	MIR100HG	122101446	122101985	0	540	189	24445	189	23905	0.0	0.007906295754026354
chr11	MIR100HG	122453615	122453619	0	5	189	24445	189	24440	0.0	0.007733224222585925
chr11	HSPA8	123062063	123062311	894	249	17697	4221	16803	3972	3.5903614457831323	4.230362537764351
chr11	HSPA8	123062312	123062345	702	34	17697	4221	16995	4187	20.647058823529413	4.058992118461906
chr11	HSPA8	123061868	123061911	0	44	17697	4221	17697	4177	0.0	4.23677280344745
chr11	HSPA8	123061587	123061673	0	87	17697	4221	17697	4134	0.0	4.280841799709724
chr11	LINC02727	123314320	123314501	0	182	0	1067	0	885	0.0	0.0
chr11	ZNF202	123740392	123740415	0	24	0	4708	0	4684	0.0	0.0
chr11	TMEM225	123885244	123885393	0	150	0	995	0	845	0.0	0.0
chr11	ESAM	124754629	124754639	2897	11	162599	2750	159702	2739	263.3636363636364	58.30668127053669
chr11	CCDC15-DT	124950719	124951337	255	619	1913	2722	1658	2103	0.41195476575121165	0.7883975273418925
chr11	CCDC15-DT	124950719	124950900	0	182	1913	2722	1913	2540	0.0	0.7531496062992126
chr11	CCDC15-DT	124950901	124951337	255	437	1913	2722	1658	2285	0.5835240274599542	0.7256017505470459
chr11	TMEM218	125102636	125102728	0	93	51	4681	51	4588	0.0	0.011115954664341761
chr11	TMEM218	125102636	125102732	0	97	51	4681	51	4584	0.0	0.01112565445026178
chr11	TMEM218	125111538	125111585	24	48	51	4681	27	4633	0.5	0.005827757392618174
chr11	TMEM218	125111538	125111583	22	46	51	4681	29	4635	0.4782608695652174	0.006256742179072276
chr11	TMEM218	125102729	125102732	0	4	51	4681	51	4677	0.0	0.010904425914047467
chr11	TMEM218	125102131	125102732	0	602	51	4681	51	4079	0.0	0.0125030644765874
chr11	TMEM218	125111584	125111585	2	2	51	4681	49	4679	1.0	0.010472323145971362
chr11	FEZ1	125495835	125496119	1695	285	862665	9010	860970	8725	5.947368421052632	98.67851002865329
chr11	ACRV1	125677796	125677852	0	57	103	1967	103	1910	0.0	0.05392670157068063
chr11	CDON	125961654	125961722	0	69	255	10623	255	10554	0.0	0.024161455372370664
chr11	CDON	126063225	126063270	0	46	255	10623	255	10577	0.0	0.024108915571523115
chr11	AP001122.1	128686056	128686225	0	170	10965	4311	10965	4141	0.0	2.6479111325766724
chr11	TP53AIP1	128936761	128937676	138	916	3253	1377	3115	461	0.15065502183406113	6.75704989154013
chr11	NFRKB	129878308	129878309	0	2	28828	6363	28828	6361	0.0	4.531991825184719
chr11	PRDM10	129912084	129912122	0	39	129	6649	129	6610	0.0	0.01951588502269289
chr11	ZBTB44	130236792	130237008	51	217	1992	9568	1941	9351	0.2350230414746544	0.20757138273981393
chr11	SNX19	130907952	130907967	0	16	1273	15366	1273	15350	0.0	0.0829315960912052
chr11	SNX19	130914265	130916278	0	2014	1273	15366	1273	13352	0.0	0.09534152186938287
chr11	SNX19	130914265	130914692	0	428	1273	15366	1273	14938	0.0	0.08521890480653367
chr11	THYN1	134253226	134253297	0	72	0	1816	0	1744	0.0	0.0
chr11	B3GAT1	134387826	134387842	0	17	0	11757	0	11740	0.0	0.0
chr12	NINJ2-AS1	643718	643837	0	120	0	4365	0	4245	0.0	0.0
chr12	WNK1	890511	890513	0	3	95456	16067	95456	16064	0.0	5.942231075697211
chr12	ERC1	991323	991487	0	165	37225	12243	37225	12078	0.0	3.0820500082795164
chr12	LRTM2	1827595	1827630	0	36	1137	4285	1137	4249	0.0	0.26759237467639446
chr12	CACNA1C	2634375	2634380	0	6	28574	19162	28574	19156	0.0	1.491647525579453
chr12	ITFG2	2818278	2818353	0	76	212	6111	212	6035	0.0	0.03512841756420878
chr12	ITFG2	2823944	2824013	0	70	212	6111	212	6041	0.0	0.03509352756166197
chr12	RHNO1	2885493	2885534	0	42	0	2529	0	2487	0.0	0.0
chr12	TEAD4	2960041	2960353	0	313	21171	2289	21171	1976	0.0	10.714068825910932
chr12	TEAD4	2960197	2960353	0	157	21171	2289	21171	2132	0.0	9.930112570356473
chr12	TEAD4	2960041	2960196	0	156	21171	2289	21171	2133	0.0	9.925457102672292
chr12	RAD51AP1	4543905	4543911	0	7	0	2491	0	2484	0.0	0.0
chr12	RAD51AP1	4556503	4556550	0	48	0	2491	0	2443	0.0	0.0
chr12	RAD51AP1	4553090	4553147	0	58	0	2491	0	2433	0.0	0.0
chr12	AC005906.2	5021769	5021842	0	74	0	7869	0	7795	0.0	0.0
chr12	CD9	6226361	6226440	0	80	0	4900	0	4820	0.0	0.0
chr12	TAPBPL	6452151	6452312	0	162	0	3198	0	3036	0.0	0.0
chr12	GAPDH	6536791	6536817	0	27	2447	2031	2447	2004	0.0	1.221057884231537
chr12	GAPDH	6534570	6534661	0	92	2447	2031	2447	1939	0.0	1.2619907168643631
chr12	COPS7A	6724153	6724179	0	27	9	2633	9	2606	0.0	0.0034535686876438986
chr12	COPS7A	6724153	6724250	0	98	9	2633	9	2535	0.0	0.0035502958579881655
chr12	COPS7A	6724180	6724250	0	71	9	2633	9	2562	0.0	0.00351288056206089
chr12	COPS7A	6724153	6724266	0	114	9	2633	9	2519	0.0	0.003572846367606193
chr12	COPS7A	6724180	6724266	0	87	9	2633	9	2546	0.0	0.003534956794972506
chr12	COPS7A	6724251	6724266	0	16	9	2633	9	2617	0.0	0.003439052350019106
chr12	COPS7A	6724331	6724378	0	48	9	2633	9	2585	0.0	0.003481624758220503
chr12	COPS7A	6724369	6724378	0	10	9	2633	9	2623	0.0	0.003431185665268776
chr12	COPS7A	6724331	6724368	0	38	9	2633	9	2595	0.0	0.003468208092485549
chr12	GPR162	6823764	6824765	0	1002	129	2902	129	1900	0.0	0.06789473684210526
chr12	GPR162	6824715	6824765	0	51	129	2902	129	2851	0.0	0.045247281655559454
chr12	GNB3	6843696	6843698	0	3	338288	2973	338288	2970	0.0	113.90168350168351
chr12	USP5	6863309	6863377	0	69	283850	3612	283850	3543	0.0	80.1157211402766
chr12	TPI1	6868256	6868509	0	254	580	2535	580	2281	0.0	0.2542744410346339
chr12	TPI1	6868324	6868509	0	186	580	2535	580	2349	0.0	0.24691358024691357
chr12	TPI1	6868256	6868323	0	68	580	2535	580	2467	0.0	0.23510336441021484
chr12	LRRC23	6904904	6905075	0	172	348	3064	348	2892	0.0	0.12033195020746888
chr12	LRRC23	6904904	6905250	0	347	348	3064	348	2717	0.0	0.12808244387191756
chr12	LRRC23	6905076	6905250	0	175	348	3064	348	2889	0.0	0.12045690550363447
chr12	ENO2	6922093	6922164	0	72	765	3883	765	3811	0.0	0.20073471529782208
chr12	C12ORF57	6944566	6944652	1160	87	32178	1715	31018	1628	13.333333333333334	19.052825552825553
chr12	PTPN6	6951516	6951520	0	5	355882	4799	355882	4794	0.0	74.2348769294952
chr12	C1S	7061792	7061917	0	126	83353	5258	83353	5132	0.0	16.241816056118473
chr12	CLSTN3	7157692	7157746	0	55	1110	6619	1110	6564	0.0	0.16910420475319926
chr12	PEX5	7190525	7190569	0	45	5387	5387	5387	5342	0.0	1.0084238113066268
chr12	PEX5	7189751	7190216	89	466	5387	5387	5298	4921	0.19098712446351931	1.0766104450314977
chr12	PEX5	7189981	7190216	0	236	5387	5387	5387	5151	0.0	1.0458163463405163
chr12	NECAP1	8093044	8093055	0	12	2154	8370	2154	8358	0.0	0.25771715721464467
chr12	NECAP1	8090300	8090343	0	44	2154	8370	2154	8326	0.0	0.25870766274321405
chr12	FAM66C	8188536	8188645	68	110	53112	4631	53044	4521	0.6181818181818182	11.732802477328026
chr12	RIMKLB	8697741	8697778	0	38	671	7829	671	7791	0.0	0.08612501604415351
chr12	AC092490.1	8788761	8788786	0	26	170	2265	170	2239	0.0	0.07592675301473872
chr12	A2ML1	8845175	8845306	0	132	1128	7146	1128	7014	0.0	0.16082121471343028
chr12	A2ML1	8845307	8845311	0	5	1128	7146	1128	7141	0.0	0.15796106987816833
chr12	PHC1	8932832	8933350	58334	519	112100	5613	53766	5094	112.39691714836223	10.554770318021202
chr12	PHC1	8919867	8919917	0	51	112100	5613	112100	5562	0.0	20.154620640057534
chr12	AC092821.3	9648377	9648933	0	557	55981	5997	55981	5440	0.0	10.290625
chr12	AC092821.3	9648329	9648933	0	605	55981	5997	55981	5392	0.0	10.38223293768546
chr12	AC092821.3	9648329	9648376	0	48	55981	5997	55981	5949	0.0	9.41015296688519
chr12	AC092821.3	9656650	9656697	0	48	55981	5997	55981	5949	0.0	9.41015296688519
chr12	CLEC2D	9688087	9688161	0	75	102	6863	102	6788	0.0	0.015026517383618149
chr12	CLEC2D	9693116	9693948	102	833	102	6863	0	6030	0.12244897959183673	0.0
chr12	CLEC2D	9692932	9693948	102	1017	102	6863	0	5846	0.10029498525073746	0.0
chr12	CLEC12B	10015728	10015874	0	147	0	3850	0	3703	0.0	0.0
chr12	GABARAPL1	10214000	10214187	0	188	0	3148	0	2960	0.0	0.0
chr12	GABARAPL1	10214188	10214779	0	592	0	3148	0	2556	0.0	0.0
chr12	GABARAPL1	10213220	10214779	0	1560	0	3148	0	1588	0.0	0.0
chr12	GABARAPL1	10213618	10214779	0	1162	0	3148	0	1986	0.0	0.0
chr12	GABARAPL1	10214000	10214779	0	780	0	3148	0	2368	0.0	0.0
chr12	GABARAPL1	10213618	10214187	0	570	0	3148	0	2578	0.0	0.0
chr12	KLRD1	10311616	10311619	0	4	459	15814	459	15810	0.0	0.02903225806451613
chr12	LINC02366	10750301	10750459	0	159	407	966	407	807	0.0	0.5043370508054523
chr12	LINC01252	11559383	11559465	0	83	0	3605	0	3522	0.0	0.0
chr12	BORCS5	12357119	12357509	0	391	51	6525	51	6134	0.0	0.008314313661558527
chr12	CDKN1B	12718054	12718314	0	261	2981	2077	2981	1816	0.0	1.6415198237885462
chr12	GPRC5A	12912143	12912300	6	158	45623	7667	45617	7509	0.0379746835443038	6.074976694633107
chr12	ATF7IP	14419191	14419361	0	171	204	12643	204	12472	0.0	0.0163566388710712
chr12	ATF7IP	14419219	14419361	0	143	204	12643	204	12500	0.0	0.01632
chr12	H2AJ	14774913	14774976	4398	64	40391	3322	35993	3258	68.71875	11.047575199508902
chr12	PTPRO	15595058	15595640	0	583	157	18862	157	18279	0.0	0.008589091306964275
chr12	MGST1	16354271	16354378	0	108	102	6231	102	6123	0.0	0.016658500734933857
chr12	AEBP2	19404125	19404216	0	92	3515	6279	3515	6187	0.0	0.5681267173104897
chr12	SLCO1C1	20750793	20750895	0	103	48873	4794	48873	4691	0.0	10.418460882541035
chr12	PYROXD1	21462121	21462125	0	5	137	5425	137	5420	0.0	0.025276752767527676
chr12	AC084816.1	22787721	22787725	0	5	79	6101	79	6096	0.0	0.012959317585301838
chr12	AC084816.1	22859546	22860095	0	550	79	6101	79	5551	0.0	0.014231669969374888
chr12	AC084816.1	23054155	23054323	0	169	79	6101	79	5932	0.0	0.013317599460552934
chr12	AC084816.1	23185543	23185594	0	52	79	6101	79	6049	0.0	0.013060009918994876
chr12	SOX5-AS1	24254936	24255042	0	107	0	3161	0	3054	0.0	0.0
chr12	ETFRF1	25195338	25195341	0	4	90	2377	90	2373	0.0	0.03792667509481669
chr12	ETFRF1	25203824	25203832	0	9	90	2377	90	2368	0.0	0.03800675675675676
chr12	RASSF8	26052603	26052996	0	394	1836	5419	1836	5025	0.0	0.3653731343283582
chr12	MED21	27022622	27022871	0	250	1268	2970	1268	2720	0.0	0.4661764705882353
chr12	STK38L	27302189	27302255	0	67	3768	6882	3768	6815	0.0	0.5528980190755686
chr12	ARNTL2	27333104	27333136	0	33	2872	7001	2872	6968	0.0	0.4121699196326062
chr12	PPFIBP1	27664438	27664446	0	9	48323	11261	48323	11252	0.0	4.294614290792748
chr12	KLHL42	27780382	27781202	0	821	125471	7360	125471	6539	0.0	19.18810215629301
chr12	CCDC91	28305780	28305806	0	27	2676	7033	2676	7006	0.0	0.3819583214387668
chr12	AC010198.2	30795812	30796216	0	405	71602	18419	71602	18014	0.0	3.974797379815699
chr12	AC010198.2	30796030	30796216	0	187	71602	18419	71602	18232	0.0	3.927270732777534
chr12	DDX11	31073970	31074091	0	122	36	7413	36	7291	0.0	0.004937594294335482
chr12	DDX11	31102312	31102335	24	24	36	7413	12	7389	1.0	0.0016240357287860333
chr12	ETFBKMT	31659790	31659935	0	146	1169	6875	1169	6729	0.0	0.17372566503195125
chr12	BICD1	32337707	32337816	0	110	2181	12614	2181	12504	0.0	0.17442418426103648
chr12	DNM1L	32701473	32701562	0	90	709	7139	709	7049	0.0	0.1005816427862108
chr12	ALG10	34022745	34022770	0	26	51	4200	51	4174	0.0	0.0122184954480115
chr12	AC046130.2	34037628	34037648	0	21	0	2566	0	2545	0.0	0.0
chr12	ALG10B	38317039	38317064	0	26	0	8599	0	8573	0.0	0.0
chr12	LRRK2	40367060	40367077	0	18	1275	11039	1275	11021	0.0	0.11568823155793485
chr12	LINC02400	41764258	41764265	0	8	0	1273	0	1265	0.0	0.0
chr12	LINC02400	41764260	41764265	0	6	0	1273	0	1267	0.0	0.0
chr12	LINC02400	41764258	41764259	0	2	0	1273	0	1271	0.0	0.0
chr12	LINC02400	41764258	41765050	0	793	0	1273	0	480	0.0	0.0
chr12	LINC02400	41764266	41765050	0	785	0	1273	0	488	0.0	0.0
chr12	LINC02400	41764260	41765050	0	791	0	1273	0	482	0.0	0.0
chr12	LINC02400	41764807	41765050	0	244	0	1273	0	1029	0.0	0.0
chr12	LINC02400	41764266	41764281	0	16	0	1273	0	1257	0.0	0.0
chr12	LINC02400	41764260	41764281	0	22	0	1273	0	1251	0.0	0.0
chr12	LINC02450	42692277	42692513	0	237	4307	1477	4307	1240	0.0	3.4733870967741933
chr12	IRAK4	43772987	43773072	0	86	0	5626	0	5540	0.0	0.0
chr12	IRAK4	43759017	43759592	0	576	0	5626	0	5050	0.0	0.0
chr12	AC008014.1	46383696	46383713	0	18	6346	4863	6346	4845	0.0	1.3098039215686275
chr12	SLC48A1	47773437	47773440	0	4	0	4924	0	4920	0.0	0.0
chr12	TMEM106C	47966173	47966229	0	57	0	3201	0	3144	0.0	0.0
chr12	TMEM106C	47963634	47963704	0	71	0	3201	0	3130	0.0	0.0
chr12	PFKM	48105718	48105810	0	93	6091	6825	6091	6732	0.0	0.9047831253713606
chr12	PFKM	48135039	48135383	0	345	6091	6825	6091	6480	0.0	0.9399691358024691
chr12	PFKM	48106138	48106311	0	174	6091	6825	6091	6651	0.0	0.9158021350172907
chr12	PFKM	48106182	48106311	0	130	6091	6825	6091	6695	0.0	0.9097834204630321
chr12	PFKM	48106253	48106311	0	59	6091	6825	6091	6766	0.0	0.9002364765001478
chr12	PFKM	48106138	48106181	0	44	6091	6825	6091	6781	0.0	0.8982450965934228
chr12	PFKM	48106138	48106252	0	115	6091	6825	6091	6710	0.0	0.9077496274217586
chr12	PFKM	48106182	48106252	0	71	6091	6825	6091	6754	0.0	0.9018359490672194
chr12	PFKM	48119407	48119462	0	56	6091	6825	6091	6769	0.0	0.8998374944600384
chr12	PFKM	48122654	48122677	2	24	6091	6825	6089	6801	0.08333333333333333	0.8953095133068666
chr12	PFKM	48139350	48139504	0	155	6091	6825	6091	6670	0.0	0.9131934032983509
chr12	CACNB3	48818523	48818558	0	36	0	6342	0	6306	0.0	0.0
chr12	CACNB3	48818523	48818974	0	452	0	6342	0	5890	0.0	0.0
chr12	CACNB3	48818559	48818974	0	416	0	6342	0	5926	0.0	0.0
chr12	TROAP	49323947	49324037	6234	91	793646	3637	787412	3546	68.50549450549451	222.0564015792442
chr12	TROAP	49325561	49325658	2928	98	793646	3637	790718	3539	29.877551020408163	223.42978242441367
chr12	SPATS2	49366920	49367021	0	102	61859	6730	61859	6628	0.0	9.332981291490645
chr12	SPATS2	49366920	49367587	0	668	61859	6730	61859	6062	0.0	10.204387990762125
chr12	SPATS2	49367022	49367587	0	566	61859	6730	61859	6164	0.0	10.035528877352368
chr12	PRPF40B	49642979	49643016	0	38	3233	8412	3233	8374	0.0	0.3860759493670886
chr12	TMBIM6	49742116	49742280	0	165	4852	5925	4852	5760	0.0	0.8423611111111111
chr12	TMBIM6	49741612	49741768	904	157	4852	5925	3948	5768	5.75796178343949	0.6844660194174758
chr12	BCDIN3D-AS1	49828745	49828748	0	4	2856	4668	2856	4664	0.0	0.6123499142367067
chr12	LINC02395	49923878	49924000	66	123	63998	6673	63932	6550	0.5365853658536586	9.7606106870229
chr12	LINC02395	49926138	49926145	48	8	63998	6673	63950	6665	6.0	9.59489872468117
chr12	LINC02395	49923878	49924513	510	636	63998	6673	63488	6037	0.8018867924528302	10.516481696206725
chr12	LINC02395	49924001	49924513	444	513	63998	6673	63554	6160	0.8654970760233918	10.317207792207792
chr12	AQP2	49954320	49954445	0	126	57402	2403	57402	2277	0.0	25.209486166007906
chr12	ASIC1	50080590	50080727	306	138	13495	4848	13189	4710	2.217391304347826	2.8002123142250532
chr12	ASIC1	50077050	50077060	0	11	13495	4848	13495	4837	0.0	2.789952449865619
chr12	COX14	50112302	50112497	0	196	0	974	0	778	0.0	0.0
chr12	LARP4	50474108	50474167	0	60	105070	8113	105070	8053	0.0	13.047311560908978
chr12	LETMD1	51048372	51048478	0	107	357	3857	357	3750	0.0	0.0952
chr12	LETMD1	51048479	51048518	0	40	357	3857	357	3817	0.0	0.09352894943673042
chr12	LETMD1	51048372	51048518	0	147	357	3857	357	3710	0.0	0.09622641509433963
chr12	LETMD1	51052208	51052246	0	39	357	3857	357	3818	0.0	0.09350445259298062
chr12	DAZAP2	51241040	51241116	0	77	0	3807	0	3730	0.0	0.0
chr12	SCN8A	51688850	51690019	0	1170	11102	16021	11102	14851	0.0	0.747559086930173
chr12	SCN8A	51689097	51690019	0	923	11102	16021	11102	15098	0.0	0.7353291826732018
chr12	SCN8A	51721909	51721941	0	33	11102	16021	11102	15988	0.0	0.6943957968476357
chr12	ANKRD33	51889483	51889512	0	30	2808	2094	2808	2064	0.0	1.3604651162790697
chr12	TAMALIN	52011142	52011207	0	66	0	2831	0	2765	0.0	0.0
chr12	NR4A1	52054652	52055204	0	553	578	6100	578	5547	0.0	0.10420046872183163
chr12	ATG101	52070072	52070242	0	171	0	3130	0	2959	0.0	0.0
chr12	ATG101	52070049	52070242	0	194	0	3130	0	2936	0.0	0.0
chr12	ATG101	52070049	52070071	0	23	0	3130	0	3107	0.0	0.0
chr12	LINC00592	52210936	52211020	0	85	24	2261	24	2176	0.0	0.011029411764705883
chr12	LINC00592	52222944	52223074	0	131	24	2261	24	2130	0.0	0.011267605633802818
chr12	EIF4B	53034710	53034724	0	15	0	5369	0	5354	0.0	0.0
chr12	TNS2	53059968	53060258	0	291	0	7370	0	7079	0.0	0.0
chr12	TNS2	53062692	53062697	0	6	0	7370	0	7364	0.0	0.0
chr12	TNS2	53058828	53058854	0	27	0	7370	0	7343	0.0	0.0
chr12	ESPL1	53268848	53268928	0	81	1243	7320	1243	7239	0.0	0.17170879955795
chr12	ESPL1	53268378	53268406	14	29	1243	7320	1229	7291	0.4827586206896552	0.16856398299273076
chr12	MYG1	53303173	53303193	0	21	821	2506	821	2485	0.0	0.33038229376257544
chr12	PFDN5	53296468	53296551	0	84	4909	2927	4909	2843	0.0	1.7266971508969398
chr12	AMHR2	53425488	53425573	0	86	116825	3292	116825	3206	0.0	36.43948845913911
chr12	PRR13	53441793	53441800	0	8	969	2774	969	2766	0.0	0.35032537960954446
chr12	PRR13	53441801	53441817	0	17	969	2774	969	2757	0.0	0.3514689880304679
chr12	PRR13	53441793	53441817	0	25	969	2774	969	2749	0.0	0.3524918152055293
chr12	PRR13	53441801	53441840	0	40	969	2774	969	2734	0.0	0.3544257498171178
chr12	PRR13	53441793	53441840	0	48	969	2774	969	2726	0.0	0.35546588407923696
chr12	PRR13	53441818	53441840	0	23	969	2774	969	2751	0.0	0.35223555070883317
chr12	PCBP2	53452976	53453283	612	308	82648	6885	82036	6577	1.9870129870129871	12.473164056560742
chr12	TARBP2	53503130	53503212	0	83	204	3979	204	3896	0.0	0.052361396303901436
chr12	HOXC11	53973924	53973927	0	4	1071	3267	1071	3263	0.0	0.3282255593012565
chr12	HNRNPA1	54282663	54282665	0	3	51	4239	51	4236	0.0	0.012039660056657223
chr12	HNRNPA1	54282666	54282874	0	209	51	4239	51	4030	0.0	0.012655086848635236
chr12	HNRNPA1	54281095	54281295	0	201	51	4239	51	4038	0.0	0.01263001485884101
chr12	HNRNPA1	54281942	54281945	0	4	51	4239	51	4235	0.0	0.012042502951593861
chr12	HNRNPA1	54281897	54281908	0	12	51	4239	51	4227	0.0	0.0120652945351313
chr12	HNRNPA1	54282597	54282665	0	69	51	4239	51	4170	0.0	0.01223021582733813
chr12	HNRNPA1	54282612	54282665	0	54	51	4239	51	4185	0.0	0.012186379928315413
chr12	HNRNPA1	54282642	54282665	0	24	51	4239	51	4215	0.0	0.012099644128113879
chr12	HNRNPA1	54282597	54282611	0	15	51	4239	51	4224	0.0	0.012073863636363636
chr12	HNRNPA1	54282597	54282662	0	66	51	4239	51	4173	0.0	0.012221423436376708
chr12	HNRNPA1	54282612	54282662	0	51	51	4239	51	4188	0.0	0.012177650429799427
chr12	HNRNPA1	54282642	54282662	0	21	51	4239	51	4218	0.0	0.01209103840682788
chr12	HNRNPA1	54282597	54282641	0	45	51	4239	51	4194	0.0	0.012160228898426323
chr12	HNRNPA1	54282612	54282641	0	30	51	4239	51	4209	0.0	0.012116892373485389
chr12	HNRNPA1	54282821	54282823	0	3	51	4239	51	4236	0.0	0.012039660056657223
chr12	HNRNPA1	54282875	54282932	0	58	51	4239	51	4181	0.0	0.012198038746711314
chr12	HNRNPA1	54282824	54282841	0	18	51	4239	51	4221	0.0	0.012082444918265814
chr12	HNRNPA1	54282821	54282841	0	21	51	4239	51	4218	0.0	0.01209103840682788
chr12	HNRNPA1	54283133	54283225	0	93	51	4239	51	4146	0.0	0.012301013024602027
chr12	HNRNPA1	54283133	54283228	0	96	51	4239	51	4143	0.0	0.012309920347574221
chr12	HNRNPA1	54283226	54283228	0	3	51	4239	51	4236	0.0	0.012039660056657223
chr12	HNRNPA1	54283133	54283234	0	102	51	4239	51	4137	0.0	0.012327773749093546
chr12	HNRNPA1	54283226	54283234	0	9	51	4239	51	4230	0.0	0.012056737588652482
chr12	HNRNPA1	54283229	54283234	0	6	51	4239	51	4233	0.0	0.012048192771084338
chr12	HNRNPA1	54283163	54283234	0	72	51	4239	51	4167	0.0	0.012239020878329733
chr12	HNRNPA1	54284318	54284321	0	4	51	4239	51	4235	0.0	0.012042502951593861
chr12	HNRNPA1	54286283	54286286	0	4	51	4239	51	4235	0.0	0.012042502951593861
chr12	OR6C4	55549967	55550118	0	152	0	5153	0	5001	0.0	0.0
chr12	TMEM198B	55833015	55833038	0	24	51	4040	51	4016	0.0	0.012699203187250997
chr12	TMEM198B	55831084	55831349	0	266	51	4040	51	3774	0.0	0.013513513513513514
chr12	TMEM198B	55833015	55833125	0	111	51	4040	51	3929	0.0	0.012980402137948587
chr12	TMEM198B	55833039	55833125	0	87	51	4040	51	3953	0.0	0.012901593726283835
chr12	DGKA	55940169	55940170	0	2	0	7520	0	7518	0.0	0.0
chr12	DGKA	55932124	55932255	0	132	0	7520	0	7388	0.0	0.0
chr12	DGKA	55932181	55932255	0	75	0	7520	0	7445	0.0	0.0
chr12	DGKA	55932124	55932180	0	57	0	7520	0	7463	0.0	0.0
chr12	CDK2	55967125	55967934	0	810	321	3698	321	2888	0.0	0.11114958448753462
chr12	CDK2	55967403	55967416	0	14	321	3698	321	3684	0.0	0.08713355048859935
chr12	SUOX	55999459	55999590	0	132	77	4350	77	4218	0.0	0.018255097202465622
chr12	IKZF4	56021451	56021580	0	130	0	6273	0	6143	0.0	0.0
chr12	MYL6B	56155494	56155592	401	99	7047	2943	6646	2844	4.05050505050505	2.3368495077355838
chr12	MYL6	56159623	56159730	373	108	18059	3310	17686	3202	3.4537037037037037	5.523422860712055
chr12	NABP2	56224442	56224521	628	80	301360	2114	300732	2034	7.85	147.85250737463127
chr12	SLC39A5	56230874	56230900	0	27	0	2914	0	2887	0.0	0.0
chr12	COQ10A	56269109	56269251	0	143	0	2553	0	2410	0.0	0.0
chr12	IL23A	56334220	56334260	144	41	4775	1184	4631	1143	3.5121951219512195	4.05161854768154
chr12	RBMS2	56587660	56587664	0	5	83323	8931	83323	8926	0.0	9.334864440958997
chr12	LRP1	57201906	57201947	0	42	23645	20587	23645	20545	0.0	1.150888293988805
chr12	SHMT2	57231914	57231917	0	4	0	3713	0	3709	0.0	0.0
chr12	SHMT2	57230201	57230244	0	44	0	3713	0	3669	0.0	0.0
chr12	SHMT2	57230236	57230244	0	9	0	3713	0	3704	0.0	0.0
chr12	SHMT2	57230245	57230256	0	12	0	3713	0	3701	0.0	0.0
chr12	SHMT2	57230201	57230256	0	56	0	3713	0	3657	0.0	0.0
chr12	SHMT2	57230236	57230256	0	21	0	3713	0	3692	0.0	0.0
chr12	SHMT2	57230201	57230235	0	35	0	3713	0	3678	0.0	0.0
chr12	SHMT2	57230342	57230420	0	79	0	3713	0	3634	0.0	0.0
chr12	SHMT2	57230421	57230474	0	54	0	3713	0	3659	0.0	0.0
chr12	SHMT2	57230463	57230474	0	12	0	3713	0	3701	0.0	0.0
chr12	SHMT2	57230421	57230462	0	42	0	3713	0	3671	0.0	0.0
chr12	SHMT2	57230421	57230660	0	240	0	3713	0	3473	0.0	0.0
chr12	SHMT2	57230475	57230660	0	186	0	3713	0	3527	0.0	0.0
chr12	SHMT2	57230463	57230660	0	198	0	3713	0	3515	0.0	0.0
chr12	SHMT2	57230421	57230666	0	246	0	3713	0	3467	0.0	0.0
chr12	SHMT2	57230475	57230666	0	192	0	3713	0	3521	0.0	0.0
chr12	SHMT2	57230463	57230666	0	204	0	3713	0	3509	0.0	0.0
chr12	SHMT2	57230661	57230666	0	6	0	3713	0	3707	0.0	0.0
chr12	MARS1	57488103	57488199	0	97	397713	6060	397713	5963	0.0	66.69679691430488
chr12	MARS1	57515992	57516158	0	167	397713	6060	397713	5893	0.0	67.48905481079247
chr12	KIF5A	57572625	57572726	2482	102	116444	8616	113962	8514	24.333333333333332	13.385247827108293
chr12	KIF5A	57550401	57550791	9360	391	116444	8616	107084	8225	23.938618925831204	13.019331306990882
chr12	KIF5A	57578331	57578342	0	12	116444	8616	116444	8604	0.0	13.533705253370526
chr12	KIF5A	57582630	57583215	102	586	116444	8616	116342	8030	0.17406143344709898	14.488418430884185
chr12	PIP4K2C	57591401	57591463	5674	63	114363	3262	108689	3199	90.06349206349206	33.97592997811816
chr12	PIP4K2C	57591435	57591463	1846	29	114363	3262	112517	3233	63.6551724137931	34.802660068048255
chr12	PIP4K2C	57591401	57591434	3828	34	114363	3262	110535	3228	112.58823529411765	34.24256505576208
chr12	SLC26A10	57621054	57621092	0	39	242086	3092	242086	3053	0.0	79.29446446118573
chr12	SLC26A10	57625689	57625752	5788	64	242086	3092	236298	3028	90.4375	78.03764861294584
chr12	SLC26A10	57621792	57621842	0	51	242086	3092	242086	3041	0.0	79.60736599802696
chr12	SLC26A10	57625319	57625330	4602	12	242086	3092	237484	3080	383.5	77.1051948051948
chr12	OS9	57695977	57696038	0	62	17230	4766	17230	4704	0.0	3.6628401360544216
chr12	OS9	57718377	57718421	0	45	17230	4766	17230	4721	0.0	3.649650497775895
chr12	OS9	57695982	57696038	0	57	17230	4766	17230	4709	0.0	3.658950944998938
chr12	TSPAN31	57745218	57745231	14	14	4742	4546	4728	4532	1.0	1.0432480141218006
chr12	EEF1AKMT3	57773074	57773128	77	55	2554	3164	2477	3109	1.4	0.7967192023158571
chr12	TSFM	57782859	57782877	0	19	3486	3221	3486	3202	0.0	1.0886945658963147
chr12	TSFM	57783653	57784170	0	518	3486	3221	3486	2703	0.0	1.2896781354051055
chr12	TSFM	57782859	57782907	0	49	3486	3221	3486	3172	0.0	1.0989911727616646
chr12	TSFM	57782878	57782907	0	30	3486	3221	3486	3191	0.0	1.0924475086179881
chr12	AC020637.1	58805983	58806059	0	77	0	1739	0	1662	0.0	0.0
chr12	SLC16A7	59689391	59689470	0	80	0	13706	0	13626	0.0	0.0
chr12	MON2	62535641	62535709	0	69	102	15990	102	15921	0.0	0.006406632749199171
chr12	RXYLT1	63780130	63780462	0	333	0	4507	0	4174	0.0	0.0
chr12	XPOT	64425139	64425182	0	44	1135	7345	1135	7301	0.0	0.1554581564169292
chr12	TBK1	64464460	64464463	0	4	25815	12697	25815	12693	0.0	2.0337981564641927
chr12	TBK1	64481957	64482021	442	65	25815	12697	25373	12632	6.8	2.0086288790373654
chr12	TBK1	64495773	64495775	0	3	25815	12697	25815	12694	0.0	2.0336379391838664
chr12	TBK1	64499145	64499280	0	136	25815	12697	25815	12561	0.0	2.0551707666587054
chr12	TBK1	64495605	64495608	0	4	25815	12697	25815	12693	0.0	2.0337981564641927
chr12	LEMD3	65170419	65171118	102	700	102	5221	0	4521	0.1457142857142857	0.0
chr12	MSRB3	65279050	65279071	0	22	153	7420	153	7398	0.0	0.02068126520681265
chr12	AC090023.1	65558672	65558763	0	92	0	1031	0	939	0.0	0.0
chr12	CAND1	67305313	67306597	0	1285	153	13597	153	12312	0.0	0.012426900584795321
chr12	RAP1B	68611044	68611052	0	9	306	16213	306	16204	0.0	0.018884226117008147
chr12	RAP1B	68611029	68611052	0	24	306	16213	306	16189	0.0	0.018901723392426958
chr12	RAP1B	68611029	68611043	0	15	306	16213	306	16198	0.0	0.01889122113841215
chr12	RAP1B	68611044	68611056	0	13	306	16213	306	16200	0.0	0.01888888888888889
chr12	RAP1B	68611053	68611056	0	4	306	16213	306	16209	0.0	0.018878400888395337
chr12	MDM2	68835844	68835984	0	141	0	10870	0	10729	0.0	0.0
chr12	RAB3IP	69800333	69800337	0	5	57874	10469	57874	10464	0.0	5.5307721712538225
chr12	RAB3IP	69779097	69779181	918	85	57874	10469	56956	10384	10.8	5.48497688751926
chr12	CNOT2	70244190	70244322	0	133	6804	10263	6804	10130	0.0	0.6716683119447187
chr12	CNOT2	70344229	70344239	0	11	6804	10263	6804	10252	0.0	0.6636753804135779
chr12	TMEM19	71700879	71701025	0	147	102	3519	102	3372	0.0	0.030249110320284697
chr12	AC128707.1	78477490	78477511	0	22	0	3254	0	3232	0.0	0.0
chr12	AC027288.1	79542392	79542410	0	19	102	1296	102	1277	0.0	0.07987470634299139
chr12	LINC01490	80763215	80763228	0	14	0	1770	0	1756	0.0	0.0
chr12	LINC01490	80763618	80763704	0	87	0	1770	0	1683	0.0	0.0
chr12	LINC01490	80763649	80763704	0	56	0	1770	0	1714	0.0	0.0
chr12	LINC01490	80763618	80763648	0	31	0	1770	0	1739	0.0	0.0
chr12	ACSS3	81078429	81078431	0	3	0	16849	0	16846	0.0	0.0
chr12	LINC02426	81953880	81954155	0	276	0	1337	0	1061	0.0	0.0
chr12	TMTC3	88142397	88142487	51	91	51	7342	0	7251	0.5604395604395604	0.0
chr12	LINC02822	90676613	90676651	0	39	1	12517	1	12478	0.0	8.014104824491104e-05
chr12	AC025164.1	92146244	92146254	0	11	102	9025	102	9014	0.0	0.011315731084978922
chr12	LINC02412	93176015	93176029	0	15	3863	2726	3863	2711	0.0	1.4249354481741054
chr12	NUDT4	93378694	93378790	0	97	0	10086	0	9989	0.0	0.0
chr12	MRPL42	93470506	93470590	0	85	51	15816	51	15731	0.0	0.0032420062297374612
chr12	SOCS2	93571427	93571914	0	488	153	4478	153	3990	0.0	0.038345864661654135
chr12	SOCS2	93571915	93572186	0	272	153	4478	153	4206	0.0	0.03637660485021398
chr12	SOCS2	93572187	93572375	0	189	153	4478	153	4289	0.0	0.035672650967591514
chr12	VEZT	95258283	95258287	0	5	349	7893	349	7888	0.0	0.04424442190669371
chr12	VEZT	95282360	95282644	0	285	349	7893	349	7608	0.0	0.045872765509989484
chr12	VEZT	95218278	95218345	0	68	349	7893	349	7825	0.0	0.04460063897763578
chr12	NEDD1	96907301	96907322	0	22	1892	4482	1892	4460	0.0	0.4242152466367713
chr12	NEDD1	96907625	96907856	0	232	1892	4482	1892	4250	0.0	0.4451764705882353
chr12	RMST	97541309	97541357	0	49	78	10114	78	10065	0.0	0.007749627421758569
chr12	SLC25A3	98593741	98593744	0	4	51	7682	51	7678	0.0	0.006642354779890596
chr12	SLC25A3	98595558	98595661	0	104	51	7682	51	7578	0.0	0.006730007917656373
chr12	APAF1	98648783	98648815	0	33	127	7025	127	6992	0.0	0.018163615560640733
chr12	ACTR6	100205745	100205757	0	13	864	3828	864	3815	0.0	0.22647444298820446
chr12	ACTR6	100200920	100201060	0	141	864	3828	864	3687	0.0	0.23433685923515052
chr12	SCYL2	100267397	100267792	0	396	102	6940	102	6544	0.0	0.01558679706601467
chr12	NR1H4	100532599	100532610	0	12	11626	3643	11626	3631	0.0	3.2018727623244287
chr12	HSP90B1	103930339	103930564	0	226	80	4445	80	4219	0.0	0.018961839298411946
chr12	TXNRD1	104287110	104287346	0	237	206226	6737	206226	6500	0.0	31.727076923076922
chr12	TXNRD1	104287110	104287431	0	322	206226	6737	206226	6415	0.0	32.14746687451286
chr12	TXNRD1	104287347	104287431	0	85	206226	6737	206226	6652	0.0	31.00210463018641
chr12	TXNRD1	104309951	104310099	0	149	206226	6737	206226	6588	0.0	31.30327868852459
chr12	CHST11	104457515	104457529	0	15	561	6497	561	6482	0.0	0.08654736192533169
chr12	WASHC4	105133897	105133899	0	3	11074	7697	11074	7694	0.0	1.4393033532622823
chr12	AC007622.2	107736695	107736947	0	253	0	1917	0	1664	0.0	0.0
chr12	ISCU	108567744	108567757	0	14	0	2718	0	2704	0.0	0.0
chr12	AC007569.1	108634423	108634629	0	207	0	2121	0	1914	0.0	0.0
chr12	UBE3B	109477765	109478109	0	345	121808	11625	121808	11280	0.0	10.798581560283688
chr12	UBE3B	109477777	109478109	0	333	121808	11625	121808	11292	0.0	10.787105915692525
chr12	UBE3B	109477765	109477776	0	12	121808	11625	121808	11613	0.0	10.488934814432103
chr12	TCHP	109900732	109901059	1836	328	26305	8836	24469	8508	5.597560975609756	2.8759990597085094
chr12	IFT81	110124444	110124861	0	418	0	6495	0	6077	0.0	0.0
chr12	ATP2A2	110346322	110347791	12047	1470	40266	7473	28219	6003	8.195238095238095	4.700816258537398
chr12	ATP2A2	110347454	110347791	0	338	40266	7473	40266	7135	0.0	5.643447792571829
chr12	FAM216A	110468526	110469018	14094	493	30811	2675	16717	2182	28.58823529411765	7.661319890009166
chr12	RAD9B	110502355	110502383	0	29	0	3723	0	3694	0.0	0.0
chr12	RAD9B	110502377	110502383	0	7	0	3723	0	3716	0.0	0.0
chr12	RAD9B	110502355	110502376	0	22	0	3723	0	3701	0.0	0.0
chr12	TCTN1	110626435	110626492	0	58	11632	5815	11632	5757	0.0	2.0204967865207575
chr12	TCTN1	110614403	110614463	0	61	11632	5815	11632	5754	0.0	2.021550225929788
chr12	MAPKAPK5	111889001	111889006	1842	6	146701	8890	144859	8884	307.0	16.30560558307069
chr12	TRAFD1	112125619	112126149	510	531	14464	3776	13954	3245	0.96045197740113	4.300154083204931
chr12	TRAFD1	112140981	112141224	0	244	14464	3776	14464	3532	0.0	4.095130237825595
chr12	RPH3A	112791985	112792012	0	28	46828	9716	46828	9688	0.0	4.833608587943848
chr12	OAS1	112911236	112911258	0	23	1659	4920	1659	4897	0.0	0.3387788441903206
chr12	OAS2	112987084	112987308	400	225	510	5140	110	4915	1.7777777777777777	0.022380467955239063
chr12	TPCN1	113221237	113221378	0	142	0	8434	0	8292	0.0	0.0
chr12	TPCN1	113221584	113221626	0	43	0	8434	0	8391	0.0	0.0
chr12	SDSL	113422478	113422887	0	410	2059	2082	2059	1672	0.0	1.2314593301435406
chr12	TBX5-AS1	114408286	114408437	0	152	0	4185	0	4033	0.0	0.0
chr12	FBXW8	116911158	116911355	459	198	1434	5207	975	5009	2.3181818181818183	0.19464963066480334
chr12	RFC5	118017816	118018053	0	238	0	3264	0	3026	0.0	0.0
chr12	RFC5	118017816	118017852	0	37	0	3264	0	3227	0.0	0.0
chr12	PXN-AS1	120206622	120206712	155	91	2091	4119	1936	4028	1.7032967032967032	0.48063555114200596
chr12	HNF1A	120978693	120978840	0	148	167401	4197	167401	4049	0.0	41.34378858977525
chr12	P2RX4	121222963	121223043	0	81	1248	2757	1248	2676	0.0	0.4663677130044843
chr12	RNF34	121409677	121409777	0	101	51	4729	51	4628	0.0	0.011019878997407088
chr12	SETD1B	121817654	121817704	0	51	334	8500	334	8449	0.0	0.03953130547993845
chr12	PSMD9	121899846	121899889	0	44	7947	8780	7947	8736	0.0	0.9096840659340659
chr12	BCL7A	122054927	122054989	0	63	11725	6571	11725	6508	0.0	1.8016287645974185
chr12	OGFOD2	122978058	122978091	0	34	43629	3734	43629	3700	0.0	11.791621621621621
chr12	OGFOD2	122974729	122975121	27392	393	43629	3734	16237	3341	69.69974554707379	4.8599221789883265
chr12	OGFOD2	122978092	122978199	0	108	43629	3734	43629	3626	0.0	12.03226696083839
chr12	OGFOD2	122978058	122978199	0	142	43629	3734	43629	3592	0.0	12.146158129175946
chr12	OGFOD2	122976964	122977166	284	203	43629	3734	43345	3531	1.3990147783251232	12.275559331634097
chr12	ARL6IP4	122980386	122980745	0	360	357	2195	357	1835	0.0	0.19455040871934604
chr12	ARL6IP4	122981267	122981299	0	33	357	2195	357	2162	0.0	0.16512488436632747
chr12	ARL6IP4	122980746	122980887	0	142	357	2195	357	2053	0.0	0.17389186556259134
chr12	ARL6IP4	122980813	122980887	0	75	357	2195	357	2120	0.0	0.16839622641509433
chr12	ARL6IP4	122980746	122980812	0	67	357	2195	357	2128	0.0	0.16776315789473684
chr12	C12ORF65	123233532	123233924	0	393	626801	6318	626801	5925	0.0	105.78919831223628
chr12	TCTN2	123671323	123671348	0	26	8861	3823	8861	3797	0.0	2.3336844877534895
chr12	ZNF664	123973304	123973352	0	49	57613	6130	57613	6081	0.0	9.474264101299129
chr12	LINC02826	126027314	126027717	0	404	51	3943	51	3539	0.0	0.014410850522746538
chr12	AC007368.1	126405049	126405310	0	262	51	5841	51	5579	0.0	0.00914142319412081
chr12	LINC02347	126442589	126442663	0	75	45	5846	45	5771	0.0	0.007797608733321781
chr12	LINC02347	126458131	126458541	0	411	45	5846	45	5435	0.0	0.00827966881324747
chr12	LINC02347	126466728	126467321	0	594	45	5846	45	5252	0.0	0.008568164508758568
chr12	LINC02824	126690589	126690698	0	110	0	1543	0	1433	0.0	0.0
chr12	LINC00943	126744889	126744919	0	31	0	8509	0	8478	0.0	0.0
chr12	LINC00943	126745333	126745881	0	549	0	8509	0	7960	0.0	0.0
chr12	LINC00943	126734970	126735249	0	280	0	8509	0	8229	0.0	0.0
chr12	LINC00943	126737157	126737186	0	30	0	8509	0	8479	0.0	0.0
chr12	LINC00507	127944788	127944799	0	12	663	6567	663	6555	0.0	0.1011441647597254
chr12	LINC00507	127948923	127948958	0	36	663	6567	663	6531	0.0	0.10151584749655489
chr12	LINC02368	128118635	128118777	0	143	0	2377	0	2234	0.0	0.0
chr12	LINC02368	128118635	128118867	0	233	0	2377	0	2144	0.0	0.0
chr12	LINC02368	128118778	128118867	0	90	0	2377	0	2287	0.0	0.0
chr12	TMEM132D-AS1	129111140	129111669	0	530	0	696	0	166	0.0	0.0
chr12	TMEM132D-AS1	129109758	129111669	0	1912	0	696	0	-1216	0.0	-0.0
chr12	TMEM132D-AS1	129111516	129111669	0	154	0	696	0	542	0.0	0.0
chr12	PIWIL1	130338147	130338171	0	25	0	5303	0	5278	0.0	0.0
chr12	PIWIL1	130338147	130338223	0	77	0	5303	0	5226	0.0	0.0
chr12	PIWIL1	130338172	130338223	0	52	0	5303	0	5251	0.0	0.0
chr12	PIWIL1	130339544	130339700	0	157	0	5303	0	5146	0.0	0.0
chr12	AC095350.1	130667673	130667682	0	10	0	3131	0	3121	0.0	0.0
chr12	AC095350.1	130668503	130668546	0	44	0	3131	0	3087	0.0	0.0
chr12	RAN	130872913	130872920	0	8	0	3779	0	3771	0.0	0.0
chr12	RAN	130872618	130872629	0	12	0	3779	0	3767	0.0	0.0
chr12	RAN	130872127	130872629	0	503	0	3779	0	3276	0.0	0.0
chr12	SFSWAP	131714194	131714240	0	47	255	8562	255	8515	0.0	0.029947152084556665
chr12	PUS1	131929286	131929380	0	95	0	5331	0	5236	0.0	0.0
chr12	PUS1	131929381	131929796	0	416	0	5331	0	4915	0.0	0.0
chr12	PUS1	131929286	131929796	0	511	0	5331	0	4820	0.0	0.0
chr12	PUS1	131929405	131929796	0	392	0	5331	0	4939	0.0	0.0
chr12	PUS1	131929381	131929404	0	24	0	5331	0	5307	0.0	0.0
chr12	EP400P1	132125397	132125408	0	12	0	11921	0	11909	0.0	0.0
chr12	FBRSL1	132572339	132572344	0	6	67492	9402	67492	9396	0.0	7.183056619838229
chr12	P2RX2	132618922	132618989	6	68	44489	1867	44483	1799	0.08823529411764706	24.726514730405782
chr12	P2RX2	132620584	132620588	62	5	44489	1867	44427	1862	12.4	23.85982814178303
chr12	P2RX2	132621346	132621364	633	19	44489	1867	43856	1848	33.31578947368421	23.73160173160173
chr12	ZNF84	133037546	133037554	0	9	816	8823	816	8814	0.0	0.09257998638529612
chr12	ZNF10	133130755	133131014	1152	260	49304	5508	48152	5248	4.430769230769231	9.175304878048781
chr12	ZNF268	133181628	133181686	0	59	534043	14004	534043	13945	0.0	38.29637863033345
chr12	AC026369.1	147757	149077	0	1321	0	5449	0	4128	0.0	0.0
chr12	SLC6A12	209772	209889	0	118	0	5131	0	5013	0.0	0.0
chr12	RAD52	949601	949604	0	4	6464	4296	6464	4292	0.0	1.5060577819198508
chr12	RAD52	929763	929817	0	55	6464	4296	6464	4241	0.0	1.5241688281065786
chr12	RAD52	929972	930049	0	78	6464	4296	6464	4218	0.0	1.532479848269322
chr12	RAD52	949402	949600	0	199	6464	4296	6464	4097	0.0	1.5777398096167927
chr12	RAD52	949402	949604	0	203	6464	4296	6464	4093	0.0	1.5792817004642072
chr12	CACNA2D4	1801042	1801047	0	6	32325	7501	32325	7495	0.0	4.312875250166778
chr12	CRACR2A	3648359	3648540	0	182	153	12489	153	12307	0.0	0.012431949297147965
chr12	CCND2-AS1	4252366	4252533	0	168	0	2768	0	2600	0.0	0.0
chr12	AKAP3	4648744	4648765	0	22	4508	3678	4508	3656	0.0	1.2330415754923414
chr12	LINC02443	5239887	5239978	0	92	204	3988	204	3896	0.0	0.052361396303901436
chr12	LINC02443	5242542	5243066	0	525	204	3988	204	3463	0.0	0.05890846087207623
chr12	LINC02443	5242531	5243066	0	536	204	3988	204	3452	0.0	0.05909617612977984
chr12	LINC02443	5242531	5242541	0	11	204	3988	204	3977	0.0	0.05129494593915011
chr12	SCNN1A	6362050	6362066	0	17	1142545	5671	1142545	5654	0.0	202.07729041386628
chr12	CD27-AS1	6450340	6450868	561	529	291043	3028	290482	2499	1.0604914933837428	116.23929571828731
chr12	CD27-AS1	6450340	6450472	0	133	291043	3028	291043	2895	0.0	100.53298791018999
chr12	CD27-AS1	6443542	6443544	0	3	291043	3028	291043	3025	0.0	96.21256198347108
chr12	CD27-AS1	6443539	6443544	0	6	291043	3028	291043	3022	0.0	96.30807412309728
chr12	CD27-AS1	6443539	6443541	0	3	291043	3028	291043	3025	0.0	96.21256198347108
chr12	MRPL51	6493057	6493249	0	193	41127	1177	41127	984	0.0	41.795731707317074
chr12	MRPL51	6493458	6493715	21101	258	41127	1177	20026	919	81.78682170542636	21.79107725788901
chr12	MRPL51	6493458	6493672	21101	215	41127	1177	20026	962	98.14418604651163	20.81704781704782
chr12	MRPL51	6493673	6493715	0	43	41127	1177	41127	1134	0.0	36.267195767195766
chr12	NOP2	6568138	6568205	244	68	66208	4122	65964	4054	3.588235294117647	16.27133695115935
chr12	CHD4	6573070	6573072	117	3	724713	11254	724596	11251	39.0	64.40280863923206
chr12	CHD4	6581037	6581042	0	6	724713	11254	724713	11248	0.0	64.43038762446658
chr12	CHD4	6583195	6583196	0	2	724713	11254	724713	11252	0.0	64.40748311411305
chr12	CHD4	6578337	6578407	0	71	724713	11254	724713	11183	0.0	64.80488241080211
chr12	CHD4	6587660	6587710	0	51	724713	11254	724713	11203	0.0	64.68919039542979
chr12	CHD4	6587660	6587705	0	46	724713	11254	724713	11208	0.0	64.66033190578159
chr12	CHD4	6587706	6587710	0	5	724713	11254	724713	11249	0.0	64.42465996977509
chr12	ING4	6652935	6652943	0	9	153	2186	153	2177	0.0	0.07028020211299954
chr12	ZNF384	6689097	6689366	0	270	80964	3521	80964	3251	0.0	24.904337127037834
chr12	ZNF384	6688702	6688835	26	134	80964	3521	80938	3387	0.19402985074626866	23.89666371420136
chr12	MLF2	6750144	6750175	0	32	5593	3274	5593	3242	0.0	1.7251696483652066
chr12	CDCA3	6850832	6851220	0	389	12554	4204	12554	3815	0.0	3.2906946264744428
chr12	PHB2	6967891	6967894	0	4	312765	2236	312765	2232	0.0	140.127688172043
chr12	PHB2	6969497	6969505	0	9	312765	2236	312765	2227	0.0	140.44229905702738
chr12	C1R	7091772	7091797	0	26	184783	4719	184783	4693	0.0	39.37417430215214
chr12	CD163L1	7433343	7433372	0	30	2875	5555	2875	5525	0.0	0.5203619909502263
chr12	CD163L1	7368057	7368085	0	29	2875	5555	2875	5526	0.0	0.5202678248280854
chr12	CLEC4C	7730780	7730795	0	16	0	1574	0	1558	0.0	0.0
chr12	SLC2A14	7872806	7872858	0	53	51	5594	51	5541	0.0	0.009204114780725501
chr12	SLC2A14	7872859	7873017	0	159	51	5594	51	5435	0.0	0.0093836246550138
chr12	C3AR1	8066220	8066276	0	57	612	3493	612	3436	0.0	0.1781140861466822
chr12	FAM86FP	8236970	8236971	0	2	5812	931	5812	929	0.0	6.256189451022605
chr12	FAM86FP	8238666	8238670	0	5	5812	931	5812	926	0.0	6.27645788336933
chr12	FAM86FP	8240641	8240644	0	4	5812	931	5812	927	0.0	6.269687162891047
chr12	CLEC4E	8539141	8539198	0	58	0	2107	0	2049	0.0	0.0
chr12	A2MP1	9233385	9233467	0	83	0	4692	0	4609	0.0	0.0
chr12	MAGOHB	10613438	10613539	0	102	0	3788	0	3686	0.0	0.0
chr12	MAGOHB	10612639	10612813	0	175	0	3788	0	3613	0.0	0.0
chr12	STYK1	10629474	10629491	0	18	33	3454	33	3436	0.0	0.00960419091967404
chr12	YBX3	10704050	10704058	0	9	306	7024	306	7015	0.0	0.043620812544547395
chr12	YBX3	10710533	10710652	0	120	306	7024	306	6904	0.0	0.044322132097334876
chr12	AC078950.1	11434991	11435124	0	134	0	1264	0	1130	0.0	0.0
chr12	GSG1	13088737	13088860	0	124	612	3041	612	2917	0.0	0.20980459376071306
chr12	ART4	14840444	14841080	408	637	408	5248	0	4611	0.640502354788069	0.0
chr12	ARHGDIB	14950916	14951004	0	89	61411	1780	61411	1691	0.0	36.3163808397398
chr12	EPS8	15881779	15882261	0	483	1272	8578	1272	8095	0.0	0.15713403335392218
chr12	EPS8	15684168	15684195	0	28	1272	8578	1272	8550	0.0	0.14877192982456142
chr12	LMO3	16600654	16600712	0	59	0	6936	0	6877	0.0	0.0
chr12	LMO3	16600600	16600653	0	54	0	6936	0	6882	0.0	0.0
chr12	LMO3	16600600	16600712	0	113	0	6936	0	6823	0.0	0.0
chr12	LMO3	16606816	16606999	0	184	0	6936	0	6752	0.0	0.0
chr12	LMO3	16607000	16607045	0	46	0	6936	0	6890	0.0	0.0
chr12	LMO3	16607290	16607303	0	14	0	6936	0	6922	0.0	0.0
chr12	LMO3	16605624	16605766	0	143	0	6936	0	6793	0.0	0.0
chr12	LMO3	16606816	16607045	0	230	0	6936	0	6706	0.0	0.0
chr12	LMO3	16601854	16602016	0	163	0	6936	0	6773	0.0	0.0
chr12	PLCZ1	18694909	18694934	0	26	51	2968	51	2942	0.0	0.01733514615907546
chr12	PLCZ1	18737931	18737933	0	3	51	2968	51	2965	0.0	0.017200674536256323
chr12	LINC02468	20125726	20125737	0	12	0	1350	0	1338	0.0	0.0
chr12	SLCO1A2	21394905	21395268	0	364	0	11312	0	10948	0.0	0.0
chr12	RECQL	21501169	21501461	0	293	0	3755	0	3462	0.0	0.0
chr12	RECQL	21501169	21501411	0	243	0	3755	0	3512	0.0	0.0
chr12	RECQL	21501412	21501461	0	50	0	3755	0	3705	0.0	0.0
chr12	RECQL	21501412	21501479	0	68	0	3755	0	3687	0.0	0.0
chr12	RECQL	21501462	21501479	0	18	0	3755	0	3737	0.0	0.0
chr12	LDHB	21657467	21657749	2183	283	15146	2807	12963	2524	7.713780918727915	5.135895404120443
chr12	SOX5	23895792	23895896	0	105	3	11064	3	10959	0.0	0.0002737476047084588
chr12	SOX5	24562332	24562336	0	5	3	11064	3	11059	0.0	0.0002712722669319107
chr12	C12ORF77	24997231	24997432	0	202	1276	2689	1276	2487	0.0	0.5130679533574588
chr12	CFAP94	25119144	25119157	0	14	645	3013	645	2999	0.0	0.21507169056352118
chr12	CFAP94	25194885	25195074	0	190	645	3013	645	2823	0.0	0.22848034006376194
chr12	CFAP94	25195057	25195074	0	18	645	3013	645	2995	0.0	0.21535893155258765
chr12	KRAS	25250750	25250762	0	13	0	6852	0	6839	0.0	0.0
chr12	LMNTD1	25553068	25553163	0	96	0	3102	0	3006	0.0	0.0
chr12	RASSF8-AS1	25952757	25955136	0	2380	12577	9597	12577	7217	0.0	1.7426908687820424
chr12	RASSF8-AS1	25957875	25958017	350	143	12577	9597	12227	9454	2.4475524475524475	1.2933149989422468
chr12	INTS13	26937657	26937794	62	138	204	3078	142	2940	0.4492753623188406	0.04829931972789116
chr12	TM7SF3	27014077	27014307	0	231	556	5517	556	5286	0.0	0.1051835035944003
chr12	AC009509.1	27710598	27710661	715	64	1160	1560	445	1496	11.171875	0.29745989304812837
chr12	PTHLH	27970024	27970068	0	45	153	3412	153	3367	0.0	0.04544104544104544
chr12	PTHLH	27969680	27970023	0	344	153	3412	153	3068	0.0	0.049869621903520206
chr12	PTHLH	27969680	27970007	0	328	153	3412	153	3084	0.0	0.04961089494163424
chr12	PTHLH	27970008	27970023	0	16	153	3412	153	3396	0.0	0.045053003533568906
chr12	PTHLH	27970008	27970068	0	61	153	3412	153	3351	0.0	0.045658012533572066
chr12	ERGIC2	29343119	29343161	0	43	4437	5842	4437	5799	0.0	0.7651319192964304
chr12	ERGIC2	29380574	29381113	0	540	4437	5842	4437	5302	0.0	0.8368540173519426
chr12	TMTC1	29518471	29518479	0	9	49702	14707	49702	14698	0.0	3.3815485100013607
chr12	IPO8	30676895	30677044	0	150	0	6688	0	6538	0.0	0.0
chr12	IPO8	30688359	30688691	0	333	0	6688	0	6355	0.0	0.0
chr12	CAPRIN2	30719078	30720809	0	1732	3570	8052	3570	6320	0.0	0.564873417721519
chr12	CAPRIN2	30741015	30741018	0	4	3570	8052	3570	8048	0.0	0.44358846918489064
chr12	CAPRIN2	30754725	30754749	0	25	3570	8052	3570	8027	0.0	0.4447489722187617
chr12	CAPRIN2	30754680	30754749	0	70	3570	8052	3570	7982	0.0	0.4472563267351541
chr12	CAPRIN2	30754680	30754687	0	8	3570	8052	3570	8044	0.0	0.44380905022376926
chr12	CAPRIN2	30754688	30754749	0	62	3570	8052	3570	7990	0.0	0.44680851063829785
chr12	AMN1	31728970	31728989	0	20	455	3144	455	3124	0.0	0.14564660691421255
chr12	KIF21A	39311414	39311415	0	2	29	10156	29	10154	0.0	0.002856017333070711
chr12	KIF21A	39321347	39322666	0	1320	29	10156	29	8836	0.0	0.003282028066998642
chr12	AC006197.2	42023809	42023833	0	25	0	2089	0	2064	0.0	0.0
chr12	ZCRB1	42324018	42324066	0	49	0	8686	0	8637	0.0	0.0
chr12	ZCRB1	42324588	42325922	0	1335	0	8686	0	7351	0.0	0.0
chr12	PRICKLE1	42589464	42589596	0	133	102	8022	102	7889	0.0	0.012929395360628723
chr12	PRICKLE1	42484053	42484272	0	220	102	8022	102	7802	0.0	0.013073570879261727
chr12	LINC02402	42645352	42646268	0	917	470	1549	470	632	0.0	0.7436708860759493
chr12	PUS7L	43754335	43755215	0	881	51	14023	51	13142	0.0	0.003880687870948105
chr12	PUS7L	43758285	43758728	0	444	51	14023	51	13579	0.0	0.0037557993961263715
chr12	PUS7L	43758285	43758699	0	415	51	14023	51	13608	0.0	0.003747795414462081
chr12	PUS7L	43758700	43758728	0	29	51	14023	51	13994	0.0	0.0036444190367300273
chr12	TWF1	43805830	43806219	0	390	0	3656	0	3266	0.0	0.0
chr12	NELL2	44774746	44774760	0	15	6	6365	6	6350	0.0	0.0009448818897637795
chr12	SCAF11	45922935	45922982	0	48	153	14007	153	13959	0.0	0.01096067053513862
chr12	SLC38A1	46268525	46268863	1428	339	1549	10037	121	9698	4.212389380530974	0.012476799340070118
chr12	AMIGO2	47079141	47079145	0	5	0	3967	0	3962	0.0	0.0
chr12	PCED1B-AS1	47209280	47210638	0	1359	0	1838	0	479	0.0	0.0
chr12	HDAC7	47796206	47796213	0	8	255	7662	255	7654	0.0	0.033315913247974914
chr12	HDAC7	47785710	47785750	0	41	255	7662	255	7621	0.0	0.033460175829943574
chr12	HDAC7	47820482	47820552	0	71	255	7662	255	7591	0.0	0.03359241206692135
chr12	VDR	47904563	47904953	0	391	153	5295	153	4904	0.0	0.031199021207177813
chr12	VDR	47878815	47878966	0	152	153	5295	153	5143	0.0	0.02974917363406572
chr12	SENP1	48105401	48105455	0	55	5564	5824	5564	5769	0.0	0.9644652452764777
chr12	ASB8	48151564	48151608	0	45	932	4093	932	4048	0.0	0.23023715415019763
chr12	ASB8	48157409	48157457	0	49	932	4093	932	4044	0.0	0.2304648862512364
chr12	ZNF641	48350045	48350117	0	73	0	8510	0	8437	0.0	0.0
chr12	KANSL2	48654940	48654951	0	12	152	3188	152	3176	0.0	0.04785894206549118
chr12	KANSL2	48660365	48660466	0	102	152	3188	152	3086	0.0	0.0492546986390149
chr12	KANSL2	48681381	48681569	0	189	152	3188	152	2999	0.0	0.050683561187062354
chr12	KANSL2	48681857	48681970	0	114	152	3188	152	3074	0.0	0.0494469746258946
chr12	DDX23	48832421	48832449	0	29	106	4903	106	4874	0.0	0.021748050882232254
chr12	RND1	48865362	48865646	0	285	0	3952	0	3667	0.0	0.0
chr12	WNT10B	48968148	48968201	0	54	102	2607	102	2553	0.0	0.0399529964747356
chr12	PRKAG1	49018523	49018730	0	208	0	3614	0	3406	0.0	0.0
chr12	KMT2D	49044190	49044198	0	9	52407	20387	52407	20378	0.0	2.5717440376877025
chr12	RHEBL1	49066955	49066966	48	12	651	1307	603	1295	4.0	0.46563706563706564
chr12	LMBR1L	49106544	49106652	0	109	3592	4888	3592	4779	0.0	0.7516216781753505
chr12	LMBR1L	49101168	49101248	0	81	3592	4888	3592	4807	0.0	0.7472436030788433
chr12	LMBR1L	49104718	49104744	0	27	3592	4888	3592	4861	0.0	0.7389426044023863
chr12	LMBR1L	49106510	49106543	0	34	3592	4888	3592	4854	0.0	0.7400082406262876
chr12	LMBR1L	49106510	49106652	0	143	3592	4888	3592	4745	0.0	0.7570073761854583
chr12	TUBA1A	49188416	49188887	204	472	1071	3106	867	2634	0.4322033898305085	0.32915717539863326
chr12	TUBA1A	49188888	49188975	0	88	1071	3106	1071	3018	0.0	0.3548707753479125
chr12	MCRS1	49567646	49567682	0	37	357	3102	357	3065	0.0	0.1164763458401305
chr12	MCRS1	49567646	49567746	0	101	357	3102	357	3001	0.0	0.11896034655114962
chr12	MCRS1	49567683	49567746	0	64	357	3102	357	3038	0.0	0.1175115207373272
chr12	FAM186B	49605201	49605380	0	180	1544	4585	1544	4405	0.0	0.35051078320090806
chr12	RACGAP1	50016630	50016633	36	4	31290	4511	31254	4507	9.0	6.9345462613712
chr12	RACGAP1	50025397	50025449	287	53	31290	4511	31003	4458	5.415094339622642	6.954463885150291
chr12	RACGAP1	50025327	50025396	0	70	31290	4511	31290	4441	0.0	7.045710425579824
chr12	RACGAP1	50025327	50025449	287	123	31290	4511	31003	4388	2.3333333333333335	7.065405651777575
chr12	RACGAP1	50025372	50025396	0	25	31290	4511	31290	4486	0.0	6.975033437360677
chr12	RACGAP1	50025327	50025371	0	45	31290	4511	31290	4466	0.0	7.006269592476489
chr12	SLC11A2	51008475	51008584	0	110	762	9310	762	9200	0.0	0.08282608695652174
chr12	SLC11A2	51026309	51026313	0	5	762	9310	762	9305	0.0	0.08189145620634068
chr12	SLC11A2	50988299	50988380	0	82	762	9310	762	9228	0.0	0.08257477243172952
chr12	SLC11A2	50991486	50991597	0	112	762	9310	762	9198	0.0	0.08284409654272668
chr12	SLC11A2	51000562	51000596	0	35	762	9310	762	9275	0.0	0.08215633423180593
chr12	SLC11A2	51005599	51005651	0	53	762	9310	762	9257	0.0	0.08231608512477044
chr12	SLC11A2	51026293	51026308	0	16	762	9310	762	9294	0.0	0.08198837959974177
chr12	SLC11A2	51026293	51026313	0	21	762	9310	762	9289	0.0	0.08203251157282808
chr12	SLC11A2	51025672	51025773	0	102	762	9310	762	9208	0.0	0.08275412684622067
chr12	CSRNP2	51083228	51083337	0	110	3929	5233	3929	5123	0.0	0.7669334374390006
chr12	TFCP2	51172300	51172599	1071	300	4208	2120	3137	1820	3.57	1.7236263736263737
chr12	GALNT6	51391286	51391353	0	68	10039	7363	10039	7295	0.0	1.3761480466072653
chr12	GALNT6	51391081	51391285	0	205	10039	7363	10039	7158	0.0	1.402486728136351
chr12	GALNT6	51383460	51383490	22	31	10039	7363	10017	7332	0.7096774193548387	1.36620294599018
chr12	GALNT6	51391081	51391353	0	273	10039	7363	10039	7090	0.0	1.4159379407616361
chr12	KRT85	52364305	52364365	0	61	610	2722	610	2661	0.0	0.22923712889891018
chr12	KRT4	52813596	52813846	0	251	0	2886	0	2635	0.0	0.0
chr12	KRT8	52949455	52949713	0	259	0	6121	0	5862	0.0	0.0
chr12	AC068888.1	53045599	53045959	0	361	0	5374	0	5013	0.0	0.0
chr12	AC068888.1	53045586	53045598	0	13	0	5374	0	5361	0.0	0.0
chr12	CSAD	53171272	53171324	0	53	51	4328	51	4275	0.0	0.011929824561403509
chr12	CSAD	53159621	53159621	0	1	51	4328	51	4327	0.0	0.011786457129651028
chr12	CSAD	53171877	53171880	0	4	51	4328	51	4324	0.0	0.01179463459759482
chr12	ITGB7	53201071	53201116	0	46	0	4220	0	4174	0.0	0.0
chr12	ITGB7	53201071	53201145	0	75	0	4220	0	4145	0.0	0.0
chr12	ITGB7	53201117	53201145	0	29	0	4220	0	4191	0.0	0.0
chr12	RARG	53232510	53232762	0	253	0	4962	0	4709	0.0	0.0
chr12	AAAS	53321342	53321469	0	128	306	4055	306	3927	0.0	0.07792207792207792
chr12	AAAS	53324561	53324690	0	130	306	4055	306	3925	0.0	0.07796178343949045
chr12	AAAS	53307844	53308050	0	207	306	4055	306	3848	0.0	0.07952182952182953
chr12	MAP3K12	53484245	53484255	0	11	546	7186	546	7175	0.0	0.07609756097560975
chr12	ATF7	53543296	53543328	0	33	2505	4276	2505	4243	0.0	0.5903841621494226
chr12	ATP5MC2	53676175	53676240	11966	66	77780	2796	65814	2730	181.3030303030303	24.107692307692307
chr12	CALCOCO1	53724584	53724643	0	60	131557	7583	131557	7523	0.0	17.48730559617174
chr12	CALCOCO1	53726199	53726242	0	44	131557	7583	131557	7539	0.0	17.45019233320069
chr12	SMUG1	54183655	54183763	0	109	0	4520	0	4411	0.0	0.0
chr12	SMUG1	54188510	54188513	0	4	0	4520	0	4516	0.0	0.0
chr12	SMUG1	54188725	54188949	0	225	0	4520	0	4295	0.0	0.0
chr12	SMUG1	54188725	54188824	0	100	0	4520	0	4420	0.0	0.0
chr12	CBX5	54259269	54259507	0	239	204	15046	204	14807	0.0	0.013777267508610792
chr12	GTSF1	54471759	54472142	0	384	357	2536	357	2152	0.0	0.16589219330855018
chr12	GLYCAM1	54608618	54608651	0	34	0	529	0	495	0.0	0.0
chr12	GLYCAM1	54609605	54609631	0	27	0	529	0	502	0.0	0.0
chr12	GLYCAM1	54610171	54610178	0	8	0	529	0	521	0.0	0.0
chr12	LACRT	54631721	54631736	1185	16	104027	887	102842	871	74.0625	118.07347876004593
chr12	CD63	55728795	55728951	0	157	1128	2254	1128	2097	0.0	0.5379113018597997
chr12	DNAJC14	55829140	55829487	0	348	51	4199	51	3851	0.0	0.013243313425084394
chr12	MMP19	55842743	55842925	0	183	0	4340	0	4157	0.0	0.0
chr12	MMP19	55838499	55838604	0	106	0	4340	0	4234	0.0	0.0
chr12	PMEL	55966292	55966610	0	319	126	3339	126	3020	0.0	0.041721854304635764
chr12	SMARCC2	56164302	56164646	2285	345	30332	7617	28047	7272	6.6231884057971016	3.8568481848184817
chr12	RNF41	56221759	56221901	26975	143	83006	6543	56031	6400	188.63636363636363	8.75484375
chr12	CS	56299827	56299924	0	98	2530	5231	2530	5133	0.0	0.49288914864601596
chr12	CS	56286496	56286593	0	98	2530	5231	2530	5133	0.0	0.49288914864601596
chr12	CNPY2	56315820	56315905	0	86	31	2842	31	2756	0.0	0.011248185776487663
chr12	PAN2	56324036	56324047	0	12	13664	6864	13664	6852	0.0	1.994162288382954
chr12	STAT2	56354989	56355274	29	286	20980	4706	20951	4420	0.10139860139860139	4.740045248868778
chr12	STAT2	56354989	56355087	6	99	20980	4706	20974	4607	0.06060606060606061	4.552637291078793
chr12	STAT2	56349344	56349424	1429	81	20980	4706	19551	4625	17.641975308641975	4.227243243243243
chr12	STAT2	56354458	56354464	0	7	20980	4706	20980	4699	0.0	4.464779740370291
chr12	STAT2	56354418	56354464	0	47	20980	4706	20980	4659	0.0	4.503112255848895
chr12	STAT2	56354418	56354457	0	40	20980	4706	20980	4666	0.0	4.496356622374625
chr12	STAT2	56355088	56355274	23	187	20980	4706	20957	4519	0.12299465240641712	4.637530427085639
chr12	TIMELESS	56423583	56423623	105	41	32003	5661	31898	5620	2.5609756097560976	5.675800711743772
chr12	BAZ2A	56601179	56601244	0	66	290466	10465	290466	10399	0.0	27.93210885662083
chr12	BAZ2A	56629972	56630123	0	152	290466	10465	290466	10313	0.0	28.165034422573452
chr12	NACA	56724961	56725261	1401	301	342650	7785	341249	7484	4.6544850498338874	45.59714056654196
chr12	NACA	56715870	56719535	281522	3666	342650	7785	61128	4119	76.79268957992362	14.840495265841223
chr12	PRIM1	56752186	56752194	0	9	47906	2848	47906	2839	0.0	16.87425149700599
chr12	MYO1A	57050717	57050721	0	5	1023447	4229	1023447	4224	0.0	242.29332386363637
chr12	NEMP1	57070673	57070818	0	146	1639097	5740	1639097	5594	0.0	293.0098319628173
chr12	STAT6	57107604	57107657	598	54	502380	7192	501782	7138	11.074074074074074	70.29728215186327
chr12	STAT6	57111109	57111127	0	19	502380	7192	502380	7173	0.0	70.03764115432874
chr12	STAT6	57110042	57110075	13	34	502380	7192	502367	7158	0.38235294117647056	70.18259290304555
chr12	STAT6	57109940	57110075	115	136	502380	7192	502265	7056	0.8455882352941176	71.18268140589569
chr12	STAT6	57109940	57110041	102	102	502380	7192	502278	7090	1.0	70.84315937940761
chr12	ARHGAP9	57475775	57475831	0	57	54163	4871	54163	4814	0.0	11.251142501038638
chr12	ARHGAP9	57477784	57477999	68	216	54163	4871	54095	4655	0.3148148148148148	11.620837808807734
chr12	ARHGAP9	57478398	57478538	561	141	54163	4871	53602	4730	3.978723404255319	11.332346723044397
chr12	DCTN2	57532732	57532782	0	51	32018	6940	32018	6889	0.0	4.64769923065757
chr12	DCTN2	57547023	57547026	0	4	32018	6940	32018	6936	0.0	4.616205305651673
chr12	DCTN2	57538482	57538517	0	36	32018	6940	32018	6904	0.0	4.637601390498262
chr12	CTDSP2	57827533	57827550	0	18	19217	5441	19217	5423	0.0	3.5436105476673427
chr12	AC083805.1	57872348	57872851	1078	504	83625	5555	82547	5051	2.138888888888889	16.342704414967333
chr12	GIHCG	57935469	57935837	16558	369	105441	3815	88883	3446	44.87262872628726	25.793093441671502
chr12	GIHCG	57935394	57935468	2873	75	105441	3815	102568	3740	38.306666666666665	27.424598930481284
chr12	GIHCG	57935297	57935468	5368	172	105441	3815	100073	3643	31.209302325581394	27.469942355201756
chr12	GIHCG	57935297	57935393	2495	97	105441	3815	102946	3718	25.721649484536083	27.688542227003765
chr12	TAFA2	62260009	62260013	0	5	1155	8739	1155	8734	0.0	0.13224181360201512
chr12	C12ORF66	64222002	64222160	0	159	8789	5906	8789	5747	0.0	1.5293196450321906
chr12	WIF1	65056030	65056071	0	42	2216	2117	2216	2075	0.0	1.0679518072289156
chr12	TMBIM4	66168914	66169288	0	375	306	2161	306	1786	0.0	0.1713325867861142
chr12	AC090061.1	68685858	68685861	0	4	102	2849	102	2845	0.0	0.035852372583479786
chr12	CPM	68933141	68933158	0	18	0	2730	0	2712	0.0	0.0
chr12	CPM	68933141	68933168	0	28	0	2730	0	2702	0.0	0.0
chr12	CPM	68933159	68933168	0	10	0	2730	0	2720	0.0	0.0
chr12	CPM	68933129	68933140	0	12	0	2730	0	2718	0.0	0.0
chr12	CPM	68933129	68933158	0	30	0	2730	0	2700	0.0	0.0
chr12	CPM	68933129	68933168	0	40	0	2730	0	2690	0.0	0.0
chr12	BEST3	69693673	69693727	0	55	112055	6878	112055	6823	0.0	16.423127656456103
chr12	PRANCR	70243065	70243310	0	246	760	5036	760	4790	0.0	0.15866388308977036
chr12	PRANCR	70242796	70242822	0	27	760	5036	760	5009	0.0	0.15172689159512875
chr12	PTPRR	70754415	70754583	0	169	2256	5055	2256	4886	0.0	0.46172738436348754
chr12	TRHDE-AS1	72261197	72264480	1785	3284	2847	8148	1062	4864	0.5435444579780755	0.21833881578947367
chr12	LINC02882	74402468	74402499	0	32	0	8438	0	8406	0.0	0.0
chr12	CAPS2	75316283	75316310	0	28	223	6680	223	6652	0.0	0.03352375225496092
chr12	CAPS2	75329831	75329865	0	35	223	6680	223	6645	0.0	0.033559066967644845
chr12	NAP1L1	76048392	76048419	0	28	0	4739	0	4711	0.0	0.0
chr12	NAP1L1	76059776	76059796	0	21	0	4739	0	4718	0.0	0.0
chr12	CSRP2	76878937	76878961	0	25	590	3237	590	3212	0.0	0.18368617683686178
chr12	PPP1R12A	79779320	79779337	0	18	4388	10162	4388	10144	0.0	0.43257097791798105
chr12	PPFIA2	81369289	81369292	0	4	0	7396	0	7392	0.0	0.0
chr12	PPFIA2	81347532	81347662	0	131	0	7396	0	7265	0.0	0.0
chr12	PPFIA2	81375732	81375794	0	63	0	7396	0	7333	0.0	0.0
chr12	PPFIA2	81759213	81759278	0	66	0	7396	0	7330	0.0	0.0
chr12	MGAT4C	86028087	86028102	0	16	0	3695	0	3679	0.0	0.0
chr12	CEP290	88120113	88120116	0	4	527	21189	527	21185	0.0	0.024876091574227047
chr12	CEP290	88136642	88136645	0	4	527	21189	527	21185	0.0	0.024876091574227047
chr12	KITLG	88580088	88580262	0	175	3609	6217	3609	6042	0.0	0.5973187686196624
chr12	POC1B	89497038	89497169	0	132	0	8786	0	8654	0.0	0.0
chr12	ATP2B1	89598589	89598655	0	67	51	9425	51	9358	0.0	0.005449882453515708
chr12	LINC01619	91987555	91987642	0	88	0	4212	0	4124	0.0	0.0
chr12	LINC01619	91987532	91987554	0	23	0	4212	0	4189	0.0	0.0
chr12	LINC01619	91990283	91990286	0	4	0	4212	0	4208	0.0	0.0
chr12	UBE2N	93411052	93411124	0	73	47	4147	47	4074	0.0	0.011536573392243496
chr12	NR2C1	95058309	95058346	0	38	0	5319	0	5281	0.0	0.0
chr12	AC084879.1	95380853	95380856	0	4	20860	3186	20860	3182	0.0	6.5556253928346955
chr12	AC084879.1	95436558	95436561	86	4	20860	3186	20774	3182	21.5	6.528598365807668
chr12	USP44	95548525	95548769	0	245	204	5382	204	5137	0.0	0.03971189410161573
chr12	CCDC38	95872254	95872360	59	107	60794	4874	60735	4767	0.5514018691588785	12.740717432347388
chr12	CCDC38	95919438	95919552	0	115	60794	4874	60794	4759	0.0	12.77453246480353
chr12	HAL	95980797	95980813	0	17	0	5065	0	5048	0.0	0.0
chr12	AC008149.2	96234036	96234348	153	313	2987	4709	2834	4396	0.48881789137380194	0.6446769790718835
chr12	CDK17	96399333	96399343	66	11	53721	6488	53655	6477	6.0	8.283927744326077
chr12	CDK17	96399092	96399343	787	252	53721	6488	52934	6236	3.123015873015873	8.48845413726748
chr12	CDK17	96399092	96399332	721	241	53721	6488	53000	6247	2.991701244813278	8.484072354730271
chr12	ANKS1B	99244341	99244352	0	12	1347	9547	1347	9535	0.0	0.14126900891452543
chr12	UHRF1BP1L	100092902	100092907	0	6	51	6666	51	6660	0.0	0.0076576576576576575
chr12	GOLGA2P5	100159557	100159770	0	214	436	6935	436	6721	0.0	0.0648712989138521
chr12	GOLGA2P5	100158678	100158796	0	119	436	6935	436	6816	0.0	0.06396713615023474
chr12	GOLGA2P5	100168451	100168458	0	8	436	6935	436	6927	0.0	0.06294211058178144
chr12	ARL1	101407277	101407376	0	100	0	4578	0	4478	0.0	0.0
chr12	ARL1	101407010	101407376	0	367	0	4578	0	4211	0.0	0.0
chr12	ARL1	101407010	101407276	0	267	0	4578	0	4311	0.0	0.0
chr12	SYCP3	101739350	101739360	98	11	918	3161	820	3150	8.909090909090908	0.26031746031746034
chr12	AC068643.1	103178331	103178427	0	97	0	2941	0	2844	0.0	0.0
chr12	AC068643.1	103178331	103178577	0	247	0	2941	0	2694	0.0	0.0
chr12	C12ORF42	103495766	103495900	0	135	0	4757	0	4622	0.0	0.0
chr12	C12ORF73	103957068	103957138	0	71	0	2983	0	2912	0.0	0.0
chr12	SLC41A2	104958087	104958188	0	102	5202	5166	5202	5064	0.0	1.0272511848341233
chr12	MTERF2	106985114	106986967	0	1854	0	1176	0	-678	0.0	-0.0
chr12	PRDM4	107751414	107751645	0	232	0	4785	0	4553	0.0	0.0
chr12	PRDM4	107760956	107761129	0	174	0	4785	0	4611	0.0	0.0
chr12	SART3	108538933	108538943	0	11	0	7034	0	7023	0.0	0.0
chr12	SART3	108549087	108549135	0	49	0	7034	0	6985	0.0	0.0
chr12	TMEM119	108594163	108594335	0	173	0	3188	0	3015	0.0	0.0
chr12	CORO1C	108730561	108730621	0	61	8	4794	8	4733	0.0	0.001690259877456159
chr12	ALKBH2	109093246	109093348	2640	103	3583	1630	943	1527	25.631067961165048	0.6175507531106745
chr12	TRPV4	109793484	109793525	0	42	0	3893	0	3851	0.0	0.0
chr12	GLTP	109857525	109857581	0	57	171	2752	171	2695	0.0	0.06345083487940631
chr12	GLTP	109857854	109858138	0	285	171	2752	171	2467	0.0	0.06931495743818403
chr12	ARPC3	110436556	110436663	0	108	1801	2641	1801	2533	0.0	0.711014607185156
chr12	GPN3	110468155	110468194	0	40	39280	2573	39280	2533	0.0	15.507303592577971
chr12	GPN3	110468125	110468154	0	30	39280	2573	39280	2543	0.0	15.4463232402674
chr12	GPN3	110468125	110468194	0	70	39280	2573	39280	2503	0.0	15.693168198162205
chr12	VPS29	110499456	110499533	0	78	1476	3202	1476	3124	0.0	0.47247119078104993
chr12	HVCN1	110661163	110661278	0	116	126	3009	126	2893	0.0	0.04355340477013481
chr12	HVCN1	110687974	110688623	0	650	126	3009	126	2359	0.0	0.05341246290801187
chr12	PHETA1	111363644	111363686	0	43	0	813	0	770	0.0	0.0
chr12	ATXN2	111485264	111485269	0	6	0	13978	0	13972	0.0	0.0
chr12	ATXN2	111598783	111599573	0	791	0	13978	0	13187	0.0	0.0
chr12	ATXN2	111519831	111519877	0	47	0	13978	0	13931	0.0	0.0
chr12	BRAP	111685587	111685709	0	123	0	4668	0	4545	0.0	0.0
chr12	MAPKAPK5-AS1	111841326	111841682	8	357	94	2732	86	2375	0.022408963585434174	0.03621052631578947
chr12	MAPKAPK5-AS1	111840133	111840331	0	199	94	2732	94	2533	0.0	0.037110146071851556
chr12	TMEM116	111936691	111936740	0	50	8518	5425	8518	5375	0.0	1.5847441860465117
chr12	TMEM116	112005943	112005947	0	5	8518	5425	8518	5420	0.0	1.5715867158671586
chr12	TMEM116	112005601	112005947	0	347	8518	5425	8518	5078	0.0	1.677432059866089
chr12	TMEM116	112005601	112005942	0	342	8518	5425	8518	5083	0.0	1.675782018493016
chr12	HECTD4	112264083	112264088	0	6	104460	19857	104460	19851	0.0	5.262203415445065
chr12	RPL6	112409410	112409585	0	176	51	3049	51	2873	0.0	0.01775147928994083
chr12	RPL6	112409410	112409491	0	82	51	3049	51	2967	0.0	0.017189079878665317
chr12	RPL6	112409040	112409409	102	370	51	3049	-51	2679	0.2756756756756757	-0.019036954087346025
chr12	RPL6	112409040	112409201	102	162	51	3049	-51	2887	0.6296296296296297	-0.01766539660547281
chr12	RPL6	112409040	112409491	102	452	51	3049	-51	2597	0.22566371681415928	-0.019638043896804003
chr12	RASAL1	113136060	113136074	0	15	352	4715	352	4700	0.0	0.0748936170212766
chr12	DDX54	113180928	113180979	0	52	102	5086	102	5034	0.0	0.02026221692491061
chr12	SLC8B1	113332722	113332747	0	26	102	6033	102	6007	0.0	0.016980189778591642
chr12	TESC	117046771	117046775	0	5	0	1937	0	1932	0.0	0.0
chr12	FBXO21	117174650	117174653	0	4	92082	6901	92082	6897	0.0	13.351022183558069
chr12	WSB2	118036337	118036383	0	47	51	3937	51	3890	0.0	0.013110539845758355
chr12	VSIG10	118082126	118082150	0	25	102	7227	102	7202	0.0	0.01416273257428492
chr12	TAOK3	118359505	118359519	0	15	1650	9442	1650	9427	0.0	0.1750291715285881
chr12	TAOK3	118190182	118190242	0	61	1650	9442	1650	9381	0.0	0.17588743204349216
chr12	LINC02439	118833386	118833452	0	67	1822	611	1822	544	0.0	3.349264705882353
chr12	CIT	119784188	119784958	0	771	408	25017	408	24246	0.0	0.016827517941103688
chr12	CIT	119804096	119804161	0	66	408	25017	408	24951	0.0	0.01635205001803535
chr12	CIT	119775774	119775784	0	11	408	25017	408	25006	0.0	0.016316084139806446
chr12	RPLP0	120198853	120198893	322	41	2390	2408	2068	2367	7.853658536585366	0.8736797634136038
chr12	RPLP0	120200718	120200728	0	11	2390	2408	2390	2397	0.0	0.9970796829370046
chr12	PXN	120226361	120226837	0	477	16445	7481	16445	7004	0.0	2.347944031981725
chr12	PXN	120226352	120226360	0	9	16445	7481	16445	7472	0.0	2.20088329764454
chr12	SRSF9	120465626	120465754	0	129	0	3090	0	2961	0.0	0.0
chr12	C12ORF43	121011010	121011102	186	93	316840	6147	316654	6054	2.0	52.30492236537826
chr12	C12ORF43	121016258	121016328	270	71	316840	6147	316570	6076	3.8028169014084505	52.1017116524029
chr12	CAMKK2	121274055	121274062	0	8	7032	7180	7032	7172	0.0	0.9804796430563302
chr12	CAMKK2	121297434	121297537	816	104	7032	7180	6216	7076	7.846153846153846	0.8784624081401922
chr12	ANAPC5	121331226	121331345	0	120	2778	10333	2778	10213	0.0	0.27200626652305887
chr12	KDM2B	121430276	121430340	0	65	56377	13372	56377	13307	0.0	4.236642368678139
chr12	KDM2B	121536010	121536018	0	9	56377	13372	56377	13363	0.0	4.218887974257277
chr12	LINC01089	121801571	121801705	0	135	95	3882	95	3747	0.0	0.025353616226314386
chr12	LINC01089	121802878	121803205	0	328	95	3882	95	3554	0.0	0.026730444569499155
chr12	LINC01089	121802630	121802877	0	248	95	3882	95	3634	0.0	0.026141992294991746
chr12	DIABLO	122224511	122224643	0	133	126542	5932	126542	5799	0.0	21.82134850836351
chr12	DIABLO	122225825	122225963	51	139	126542	5932	126491	5793	0.3669064748201439	21.83514586569998
chr12	DIABLO	122209696	122209771	21	76	126542	5932	126521	5856	0.27631578947368424	21.605362021857925
chr12	DIABLO	122225786	122225963	51	178	126542	5932	126491	5754	0.28651685393258425	21.98314216197428
chr12	DIABLO	122225786	122225824	0	39	126542	5932	126542	5893	0.0	21.473273375190903
chr12	VPS33A	122250958	122250981	0	24	36485	5708	36485	5684	0.0	6.418895144264602
chr12	CLIP1	122340752	122340979	23191	228	88903	17314	65712	17086	101.71491228070175	3.8459557532482735
chr12	CLIP1	122360815	122360957	0	143	88903	17314	88903	17171	0.0	5.177508590064644
chr12	ZCCHC8	122498826	122499971	97052	1146	58904	7908	-38148	6762	84.68760907504362	-5.641526175687666
chr12	RSRC2	122517226	122517229	0	4	563	7431	563	7427	0.0	0.07580449710515685
chr12	MPHOSPH9	123202623	123202689	0	67	16409	8436	16409	8369	0.0	1.960688254271717
chr12	MPHOSPH9	123218375	123218397	0	23	16409	8436	16409	8413	0.0	1.95043385237133
chr12	MPHOSPH9	123227462	123227544	0	83	16409	8436	16409	8353	0.0	1.9644439123668143
chr12	NCOR2	124327408	124327545	0	138	9321	12472	9321	12334	0.0	0.7557159072482569
chr12	NCOR2	124326179	124326189	0	11	9321	12472	9321	12461	0.0	0.7480138030655645
chr12	SCARB1	124786356	124786439	68	84	26043	4213	25975	4129	0.8095238095238095	6.290869459917656
chr12	SCARB1	124786106	124786355	719	250	26043	4213	25324	3963	2.876	6.390108503658844
chr12	UBC	124914004	124914039	0	36	37643	2504	37643	2468	0.0	15.252431118314425
chr12	UBC	124914004	124914092	0	89	37643	2504	37643	2415	0.0	15.587163561076604
chr12	UBC	124914040	124914092	0	53	37643	2504	37643	2451	0.0	15.358221134230925
chr12	UBC	124913968	124914003	0	36	37643	2504	37643	2468	0.0	15.252431118314425
chr12	UBC	124913968	124914039	0	72	37643	2504	37643	2432	0.0	15.478207236842104
chr12	UBC	124914297	124914368	0	72	37643	2504	37643	2432	0.0	15.478207236842104
chr12	UBC	124914369	124914585	0	217	37643	2504	37643	2287	0.0	16.45955400087451
chr12	UBC	124914093	124914296	9265	204	37643	2504	28378	2300	45.416666666666664	12.338260869565218
chr12	LINC00939	125983203	125983235	0	33	102	6810	102	6777	0.0	0.015050907481186366
chr12	LINC00944	126735144	126736664	51	1521	51	4790	0	3269	0.03353057199211045	0.0
chr12	LINC00944	126732310	126732341	0	32	51	4790	51	4758	0.0	0.010718789407313998
chr12	LINC00944	126735144	126736782	51	1639	51	4790	0	3151	0.03111653447223917	0.0
chr12	LINC00944	126736665	126736782	0	118	51	4790	51	4672	0.0	0.01091609589041096
chr12	LINC02372	126873325	126873332	0	8	0	1883	0	1875	0.0	0.0
chr12	LINC02372	126873325	126873388	0	64	0	1883	0	1819	0.0	0.0
chr12	LINC02372	126874285	126874455	0	171	0	1883	0	1712	0.0	0.0
chr12	LINC02375	127339909	127339967	0	59	0	954	0	895	0.0	0.0
chr12	LINC02375	127339909	127339912	0	4	0	954	0	950	0.0	0.0
chr12	LINC02375	127339913	127339967	0	55	0	954	0	899	0.0	0.0
chr12	LINC02411	127636350	127636400	0	51	0	2406	0	2355	0.0	0.0
chr12	LINC02411	127636202	127636400	0	199	0	2406	0	2207	0.0	0.0
chr12	LINC02411	127636202	127636349	0	148	0	2406	0	2258	0.0	0.0
chr12	LINC02411	127632373	127632573	0	201	0	2406	0	2205	0.0	0.0
chr12	LINC02369	128112704	128112709	0	6	0	2394	0	2388	0.0	0.0
chr12	AC061709.2	128191177	128191310	0	134	0	1439	0	1305	0.0	0.0
chr12	RIMBP2	130469019	130469147	0	129	102	9642	102	9513	0.0	0.010722169662567014
chr12	AC073578.1	131492347	131492755	0	409	0	1513	0	1104	0.0	0.0
chr12	AC073578.1	131529690	131529773	0	84	0	1513	0	1429	0.0	0.0
chr12	GALNT9	132205362	132205559	0	198	42387	4904	42387	4706	0.0	9.007012324691882
chr12	LRCOL1	132604700	132604704	60	5	22536	1775	22476	1770	12.0	12.698305084745762
chr12	POLE	132641017	132641645	2221	629	211617	15952	209396	15323	3.5310015898251192	13.665470208183777
chr12	POLE	132676085	132676092	0	8	211617	15952	211617	15944	0.0	13.272516307074762
chr12	GOLGA3	132828326	132828801	0	476	0	10572	0	10096	0.0	0.0
chr12	GOLGA3	132775065	132775139	0	75	0	10572	0	10497	0.0	0.0
chr12	CHFR	132848084	132848180	0	97	41	16627	41	16530	0.0	0.002480338777979431
chr13	ANKRD26P3	19296634	19296634	0	1	0	4491	0	4490	0.0	0.0
chr13	ANKRD26P3	19314710	19314712	0	3	0	4491	0	4488	0.0	0.0
chr13	GJB6	20230697	20230740	3	44	27609	3279	27606	3235	0.06818181818181818	8.53353941267388
chr13	AL590096.1	20566460	20566674	0	215	372	791	372	576	0.0	0.6458333333333334
chr13	SKA3	21176347	21176373	0	27	1798	2980	1798	2953	0.0	0.6088723332204538
chr13	LINC00539	21312145	21312277	0	133	52378	4251	52378	4118	0.0	12.719281204468189
chr13	LINC00539	21312145	21312149	0	5	52378	4251	52378	4246	0.0	12.33584550164861
chr13	LINC00539	21312150	21312277	0	128	52378	4251	52378	4123	0.0	12.703856415231627
chr13	CENPJ	24886233	24886233	0	1	459	5689	459	5688	0.0	0.08069620253164557
chr13	RNF6	26221781	26221833	0	53	153	4449	153	4396	0.0	0.034804367606915375
chr13	KATNAL1	30306712	30306938	0	227	51	8051	51	7824	0.0	0.00651840490797546
chr13	KATNAL1	30306712	30306762	0	51	51	8051	51	8000	0.0	0.006375
chr13	TEX26-AS1	30932108	30932274	0	167	9286	6332	9286	6165	0.0	1.5062449310624493
chr13	N4BP2L1	32402907	32403148	0	242	0	5266	0	5024	0.0	0.0
chr13	N4BP2L1	32416498	32416549	0	52	0	5266	0	5214	0.0	0.0
chr13	N4BP2L2	32538617	32538681	0	65	1521	10496	1521	10431	0.0	0.1458153580672994
chr13	N4BP2L2	32527407	32527456	0	50	1521	10496	1521	10446	0.0	0.1456059735784032
chr13	N4BP2L2	32535768	32537004	816	1237	1521	10496	705	9259	0.6596604688763137	0.07614213197969544
chr13	N4BP2L2	32535768	32536931	816	1164	1521	10496	705	9332	0.7010309278350515	0.07554650664380626
chr13	N4BP2L2	32538617	32538776	0	160	1521	10496	1521	10336	0.0	0.14715557275541796
chr13	N4BP2L2	32538617	32538748	0	132	1521	10496	1521	10364	0.0	0.14675800849093015
chr13	N4BP2L2	32536932	32537004	0	73	1521	10496	1521	10423	0.0	0.14592727621606064
chr13	N4BP2L2	32538749	32538776	0	28	1521	10496	1521	10468	0.0	0.14529996178830723
chr13	N4BP2L2	32538682	32538776	0	95	1521	10496	1521	10401	0.0	0.14623593885203345
chr13	N4BP2L2	32538682	32538748	0	67	1521	10496	1521	10429	0.0	0.1458433215073353
chr13	SUPT20H	37059479	37059557	0	79	53297	10212	53297	10133	0.0	5.259745386361393
chr13	SUPT20H	37059194	37059360	0	167	53297	10212	53297	10045	0.0	5.305823792931807
chr13	TRPC4	37651249	37651263	0	15	0	3351	0	3336	0.0	0.0
chr13	EPSTI1	42926335	42926389	0	55	5529	4643	5529	4588	0.0	1.2051002615518744
chr13	TPT1	45341037	45341040	0	4	153	6154	153	6150	0.0	0.024878048780487806
chr13	TPT1	45340711	45341040	0	330	153	6154	153	5824	0.0	0.026270604395604396
chr13	ZC3H13	46052403	46052696	0	294	342155	10286	342155	9992	0.0	34.24289431545236
chr13	LINC01198	46460944	46460988	0	45	51	5378	51	5333	0.0	0.009563097693605851
chr13	LINC01198	46464674	46464739	0	66	51	5378	51	5312	0.0	0.009600903614457831
chr13	LINC01198	46464674	46464734	0	61	51	5378	51	5317	0.0	0.009591875117547489
chr13	LINC01198	46465842	46465907	0	66	51	5378	51	5312	0.0	0.009600903614457831
chr13	LINC01198	46465842	46465902	0	61	51	5378	51	5317	0.0	0.009591875117547489
chr13	LINC01198	46465903	46465907	0	5	51	5378	51	5373	0.0	0.009491903964265773
chr13	LINC01198	46467733	46467737	0	5	51	5378	51	5373	0.0	0.009491903964265773
chr13	LINC01198	46467672	46467737	0	66	51	5378	51	5312	0.0	0.009600903614457831
chr13	LINC01198	46467672	46467732	0	61	51	5378	51	5317	0.0	0.009591875117547489
chr13	LINC01198	46464735	46464739	0	5	51	5378	51	5373	0.0	0.009491903964265773
chr13	LINC01198	46469654	46469833	0	180	51	5378	51	5198	0.0	0.009811465948441709
chr13	LINC01198	46486280	46486321	0	42	51	5378	51	5336	0.0	0.009557721139430285
chr13	LINC01198	46467660	46467737	0	78	51	5378	51	5300	0.0	0.009622641509433962
chr13	LINC01198	46467660	46467671	0	12	51	5378	51	5366	0.0	0.009504286246738726
chr13	LINC01198	46467660	46467732	0	73	51	5378	51	5305	0.0	0.009613572101790764
chr13	MED4	48094953	48095058	0	106	0	2599	0	2493	0.0	0.0
chr13	RB1-DT	48303290	48303484	0	195	99	1836	99	1641	0.0	0.0603290676416819
chr13	CAB39L	49401132	49401393	0	262	0	4839	0	4577	0.0	0.0
chr13	DLEU2	50044639	50044649	0	11	34690	11660	34690	11649	0.0	2.9779380204309382
chr13	INTS6	51451421	51451495	0	75	255	25534	255	25459	0.0	0.010016104324600338
chr13	ATP7B	51949661	51949714	144	54	78021	13652	77877	13598	2.6666666666666665	5.727092219444036
chr13	NEK3	52143914	52143914	0	1	3767	4289	3767	4288	0.0	0.8784981343283582
chr13	TPTE2P2	52235152	52235218	0	67	90789	4148	90789	4081	0.0	22.246753246753247
chr13	TPTE2P2	52323796	52323828	0	33	90789	4148	90789	4115	0.0	22.062940461725393
chr13	PCDH8	52845805	52846095	51	291	510	5153	459	4862	0.17525773195876287	0.0944055944055944
chr13	COMMD6	75537381	75537497	0	117	0	2499	0	2382	0.0	0.0
chr13	FBXL3	77021512	77021655	0	144	204	7083	204	6939	0.0	0.029399048854301772
chr13	MYCBP2	77076750	77076758	0	9	326	15782	326	15773	0.0	0.020668230520509732
chr13	MYCBP2	77095357	77095529	0	173	326	15782	326	15609	0.0	0.020885386635915177
chr13	EDNRB	77919006	77919064	0	59	1429	4631	1429	4572	0.0	0.3125546806649169
chr13	LINC01069	77997723	77997814	0	92	0	3687	0	3595	0.0	0.0
chr13	AL158064.1	80054669	80054730	0	62	50476	10299	50476	10237	0.0	4.930741428152779
chr13	LINC00559	90106582	90107852	0	1271	0	2089	0	818	0.0	0.0
chr13	LINC00559	90118772	90119424	0	653	0	2089	0	1436	0.0	0.0
chr13	ABCC4	95266098	95266110	0	13	44404	8667	44404	8654	0.0	5.1310376704414145
chr13	OXGR1	96992421	96992506	0	86	0	1637	0	1551	0.0	0.0
chr13	UBAC2-AS1	99200365	99200636	0	272	255	2596	255	2324	0.0	0.10972461273666093
chr13	UBAC2-AS1	99200329	99200364	0	36	255	2596	255	2560	0.0	0.099609375
chr13	UBAC2-AS1	99200329	99200636	0	308	255	2596	255	2288	0.0	0.11145104895104894
chr13	LINC01232	99496697	99496707	0	11	5865	6199	5865	6188	0.0	0.9478021978021978
chr13	CLYBL-AS1	99727194	99727228	16	35	510	712	494	677	0.45714285714285713	0.7296898079763663
chr13	PCCA-AS1	100480979	100481118	0	140	0	862	0	722	0.0	0.0
chr13	GGACT	100533286	100533561	0	276	2458	3482	2458	3206	0.0	0.7666874610106051
chr13	TMTC4	100670282	100670358	0	77	1091713	6368	1091713	6291	0.0	173.53568590049278
chr13	NALCN	101345265	101345299	0	35	189771	19504	189771	19469	0.0	9.747341928193539
chr13	NALCN	101416312	101416434	0	123	189771	19504	189771	19381	0.0	9.79160002063877
chr13	AL390755.1	110045196	110045431	0	236	306	4212	306	3976	0.0	0.07696177062374246
chr13	AL390755.1	110045196	110045783	0	588	306	4212	306	3624	0.0	0.08443708609271523
chr13	AL390755.1	110045432	110045783	0	352	306	4212	306	3860	0.0	0.07927461139896373
chr13	AL390755.1	110045779	110045783	0	5	306	4212	306	4207	0.0	0.07273591632992632
chr13	COL4A1	110152333	110152338	0	6	77	12365	77	12359	0.0	0.0062302775305445425
chr13	CARS2	110713136	110713301	0	166	44	8121	44	7955	0.0	0.005531112507856694
chr13	ANKRD10	110883552	110883696	0	145	0	4241	0	4096	0.0	0.0
chr13	PCID2	113208023	113208597	60980	575	6425	4056	-54555	3481	106.05217391304348	-15.672220626256824
chr13	GRTP1	113364019	113364070	0	52	1506	2926	1506	2874	0.0	0.524008350730689
chr13	LINC00454	113880698	113881346	23630	649	74013	2845	50383	2196	36.409861325115564	22.943078324225866
chr13	LINC00408	18907803	18907817	0	15	0	2363	0	2348	0.0	0.0
chr13	LINC00408	18906659	18906692	0	34	0	2363	0	2329	0.0	0.0
chr13	LINC00408	18905573	18905576	0	4	0	2363	0	2359	0.0	0.0
chr13	LINC00350	19587157	19587389	0	233	0	1646	0	1413	0.0	0.0
chr13	ZMYM2	19958772	19958841	0	70	734	12671	734	12601	0.0	0.05824934529005635
chr13	LINC00327	23467164	23467749	0	586	1020	5213	1020	4627	0.0	0.22044521288091637
chr13	RPL21	27255350	27255354	104	5	16787	1957	16683	1952	20.8	8.546618852459016
chr13	RPL21	27251586	27251656	698	71	16787	1957	16089	1886	9.830985915492958	8.530752916224815
chr13	RPL21	27251586	27251850	3210	265	16787	1957	13577	1692	12.11320754716981	8.024231678486998
chr13	RPL21	27251657	27251850	2512	194	16787	1957	14275	1763	12.948453608247423	8.09699376063528
chr13	RPL21	27251700	27251850	1962	151	16787	1957	14825	1806	12.993377483443709	8.20874861572536
chr13	RPL21	27251657	27251699	550	43	16787	1957	16237	1914	12.790697674418604	8.483281086729363
chr13	GTF3A	27424854	27424938	0	85	0	2790	0	2705	0.0	0.0
chr13	GTF3A	27424939	27425165	0	227	0	2790	0	2563	0.0	0.0
chr13	GTF3A	27424854	27425165	0	312	0	2790	0	2478	0.0	0.0
chr13	POLR1D	27621105	27621140	40	36	16728	9742	16688	9706	1.1111111111111112	1.7193488563774983
chr13	POLR1D	27621141	27621437	215	297	16728	9742	16513	9445	0.7239057239057239	1.7483324510322922
chr13	POLR1D	27621264	27621437	0	174	16728	9742	16728	9568	0.0	1.7483277591973243
chr13	POLR1D	27648450	27648453	92	4	16728	9742	16636	9738	23.0	1.7083590059560485
chr13	POLR1D	27650242	27651352	408	1111	16728	9742	16320	8631	0.36723672367236726	1.8908585331942995
chr13	BRCA2	32316524	32316527	0	4	1478	12439	1478	12435	0.0	0.11885806192199437
chr13	PDS5B	32764589	32764594	0	6	0	13222	0	13216	0.0	0.0
chr13	STARD13-AS	33279571	33279656	0	86	10100	3839	10100	3753	0.0	2.6911803890221155
chr13	STARD13-AS	33271562	33271582	0	21	10100	3839	10100	3818	0.0	2.645364064955474
chr13	STARD13-AS	33277576	33277696	0	121	10100	3839	10100	3718	0.0	2.7165142549757935
chr13	STARD13-AS	33272794	33272894	0	101	10100	3839	10100	3738	0.0	2.701979668271803
chr13	STARD13-AS	33273977	33274058	1275	82	10100	3839	8825	3757	15.548780487804878	2.348948629225446
chr13	STARD13-AS	33280480	33280583	153	104	10100	3839	9947	3735	1.4711538461538463	2.663186077643909
chr13	LINC00445	35697616	35697851	102	236	102	1560	0	1324	0.4322033898305085	0.0
chr13	LINC00445	35697637	35697851	102	215	102	1560	0	1345	0.4744186046511628	0.0
chr13	LINC00445	35697616	35697636	0	21	102	1560	102	1539	0.0	0.06627680311890838
chr13	LINC02334	37934897	37935037	0	141	51	6006	51	5865	0.0	0.008695652173913044
chr13	LINC02334	38029692	38029696	0	5	51	6006	51	6001	0.0	0.0084985835694051
chr13	UFM1	38350056	38350227	0	172	0	4388	0	4216	0.0	0.0
chr13	NHLRC3	39038466	39038723	0	258	102	6410	102	6152	0.0	0.01657997399219766
chr13	SLC25A15	40799173	40799315	0	143	0	4194	0	4051	0.0	0.0
chr13	NAA16	41362160	41362873	143	714	27391	5826	27248	5112	0.20028011204481794	5.330203442879499
chr13	DGKH	42198594	42198595	0	2	5845	19782	5845	19780	0.0	0.2955005055611729
chr13	TPT1-AS1	45383170	45383235	0	66	51	8229	51	8163	0.0	0.006247703050349137
chr13	TPT1-AS1	45390859	45390902	0	44	51	8229	51	8185	0.0	0.006230910201588271
chr13	TPT1-AS1	45341615	45341630	0	16	51	8229	51	8213	0.0	0.00620966760014611
chr13	TPT1-AS1	45379336	45380001	0	666	51	8229	51	7563	0.0	0.006743355811186037
chr13	TPT1-AS1	45383839	45383843	0	5	51	8229	51	8224	0.0	0.00620136186770428
chr13	TPT1-AS1	45389821	45390902	0	1082	51	8229	51	7147	0.0	0.007135861200503708
chr13	CPB2-AS1	46098668	46098781	0	114	39674	17234	39674	17120	0.0	2.3174065420560748
chr13	CPB2-AS1	46098782	46098810	0	29	39674	17234	39674	17205	0.0	2.3059575704736996
chr13	CPB2-AS1	46098668	46098810	0	143	39674	17234	39674	17091	0.0	2.321338716283424
chr13	CYSLTR2	48691279	48691301	0	23	16574	5116	16574	5093	0.0	3.2542705674455132
chr13	FNDC3A	49191110	49191120	0	11	393	7727	393	7716	0.0	0.05093312597200622
chr13	PHF11	49496449	49496600	0	152	0	4736	0	4584	0.0	0.0
chr13	PHF11	49496483	49496600	0	118	0	4736	0	4618	0.0	0.0
chr13	PHF11	49496449	49496482	0	34	0	4736	0	4702	0.0	0.0
chr13	TRIM13	49997132	49997216	0	85	16354	8102	16354	8017	0.0	2.039915180241986
chr13	DLEU1	50082558	50083194	714	637	233640	22973	232926	22336	1.120879120879121	10.428277220630372
chr13	RNASEH2B	50910141	50910558	0	418	6273	19088	6273	18670	0.0	0.33599357257632567
chr13	RNASEH2B	50910439	50910558	0	120	6273	19088	6273	18968	0.0	0.33071488823281314
chr13	RNASEH2B	50910559	50913131	0	2573	6273	19088	6273	16515	0.0	0.3798365122615804
chr13	RNASEH2B	50910439	50913131	0	2693	6273	19088	6273	16395	0.0	0.3826166514181153
chr13	RNASEH2B	50930760	50930848	0	89	6273	19088	6273	18999	0.0	0.330175272382757
chr13	SERPINE3	51340862	51340925	0	64	0	2576	0	2512	0.0	0.0
chr13	ALG11	52012463	52012574	0	112	150243	11770	150243	11658	0.0	12.887545033453423
chr13	LINC02333	52341058	52341075	0	18	42590	1049	42590	1031	0.0	41.3094083414161
chr13	AL137058.1	52584704	52585168	51	465	6863	4551	6812	4086	0.10967741935483871	1.667156142927068
chr13	AL390964.1	54980425	54980446	0	22	0	4150	0	4128	0.0	0.0
chr13	AL390964.1	54940050	54940160	0	111	0	4150	0	4039	0.0	0.0
chr13	AL390964.1	54940130	54940160	0	31	0	4150	0	4119	0.0	0.0
chr13	AL390964.1	54940161	54940315	0	155	0	4150	0	3995	0.0	0.0
chr13	AL390964.1	54940130	54940315	0	186	0	4150	0	3964	0.0	0.0
chr13	AL390964.1	54940316	54940360	0	45	0	4150	0	4105	0.0	0.0
chr13	AL390964.1	54940762	54940782	0	21	0	4150	0	4129	0.0	0.0
chr13	AL390964.1	54940783	54940966	0	184	0	4150	0	3966	0.0	0.0
chr13	AL390964.1	54940881	54940966	0	86	0	4150	0	4064	0.0	0.0
chr13	AL390964.1	54941124	54941176	0	53	0	4150	0	4097	0.0	0.0
chr13	AL390964.1	54941674	54941799	0	126	0	4150	0	4024	0.0	0.0
chr13	LINC00378	60724213	60724493	0	281	0	3415	0	3134	0.0	0.0
chr13	LINC00348	71157765	71157799	0	35	0	1793	0	1758	0.0	0.0
chr13	BORA	72728008	72728260	0	253	0	3201	0	2948	0.0	0.0
chr13	LINC00392	73574727	73574806	0	80	503	1093	503	1013	0.0	0.49654491609081935
chr13	AL353660.1	74365062	74365087	0	26	0	3166	0	3140	0.0	0.0
chr13	LMO7	75760560	75760665	0	106	119331	12803	119331	12697	0.0	9.398361817752225
chr13	LMO7	75760666	75760831	0	166	119331	12803	119331	12637	0.0	9.44298488565324
chr13	CLN5	76992582	76992852	0	271	102	21845	102	21574	0.0	0.004727913228886623
chr13	MYCBP2-AS1	77076867	77076933	0	67	0	4097	0	4030	0.0	0.0
chr13	SLAIN1	77697929	77698539	0	611	357	4111	357	3500	0.0	0.102
chr13	SLAIN1	77699058	77699223	0	166	357	4111	357	3945	0.0	0.09049429657794676
chr13	SLAIN1	77744433	77744516	0	84	357	4111	357	4027	0.0	0.08865160168860194
chr13	SLAIN1	77743166	77743462	51	297	357	4111	306	3814	0.1717171717171717	0.08023072889355008
chr13	OBI1-AS1	78605445	78605456	0	12	0	8801	0	8789	0.0	0.0
chr13	RBM26-AS1	79406478	79407095	0	618	2040	6758	2040	6140	0.0	0.3322475570032573
chr13	IPO5	97953717	97954198	0	482	5111	9701	5111	9219	0.0	0.5543985247857686
chr13	IPO5	97953928	97954198	0	271	5111	9701	5111	9430	0.0	0.5419936373276776
chr13	IPO5	97953717	97953927	0	211	5111	9701	5111	9490	0.0	0.5385669125395153
chr13	UBAC2	99200940	99201567	0	628	0	4688	0	4060	0.0	0.0
chr13	UBAC2	99201185	99201567	0	383	0	4688	0	4305	0.0	0.0
chr13	UBAC2	99200940	99201184	0	245	0	4688	0	4443	0.0	0.0
chr13	PCCA	100302997	100302998	26	2	9444	7321	9418	7319	13.0	1.286787812542697
chr13	BIVM	102816555	102817128	0	574	52	7930	52	7356	0.0	0.0070690592713431215
chr13	LINC01309	103421273	103421388	234	116	4717	1672	4483	1556	2.0172413793103448	2.8811053984575836
chr13	LINC00343	105761438	105761560	0	123	153	12772	153	12649	0.0	0.012095817851213535
chr13	LINC00343	105761387	105761560	0	174	153	12772	153	12598	0.0	0.012144784886489918
chr13	LINC00343	105706727	105706917	0	191	153	12772	153	12581	0.0	0.012161195453461568
chr13	LINC00343	105761387	105761437	0	51	153	12772	153	12721	0.0	0.012027356339910384
chr13	LINC00343	105718560	105718852	0	293	153	12772	153	12479	0.0	0.012260597804311242
chr13	LINC00343	105706918	105706925	0	8	153	12772	153	12764	0.0	0.01198683798182388
chr13	LINC00343	105728728	105730458	0	1731	153	12772	153	11041	0.0	0.01385744044923467
chr13	LINC00460	106376557	106376665	0	109	0	4088	0	3979	0.0	0.0
chr13	ING1	110715529	110716008	0	480	0	5643	0	5163	0.0	0.0
chr13	ARHGEF7	111115058	111115691	30	634	560170	11306	560140	10672	0.0473186119873817	52.48688155922039
chr13	LINC00354	111893449	111893574	0	126	0	1978	0	1852	0.0	0.0
chr13	MCF2L	113090152	113090160	0	9	765	16966	765	16957	0.0	0.04511411216606711
chr13	F10	113147493	113147496	20	4	84893	2380	84873	2376	5.0	35.7209595959596
chr13	F10	113147487	113147496	50	10	84893	2380	84843	2370	5.0	35.79873417721519
chr13	F10	113147487	113147492	30	6	84893	2380	84863	2374	5.0	35.746840775063184
chr13	CUL4A	113210064	113210088	0	25	95201	7698	95201	7673	0.0	12.407272253355924
chr13	TFDP1	113585428	113585677	0	250	0	3759	0	3509	0.0	0.0
chr13	TMEM255B	113800866	113800912	170	47	15062	7316	14892	7269	3.617021276595745	2.0486999587288484
chr13	BX072579.2	113885053	113885158	405	106	163070	1573	162665	1467	3.8207547169811322	110.88275391956374
chr13	CFAP97D2	114179368	114179420	817	53	14527	2188	13710	2135	15.415094339622641	6.421545667447306
chr13	UPF3A	114301868	114302025	0	158	248189	5735	248189	5577	0.0	44.502241348395195
chr14	MED15P6	19485767	19485768	0	2	250	792	250	790	0.0	0.31645569620253167
chr14	OR11G2	20191040	20191666	0	627	0	4513	0	3886	0.0	0.0
chr14	PARP2	20345088	20345126	0	39	146	3806	146	3767	0.0	0.03875763206795859
chr14	APEX1	20455241	20455338	0	98	765	1679	765	1581	0.0	0.4838709677419355
chr14	APEX1	20455329	20455338	0	10	765	1679	765	1669	0.0	0.45835829838226483
chr14	APEX1	20455339	20455389	0	51	765	1679	765	1628	0.0	0.4699017199017199
chr14	APEX1	20455241	20455389	0	149	765	1679	765	1530	0.0	0.5
chr14	APEX1	20455329	20455389	0	61	765	1679	765	1618	0.0	0.47280593325092707
chr14	APEX1	20455339	20455394	0	56	765	1679	765	1623	0.0	0.4713493530499076
chr14	APEX1	20455241	20455394	0	154	765	1679	765	1525	0.0	0.5016393442622951
chr14	APEX1	20455390	20455394	0	5	765	1679	765	1674	0.0	0.45698924731182794
chr14	APEX1	20455329	20455394	0	66	765	1679	765	1613	0.0	0.47427154370737756
chr14	APEX1	20455241	20455328	0	88	765	1679	765	1591	0.0	0.4808296668761785
chr14	APEX1	20455704	20455773	0	70	765	1679	765	1609	0.0	0.4754505904288378
chr14	APEX1	20455339	20455401	0	63	765	1679	765	1616	0.0	0.47339108910891087
chr14	APEX1	20455241	20455401	0	161	765	1679	765	1518	0.0	0.5039525691699605
chr14	APEX1	20455390	20455401	0	12	765	1679	765	1667	0.0	0.4589082183563287
chr14	APEX1	20455395	20455401	0	7	765	1679	765	1672	0.0	0.45753588516746413
chr14	APEX1	20455329	20455401	0	73	765	1679	765	1606	0.0	0.4763387297633873
chr14	APEX1	20455339	20455428	0	90	765	1679	765	1589	0.0	0.4814348646947766
chr14	APEX1	20455390	20455428	0	39	765	1679	765	1640	0.0	0.46646341463414637
chr14	APEX1	20455395	20455428	0	34	765	1679	765	1645	0.0	0.46504559270516715
chr14	APEX1	20455329	20455428	0	100	765	1679	765	1579	0.0	0.4844838505383154
chr14	APEX1	20455402	20455428	0	27	765	1679	765	1652	0.0	0.46307506053268765
chr14	ANG	20684697	20684758	0	62	100	1443	100	1381	0.0	0.07241129616220131
chr14	METTL17	20990263	20990383	0	121	102	3390	102	3269	0.0	0.03120220250841236
chr14	TPPP2	21030305	21030317	0	13	0	2314	0	2301	0.0	0.0
chr14	ARHGEF40	21074992	21075180	0	189	0	8078	0	7889	0.0	0.0
chr14	TMEM253	21102121	21102192	0	72	0	2166	0	2094	0.0	0.0
chr14	RPGRIP1	21321301	21321402	0	102	240	4850	240	4748	0.0	0.05054759898904802
chr14	RPGRIP1	21324726	21325070	0	345	240	4850	240	4505	0.0	0.05327413984461709
chr14	RPGRIP1	21321972	21322004	0	33	240	4850	240	4817	0.0	0.04982354162341707
chr14	RPGRIP1	21321403	21321506	0	104	240	4850	240	4746	0.0	0.05056890012642225
chr14	TOX4	21487603	21487693	0	91	0	6373	0	6282	0.0	0.0
chr14	TOX4	21477565	21477592	0	28	0	6373	0	6345	0.0	0.0
chr14	ABHD4	22603458	22603762	0	305	0	3045	0	2740	0.0	0.0
chr14	ABHD4	22598330	22598442	0	113	0	3045	0	2932	0.0	0.0
chr14	OXA1L	22766765	22766914	0	150	0	4326	0	4176	0.0	0.0
chr14	OXA1L	22766765	22767051	0	287	0	4326	0	4039	0.0	0.0
chr14	OXA1L	22766915	22767051	0	137	0	4326	0	4189	0.0	0.0
chr14	MRPL52	22829941	22829948	0	8	102	2769	102	2761	0.0	0.03694313654473017
chr14	MRPL52	22829941	22830110	0	170	102	2769	102	2599	0.0	0.039245863793766836
chr14	MRPL52	22833483	22833489	0	7	102	2769	102	2762	0.0	0.036929761042722664
chr14	BCL2L2	23306895	23306947	0	53	1278798	2991	1278798	2938	0.0	435.26140231449966
chr14	BCL2L2	23306942	23306947	0	6	1278798	2991	1278798	2985	0.0	428.408040201005
chr14	BCL2L2	23306895	23306941	0	47	1278798	2991	1278798	2944	0.0	434.37432065217394
chr14	PABPN1	23324290	23324328	0	39	3497	3086	3497	3047	0.0	1.1476862487692812
chr14	THTPA	23557040	23557304	840	265	73483	2498	72643	2233	3.169811320754717	32.53157187639946
chr14	THTPA	23557035	23557304	840	270	73483	2498	72643	2228	3.111111111111111	32.60457809694793
chr14	THTPA	23557035	23557039	0	5	73483	2498	73483	2493	0.0	29.47573204973927
chr14	THTPA	23556344	23557304	2778	961	73483	2498	70705	1537	2.890738813735692	46.00195185426155
chr14	THTPA	23556344	23557039	1938	696	73483	2498	71545	1802	2.7844827586206895	39.703107658157606
chr14	DHRS2	23644496	23644543	0	48	0	4357	0	4309	0.0	0.0
chr14	DHRS2	23644544	23644554	0	11	0	4357	0	4346	0.0	0.0
chr14	DHRS2	23644496	23644554	0	59	0	4357	0	4298	0.0	0.0
chr14	CPNE6	24070976	24071028	0	53	0	3677	0	3624	0.0	0.0
chr14	CPNE6	24071029	24071038	0	10	0	3677	0	3667	0.0	0.0
chr14	CPNE6	24070976	24071038	0	63	0	3677	0	3614	0.0	0.0
chr14	CPNE6	24074126	24074365	0	240	0	3677	0	3437	0.0	0.0
chr14	CPNE6	24074126	24074160	0	35	0	3677	0	3642	0.0	0.0
chr14	CPNE6	24073105	24073119	0	15	0	3677	0	3662	0.0	0.0
chr14	PCK2	24094255	24094434	0	180	0	3751	0	3571	0.0	0.0
chr14	PCK2	24094435	24094845	0	411	0	3751	0	3340	0.0	0.0
chr14	PCK2	24094737	24094845	0	109	0	3751	0	3642	0.0	0.0
chr14	PCK2	24094435	24094736	0	302	0	3751	0	3449	0.0	0.0
chr14	PCK2	24099237	24099247	0	11	0	3751	0	3740	0.0	0.0
chr14	DCAF11	24115727	24115749	0	23	7849	5675	7849	5652	0.0	1.3887119603680114
chr14	DCAF11	24114925	24115293	0	369	7849	5675	7849	5306	0.0	1.4792687523558237
chr14	DCAF11	24114925	24114969	0	45	7849	5675	7849	5630	0.0	1.3941385435168738
chr14	PSME1	24136302	24136341	0	40	0	1347	0	1307	0.0	0.0
chr14	PSME1	24138561	24138568	0	8	0	1347	0	1339	0.0	0.0
chr14	PSME1	24138400	24138403	0	4	0	1347	0	1343	0.0	0.0
chr14	RNF31	24148062	24148122	0	61	0	5009	0	4948	0.0	0.0
chr14	RNF31	24148414	24148477	0	64	0	5009	0	4945	0.0	0.0
chr14	RNF31	24147592	24147890	0	299	0	5009	0	4710	0.0	0.0
chr14	IRF9	24162281	24162324	0	44	0	3101	0	3057	0.0	0.0
chr14	TSSK4	24205805	24206148	0	344	528	1855	528	1511	0.0	0.3494374586366645
chr14	GMPR2	24233594	24233598	0	5	0	2910	0	2905	0.0	0.0
chr14	GMPR2	24233587	24233598	0	12	0	2910	0	2898	0.0	0.0
chr14	GMPR2	24232789	24232847	0	59	0	2910	0	2851	0.0	0.0
chr14	GMPR2	24236042	24236140	0	99	0	2910	0	2811	0.0	0.0
chr14	GMPR2	24233587	24233593	0	7	0	2910	0	2903	0.0	0.0
chr14	GMPR2	24238749	24238769	0	21	0	2910	0	2889	0.0	0.0
chr14	LTB4R2	24311559	24311804	0	246	0	1652	0	1406	0.0	0.0
chr14	LTB4R	24315017	24315020	0	4	0	3122	0	3118	0.0	0.0
chr14	NFATC4	24369671	24370594	2438	924	6525	7075	4087	6151	2.6385281385281387	0.6644448057226467
chr14	NFATC4	24376555	24376878	0	324	6525	7075	6525	6751	0.0	0.9665234780032588
chr14	NFATC4	24369157	24369343	189	187	6525	7075	6336	6888	1.0106951871657754	0.9198606271777003
chr14	NFATC4	24369344	24369376	759	33	6525	7075	5766	7042	23.0	0.8188014768531667
chr14	NFATC4	24369157	24369376	948	220	6525	7075	5577	6855	4.3090909090909095	0.8135667396061269
chr14	KHNYN	24429992	24430119	0	128	42938	8033	42938	7905	0.0	5.431752055660974
chr14	LINC02588	26663787	26663930	0	144	0	5137	0	4993	0.0	0.0
chr14	MIR4307HG	26873222	26873294	0	73	3197	3583	3197	3510	0.0	0.9108262108262108
chr14	MIR4307HG	26873472	26873542	0	71	3197	3583	3197	3512	0.0	0.9103075170842825
chr14	MIR4307HG	26873532	26873542	0	11	3197	3583	3197	3572	0.0	0.89501679731243
chr14	MIR4307HG	26873440	26873542	0	103	3197	3583	3197	3480	0.0	0.9186781609195402
chr14	MIR4307HG	26873489	26873542	0	54	3197	3583	3197	3529	0.0	0.9059223576083877
chr14	MIR4307HG	26873440	26873471	0	32	3197	3583	3197	3551	0.0	0.9003097718952408
chr14	MIR4307HG	26880456	26880635	0	180	3197	3583	3197	3403	0.0	0.9394651777843079
chr14	MIR4307HG	26873472	26873531	0	60	3197	3583	3197	3523	0.0	0.9074652284984388
chr14	MIR4307HG	26873440	26873531	0	92	3197	3583	3197	3491	0.0	0.9157834431395016
chr14	MIR4307HG	26873489	26873531	0	43	3197	3583	3197	3540	0.0	0.9031073446327683
chr14	MIR4307HG	26873472	26873488	0	17	3197	3583	3197	3566	0.0	0.8965227145260797
chr14	MIR4307HG	26873543	26874043	0	501	3197	3583	3197	3082	0.0	1.037313432835821
chr14	MIR4307HG	26873472	26874043	0	572	3197	3583	3197	3011	0.0	1.0617734971770176
chr14	MIR4307HG	26873532	26874043	0	512	3197	3583	3197	3071	0.0	1.0410289807880169
chr14	MIR4307HG	26873440	26874043	0	604	3197	3583	3197	2979	0.0	1.0731789191003693
chr14	MIR4307HG	26873489	26874043	0	555	3197	3583	3197	3028	0.0	1.0558124174372523
chr14	MIR4307HG	26873440	26873488	0	49	3197	3583	3197	3534	0.0	0.9046406338426712
chr14	LINC02327	28834821	28834904	0	84	0	5076	0	4992	0.0	0.0
chr14	SCFD1	30675066	30676855	51	1790	51	20324	0	18534	0.028491620111731845	0.0
chr14	SCFD1	30676634	30676855	0	222	51	20324	51	20102	0.0	0.002537060988956323
chr14	SCFD1	30707915	30708065	0	151	51	20324	51	20173	0.0	0.002528131661131215
chr14	SCFD1	30705886	30708065	0	2180	51	20324	51	18144	0.0	0.0028108465608465607
chr14	SCFD1	30622400	30622462	0	63	51	20324	51	20261	0.0	0.002517151177138345
chr14	COCH	30875104	30875298	0	195	0	3999	0	3804	0.0	0.0
chr14	COCH	30874973	30875055	0	83	0	3999	0	3916	0.0	0.0
chr14	ARHGAP5	32094384	32094386	0	3	4633	10287	4633	10284	0.0	0.4505056398288604
chr14	ARHGAP5	32077436	32077436	0	1	4633	10287	4633	10286	0.0	0.4504180439432238
chr14	NPAS3	33797573	33797581	0	9	0	9801	0	9792	0.0	0.0
chr14	SRP54	34983004	34983215	0	212	16402	8450	16402	8238	0.0	1.9910172371934935
chr14	SRP54	34999645	34999649	0	5	16402	8450	16402	8445	0.0	1.9422143280047366
chr14	FAM177A1	35046629	35046954	663	326	90481	8320	89818	7994	2.0337423312883436	11.235676757568177
chr14	FAM177A1	35046955	35047084	561	130	90481	8320	89920	8190	4.315384615384615	10.97924297924298
chr14	PSMA6	35312922	35313059	0	138	972	2284	972	2146	0.0	0.45293569431500463
chr14	PRORP	35122636	35122767	0	132	12350	7001	12350	6869	0.0	1.7979327413014994
chr14	PRORP	35122768	35122806	0	39	12350	7001	12350	6962	0.0	1.7739155415110601
chr14	PSMA6	35292553	35292600	921	48	972	2284	51	2236	19.1875	0.022808586762075134
chr14	AL133304.3	35898841	35898884	26	44	458	3442	432	3398	0.5909090909090909	0.12713360800470866
chr14	PAX9	36666592	36666601	0	10	0	4791	0	4781	0.0	0.0
chr14	MIPOL1	37198105	37198278	0	174	0	20276	0	20102	0.0	0.0
chr14	AL355835.1	38298605	38298811	0	207	0	1874	0	1667	0.0	0.0
chr14	GEMIN2	39114396	39114475	0	80	4	2501	4	2421	0.0	0.0016522098306484924
chr14	GEMIN2	39114421	39114475	0	55	4	2501	4	2446	0.0	0.001635322976287817
chr14	GEMIN2	39114467	39114475	0	9	4	2501	4	2492	0.0	0.0016051364365971107
chr14	GEMIN2	39114396	39114420	0	25	4	2501	4	2476	0.0	0.0016155088852988692
chr14	GEMIN2	39114396	39114466	0	71	4	2501	4	2430	0.0	0.0016460905349794238
chr14	GEMIN2	39114421	39114466	0	46	4	2501	4	2455	0.0	0.001629327902240326
chr14	MIA2	39276956	39277065	0	110	55	9868	55	9758	0.0	0.005636400901824145
chr14	MIA2	39267190	39267522	0	333	55	9868	55	9535	0.0	0.0057682223387519665
chr14	MIA2	39291097	39291111	0	15	55	9868	55	9853	0.0	0.005582056226529991
chr14	AL049828.1	39470401	39470589	0	189	2062	12973	2062	12784	0.0	0.16129536921151438
chr14	AL049828.1	39474898	39474955	0	58	2062	12973	2062	12915	0.0	0.15965931087882307
chr14	PRPF39	45095534	45095563	0	30	98	4642	98	4612	0.0	0.021248915871639202
chr14	FANCM	45198836	45198935	0	100	255	8294	255	8194	0.0	0.03112033195020747
chr14	DMAC2L	50312390	50313060	4182	671	9562	4575	5380	3904	6.2324888226527575	1.3780737704918034
chr14	DMAC2L	50322720	50322806	0	87	9562	4575	9562	4488	0.0	2.1305704099821745
chr14	ATL1	50560300	50560500	0	201	11685	6261	11685	6060	0.0	1.9282178217821782
chr14	TMX1	51245359	51245454	0	96	5413	4616	5413	4520	0.0	1.197566371681416
chr14	FRMD6	51701136	51701159	0	24	35393	7476	35393	7452	0.0	4.749463231347289
chr14	FRMD6	51651997	51652217	0	221	35393	7476	35393	7255	0.0	4.878428669882839
chr14	PSMC6	52707305	52707529	0	225	357	7350	357	7125	0.0	0.050105263157894736
chr14	AL139317.5	52898151	52898154	288	4	31421	6856	31133	6852	72.0	4.5436368943374195
chr14	SAMD4A	54567311	54567338	0	28	153	12348	153	12320	0.0	0.01241883116883117
chr14	SAMD4A	54784382	54784447	0	66	153	12348	153	12282	0.0	0.012457254518808011
chr14	KTN1	55648089	55648115	0	27	29033	13937	29033	13910	0.0	2.0872034507548527
chr14	LINC02284	56311095	56311102	0	8	51	4445	51	4437	0.0	0.011494252873563218
chr14	AP5M1	57269070	57269388	0	319	153	12111	153	11792	0.0	0.012974898236092266
chr14	NAA30	57391507	57391728	0	222	0	7303	0	7081	0.0	0.0
chr14	ACTR10	58211393	58211410	0	18	0	3657	0	3639	0.0	0.0
chr14	ARID4A	58366069	58366230	0	162	0	7475	0	7313	0.0	0.0
chr14	KIAA0586	58459910	58460070	0	161	204	17469	204	17308	0.0	0.011786457129651028
chr14	KIAA0586	58427814	58428463	0	650	204	17469	204	16819	0.0	0.01212913966347583
chr14	KIAA0586	58427858	58428463	0	606	204	17469	204	16863	0.0	0.012097491549546344
chr14	KIAA0586	58427814	58427857	0	44	204	17469	204	17425	0.0	0.011707317073170732
chr14	LINC01500	58828549	58828555	0	7	33152	6780	33152	6773	0.0	4.894729071312565
chr14	JKAMP	59495088	59495224	0	137	102	4049	102	3912	0.0	0.02607361963190184
chr14	JKAMP	59484594	59485116	0	523	102	4049	102	3526	0.0	0.028927963698241632
chr14	LRRC9	60032064	60032067	0	4	8905	5408	8905	5404	0.0	1.6478534418948927
chr14	PCNX4	60124311	60125251	0	941	19	9442	19	8501	0.0	0.0022350311728031994
chr14	PCNX4	60124714	60125251	0	538	19	9442	19	8904	0.0	0.0021338724168912847
chr14	PCNX4	60124311	60124713	0	403	19	9442	19	9039	0.0	0.002102002433897555
chr14	PPM1A	60282795	60283537	0	743	0	11920	0	11177	0.0	0.0
chr14	SLC38A6	60981383	60981687	0	305	91	4924	91	4619	0.0	0.01970123403334055
chr14	SLC38A6	60981688	60981691	0	4	91	4924	91	4920	0.0	0.018495934959349595
chr14	PRKCH	61281269	61281308	0	40	51239	8398	51239	8358	0.0	6.130533620483369
chr14	LINC00643	62117567	62117588	0	22	0	4644	0	4622	0.0	0.0
chr14	AL136038.4	63642186	63642197	0	12	0	1434	0	1422	0.0	0.0
chr14	AL136038.4	63651420	63651456	0	37	0	1434	0	1397	0.0	0.0
chr14	SYNE2	64137984	64138001	0	18	42515	32202	42515	32184	0.0	1.320998011434253
chr14	SYNE2	64212955	64213005	0	51	42515	32202	42515	32151	0.0	1.322353892569438
chr14	SYNE2	63997392	63997576	4	185	42515	32202	42511	32017	0.021621621621621623	1.3277633757066558
chr14	MTHFD1	64390468	64390791	0	324	6268	12243	6268	11919	0.0	0.5258830438795201
chr14	PLEKHG3	64738138	64738224	0	87	2195	11824	2195	11737	0.0	0.187015421317202
chr14	FNTB	65027766	65027781	0	16	1006	3789	1006	3773	0.0	0.26663132785581767
chr14	AL139022.1	65090020	65090227	0	208	0	1382	0	1174	0.0	0.0
chr14	AL139022.1	65090161	65090227	0	67	0	1382	0	1315	0.0	0.0
chr14	AL139022.1	65090020	65090160	0	141	0	1382	0	1241	0.0	0.0
chr14	LINC02290	66111772	66112354	0	583	238	4521	238	3938	0.0	0.06043676993397664
chr14	LINC02290	66111996	66112354	0	359	238	4521	238	4162	0.0	0.05718404613166747
chr14	LINC02290	66123181	66123313	0	133	238	4521	238	4388	0.0	0.05423883318140383
chr14	LINC02290	66111772	66111995	0	224	238	4521	238	4297	0.0	0.05538747963695602
chr14	FAM71D	67221808	67222025	0	218	1938	4520	1938	4302	0.0	0.4504881450488145
chr14	PLEKHH1	67581002	67581038	0	37	20098	8378	20098	8341	0.0	2.4095432202373814
chr14	GALNT16	69259747	69259797	1521	51	1565322	9668	1563801	9617	29.823529411764707	162.6079858583758
chr14	SLC39A9	69398451	69398603	768	153	2063	7148	1295	6995	5.019607843137255	0.18513223731236597
chr14	SRSF5	69767252	69767255	0	4	3779	3622	3779	3618	0.0	1.0444997236042013
chr14	SRSF5	69767256	69767380	0	125	3779	3622	3779	3497	0.0	1.080640549042036
chr14	SRSF5	69767252	69767380	0	129	3779	3622	3779	3493	0.0	1.0818780417978815
chr14	AC004816.1	70810292	70810665	0	374	510	1456	510	1082	0.0	0.4713493530499076
chr14	AC004816.1	70810666	70810674	0	9	510	1456	510	1447	0.0	0.3524533517622668
chr14	AC004816.1	70810292	70810674	0	383	510	1456	510	1073	0.0	0.47530288909599255
chr14	PCNX1	70995844	70995925	0	82	3686	16758	3686	16676	0.0	0.2210362197169585
chr14	DCAF4	72954463	72954483	0	21	0	5555	0	5534	0.0	0.0
chr14	RBM25	73058706	73058811	0	106	2320	11083	2320	10977	0.0	0.21135100665026874
chr14	PSEN1	73136449	73136583	0	135	27020	9942	27020	9807	0.0	2.7551748750892218
chr14	PSEN1	73136580	73136583	0	4	27020	9942	27020	9938	0.0	2.71885691285973
chr14	PSEN1	73136449	73136579	0	131	27020	9942	27020	9811	0.0	2.754051574763021
chr14	PSEN1	73148095	73148106	0	12	27020	9942	27020	9930	0.0	2.7210473313192347
chr14	ACOT2	73569397	73569883	22972	487	61795	2306	38823	1819	47.17043121149897	21.34304562946674
chr14	PTGR2	73851944	73852004	0	61	663	6154	663	6093	0.0	0.10881339241752831
chr14	PTGR2	73874144	73874214	0	71	663	6154	663	6083	0.0	0.10899227354923557
chr14	PTGR2	73852005	73852120	0	116	663	6154	663	6038	0.0	0.10980457105001656
chr14	PTGR2	73852117	73852120	0	4	663	6154	663	6150	0.0	0.10780487804878049
chr14	PTGR2	73852005	73852116	0	112	663	6154	663	6042	0.0	0.10973187686196624
chr14	ZNF410	73892108	73892208	0	101	226	5246	226	5145	0.0	0.04392614188532556
chr14	ZNF410	73886916	73886927	0	12	226	5246	226	5234	0.0	0.043179212839128775
chr14	COQ6	73950289	73950495	0	207	151961	5835	151961	5628	0.0	27.000888415067518
chr14	FCF1	74713553	74713620	0	68	510	4755	510	4687	0.0	0.10881160657136761
chr14	FCF1	74713508	74713620	0	113	510	4755	510	4642	0.0	0.1098664368806549
chr14	FCF1	74713508	74713552	0	45	510	4755	510	4710	0.0	0.10828025477707007
chr14	FCF1	74713201	74713259	0	59	510	4755	510	4696	0.0	0.108603066439523
chr14	DLST	74891168	74891193	0	26	0	4551	0	4525	0.0	0.0
chr14	ZC2HC1C	75069750	75071396	15991	1647	58090	7841	42099	6194	9.70916818457802	6.796738779463998
chr14	ZC2HC1C	75069686	75069749	0	64	58090	7841	58090	7777	0.0	7.469461231837469
chr14	ZC2HC1C	75071397	75071738	0	342	58090	7841	58090	7499	0.0	7.746366182157621
chr14	ZC2HC1C	75071397	75071911	0	515	58090	7841	58090	7326	0.0	7.929292929292929
chr14	ZC2HC1C	75071739	75071911	0	173	58090	7841	58090	7668	0.0	7.575639019300991
chr14	ZC2HC1C	75069750	75069948	0	199	58090	7841	58090	7642	0.0	7.601413242606648
chr14	ZC2HC1C	75069686	75069948	0	263	58090	7841	58090	7578	0.0	7.665610979150172
chr14	ZC2HC1C	75069926	75069948	0	23	58090	7841	58090	7818	0.0	7.430289076490151
chr14	ZC2HC1C	75069750	75071911	15991	2162	58090	7841	42099	5679	7.396392229417207	7.413100898045431
chr14	ZC2HC1C	75069750	75069925	0	176	58090	7841	58090	7665	0.0	7.578604044357469
chr14	ZC2HC1C	75069686	75069925	0	240	58090	7841	58090	7601	0.0	7.642415471648468
chr14	LINC01220	75294542	75294737	408	196	6500	1982	6092	1786	2.0816326530612246	3.4109742441209407
chr14	BATF	75522541	75522745	9340	205	17772	931	8432	726	45.5609756097561	11.614325068870523
chr14	IFT43	75986283	75986308	0	26	102	3897	102	3871	0.0	0.02634978041849651
chr14	GPATCH2L	76151976	76151991	0	16	6316	20948	6316	20932	0.0	0.30173896426523983
chr14	LRRC74A	76826584	76826734	0	151	0	2320	0	2169	0.0	0.0
chr14	GSTZ1	77327511	77327552	0	42	51	5473	51	5431	0.0	0.009390535812925796
chr14	SLIRP	77710881	77710896	0	16	323	2452	323	2436	0.0	0.1325944170771757
chr14	C14ORF178	77768466	77768523	0	58	357	703	357	645	0.0	0.5534883720930233
chr14	NRXN3	79805191	79805199	0	9	2586	14947	2586	14938	0.0	0.17311554424956488
chr14	LINC02301	82657212	82657455	0	244	0	6218	0	5974	0.0	0.0
chr14	LINC02301	82642675	82642798	0	124	0	6218	0	6094	0.0	0.0
chr14	LINC00911	85393900	85393959	0	60	0	1755	0	1695	0.0	0.0
chr14	FLRT2	85530535	85530556	0	22	51	30568	51	30546	0.0	0.001669613042624239
chr14	LINC01146	88087024	88087037	0	14	0	9300	0	9286	0.0	0.0
chr14	LINC01146	88091450	88091652	0	203	0	9300	0	9097	0.0	0.0
chr14	LINC01146	88084156	88084483	0	328	0	9300	0	8972	0.0	0.0
chr14	SPATA7	88396185	88396203	0	19	1667	6106	1667	6087	0.0	0.2738623295547889
chr14	SPATA7	88385838	88386031	0	194	1667	6106	1667	5912	0.0	0.28196887686062244
chr14	ZC3H14	88603046	88603060	0	15	0	20176	0	20161	0.0	0.0
chr14	TTC8	88840924	88840928	0	5	2340	6251	2340	6246	0.0	0.3746397694524496
chr14	TTC8	88841515	88841557	0	43	2340	6251	2340	6208	0.0	0.37693298969072164
chr14	TDP1	89980633	89980679	0	47	151	6245	151	6198	0.0	0.02436269764440142
chr14	CALM1	90397155	90397233	782	79	3936	7087	3154	7008	9.89873417721519	0.4500570776255708
chr14	CALM1	90399088	90399162	170	75	3936	7087	3766	7012	2.2666666666666666	0.5370792926411866
chr14	LINC00642	90455487	90456254	2263	768	25892	5124	23629	4356	2.9466145833333335	5.424471992653811
chr14	LINC00642	90455506	90456254	2263	749	25892	5124	23629	4375	3.021361815754339	5.400914285714285
chr14	LINC00642	90455379	90456270	9874	892	25892	5124	16018	4232	11.0695067264574	3.7849716446124764
chr14	LINC00642	90456255	90456270	0	16	25892	5124	25892	5108	0.0	5.068911511354738
chr14	LINC00642	90455379	90456254	9874	876	25892	5124	16018	4248	11.271689497716896	3.7707156308851224
chr14	LINC00642	90455487	90456270	2263	784	25892	5124	23629	4340	2.8864795918367347	5.444470046082949
chr14	LINC00642	90455506	90456270	2263	765	25892	5124	23629	4359	2.958169934640523	5.42073870153705
chr14	LINC00642	90455487	90455505	0	19	25892	5124	25892	5105	0.0	5.071890303623898
chr14	DGLUCY	91114284	91114528	0	245	15811	7243	15811	6998	0.0	2.2593598170905973
chr14	DGLUCY	91170187	91170201	0	15	15811	7243	15811	7228	0.0	2.1874654122855564
chr14	DGLUCY	91173404	91173439	0	36	15811	7243	15811	7207	0.0	2.1938393228805326
chr14	DGLUCY	91114995	91115221	0	227	15811	7243	15811	7016	0.0	2.253563283922463
chr14	DGLUCY	91204826	91204867	0	42	15811	7243	15811	7201	0.0	2.1956672684349394
chr14	DGLUCY	91215557	91215793	0	237	15811	7243	15811	7006	0.0	2.256779902940337
chr14	CPSF2	92122129	92122351	0	223	47	13579	47	13356	0.0	0.0035190176699610664
chr14	SLC24A4	92449160	92449216	0	57	51896	14801	51896	14744	0.0	3.5198046663049376
chr14	FAM181A	93927400	93927454	0	55	0	2123	0	2068	0.0	0.0
chr14	FAM181A	93927455	93927626	0	172	0	2123	0	1951	0.0	0.0
chr14	FAM181A	93927400	93927626	0	227	0	2123	0	1896	0.0	0.0
chr14	CCDC197	94001320	94001323	0	4	0	2717	0	2713	0.0	0.0
chr14	CCDC197	94001324	94001722	0	399	0	2717	0	2318	0.0	0.0
chr14	CCDC197	94001320	94001722	0	403	0	2717	0	2314	0.0	0.0
chr14	IFI27L1	94101976	94102059	0	84	0	2366	0	2282	0.0	0.0
chr14	IFI27	94110762	94110797	0	36	0	3825	0	3789	0.0	0.0
chr14	SERPINA4	94561495	94561809	931	315	27377	1992	26446	1677	2.9555555555555557	15.769827072152653
chr14	SERPINA4	94561655	94561809	931	155	27377	1992	26446	1837	6.006451612903226	14.396298312465976
chr14	SERPINA4	94561495	94561654	0	160	27377	1992	27377	1832	0.0	14.943777292576419
chr14	SERPINA5	94581491	94581710	0	220	2625	3760	2625	3540	0.0	0.7415254237288136
chr14	SERPINA5	94581639	94581710	0	72	2625	3760	2625	3688	0.0	0.711767895878525
chr14	SERPINA5	94581491	94581638	0	148	2625	3760	2625	3612	0.0	0.7267441860465116
chr14	SERPINA5	94581999	94582342	2499	344	2625	3760	126	3416	7.2645348837209305	0.036885245901639344
chr14	SERPINA3	94612444	94612447	0	4	51	5005	51	5001	0.0	0.010197960407918417
chr14	LINC02292	95331518	95331645	0	128	0	3162	0	3034	0.0	0.0
chr14	LINC02292	95329639	95329668	0	30	0	3162	0	3132	0.0	0.0
chr14	LINC02318	95573683	95573684	0	2	4794	2840	4794	2838	0.0	1.6892177589852009
chr14	LINC02318	95573685	95573886	0	202	4794	2840	4794	2638	0.0	1.8172858225928734
chr14	LINC02318	95573683	95573886	0	204	4794	2840	4794	2636	0.0	1.8186646433990896
chr14	LINC02318	95580612	95580651	0	40	4794	2840	4794	2800	0.0	1.7121428571428572
chr14	LINC02318	95577606	95577696	15	91	4794	2840	4779	2749	0.16483516483516483	1.738450345580211
chr14	AL133467.2	95621034	95621118	102	85	6198	1929	6096	1844	1.2	3.3058568329718003
chr14	TCL6	95668581	95669617	1527	1037	2955	10388	1428	9351	1.4725168756027	0.1527109400064164
chr14	TCL6	95663636	95665076	0	1441	2955	10388	2955	8947	0.0	0.3302783055772885
chr14	AL139020.1	95711899	95712025	0	127	0	3021	0	2894	0.0	0.0
chr14	GSKIP	96379756	96379788	0	33	0	4558	0	4525	0.0	0.0
chr14	GSKIP	96379735	96379788	0	54	0	4558	0	4504	0.0	0.0
chr14	GSKIP	96379735	96379755	0	21	0	4558	0	4537	0.0	0.0
chr14	GSKIP	96363569	96365266	0	1698	0	4558	0	2860	0.0	0.0
chr14	AL137786.1	96592816	96593249	0	434	0	2863	0	2429	0.0	0.0
chr14	AL137786.1	96593580	96593699	0	120	0	2863	0	2743	0.0	0.0
chr14	AL137786.1	96593696	96593699	0	4	0	2863	0	2859	0.0	0.0
chr14	AL137786.1	96592808	96592815	0	8	0	2863	0	2855	0.0	0.0
chr14	AL137786.1	96594882	96594949	0	68	0	2863	0	2795	0.0	0.0
chr14	AL137786.1	96593580	96593695	0	116	0	2863	0	2747	0.0	0.0
chr14	LINC02325	97427120	97427254	0	135	0	5246	0	5111	0.0	0.0
chr14	CCNK	99481480	99481614	0	135	0	5576	0	5441	0.0	0.0
chr14	CYP46A1	99722037	99722066	0	30	41	9376	41	9346	0.0	0.004386903488123262
chr14	EML1	99793518	99793543	0	26	1880	8834	1880	8808	0.0	0.2134423251589464
chr14	WDR25	100376496	100376504	0	9	17342	4230	17342	4221	0.0	4.10850509357972
chr14	WDR25	100376505	100376704	11176	200	17342	4230	6166	4030	55.88	1.5300248138957817
chr14	WDR25	100376496	100376704	11176	209	17342	4230	6166	4021	53.473684210526315	1.5334493906988311
chr14	LINC00523	100657711	100658105	0	395	5868	3347	5868	2952	0.0	1.9878048780487805
chr14	MEG3	100829750	100829787	0	38	70319	9744	70319	9706	0.0	7.244900061817432
chr14	MEG3	100834752	100835879	28097	1128	70319	9744	42222	8616	24.90868794326241	4.9004178272980505
chr14	MEG3	100835550	100835879	9064	330	70319	9744	61255	9414	27.466666666666665	6.506798385383472
chr14	MEG3	100835880	100836075	700	196	70319	9744	69619	9548	3.5714285714285716	7.29147465437788
chr14	MEG3	100834752	100836075	28797	1324	70319	9744	41522	8420	21.75	4.931353919239905
chr14	MEG3	100835550	100836075	9764	526	70319	9744	60555	9218	18.562737642585553	6.569212410501193
chr14	MEG8	100944873	100944925	0	53	12150	24817	12150	24764	0.0	0.49063156194475854
chr14	MEG8	100944894	100944925	0	32	12150	24817	12150	24785	0.0	0.49021585636473675
chr14	MEG3	100856269	100857388	1836	1120	70319	9744	68483	8624	1.6392857142857142	7.94097866419295
chr14	MEG8	100942827	100942838	0	12	12150	24817	12150	24805	0.0	0.4898206006853457
chr14	MEG8	100968723	100968724	0	2	12150	24817	12150	24815	0.0	0.48962321176707635
chr14	MEG8	100944873	100944893	0	21	12150	24817	12150	24796	0.0	0.48999838683658653
chr14	MEG8	100966732	100966735	0	4	12150	24817	12150	24813	0.0	0.4896626768226333
chr14	MEG8	100977695	100977722	0	28	12150	24817	12150	24789	0.0	0.49013675420549435
chr14	MEG8	100997547	100997552	0	6	12150	24817	12150	24811	0.0	0.4897021482406997
chr14	MEG8	100967787	100967790	0	4	12150	24817	12150	24813	0.0	0.4896626768226333
chr14	DYNC1H1	102049583	102049611	0	29	108125	31680	108125	31651	0.0	3.416163786294272
chr14	WDR20	102139988	102140172	0	185	0	7270	0	7085	0.0	0.0
chr14	ZNF839	102339224	102339229	0	6	11232	5405	11232	5399	0.0	2.0803852565289866
chr14	AMN	102928943	102928975	0	33	2279	4057	2279	4024	0.0	0.566351888667992
chr14	TNFAIP2	103123484	103123951	36	468	3149	3893	3113	3425	0.07692307692307693	0.9089051094890511
chr14	EIF5	103334261	103334597	816	337	36624	6699	35808	6362	2.421364985163205	5.628418736246464
chr14	EIF5	103335063	103335185	0	123	36624	6699	36624	6576	0.0	5.569343065693431
chr14	EIF5	103335039	103335185	0	147	36624	6699	36624	6552	0.0	5.589743589743589
chr14	EIF5	103335039	103335062	0	24	36624	6699	36624	6675	0.0	5.486741573033708
chr14	MARK3	103385698	103386080	2115	383	83139	15808	81024	15425	5.522193211488251	5.252771474878444
chr14	MARK3	103411750	103411765	16	16	83139	15808	83123	15792	1.0	5.263614488348531
chr14	KLC1	103662922	103662927	0	6	51	18950	51	18944	0.0	0.00269214527027027
chr14	KLC1	103679519	103679545	0	27	51	18950	51	18923	0.0	0.0026951329070443375
chr14	INF2	104706153	104706176	0	24	51	13399	51	13375	0.0	0.0038130841121495327
chr14	INF2	104711008	104711011	0	4	51	13399	51	13395	0.0	0.003807390817469205
chr14	ADSS1	104729896	104730213	0	318	51	4717	51	4399	0.0	0.011593543987269835
chr14	CLBA1	104989075	104989088	0	14	153	5232	153	5218	0.0	0.02932157914909927
chr14	CLBA1	104985879	104986854	0	976	153	5232	153	4256	0.0	0.03594924812030075
chr14	CLBA1	104989089	104989707	0	619	153	5232	153	4613	0.0	0.03316713635378279
chr14	CLBA1	104989075	104989707	0	633	153	5232	153	4599	0.0	0.033268101761252444
chr14	PACS2	105368516	105368539	0	24	14595	12388	14595	12364	0.0	1.180443222258169
chr14	PACS2	105382047	105382058	0	12	14595	12388	14595	12376	0.0	1.1792986425339367
chr14	TEDC1	105491119	105491126	0	8	8337	3476	8337	3468	0.0	2.4039792387543253
chr14	AL928654.3	105488795	105488947	0	153	1871	1416	1871	1263	0.0	1.4813935075217735
chr14	TEDC1	105491119	105491132	0	14	8337	3476	8337	3462	0.0	2.4081455805892547
chr14	TEDC1	105491127	105491132	0	6	8337	3476	8337	3470	0.0	2.402593659942363
chr14	TEDC1	105491119	105491154	715	36	8337	3476	7622	3440	19.86111111111111	2.2156976744186045
chr14	TEDC1	105491127	105491154	715	28	8337	3476	7622	3448	25.535714285714285	2.210556844547564
chr14	TEDC1	105491133	105491154	715	22	8337	3476	7622	3454	32.5	2.206716850028952
chr14	TEDC1	105491684	105491700	0	17	8337	3476	8337	3459	0.0	2.410234171725932
chr14	TEDC1	105491361	105491522	821	162	8337	3476	7516	3314	5.067901234567901	2.267954133977067
chr14	OR4K13	20035641	20035936	0	296	0	5982	0	5686	0.0	0.0
chr14	TTC5	20300606	20300673	0	68	204	8194	204	8126	0.0	0.02510460251046025
chr14	TTC5	20305355	20305885	0	531	204	8194	204	7663	0.0	0.026621427639305754
chr14	CCNB1IP1	20329173	20329222	0	50	0	3695	0	3645	0.0	0.0
chr14	CCNB1IP1	20317793	20317793	0	1	0	3695	0	3694	0.0	0.0
chr14	CCNB1IP1	20332843	20333252	0	410	0	3695	0	3285	0.0	0.0
chr14	TEP1	20413370	20413403	0	34	184	11420	184	11386	0.0	0.01616019673282979
chr14	KLHL33	20435063	20435462	0	400	0	5114	0	4714	0.0	0.0
chr14	OSGEP	20451973	20451993	0	21	0	4721	0	4700	0.0	0.0
chr14	PIP4P1	20461162	20461182	0	21	0	3028	0	3007	0.0	0.0
chr14	RNASE9	20558539	20558613	0	75	0	2714	0	2639	0.0	0.0
chr14	RNASE11	20587968	20588013	0	46	0	1739	0	1693	0.0	0.0
chr14	RNASE11	20587877	20587967	0	91	0	1739	0	1648	0.0	0.0
chr14	RNASE11	20587742	20587967	0	226	0	1739	0	1513	0.0	0.0
chr14	RNASE11	20587742	20587876	0	135	0	1739	0	1604	0.0	0.0
chr14	RNASE11	20587742	20587767	0	26	0	1739	0	1713	0.0	0.0
chr14	RNASE11	20587742	20587858	0	117	0	1739	0	1622	0.0	0.0
chr14	RNASE11	20587768	20587967	0	200	0	1739	0	1539	0.0	0.0
chr14	RNASE11	20587768	20587876	0	109	0	1739	0	1630	0.0	0.0
chr14	RNASE11	20587768	20587858	0	91	0	1739	0	1648	0.0	0.0
chr14	RNASE11	20587859	20587876	0	18	0	1739	0	1721	0.0	0.0
chr14	NDRG2	21018762	21018794	0	33	153	5997	153	5964	0.0	0.025653923541247486
chr14	NDRG2	21023985	21024028	0	44	153	5997	153	5953	0.0	0.025701327061985555
chr14	NDRG2	21024825	21024847	0	23	153	5997	153	5974	0.0	0.025610980917308335
chr14	NDRG2	21024848	21025027	0	180	153	5997	153	5817	0.0	0.02630221763795771
chr14	NDRG2	21025028	21025062	0	35	153	5997	153	5962	0.0	0.025662529352566254
chr14	NDRG2	21024029	21024847	0	819	153	5997	153	5178	0.0	0.02954808806488992
chr14	NDRG2	21024029	21024824	0	796	153	5997	153	5201	0.0	0.02941741972697558
chr14	NDRG2	21024029	21024836	0	808	153	5997	153	5189	0.0	0.029485449990364232
chr14	NDRG2	21025393	21025469	0	77	153	5997	153	5920	0.0	0.025844594594594594
chr14	NDRG2	21020968	21021038	0	71	153	5997	153	5926	0.0	0.02581842726965913
chr14	NDRG2	21021746	21021815	0	70	153	5997	153	5927	0.0	0.025814071199595074
chr14	NDRG2	21024215	21024234	0	20	153	5997	153	5977	0.0	0.025598126150242595
chr14	NDRG2	21023975	21024028	0	54	153	5997	153	5943	0.0	0.02574457344775366
chr14	NDRG2	21023975	21023984	0	10	153	5997	153	5987	0.0	0.025555369968264574
chr14	NDRG2	21024825	21024836	0	12	153	5997	153	5985	0.0	0.02556390977443609
chr14	NDRG2	21024837	21024847	0	11	153	5997	153	5986	0.0	0.025559639158035417
chr14	NDRG2	21025470	21025675	0	206	153	5997	153	5791	0.0	0.02642030737351062
chr14	ZNF219	21094390	21094418	0	29	0	5150	0	5121	0.0	0.0
chr14	OR5AU1	21158345	21158821	1377	477	55362	8411	53985	7934	2.8867924528301887	6.804260146206201
chr14	HNRNPC	21230957	21230995	0	39	612	5164	612	5125	0.0	0.11941463414634146
chr14	HNRNPC	21262600	21263309	0	710	612	5164	612	4454	0.0	0.13740458015267176
chr14	CHD8	21430800	21431809	0	1010	459	13518	459	12508	0.0	0.03669651423089223
chr14	SALL2	21536848	21536960	113	113	1019	4770	906	4657	1.0	0.19454584496456948
chr14	DAD1	22588946	22589034	0	89	0	765	0	676	0.0	0.0
chr14	DAD1	22588946	22589029	0	84	0	765	0	681	0.0	0.0
chr14	DAD1	22589030	22589034	0	5	0	765	0	760	0.0	0.0
chr14	SLC7A7	22815313	22815318	0	6	146	4786	146	4780	0.0	0.030543933054393305
chr14	PRMT5	22922175	22922208	0	34	0	3100	0	3066	0.0	0.0
chr14	PRMT5	22924269	22924304	0	36	0	3100	0	3064	0.0	0.0
chr14	PRMT5	22926505	22926522	0	18	0	3100	0	3082	0.0	0.0
chr14	PRMT5	22929166	22929250	0	85	0	3100	0	3015	0.0	0.0
chr14	PRMT5	22929166	22929217	0	52	0	3100	0	3048	0.0	0.0
chr14	PRMT5	22929166	22929332	0	167	0	3100	0	2933	0.0	0.0
chr14	PRMT5	22920839	22920986	0	148	0	3100	0	2952	0.0	0.0
chr14	PRMT5	22929251	22929332	0	82	0	3100	0	3018	0.0	0.0
chr14	PRMT5	22929218	22929250	0	33	0	3100	0	3067	0.0	0.0
chr14	PRMT5	22929218	22929332	0	115	0	3100	0	2985	0.0	0.0
chr14	HAUS4	22956915	22956922	0	8	0	2413	0	2405	0.0	0.0
chr14	HAUS4	22956745	22956914	0	170	0	2413	0	2243	0.0	0.0
chr14	HAUS4	22956745	22956922	0	178	0	2413	0	2235	0.0	0.0
chr14	C14ORF93	23010016	23010099	0	84	0	3210	0	3126	0.0	0.0
chr14	C14ORF93	23010016	23010064	0	49	0	3210	0	3161	0.0	0.0
chr14	PSMB5	23034475	23034682	1173	208	1672	1347	499	1139	5.639423076923077	0.43810359964881473
chr14	ACIN1	23071124	23071425	0	302	62647	7290	62647	6988	0.0	8.964939896966229
chr14	PPP1R3E	23301297	23301396	6500	100	137241	4258	130741	4158	65.0	31.443241943241944
chr14	SLC22A17	23347459	23347512	1329	54	390628	4288	389299	4234	24.61111111111111	91.94591402928673
chr14	AP1G2	23567110	23567235	52837	126	328187	5143	275350	5017	419.3412698412698	54.88339645206299
chr14	AP1G2	23567596	23567737	41222	142	328187	5143	286965	5001	290.2957746478873	57.381523695260945
chr14	DHRS4-AS1	23953773	23954123	255	351	34949	7706	34694	7355	0.7264957264957265	4.717063222297757
chr14	DHRS4-AS1	23953308	23953772	255	465	34949	7706	34694	7241	0.5483870967741935	4.791327164756249
chr14	DHRS4-AS1	23953308	23953572	0	265	34949	7706	34949	7441	0.0	4.696814944227927
chr14	DHRS4-AS1	23953308	23954123	510	816	34949	7706	34439	6890	0.625	4.9984034833091435
chr14	DHRS4-AS1	23953573	23953772	255	200	34949	7706	34694	7506	1.275	4.62216893152145
chr14	DHRS4-AS1	23953573	23954123	510	551	34949	7706	34439	7155	0.925589836660617	4.813277428371768
chr14	DHRS4-AS1	24052297	24052385	0	89	34949	7706	34949	7617	0.0	4.588289352763555
chr14	DHRS4-AS1	23952597	23953772	255	1176	34949	7706	34694	6530	0.21683673469387754	5.3130168453292494
chr14	DHRS4-AS1	23952597	23953307	0	711	34949	7706	34949	6995	0.0	4.996283059328092
chr14	DHRS4-AS1	23952597	23953572	0	976	34949	7706	34949	6730	0.0	5.193016344725112
chr14	DHRS4-AS1	23952597	23954123	510	1527	34949	7706	34439	6179	0.33398821218074654	5.573555591519663
chr14	NRL	24081679	24081766	0	88	3316	4561	3316	4473	0.0	0.7413369103509948
chr14	EMC9	24141106	24141346	0	241	0	1307	0	1066	0.0	0.0
chr14	IPO4	24180682	24180687	0	6	556	4634	556	4628	0.0	0.12013828867761452
chr14	TM9SF1	24190379	24190429	0	51	0	2941	0	2890	0.0	0.0
chr14	TM9SF1	24195345	24195548	0	204	0	2941	0	2737	0.0	0.0
chr14	TM9SF1	24195308	24195344	0	37	0	2941	0	2904	0.0	0.0
chr14	TM9SF1	24195308	24195548	0	241	0	2941	0	2700	0.0	0.0
chr14	CHMP4A	24211410	24211413	0	4	51	1933	51	1929	0.0	0.026438569206842923
chr14	MDP1	24214491	24214544	0	54	0	1029	0	975	0.0	0.0
chr14	NEDD8	24218058	24218131	0	74	102	3793	102	3719	0.0	0.027426727614950255
chr14	TINF2	24242140	24242375	0	236	0	2610	0	2374	0.0	0.0
chr14	TGM1	24263933	24263992	0	60	0	3450	0	3390	0.0	0.0
chr14	RABGGTA	24270333	24270358	0	26	0	3090	0	3064	0.0	0.0
chr14	RABGGTA	24271112	24271485	0	374	0	3090	0	2716	0.0	0.0
chr14	RABGGTA	24267865	24267868	0	4	0	3090	0	3086	0.0	0.0
chr14	DHRS1	24292620	24292650	0	31	0	4668	0	4637	0.0	0.0
chr14	ADCY4	24326078	24326103	0	26	0	7362	0	7336	0.0	0.0
chr14	ADCY4	24334493	24334982	0	490	0	7362	0	6872	0.0	0.0
chr14	ADCY4	24334884	24334982	0	99	0	7362	0	7263	0.0	0.0
chr14	RIPK3	24338210	24338247	0	38	0	2737	0	2699	0.0	0.0
chr14	SDR39U1	24441673	24441676	0	4	564	2120	564	2116	0.0	0.2665406427221172
chr14	SDR39U1	24442812	24442816	0	5	564	2120	564	2115	0.0	0.26666666666666666
chr14	SDR39U1	24442097	24442176	490	80	564	2120	74	2040	6.125	0.03627450980392157
chr14	SDR39U1	24442097	24442107	231	11	564	2120	333	2109	21.0	0.15789473684210525
chr14	SDR39U1	24442108	24442176	259	69	564	2120	305	2051	3.753623188405797	0.14870794734275963
chr14	STXBP6	25049206	25049876	0	671	7213	8079	7213	7408	0.0	0.9736771058315334
chr14	AL390334.1	27656337	27656441	0	105	51	1674	51	1569	0.0	0.032504780114722756
chr14	FOXG1-AS1	28765142	28765158	0	17	0	4513	0	4496	0.0	0.0
chr14	LINC02281	28830073	28830124	0	52	28	431	28	379	0.0	0.07387862796833773
chr14	AL133166.1	29267599	29267732	0	134	7769	11324	7769	11190	0.0	0.6942806076854334
chr14	AL049830.3	30889119	30889141	0	23	0	2531	0	2508	0.0	0.0
chr14	HECTD1	31122913	31122918	0	6	48561	11639	48561	11633	0.0	4.174417605088971
chr14	HECTD1	31207015	31207389	0	375	48561	11639	48561	11264	0.0	4.311168323863637
chr14	AL139353.1	31457028	31457281	51	254	119192	4448	119141	4194	0.20078740157480315	28.40748688602766
chr14	EGLN3	33950395	33950676	0	282	0	4709	0	4427	0.0	0.0
chr14	EAPP	34539255	34539553	0	299	0	1953	0	1654	0.0	0.0
chr14	CFL2	34713253	34713506	0	254	0	4948	0	4694	0.0	0.0
chr14	CFL2	34713253	34713395	0	143	0	4948	0	4805	0.0	0.0
chr14	CFL2	34713642	34713672	0	31	0	4948	0	4917	0.0	0.0
chr14	CFL2	34713396	34713506	0	111	0	4948	0	4837	0.0	0.0
chr14	CFL2	34714434	34714536	0	103	0	4948	0	4845	0.0	0.0
chr14	SRP54-AS1	34982423	34982428	0	6	110	1535	110	1529	0.0	0.07194244604316546
chr14	PPP2R3C	35109818	35109846	0	29	62821	3757	62821	3728	0.0	16.85112660944206
chr14	PPP2R3C	35108094	35108137	0	44	62821	3757	62821	3713	0.0	16.919202800969565
chr14	RALGAPA1	35688458	35689834	102	1377	16038	14305	15936	12928	0.07407407407407407	1.2326732673267327
chr14	LINC00639	38835541	38838839	0	3299	0	9470	0	6171	0.0	0.0
chr14	TRAPPC6B	39170014	39170016	0	3	0	4538	0	4535	0.0	0.0
chr14	TRAPPC6B	39159449	39159481	0	33	0	4538	0	4505	0.0	0.0
chr14	AL161752.1	44393608	44393616	0	9	0	270	0	261	0.0	0.0
chr14	LINC02277	44478719	44478727	0	9	0	709	0	700	0.0	0.0
chr14	KLHL28	44961596	44961844	0	249	0	7833	0	7584	0.0	0.0
chr14	MDGA2	47342941	47343096	0	156	0	8746	0	8590	0.0	0.0
chr14	LINC01588	50005363	50005592	0	230	284004	13032	284004	12802	0.0	22.18434619590689
chr14	LINC01588	49992995	49993001	67	7	284004	13032	283937	13025	9.571428571428571	21.799385796545106
chr14	VCPKMT	50116068	50116078	11	11	40874	2061	40863	2050	1.0	19.933170731707317
chr14	MAP4K5	50532399	50532446	0	48	1878	7433	1878	7385	0.0	0.25429925524712255
chr14	NIN	50759856	50759992	0	137	31969	13565	31969	13428	0.0	2.380771522192434
chr14	NIN	50771315	50771330	32	16	31969	13565	31937	13549	2.0	2.3571481290132112
chr14	ERO1A	52678318	52678432	0	115	136	7564	136	7449	0.0	0.018257484226070615
chr14	FERMT2	52950827	52950919	0	93	0	6261	0	6168	0.0	0.0
chr14	FERMT2	52928019	52928344	0	326	0	6261	0	5935	0.0	0.0
chr14	BMP4	53956549	53956757	0	209	0	2108	0	1899	0.0	0.0
chr14	WDHD1	55026710	55027026	0	317	80252	6411	80252	6094	0.0	13.169018706924843
chr14	LINC00520	55796602	55796670	0	69	32	2977	32	2908	0.0	0.011004126547455296
chr14	LINC00520	55793045	55793366	1224	322	32	2977	-1192	2655	3.801242236024845	-0.44896421845574386
chr14	AL137100.3	56992068	56992198	0	131	1554	4378	1554	4247	0.0	0.36590534494937604
chr14	CCDC198	57493492	57493511	0	20	0	4116	0	4096	0.0	0.0
chr14	CCDC198	57490941	57490987	0	47	0	4116	0	4069	0.0	0.0
chr14	SLC35F4	57596686	57596797	0	112	51	4288	51	4176	0.0	0.01221264367816092
chr14	SLC35F4	57595734	57596685	0	952	51	4288	51	3336	0.0	0.015287769784172662
chr14	SLC35F4	57595734	57596797	0	1064	51	4288	51	3224	0.0	0.015818858560794045
chr14	ARMH4	58137989	58138346	0	358	0	4073	0	3715	0.0	0.0
chr14	L3HYPDH	59483489	59483678	0	190	51	3501	51	3311	0.0	0.015403201449713078
chr14	L3HYPDH	59483679	59483807	0	129	51	3501	51	3372	0.0	0.015124555160142349
chr14	DHRS7	60149352	60149448	0	97	0	3008	0	2911	0.0	0.0
chr14	TRMT5	60980962	60981022	0	61	0	5519	0	5458	0.0	0.0
chr14	TRMT5	60980843	60980961	0	119	0	5519	0	5400	0.0	0.0
chr14	TRMT5	60980843	60981022	0	180	0	5519	0	5339	0.0	0.0
chr14	LINC01303	61560742	61565117	4682	4376	4740	5194	58	818	1.069926873857404	0.07090464547677261
chr14	PPP2R5E	63382055	63382069	0	15	102	6784	102	6769	0.0	0.015068695523711036
chr14	TEX21P	64353952	64353999	0	48	204	3094	204	3046	0.0	0.066973079448457
chr14	GPX2	64942504	64942665	0	162	1436	1444	1436	1282	0.0	1.1201248049921997
chr14	RAB15	64950942	64951072	6909	131	61330	4909	54421	4778	52.74045801526717	11.389912097111763
chr14	RAB15	64972694	64972708	13	15	61330	4909	61317	4894	0.8666666666666667	12.529015120555783
chr14	RAB15	64950578	64950941	17937	364	61330	4909	43393	4545	49.277472527472526	9.547414741474148
chr14	RAB15	64950578	64951072	24846	495	61330	4909	36484	4414	50.193939393939395	8.26551880380607
chr14	MAX	65077327	65077342	0	16	102	5511	102	5495	0.0	0.01856232939035487
chr14	MAX	65102303	65102507	0	205	102	5511	102	5306	0.0	0.019223520542781758
chr14	PLEK2	67388218	67388222	0	5	0	1579	0	1574	0.0	0.0
chr14	PIGH	67593727	67593741	0	15	0	2424	0	2409	0.0	0.0
chr14	VTI1B	67656411	67656414	0	4	78634	5775	78634	5771	0.0	13.625714780800555
chr14	RDH11	67692933	67692971	12	39	51	3089	39	3050	0.3076923076923077	0.012786885245901639
chr14	ZFYVE26	67782779	67783097	1020	319	68756	15344	67736	15025	3.197492163009404	4.508219633943428
chr14	ZFYVE26	67777513	67777557	0	45	68756	15344	68756	15299	0.0	4.494149944440813
chr14	ZFP36L1	68796042	68796073	0	32	1938	4219	1938	4187	0.0	0.46286123716264627
chr14	ACTN1	68978176	68978215	0	40	2737	9387	2737	9347	0.0	0.292821226061838
chr14	ACTN1	68978015	68978175	0	161	2737	9387	2737	9226	0.0	0.2966616084977238
chr14	ACTN1	68978015	68978215	0	201	2737	9387	2737	9186	0.0	0.2979534073590246
chr14	ACTN1	68977949	68978175	608	227	2737	9387	2129	9160	2.6784140969162995	0.2324235807860262
chr14	ACTN1	68977949	68978215	608	267	2737	9387	2129	9120	2.2771535580524342	0.23344298245614034
chr14	ACTN1	68977949	68978014	608	66	2737	9387	2129	9321	9.212121212121213	0.22840896899474306
chr14	DCAF5	69152764	69152942	77	179	2082	8307	2005	8128	0.4301675977653631	0.24667814960629922
chr14	DCAF5	69152413	69152487	0	75	2082	8307	2082	8232	0.0	0.2529154518950437
chr14	MAP3K9	70739897	70740040	0	144	38782	12402	38782	12258	0.0	3.163811388480992
chr14	ZFYVE1	72986891	72986895	0	5	51	5233	51	5228	0.0	0.009755164498852333
chr14	AC005280.2	73462528	73462599	204	72	5112	1417	4908	1345	2.8333333333333335	3.64907063197026
chr14	ENTPD5	74015823	74015846	0	24	114290	8498	114290	8474	0.0	13.487137125324523
chr14	ALDH6A1	74072202	74072240	0	39	40563	6675	40563	6636	0.0	6.112567811934901
chr14	ABCD4	74288659	74288714	0	56	102	8153	102	8097	0.0	0.012597258243793997
chr14	ABCD4	74297638	74297928	0	291	102	8153	102	7862	0.0	0.012973798015772068
chr14	NPC2	74480701	74480709	0	9	10930	2591	10930	2582	0.0	4.233152594887684
chr14	NPC2	74480685	74480700	0	16	10930	2591	10930	2575	0.0	4.244660194174758
chr14	NPC2	74480685	74480709	0	25	10930	2591	10930	2566	0.0	4.259547934528449
chr14	LTBP2	74502563	74502651	0	89	23804	9114	23804	9025	0.0	2.6375623268698063
chr14	AC013451.2	74616572	74616586	0	15	0	704	0	689	0.0	0.0
chr14	AREL1	74675698	74675739	0	42	11649	7250	11649	7208	0.0	1.6161209766925637
chr14	RPS6KL1	74921977	74922339	102	363	171	4369	69	4006	0.2809917355371901	0.017224163754368447
chr14	RPS6KL1	74907387	74907433	0	47	171	4369	171	4322	0.0	0.03956501619620546
chr14	MLH3	75051379	75051413	0	35	69277	6620	69277	6585	0.0	10.520425208807897
chr14	MLH3	75051379	75051437	0	59	69277	6620	69277	6561	0.0	10.558908702941626
chr14	MLH3	75051414	75051437	0	24	69277	6620	69277	6596	0.0	10.502880533656763
chr14	ACYP1	75063953	75063970	0	18	1742	1809	1742	1791	0.0	0.972640982691234
chr14	NEK9	75126702	75126903	1531	202	14785	13134	13254	12932	7.579207920792079	1.0248994741725952
chr14	NEK9	75106465	75106500	0	36	14785	13134	14785	13098	0.0	1.1287982898152389
chr14	NEK9	75086647	75086779	0	133	14785	13134	14785	13001	0.0	1.1372202138297054
chr14	LINC02289	77076104	77076298	0	195	0	3491	0	3296	0.0	0.0
chr14	POMT2	77306336	77306400	0	65	273	7097	273	7032	0.0	0.038822525597269626
chr14	VIPAS39	77457094	77457316	0	223	584	3451	584	3228	0.0	0.1809169764560099
chr14	VIPAS39	77457094	77457493	0	400	584	3451	584	3051	0.0	0.19141265158964274
chr14	VIPAS39	77457317	77457493	0	177	584	3451	584	3274	0.0	0.17837507635919364
chr14	ISM2	77498223	77498315	0	93	0	4104	0	4011	0.0	0.0
chr14	ISM2	77498316	77498651	0	336	0	4104	0	3768	0.0	0.0
chr14	ISM2	77498223	77498651	0	429	0	4104	0	3675	0.0	0.0
chr14	LINC02308	81442284	81442364	0	81	0	785	0	704	0.0	0.0
chr14	LINC02305	83914978	83915039	0	62	0	1003	0	941	0.0	0.0
chr14	LINC02316	86061402	86061516	0	115	1530	3279	1530	3164	0.0	0.4835651074589128
chr14	PTPN21	88468915	88468985	0	71	102	7692	102	7621	0.0	0.013384070331977431
chr14	PTPN21	88551235	88551310	0	76	102	7692	102	7616	0.0	0.013392857142857142
chr14	FOXN3	89190383	89190385	0	3	0	11177	0	11174	0.0	0.0
chr14	EFCAB11	89954585	89954731	0	147	54	7113	54	6966	0.0	0.007751937984496124
chr14	PPP4R3A	91475810	91475848	0	39	510	5929	510	5890	0.0	0.0865874363327674
chr14	TC2N	91836182	91836369	0	188	26210	6166	26210	5978	0.0	4.3844095015055204
chr14	ATXN3	92080952	92080963	0	12	102	9265	102	9253	0.0	0.011023451853452933
chr14	LGMN	92718746	92718772	0	27	0	3797	0	3770	0.0	0.0
chr14	LGMN	92712722	92712803	0	82	0	3797	0	3715	0.0	0.0
chr14	LGMN	92741704	92741716	0	13	0	3797	0	3784	0.0	0.0
chr14	GON7	93206829	93206907	0	79	0	1048	0	969	0.0	0.0
chr14	SERPINA6	94313886	94314034	0	149	0	1852	0	1703	0.0	0.0
chr14	SERPINA1	94390419	94390455	0	37	0	4706	0	4669	0.0	0.0
chr14	SERPINA1	94380650	94380869	0	220	0	4706	0	4486	0.0	0.0
chr14	SERPINA1	94388800	94388817	0	18	0	4706	0	4688	0.0	0.0
chr14	DICER1	95157229	95157389	0	161	63	10278	63	10117	0.0	0.006227142433527726
chr14	SNHG10	95533692	95534512	0	821	0	4852	0	4031	0.0	0.0
chr14	SNHG10	95533692	95534033	0	342	0	4852	0	4510	0.0	0.0
chr14	SNHG10	95533692	95534591	0	900	0	4852	0	3952	0.0	0.0
chr14	SNHG10	95534513	95534591	0	79	0	4852	0	4773	0.0	0.0
chr14	SNHG10	95534034	95534512	0	479	0	4852	0	4373	0.0	0.0
chr14	SNHG10	95534034	95534591	0	558	0	4852	0	4294	0.0	0.0
chr14	TCL1A	95711748	95711752	0	5	0	1869	0	1864	0.0	0.0
chr14	TCL1A	95712550	95712678	0	129	0	1869	0	1740	0.0	0.0
chr14	AL133167.1	95866029	95866178	0	150	51	1083	51	933	0.0	0.05466237942122187
chr14	WARS1	100375282	100375509	0	228	32313	6022	32313	5794	0.0	5.576976182257508
chr14	DIO3OS	101557648	101557752	0	105	0	4042	0	3937	0.0	0.0
chr14	DIO3OS	101559799	101560250	0	452	0	4042	0	3590	0.0	0.0
chr14	HSP90AA1	102085757	102085963	0	207	102	4954	102	4747	0.0	0.021487255108489572
chr14	MOK	102225094	102225218	0	125	47925	7725	47925	7600	0.0	6.305921052631579
chr14	CINP	102355767	102355770	0	4	75713	3837	75713	3833	0.0	19.752935037829378
chr14	ANKRD9	102508640	102508734	10511	95	800225	7211	789714	7116	110.6421052631579	110.97723440134908
chr14	LINC00677	103122608	103122858	0	251	0	586	0	335	0.0	0.0
chr14	CKB	103520468	103520500	0	33	2821	2363	2821	2330	0.0	1.2107296137339056
chr14	CKB	103522300	103522436	1173	137	2821	2363	1648	2226	8.562043795620438	0.7403414195867026
chr14	BAG5	103561912	103562098	0	187	0	5274	0	5087	0.0	0.0
chr14	AKT1	104793126	104794117	0	992	51	7131	51	6139	0.0	0.008307541944942173
chr14	BRF1	105247070	105247286	190	217	329275	12275	329085	12058	0.8755760368663594	27.291839442693647
chr14	BRF1	105246865	105247069	320	205	329275	12275	328955	12070	1.5609756097560976	27.25393537696769
chr14	BRF1	105226102	105226112	0	11	329275	12275	329275	12264	0.0	26.848907371167645
chr14	BRF1	105315321	105315340	0	20	329275	12275	329275	12255	0.0	26.868625050999594
chr14	BRF1	105247287	105248073	3672	787	329275	12275	325603	11488	4.6658195679796695	28.342879526462397
chr14	AL928654.1	105418938	105419020	49419	83	427549	2368	378130	2285	595.4096385542168	165.4835886214442
chr15	LINC01193	20940767	20940770	0	4	1224	6672	1224	6668	0.0	0.1835632873425315
chr15	LINC01193	20981969	20981980	0	12	1224	6672	1224	6660	0.0	0.1837837837837838
chr15	LINC01193	20979119	20979357	0	239	1224	6672	1224	6433	0.0	0.19026892585108038
chr15	AC134980.1	21990152	21990390	0	239	0	2337	0	2098	0.0	0.0
chr15	WHAMMP3	22664961	22665334	0	374	130	5719	130	5345	0.0	0.02432179607109448
chr15	NIPA2	22838922	22838947	0	26	36720	4741	36720	4715	0.0	7.7879109225874865
chr15	NIPA2	22838948	22839174	0	227	36720	4741	36720	4514	0.0	8.134692069118298
chr15	NIPA2	22838922	22839174	0	253	36720	4741	36720	4488	0.0	8.181818181818182
chr15	GOLGA8DP	23165866	23165875	0	10	1174	5274	1174	5264	0.0	0.2230243161094225
chr15	MKRN3	23565834	23566087	0	254	357	7026	357	6772	0.0	0.05271707028942705
chr15	MKRN3	23566088	23566709	0	622	357	7026	357	6404	0.0	0.05574640849469082
chr15	MKRN3	23565834	23566709	0	876	357	7026	357	6150	0.0	0.05804878048780488
chr15	PWRN4	23914827	23914915	0	89	132	4181	132	4092	0.0	0.03225806451612903
chr15	PWRN1	24507424	24507478	0	55	51	22178	51	22123	0.0	0.002305293133842607
chr15	PWRN1	24299715	24299769	0	55	51	22178	51	22123	0.0	0.002305293133842607
chr15	PWRN1	24276659	24276710	0	52	51	22178	51	22126	0.0	0.002304980565850131
chr15	PWRN1	24346553	24346586	0	34	51	22178	51	22144	0.0	0.002303106936416185
chr15	PWRN1	24574745	24574813	0	69	51	22178	51	22109	0.0	0.002306752906056357
chr15	SNRPN	24823824	24823850	0	27	0	3407	0	3380	0.0	0.0
chr15	SNRPN	24967153	24967240	0	88	0	3407	0	3319	0.0	0.0
chr15	SNHG14	25042516	25042910	0	395	1269	110104	1269	109709	0.0	0.011566963512565058
chr15	SNHG14	25095729	25095828	0	100	1269	110104	1269	110004	0.0	0.011535944147485546
chr15	SNHG14	25099279	25102147	0	2869	1269	110104	1269	107235	0.0	0.011833822912295426
chr15	SNHG14	25101932	25102147	0	216	1269	110104	1269	109888	0.0	0.0115481217239371
chr15	SNHG14	25100891	25102147	0	1257	1269	110104	1269	108847	0.0	0.01165856661184966
chr15	SNHG14	25109100	25109103	0	4	1269	110104	1269	110100	0.0	0.011525885558583106
chr15	SNHG14	25109671	25109715	0	45	1269	110104	1269	110059	0.0	0.011530179267483804
chr15	SNHG14	25053968	25054866	0	899	1269	110104	1269	109205	0.0	0.011620347053706332
chr15	SNHG14	25051677	25052140	0	464	1269	110104	1269	109640	0.0	0.011574242977015687
chr15	SNHG14	25053968	25055230	0	1263	1269	110104	1269	108841	0.0	0.01165920930531693
chr15	SNHG14	25056623	25057088	0	466	1269	110104	1269	109638	0.0	0.011574454112625185
chr15	SNHG14	25093975	25095828	51	1854	1269	110104	1218	108250	0.02750809061488673	0.011251732101616629
chr15	SNHG14	25086465	25086614	0	150	1269	110104	1269	109954	0.0	0.011541189952161813
chr15	SNHG14	25099279	25100290	0	1012	1269	110104	1269	109092	0.0	0.011632383676163238
chr15	SNHG14	25099647	25100290	0	644	1269	110104	1269	109460	0.0	0.011593276082587246
chr15	SNHG14	25111895	25115656	153	3762	1269	110104	1116	106342	0.04066985645933014	0.010494442459235297
chr15	SNHG14	25234618	25234619	0	2	1269	110104	1269	110102	0.0	0.01152567619116819
chr15	SNHG14	25250812	25250814	0	3	1269	110104	1269	110101	0.0	0.01152578087392485
chr15	SNHG14	25247289	25247289	0	1	1269	110104	1269	110103	0.0	0.01152557151031307
chr15	SNHG14	25266383	25266614	0	232	1269	110104	1269	109872	0.0	0.011549803407601573
chr15	LINC00929	26116285	26116700	0	416	0	3665	0	3249	0.0	0.0
chr15	LINC00929	26116301	26116700	0	400	0	3665	0	3265	0.0	0.0
chr15	LINC00929	26116478	26116700	0	223	0	3665	0	3442	0.0	0.0
chr15	LINC00929	26116285	26116300	0	16	0	3665	0	3649	0.0	0.0
chr15	LINC00929	26116285	26116477	0	193	0	3665	0	3472	0.0	0.0
chr15	LINC00929	26116301	26116477	0	177	0	3665	0	3488	0.0	0.0
chr15	GABRA5	26867385	26867418	0	34	0	3621	0	3587	0.0	0.0
chr15	GOLGA8F	28378681	28378809	1651	129	34059	5682	32408	5553	12.7984496124031	5.836124617323969
chr15	HERC2P9	28641227	28641312	0	86	38	8168	38	8082	0.0	0.0047018064835436775
chr15	HERC2P9	28655421	28655691	0	271	38	8168	38	7897	0.0	0.00481195390654679
chr15	WHAMMP2	28741267	28741283	0	17	102	6666	102	6649	0.0	0.015340652729733794
chr15	WHAMMP2	28751675	28751678	0	4	102	6666	102	6662	0.0	0.015310717502251577
chr15	PDCD6IPP2	28801493	28801496	0	4	6668	5256	6668	5252	0.0	1.2696115765422695
chr15	APBA2	28921719	28921749	0	31	6027	6889	6027	6858	0.0	0.878827646544182
chr15	FAN1	30904591	30905353	255	763	141866	15722	141611	14959	0.33420707732634336	9.466608730530115
chr15	FAN1	30905354	30905897	0	544	141866	15722	141866	15178	0.0	9.34681776255106
chr15	FAN1	30904591	30905897	255	1307	141866	15722	141611	14415	0.19510328997704668	9.82386403052376
chr15	FAN1	30903888	30903894	7	7	141866	15722	141859	15715	1.0	9.026980591791283
chr15	FAN1	30904012	30904024	0	13	141866	15722	141866	15709	0.0	9.030874021261697
chr15	FAN1	30903888	30904024	525	137	141866	15722	141341	15585	3.832116788321168	9.069040744305422
chr15	FAN1	30903895	30904024	518	130	141866	15722	141348	15592	3.9846153846153847	9.065418163160595
chr15	FAN1	30903895	30904011	518	117	141866	15722	141348	15605	4.427350427350428	9.057866068567767
chr15	CHRNA7	32157772	32157775	0	4	612	13012	612	13008	0.0	0.0470479704797048
chr15	CHRNA7	32030650	32030736	0	87	612	13012	612	12925	0.0	0.047350096711798836
chr15	ARHGAP11A	32629676	32629762	0	87	203	6156	203	6069	0.0	0.03344867358708189
chr15	ARHGAP11A	32615919	32616340	0	422	203	6156	203	5734	0.0	0.03540286013254273
chr15	RYR3	33807570	33807800	0	231	205	19804	205	19573	0.0	0.010473611607827109
chr15	EMC4	34225651	34225658	0	8	15	2766	15	2758	0.0	0.005438723712835388
chr15	DPH6-DT	35711792	35711889	0	98	0	2857	0	2759	0.0	0.0
chr15	TMCO5A	37941731	37941743	0	13	51	4376	51	4363	0.0	0.01168920467568187
chr15	AC109630.1	39479353	39479499	0	147	2428	3057	2428	2910	0.0	0.8343642611683849
chr15	AC109630.1	39479264	39479352	0	89	2428	3057	2428	2968	0.0	0.8180592991913747
chr15	AC109630.1	39479264	39479499	0	236	2428	3057	2428	2821	0.0	0.8606876993973768
chr15	AC109630.1	39473895	39473933	0	39	2428	3057	2428	3018	0.0	0.8045062955599734
chr15	BUB1B	40170572	40170681	0	110	3919	4281	3919	4171	0.0	0.9395828338527931
chr15	BUB1B	40170122	40170163	0	42	3919	4281	3919	4239	0.0	0.9245104977589054
chr15	PAK6	40239136	40239802	0	667	10384	6404	10384	5737	0.0	1.8100052292138749
chr15	KNSTRN	40387207	40387218	0	12	42631	3389	42631	3377	0.0	12.623926562037312
chr15	IVD	40407726	40407812	0	87	51	6598	51	6511	0.0	0.007832898172323759
chr15	RPUSD2	40569761	40569943	0	183	19238	2459	19238	2276	0.0	8.452548330404218
chr15	RAD51	40695322	40695425	0	104	9327	2952	9327	2848	0.0	3.274929775280899
chr15	RAD51	40695426	40695860	0	435	9327	2952	9327	2517	0.0	3.705601907032181
chr15	RAD51	40695627	40695860	0	234	9327	2952	9327	2718	0.0	3.431567328918322
chr15	ZFYVE19	40807822	40807868	0	47	374	3308	374	3261	0.0	0.114688745783502
chr15	ZFYVE19	40807672	40807868	0	197	374	3308	374	3111	0.0	0.12021857923497267
chr15	SPINT1	40853882	40853929	0	48	1929	3461	1929	3413	0.0	0.5651919132727805
chr15	SPINT1	40844187	40844278	0	92	1929	3461	1929	3369	0.0	0.572573463935886
chr15	OIP5-AS1	41284111	41284288	0	178	9163	12683	9163	12505	0.0	0.7327469012395041
chr15	NUSAP1	41332996	41333050	0	55	3261	3040	3261	2985	0.0	1.092462311557789
chr15	AC020659.1	41893079	41895336	51	2258	459	4463	408	2205	0.022586359610274578	0.18503401360544217
chr15	GANC	42273445	42273829	0	385	0	10932	0	10547	0.0	0.0
chr15	GANC	42273612	42273829	0	218	0	10932	0	10714	0.0	0.0
chr15	GANC	42273445	42273611	0	167	0	10932	0	10765	0.0	0.0
chr15	GANC	42273830	42274044	0	215	0	10932	0	10717	0.0	0.0
chr15	CAPN3	42402916	42403002	0	87	290	10244	290	10157	0.0	0.028551737717830067
chr15	CAPN3	42410927	42411000	0	74	290	10244	290	10170	0.0	0.028515240904621434
chr15	CAPN3	42404852	42404955	0	104	290	10244	290	10140	0.0	0.028599605522682446
chr15	CAPN3	42408141	42408324	0	184	290	10244	290	10060	0.0	0.02882703777335984
chr15	CAPN3	42404956	42404968	0	13	290	10244	290	10231	0.0	0.02834522529567002
chr15	CAPN3	42404852	42404968	0	117	290	10244	290	10127	0.0	0.028636318751851485
chr15	CAPN3	42404852	42405943	51	1092	290	10244	239	9152	0.046703296703296704	0.026114510489510488
chr15	CAPN3	42404956	42405943	51	988	290	10244	239	9256	0.05161943319838057	0.025821089023336213
chr15	CAPN3	42404969	42405943	51	975	290	10244	239	9269	0.052307692307692305	0.02578487431222354
chr15	CAPN3	42404956	42408324	51	3369	290	10244	239	6875	0.015138023152270703	0.034763636363636365
chr15	CAPN3	42404969	42408324	51	3356	290	10244	239	6888	0.015196662693682956	0.03469802555168409
chr15	CAPN3	42404852	42408324	51	3473	290	10244	239	6771	0.01468471062482004	0.03529759267464185
chr15	CAPN3	42405944	42408324	0	2381	290	10244	290	7863	0.0	0.03688159735469922
chr15	CAPN3	42408325	42408437	0	113	290	10244	290	10131	0.0	0.028625012338367388
chr15	CAPN3	42409996	42410274	0	279	290	10244	290	9965	0.0	0.029101856497742096
chr15	SNAP23	42492946	42492957	0	12	38154	5373	38154	5361	0.0	7.1169557918298825
chr15	SNAP23	42495714	42495931	0	218	38154	5373	38154	5155	0.0	7.401357904946654
chr15	STARD9	42585635	42585637	0	3	18155	20421	18155	20418	0.0	0.8891664217846997
chr15	TUBGCP4	43403800	43403842	0	43	154381	9091	154381	9048	0.0	17.06244473916888
chr15	CKMT1B	43593680	43593711	0	32	0	3278	0	3246	0.0	0.0
chr15	SERF2	43792384	43792611	0	228	11305	8388	11305	8160	0.0	1.3854166666666667
chr15	SERF2	43792579	43792611	0	33	11305	8388	11305	8355	0.0	1.353081986834231
chr15	SERF2	43792384	43792578	0	195	11305	8388	11305	8193	0.0	1.3798364457463688
chr15	WDR76	43827093	43827118	1080	26	54411	4060	53331	4034	41.53846153846154	13.220376797223599
chr15	CTDSPL2	44427693	44427772	0	80	854	9295	854	9215	0.0	0.09267498643516006
chr15	CTDSPL2	44427894	44428005	0	112	854	9295	854	9183	0.0	0.09299793095938147
chr15	CTDSPL2	44427894	44428095	0	202	854	9295	854	9093	0.0	0.0939183987682833
chr15	CTDSPL2	44428006	44428095	0	90	854	9295	854	9205	0.0	0.09277566539923954
chr15	TRIM69	44758804	44758854	2	51	4488	6935	4486	6884	0.0392156862745098	0.6516560139453806
chr15	TRIM69	44729350	44729552	0	203	4488	6935	4488	6732	0.0	0.6666666666666666
chr15	SORD	45068979	45069052	0	74	3213	8966	3213	8892	0.0	0.36133603238866396
chr15	DUOX1	45131648	45131662	1442	15	33293	8173	31851	8158	96.13333333333334	3.904265751409659
chr15	DUOX1	45139169	45139244	33	76	33293	8173	33260	8097	0.4342105263157895	4.107694207731258
chr15	SPATA5L1	45415780	45415809	0	30	0	3407	0	3377	0.0	0.0
chr15	BLOC1S6	45597892	45597996	0	105	0	6784	0	6679	0.0	0.0
chr15	BLOC1S6	45587797	45587876	0	80	0	6784	0	6704	0.0	0.0
chr15	SQOR	45632016	45632019	0	4	459	2809	459	2805	0.0	0.16363636363636364
chr15	SEMA6D	47768616	47768748	0	133	0	8530	0	8397	0.0	0.0
chr15	SLC12A1	48220758	48220765	0	8	0	8819	0	8811	0.0	0.0
chr15	DUT	48331480	48331795	0	316	0	3152	0	2836	0.0	0.0
chr15	DUT	48331727	48331795	0	69	0	3152	0	3083	0.0	0.0
chr15	DUT	48331480	48331726	0	247	0	3152	0	2905	0.0	0.0
chr15	GALK2	49170359	49170375	11829	17	121881	7192	110052	7175	695.8235294117648	15.338257839721255
chr15	DTWD1	49621123	49621193	143	71	6964	14874	6821	14803	2.0140845070422535	0.46078497601837465
chr15	DTWD1	49621123	49621329	1469	207	6964	14874	5495	14667	7.096618357487923	0.3746505761232699
chr15	DTWD1	49621194	49621329	1326	136	6964	14874	5638	14738	9.75	0.382548514045325
chr15	GABPB1-AS1	50355766	50355788	0	23	0	4668	0	4645	0.0	0.0
chr15	GABPB1-AS1	50355546	50355788	0	243	0	4668	0	4425	0.0	0.0
chr15	GABPB1-AS1	50355784	50355788	0	5	0	4668	0	4663	0.0	0.0
chr15	GABPB1-AS1	50355546	50355765	0	220	0	4668	0	4448	0.0	0.0
chr15	GABPB1-AS1	50355766	50355783	0	18	0	4668	0	4650	0.0	0.0
chr15	GABPB1-AS1	50355789	50355932	0	144	0	4668	0	4524	0.0	0.0
chr15	GABPB1-AS1	50355766	50355932	0	167	0	4668	0	4501	0.0	0.0
chr15	GABPB1-AS1	50355784	50355932	0	149	0	4668	0	4519	0.0	0.0
chr15	USP8	50424515	50424654	0	140	1082	20665	1082	20525	0.0	0.05271619975639464
chr15	USP8	50476994	50476997	0	4	1082	20665	1082	20661	0.0	0.052369198005904845
chr15	TMOD3	51908863	51908876	0	14	2217	8470	2217	8456	0.0	0.26218070009460737
chr15	PIGB	55350804	55350912	0	109	0	3377	0	3268	0.0	0.0
chr15	TEX9	56365671	56365893	9452	223	18634	8304	9182	8081	42.38565022421525	1.1362455141690384
chr15	MINDY2	58810287	58810388	0	102	0	9464	0	9362	0.0	0.0
chr15	MINDY2	58821820	58821823	0	4	0	9464	0	9460	0.0	0.0
chr15	FAM81A	59458618	59458646	500	29	3840	5589	3340	5560	17.24137931034483	0.6007194244604317
chr15	TLN2	62836074	62836118	0	45	2731	16272	2731	16227	0.0	0.1682997473346891
chr15	TPM1	63064143	63064190	0	48	18439	12357	18439	12309	0.0	1.4980095864814365
chr15	TPM1	63064191	63064982	0	792	18439	12357	18439	11565	0.0	1.5943795936013836
chr15	TPM1	63064143	63064982	0	840	18439	12357	18439	11517	0.0	1.6010245723712773
chr15	APH1B	63277737	63277929	0	193	408	5418	408	5225	0.0	0.07808612440191387
chr15	SNX22	64153340	64153386	0	47	153	4065	153	4018	0.0	0.03807864609258337
chr15	ANKDD1A	64917485	64917514	0	30	1574	5051	1574	5021	0.0	0.3134833698466441
chr15	HACD3	65530644	65530718	0	75	21088	7025	21088	6950	0.0	3.0342446043165467
chr15	RAB11A	65792650	65792772	0	123	311878	5691	311878	5568	0.0	56.01257183908046
chr15	DIS3L	66293337	66293367	0	31	0	5320	0	5289	0.0	0.0
chr15	DIS3L	66294175	66294448	0	274	0	5320	0	5046	0.0	0.0
chr15	ZWILCH	66518970	66519078	0	109	0	4786	0	4677	0.0	0.0
chr15	SMAD3	67098769	67099024	0	256	9416	7224	9416	6968	0.0	1.3513203214695753
chr15	C15ORF61	67522122	67522204	0	83	46343	4654	46343	4571	0.0	10.138481732662438
chr15	C15ORF61	67522205	67522242	0	38	46343	4654	46343	4616	0.0	10.039644714038129
chr15	C15ORF61	67522122	67522242	0	121	46343	4654	46343	4533	0.0	10.223472314140746
chr15	SKOR1	67825626	67825709	0	84	4983	3778	4983	3694	0.0	1.348944233892799
chr15	EWSAT1	69092243	69092367	461	125	30054	3583	29593	3458	3.688	8.557836899942163
chr15	PAQR5	69337502	69337505	0	4	0	6270	0	6266	0.0	0.0
chr15	KIF23	69426458	69426656	0	199	0	6339	0	6140	0.0	0.0
chr15	DRAIC	69548486	69548631	3492	146	131161	25376	127669	25230	23.91780821917808	5.06020610384463
chr15	DRAIC	69463126	69463285	0	160	131161	25376	131161	25216	0.0	5.20149904822335
chr15	DRAIC	69526358	69526538	0	181	131161	25376	131161	25195	0.0	5.205834490970431
chr15	DRAIC	69561781	69562017	6846	237	131161	25376	124315	25139	28.88607594936709	4.945105215004575
chr15	DRAIC	69563805	69564019	13202	215	131161	25376	117959	25161	61.4046511627907	4.688168196812527
chr15	LRRC49	70893641	70893655	0	15	7240	9178	7240	9163	0.0	0.7901342355123868
chr15	LRRC49	70894670	70894755	0	86	7240	9178	7240	9092	0.0	0.796304443466784
chr15	SENP8	72117063	72117166	1369	104	7884	4933	6515	4829	13.163461538461538	1.3491406088217022
chr15	ARIH1	72580878	72580991	153	114	36523	22087	36370	21973	1.3421052631578947	1.6552132162199062
chr15	BBS4	72686252	72686564	0	313	218	4162	218	3849	0.0	0.05663808781501689
chr15	CD276	73684408	73684460	0	53	0	5220	0	5167	0.0	0.0
chr15	CD276	73684800	73684899	0	100	0	5220	0	5120	0.0	0.0
chr15	LOXL1	73949538	73949574	0	37	0	3644	0	3607	0.0	0.0
chr15	PML	74023366	74023408	0	43	30510	10347	30510	10304	0.0	2.9609860248447206
chr15	PML	74033415	74033422	0	8	30510	10347	30510	10339	0.0	2.9509623754715157
chr15	ISLR2	74129957	74129973	0	17	357	5585	357	5568	0.0	0.06411637931034483
chr15	ISLR2	74129957	74130087	0	131	357	5585	357	5454	0.0	0.06545654565456546
chr15	ISLR2	74129974	74130087	0	114	357	5585	357	5471	0.0	0.06525315298848473
chr15	CCDC33	74217434	74217581	204	148	39229	6959	39025	6811	1.3783783783783783	5.729701952723535
chr15	UBL7-AS1	74462028	74462031	0	4	13523	2142	13523	2138	0.0	6.3250701590271285
chr15	UBL7-AS1	74462032	74462098	0	67	13523	2142	13523	2075	0.0	6.51710843373494
chr15	UBL7-AS1	74462028	74462098	0	71	13523	2142	13523	2071	0.0	6.529695799130855
chr15	CLK3	74615050	74615898	0	849	0	14732	0	13883	0.0	0.0
chr15	CLK3	74615899	74615949	0	51	0	14732	0	14681	0.0	0.0
chr15	MPI	74891490	74891579	0	90	23569	7175	23569	7085	0.0	3.326605504587156
chr15	MPI	74890090	74890201	2838	112	23569	7175	20731	7063	25.339285714285715	2.9351550332719807
chr15	MPI	74890090	74890654	10251	565	23569	7175	13318	6610	18.143362831858408	2.0148260211800304
chr15	SCAMP5	74996260	74996320	0	61	10627	4634	10627	4573	0.0	2.3238574240104963
chr15	C15ORF39	75208825	75208876	0	52	28455	5813	28455	5761	0.0	4.939246658566221
chr15	COMMD4	75336093	75336221	292	129	110505	4643	110213	4514	2.2635658914728682	24.415817456801065
chr15	NEIL1	75348000	75348026	2	27	16767	6176	16765	6149	0.07407407407407407	2.7264595869247032
chr15	NEIL1	75348647	75348723	926	77	16767	6176	15841	6099	12.025974025974026	2.5973110345958355
chr15	AC019294.2	75758614	75758627	0	14	340767	6185	340767	6171	0.0	55.22070977151191
chr15	TMEM266	76156653	76156758	765	106	53891	5159	53126	5053	7.216981132075472	10.513754205422522
chr15	PSTPIP1	77028644	77028652	0	9	1530	4597	1530	4588	0.0	0.33347863993025284
chr15	PSTPIP1	77032395	77032428	0	34	1530	4597	1530	4563	0.0	0.33530571992110453
chr15	HMG20A	77458497	77458558	0	62	0	5473	0	5411	0.0	0.0
chr15	CSPG4P13	77901789	77901804	0	16	153	4825	153	4809	0.0	0.031815346225826574
chr15	IDH3A	78155252	78155275	0	24	0	5879	0	5855	0.0	0.0
chr15	DNAJA4	78274409	78274424	0	16	0	5692	0	5676	0.0	0.0
chr15	CRABP1	78341222	78341336	0	115	0	857	0	742	0.0	0.0
chr15	IREB2	78439877	78439881	0	5	2369	8021	2369	8016	0.0	0.29553393213572854
chr15	PSMA4	78540464	78540539	0	76	102	5745	102	5669	0.0	0.017992591285941082
chr15	CHRNA5	78589850	78590636	202	787	1961	3367	1759	2580	0.25667090216010163	0.681782945736434
chr15	CHRNA5	78590099	78590636	102	538	1961	3367	1859	2829	0.1895910780669145	0.6571226581831036
chr15	CHRNA5	78590507	78590636	0	130	1961	3367	1961	3237	0.0	0.6058078467717022
chr15	CHRNA5	78589850	78590098	100	249	1961	3367	1861	3118	0.40160642570281124	0.5968569595894805
chr15	MORF4L1	78873058	78873118	0	61	14290	6570	14290	6509	0.0	2.1954217237670917
chr15	MORF4L1	78873058	78873218	5722	161	14290	6570	8568	6409	35.54037267080745	1.336870026525199
chr15	MORF4L1	78873119	78873218	5722	100	14290	6570	8568	6470	57.22	1.3242658423493046
chr15	MORF4L1	78873840	78873920	0	81	14290	6570	14290	6489	0.0	2.202188318693173
chr15	ZFAND6	80075243	80075315	0	73	109021	3588	109021	3515	0.0	31.015931721194878
chr15	FAH	80152842	80152905	960	64	3192	7210	2232	7146	15.0	0.3123425692695214
chr15	FAH	80180226	80180330	0	105	3192	7210	3192	7105	0.0	0.4492610837438424
chr15	ABHD17C	80749591	80749692	0	102	1759	3627	1759	3525	0.0	0.4990070921985816
chr15	CEMIP	80873637	80873696	2185	60	37809	7651	35624	7591	36.416666666666664	4.692925833223554
chr15	IL16	81197138	81197152	7	15	54470	11081	54463	11066	0.4666666666666667	4.92165190674137
chr15	TMC3-AS1	81380255	81380260	0	6	3389	12395	3389	12389	0.0	0.27354911615142463
chr15	SAXO2	82262933	82263188	0	256	0	4166	0	3910	0.0	0.0
chr15	SNHG21	82750715	82750848	0	134	714	1055	714	921	0.0	0.7752442996742671
chr15	TM6SF1	83119682	83119734	0	53	8557	2508	8557	2455	0.0	3.4855397148676173
chr15	TM6SF1	83107773	83107886	1632	114	8557	2508	6925	2394	14.31578947368421	2.8926482873851294
chr15	LINC00933	84572340	84572344	0	5	357	3006	357	3001	0.0	0.11896034655114962
chr15	ZSCAN2	84601136	84601188	0	53	0	4531	0	4478	0.0	0.0
chr15	ZSCAN2	84604201	84604333	0	133	0	4531	0	4398	0.0	0.0
chr15	ZSCAN2	84604331	84604333	0	3	0	4531	0	4528	0.0	0.0
chr15	ZSCAN2	84604201	84604330	0	130	0	4531	0	4401	0.0	0.0
chr15	ZSCAN2	84620773	84622714	0	1942	0	4531	0	2589	0.0	0.0
chr15	SCAND2P	84632299	84632338	0	40	102	9041	102	9001	0.0	0.011332074213976225
chr15	ZNF592	84790873	84790883	0	11	1244	6050	1244	6039	0.0	0.20599436992879616
chr15	AEN	88621383	88621663	0	281	153	5979	153	5698	0.0	0.026851526851526853
chr15	ACAN	88874025	88874059	0	35	0	10933	0	10898	0.0	0.0
chr15	FANCI	89247727	89247731	0	5	0	11868	0	11863	0.0	0.0
chr15	FANCI	89244034	89244067	0	34	0	11868	0	11834	0.0	0.0
chr15	FANCI	89244045	89244067	0	23	0	11868	0	11845	0.0	0.0
chr15	FANCI	89244034	89244044	0	11	0	11868	0	11857	0.0	0.0
chr15	FANCI	89244039	89244067	0	29	0	11868	0	11839	0.0	0.0
chr15	MIR9-3HG	89362732	89362735	0	4	0	8103	0	8099	0.0	0.0
chr15	MIR9-3HG	89387498	89387538	0	41	0	8103	0	8062	0.0	0.0
chr15	MIR9-3HG	89379270	89379407	0	138	0	8103	0	7965	0.0	0.0
chr15	MIR9-3HG	89382494	89382597	0	104	0	8103	0	7999	0.0	0.0
chr15	MIR9-3HG	89388582	89388746	0	165	0	8103	0	7938	0.0	0.0
chr15	SEMA4B	90217830	90217928	23	99	28673	5402	28650	5303	0.23232323232323232	5.402602300584575
chr15	SEMA4B	90225398	90225427	1172	30	28673	5402	27501	5372	39.06666666666667	5.119322412509307
chr15	TTLL13P	90263075	90263145	0	71	52	3011	52	2940	0.0	0.017687074829931974
chr15	LINC01585	90660825	90661006	0	182	0	1507	0	1325	0.0	0.0
chr15	FURIN	90880116	90880273	0	158	41	4749	41	4591	0.0	0.008930516227401437
chr15	FES	90884545	90884639	0	95	4677	4121	4677	4026	0.0	1.161698956780924
chr15	FES	90885259	90885585	0	327	4677	4121	4677	3794	0.0	1.2327358987875594
chr15	MAN2A2	90903433	90903734	167	302	12145	9354	11978	9052	0.5529801324503312	1.3232434821034025
chr15	MAN2A2	90913375	90913406	0	32	12145	9354	12145	9322	0.0	1.3028320102982192
chr15	UNC45A	90935101	90935330	254	230	23450	7365	23196	7135	1.1043478260869566	3.2510161177295025
chr15	UNC45A	90935331	90935375	0	45	23450	7365	23450	7320	0.0	3.203551912568306
chr15	VPS33B-DT	91023436	91023594	0	159	42761	3435	42761	3276	0.0	13.052808302808304
chr15	C15ORF32	92473073	92473110	0	38	0	1790	0	1752	0.0	0.0
chr15	AC091544.2	92580844	92580895	0	52	0	3868	0	3816	0.0	0.0
chr15	CHD2	92946217	92946340	0	124	39341	16852	39341	16728	0.0	2.351805356288857
chr15	LINC02207	93844339	93844861	0	523	448	7807	448	7284	0.0	0.061504667764964306
chr15	LINC02207	93844339	93845206	0	868	448	7807	448	6939	0.0	0.06456261709179997
chr15	LINC02207	93858551	93858644	0	94	448	7807	448	7713	0.0	0.05808375469985738
chr15	LINC01580	93899291	93899405	0	115	19	2674	19	2559	0.0	0.007424775302852677
chr15	LINC01580	93899291	93899603	0	313	19	2674	19	2361	0.0	0.008047437526471834
chr15	LINC01580	93899406	93899603	0	198	19	2674	19	2476	0.0	0.007673667205169628
chr15	AC087633.2	95018870	95019043	0	174	85	3304	85	3130	0.0	0.027156549520766772
chr15	NR2F2	96332548	96332621	0	74	0	6481	0	6407	0.0	0.0
chr15	SPATA8	96783590	96783744	16	155	300	1471	284	1316	0.1032258064516129	0.21580547112462006
chr15	SPATA8	96783745	96783830	0	86	300	1471	300	1385	0.0	0.21660649819494585
chr15	SPATA8	96783590	96783830	16	241	300	1471	284	1230	0.06639004149377593	0.23089430894308943
chr15	LINC02251	98020537	98020688	0	152	0	2090	0	1938	0.0	0.0
chr15	LUNAR1	99024674	99024787	0	114	0	1690	0	1576	0.0	0.0
chr15	LRRC28	99255974	99256125	0	152	351	6078	351	5926	0.0	0.059230509618629766
chr15	AC015712.1	100850333	100850468	0	136	0	1487	0	1351	0.0	0.0
chr15	LRRK1	101022479	101022597	0	119	102	17485	102	17366	0.0	0.00587354600944374
chr15	DNM1P47	101751724	101751745	0	22	30399	13739	30399	13717	0.0	2.216155135962674
chr15	WASH3P	101974085	101974106	0	22	0	2365	0	2343	0.0	0.0
chr15	HERC2P3	20445858	20445883	0	26	2012	9444	2012	9418	0.0	0.21363346782756423
chr15	HERC2P3	20453619	20453704	0	86	2012	9444	2012	9358	0.0	0.21500320581320795
chr15	HERC2P3	20443338	20443369	0	32	2012	9444	2012	9412	0.0	0.21376965575860604
chr15	HERC2P3	20453612	20453618	0	7	2012	9444	2012	9437	0.0	0.213203348521776
chr15	CYFIP1	22916476	22916880	0	405	201111	10198	201111	9793	0.0	20.536199326049218
chr15	CYFIP1	22917622	22917786	0	165	201111	10198	201111	10033	0.0	20.044951659523573
chr15	UBE3A	25415709	25415713	0	5	0	16169	0	16164	0.0	0.0
chr15	UBE3A	25408571	25408618	0	48	0	16169	0	16121	0.0	0.0
chr15	UBE3A	25438052	25438289	0	238	0	16169	0	15931	0.0	0.0
chr15	OCA2	28099110	28099222	0	113	0	3280	0	3167	0.0	0.0
chr15	GOLGA8G	28532825	28532953	0	129	7290	6365	7290	6236	0.0	1.1690186016677357
chr15	TJP1	29704161	29704220	0	60	0	11348	0	11288	0.0	0.0
chr15	TJP1	29704161	29704199	0	39	0	11348	0	11309	0.0	0.0
chr15	TJP1	29704200	29704220	0	21	0	11348	0	11327	0.0	0.0
chr15	CHRFAM7A	30386862	30386882	0	21	153	4049	153	4028	0.0	0.03798411122144985
chr15	TRPM1	31063117	31063134	111	18	51105	7483	50994	7465	6.166666666666667	6.831078365706631
chr15	TRPM1	31063087	31063116	256	30	51105	7483	50849	7453	8.533333333333333	6.822621763048437
chr15	TRPM1	31063087	31063134	367	48	51105	7483	50738	7435	7.645833333333333	6.824209818426362
chr15	ULK4P1	32428190	32428210	0	21	37	1694	37	1673	0.0	0.02211595935445308
chr15	AC135983.2	32533194	32533210	0	17	171	2691	171	2674	0.0	0.06394913986537024
chr15	FMN1	33066510	33067792	0	1283	66417	20297	66417	19014	0.0	3.4930577469233195
chr15	TMCO5B	33246502	33246567	0	66	0	2056	0	1990	0.0	0.0
chr15	EMC7	34101603	34101763	0	161	0	1458	0	1297	0.0	0.0
chr15	SLC12A6	34337331	34337473	0	143	5865	9653	5865	9510	0.0	0.6167192429022083
chr15	SLC12A6	34237389	34237417	0	29	5865	9653	5865	9624	0.0	0.6094139650872819
chr15	GOLGA8A	34407523	34407574	0	52	116393	6731	116393	6679	0.0	17.426710585416977
chr15	GOLGA8B	34527921	34527923	0	3	98145	7660	98145	7657	0.0	12.817683165730704
chr15	ACTC1	34793244	34793296	0	53	1326	2299	1326	2246	0.0	0.5903829029385574
chr15	AQR	34906518	34906543	0	26	6508	13465	6508	13439	0.0	0.4842622218915098
chr15	CSNK1A1P1	36817726	36817934	0	209	0	2589	0	2380	0.0	0.0
chr15	RASGRP1	38564972	38565070	0	99	0	6027	0	5928	0.0	0.0
chr15	AC013652.1	38886696	38886828	0	133	51	7014	51	6881	0.0	0.0074117134137480015
chr15	BMF	40104179	40104241	0	63	80531	5238	80531	5175	0.0	15.561545893719806
chr15	BMF	40106304	40106356	0	53	80531	5238	80531	5185	0.0	15.531533269045322
chr15	PLCB2	40296745	40296756	0	12	14153	6493	14153	6481	0.0	2.183767937046752
chr15	CCDC32	40564790	40564974	3704	185	13936	8099	10232	7914	20.021621621621623	1.2928986606014659
chr15	CCDC32	40564765	40564974	5413	210	13936	8099	8523	7889	25.776190476190475	1.0803650652807706
chr15	CCDC32	40564765	40564789	1709	25	13936	8099	12227	8074	68.36	1.5143671042853604
chr15	RMDN3	40755082	40755197	1173	116	63126	4467	61953	4351	10.112068965517242	14.238795679154217
chr15	DNAJC17	40779850	40779926	0	77	58276	5641	58276	5564	0.0	10.473759884974838
chr15	DNAJC17	40780092	40780230	0	139	58276	5641	58276	5502	0.0	10.591784805525263
chr15	DNAJC17	40779083	40779221	0	139	58276	5641	58276	5502	0.0	10.591784805525263
chr15	DNAJC17	40774967	40775029	0	63	58276	5641	58276	5578	0.0	10.44747221226246
chr15	NDUFAF1	41402143	41402445	51	303	9325	3613	9274	3310	0.16831683168316833	2.801812688821752
chr15	NDUFAF1	41402143	41402258	51	116	9325	3613	9274	3497	0.4396551724137931	2.6519874177866742
chr15	NDUFAF1	41394104	41394263	0	160	9325	3613	9325	3453	0.0	2.700550246162757
chr15	LTK	41507513	41507560	0	48	185	3509	185	3461	0.0	0.053452759318116154
chr15	RPAP1	41543912	41544217	0	306	8954	6765	8954	6459	0.0	1.386282706301285
chr15	RPAP1	41543912	41544185	0	274	8954	6765	8954	6491	0.0	1.3794484671083038
chr15	RPAP1	41544186	41544217	0	32	8954	6765	8954	6733	0.0	1.329867815238378
chr15	AC016134.1	41621088	41621207	0	120	937	1392	937	1272	0.0	0.7366352201257862
chr15	AC016134.1	41621066	41621087	0	22	937	1392	937	1370	0.0	0.6839416058394161
chr15	AC016134.1	41621066	41621207	0	142	937	1392	937	1250	0.0	0.7496
chr15	AC073657.1	41772430	41772513	20714	84	21583	428	869	344	246.5952380952381	2.5261627906976742
chr15	TMEM87A	42272888	42272961	0	74	105209	5620	105209	5546	0.0	18.970248827984133
chr15	ZNF106	42456957	42457215	5770	259	168382	9722	162612	9463	22.27799227799228	17.183979710451233
chr15	LRRC57	42548692	42548698	0	7	6528	7909	6528	7902	0.0	0.8261199696279423
chr15	LRRC57	42548666	42548691	0	26	6528	7909	6528	7883	0.0	0.8281111252061398
chr15	LRRC57	42548666	42548698	0	33	6528	7909	6528	7876	0.0	0.8288471305231082
chr15	CDAN1	42727620	42727666	1052	47	17274	4961	16222	4914	22.382978723404257	3.301180301180301
chr15	CDAN1	42736988	42737011	0	24	17274	4961	17274	4937	0.0	3.4988859631355074
chr15	UBR1	43025373	43025379	71	7	66640	9976	66569	9969	10.142857142857142	6.677600561741398
chr15	EPB42	43220725	43220814	0	90	896	2855	896	2765	0.0	0.3240506329113924
chr15	ZSCAN29	43363914	43364124	0	211	5365	6474	5365	6263	0.0	0.8566182340731279
chr15	TP53BP1	43420304	43420616	0	313	60848	13009	60848	12696	0.0	4.792690611216131
chr15	PPIP5K1	43573356	43573379	0	24	553	7736	553	7712	0.0	0.0717064315352697
chr15	PPIP5K1	43589881	43589900	0	20	553	7736	553	7716	0.0	0.07166925868325558
chr15	STRC	43612790	43612797	0	8	102	6367	102	6359	0.0	0.016040257902185877
chr15	CATSPER2	43648817	43648820	0	4	2009	5336	2009	5332	0.0	0.376781695423856
chr15	SERINC4	43797140	43797143	0	4	3695	2886	3695	2882	0.0	1.2820957668285913
chr15	FRMD5	43888808	43888822	9	15	33158	6396	33149	6381	0.6	5.194953769001724
chr15	FRMD5	43885667	43885679	0	13	33158	6396	33158	6383	0.0	5.194736017546608
chr15	EIF3J-DT	44536042	44536799	0	758	0	3200	0	2442	0.0	0.0
chr15	EIF3J-DT	44535759	44536041	0	283	0	3200	0	2917	0.0	0.0
chr15	EIF3J-DT	44535759	44536799	0	1041	0	3200	0	2159	0.0	0.0
chr15	SPG11	44620124	44620188	0	65	12776	11477	12776	11412	0.0	1.1195233087977567
chr15	DUOXA1	45129761	45129850	0	90	130406	3541	130406	3451	0.0	37.78788756882063
chr15	DUOXA1	45129761	45129821	0	61	130406	3541	130406	3480	0.0	37.472988505747125
chr15	DUOXA1	45129822	45129850	0	29	130406	3541	130406	3512	0.0	37.13154897494305
chr15	SHF	45172146	45172147	0	2	102	4906	102	4904	0.0	0.020799347471451877
chr15	GATM	45375650	45376599	0	950	148562	6854	148562	5904	0.0	25.162940379403793
chr15	LINC01491	47804768	47804772	0	5	0	1932	0	1927	0.0	0.0
chr15	LINC01491	47827558	47827569	0	12	0	1932	0	1920	0.0	0.0
chr15	AC066612.1	48190039	48190056	0	18	0	3119	0	3101	0.0	0.0
chr15	FAM227B	49620630	49620698	10715	69	34355	5713	23640	5644	155.28985507246378	4.188518781006379
chr15	GABPB1	50301220	50301255	0	36	51	5585	51	5549	0.0	0.009190845197332853
chr15	CYP19A1	51338436	51338493	0	58	1959	7380	1959	7322	0.0	0.267549849767823
chr15	BCL2L10	52112167	52112236	0	70	0	1321	0	1251	0.0	0.0
chr15	MYO5C	52260861	52260900	0	40	60940	10094	60940	10054	0.0	6.061269146608315
chr15	ARPP19	52569111	52569114	0	4	349	6840	349	6836	0.0	0.051053247513165596
chr15	FAM214A	52587055	52587149	0	95	22141	9760	22141	9665	0.0	2.290843248836006
chr15	FAM214A	52678429	52678570	0	142	22141	9760	22141	9618	0.0	2.302037845705968
chr15	FAM214A	52678429	52678702	0	274	22141	9760	22141	9486	0.0	2.334071262913768
chr15	FAM214A	52678827	52679274	0	448	22141	9760	22141	9312	0.0	2.37768470790378
chr15	WDR72	53759586	53759631	0	46	115	8513	115	8467	0.0	0.013582142435337192
chr15	WDR72	53711299	53711334	0	36	115	8513	115	8477	0.0	0.01356612008965436
chr15	RSL24D1	55192710	55192718	0	9	0	6103	0	6094	0.0	0.0
chr15	RSL24D1	55192402	55192718	0	317	0	6103	0	5786	0.0	0.0
chr15	RSL24D1	55192402	55192709	0	308	0	6103	0	5795	0.0	0.0
chr15	RAB27A	55270755	55270857	0	103	0	5247	0	5144	0.0	0.0
chr15	PIGBOS1	55318863	55318905	0	43	0	947	0	904	0.0	0.0
chr15	PIGBOS1	55318863	55318899	0	37	0	947	0	910	0.0	0.0
chr15	PIGBOS1	55318900	55318905	0	6	0	947	0	941	0.0	0.0
chr15	CCPG1	55359538	55359786	0	249	204	5580	204	5331	0.0	0.038266741699493526
chr15	ZNF280D	56666678	56666798	0	121	704	10430	704	10309	0.0	0.06828984382578329
chr15	AC090517.5	56917064	56917145	0	82	204	6477	204	6395	0.0	0.031899921813917126
chr15	SLTM	58893820	58893900	1320	81	93768	6192	92448	6111	16.296296296296298	15.128129602356406
chr15	GTF2A2	59657123	59657404	0	282	3858	2929	3858	2647	0.0	1.4574990555345675
chr15	BNIP2	59678747	59678774	0	28	4408	7747	4408	7719	0.0	0.5710584272574167
chr15	ANXA2	60393012	60393237	0	226	0	11528	0	11302	0.0	0.0
chr15	ANXA2	60393012	60393036	0	25	0	11528	0	11503	0.0	0.0
chr15	ANXA2	60396279	60396371	0	93	0	11528	0	11435	0.0	0.0
chr15	ANXA2	60393037	60393237	0	201	0	11528	0	11327	0.0	0.0
chr15	ANXA2	60396150	60396278	0	129	0	11528	0	11399	0.0	0.0
chr15	ANXA2	60396150	60396371	0	222	0	11528	0	11306	0.0	0.0
chr15	ANXA2	60357138	60357144	0	7	0	11528	0	11521	0.0	0.0
chr15	ANXA2	60397870	60397941	0	72	0	11528	0	11456	0.0	0.0
chr15	ANXA2	60352378	60352381	0	4	0	11528	0	11524	0.0	0.0
chr15	ANXA2	60397254	60397256	0	3	0	11528	0	11525	0.0	0.0
chr15	ANXA2	60360930	60360939	0	10	0	11528	0	11518	0.0	0.0
chr15	ANXA2	60391022	60391106	0	85	0	11528	0	11443	0.0	0.0
chr15	ICE2	60479002	60479070	0	69	153	10708	153	10639	0.0	0.014381050850643857
chr15	VPS13C	61954420	61954465	0	46	389	19787	389	19741	0.0	0.019705182108302518
chr15	USP3-AS1	63556831	63556892	677	62	84010	2791	83333	2729	10.919354838709678	30.536093807255405
chr15	USP3-AS1	63599182	63600587	71908	1406	84010	2791	12102	1385	51.14366998577525	8.737906137184115
chr15	USP3-AS1	63599182	63600260	49516	1079	84010	2791	34494	1712	45.890639481000925	20.148364485981308
chr15	USP3-AS1	63600261	63600587	22392	327	84010	2791	61618	2464	68.4770642201835	25.007305194805195
chr15	HERC1	63625941	63625983	230	43	40467	16742	40237	16699	5.348837209302325	2.409545481765375
chr15	HERC1	63833821	63833825	0	5	40467	16742	40467	16737	0.0	2.4178168130489337
chr15	DAPK2	63983532	63983623	0	92	13797	11854	13797	11762	0.0	1.1730147934024826
chr15	AC087632.2	64365973	64365984	111	12	82573	3306	82462	3294	9.25	25.034001214329084
chr15	AC087632.2	64373494	64373696	2613	203	82573	3306	79960	3103	12.87192118226601	25.768611021592008
chr15	AC087632.2	64373155	64373696	17396	542	82573	3306	65177	2764	32.095940959409596	23.58068017366136
chr15	AC087632.2	64373155	64373493	14783	339	82573	3306	67790	2967	43.607669616519175	22.847994607347488
chr15	PIF1	64825568	64825591	0	24	205664	3967	205664	3943	0.0	52.15926959168146
chr15	MTFMT	65026817	65026829	0	13	1275	2292	1275	2279	0.0	0.5594559017112769
chr15	CLPX	65158574	65158685	4982	112	21501	5476	16519	5364	44.482142857142854	3.0796047725577926
chr15	CLPX	65156777	65156842	0	66	21501	5476	21501	5410	0.0	3.974306839186691
chr15	DPP8	65517380	65517484	0	105	138779	9869	138779	9764	0.0	14.213334698893895
chr15	INTS14	65599773	65599836	0	64	5019	4223	5019	4159	0.0	1.2067804760759797
chr15	INTS14	65607158	65607300	0	143	5019	4223	5019	4080	0.0	1.2301470588235295
chr15	INTS14	65610795	65611096	0	302	5019	4223	5019	3921	0.0	1.2800306044376435
chr15	INTS14	65610685	65611096	0	412	5019	4223	5019	3811	0.0	1.3169771713461034
chr15	INTS14	65610685	65610794	0	110	5019	4223	5019	4113	0.0	1.2202771699489423
chr15	DENND4A	65761359	65761365	0	7	19783	7940	19783	7933	0.0	2.4937602420269758
chr15	MEGF11	65916597	65916826	10414	230	68980	9387	58566	9157	45.278260869565216	6.395762804411925
chr15	MEGF11	65971165	65971202	0	38	68980	9387	68980	9349	0.0	7.378329233073056
chr15	TIPIN	66386606	66386648	0	43	0	2519	0	2476	0.0	0.0
chr15	TIPIN	66386419	66386605	0	187	0	2519	0	2332	0.0	0.0
chr15	TIPIN	66386419	66386648	0	230	0	2519	0	2289	0.0	0.0
chr15	SNAPC5	66494276	66494413	0	138	0	2480	0	2342	0.0	0.0
chr15	SNAPC5	66494902	66495328	0	427	0	2480	0	2053	0.0	0.0
chr15	SNAPC5	66497489	66497640	0	152	0	2480	0	2328	0.0	0.0
chr15	AAGAB	67254413	67254557	0	145	153	4153	153	4008	0.0	0.03817365269461078
chr15	CLN6	68211555	68211673	0	119	102	7108	102	6989	0.0	0.014594362569752469
chr15	CLN6	68211555	68211647	0	93	102	7108	102	7015	0.0	0.014540270848182466
chr15	CLN6	68256689	68256695	0	7	102	7108	102	7101	0.0	0.01436417405999155
chr15	CLN6	68211648	68211673	0	26	102	7108	102	7082	0.0	0.014402711098559728
chr15	ITGA11	68311286	68311288	0	3	2384	10898	2384	10895	0.0	0.21881597062872876
chr15	TLE3	70057458	70057472	0	15	102	9700	102	9685	0.0	0.010531750129065565
chr15	TLE3	70058158	70058184	0	27	102	9700	102	9673	0.0	0.01054481546572935
chr15	TLE3	70058149	70058157	0	9	102	9700	102	9691	0.0	0.010525229594469094
chr15	TLE3	70058149	70058184	0	36	102	9700	102	9664	0.0	0.010554635761589404
chr15	TLE3	70074502	70074531	0	30	102	9700	102	9670	0.0	0.010548086866597724
chr15	TLE3	70095389	70095576	0	188	102	9700	102	9512	0.0	0.010723296888141295
chr15	UACA	70671964	70671969	0	6	51	11017	51	11011	0.0	0.004631731904459177
chr15	THAP10	70891843	70892371	0	529	0	1521	0	992	0.0	0.0
chr15	CT62	71113536	71113633	0	98	2295	2536	2295	2438	0.0	0.9413453650533224
chr15	CT62	71114923	71115127	0	205	2295	2536	2295	2331	0.0	0.9845559845559846
chr15	THSD4-AS1	71185404	71185423	0	20	10509	4037	10509	4017	0.0	2.6161314413741596
chr15	MYO9A	71951701	71951775	0	75	20367	14410	20367	14335	0.0	1.4207882804325078
chr15	PKM	72230899	72231114	0	216	459	7878	459	7662	0.0	0.05990602975724354
chr15	PKM	72230899	72231322	0	424	459	7878	459	7454	0.0	0.06157767641534746
chr15	PKM	72231115	72231322	0	208	459	7878	459	7670	0.0	0.05984354628422425
chr15	PKM	72230895	72231114	0	220	459	7878	459	7658	0.0	0.05993732044920345
chr15	PKM	72230895	72230898	0	4	459	7878	459	7874	0.0	0.05829311658623317
chr15	PKM	72208616	72208619	0	4	459	7878	459	7874	0.0	0.05829311658623317
chr15	PKM	72231323	72231597	0	275	459	7878	459	7603	0.0	0.06037090622122846
chr15	PARP6	72260477	72260536	0	60	2958	7059	2958	6999	0.0	0.42263180454350624
chr15	PARP6	72265269	72265411	1530	143	2958	7059	1428	6916	10.6993006993007	0.20647773279352227
chr15	PARP6	72272280	72272391	0	112	2958	7059	2958	6947	0.0	0.4257953073269037
chr15	ADPGK	72783245	72783457	0	213	3061	5311	3061	5098	0.0	0.6004315417810906
chr15	ADPGK	72783245	72783300	0	56	3061	5311	3061	5255	0.0	0.5824928639391056
chr15	ADPGK	72783301	72783457	0	157	3061	5311	3061	5154	0.0	0.593907644547924
chr15	LOXL1-AS1	73919837	73919958	0	122	8599	4796	8599	4674	0.0	1.8397518185708173
chr15	STOML1	73992090	73992211	51	122	13933	8369	13882	8247	0.4180327868852459	1.683278768036862
chr15	STRA6	74202417	74202711	816	295	10514	6568	9698	6273	2.766101694915254	1.5459907540251874
chr15	STRA6	74183252	74183854	0	603	10514	6568	10514	5965	0.0	1.762615255658005
chr15	STRA6	74197519	74197750	0	232	10514	6568	10514	6336	0.0	1.6594065656565657
chr15	UBL7	74460667	74461035	51	369	1088	1897	1037	1528	0.13821138211382114	0.6786649214659686
chr15	UBL7	74461036	74461106	29	71	1088	1897	1059	1826	0.4084507042253521	0.5799561883899234
chr15	EDC3	74695369	74695421	0	53	0	5102	0	5049	0.0	0.0
chr15	EDC3	74695325	74695421	0	97	0	5102	0	5005	0.0	0.0
chr15	EDC3	74695325	74695368	0	44	0	5102	0	5058	0.0	0.0
chr15	ULK3	74837750	74837755	0	6	9712	3361	9712	3355	0.0	2.8947839046199704
chr15	ULK3	74842534	74842537	0	4	9712	3361	9712	3357	0.0	2.8930592791182606
chr15	ULK3	74842534	74842544	0	11	9712	3361	9712	3350	0.0	2.89910447761194
chr15	ULK3	74842538	74842544	0	7	9712	3361	9712	3354	0.0	2.8956469886702445
chr15	FAM219B	74906277	74906322	0	46	300	3076	300	3030	0.0	0.09900990099009901
chr15	FAM219B	74906277	74906585	0	309	300	3076	300	2767	0.0	0.10842067220816769
chr15	DNM1P34	75302443	75302471	0	29	8305	2307	8305	2278	0.0	3.6457418788410885
chr15	SIN3A	75451359	75451421	0	63	4168	12419	4168	12356	0.0	0.3373259954677889
chr15	SNUPN	75625335	75625664	57	330	204	3528	147	3198	0.17272727272727273	0.04596622889305816
chr15	NRG4	76012301	76012317	0	17	11295	3050	11295	3033	0.0	3.7240356083086055
chr15	SCAPER	76771723	76771740	0	18	1049	11270	1049	11252	0.0	0.09322787060078208
chr15	SCAPER	76795240	76795278	0	39	1049	11270	1049	11231	0.0	0.09340219036595139
chr15	TSPAN3	77070891	77071003	0	113	4442	6899	4442	6786	0.0	0.6545829649277926
chr15	LINGO1	77820786	77820841	0	56	562	5340	562	5284	0.0	0.10635881907645722
chr15	WDR61	78299455	78299560	0	106	53088	5010	53088	4904	0.0	10.825448613376835
chr15	CHRNB4	78630927	78631074	0	148	0	5003	0	4855	0.0	0.0
chr15	CTSH	78931868	78931899	0	32	51	11133	51	11101	0.0	0.004594180704441042
chr15	CTSH	78932582	78934976	0	2395	51	11133	51	8738	0.0	0.005836575875486381
chr15	CTSH	78932582	78933729	0	1148	51	11133	51	9985	0.0	0.005107661492238357
chr15	CTSH	78932582	78934813	0	2232	51	11133	51	8901	0.0	0.005729693292888439
chr15	CTSH	78933730	78934976	0	1247	51	11133	51	9886	0.0	0.005158810439004653
chr15	CTSH	78933730	78934813	0	1084	51	11133	51	10049	0.0	0.005075131853915812
chr15	CTSH	78944777	78944889	0	113	51	11133	51	11020	0.0	0.0046279491833030855
chr15	CTSH	78926562	78927711	0	1150	51	11133	51	9983	0.0	0.005108684764098969
chr15	CTSH	78926562	78926780	0	219	51	11133	51	10914	0.0	0.004672897196261682
chr15	CTSH	78926562	78927366	0	805	51	11133	51	10328	0.0	0.004938032532920217
chr15	CTSH	78932371	78934976	0	2606	51	11133	51	8527	0.0	0.005981001524569016
chr15	CTSH	78932275	78932370	0	96	51	11133	51	11037	0.0	0.0046208208752378365
chr15	CTSH	78934814	78934976	0	163	51	11133	51	10970	0.0	0.004649042844120328
chr15	CTSH	78926174	78927711	0	1538	51	11133	51	9595	0.0	0.005315268368942158
chr15	CTSH	78926174	78926780	0	607	51	11133	51	10526	0.0	0.004845145354360631
chr15	CTSH	78926174	78926561	0	388	51	11133	51	10745	0.0	0.0047463936714751045
chr15	CTSH	78926174	78927366	0	1193	51	11133	51	9940	0.0	0.005130784708249497
chr15	RASGRF1	79006176	79006184	0	9	1021	9181	1021	9172	0.0	0.11131705189707806
chr15	ANKRD34C-AS1	79260224	79260227	0	4	760484	10687	760484	10683	0.0	71.18637086960591
chr15	MTHFS	79896790	79896870	0	81	0	1423	0	1342	0.0	0.0
chr15	AC016705.2	80347687	80347697	0	11	20278	8076	20278	8065	0.0	2.514321140731556
chr15	MESD	80978765	80978929	0	165	0	4448	0	4283	0.0	0.0
chr15	STARD5	81323801	81323999	357	199	5562	5447	5205	5248	1.7939698492462313	0.9918064024390244
chr15	GOLGA2P10	82513665	82513714	0	50	0	1291	0	1241	0.0	0.0
chr15	GOLGA2P10	82477393	82477479	0	87	0	1291	0	1204	0.0	0.0
chr15	CPEB1	82553451	82553465	0	15	8875	8139	8875	8124	0.0	1.0924421467257508
chr15	CPEB1	82628137	82628362	0	226	8875	8139	8875	7913	0.0	1.1215720965499811
chr15	CPEB1	82647136	82647207	0	72	8875	8139	8875	8067	0.0	1.1001611503656874
chr15	AP3B2	82688987	82689156	306	170	1275758	8150	1275452	7980	1.8	159.8310776942356
chr15	AC105339.1	82711560	82711674	2777	115	6022	1228	3245	1113	24.14782608695652	2.9155435759209345
chr15	HOMER2	82985786	82986078	51	293	62	13758	11	13465	0.17406143344709898	0.0008169327887114742
chr15	C15ORF40	83011485	83011495	19	11	6073	2219	6054	2208	1.7272727272727273	2.7418478260869565
chr15	C15ORF40	82991931	82991954	0	24	6073	2219	6073	2195	0.0	2.766742596810934
chr15	AC024270.4	83106629	83106711	243	83	6562	2477	6319	2394	2.927710843373494	2.639515455304929
chr15	GOLGA2P7	84229851	84229900	0	50	0	3261	0	3211	0.0	0.0
chr15	UBE2Q2P1	84554960	84554964	0	5	51	2432	51	2427	0.0	0.021013597033374538
chr15	UBE2Q2P1	84542144	84542145	0	2	51	2432	51	2430	0.0	0.020987654320987655
chr15	UBE2Q2P1	84570486	84570597	0	112	51	2432	51	2320	0.0	0.021982758620689654
chr15	WDR73	84653631	84653698	0	68	0	8315	0	8247	0.0	0.0
chr15	AC044860.1	85234478	85234527	736	50	117315	2932	116579	2882	14.72	40.450728660652324
chr15	LINC01584	86116580	86116613	0	34	2296	3080	2296	3046	0.0	0.7537754432042022
chr15	DET1	88531608	88531611	0	4	153	4789	153	4785	0.0	0.03197492163009404
chr15	RLBP1	89219736	89219794	0	59	153	1857	153	1798	0.0	0.08509454949944383
chr15	POLG	89325449	89325488	0	40	155	6927	155	6887	0.0	0.022506171046899958
chr15	POLG	89334672	89334683	0	12	155	6927	155	6915	0.0	0.022415039768618944
chr15	RHCG	89472710	89472720	0	11	51	2548	51	2537	0.0	0.02010248324793063
chr15	LINC00928	89517283	89517400	1	118	38	2562	37	2444	0.00847457627118644	0.015139116202945991
chr15	PLIN1	89679250	89679320	0	71	714	3804	714	3733	0.0	0.19126707741762658
chr15	MESP1	89750508	89751022	0	515	312	1856	312	1341	0.0	0.232662192393736
chr15	ANPEP	89803611	89803645	0	35	30577	5070	30577	5035	0.0	6.072889771598808
chr15	ANPEP	89804945	89805076	3319	132	30577	5070	27258	4938	25.143939393939394	5.520048602673147
chr15	AP3S2	89893876	89893879	0	4	30014	3566	30014	3562	0.0	8.426165075800112
chr15	CIB1	90233834	90233917	681	84	5403	1480	4722	1396	8.107142857142858	3.3825214899713467
chr15	HDDC3	90932385	90932427	144	43	13693	2622	13549	2579	3.3488372093023258	5.253586661496704
chr15	PRC1	90969446	90969522	1474	77	13227	5528	11753	5451	19.142857142857142	2.1561181434599157
chr15	LINC00930	92571185	92571199	0	15	266	4167	266	4152	0.0	0.0640655105973025
chr15	AC091544.4	92596055	92596300	0	246	0	2472	0	2226	0.0	0.0
chr15	FAM174B	92655130	92655314	0	185	176	4298	176	4113	0.0	0.042791150012156574
chr15	RGMA	93073563	93073582	0	20	0	12942	0	12922	0.0	0.0
chr15	RGMA	93088280	93088397	0	118	0	12942	0	12824	0.0	0.0
chr15	RGMA	93065831	93066099	561	269	0	12942	-561	12673	2.0855018587360594	-0.044267340014203425
chr15	LINC01579	93900035	93900349	0	315	179	9355	179	9040	0.0	0.01980088495575221
chr15	LINC01579	93900350	93900467	0	118	179	9355	179	9237	0.0	0.019378586121034966
chr15	AC027013.1	95469744	95469782	0	39	51	1510	51	1471	0.0	0.03467029231815092
chr15	LINC02254	97427650	97427841	0	192	0	5214	0	5022	0.0	0.0
chr15	LINC01582	98088697	98088737	0	41	0	2922	0	2881	0.0	0.0
chr15	LINC01582	98088505	98088737	0	233	0	2922	0	2689	0.0	0.0
chr15	LINC01582	98088505	98088696	0	192	0	2922	0	2730	0.0	0.0
chr15	TTC23	99249170	99249415	0	246	1394	5136	1394	4890	0.0	0.2850715746421268
chr15	TTC23	99249170	99249620	0	451	1394	5136	1394	4685	0.0	0.2975453575240128
chr15	DNM1P46	99800974	99801040	0	67	320598	3985	320598	3918	0.0	81.82695252679939
chr15	DNM1P46	99804799	99804803	0	5	320598	3985	320598	3980	0.0	80.55226130653266
chr15	SPATA41	100346523	100348732	38812	2210	12133	3001	-26679	791	17.561990950226246	-33.72819216182048
chr15	SPATA41	100346523	100349306	40342	2784	12133	3001	-28209	217	14.49066091954023	-129.99539170506912
chr15	SPATA41	100348733	100349306	1530	574	12133	3001	10603	2427	2.6655052264808363	4.368768026370004
chr15	CERS3	100544123	100544214	0	92	3380	5147	3380	5055	0.0	0.66864490603363
chr15	LINS1	100580443	100580799	0	357	0	7512	0	7155	0.0	0.0
chr15	LINS1	100602116	100602119	0	4	0	7512	0	7508	0.0	0.0
chr15	SELENOS	101277091	101277279	0	189	5	3069	5	2880	0.0	0.001736111111111111
chr15	PCSK6	101318184	101318317	0	134	53100	16686	53100	16552	0.0	3.208071532141131
chr15	TM2D3	101651695	101652269	204	575	2125	11588	1921	11013	0.35478260869565215	0.17443021883228912
chr15	TM2D3	101651695	101651826	0	132	2125	11588	2125	11456	0.0	0.1854923184357542
chr15	TM2D3	101651827	101652269	204	443	2125	11588	1921	11145	0.4604966139954853	0.17236428891879765
chr16	SNRNP25	55543	55549	0	7	0	1293	0	1286	0.0	0.0
chr16	HBA2	172959	173007	14	49	8029	815	8015	766	0.2857142857142857	10.463446475195822
chr16	HBA1	176763	176811	0	49	846	813	846	764	0.0	1.1073298429319371
chr16	FAM234A	249655	249658	0	4	74763	5109	74763	5105	0.0	14.645053868756122
chr16	ARHGDIG	282356	282373	0	18	22875	1855	22875	1837	0.0	12.452367991290147
chr16	PDIA2	285434	285437	6	4	8058	1999	8052	1995	1.5	4.0360902255639095
chr16	NME4	398386	398394	0	9	60411	3175	60411	3166	0.0	19.081174984207202
chr16	NME4	397903	398179	0	277	60411	3175	60411	2898	0.0	20.84575569358178
chr16	DECR2	410754	410784	0	31	153	2636	153	2605	0.0	0.05873320537428023
chr16	DECR2	406362	406397	0	36	153	2636	153	2600	0.0	0.05884615384615385
chr16	DECR2	407561	407580	0	20	153	2636	153	2616	0.0	0.058486238532110095
chr16	DECR2	406778	406952	0	175	153	2636	153	2461	0.0	0.06216984965461195
chr16	DECR2	406890	406952	0	63	153	2636	153	2573	0.0	0.05946366109599689
chr16	DECR2	410368	410404	0	37	153	2636	153	2599	0.0	0.05886879569065025
chr16	RAB11FIP3	475046	475098	120	53	157678	6050	157558	5997	2.2641509433962264	26.272803068200766
chr16	PIGQ	574439	574763	750	325	23122	6456	22372	6131	2.3076923076923075	3.648996900994944
chr16	PIGQ	575971	576002	154	32	23122	6456	22968	6424	4.8125	3.5753424657534247
chr16	PIGQ	578463	578505	0	43	23122	6456	23122	6413	0.0	3.6054888507718696
chr16	WDR90	658615	658653	0	39	78603	10446	78603	10407	0.0	7.552897088498126
chr16	WDR90	655886	655889	0	4	78603	10446	78603	10442	0.0	7.52758092319479
chr16	RHOT2	668155	668236	3469	82	27744	4192	24275	4110	42.30487804878049	5.906326034063261
chr16	ANTKMT	722084	722134	22245	51	209710	1398	187465	1347	436.1764705882353	139.17223459539719
chr16	HAGHL	727141	727175	0	35	221403	4949	221403	4914	0.0	45.05555555555556
chr16	CHTF18	788757	788775	423	19	12796	4621	12373	4602	22.263157894736842	2.688613646240765
chr16	CHTF18	792348	792367	0	20	12796	4621	12796	4601	0.0	2.781134535970441
chr16	CACNA1H	1201836	1202452	0	617	0	8655	0	8038	0.0	0.0
chr16	CACNA1H	1209413	1209462	0	50	0	8655	0	8605	0.0	0.0
chr16	CACNA1H	1212139	1212171	0	33	0	8655	0	8622	0.0	0.0
chr16	UBE2I	1309272	1309419	0	148	51	8510	51	8362	0.0	0.006099019373355657
chr16	UBE2I	1312559	1312603	0	45	51	8510	51	8465	0.0	0.006024808033077377
chr16	UBE2I	1312604	1312667	0	64	51	8510	51	8446	0.0	0.006038361354487331
chr16	UBE2I	1312559	1312667	0	109	51	8510	51	8401	0.0	0.0060707058683490064
chr16	CRAMP1	1612423	1612657	336	235	43996	8617	43660	8382	1.4297872340425533	5.2087807205917445
chr16	CRAMP1	1668185	1668193	0	9	43996	8617	43996	8608	0.0	5.111059479553903
chr16	JPT2	1678322	1678356	0	35	37474	3868	37474	3833	0.0	9.776676232715888
chr16	JPT2	1683593	1683620	0	28	37474	3868	37474	3840	0.0	9.758854166666667
chr16	JPT2	1680499	1680587	0	89	37474	3868	37474	3779	0.0	9.916379994707595
chr16	MAPK8IP3	1761279	1761305	16	27	21080	7888	21064	7861	0.5925925925925926	2.679557308230505
chr16	NUBP2	1783037	1783506	73	470	9482	3124	9409	2654	0.15531914893617021	3.5452147701582515
chr16	NDUFB10	1961259	1961291	0	33	0	679	0	646	0.0	0.0
chr16	NDUFB10	1961612	1961636	0	25	0	679	0	654	0.0	0.0
chr16	TBL3	1976258	1976314	0	57	703	6954	703	6897	0.0	0.10192837465564739
chr16	SLC9A3R2	2033427	2033432	126	6	128610	3115	128484	3109	21.0	41.32647153425539
chr16	TSC2	2084703	2084715	0	13	127539	14665	127539	14652	0.0	8.704545454545455
chr16	TSC2	2082501	2082504	0	4	127539	14665	127539	14661	0.0	8.699201964395334
chr16	TSC2	2053453	2053542	51	90	127539	14665	127488	14575	0.5666666666666667	8.747032590051457
chr16	TSC2	2076171	2076257	0	87	127539	14665	127539	14578	0.0	8.748730964467006
chr16	TSC2	2082505	2082558	190	54	127539	14665	127349	14611	3.5185185185185186	8.71596742180549
chr16	TSC2	2082501	2082558	190	58	127539	14665	127349	14607	3.2758620689655173	8.718354213733141
chr16	TSC2	2082505	2082594	255	90	127539	14665	127284	14575	2.8333333333333335	8.73303602058319
chr16	TSC2	2082501	2082594	255	94	127539	14665	127284	14571	2.7127659574468086	8.735433395099856
chr16	TSC2	2082559	2082594	65	36	127539	14665	127474	14629	1.8055555555555556	8.713787682001504
chr16	AC009065.2	2091609	2091614	84	6	18707	592	18623	586	14.0	31.77986348122867
chr16	MLST8	2204683	2204858	8030	176	79014	3668	70984	3492	45.625	20.327605956471935
chr16	E4F1	2234950	2235001	168	52	48653	5540	48485	5488	3.230769230769231	8.834730320699709
chr16	E4F1	2223771	2223929	15690	159	48653	5540	32963	5381	98.67924528301887	6.125813045902249
chr16	ABCA17P	2425050	2425086	0	37	5104	6345	5104	6308	0.0	0.8091312618896639
chr16	TEDC2	2460171	2460381	0	211	714	2854	714	2643	0.0	0.27014755959137343
chr16	ATP6V0C	2514130	2514182	1400	53	3869	1396	2469	1343	26.41509433962264	1.838421444527178
chr16	AMDHD2	2528560	2528718	224	159	26592	3044	26368	2885	1.4088050314465408	9.139688041594454
chr16	SRRM2	2752847	2752854	0	8	127808	11355	127808	11347	0.0	11.263593901471754
chr16	PRSS21	2821068	2821109	419	42	435775	1973	435356	1931	9.976190476190476	225.45624029000518
chr16	FLYWCH2	2883273	2883366	0	94	0	1343	0	1249	0.0	0.0
chr16	PAQR4	2969444	2969840	44	397	5147	2874	5103	2477	0.11083123425692695	2.0601534113847397
chr16	TNFRSF12A	3020492	3020759	4291	268	172802	1406	168511	1138	16.011194029850746	148.07644991212655
chr16	MMP25	3050546	3050546	0	1	36861	4257	36861	4256	0.0	8.6609492481203
chr16	IL32	3067416	3067613	0	198	2027	2993	2027	2795	0.0	0.7252236135957066
chr16	IL32	3065495	3065826	0	332	2027	2993	2027	2661	0.0	0.7617437053739196
chr16	IL32	3065656	3065687	0	32	2027	2993	2027	2961	0.0	0.6845660249915569
chr16	IL32	3065688	3065710	0	23	2027	2993	2027	2970	0.0	0.6824915824915825
chr16	IL32	3065656	3065710	0	55	2027	2993	2027	2938	0.0	0.689925119128659
chr16	ZNF205	3112683	3112950	0	268	17155	2337	17155	2069	0.0	8.291445142580956
chr16	ZNF213	3135388	3135445	0	58	994	3717	994	3659	0.0	0.27165892320306095
chr16	NAA60	3443828	3443837	0	10	20914	6190	20914	6180	0.0	3.3841423948220064
chr16	NAA60	3443828	3443893	857	66	20914	6190	20057	6124	12.984848484848484	3.2751469627694316
chr16	NAA60	3443838	3443893	857	56	20914	6190	20057	6134	15.303571428571429	3.2698076296054777
chr16	NAA60	3485062	3485083	0	22	20914	6190	20914	6168	0.0	3.3907263294422827
chr16	DNASE1	3655938	3655966	0	29	74602	8622	74602	8593	0.0	8.6817176771791
chr16	HMOX2	4483739	4483754	0	16	40405	3349	40405	3333	0.0	12.122712271227122
chr16	HMOX2	4476418	4476665	4701	248	40405	3349	35704	3101	18.955645161290324	11.513705256368914
chr16	HMOX2	4476488	4476665	4306	178	40405	3349	36099	3171	24.191011235955056	11.3841059602649
chr16	HMOX2	4476418	4476487	395	70	40405	3349	40010	3279	5.642857142857143	12.201890820372064
chr16	NUDT16L1	4694239	4694308	0	70	153	1422	153	1352	0.0	0.11316568047337278
chr16	C16ORF71	4737947	4737988	334	42	126459	3600	126125	3558	7.9523809523809526	35.44828555368184
chr16	C16ORF71	4746513	4746521	7	9	126459	3600	126452	3591	0.7777777777777778	35.213589529379
chr16	SMIM22	4796034	4796048	15	15	646	1629	631	1614	1.0	0.3909541511771995
chr16	UBN1	4848211	4848393	0	183	105816	7647	105816	7464	0.0	14.17684887459807
chr16	UBN1	4860954	4861102	36	149	105816	7647	105780	7498	0.24161073825503357	14.107762069885302
chr16	ALG1	5072058	5072213	0	156	30518	5368	30518	5212	0.0	5.8553338449731385
chr16	ALG1	5072214	5072318	0	105	30518	5368	30518	5263	0.0	5.798593957818735
chr16	ALG1	5072304	5072318	0	15	30518	5368	30518	5353	0.0	5.701102185690267
chr16	AC074051.3	5107768	5107850	0	83	0	1934	0	1851	0.0	0.0
chr16	RBFOX1	6019902	6019992	0	91	306	14371	306	14280	0.0	0.02142857142857143
chr16	METTL22	8623896	8624118	0	223	0	7747	0	7524	0.0	0.0
chr16	ABAT	8713866	8713879	0	14	64576	9737	64576	9723	0.0	6.641571531420343
chr16	LITAFD	8882511	8882790	115	280	166	1632	51	1352	0.4107142857142857	0.03772189349112426
chr16	AC012178.1	9467011	9467028	0	18	0	4432	0	4414	0.0	0.0
chr16	AC012178.1	9490098	9490425	0	328	0	4432	0	4104	0.0	0.0
chr16	ATF7IP2	10387485	10387494	0	10	51	5287	51	5277	0.0	0.009664582148948267
chr16	CIITA	10866320	10866572	0	253	341	11180	341	10927	0.0	0.031207101674750617
chr16	CLEC16A	11003258	11003305	0	48	13228	11576	13228	11528	0.0	1.147467036780014
chr16	RMI2	11345544	11345766	0	223	800	3308	800	3085	0.0	0.2593192868719611
chr16	U91319.1	13350422	13350616	0	195	204	3219	204	3024	0.0	0.06746031746031746
chr16	ERCC4	13932286	13932404	0	119	286	8348	286	8229	0.0	0.03475513428120063
chr16	MRTFB	14247358	14247507	0	150	1326	15184	1326	15034	0.0	0.08820007981907677
chr16	MIR193BHG	14302537	14302597	0	61	5151	6057	5151	5996	0.0	0.859072715143429
chr16	MIR193BHG	14322544	14322547	0	4	5151	6057	5151	6053	0.0	0.8509829836444738
chr16	MIR193BHG	14322544	14322550	0	7	5151	6057	5151	6050	0.0	0.851404958677686
chr16	MIR193BHG	14322548	14322550	0	3	5151	6057	5151	6054	0.0	0.8508424182358771
chr16	MIR193BHG	14322548	14322554	0	7	5151	6057	5151	6050	0.0	0.851404958677686
chr16	MIR193BHG	14322544	14322554	0	11	5151	6057	5151	6046	0.0	0.8519682434667549
chr16	NOMO1	14895642	14895694	0	53	16401	5532	16401	5479	0.0	2.9934294579302794
chr16	NPIPA1	14929422	14930031	0	610	38158	7367	38158	6757	0.0	5.647180701494746
chr16	PDXDC1	14974805	14974973	612	169	145079	9435	144467	9266	3.621301775147929	15.591085689617959
chr16	PDXDC1	15001857	15001887	0	31	145079	9435	145079	9404	0.0	15.427371331348363
chr16	NDE1	15725120	15727000	4960	1881	18222	8104	13262	6223	2.6368952684742157	2.1311264663345653
chr16	NOMO3	16294296	16294348	0	53	19420	10120	19420	10067	0.0	1.9290751961855568
chr16	NOMO3	16265180	16265271	0	92	19420	10120	19420	10028	0.0	1.936577582768249
chr16	PKD1P1	16328199	16328516	0	318	25972	6837	25972	6519	0.0	3.9840466329191595
chr16	ABCC6P1	18571305	18571311	0	7	38345	3328	38345	3321	0.0	11.546221017765733
chr16	TMC7	19035811	19035823	0	13	15486	5656	15486	5643	0.0	2.7442849548112704
chr16	COQ7	19074036	19074097	189	62	22616	3599	22427	3537	3.0483870967741935	6.340684195646028
chr16	COQ7	19068009	19068230	647	222	22616	3599	21969	3377	2.9144144144144146	6.505478235119929
chr16	COQ7	19068009	19068878	647	870	22616	3599	21969	2729	0.7436781609195402	8.050201539025284
chr16	COQ7	19068231	19068878	0	648	22616	3599	22616	2951	0.0	7.663842765164351
chr16	TMC5	19410541	19410773	0	233	214	6198	214	5965	0.0	0.035875943000838226
chr16	TMC5	19410774	19411176	0	403	214	6198	214	5795	0.0	0.036928386540120796
chr16	TMC5	19456746	19457016	0	271	214	6198	214	5927	0.0	0.03610595579551206
chr16	VPS35L	19581654	19581654	0	1	44499	9805	44499	9804	0.0	4.538861689106487
chr16	REXO5	20806491	20806721	0	231	38705	3857	38705	3626	0.0	10.674296745725318
chr16	REXO5	20806706	20806721	0	16	38705	3857	38705	3841	0.0	10.076802915907315
chr16	REXO5	20806722	20806735	0	14	38705	3857	38705	3843	0.0	10.071558678116055
chr16	REXO5	20806706	20806735	0	30	38705	3857	38705	3827	0.0	10.113666056963678
chr16	REXO5	20806722	20806817	798	96	38705	3857	37907	3761	8.3125	10.078968359478862
chr16	REXO5	20806706	20806817	798	112	38705	3857	37907	3745	7.125	10.122029372496662
chr16	REXO5	20806736	20806817	798	82	38705	3857	37907	3775	9.731707317073171	10.04158940397351
chr16	REXO5	20806722	20807091	2040	370	38705	3857	36665	3487	5.513513513513513	10.514769142529396
chr16	LYRM1	20920607	20920674	0	68	6401	3603	6401	3535	0.0	1.8107496463932107
chr16	CRYM-AS1	21301328	21301335	0	8	4866	2720	4866	2712	0.0	1.7942477876106195
chr16	METTL9	21599829	21599898	0	70	7428	3443	7428	3373	0.0	2.202193892677142
chr16	OTOA	21701028	21701069	0	42	152	7574	152	7532	0.0	0.0201805629314923
chr16	EEF2K	22258696	22258827	561	132	24462	5214	23901	5082	4.25	4.703069657615112
chr16	NPIPB5	22513601	22513610	296	10	124995	8940	124699	8930	29.6	13.964053751399776
chr16	NPIPB5	22513522	22513600	1593	79	124995	8940	123402	8861	20.164556962025316	13.926419140051912
chr16	NPIPB5	22519270	22519414	3215	145	124995	8940	121780	8795	22.17241379310345	13.84650369528141
chr16	NPIPB5	22527643	22527665	1398	23	124995	8940	123597	8917	60.78260869565217	13.860827632611866
chr16	UBFD1	23557746	23557767	0	22	173230	7830	173230	7808	0.0	22.186219262295083
chr16	PLK1	23679341	23679500	37196	160	316538	3134	279342	2974	232.475	93.9280430396772
chr16	SLC5A11	24846013	24846084	0	72	7	3411	7	3339	0.0	0.0020964360587002098
chr16	LINC02175	25067647	25067660	0	14	13995	5566	13995	5552	0.0	2.5207132564841497
chr16	LINC02175	25076184	25076274	816	91	13995	5566	13179	5475	8.967032967032967	2.407123287671233
chr16	LCMT1	25170798	25170805	32	8	36229	2603	36197	2595	4.0	13.948747591522158
chr16	LCMT1	25111769	25111996	561	228	36229	2603	35668	2375	2.460526315789474	15.018105263157894
chr16	LCMT1	25128567	25128570	16	4	36229	2603	36213	2599	4.0	13.933435936898807
chr16	KDM8	27219047	27219110	0	64	12300	3982	12300	3918	0.0	3.139356814701378
chr16	KDM8	27204165	27204175	0	11	12300	3982	12300	3971	0.0	3.0974565600604382
chr16	IL4R	27314021	27314231	0	211	49172	5144	49172	4933	0.0	9.967970808838436
chr16	EIF3C	28711519	28711567	44	49	895297	4992	895253	4943	0.8979591836734694	181.11531458628363
chr16	ATXN2L	28836123	28836176	1954	54	107556	6097	105602	6043	36.18518518518518	17.47509515141486
chr16	ATXN2L	28836486	28836490	140	5	107556	6097	107416	6092	28.0	17.63230466185161
chr16	ATXN2L	28824543	28824661	1625	119	107556	6097	105931	5978	13.655462184873949	17.720140515222482
chr16	ATXN2L	28836123	28836485	4060	363	107556	6097	103496	5734	11.18457300275482	18.049529124520404
chr16	ATXN2L	28836177	28836485	2106	309	107556	6097	105450	5788	6.815533980582524	18.21872840359364
chr16	SH2B1	28863755	28867033	10099	3279	136072	4469	125973	1190	3.0799024092711194	105.85966386554622
chr16	SH2B1	28872706	28872758	43	53	136072	4469	136029	4416	0.8113207547169812	30.80366847826087
chr16	ATP2A1	28892432	28892659	0	228	53619	4569	53619	4341	0.0	12.351762266758811
chr16	NFATC2IP	28951052	28951398	0	347	215812	5696	215812	5349	0.0	40.346232940736584
chr16	RRN3P2	29094331	29094408	0	78	4152	2287	4152	2209	0.0	1.879583521955636
chr16	AC009093.11	29326484	29326487	0	4	459	1729	459	1725	0.0	0.26608695652173914
chr16	SULT1A4	29461739	29461763	138	25	35727	1840	35589	1815	5.52	19.608264462809917
chr16	QPRT	29694756	29695199	732	444	816	2415	84	1971	1.6486486486486487	0.0426179604261796
chr16	KIF22	29790830	29791221	0	392	2606	3665	2606	3273	0.0	0.7962114268255424
chr16	KIF22	29797089	29797093	0	5	2606	3665	2606	3660	0.0	0.7120218579234973
chr16	KIF22	29791222	29791461	0	240	2606	3665	2606	3425	0.0	0.7608759124087591
chr16	KIF22	29804066	29804107	0	42	2606	3665	2606	3623	0.0	0.7192934032569693
chr16	MAZ	29807829	29807885	0	57	660470	3213	660470	3156	0.0	209.27439797211662
chr16	PRRT2	29811977	29812036	1362	60	265381	2305	264019	2245	22.7	117.60311804008909
chr16	PRRT2	29813394	29814009	17404	616	265381	2305	247977	1689	28.253246753246753	146.81882770870337
chr16	PRRT2	29813934	29814009	4910	76	265381	2305	260471	2229	64.60526315789474	116.85554060116644
chr16	PRRT2	29813779	29814009	11056	231	265381	2305	254325	2074	47.86147186147186	122.62536162005786
chr16	PRRT2	29813776	29814009	11131	234	265381	2305	254250	2071	47.56837606837607	122.76677933365524
chr16	PRRT2	29813779	29813933	6146	155	265381	2305	259235	2150	39.651612903225804	120.57441860465116
chr16	PRRT2	29813776	29813933	6221	158	265381	2305	259160	2147	39.37341772151899	120.70796460176992
chr16	PRRT2	29813394	29813933	12494	540	265381	2305	252887	1765	23.137037037037036	143.2787535410765
chr16	PRRT2	29813394	29813778	6348	385	265381	2305	259033	1920	16.48831168831169	134.91302083333332
chr16	PRRT2	29813776	29813778	75	3	265381	2305	265306	2302	25.0	115.25021720243267
chr16	PRRT2	29812324	29812351	1038	28	265381	2305	264343	2277	37.07142857142857	116.09266578831796
chr16	PRRT2	29813394	29813775	6273	382	265381	2305	259108	1923	16.421465968586386	134.74154966198648
chr16	PRRT2	29812352	29812404	1467	53	265381	2305	263914	2252	27.67924528301887	117.19094138543517
chr16	PRRT2	29812405	29812472	7144	68	265381	2305	258237	2237	105.05882352941177	115.43898077782745
chr16	MVP	29834067	29834397	541	331	208997	5786	208456	5455	1.634441087613293	38.21374885426214
chr16	ASPHD1	29900567	29900741	0	175	6603	2178	6603	2003	0.0	3.2965551672491262
chr16	AC093512.2	30064072	30064248	168	177	3839	3371	3671	3194	0.9491525423728814	1.149342517219787
chr16	ALDOA	30067334	30067366	0	33	11236	2724	11236	2691	0.0	4.1753994797473055
chr16	ALDOA	30064506	30064784	2942	279	11236	2724	8294	2445	10.544802867383513	3.3922290388548055
chr16	ALDOA	30068979	30068990	82	12	11236	2724	11154	2712	6.833333333333333	4.1128318584070795
chr16	PPP4C	30076095	30076100	60	6	2764571	2653	2764511	2647	10.0	1044.3940309784662
chr16	PPP4C	30082848	30082963	1809	116	2764571	2653	2762762	2537	15.594827586206897	1088.987780843516
chr16	CORO1A	30183014	30183133	0	120	0	3668	0	3548	0.0	0.0
chr16	SLX1A-SULT1A3	30194792	30195227	1859	436	40996	4064	39137	3628	4.263761467889908	10.787486218302094
chr16	ITGAL	30483960	30483964	0	5	417	9594	417	9589	0.0	0.04348732923141099
chr16	ITGAL	30489387	30492069	306	2683	417	9594	111	6911	0.1140514349608647	0.01606135146867313
chr16	PRR14	30654998	30655214	0	217	240	3517	240	3300	0.0	0.07272727272727272
chr16	PHKG2	30748419	30748490	4969	72	243622	4744	238653	4672	69.01388888888889	51.08154965753425
chr16	PHKG2	30751218	30751281	12323	64	243622	4744	231299	4680	192.546875	49.42286324786325
chr16	RNF40	30762361	30762398	0	38	497203	6186	497203	6148	0.0	80.87231620039037
chr16	FBXL19	30928629	30928630	0	2	18501	4683	18501	4681	0.0	3.9523606067079684
chr16	FBXL19	30928500	30928630	1353	131	18501	4683	17148	4552	10.32824427480916	3.76713532513181
chr16	FBXL19	30928500	30928628	1353	129	18501	4683	17148	4554	10.488372093023257	3.7654808959156787
chr16	HSD3B7	30985825	30985947	64	123	1048	2497	984	2374	0.5203252032520326	0.4144903117101938
chr16	ZNF646	31074632	31074761	0	130	27542	8293	27542	8163	0.0	3.3740046551512926
chr16	ZNF646	31074721	31074761	0	41	27542	8293	27542	8252	0.0	3.3376151236063984
chr16	ZNF646	31074632	31074720	0	89	27542	8293	27542	8204	0.0	3.357142857142857
chr16	ARMC5	31458977	31459340	4194	364	85837	4981	81643	4617	11.521978021978022	17.68312757201646
chr16	ARMC5	31460000	31460278	2382	279	85837	4981	83455	4702	8.53763440860215	17.74883028498511
chr16	ZNF720	31713436	31713448	0	13	7023	6006	7023	5993	0.0	1.1718671783747705
chr16	AC142381.3	31984190	31984197	0	8	102	2178	102	2170	0.0	0.047004608294930875
chr16	AC137800.1	32602633	32602697	0	65	0	1168	0	1103	0.0	0.0
chr16	AC142086.1	32886592	32886772	0	181	714	2163	714	1982	0.0	0.3602421796165489
chr16	AC023824.5	35144766	35144969	0	204	0	1223	0	1019	0.0	0.0
chr16	AC023824.5	35144970	35145075	0	106	0	1223	0	1117	0.0	0.0
chr16	AC023824.5	35144766	35145075	0	310	0	1223	0	913	0.0	0.0
chr16	GPT2	46884725	46884958	0	234	8396	6374	8396	6140	0.0	1.3674267100977198
chr16	LINC02134	47965821	47966010	0	190	0	756	0	566	0.0	0.0
chr16	AC007614.1	49285521	49285623	0	103	102	24089	102	23986	0.0	0.00425248061369132
chr16	ADCY7	50304517	50304551	0	35	686	8372	686	8337	0.0	0.08228379513014274
chr16	ADCY7	50266588	50266680	0	93	686	8372	686	8279	0.0	0.08286024882232154
chr16	NOD2	50697317	50698039	0	723	0	6889	0	6166	0.0	0.0
chr16	NOD2	50712374	50712401	0	28	0	6889	0	6861	0.0	0.0
chr16	NOD2	50712402	50712637	0	236	0	6889	0	6653	0.0	0.0
chr16	NOD2	50712374	50712637	0	264	0	6889	0	6625	0.0	0.0
chr16	CYLD	50742823	50742841	0	19	38471	10005	38471	9986	0.0	3.8524934908872424
chr16	CYLD	50742125	50742216	0	92	38471	10005	38471	9913	0.0	3.8808635125592654
chr16	LINC02128	50884278	50884322	0	45	0	5070	0	5025	0.0	0.0
chr16	LINC02128	50884310	50884322	0	13	0	5070	0	5057	0.0	0.0
chr16	LINC02128	50884278	50884309	0	32	0	5070	0	5038	0.0	0.0
chr16	LINC02128	50884742	50884747	0	6	0	5070	0	5064	0.0	0.0
chr16	LINC02128	50880262	50880520	0	259	0	5070	0	4811	0.0	0.0
chr16	LINC02127	51025014	51025059	0	46	0	1918	0	1872	0.0	0.0
chr16	LINC02127	51022277	51022863	0	587	0	1918	0	1331	0.0	0.0
chr16	LINC02180	52092337	52092338	0	2	0	2068	0	2066	0.0	0.0
chr16	LINC02180	52092339	52092342	0	4	0	2068	0	2064	0.0	0.0
chr16	LINC02180	52092337	52092342	0	6	0	2068	0	2062	0.0	0.0
chr16	AC007333.1	52238566	52238711	0	146	0	2171	0	2025	0.0	0.0
chr16	AC026462.3	52607158	52607538	0	381	0	3107	0	2726	0.0	0.0
chr16	CHD9	53307906	53307953	0	48	4499	15474	4499	15426	0.0	0.2916504602618955
chr16	GNAO1	56354988	56355081	0	94	360	13840	360	13746	0.0	0.026189436927106065
chr16	OGFOD1	56451568	56451760	0	193	50204	5793	50204	5600	0.0	8.965
chr16	OGFOD1	56453381	56453408	0	28	50204	5793	50204	5765	0.0	8.708412836079791
chr16	OGFOD1	56451568	56451766	0	199	50204	5793	50204	5594	0.0	8.974615659635324
chr16	OGFOD1	56451761	56451766	0	6	50204	5793	50204	5787	0.0	8.67530672196302
chr16	MT1B	56652635	56652636	2352	2	69920	396	67568	394	1176.0	171.49238578680203
chr16	MT1F	56658741	56658782	0	42	145416	589	145416	547	0.0	265.84277879341863
chr16	MT1X	56683231	56683386	0	156	0	1133	0	977	0.0	0.0
chr16	NUP93	56782308	56782641	5992	334	120263	11123	114271	10789	17.940119760479043	10.591435721568264
chr16	NUP93	56783573	56783872	0	300	120263	11123	120263	10823	0.0	11.11179894668761
chr16	SLC12A3	56892134	56892160	0	27	57577	6207	57577	6180	0.0	9.316666666666666
chr16	HERPUD1	56940089	56940245	0	157	153	4885	153	4728	0.0	0.03236040609137056
chr16	NLRC5	56989596	56989617	0	22	21072	12006	21072	11984	0.0	1.7583444592790387
chr16	NLRC5	57028156	57028203	0	48	21072	12006	21072	11958	0.0	1.7621675865529354
chr16	RSPRY1	57186430	57186442	805	13	155387	5008	154582	4995	61.92307692307692	30.947347347347346
chr16	RSPRY1	57186430	57186785	46373	356	155387	5008	109014	4652	130.26123595505618	23.433791917454858
chr16	RSPRY1	57186443	57186785	45568	343	155387	5008	109819	4665	132.85131195335276	23.541050375133977
chr16	RSPRY1	57186452	57186785	45044	334	155387	5008	110343	4674	134.8622754491018	23.607830551989732
chr16	RSPRY1	57186430	57186451	1329	22	155387	5008	154058	4986	60.40909090909091	30.898114721219414
chr16	RSPRY1	57186443	57186451	524	9	155387	5008	154863	4999	58.22222222222222	30.97879575915183
chr16	RSPRY1	57186430	57187050	97883	621	155387	5008	57504	4387	157.62157809983896	13.107818554821062
chr16	RSPRY1	57186443	57187050	97078	608	155387	5008	58309	4400	159.66776315789474	13.252045454545454
chr16	RSPRY1	57186786	57187050	51510	265	155387	5008	103877	4743	194.37735849056602	21.9011174362218
chr16	RSPRY1	57186452	57187050	96554	599	155387	5008	58833	4409	161.19198664440734	13.343842141075074
chr16	COQ9	57456627	57456646	0	20	357	3924	357	3904	0.0	0.09144467213114754
chr16	ADGRG5	57542702	57543173	306	472	17484	5643	17178	5171	0.6483050847457628	3.321988010056082
chr16	ADGRG1	57650352	57650355	0	4	1225	7445	1225	7441	0.0	0.16462841015992474
chr16	ADGRG1	57628727	57628802	0	76	1225	7445	1225	7369	0.0	0.16623693852625865
chr16	ADGRG1	57628803	57628828	0	26	1225	7445	1225	7419	0.0	0.16511659253268635
chr16	ADGRG1	57628727	57628828	0	102	1225	7445	1225	7343	0.0	0.16682554814108674
chr16	ADGRG1	57640143	57640268	0	126	1225	7445	1225	7319	0.0	0.16737259188413717
chr16	ADGRG1	57645996	57646319	0	324	1225	7445	1225	7121	0.0	0.1720264007864064
chr16	ADGRG1	57646150	57646319	0	170	1225	7445	1225	7275	0.0	0.16838487972508592
chr16	DRC7	57699025	57699033	0	9	28143	4027	28143	4018	0.0	7.004230960676954
chr16	KATNB1	57737068	57737283	0	216	0	3360	0	3144	0.0	0.0
chr16	USB1	58002591	58002645	0	55	240	4598	240	4543	0.0	0.05282852740479859
chr16	USB1	58014295	58014326	0	32	240	4598	240	4566	0.0	0.052562417871222074
chr16	USB1	58001582	58001588	0	7	240	4598	240	4591	0.0	0.05227619255064256
chr16	LINC02137	58421386	58421421	0	36	5274	1782	5274	1746	0.0	3.020618556701031
chr16	NDRG4	58465072	58465235	0	164	2739	7151	2739	6987	0.0	0.3920137398024903
chr16	NDRG4	58503904	58503957	0	54	2739	7151	2739	7097	0.0	0.38593772016344935
chr16	NDRG4	58501613	58501678	0	66	2739	7151	2739	7085	0.0	0.38659139026111505
chr16	SETD6	58515881	58516097	1224	217	6423	7506	5199	7289	5.640552995391705	0.7132665660584442
chr16	AC009081.2	60359904	60359966	0	63	0	2517	0	2454	0.0	0.0
chr16	CDH5	66376543	66376600	0	58	23	6002	23	5944	0.0	0.0038694481830417226
chr16	CMTM1	66566595	66566612	0	18	2311	1471	2311	1453	0.0	1.59050240880936
chr16	CMTM1	66566613	66566960	0	348	2311	1471	2311	1123	0.0	2.057880676758682
chr16	CMTM1	66566595	66566960	0	366	2311	1471	2311	1105	0.0	2.091402714932127
chr16	CMTM1	66566595	66566945	0	351	2311	1471	2311	1120	0.0	2.063392857142857
chr16	CMTM3	66604450	66604482	0	33	9920	2917	9920	2884	0.0	3.439667128987517
chr16	CMTM3	66604183	66604482	2241	300	9920	2917	7679	2617	7.47	2.934275888421857
chr16	CMTM3	66604183	66604449	2241	267	9920	2917	7679	2650	8.393258426966293	2.8977358490566036
chr16	CMTM3	66604483	66604555	0	73	9920	2917	9920	2844	0.0	3.488045007032349
chr16	CMTM3	66604450	66604555	0	106	9920	2917	9920	2811	0.0	3.528993240839559
chr16	PDP2	66880641	66880756	6	116	2307	5160	2301	5044	0.05172413793103448	0.45618556701030927
chr16	PDP2	66880665	66880756	0	92	2307	5160	2307	5068	0.0	0.4552091554853986
chr16	PDP2	66880674	66880756	0	83	2307	5160	2307	5077	0.0	0.4544022060271814
chr16	PDP2	66880641	66880664	6	24	2307	5160	2301	5136	0.25	0.4480140186915888
chr16	PDP2	66880641	66880673	6	33	2307	5160	2301	5127	0.18181818181818182	0.44880046811000585
chr16	PDP2	66880665	66880673	0	9	2307	5160	2307	5151	0.0	0.44787419918462434
chr16	CES2	66935712	66935976	0	265	0	4926	0	4661	0.0	0.0
chr16	CES2	66935876	66935976	0	101	0	4926	0	4825	0.0	0.0
chr16	CES2	66942738	66942785	0	48	0	4926	0	4878	0.0	0.0
chr16	CES2	66935712	66935875	0	164	0	4926	0	4762	0.0	0.0
chr16	CES4A	67000780	67000783	78	4	7043	4201	6965	4197	19.5	1.6595187038360735
chr16	CES4A	67000991	67001046	0	56	7043	4201	7043	4145	0.0	1.6991556091676718
chr16	CES4A	67001003	67001046	0	44	7043	4201	7043	4157	0.0	1.6942506615347606
chr16	CES4A	67000991	67001002	0	12	7043	4201	7043	4189	0.0	1.6813081881117211
chr16	CBFB	67082309	67082339	0	31	107975	4534	107975	4503	0.0	23.97845880524095
chr16	CBFB	67029814	67030177	0	364	107975	4534	107975	4170	0.0	25.89328537170264
chr16	C16ORF70	67109990	67110004	0	15	465126	5214	465126	5199	0.0	89.46451240623196
chr16	HSF4	67166370	67166395	2576	26	20186	2898	17610	2872	99.07692307692308	6.131615598885793
chr16	HSF4	67166012	67166070	0	59	20186	2898	20186	2839	0.0	7.110250088059176
chr16	NOL3	67174341	67174464	6614	124	55556	2844	48942	2720	53.33870967741935	17.993382352941175
chr16	NOL3	67174455	67174464	517	10	55556	2844	55039	2834	51.7	19.420959774170782
chr16	NOL3	67174341	67174454	6097	114	55556	2844	49459	2730	53.48245614035088	18.116849816849818
chr16	NOL3	67174945	67174946	80	2	55556	2844	55476	2842	40.0	19.520056298381423
chr16	E2F4	67192825	67192870	2502	46	193676	3376	191174	3330	54.391304347826086	57.40960960960961
chr16	ELMO3	67199583	67199593	508	11	251427	2551	250919	2540	46.18181818181818	98.78700787401574
chr16	ELMO3	67200807	67200808	0	2	251427	2551	251427	2549	0.0	98.63750490388388
chr16	TMEM208	67228837	67228881	12101	45	206659	1641	194558	1596	268.9111111111111	121.90350877192982
chr16	TMEM208	67228632	67228657	14922	26	206659	1641	191737	1615	573.9230769230769	118.72260061919505
chr16	PLEKHG4	67280184	67280806	0	623	24073	5721	24073	5098	0.0	4.72204786190663
chr16	PLEKHG4	67280397	67280806	0	410	24073	5721	24073	5311	0.0	4.532668047448691
chr16	PLEKHG4	67279627	67279789	0	163	24073	5721	24073	5558	0.0	4.331234256926952
chr16	PLEKHG4	67279662	67279789	0	128	24073	5721	24073	5593	0.0	4.3041301627033794
chr16	PLEKHG4	67280184	67280396	0	213	24073	5721	24073	5508	0.0	4.370551924473493
chr16	PLEKHG4	67279627	67279661	0	35	24073	5721	24073	5686	0.0	4.233731973267675
chr16	LRRC36	67347516	67347591	6	76	2071	4036	2065	3960	0.07894736842105263	0.5214646464646465
chr16	LRRC36	67326846	67326932	1528	87	2071	4036	543	3949	17.563218390804597	0.13750316535831855
chr16	RIPOR1	67529860	67530087	3225	228	24075	6172	20850	5944	14.144736842105264	3.5077388963660834
chr16	PARD6A	67661588	67661677	0	90	40783	1261	40783	1171	0.0	34.82749786507259
chr16	TSNAXIP1	67807197	67807385	0	189	933	3696	933	3507	0.0	0.2660393498716852
chr16	NUTF2	67847457	67847566	0	110	35667	2866	35667	2756	0.0	12.941582002902758
chr16	DUS2	68023352	68023615	0	264	19133	4104	19133	3840	0.0	4.982552083333333
chr16	NFATC3	68084926	68085180	1428	255	31727	8798	30299	8543	5.6	3.546646377150884
chr16	SLC7A6	68264577	68264741	525	165	60047	6338	59522	6173	3.1818181818181817	9.642313299854203
chr16	PRMT7	68311100	68311246	612	147	108658	8534	108046	8387	4.163265306122449	12.882556337188506
chr16	PRMT7	68311112	68311246	612	135	108658	8534	108046	8399	4.533333333333333	12.864150494106442
chr16	PRMT7	68311100	68311111	0	12	108658	8534	108658	8522	0.0	12.75029335836658
chr16	PRMT7	68311506	68311745	49	240	108658	8534	108609	8294	0.20416666666666666	13.09488787074994
chr16	ZFP90	68530335	68530534	0	200	2754	5921	2754	5721	0.0	0.48138437336130047
chr16	ZFP90	68539430	68539469	0	40	2754	5921	2754	5881	0.0	0.46828770617241966
chr16	ZFP90	68539470	68539487	0	18	2754	5921	2754	5903	0.0	0.4665424360494664
chr16	ZFP90	68539430	68539487	0	58	2754	5921	2754	5863	0.0	0.46972539655466483
chr16	ZFP90	68539480	68539487	0	8	2754	5921	2754	5913	0.0	0.4657534246575342
chr16	ZFP90	68539470	68539479	0	10	2754	5921	2754	5911	0.0	0.46591101336491286
chr16	ZFP90	68539430	68539479	0	50	2754	5921	2754	5871	0.0	0.4690853346959632
chr16	CDH3	68687737	68687744	0	8	17114	5982	17114	5974	0.0	2.8647472380314696
chr16	CDH1	68813496	68813562	0	67	102	5466	102	5399	0.0	0.018892387479162807
chr16	TANGO6	68909403	68909615	0	213	4127	6935	4127	6722	0.0	0.6139541803034811
chr16	SNTB2	69187734	69187746	468	13	21439	9427	20971	9414	36.0	2.227639685574676
chr16	SNTB2	69260128	69260260	0	133	21439	9427	21439	9294	0.0	2.306757047557564
chr16	NFAT5	69647168	69647586	204	419	13607	11906	13403	11487	0.48687350835322196	1.1667972490641594
chr16	CLEC18A	69951040	69951097	0	58	17085	5340	17085	5282	0.0	3.2345702385460053
chr16	PDPR	70145798	70145833	0	36	80158	9700	80158	9664	0.0	8.294495033112582
chr16	CLEC18C	70173952	70174009	0	58	68521	4195	68521	4137	0.0	16.56296833454194
chr16	CLEC18C	70173973	70174009	0	37	68521	4195	68521	4158	0.0	16.47931697931698
chr16	CLEC18C	70173952	70173972	0	21	68521	4195	68521	4174	0.0	16.416147580258745
chr16	DDX19B	70294918	70295066	131233	149	205610	4471	74377	4322	880.7583892617449	17.20893105043961
chr16	DDX19A	70361511	70361636	1786	126	20147	5294	18361	5168	14.174603174603174	3.552825077399381
chr16	FCSK	70475416	70475493	0	78	6369	7256	6369	7178	0.0	0.8872945110058512
chr16	FCSK	70454806	70454940	0	135	6369	7256	6369	7121	0.0	0.8943968543743857
chr16	SF3B3	70523929	70524055	0	127	153036	8298	153036	8171	0.0	18.729164116999144
chr16	AC106736.1	71301796	71301850	0	55	0	1680	0	1625	0.0	0.0
chr16	CALB2	71384020	71384025	0	6	0	1478	0	1472	0.0	0.0
chr16	TAT-AS1	71565095	71565122	0	28	609	1575	609	1547	0.0	0.3936651583710407
chr16	TAT-AS1	71565123	71565666	0	544	609	1575	609	1031	0.0	0.5906886517943744
chr16	TAT-AS1	71565095	71565666	0	572	609	1575	609	1003	0.0	0.6071784646061814
chr16	MARVELD3	71626534	71626696	0	163	335	6429	335	6266	0.0	0.053463134375997444
chr16	DHX38	72093890	72094051	0	162	2709	6143	2709	5981	0.0	0.45293429192442736
chr16	HCCAT5	73092594	73092985	1144	392	9393	2298	8249	1906	2.9183673469387754	4.32791185729276
chr16	ZFP1	75148644	75148662	0	19	2291	3766	2291	3747	0.0	0.6114224713103816
chr16	ZFP1	75166897	75166913	0	17	2291	3766	2291	3749	0.0	0.6110962923446253
chr16	AC009078.2	75227229	75227306	0	78	0	1027	0	949	0.0	0.0
chr16	TERF2IP	75648553	75648682	0	130	39714	4429	39714	4299	0.0	9.237962316817864
chr16	MON1B	77190935	77191260	0	326	0	6532	0	6206	0.0	0.0
chr16	MON1B	77191225	77191260	0	36	0	6532	0	6496	0.0	0.0
chr16	MON1B	77191259	77191260	0	2	0	6532	0	6530	0.0	0.0
chr16	MON1B	77191225	77191258	0	34	0	6532	0	6498	0.0	0.0
chr16	WWOX	78099886	78099999	0	114	204	4894	204	4780	0.0	0.042677824267782424
chr16	LINC01229	79722396	79722453	0	58	0	9960	0	9902	0.0	0.0
chr16	CENPN	81007278	81007445	0	168	7664	3581	7664	3413	0.0	2.2455317902138883
chr16	CENPN	81014182	81014391	1933	210	7664	3581	5731	3371	9.204761904761904	1.7000889943636903
chr16	ATMIN	81037476	81037498	41	23	100847	6264	100806	6241	1.7826086956521738	16.152219195641724
chr16	AC099524.1	81739386	81739436	0	51	15701	1867	15701	1816	0.0	8.64592511013216
chr16	AC099524.1	81739437	81739734	51	298	15701	1867	15650	1569	0.17114093959731544	9.974506054811982
chr16	DNAAF1	84174723	84174728	0	6	9728	3756	9728	3750	0.0	2.594133333333333
chr16	ADAD2	84195159	84195194	0	36	629	3985	629	3949	0.0	0.1592808305900228
chr16	KLHL36	84648650	84648887	255	238	5746	10014	5491	9776	1.0714285714285714	0.5616816693944353
chr16	KLHL36	84649067	84649318	1137	252	5746	10014	4609	9762	4.511904761904762	0.47213685720139315
chr16	KIAA0513	85027852	85027858	84	7	1102	8851	1018	8844	12.0	0.1151062867480778
chr16	COX4I1	85799753	85799884	204	132	2158	1997	1954	1865	1.5454545454545454	1.0477211796246648
chr16	COX4I1	85805105	85805153	0	49	2158	1997	2158	1948	0.0	1.1078028747433264
chr16	IRF8	85902868	85902889	0	22	0	4561	0	4539	0.0	0.0
chr16	IRF8	85914142	85914171	0	30	0	4561	0	4531	0.0	0.0
chr16	LINC02188	86734889	86734909	0	21	0	5791	0	5770	0.0	0.0
chr16	LINC02188	86722132	86722147	0	16	0	5791	0	5775	0.0	0.0
chr16	MAP1LC3B	87392468	87393319	2349	852	26273	5043	23924	4191	2.757042253521127	5.708422810785016
chr16	BANP	87975186	87975203	0	18	26021	7681	26021	7663	0.0	3.3956674931488973
chr16	BANP	87975186	87975207	0	22	26021	7681	26021	7659	0.0	3.3974409191800494
chr16	BANP	87975204	87975207	0	4	26021	7681	26021	7677	0.0	3.3894750553601667
chr16	ZC3H18	88577376	88577726	385	351	15546	7150	15161	6799	1.0968660968660968	2.229886748051184
chr16	SNAI3-AS1	88671466	88671693	204	228	36456	5297	36252	5069	0.8947368421052632	7.151706450976524
chr16	SNAI3-AS1	88672115	88672122	0	8	36456	5297	36456	5289	0.0	6.892796369824163
chr16	CDT1	88806639	88806674	0	36	60536	2770	60536	2734	0.0	22.141916605705926
chr16	TRAPPC2L	88857184	88857451	4550	268	8812	3018	4262	2750	16.97761194029851	1.5498181818181818
chr16	AC092384.2	88881613	88881620	162	8	27957	2819	27795	2811	20.25	9.88794023479189
chr16	ACSF3	89093993	89093996	0	4	330	8565	330	8561	0.0	0.038546898726784254
chr16	AC137932.1	89297751	89297962	4517	212	21650	1262	17133	1050	21.306603773584907	16.31714285714286
chr16	SPG7	89529525	89529579	0	55	40502	18796	40502	18741	0.0	2.161144015794248
chr16	SPG7	89540978	89541027	0	50	40502	18796	40502	18746	0.0	2.1605675877520536
chr16	SPG7	89541385	89542279	0	895	40502	18796	40502	17901	0.0	2.2625551645159487
chr16	SPG7	89541347	89542279	0	933	40502	18796	40502	17863	0.0	2.2673683031965517
chr16	SPG7	89541371	89542279	0	909	40502	18796	40502	17887	0.0	2.2643260468496673
chr16	SPG7	89545980	89546030	0	51	40502	18796	40502	18745	0.0	2.160682848759669
chr16	SPG7	89545996	89546030	0	35	40502	18796	40502	18761	0.0	2.1588401471136933
chr16	SPG7	89541347	89541384	0	38	40502	18796	40502	18758	0.0	2.159185414223265
chr16	SPG7	89541371	89541384	0	14	40502	18796	40502	18782	0.0	2.1564263656692577
chr16	SPG7	89546031	89546181	0	151	40502	18796	40502	18645	0.0	2.1722713864306784
chr16	SPG7	89545980	89546181	0	202	40502	18796	40502	18594	0.0	2.1782295364095945
chr16	SPG7	89545996	89546181	0	186	40502	18796	40502	18610	0.0	2.1763567974207416
chr16	SPG7	89530809	89530957	0	149	40502	18796	40502	18647	0.0	2.172038397597469
chr16	SPG7	89553136	89553163	70	28	40502	18796	40432	18768	2.5	2.154305200341006
chr16	SPG7	89541347	89541370	0	24	40502	18796	40502	18772	0.0	2.1575751118687405
chr16	SPG7	89545980	89545995	0	16	40502	18796	40502	18780	0.0	2.1566560170394036
chr16	SPG7	89546182	89546187	0	6	40502	18796	40502	18790	0.0	2.1555082490686535
chr16	SPG7	89544773	89546181	3417	1409	40502	18796	37085	17387	2.425124201561391	2.132915396560649
chr16	SPG7	89549337	89549713	1481	377	40502	18796	39021	18419	3.9283819628647216	2.118518920679733
chr16	RPL13	89560713	89560839	0	127	25337	3088	25337	2961	0.0	8.556906450523472
chr16	RPL13	89560713	89561063	403	351	25337	3088	24934	2737	1.1481481481481481	9.10997442455243
chr16	RPL13	89562392	89562445	17	54	25337	3088	25320	3034	0.3148148148148148	8.345418589321028
chr16	SPATA33	89657836	89657866	4454	31	77104	3500	72650	3469	143.67741935483872	20.942634765061978
chr16	SPATA33	89657867	89657948	4816	82	77104	3500	72288	3418	58.73170731707317	21.149210064365125
chr16	SPATA33	89657836	89657948	9270	113	77104	3500	67834	3387	82.03539823008849	20.027753173900205
chr16	SPATA33	89658210	89658421	4039	212	77104	3500	73065	3288	19.05188679245283	22.221715328467152
chr16	CDK10	89695053	89695070	0	18	134	5398	134	5380	0.0	0.02490706319702602
chr16	CDK10	89689307	89689324	0	18	134	5398	134	5380	0.0	0.02490706319702602
chr16	CDK10	89686760	89686797	0	38	134	5398	134	5360	0.0	0.025
chr16	VPS9D1-AS1	89716638	89716904	717	267	147113	1700	146396	1433	2.6853932584269664	102.16050244242847
chr16	ZNF276	89727326	89727357	5109	32	73884	5580	68775	5548	159.65625	12.396359048305696
chr16	TCF25	89887682	89887717	0	36	66725	6664	66725	6628	0.0	10.067139408569703
chr16	TCF25	89909084	89909107	339	24	66725	6664	66386	6640	14.125	9.99789156626506
chr16	TUBB3	89922184	89922245	44	62	70244	4255	70200	4193	0.7096774193548387	16.742189363224423
chr16	DEF8	89949514	89949638	1335	125	170457	5553	169122	5428	10.68	31.157332350773764
chr16	DEF8	89950307	89950328	100	22	170457	5553	170357	5531	4.545454545454546	30.80039775809076
chr16	AFG3L1P	89981919	89981923	120	5	5067709	8480	5067589	8475	24.0	597.945604719764
chr16	AFG3L1P	89984600	89984617	348	18	5067709	8480	5067361	8462	19.333333333333332	598.8372725124084
chr16	TUBB8P7	90094536	90094639	162	104	35246	2470	35084	2366	1.5576923076923077	14.828402366863905
chr16	TUBB8P7	90094536	90094829	491	294	35246	2470	34755	2176	1.6700680272108843	15.971966911764707
chr16	TUBB8P7	90094640	90094829	329	190	35246	2470	34917	2280	1.731578947368421	15.314473684210526
chr16	LINC02193	90215557	90216198	204	642	10573	4443	10369	3801	0.3177570093457944	2.7279663246514074
chr16	LINC02193	90222293	90222296	16	4	10573	4443	10557	4439	4.0	2.378238341968912
chr16	NPRL3	138149	138230	0	82	41948	5493	41948	5411	0.0	7.7523563112178895
chr16	NPRL3	138149	138640	802	492	41948	5493	41146	5001	1.6300813008130082	8.227554489102179
chr16	LUC7L	227986	229277	2448	1292	5313	6101	2865	4809	1.894736842105263	0.5957579538365565
chr16	LUC7L	227986	228331	0	346	5313	6101	5313	5755	0.0	0.9231972198088618
chr16	LUC7L	227986	228699	1326	714	5313	6101	3987	5387	1.8571428571428572	0.7401150918878783
chr16	LUC7L	189930	189966	10	37	5313	6101	5303	6064	0.2702702702702703	0.8745052770448549
chr16	LUC7L	189930	189945	0	16	5313	6101	5313	6085	0.0	0.8731306491372227
chr16	LUC7L	189946	189966	10	21	5313	6101	5303	6080	0.47619047619047616	0.8722039473684211
chr16	LUC7L	228488	228699	561	212	5313	6101	4752	5889	2.6462264150943398	0.8069281711665818
chr16	LUC7L	228700	228788	0	89	5313	6101	5313	6012	0.0	0.8837325349301397
chr16	LUC7L	228789	229277	1122	489	5313	6101	4191	5612	2.294478527607362	0.7467925873129009
chr16	RGS11	275837	275847	0	11	35923	4272	35923	4261	0.0	8.430650082140343
chr16	MRPL28	370484	370497	0	14	10780	2261	10780	2247	0.0	4.797507788161994
chr16	MRPL28	370443	370497	0	55	10780	2261	10780	2206	0.0	4.8866727107887575
chr16	MRPL28	370443	370483	0	41	10780	2261	10780	2220	0.0	4.8558558558558556
chr16	METTL26	635517	635610	141	94	590	1123	449	1029	1.5	0.4363459669582119
chr16	JMJD8	682952	682956	0	5	13361	2400	13361	2395	0.0	5.578705636743215
chr16	JMJD8	683860	683908	0	49	13361	2400	13361	2351	0.0	5.683113568694172
chr16	CCDC78	725412	725444	0	33	225654	2919	225654	2886	0.0	78.1891891891892
chr16	CIAO3	737497	737659	11945	163	557062	6627	545117	6464	73.28220858895706	84.33121905940594
chr16	CIAO3	739539	739641	4398	103	557062	6627	552664	6524	42.699029126213595	84.71244635193133
chr16	MSLNL	778625	778640	66	16	36861	2355	36795	2339	4.125	15.73108165882856
chr16	RPUSD1	787353	787395	302	43	23123	2764	22821	2721	7.023255813953488	8.386990077177508
chr16	RPUSD1	787067	787075	0	9	23123	2764	23123	2755	0.0	8.393103448275863
chr16	RPUSD1	787343	787352	20	10	23123	2764	23103	2754	2.0	8.38888888888889
chr16	RPUSD1	787343	787395	322	53	23123	2764	22801	2711	6.0754716981132075	8.410549612689044
chr16	LMF1	934189	934242	0	54	6057	8238	6057	8184	0.0	0.7401026392961877
chr16	CEROX1	979600	980125	0	526	102	2975	102	2449	0.0	0.041649652919559
chr16	UNKL	1367091	1367240	6011	150	242038	4550	236027	4400	40.07333333333333	53.6425
chr16	UNKL	1369933	1370128	12090	196	242038	4550	229948	4354	61.683673469387756	52.8130454754249
chr16	UNKL	1379532	1379592	0	61	242038	4550	242038	4489	0.0	53.918021831142795
chr16	CCDC154	1434667	1434749	828	83	16226	2440	15398	2357	9.975903614457831	6.532880780653373
chr16	PTX4	1487315	1487759	3213	445	10273	1692	7060	1247	7.2202247191011235	5.6615878107457895
chr16	IFT140	1526618	1526731	0	114	188325	8162	188325	8048	0.0	23.40022365805169
chr16	IFT140	1610416	1610662	0	247	188325	8162	188325	7915	0.0	23.7934301958307
chr16	NME3	1770880	1770887	0	8	0	1294	0	1286	0.0	0.0
chr16	NME3	1771268	1771278	0	11	0	1294	0	1283	0.0	0.0
chr16	NME3	1771279	1771303	0	25	0	1294	0	1269	0.0	0.0
chr16	HAGH	1826506	1826710	2199	205	352969	5851	350770	5646	10.726829268292683	62.12716967764789
chr16	MSRB1	1940777	1941255	0	479	0	2025	0	1546	0.0	0.0
chr16	RPS2	1964448	1964805	0	358	102	1934	102	1576	0.0	0.06472081218274112
chr16	NOXO1	1980640	1980654	0	15	612	2072	612	2057	0.0	0.2975206611570248
chr16	ZNF598	2000390	2000407	0	18	214860	4333	214860	4315	0.0	49.793742757821555
chr16	ZNF598	2001582	2001590	0	9	214860	4333	214860	4324	0.0	49.69010175763182
chr16	NTHL1	2046127	2046278	0	152	95899	1666	95899	1514	0.0	63.341479524438576
chr16	PKD1	2103265	2103723	16137	459	277560	16200	261423	15741	35.15686274509804	16.607775871926815
chr16	PKD1	2103265	2103430	10643	166	277560	16200	266917	16034	64.1144578313253	16.64693775726581
chr16	PKD1	2103431	2103723	5494	293	277560	16200	272066	15907	18.75085324232082	17.103539322310933
chr16	ECI1	2243317	2243367	0	51	1014	2942	1014	2891	0.0	0.35074368730543065
chr16	RNPS1	2263095	2263140	4281	46	446461	7319	442180	7273	93.06521739130434	60.79747009487144
chr16	RNPS1	2264175	2264181	1351	7	446461	7319	445110	7312	193.0	60.87390590809628
chr16	RNPS1	2267174	2267207	90	34	446461	7319	446371	7285	2.6470588235294117	61.272614962251204
chr16	RNPS1	2267174	2267573	1161	400	446461	7319	445300	6919	2.9025	64.35901141783495
chr16	RNPS1	2267174	2267198	90	25	446461	7319	446371	7294	3.6	61.19701124211681
chr16	RNPS1	2267174	2267187	84	14	446461	7319	446377	7305	6.0	61.1056810403833
chr16	RNPS1	2267932	2268053	0	122	446461	7319	446461	7197	0.0	62.03431985549535
chr16	RNPS1	2267208	2267661	1071	454	446461	7319	445390	6865	2.359030837004405	64.87836853605243
chr16	RNPS1	2267208	2267573	1071	366	446461	7319	445390	6953	2.9262295081967213	64.05724147849848
chr16	RNPS1	2267574	2267661	0	88	446461	7319	446461	7231	0.0	61.742635873323195
chr16	RNPS1	2267199	2267207	0	9	446461	7319	446461	7310	0.0	61.075376196990426
chr16	RNPS1	2267188	2267207	6	20	446461	7319	446455	7299	0.3	61.166598164132076
chr16	RNPS1	2267188	2267198	6	11	446461	7319	446455	7308	0.5454545454545454	61.09126984126984
chr16	ERVK13-1	2671344	2671593	836	250	51005	6668	50169	6418	3.344	7.816921159239638
chr16	ERVK13-1	2669410	2671343	4641	1934	51005	6668	46364	4734	2.3996897621509823	9.793831854668356
chr16	ERVK13-1	2669410	2671593	5477	2184	51005	6668	45528	4484	2.5077838827838828	10.15343443354148
chr16	ERVK13-1	2671023	2671343	2346	321	51005	6668	48659	6347	7.308411214953271	7.666456593666299
chr16	ERVK13-1	2671023	2671593	3182	571	51005	6668	47823	6097	5.572679509632224	7.843693619813023
chr16	ERVK13-1	2670809	2670862	0	54	51005	6668	51005	6614	0.0	7.711672210462655
chr16	ERVK13-1	2672706	2673281	5739	576	51005	6668	45266	6092	9.963541666666666	7.430400525279055
chr16	SRRM2-AS1	2743441	2743550	180	110	51997	5093	51817	4983	1.6363636363636365	10.398755769616697
chr16	SRRM2-AS1	2738368	2738440	0	73	51997	5093	51997	5020	0.0	10.35796812749004
chr16	PRSS30P	2840147	2841161	0	1015	0	1785	0	770	0.0	0.0
chr16	PRSS30P	2841407	2841678	0	272	0	1785	0	1513	0.0	0.0
chr16	PRSS30P	2841407	2841571	0	165	0	1785	0	1620	0.0	0.0
chr16	PRSS22	2856081	2856132	0	52	163	2201	163	2149	0.0	0.07584923220102373
chr16	PRSS22	2857636	2857826	0	191	163	2201	163	2010	0.0	0.08109452736318408
chr16	PKMYT1	2979647	2979806	16475	160	45511	4989	29036	4829	102.96875	6.0128390971215575
chr16	PKMYT1	2979647	2979814	18049	168	45511	4989	27462	4821	107.43452380952381	5.696328562538892
chr16	PKMYT1	2979807	2979814	1574	8	45511	4989	43937	4981	196.75	8.820919494077495
chr16	PKMYT1	2980218	2980284	0	67	45511	4989	45511	4922	0.0	9.246444534741975
chr16	ZSCAN10	3092541	3092675	18	135	2606	3080	2588	2945	0.13333333333333333	0.8787775891341256
chr16	ZNF213-AS1	3129247	3129459	0	213	11489	9872	11489	9659	0.0	1.1894606066880629
chr16	ZNF213-AS1	3142805	3143602	0	798	11489	9872	11489	9074	0.0	1.266145029755345
chr16	ZNF213-AS1	3134508	3134632	0	125	11489	9872	11489	9747	0.0	1.1787216579460347
chr16	ZNF200	3234986	3235110	0	125	8596	7136	8596	7011	0.0	1.2260733133647126
chr16	ZNF200	3234635	3234985	102	351	8596	7136	8494	6785	0.2905982905982906	1.2518791451731761
chr16	ZNF200	3234635	3235110	102	476	8596	7136	8494	6660	0.21428571428571427	1.2753753753753754
chr16	MEFV	3244135	3244252	0	118	14956	4838	14956	4720	0.0	3.16864406779661
chr16	C16ORF90	3495375	3495408	0	34	288	941	288	907	0.0	0.3175303197353914
chr16	ADCY9	3993348	3993404	0	57	6388	9168	6388	9111	0.0	0.7011305015914828
chr16	LINC01569	4253646	4253675	0	30	102	2431	102	2401	0.0	0.0424822990420658
chr16	LINC01569	4246972	4246987	0	16	102	2431	102	2415	0.0	0.0422360248447205
chr16	LINC01569	4252877	4253645	0	769	102	2431	102	1662	0.0	0.061371841155234655
chr16	LINC01569	4252877	4253675	0	799	102	2431	102	1632	0.0	0.0625
chr16	CORO7	4407500	4407560	29	61	26665	7153	26636	7092	0.47540983606557374	3.7557811618725325
chr16	CORO7	4416458	4416783	0	326	26665	7153	26665	6827	0.0	3.9058151457448367
chr16	CORO7	4415714	4415764	0	51	26665	7153	26665	7102	0.0	3.754576175725148
chr16	NMRAL1	4463659	4463676	0	18	9242	3199	9242	3181	0.0	2.9053756680289218
chr16	NMRAL1	4463641	4463658	0	18	9242	3199	9242	3181	0.0	2.9053756680289218
chr16	NMRAL1	4463641	4463676	0	36	9242	3199	9242	3163	0.0	2.9219095795131205
chr16	NMRAL1	4474409	4474552	0	144	9242	3199	9242	3055	0.0	3.025204582651391
chr16	NMRAL1	4474409	4474421	0	13	9242	3199	9242	3186	0.0	2.9008160703075956
chr16	NMRAL1	4474422	4474552	0	131	9242	3199	9242	3068	0.0	3.01238591916558
chr16	NMRAL1	4471313	4471355	0	43	9242	3199	9242	3156	0.0	2.928390367553866
chr16	CDIP1	4514574	4514629	443	56	225635	2499	225192	2443	7.910714285714286	92.17846909537454
chr16	CDIP1	4513695	4513814	141075	120	225635	2499	84560	2379	1175.625	35.544346364018494
chr16	UBALD1	4614492	4614676	0	185	306	2587	306	2402	0.0	0.1273938384679434
chr16	ANKS3	4733937	4734154	2	218	66065	6948	66063	6730	0.009174311926605505	9.816196136701338
chr16	SEPTIN12	4783316	4783460	34	145	9199	1954	9165	1809	0.23448275862068965	5.066334991708126
chr16	SEPTIN12	4787468	4787478	0	11	9199	1954	9199	1943	0.0	4.734431291816779
chr16	ROGDI	4801049	4801265	18321	217	55188	2850	36867	2633	84.42857142857143	14.001898974553741
chr16	NAGPA	5033272	5033339	0	68	153	4883	153	4815	0.0	0.03177570093457944
chr16	EEF2KMT	5095374	5095450	0	77	1169	2853	1169	2776	0.0	0.4211095100864553
chr16	LINC01570	5616101	5616124	0	24	0	3791	0	3767	0.0	0.0
chr16	CARHSP1	8868048	8868325	0	278	51	4936	51	4658	0.0	0.010948905109489052
chr16	CARHSP1	8861641	8861664	0	24	51	4936	51	4912	0.0	0.010382736156351791
chr16	USP7	8923214	8923352	102	139	65147	8661	65045	8522	0.7338129496402878	7.632597981694438
chr16	AC099489.1	11391665	11391782	0	118	26221	12096	26221	11978	0.0	2.1890966772416096
chr16	LITAF	11636069	11636239	0	171	1173	4952	1173	4781	0.0	0.24534616189081782
chr16	ZC3H7A	11761405	11761466	0	62	29501	7094	29501	7032	0.0	4.195250284414107
chr16	BCAR4	11821633	11821636	0	4	29758	1241	29758	1237	0.0	24.05658852061439
chr16	NPIPB2	11941837	11941981	0	145	184139	2700	184139	2555	0.0	72.07005870841488
chr16	PARN	14630106	14630188	0	83	49697	8816	49697	8733	0.0	5.6907133860071
chr16	PARN	14591912	14593299	46	1388	49697	8816	49651	7428	0.03314121037463977	6.684302638664513
chr16	NTAN1	15047996	15048076	3	81	179043	3324	179040	3243	0.037037037037037035	55.20814061054579
chr16	NTAN1	15047417	15047440	0	24	179043	3324	179043	3300	0.0	54.25545454545455
chr16	PKD1P6	15131073	15131085	1184	13	518002	6041	516818	6028	91.07692307692308	85.73623092236231
chr16	ABCC6	16221612	16221647	0	36	72339	6965	72339	6929	0.0	10.440034637032761
chr16	AC126755.5	18339367	18339384	0	18	314	4104	314	4086	0.0	0.07684777288301517
chr16	NOMO2	18529408	18529499	0	92	284362	6838	284362	6746	0.0	42.15268307144975
chr16	RPS15A	18790243	18790308	0	66	2653	4037	2653	3971	0.0	0.6680936791740116
chr16	RPS15A	18789896	18790242	0	347	2653	4037	2653	3690	0.0	0.718970189701897
chr16	SMG1	18868522	18868631	0	110	548337	22455	548337	22345	0.0	24.53958379950772
chr16	AC099518.4	19067242	19067316	0	75	0	892	0	817	0.0	0.0
chr16	AC099518.4	19067550	19067579	0	30	0	892	0	862	0.0	0.0
chr16	GDE1	19507654	19507685	0	32	3923	4397	3923	4365	0.0	0.8987399770904926
chr16	GP2	20326255	20326336	0	82	0	4061	0	3979	0.0	0.0
chr16	UMOD	20349770	20349799	0	30	0	3277	0	3247	0.0	0.0
chr16	UMOD	20352541	20352687	0	147	0	3277	0	3130	0.0	0.0
chr16	UMOD	20349707	20349769	0	63	0	3277	0	3214	0.0	0.0
chr16	UMOD	20349707	20349799	0	93	0	3277	0	3184	0.0	0.0
chr16	UMOD	20351019	20351128	0	110	0	3277	0	3167	0.0	0.0
chr16	ACSM1	20627188	20627254	0	67	51	2887	51	2820	0.0	0.018085106382978722
chr16	NPIPB3	21411241	21411263	0	23	55825	4575	55825	4552	0.0	12.26384007029877
chr16	NPIPB3	21425289	21425298	20	10	55825	4575	55805	4565	2.0	12.224534501642935
chr16	IGSF6	21647132	21647305	372	174	5164	3473	4792	3299	2.1379310344827585	1.4525613822370416
chr16	NPIPB4	21857569	21857578	30	10	65942	7314	65912	7304	3.0	9.024096385542169
chr16	NPIPB4	21857569	21857657	152	89	65942	7314	65790	7225	1.7078651685393258	9.105882352941176
chr16	NPIPB4	21851769	21851913	2429	145	65942	7314	63513	7169	16.751724137931035	8.859394615706513
chr16	AC009034.1	22288430	22288434	129	5	9646	716	9517	711	25.8	13.385372714486639
chr16	AC009034.1	22288390	22288434	2421	45	9646	716	7225	671	53.8	10.767511177347243
chr16	AC009034.1	22288390	22288429	2292	40	9646	716	7354	676	57.3	10.878698224852071
chr16	GGA2	23495693	23495712	0	20	194158	5750	194158	5730	0.0	33.88446771378709
chr16	GGA2	23495688	23495692	0	5	194158	5750	194158	5745	0.0	33.795996518711924
chr16	GGA2	23495688	23495712	0	25	194158	5750	194158	5725	0.0	33.91406113537118
chr16	GGA2	23494298	23494301	1167	4	194158	5750	192991	5746	291.75	33.58701705534285
chr16	EARS2	23553006	23553042	0	37	96082	4213	96082	4176	0.0	23.00814176245211
chr16	PALB2	23641109	23641125	389	17	44669	4745	44280	4728	22.88235294117647	9.365482233502538
chr16	NSMCE1	27241352	27241797	735	446	13465	2869	12730	2423	1.647982062780269	5.253817581510524
chr16	GTF3C1	27464319	27464393	0	75	181040	10137	181040	10062	0.0	17.99244682965613
chr16	GTF3C1	27471564	27471746	0	183	181040	10137	181040	9954	0.0	18.18766325095439
chr16	AC016597.1	27718242	27718332	0	91	8729	5320	8729	5229	0.0	1.6693440428380188
chr16	EIF3CL	28403782	28403785	0	4	1118663	3074	1118663	3070	0.0	364.385342019544
chr16	CLN3	28482476	28482606	3088	131	270893	5985	267805	5854	23.572519083969464	45.74735223778613
chr16	AC138894.1	28477011	28477462	458	452	54916	4138	54458	3686	1.0132743362831858	14.774281063483452
chr16	CLN3	28491481	28491712	246	232	270893	5985	270647	5753	1.0603448275862069	47.04449852251
chr16	CLN3	28495125	28495339	15984	215	270893	5985	254909	5770	74.34418604651162	44.178336221837085
chr16	ATP2A1-AS1	28879488	28879540	29	53	751	585	722	532	0.5471698113207547	1.3571428571428572
chr16	AC133555.3	29465394	29465476	29133	83	248632	1824	219499	1741	351.0	126.07639287765652
chr16	NPIPB12	29505783	29505792	46	10	57489	4334	57443	4324	4.6	13.284690101757631
chr16	NPIPB12	29499997	29500141	1433	145	57489	4334	56056	4189	9.882758620689655	13.381714012890905
chr16	KCTD13	29911660	29911813	826	154	115746	5191	114920	5037	5.363636363636363	22.815167758586462
chr16	HIRIP3	29993905	29994646	75943	742	187277	3487	111334	2745	102.34905660377359	40.558834244080145
chr16	DOC2A	30006784	30006854	861	71	453809	6385	452948	6314	12.126760563380282	71.73709217611656
chr16	DOC2A	30008995	30009002	97	8	453809	6385	453712	6377	12.125	71.14818880351262
chr16	DOC2A	30010898	30010901	393	4	453809	6385	453416	6381	98.25	71.05720106566369
chr16	TLCD3B	30035306	30035349	0	44	5609	4932	5609	4888	0.0	1.147504091653028
chr16	YPEL3	30096615	30096743	109493	129	490128	2150	380635	2021	848.7829457364342	188.33993072736268
chr16	YPEL3	30095995	30096095	95768	101	490128	2150	394360	2049	948.1980198019802	192.464616886286
chr16	YPEL3	30094997	30095101	104370	105	490128	2150	385758	2045	994.0	188.63471882640587
chr16	GDPD3	30108120	30108211	262	92	6994	1473	6732	1381	2.847826086956522	4.874728457639391
chr16	MAPK3	30118046	30118097	0	52	25236	3678	25236	3626	0.0	6.959735245449531
chr16	MAPK3	30117136	30117152	0	17	25236	3678	25236	3661	0.0	6.8931985796230535
chr16	AC106782.1	30204744	30204825	16283	82	283717	2545	267434	2463	198.5731707317073	108.580592773041
chr16	NPIPB13	30245764	30245773	60	10	35505	5013	35445	5003	6.0	7.084749150509694
chr16	DCTPP1	30429588	30429746	7941	159	29422	1485	21481	1326	49.943396226415096	16.199849170437407
chr16	DCTPP1	30429854	30429878	1618	25	29422	1485	27804	1460	64.72	19.043835616438358
chr16	ZNF688	30571433	30572120	102	688	2625	2926	2523	2238	0.14825581395348839	1.1273458445040214
chr16	ZNF785	30585121	30585165	1779	45	19839	3100	18060	3055	39.53333333333333	5.911620294599018
chr16	ZNF785	30585375	30585405	0	31	19839	3100	19839	3069	0.0	6.464320625610948
chr16	ZNF689	30609836	30610200	0	365	5406	3804	5406	3439	0.0	1.571968595521954
chr16	AC093249.6	30698135	30698879	102	745	0	780	-102	35	0.13691275167785236	-2.914285714285714
chr16	ZNF668	31063812	31064293	663	482	28458	3757	27795	3275	1.3755186721991701	8.487022900763359
chr16	ZNF668	31072739	31072884	5956	146	28458	3757	22502	3611	40.794520547945204	6.231514815840487
chr16	ZNF668	31064799	31064902	1075	104	28458	3757	27383	3653	10.336538461538462	7.496030659731727
chr16	PRSS36	31140491	31140677	51	187	102847	3373	102796	3186	0.2727272727272727	32.264908976773384
chr16	PRSS36	31142480	31142494	258	15	102847	3373	102589	3358	17.2	30.550625372245385
chr16	HERC2P4	32180584	32180618	0	35	446	5885	446	5850	0.0	0.07623931623931623
chr16	HERC2P4	32181810	32181862	0	53	446	5885	446	5832	0.0	0.07647462277091907
chr16	TP53TG3	32675735	32675858	0	124	0	3008	0	2884	0.0	0.0
chr16	HERC2P8	33095356	33095365	0	10	462	5145	462	5135	0.0	0.08997078870496591
chr16	HERC2P8	33115362	33115367	0	6	462	5145	462	5139	0.0	0.08990075890251022
chr16	BMS1P8	33698306	33698423	0	118	102	2182	102	2064	0.0	0.04941860465116279
chr16	AC140658.1	33974767	33974947	0	181	0	2508	0	2327	0.0	0.0
chr16	AC018558.1	35505627	35505760	0	134	0	1199	0	1065	0.0	0.0
chr16	AC018558.1	35505565	35505626	0	62	0	1199	0	1137	0.0	0.0
chr16	VPS35	46688313	46689129	102	817	112919	9751	112817	8934	0.12484700122399021	12.627826281620775
chr16	NETO2	47122867	47122887	0	21	16732	7390	16732	7369	0.0	2.270593024833763
chr16	NETO2	47109482	47109529	0	48	16732	7390	16732	7342	0.0	2.2789430672841187
chr16	ABCC12	48086740	48087924	0	1185	50	8731	50	7546	0.0	0.0066260270341902995
chr16	ABCC12	48086740	48087938	0	1199	50	8731	50	7532	0.0	0.006638343069569836
chr16	ABCC12	48087925	48087938	0	14	50	8731	50	8717	0.0	0.0057359183205231154
chr16	ABCC12	48111577	48111585	0	9	50	8731	50	8722	0.0	0.005732630130703967
chr16	ABCC12	48139162	48139186	0	25	50	8731	50	8706	0.0	0.005743165632896853
chr16	ABCC12	48155817	48155839	0	23	50	8731	50	8708	0.0	0.005741846577859439
chr16	ABCC11	48247313	48247480	0	168	306	8503	306	8335	0.0	0.0367126574685063
chr16	SIAH1	48361462	48361486	0	25	13170	5767	13170	5742	0.0	2.2936259143155695
chr16	AKTIP	53503117	53503145	0	29	58155	4978	58155	4949	0.0	11.750858759345322
chr16	AKTIP	53502699	53503145	204	447	58155	4978	57951	4531	0.4563758389261745	12.789891856102406
chr16	AKTIP	53502699	53503116	204	418	58155	4978	57951	4560	0.4880382775119617	12.708552631578947
chr16	RPGRIP1L	53703554	53703801	0	248	12548	12304	12548	12056	0.0	1.0408095554080956
chr16	LINC02169	54246822	54246837	0	16	0	858	0	842	0.0	0.0
chr16	IRX3	54285783	54286677	0	895	0	1990	0	1095	0.0	0.0
chr16	LINC02140	54370283	54370300	0	18	51	2558	51	2540	0.0	0.020078740157480315
chr16	LINC02140	54370301	54370564	0	264	51	2558	51	2294	0.0	0.022231909328683522
chr16	CRNDE	54848140	54848286	0	147	128	12295	128	12148	0.0	0.010536713862364174
chr16	CRNDE	54847975	54848139	0	165	128	12295	128	12130	0.0	0.010552349546578731
chr16	CRNDE	54928493	54928768	0	276	128	12295	128	12019	0.0	0.010649804476245944
chr16	CRNDE	54926880	54928003	0	1124	128	12295	128	11171	0.0	0.0114582400859368
chr16	AC106738.2	54938163	54938383	0	221	140	780	140	559	0.0	0.2504472271914132
chr16	CES5A	55871624	55871713	0	90	102	3225	102	3135	0.0	0.03253588516746411
chr16	CES5A	55869478	55869609	0	132	102	3225	102	3093	0.0	0.03297769156159069
chr16	CES5A	55873822	55873831	0	10	102	3225	102	3215	0.0	0.031726283048211505
chr16	BBS2	56502672	56502700	0	29	279645	5825	279645	5796	0.0	48.247929606625256
chr16	BBS2	56519745	56519955	0	211	279645	5825	279645	5614	0.0	49.81207695048094
chr16	AC106779.1	56729505	56729781	0	277	204	1568	204	1291	0.0	0.15801704105344694
chr16	PSME3IP1	57185820	57185823	0	4	111294	3087	111294	3083	0.0	36.09925397340253
chr16	PSME3IP1	57185820	57186029	1015	210	111294	3087	110279	2877	4.833333333333333	38.33124782759819
chr16	PSME3IP1	57185824	57186029	1015	206	111294	3087	110279	2881	4.927184466019417	38.27802846233946
chr16	PSME3IP1	57185544	57185819	969	276	111294	3087	110325	2811	3.510869565217391	39.24759871931697
chr16	PSME3IP1	57178501	57178804	245	304	111294	3087	111049	2783	0.805921052631579	39.90262306863097
chr16	PSME3IP1	57185544	57185734	456	191	111294	3087	110838	2896	2.387434554973822	38.27279005524862
chr16	CIAPIN1	57439181	57439184	0	4	0	3392	0	3388	0.0	0.0
chr16	DOK4	57479844	57479859	0	16	114931	4617	114931	4601	0.0	24.979569658769833
chr16	DOK4	57487095	57487129	417	35	114931	4617	114514	4582	11.914285714285715	24.992143168921867
chr16	DOK4	57480294	57480328	716	35	114931	4617	114215	4582	20.457142857142856	24.92688782191183
chr16	DOK4	57487130	57487244	1649	115	114931	4617	113282	4502	14.339130434782609	25.162594402487784
chr16	KIFC3	57797704	57797963	0	260	137741	7697	137741	7437	0.0	18.521043431491194
chr16	KIFC3	57761314	57761411	0	98	137741	7697	137741	7599	0.0	18.12620081589683
chr16	CNGB1	57960481	57960498	0	18	162	7346	162	7328	0.0	0.02210698689956332
chr16	CNOT1	58556846	58556860	60	15	86360	10398	86300	10383	4.0	8.311663295771934
chr16	CNOT1	58536967	58536987	420	21	86360	10398	85940	10377	20.0	8.281777006842054
chr16	CNOT1	58624652	58624671	0	20	86360	10398	86360	10378	0.0	8.321449219502794
chr16	SLC38A7	58683954	58684715	50	762	1681	6005	1631	5243	0.06561679790026247	0.31108144192256343
chr16	GOT2	58722118	58722148	0	31	4568	3760	4568	3729	0.0	1.224993295789756
chr16	AC092378.1	58879878	58879983	51	106	326	883	275	777	0.4811320754716981	0.3539253539253539
chr16	CDH11	65071988	65072044	0	57	25712	13237	25712	13180	0.0	1.950834597875569
chr16	CDH11	65121874	65121878	0	5	25712	13237	25712	13232	0.0	1.94316807738815
chr16	LINC00922	65356394	65356429	0	36	153	2337	153	2301	0.0	0.06649282920469361
chr16	BEAN1-AS1	66471376	66471513	0	138	33	1739	33	1601	0.0	0.02061211742660837
chr16	TK2	66510610	66511956	0	1347	58762	8924	58762	7577	0.0	7.755312128810875
chr16	TK2	66510610	66510721	0	112	58762	8924	58762	8812	0.0	6.668406718111666
chr16	TK2	66510722	66511956	0	1235	58762	8924	58762	7689	0.0	7.642346208869814
chr16	TK2	66551411	66551538	0	128	58762	8924	58762	8796	0.0	6.680536607548886
chr16	TK2	66551411	66552423	44753	1013	58762	8924	14009	7911	44.1786771964462	1.7708254329414739
chr16	TK2	66549576	66549665	78	90	58762	8924	58684	8834	0.8666666666666667	6.642970341860992
chr16	TK2	66546104	66546145	38	42	58762	8924	58724	8882	0.9047619047619048	6.611573969826615
chr16	CMTM4	66696339	66696425	0	87	9086	6340	9086	6253	0.0	1.4530625299856068
chr16	TERB1	66759114	66759139	537	26	262942	3451	262405	3425	20.653846153846153	76.61459854014599
chr16	TERB1	66801467	66801569	0	103	262942	3451	262942	3348	0.0	78.53703703703704
chr16	NAE1	66826667	66826675	0	9	102	4416	102	4407	0.0	0.02314499659632403
chr16	NAE1	66827934	66827978	0	45	102	4416	102	4371	0.0	0.023335621139327384
chr16	KIAA0895L	67181557	67181604	5928	48	192351	3439	186423	3391	123.5	54.97581834267178
chr16	EXOC3L1	67188720	67188902	19014	183	59390	3057	40376	2874	103.90163934426229	14.048712595685457
chr16	EXOC3L1	67184685	67184900	451	216	59390	3057	58939	2841	2.087962962962963	20.745864132347766
chr16	KCTD19	67326621	67326703	47	83	196761	7397	196714	7314	0.5662650602409639	26.895542794640416
chr16	TPPP3	67392946	67393378	0	433	408	2263	408	1830	0.0	0.22295081967213115
chr16	ATP6V0D1	67458963	67459096	0	134	27750	6487	27750	6353	0.0	4.368015110971195
chr16	AC027682.6	67528316	67528598	2404	283	12712	602	10308	319	8.49469964664311	32.31347962382445
chr16	ACD	67659876	67659901	0	26	23941	2398	23941	2372	0.0	10.093170320404722
chr16	GFOD2	67685456	67685510	34	55	15713	4622	15679	4567	0.6181818181818182	3.4331070724764614
chr16	CENPT	67829764	67829920	0	157	204	5102	204	4945	0.0	0.04125379170879676
chr16	CENPT	67829764	67829928	0	165	204	5102	204	4937	0.0	0.04132064006481669
chr16	CENPT	67847400	67847578	0	179	204	5102	204	4923	0.0	0.04143814747105423
chr16	CENPT	67829921	67829928	0	8	204	5102	204	5094	0.0	0.04004711425206125
chr16	CENPT	67842957	67842997	0	41	204	5102	204	5061	0.0	0.04030823947836396
chr16	CENPT	67842998	67843029	0	32	204	5102	204	5070	0.0	0.040236686390532544
chr16	CENPT	67842957	67843029	0	73	204	5102	204	5029	0.0	0.040564724597335455
chr16	CTRL	67930680	67930724	0	45	1978	2174	1978	2129	0.0	0.9290746829497417
chr16	DPEP2	67999374	67999394	33	21	34468	3207	34435	3186	1.5714285714285714	10.808223477715003
chr16	DPEP2	67999266	67999373	340	108	34468	3207	34128	3099	3.1481481481481484	11.012584704743466
chr16	DPEP2	67999266	67999394	373	129	34468	3207	34095	3078	2.891472868217054	11.076998050682262
chr16	ESRP2	68231177	68231294	0	118	10313	5121	10313	5003	0.0	2.0613631820907456
chr16	SMPD3	68363776	68363799	0	24	135031	6995	135031	6971	0.0	19.370391622435804
chr16	TERF2	69385592	69385629	394	38	493993	3724	493599	3686	10.368421052631579	133.91182854042322
chr16	NQO1	69726432	69726499	680	68	19775	2978	19095	2910	10.0	6.561855670103093
chr16	NOB1	69748917	69748949	218963	33	2096813	2054	1877850	2021	6635.242424242424	929.1687283523008
chr16	SMG1P7	70221249	70221252	0	4	4517	4515	4517	4511	0.0	1.0013300820217246
chr16	SMG1P7	70222366	70222369	4	4	4517	4515	4513	4511	1.0	1.0004433606739083
chr16	SMG1P7	70231322	70231435	0	114	4517	4515	4517	4401	0.0	1.0263576459895478
chr16	SMG1P7	70233412	70233422	11	11	4517	4515	4506	4504	1.0	1.0004440497335703
chr16	SMG1P7	70241006	70241034	0	29	4517	4515	4517	4486	0.0	1.0069103878733838
chr16	SMG1P7	70243612	70243625	14	14	4517	4515	4503	4501	1.0	1.0004443457009553
chr16	AARS1	70258032	70258051	0	20	132468	9918	132468	9898	0.0	13.383309759547384
chr16	AARS1	70262345	70262365	0	21	132468	9918	132468	9897	0.0	13.384662018793573
chr16	AARS1	70262345	70262371	0	27	132468	9918	132468	9891	0.0	13.392781316348195
chr16	AARS1	70289420	70289528	34	109	132468	9918	132434	9809	0.3119266055045872	13.501274339891935
chr16	AARS1	70262366	70262371	0	6	132468	9918	132468	9912	0.0	13.364406779661017
chr16	AARS1	70258032	70258978	3729	947	132468	9918	128739	8971	3.937697993664203	14.35057407200981
chr16	AARS1	70255719	70255726	0	8	132468	9918	132468	9910	0.0	13.367103935418768
chr16	AARS1	70253665	70253712	160	48	132468	9918	132308	9870	3.3333333333333335	13.405065856129687
chr16	COG4	70519648	70519675	14	28	66177	4424	66163	4396	0.5	15.050727934485897
chr16	HYDIN	71230561	71230628	0	68	44005	28693	44005	28625	0.0	1.537292576419214
chr16	HYDIN	71230561	71230658	0	98	44005	28693	44005	28595	0.0	1.53890540304249
chr16	HYDIN	71230629	71230658	0	30	44005	28693	44005	28663	0.0	1.5352545092977008
chr16	CMTR2	71289135	71289350	0	216	0	5440	0	5224	0.0	0.0
chr16	CMTR2	71288555	71288674	0	120	0	5440	0	5320	0.0	0.0
chr16	CMTR2	71289085	71289134	0	50	0	5440	0	5390	0.0	0.0
chr16	ZNF23	71453242	71453301	0	60	153	6589	153	6529	0.0	0.023433910246592127
chr16	ZNF23	71461658	71462208	0	551	153	6589	153	6038	0.0	0.02533951639615767
chr16	ZNF19	71488997	71489270	923	274	10992	8775	10069	8501	3.3686131386861313	1.1844488883660746
chr16	AP1G1	71769618	71769621	0	4	59370	10941	59370	10937	0.0	5.428362439425802
chr16	AP1G1	71808504	71808761	0	258	59370	10941	59370	10683	0.0	5.557427688851446
chr16	ZNF821	71867892	71867910	0	19	54736	3268	54736	3249	0.0	16.847029855340104
chr16	PMFBP1	72132732	72132746	4	15	193099	5619	193095	5604	0.26666666666666666	34.45663811563169
chr16	LINC01572	72284571	72284575	0	5	7305	12582	7305	12577	0.0	0.5808221356444303
chr16	LINC01572	72570434	72570449	0	16	7305	12582	7305	12566	0.0	0.58133057456629
chr16	AC138627.1	74215833	74215964	0	132	102	7414	102	7282	0.0	0.014007140895358419
chr16	AC138627.1	74296414	74296421	0	8	102	7414	102	7406	0.0	0.013772616797191467
chr16	AC138627.1	74296414	74296621	51	208	102	7414	51	7206	0.24519230769230768	0.007077435470441299
chr16	RFWD3	74664623	74664688	6015	66	83855	6472	77840	6406	91.13636363636364	12.15110833593506
chr16	MLKL	74675323	74675353	775	31	90965	4745	90190	4714	25.0	19.132371658888417
chr16	LDHD	75116611	75116647	0	37	671	2378	671	2341	0.0	0.2866296454506621
chr16	CTRB2	75204772	75204795	552	24	40363	2319	39811	2295	23.0	17.346840958605664
chr16	CTRB2	75204741	75204795	2325	55	40363	2319	38038	2264	42.27272727272727	16.801236749116608
chr16	CTRB2	75204741	75204771	1773	31	40363	2319	38590	2288	57.193548387096776	16.86625874125874
chr16	BCAR1	75242469	75242912	8114	444	17179	8469	9065	8025	18.274774774774773	1.129595015576324
chr16	BCAR1	75263637	75264349	355454	713	17179	8469	-338275	7756	498.5329593267882	-43.61462093862816
chr16	BCAR1	75263637	75264339	355454	703	17179	8469	-338275	7766	505.624466571835	-43.55845995364409
chr16	BCAR1	75236827	75236880	0	54	17179	8469	17179	8415	0.0	2.041473559120618
chr16	BCAR1	75264340	75264349	0	10	17179	8469	17179	8459	0.0	2.0308547109587423
chr16	TMEM170A	75464467	75464670	0	204	138956	5151	138956	4947	0.0	28.08894279361229
chr16	TMEM170A	75451668	75451736	0	69	138956	5151	138956	5082	0.0	27.342778433687524
chr16	TMEM231	75545825	75545862	32	38	30501	5614	30469	5576	0.8421052631578947	5.464311334289813
chr16	ADAT1	75622791	75623236	1326	446	174036	4501	172710	4055	2.9730941704035874	42.59186189889026
chr16	KARS1	75647463	75647576	0	114	162742	3670	162742	3556	0.0	45.765466816647915
chr16	AC105430.1	75851426	75851429	0	4	0	737	0	733	0.0	0.0
chr16	ADAMTS18	77367436	77367439	0	4	9429	6624	9429	6620	0.0	1.4243202416918428
chr16	WWOX-AS1	78241193	78241196	0	4	0	1564	0	1560	0.0	0.0
chr16	AC105411.1	80540604	80540848	0	245	0	7114	0	6869	0.0	0.0
chr16	LINC01227	80568815	80569223	0	409	0	3106	0	2697	0.0	0.0
chr16	LINC01227	80568806	80568814	0	9	0	3106	0	3097	0.0	0.0
chr16	LINC01227	80568806	80569223	0	418	0	3106	0	2688	0.0	0.0
chr16	ARLNC1	80831692	80831841	0	150	0	5783	0	5633	0.0	0.0
chr16	ARLNC1	80846456	80846658	0	203	0	5783	0	5580	0.0	0.0
chr16	ARLNC1	80837910	80837930	0	21	0	5783	0	5762	0.0	0.0
chr16	ARLNC1	80845630	80846658	0	1029	0	5783	0	4754	0.0	0.0
chr16	ARLNC1	80845630	80846455	0	826	0	5783	0	4957	0.0	0.0
chr16	ARLNC1	80845630	80846272	0	643	0	5783	0	5140	0.0	0.0
chr16	ARLNC1	80845630	80846092	0	463	0	5783	0	5320	0.0	0.0
chr16	MPHOSPH6	82164081	82164113	0	33	0	2011	0	1978	0.0	0.0
chr16	MPHOSPH6	82170092	82170123	0	32	0	2011	0	1979	0.0	0.0
chr16	AC009119.1	83804507	83805621	0	1115	0	5039	0	3924	0.0	0.0
chr16	SLC38A8	84042550	84042562	0	13	69	1990	69	1977	0.0	0.03490136570561457
chr16	TAF1C	84183071	84183074	0	4	1786	4997	1786	4993	0.0	0.35770078109353093
chr16	LINC00917	86349550	86349573	96	24	83	5647	-13	5623	4.0	-0.0023119331317801887
chr16	LINC00917	86332958	86333686	0	729	83	5647	83	4918	0.0	0.016876779178527857
chr16	MTHFSD	86555168	86555171	0	4	4806	6866	4806	6862	0.0	0.7003788982803847
chr16	MTHFSD	86551972	86552031	0	60	4806	6866	4806	6806	0.0	0.7061416397296503
chr16	LINC02189	86721695	86721898	0	204	102	902	102	698	0.0	0.14613180515759314
chr16	LINC02189	86721764	86721898	0	135	102	902	102	767	0.0	0.13298565840938723
chr16	LINC02189	86721695	86721763	0	69	102	902	102	833	0.0	0.12244897959183673
chr16	C16ORF95	87317086	87317089	0	4	51	3579	51	3575	0.0	0.014265734265734267
chr16	KLHDC4	87701553	87701636	0	84	45453	8827	45453	8743	0.0	5.198787601509779
chr16	KLHDC4	87756398	87756420	0	23	45453	8827	45453	8804	0.0	5.162766924125398
chr16	AC126696.3	87778807	87778985	1112	179	44484	1276	43372	1097	6.212290502793296	39.53691886964449
chr16	MVD	88657734	88657913	0	180	10811	4212	10811	4032	0.0	2.6812996031746033
chr16	RNF166	88702789	88703133	0	345	187862	4086	187862	3741	0.0	50.21705426356589
chr16	PIEZO1	88715932	88715969	3109	38	248096	10919	244987	10881	81.8157894736842	22.515118095763256
chr16	APRT	88811496	88811548	0	53	1885	1728	1885	1675	0.0	1.1253731343283582
chr16	ANKRD11	89313316	89313349	38	34	37481	12643	37443	12609	1.1176470588235294	2.9695455626933143
chr16	CHMP1A	89649350	89649376	38	27	452900	5318	452862	5291	1.4074074074074074	85.59100359100358
chr16	CHMP1A	89647034	89647201	28805	168	452900	5318	424095	5150	171.45833333333334	82.3485436893204
chr16	CHMP1A	89653798	89653902	9125	105	452900	5318	443775	5213	86.9047619047619	85.1285248417418
chr16	CHMP1A	89656632	89657580	52578	949	452900	5318	400322	4369	55.403582718651215	91.62783245593957
chr16	SPATA2L	89701490	89701626	0	137	51	2471	51	2334	0.0	0.021850899742930592
chr16	FANCA	89739132	89739136	15	5	201571	7815	201556	7810	3.0	25.80742637644046
chr16	FANCA	89739128	89739131	12	4	201571	7815	201559	7811	3.0	25.804506465241328
chr16	FANCA	89739128	89739136	27	9	201571	7815	201544	7806	3.0	25.819113502434025
chr16	FANCA	89764806	89764888	0	83	201571	7815	201571	7732	0.0	26.069710294878426
chr16	FANCA	89769707	89769835	0	129	201571	7815	201571	7686	0.0	26.225735102784284
chr16	FANCA	89798950	89799164	3353	215	201571	7815	198218	7600	15.595348837209302	26.081315789473685
chr16	FANCA	89799165	89799170	0	6	201571	7815	201571	7809	0.0	25.81265206812652
chr16	FANCA	89816079	89816535	89542	457	201571	7815	112029	7358	195.9343544857768	15.22546887741234
chr17	RPH3AL	352592	352710	0	119	1161	6091	1161	5972	0.0	0.19440723375753516
chr17	RPH3AL	338535	338864	0	330	1161	6091	1161	5761	0.0	0.20152751258462073
chr17	VPS53	553379	553431	34	53	173157	10943	173123	10890	0.6415094339622641	15.89742883379247
chr17	GLOD4	778621	778693	0	73	704	3270	704	3197	0.0	0.22020644354081953
chr17	GLOD4	781862	782164	0	303	704	3270	704	2967	0.0	0.23727671048196833
chr17	NXN	805067	805208	0	142	74266	5509	74266	5367	0.0	13.837525619526737
chr17	NXN	863886	864013	0	128	74266	5509	74266	5381	0.0	13.801523880319643
chr17	ABR	1057843	1057968	315	126	29893	9793	29578	9667	2.5	3.0596875969794146
chr17	ABR	1078804	1078812	0	9	29893	9793	29893	9784	0.0	3.0552943581357317
chr17	CRK	1436619	1436788	1325	170	659137	2531	657812	2361	7.794117647058823	278.61584074544686
chr17	INPP5K	1515426	1515567	51	142	34689	5034	34638	4892	0.3591549295774648	7.080539656582175
chr17	INPP5K	1509167	1509176	0	10	34689	5034	34689	5024	0.0	6.904657643312102
chr17	PITPNA	1562540	1562654	1420	115	349330	4776	347910	4661	12.347826086956522	74.64278051920189
chr17	PITPNA	1559507	1559754	77325	248	349330	4776	272005	4528	311.7943548387097	60.07177561837456
chr17	SLC43A2	1628080	1628112	99	33	707300	10395	707201	10362	3.0	68.24946921443737
chr17	SCARF1	1645559	1645595	0	37	139682	4563	139682	4526	0.0	30.862129916040654
chr17	MIR22HG	1713702	1713854	0	153	3825	2975	3825	2822	0.0	1.355421686746988
chr17	TSR1	2335259	2335306	0	48	227626	4816	227626	4768	0.0	47.74035234899329
chr17	CLUH	2711561	2711716	0	156	530	6845	530	6689	0.0	0.07923456420989684
chr17	OR1D2	3104098	3104102	0	5	51	1315	51	1310	0.0	0.038931297709923665
chr17	AC090282.1	3176790	3176874	0	85	0	712	0	627	0.0	0.0
chr17	SPATA22	3467425	3467472	32	48	114135	2625	114103	2577	0.6666666666666666	44.27745440434614
chr17	SPATA22	3471582	3471680	372	99	114135	2625	113763	2526	3.757575757575758	45.03681710213777
chr17	SPATA22	3471582	3471722	764	141	114135	2625	113371	2484	5.418439716312057	45.640499194847024
chr17	SPATA22	3471681	3471744	1088	64	114135	2625	113047	2561	17.0	44.14174150722374
chr17	SPATA22	3471681	3471722	392	42	114135	2625	113743	2583	9.333333333333334	44.03523035230352
chr17	SPATA22	3471723	3471744	696	22	114135	2625	113439	2603	31.636363636363637	43.580099884748364
chr17	SPATA22	3471723	3471865	1954	143	114135	2625	112181	2482	13.664335664335665	45.19782433521354
chr17	TRPV3	3513411	3513609	38208	199	469023	9617	430815	9418	192.0	45.74378849012529
chr17	SPATA22	3471430	3471581	46	152	114135	2625	114089	2473	0.3026315789473684	46.13384553174282
chr17	SPATA22	3471430	3471680	418	251	114135	2625	113717	2374	1.6653386454183268	47.90101095197978
chr17	SPATA22	3471430	3471722	810	293	114135	2625	113325	2332	2.7645051194539247	48.59562607204116
chr17	SPATA22	3471745	3471865	1258	121	114135	2625	112877	2504	10.396694214876034	45.078674121405754
chr17	TRPV1	3588187	3588216	0	30	1027481	5538	1027481	5508	0.0	186.54339143064632
chr17	ATP2A3	3928226	3928238	1290	13	78618	6298	77328	6285	99.23076923076923	12.303579952267302
chr17	ZZEF1	4070683	4070809	42936	127	252132	14559	209196	14432	338.0787401574803	14.49528824833703
chr17	AC127521.1	4483451	4483530	0	80	276	1062	276	982	0.0	0.28105906313645623
chr17	PELP1	4676356	4676499	0	144	11311	6512	11311	6368	0.0	1.7762248743718594
chr17	VMO1	4785936	4785955	320	20	2342	806	2022	786	16.0	2.572519083969466
chr17	VMO1	4785900	4785935	281	36	2342	806	2061	770	7.805555555555555	2.6766233766233767
chr17	VMO1	4785900	4785955	601	56	2342	806	1741	750	10.732142857142858	2.3213333333333335
chr17	CHRNE	4901931	4901977	0	47	15802	3533	15802	3486	0.0	4.532989099254159
chr17	SLC25A11	4939815	4939847	0	33	2078	1758	2078	1725	0.0	1.2046376811594204
chr17	INCA1	4996840	4997001	9802	162	25589	1562	15787	1400	60.50617283950617	11.276428571428571
chr17	ZNF232	5109393	5109709	17	317	3255	2800	3238	2483	0.05362776025236593	1.3040676600886025
chr17	ZNF594	5191431	5191746	714	316	1581	5302	867	4986	2.259493670886076	0.17388688327316487
chr17	SCIMP	5223332	5223352	0	21	255	4255	255	4234	0.0	0.06022673594709495
chr17	C1QBP	5438491	5438707	0	217	5533	2090	5533	1873	0.0	2.95408435664709
chr17	DERL2	5486068	5486115	233	48	453	5129	220	5081	4.854166666666667	0.04329856327494588
chr17	DERL2	5485862	5486067	138	206	453	5129	315	4923	0.6699029126213593	0.06398537477148081
chr17	DERL2	5485862	5486115	371	254	453	5129	82	4875	1.4606299212598426	0.01682051282051282
chr17	NLRP1	5533291	5533302	0	12	153	11515	153	11503	0.0	0.013300878031817787
chr17	AIPL1	6434950	6435007	0	58	1802	3150	1802	3092	0.0	0.5827943078913325
chr17	SLC13A5	6707027	6707030	0	4	153	5209	153	5205	0.0	0.029394812680115272
chr17	CLEC10A	7075975	7075983	0	9	5591	2340	5591	2331	0.0	2.3985413985413984
chr17	ASGR2	7108756	7108770	30	15	41992	2445	41962	2430	2.0	17.268312757201645
chr17	ASGR2	7114116	7114172	256	57	41992	2445	41736	2388	4.491228070175438	17.477386934673365
chr17	DLG4	7208074	7208172	0	99	353209	9775	353209	9676	0.0	36.50361719718892
chr17	DVL2	7230045	7230056	981	12	257511	4256	256530	4244	81.75	60.44533459000942
chr17	PHF23	7238785	7238799	0	15	357	2660	357	2645	0.0	0.13497164461247638
chr17	GABARAP	7241600	7242239	0	640	0	1609	0	969	0.0	0.0
chr17	CTDNEP1	7244101	7244187	0	87	7204	2647	7204	2560	0.0	2.8140625
chr17	CLDN7	7261820	7261845	0	26	0	2285	0	2259	0.0	0.0
chr17	YBX2	7294229	7294566	2624	338	190097	2588	187473	2250	7.763313609467455	83.32133333333333
chr17	NEURL4	7324798	7324909	84	112	827625	6057	827541	5945	0.75	139.19949537426407
chr17	NEURL4	7322947	7322952	5426	6	827625	6057	822199	6051	904.3333333333334	135.8782019500909
chr17	FXR2	7614451	7614789	96222	339	190649	4035	94427	3696	283.8407079646018	25.548430735930737
chr17	FXR2	7606015	7606095	4714	81	190649	4035	185935	3954	58.19753086419753	47.024532119372786
chr17	SAT2	7627556	7627568	0	13	50	1405	50	1392	0.0	0.035919540229885055
chr17	SAT2	7626706	7626751	46	46	50	1405	4	1359	1.0	0.0029433406916850625
chr17	NAA38	7856984	7857013	0	30	3255	1833	3255	1803	0.0	1.805324459234609
chr17	KCNAB3	7929096	7929343	0	248	17927	4331	17927	4083	0.0	4.390644134215038
chr17	TRAPPC1	7931927	7931938	0	12	0	1175	0	1163	0.0	0.0
chr17	PER1	8144750	8144758	0	9	54371	6344	54371	6335	0.0	8.582636148382004
chr17	VAMP2	8162443	8162876	939	434	247948	3246	247009	2812	2.1635944700460827	87.84103840682788
chr17	TMEM107	8174519	8174539	670	21	630460	3772	629790	3751	31.904761904761905	167.8992268728339
chr17	AURKB	8205215	8205316	0	102	1158	2119	1158	2017	0.0	0.5741199801685671
chr17	CTC1	8229301	8229333	0	33	768	8044	768	8011	0.0	0.09586818125078017
chr17	SLC25A35	8290602	8290613	0	12	4291	3447	4291	3435	0.0	1.2491994177583696
chr17	RPL26	8383141	8383155	290	15	52968	2188	52678	2173	19.333333333333332	24.242061665899676
chr17	RPL26	8382780	8383140	1356	361	52968	2188	51612	1827	3.7562326869806095	28.249589490968802
chr17	RPL26	8382780	8383155	1646	376	52968	2188	51322	1812	4.377659574468085	28.323399558498895
chr17	RPL26	8382780	8382860	100	81	52968	2188	52868	2107	1.2345679012345678	25.091599430469863
chr17	RPL26	8382861	8383140	1256	280	52968	2188	51712	1908	4.485714285714286	27.10272536687631
chr17	RPL26	8382861	8383155	1546	295	52968	2188	51422	1893	5.240677966101695	27.164289487585844
chr17	RPL26	8382774	8382779	2	6	52968	2188	52966	2182	0.3333333333333333	24.274060494958754
chr17	RPL26	8382774	8382860	102	87	52968	2188	52866	2101	1.1724137931034482	25.162303664921467
chr17	SPDYE4	8758268	8758272	0	5	0	1069	0	1064	0.0	0.0
chr17	PIK3R6	8837802	8837817	16	16	207	3586	191	3570	1.0	0.05350140056022409
chr17	PIK3R6	8838295	8838562	0	268	207	3586	207	3318	0.0	0.06238698010849909
chr17	GAS7	10036433	10036450	0	18	55	3981	55	3963	0.0	0.01387837496845824
chr17	SCO1	10692763	10692855	0	93	62	10307	62	10214	0.0	0.006070099862933229
chr17	ELAC2	13002440	13002444	0	5	0	6704	0	6699	0.0	0.0
chr17	ELAC2	13010612	13010616	0	5	0	6704	0	6699	0.0	0.0
chr17	ELAC2	13017702	13017989	0	288	0	6704	0	6416	0.0	0.0
chr17	ELAC2	13003449	13003477	0	29	0	6704	0	6675	0.0	0.0
chr17	ELAC2	13017566	13017580	0	15	0	6704	0	6689	0.0	0.0
chr17	ELAC2	13017496	13017565	0	70	0	6704	0	6634	0.0	0.0
chr17	ELAC2	13017496	13017580	0	85	0	6704	0	6619	0.0	0.0
chr17	ELAC2	13017412	13017565	0	154	0	6704	0	6550	0.0	0.0
chr17	ELAC2	13017412	13017580	0	169	0	6704	0	6535	0.0	0.0
chr17	ELAC2	13017412	13017495	0	84	0	6704	0	6620	0.0	0.0
chr17	COX10-AS1	14033551	14033938	0	388	0	11234	0	10846	0.0	0.0
chr17	COX10-AS1	14033551	14034006	0	456	0	11234	0	10778	0.0	0.0
chr17	COX10-AS1	14033939	14034006	0	68	0	11234	0	11166	0.0	0.0
chr17	CDRT15	14236571	14236694	0	124	0	782	0	658	0.0	0.0
chr17	PMP22	15262428	15263063	0	636	582	6135	582	5499	0.0	0.10583742498636116
chr17	PMP22	15262424	15262427	0	4	582	6135	582	6131	0.0	0.09492741803947154
chr17	PMP22	15271671	15271694	0	24	582	6135	582	6111	0.0	0.09523809523809523
chr17	TVP23C	15553684	15553763	0	80	40755	5447	40755	5367	0.0	7.593627724986026
chr17	TRIM16	15682853	15682859	0	7	2054	4831	2054	4824	0.0	0.425787728026534
chr17	ZSWIM7	15999502	15999504	6	3	6749	2082	6743	2079	2.0	3.2433862433862433
chr17	ZSWIM7	15999502	15999517	88	16	6749	2082	6661	2066	5.5	3.224104549854792
chr17	ZSWIM7	15999505	15999517	82	13	6749	2082	6667	2069	6.3076923076923075	3.222329627839536
chr17	ZSWIM7	15999518	15999658	1210	141	6749	2082	5539	1941	8.581560283687944	2.8536836682122617
chr17	ZSWIM7	15999502	15999658	1298	157	6749	2082	5451	1925	8.26751592356688	2.831688311688312
chr17	ZSWIM7	15999505	15999658	1292	154	6749	2082	5457	1928	8.38961038961039	2.8303941908713695
chr17	NCOR1	16046950	16046988	1065	39	56884	14501	55819	14462	27.307692307692307	3.859701286129166
chr17	NCOR1	16061400	16061756	0	357	56884	14501	56884	14144	0.0	4.021776018099548
chr17	ZNF287	16568749	16568950	0	202	7854	7922	7854	7720	0.0	1.0173575129533678
chr17	ZNF624	16653567	16653762	0	196	11897	5100	11897	4904	0.0	2.425978792822186
chr17	KRT16P6	16820646	16820657	0	12	255	1817	255	1805	0.0	0.14127423822714683
chr17	KRT16P6	16820618	16820645	0	28	255	1817	255	1789	0.0	0.14253773057574065
chr17	KRT16P6	16820618	16820657	0	40	255	1817	255	1777	0.0	0.14350028137310072
chr17	KRT17P4	16852298	16852325	0	28	0	2302	0	2274	0.0	0.0
chr17	TBC1D27P	16929520	16929828	0	309	0	4955	0	4646	0.0	0.0
chr17	TBC1D27P	16930308	16930371	0	64	0	4955	0	4891	0.0	0.0
chr17	TBC1D27P	16932782	16932785	0	4	0	4955	0	4951	0.0	0.0
chr17	PEMT	17591530	17591595	0	66	279	1735	279	1669	0.0	0.1671659676452966
chr17	SREBF1	17819537	17819542	6	6	9822	6629	9816	6623	1.0	1.4821078061301525
chr17	SREBF1	17817547	17817694	1275	148	9822	6629	8547	6481	8.614864864864865	1.3187779663632155
chr17	FLII	18245743	18245836	32	94	158013	5686	157981	5592	0.3404255319148936	28.251251788268956
chr17	FLII	18253543	18253597	231	55	158013	5686	157782	5631	4.2	28.02024507192328
chr17	TOP3A	18290539	18290555	0	17	3960	5240	3960	5223	0.0	0.7581849511774842
chr17	TOP3A	18308312	18308349	76	38	3960	5240	3884	5202	2.0	0.746635909265667
chr17	TOP3A	18308312	18308411	80	100	3960	5240	3880	5140	0.8	0.754863813229572
chr17	TOP3A	18308350	18308411	4	62	3960	5240	3956	5178	0.06451612903225806	0.7640015449980687
chr17	FAM106A	18521059	18521077	95	19	5982	8673	5887	8654	5.0	0.6802634619828981
chr17	FAM106A	18523776	18524141	0	366	5982	8673	5982	8307	0.0	0.7201155651859877
chr17	FAM106A	18523650	18523775	0	126	5982	8673	5982	8547	0.0	0.6998946998946999
chr17	FOXO3B	18681393	18681613	0	221	2782	6171	2782	5950	0.0	0.467563025210084
chr17	B9D1	19362506	19362598	0	93	116	6772	116	6679	0.0	0.017367869441533165
chr17	MFAP4	19387040	19387148	0	109	40	1919	40	1810	0.0	0.022099447513812154
chr17	ALDH3A1	19744967	19744996	812	30	2101	3484	1289	3454	27.066666666666666	0.3731905037637522
chr17	ALDH3A1	19747901	19747934	0	34	2101	3484	2101	3450	0.0	0.6089855072463768
chr17	ALDH3A1	19747935	19748257	0	323	2101	3484	2101	3161	0.0	0.664663081303385
chr17	KRT17P7	20521595	20522065	765	471	4998	2635	4233	2164	1.624203821656051	1.9560998151571165
chr17	CCDC144NL	20866547	20866574	0	28	0	3361	0	3333	0.0	0.0
chr17	USP22	21043320	21043624	0	305	826	4014	826	3709	0.0	0.22270153680237262
chr17	NOS2	27781035	27781109	0	75	1715	4427	1715	4352	0.0	0.39407169117647056
chr17	KRT18P55	28306975	28307030	0	56	91	2032	91	1976	0.0	0.046052631578947366
chr17	PIGS	28571048	28571461	0	414	0	4809	0	4395	0.0	0.0
chr17	PIGS	28570851	28571047	0	197	0	4809	0	4612	0.0	0.0
chr17	ALDOC	28575964	28576278	39811	315	128048	2363	88237	2048	126.38412698412698	43.08447265625
chr17	SPAG5	28598464	28598508	0	45	2822	4721	2822	4676	0.0	0.6035072711719418
chr17	RSKR	28613077	28613088	336	12	67557	6992	67221	6980	28.0	9.63051575931232
chr17	PROCA1	28706676	28706678	97	3	7202	3553	7105	3550	32.333333333333336	2.0014084507042256
chr17	RAB34	28715194	28715217	0	24	1224	3005	1224	2981	0.0	0.41060046964106006
chr17	RAB34	28715027	28715030	0	4	1224	3005	1224	3001	0.0	0.40786404531822723
chr17	FAM222B	28812157	28812207	40	51	12387	5523	12347	5472	0.7843137254901961	2.2563961988304095
chr17	FLOT2	28883107	28883175	0	69	0	3397	0	3328	0.0	0.0
chr17	PHF12	28950894	28951465	2979	572	9036	6230	6057	5658	5.208041958041958	1.0705196182396606
chr17	GIT1	29577135	29577182	494	48	6619	5400	6125	5352	10.291666666666666	1.1444319880418534
chr17	BLMH	30291806	30291912	631	107	3570	5133	2939	5026	5.897196261682243	0.5847592518901711
chr17	BLMH	30291179	30291309	0	131	3570	5133	3570	5002	0.0	0.7137145141943223
chr17	COPRS	31858757	31858823	0	67	0	1318	0	1251	0.0	0.0
chr17	C17ORF75	32341800	32341861	0	62	0	5756	0	5694	0.0	0.0
chr17	RAD51D	35119531	35119698	0	168	0	11317	0	11149	0.0	0.0
chr17	NLE1	35139819	35139847	0	29	0	5488	0	5459	0.0	0.0
chr17	SLFN11	35362738	35362765	0	28	587	4258	587	4230	0.0	0.13877068557919622
chr17	SLFN11	35367602	35367648	0	47	587	4258	587	4211	0.0	0.13939681785799096
chr17	SLFN11	35373473	35373580	0	108	587	4258	587	4150	0.0	0.14144578313253012
chr17	SLFN11	35367540	35367601	0	62	587	4258	587	4196	0.0	0.13989513822688274
chr17	SLFN11	35367540	35367648	0	109	587	4258	587	4149	0.0	0.14147987466859485
chr17	SLFN13	35445372	35445654	0	283	39566	9056	39566	8773	0.0	4.50997378319845
chr17	GAS2L2	35750153	35750153	0	1	8364	3381	8364	3380	0.0	2.4745562130177516
chr17	HEATR9	35864757	35864876	36	120	6553	2944	6517	2824	0.3	2.30771954674221
chr17	HEATR9	35865214	35865217	0	4	6553	2944	6553	2940	0.0	2.22891156462585
chr17	HEATR9	35862950	35862993	0	44	6553	2944	6553	2900	0.0	2.259655172413793
chr17	HEATR9	35868566	35868653	51	88	6553	2944	6502	2856	0.5795454545454546	2.276610644257703
chr17	RDM1	35930075	35930630	0	556	2676	1650	2676	1094	0.0	2.446069469835466
chr17	CCL14	35984333	35984336	0	4	5370	1206	5370	1202	0.0	4.467554076539101
chr17	CCL23	36013631	36013742	0	112	0	746	0	634	0.0	0.0
chr17	MYO19	36512873	36513427	4131	555	13363	11489	9232	10934	7.443243243243243	0.8443387598317176
chr17	MYO19	36508896	36509060	416	165	13363	11489	12947	11324	2.521212121212121	1.143323913811374
chr17	MYO19	36534672	36534759	0	88	13363	11489	13363	11401	0.0	1.1720901675291642
chr17	MYO19	36534672	36534682	0	11	13363	11489	13363	11478	0.0	1.1642272172852413
chr17	MYO19	36534683	36534759	0	77	13363	11489	13363	11412	0.0	1.1709603925692254
chr17	SYNRG	37577379	37577445	0	67	17679	8725	17679	8658	0.0	2.041926541926542
chr17	SYNRG	37609278	37609366	6	89	17679	8725	17673	8636	0.06741573033707865	2.0464335340435387
chr17	NPEPPSP1	38202735	38202779	176	45	760	1700	584	1655	3.911111111111111	0.3528700906344411
chr17	PCGF2	38738748	38738751	0	4	0	2284	0	2280	0.0	0.0
chr17	CWC25	38825165	38825268	0	104	1389	3726	1389	3622	0.0	0.383489784649365
chr17	CWC25	38810275	38810466	0	192	1389	3726	1389	3534	0.0	0.3930390492359932
chr17	RPL23	38853301	38853357	0	57	153	5524	153	5467	0.0	0.02798609840863362
chr17	PLXDC1	39152468	39152544	0	77	0	9280	0	9203	0.0	0.0
chr17	STAC2	39217866	39218067	0	202	0	3441	0	3239	0.0	0.0
chr17	ORMDL3	39924029	39924076	0	48	51942	2853	51942	2805	0.0	18.51764705882353
chr17	KRT222	40664921	40665002	1056	82	44089	3031	43033	2949	12.878048780487806	14.59240420481519
chr17	SMARCE1	40642117	40642453	0	337	94542	10517	94542	10180	0.0	9.287033398821219
chr17	SMARCE1	40642117	40642163	0	47	94542	10517	94542	10470	0.0	9.029799426934098
chr17	KRT10	40818766	40818785	5931	20	128182	2171	122251	2151	296.55	56.83449558344956
chr17	KRT23	40937127	40937344	663	218	87941	2919	87278	2701	3.041284403669725	32.313217326915954
chr17	KRT19	41527827	41527919	0	93	105	2153	105	2060	0.0	0.050970873786407765
chr17	KRT42P	41628604	41629074	0	471	133	4308	133	3837	0.0	0.03466249674224655
chr17	HAP1	41732694	41732717	0	24	1245	2283	1245	2259	0.0	0.5511288180610889
chr17	JUP	41786502	41786586	0	85	0	4876	0	4791	0.0	0.0
chr17	NT5C3B	41836078	41836180	0	103	0	2859	0	2756	0.0	0.0
chr17	DNAJC7	41997114	41997135	0	22	743	9268	743	9246	0.0	0.08035907419424616
chr17	DNAJC7	42017039	42017050	0	12	743	9268	743	9256	0.0	0.08027225583405359
chr17	DNAJC7	41982245	41982253	0	9	743	9268	743	9259	0.0	0.08024624689491305
chr17	DNAJC7	41982245	41982248	0	4	743	9268	743	9264	0.0	0.08020293609671848
chr17	DNAJC7	42016586	42017038	0	453	743	9268	743	8815	0.0	0.08428814520703347
chr17	DNAJC7	42016586	42017050	0	465	743	9268	743	8803	0.0	0.08440304441667613
chr17	DNAJC7	41982249	41982253	0	5	743	9268	743	9263	0.0	0.08021159451581561
chr17	ZNF385C	42027617	42027631	0	15	604	5209	604	5194	0.0	0.11628802464381979
chr17	DHX58	42111724	42111744	161	21	73350	3749	73189	3728	7.666666666666667	19.632242489270386
chr17	KAT2A	42114891	42114952	24	62	166853	3583	166829	3521	0.3870967741935484	47.38114172110196
chr17	KAT2A	42119053	42119243	0	191	166853	3583	166853	3392	0.0	49.190153301886795
chr17	RAB5C	42136264	42136339	140	76	2550	2590	2410	2514	1.8421052631578947	0.958631662688942
chr17	KCNH4	42159730	42159733	0	4	104693	3805	104693	3801	0.0	27.543541173375427
chr17	GHDC	42194392	42194415	84	24	3478	3702	3394	3678	3.5	0.922784121805329
chr17	STAT3	42322281	42322283	0	3	1726	9674	1726	9671	0.0	0.17847171957398408
chr17	STAT3	42323259	42323285	0	27	1726	9674	1726	9647	0.0	0.17891572509588474
chr17	STAT3	42323452	42323571	0	120	1726	9674	1726	9554	0.0	0.18065731630730583
chr17	PSMC3IP	42574098	42574194	0	97	2913	2585	2913	2488	0.0	1.1708199356913183
chr17	PSMC3IP	42577079	42577211	510	133	2913	2585	2403	2452	3.8345864661654137	0.9800163132137031
chr17	PSMC3IP	42573818	42574097	0	280	2913	2585	2913	2305	0.0	1.263774403470716
chr17	PSMC3IP	42573818	42574194	0	377	2913	2585	2913	2208	0.0	1.3192934782608696
chr17	RETREG3	42608659	42609084	1404	426	2848	4732	1444	4306	3.295774647887324	0.3353460287970274
chr17	PLEKHH3	42670993	42671001	0	9	51	3655	51	3646	0.0	0.013987931980252331
chr17	PLEKHH3	42669917	42669941	0	25	51	3655	51	3630	0.0	0.014049586776859505
chr17	EZH1	42727634	42727660	0	27	153	6587	153	6560	0.0	0.023323170731707317
chr17	BECN1	42824132	42824153	0	22	55969	5109	55969	5087	0.0	11.002358954196973
chr17	BECN1	42823704	42823746	52	43	55969	5109	55917	5066	1.2093023255813953	11.037702329253849
chr17	AARSD1	42951799	42951799	7	1	79835	2950	79828	2949	7.0	27.06951508986097
chr17	AARSD1	42964401	42964441	0	41	79835	2950	79835	2909	0.0	27.44413887933998
chr17	PTGES3L-AARSD1	42979549	42979626	0	78	37974	2312	37974	2234	0.0	16.998209489704564
chr17	VAT1	43021935	43022138	3489	204	75593	3313	72104	3109	17.102941176470587	23.19202315857189
chr17	BRCA1	43091434	43094742	0	3309	41484	8555	41484	5246	0.0	7.907739229889439
chr17	BRCA1	43106455	43106476	30	22	41484	8555	41454	8533	1.3636363636363635	4.858080393765381
chr17	BRCA1	43125270	43125275	141	6	41484	8555	41343	8549	23.5	4.836004211018833
chr17	BRCA1	43125181	43125269	1130	89	41484	8555	40354	8466	12.696629213483146	4.766595794944484
chr17	BRCA1	43125181	43125275	1271	95	41484	8555	40213	8460	13.378947368421052	4.753309692671395
chr17	BRCA1	43124736	43125269	1162	534	41484	8555	40322	8021	2.1760299625468167	5.027053983293854
chr17	BRCA1	43124736	43125275	1303	540	41484	8555	40181	8015	2.412962962962963	5.013225202744853
chr17	BRCA1	43124736	43125180	32	445	41484	8555	41452	8110	0.07191011235955057	5.1112207151664615
chr17	AC060780.1	43159422	43159465	0	44	57171	6052	57171	6008	0.0	9.515812250332889
chr17	CCDC200	43224163	43224232	42	70	104112	3210	104070	3140	0.6	33.14331210191083
chr17	CCDC200	43224163	43224353	94	191	104112	3210	104018	3019	0.49214659685863876	34.45445511758861
chr17	CCDC200	43224111	43224162	0	52	104112	3210	104112	3158	0.0	32.96770107663078
chr17	CCDC200	43224111	43224232	42	122	104112	3210	104070	3088	0.3442622950819672	33.70142487046632
chr17	CCDC200	43224111	43224353	94	243	104112	3210	104018	2967	0.3868312757201646	35.058308055274686
chr17	CCDC200	43228768	43228960	29653	193	104112	3210	74459	3017	153.6424870466321	24.679814385150813
chr17	CCDC200	43224233	43224353	52	121	104112	3210	104060	3089	0.4297520661157025	33.687277436063454
chr17	LINC00910	43388288	43388289	6	2	291389	8593	291383	8591	3.0	33.91723897101618
chr17	LINC00910	43388288	43388503	1038	216	291389	8593	290351	8377	4.805555555555555	34.66049898531694
chr17	LINC00910	43387935	43388287	684	353	291389	8593	290705	8240	1.9376770538243626	35.279733009708735
chr17	LINC00910	43387935	43388289	690	355	291389	8593	290699	8238	1.943661971830986	35.28756979849478
chr17	DUSP3	43773973	43774033	0	61	0	4997	0	4936	0.0	0.0
chr17	MPP2	43898261	43898278	0	18	39	6133	39	6115	0.0	0.006377759607522486
chr17	MPP2	43907212	43907472	0	261	39	6133	39	5872	0.0	0.006641689373297003
chr17	MPP2	43907209	43907211	0	3	39	6133	39	6130	0.0	0.006362153344208809
chr17	MPP2	43907128	43907208	0	81	39	6133	39	6052	0.0	0.006444150693985459
chr17	MPP2	43907128	43907211	0	84	39	6133	39	6049	0.0	0.006447346668870888
chr17	MPP2	43898243	43898260	0	18	39	6133	39	6115	0.0	0.006377759607522486
chr17	MPP2	43898243	43898278	0	36	39	6133	39	6097	0.0	0.006396588486140725
chr17	TMEM101	44014815	44014982	0	168	153	3037	153	2869	0.0	0.05332868595329383
chr17	HDAC5	44123253	44123502	312	250	9538	7417	9226	7167	1.248	1.2872889633040323
chr17	UBTF	44207698	44207701	0	4	7509	6885	7509	6881	0.0	1.091265804388897
chr17	FAM171A2	44358944	44359060	0	117	102	3579	102	3462	0.0	0.029462738301559793
chr17	GFAP	44903958	44904440	0	483	51	7492	51	7009	0.0	0.007276358967042374
chr17	GFAP	44910091	44910613	0	523	51	7492	51	6969	0.0	0.007318123116659492
chr17	GFAP	44910091	44910224	0	134	51	7492	51	7358	0.0	0.006931231312856755
chr17	GFAP	44910091	44910139	0	49	51	7492	51	7443	0.0	0.0068520757758968156
chr17	GFAP	44910140	44910224	0	85	51	7492	51	7407	0.0	0.00688537869582827
chr17	DCAKD	45051360	45051551	0	192	0	2808	0	2616	0.0	0.0
chr17	PLCD3	45115093	45115141	107	49	27290	6647	27183	6598	2.183673469387755	4.119884813579873
chr17	ARHGAP27	45404923	45405026	0	104	42814	10105	42814	10001	0.0	4.280971902809719
chr17	ARHGAP27	45405675	45405845	2325	171	42814	10105	40489	9934	13.596491228070175	4.075800281860277
chr17	PLEKHM1	45477899	45478099	0	201	36397	9251	36397	9050	0.0	4.021767955801105
chr17	PLEKHM1	45440026	45440161	45	136	36397	9251	36352	9115	0.33088235294117646	3.9881513987931982
chr17	PLEKHM1	45477804	45477898	0	95	36397	9251	36397	9156	0.0	3.97520751419834
chr17	PLEKHM1	45477804	45478099	0	296	36397	9251	36397	8955	0.0	4.064433277498604
chr17	MAPT-AS1	45894611	45895478	4883	868	6574	7365	1691	6497	5.625576036866359	0.2602739726027397
chr17	AC005670.3	47033277	47033318	0	42	510390	10495	510390	10453	0.0	48.827130967186456
chr17	AC005670.3	47056455	47056458	0	4	510390	10495	510390	10491	0.0	48.65027166142408
chr17	CDC27	47189145	47189259	0	115	98	6557	98	6442	0.0	0.015212666873641726
chr17	MRPL10	47831310	47831458	0	149	306	2777	306	2628	0.0	0.11643835616438356
chr17	SCRN2	47838269	47838334	576	66	2692	3004	2116	2938	8.727272727272727	0.720217835262083
chr17	SCRN2	47841184	47841206	0	23	2692	3004	2692	2981	0.0	0.9030526668903053
chr17	SP2-AS1	47941335	47941345	0	11	23285	2536	23285	2525	0.0	9.221782178217822
chr17	CBX1	48075988	48075999	0	12	0	3053	0	3041	0.0	0.0
chr17	TTLL6	48787788	48787809	0	22	50599	5118	50599	5096	0.0	9.929160125588696
chr17	SNF8	48937019	48937107	0	89	34216	4805	34216	4716	0.0	7.255301102629347
chr17	SNF8	48936130	48936168	0	39	34216	4805	34216	4766	0.0	7.1791859001258915
chr17	SNF8	48936854	48937018	0	165	34216	4805	34216	4640	0.0	7.374137931034483
chr17	GNGT2	49209206	49209351	0	146	51	1694	51	1548	0.0	0.03294573643410853
chr17	GNGT2	49209206	49209241	0	36	51	1694	51	1658	0.0	0.030759951749095297
chr17	GNGT2	49209242	49209351	0	110	51	1694	51	1584	0.0	0.032196969696969696
chr17	PHOSPHO1	49230467	49230575	0	109	102	2397	102	2288	0.0	0.044580419580419584
chr17	ZNF652	49316825	49317364	0	540	26565	11753	26565	11213	0.0	2.369125122625524
chr17	PHB	49414741	49414746	0	6	459	5014	459	5008	0.0	0.09165335463258786
chr17	PHB	49414741	49414742	0	2	459	5014	459	5012	0.0	0.0915802075019952
chr17	PHB	49414747	49414833	0	87	459	5014	459	4927	0.0	0.09316013801501928
chr17	PHB	49414739	49414740	0	2	459	5014	459	5012	0.0	0.0915802075019952
chr17	PHB	49414739	49414833	0	95	459	5014	459	4919	0.0	0.09331164870908722
chr17	PHB	49414739	49414746	0	8	459	5014	459	5006	0.0	0.09168997203355973
chr17	PHB	49414739	49414742	0	4	459	5014	459	5010	0.0	0.09161676646706587
chr17	PHB	49414743	49414833	0	91	459	5014	459	4923	0.0	0.09323583180987204
chr17	PHB	49414743	49414746	0	4	459	5014	459	5010	0.0	0.09161676646706587
chr17	SLC35B1	49707729	49708074	0	346	284	5087	284	4741	0.0	0.059902974056106305
chr17	FAM117A	49788496	49788500	0	5	0	3816	0	3811	0.0	0.0
chr17	TAC4	49847894	49847911	0	18	0	1002	0	984	0.0	0.0
chr17	CHAD	50465282	50465292	0	11	0	1735	0	1724	0.0	0.0
chr17	CACNA1G-AS1	50559304	50559326	0	23	0	1559	0	1536	0.0	0.0
chr17	MBTD1	51192657	51192780	0	124	0	6681	0	6557	0.0	0.0
chr17	TRIM25	56891354	56891362	0	9	6680	6852	6680	6843	0.0	0.9761800379950314
chr17	MRPS23	57849838	57849965	0	128	1119	6256	1119	6128	0.0	0.18260443864229764
chr17	SRSF1	58005397	58005412	0	16	9193	2405	9193	2389	0.0	3.848053578903307
chr17	SRSF1	58006906	58006942	0	37	9193	2405	9193	2368	0.0	3.882179054054054
chr17	MKS1	58206464	58207083	612	620	93257	8985	92645	8365	0.9870967741935484	11.07531380753138
chr17	RNF43	58415325	58417015	0	1691	1581	5286	1581	3595	0.0	0.43977746870653683
chr17	SUPT4H1	58352064	58352065	0	2	0	2085	0	2083	0.0	0.0
chr17	SUPT4H1	58352023	58352065	0	43	0	2085	0	2042	0.0	0.0
chr17	SUPT4H1	58352023	58352063	0	41	0	2085	0	2044	0.0	0.0
chr17	SEPTIN4	58526681	58526765	0	85	78318	6797	78318	6712	0.0	11.668355184743742
chr17	SEPTIN4	58526681	58526930	0	250	78318	6797	78318	6547	0.0	11.962425538414541
chr17	SEPTIN4	58542625	58544269	23130	1645	78318	6797	55188	5152	14.060790273556231	10.71195652173913
chr17	SEPTIN4	58526766	58526930	0	165	78318	6797	78318	6632	0.0	11.809107358262967
chr17	SKA2	59154955	59155129	0	175	8084	3064	8084	2889	0.0	2.798200069228107
chr17	SKA2	59119298	59119317	0	20	8084	3064	8084	3044	0.0	2.6557161629434956
chr17	RNFT1	59962826	59962930	0	105	4779	3189	4779	3084	0.0	1.5496108949416343
chr17	TBC1D3P1-DHX40P1	60001516	60001668	0	153	4647	1855	4647	1702	0.0	2.7303172737955346
chr17	WFDC21P	60085054	60085101	0	48	5161	1104	5161	1056	0.0	4.887310606060606
chr17	WFDC21P	60085054	60085111	0	58	5161	1104	5161	1046	0.0	4.9340344168260035
chr17	WFDC21P	60085102	60085111	0	10	5161	1104	5161	1094	0.0	4.717550274223035
chr17	AC025048.2	60128955	60128991	0	37	561	3106	561	3069	0.0	0.1827956989247312
chr17	AC025048.2	60135085	60135095	0	11	561	3106	561	3095	0.0	0.1812600969305331
chr17	AC025048.2	60128535	60128539	0	5	561	3106	561	3101	0.0	0.18090938406965495
chr17	USP32	60219627	60219668	0	42	21272	9563	21272	9521	0.0	2.2342190946329166
chr17	TBX2-AS1	61399036	61399237	0	202	0	1010	0	808	0.0	0.0
chr17	INTS2	61927653	61927933	0	281	592728	8387	592728	8106	0.0	73.1221317542561
chr17	INTS2	61927653	61927920	0	268	592728	8387	592728	8119	0.0	73.00504988299052
chr17	INTS2	61927921	61927933	0	13	592728	8387	592728	8374	0.0	70.78194411272987
chr17	TBC1D3P2	62270916	62270968	2347	53	16521	2130	14174	2077	44.283018867924525	6.824265767934521
chr17	CYB561	63436006	63436052	0	47	0	4066	0	4019	0.0	0.0
chr17	CYB561	63438022	63438039	0	18	0	4066	0	4048	0.0	0.0
chr17	STRADA	63713405	63713458	0	54	51	9568	51	9514	0.0	0.005360521336977086
chr17	STRADA	63704340	63704430	0	91	51	9568	51	9477	0.0	0.0053814498258942705
chr17	STRADA	63728333	63728356	0	24	51	9568	51	9544	0.0	0.005343671416596815
chr17	STRADA	63741453	63741739	0	287	51	9568	51	9281	0.0	0.005495097511044068
chr17	STRADA	63741453	63741716	0	264	51	9568	51	9304	0.0	0.005481513327601032
chr17	STRADA	63741717	63741739	0	23	51	9568	51	9545	0.0	0.005343111576741749
chr17	FTSJ3	63827051	63827107	0	57	306	4818	306	4761	0.0	0.06427221172022685
chr17	FTSJ3	63826546	63826565	0	20	306	4818	306	4798	0.0	0.0637765735723218
chr17	SMARCD2	63842380	63842457	0	78	257	3571	257	3493	0.0	0.07357572287432007
chr17	SMARCD2	63837145	63837193	0	49	257	3571	257	3522	0.0	0.07296990346394094
chr17	GH2	63880771	63880774	0	4	92	1160	92	1156	0.0	0.07958477508650519
chr17	ICAM2	64020405	64020521	0	117	0	1706	0	1589	0.0	0.0
chr17	POLG2	64496406	64496530	0	125	452	4433	452	4308	0.0	0.10492107706592387
chr17	POLG2	64483963	64485726	0	1764	452	4433	452	2669	0.0	0.169351817159985
chr17	DDX5	64505040	64505217	0	178	5205	7977	5205	7799	0.0	0.6673932555455828
chr17	DDX5	64505040	64505284	0	245	5205	7977	5205	7732	0.0	0.6731764097258148
chr17	DDX5	64506075	64506512	1020	438	5205	7977	4185	7539	2.328767123287671	0.5551134102666136
chr17	DDX5	64501260	64502008	714	749	5205	7977	4491	7228	0.9532710280373832	0.621333702268954
chr17	DDX5	64505218	64505284	0	67	5205	7977	5205	7910	0.0	0.6580278128950695
chr17	DDX5	64505285	64505437	0	153	5205	7977	5205	7824	0.0	0.665260736196319
chr17	HELZ	67128494	67128649	0	156	1939	15615	1939	15459	0.0	0.12542855294650365
chr17	C17ORF58	67992900	67993042	0	143	0	2252	0	2109	0.0	0.0
chr17	AC145343.1	68100551	68101413	0	863	0	675	0	-188	0.0	-0.0
chr17	LRRC37A16P	68145488	68145524	0	37	102	3794	102	3757	0.0	0.027149321266968326
chr17	WIPI1	68433463	68433466	0	4	46	3414	46	3410	0.0	0.013489736070381233
chr17	WIPI1	68426057	68426073	0	17	46	3414	46	3397	0.0	0.013541360023550192
chr17	ABCA10	69149983	69149986	0	4	226	8379	226	8375	0.0	0.026985074626865672
chr17	ABCA10	69196245	69196284	0	40	226	8379	226	8339	0.0	0.0271015709317664
chr17	ABCA5	69273942	69273957	0	16	0	13202	0	13186	0.0	0.0
chr17	CASC17	71132361	71132388	0	28	11917	2897	11917	2869	0.0	4.1537120948065525
chr17	CASC17	71168603	71168612	0	10	11917	2897	11917	2887	0.0	4.12781434014548
chr17	ROCR	72030200	72030319	0	120	14	3480	14	3360	0.0	0.004166666666666667
chr17	SOX9-AS1	72081359	72081371	0	13	0	11672	0	11659	0.0	0.0
chr17	LINC00511	72324431	72324538	0	108	504	21819	504	21711	0.0	0.023214038966422552
chr17	LINC00511	72323742	72324020	0	279	504	21819	504	21540	0.0	0.0233983286908078
chr17	LINC00511	72342105	72342123	0	19	504	21819	504	21800	0.0	0.02311926605504587
chr17	LINC00511	72501611	72501755	44	145	504	21819	460	21674	0.30344827586206896	0.021223585863246287
chr17	LINC00511	72422746	72422783	0	38	504	21819	504	21781	0.0	0.02313943345117304
chr17	LINC00511	72420699	72422783	0	2085	504	21819	504	19734	0.0	0.025539677713590756
chr17	LINC00511	72420699	72422745	0	2047	504	21819	504	19772	0.0	0.025490592757434757
chr17	LINC00511	72516675	72516788	0	114	504	21819	504	21705	0.0	0.02322045611610228
chr17	SLC39A11	72947730	72947750	0	21	3765	5564	3765	5543	0.0	0.67923507126105
chr17	SLC39A11	72947527	72947750	0	224	3765	5564	3765	5340	0.0	0.7050561797752809
chr17	SLC39A11	72947527	72947729	0	203	3765	5564	3765	5361	0.0	0.7022943480693901
chr17	SLC39A11	73092494	73092609	0	116	3765	5564	3765	5448	0.0	0.691079295154185
chr17	MGC16275	74212523	74212950	0	428	0	2276	0	1848	0.0	0.0
chr17	MGC16275	74212424	74212522	0	99	0	2276	0	2177	0.0	0.0
chr17	MGC16275	74212424	74212950	0	527	0	2276	0	1749	0.0	0.0
chr17	NAT9	74776266	74776307	1176	42	21099	2692	19923	2650	28.0	7.51811320754717
chr17	NAT9	74776266	74776269	5	4	21099	2692	21094	2688	1.25	7.847470238095238
chr17	NAT9	74776270	74776307	1171	38	21099	2692	19928	2654	30.81578947368421	7.508666164280331
chr17	FDXR	74863895	74864146	0	252	102	3392	102	3140	0.0	0.03248407643312102
chr17	FDXR	74872768	74872864	0	97	102	3392	102	3295	0.0	0.030955993930197268
chr17	HID1	74963739	74963769	0	31	255	5791	255	5760	0.0	0.044270833333333336
chr17	NT5C	75130964	75131043	0	80	0	1396	0	1316	0.0	0.0
chr17	JPT1	75153217	75153827	0	611	2233	2939	2233	2328	0.0	0.959192439862543
chr17	JPT1	75153217	75153768	0	552	2233	2939	2233	2387	0.0	0.9354838709677419
chr17	JPT1	75152904	75153216	0	313	2233	2939	2233	2626	0.0	0.8503427265803504
chr17	JPT1	75147519	75147554	0	36	2233	2939	2233	2903	0.0	0.7692042714433345
chr17	MIF4GD	75270942	75271142	51	201	153	3393	102	3192	0.2537313432835821	0.03195488721804511
chr17	MIF4GD	75267450	75267536	0	87	153	3393	153	3306	0.0	0.04627949183303085
chr17	SLC25A19	75289088	75289352	0	265	816	2966	816	2701	0.0	0.30211032950758976
chr17	SLC25A19	75288387	75288500	0	114	816	2966	816	2852	0.0	0.2861150070126227
chr17	SLC25A19	75288387	75288496	0	110	816	2966	816	2856	0.0	0.2857142857142857
chr17	SLC25A19	75288497	75288500	0	4	816	2966	816	2962	0.0	0.275489534098582
chr17	SLC25A19	75289009	75289352	0	344	816	2966	816	2622	0.0	0.3112128146453089
chr17	GALK1	75758209	75758358	0	150	0	1926	0	1776	0.0	0.0
chr17	H3-3B	75778809	75778881	0	73	0	3476	0	3403	0.0	0.0
chr17	H3-3B	75778809	75778819	0	11	0	3476	0	3465	0.0	0.0
chr17	H3-3B	75778820	75778881	0	62	0	3476	0	3414	0.0	0.0
chr17	H3-3B	75779646	75779655	0	10	0	3476	0	3466	0.0	0.0
chr17	WBP2	75855179	75855237	0	59	0	4661	0	4602	0.0	0.0
chr17	WBP2	75846335	75846736	0	402	0	4661	0	4259	0.0	0.0
chr17	WBP2	75855123	75855178	0	56	0	4661	0	4605	0.0	0.0
chr17	TRIM47	75877850	75877872	0	23	0	3017	0	2994	0.0	0.0
chr17	AC087289.3	75909467	75909572	0	106	12	4991	12	4885	0.0	0.0024564994882292734
chr17	FBF1	75914746	75914828	0	83	114	6205	114	6122	0.0	0.018621365566808233
chr17	ACOX1	75978790	75978963	0	174	112	6842	112	6668	0.0	0.016796640671865627
chr17	EVPL	76018094	76018159	0	66	4745	6988	4745	6922	0.0	0.6854955215255707
chr17	RNF157	76154279	76154281	0	3	137861	5950	137861	5947	0.0	23.181604170169834
chr17	PRPSAP1	76383845	76384379	1938	535	87466	6579	85528	6044	3.622429906542056	14.15089344804765
chr17	UBE2O	76400146	76400220	1424	75	54612	6064	53188	5989	18.986666666666668	8.880948405409919
chr17	RHBDF2	76500935	76501351	153	417	2682	6598	2529	6181	0.3669064748201439	0.40915709432130726
chr17	ST6GALNAC1	76626005	76626049	0	45	59	3207	59	3162	0.0	0.01865907653383934
chr17	ST6GALNAC1	76626288	76626316	0	29	59	3207	59	3178	0.0	0.018565135305223412
chr17	SRSF2	76736798	76736833	0	36	0	2637	0	2601	0.0	0.0
chr17	SRSF2	76735617	76735770	0	154	0	2637	0	2483	0.0	0.0
chr17	TMC6	78128611	78128657	0	47	808848	11377	808848	11330	0.0	71.38993821712268
chr17	SCAT1	78631918	78631947	0	30	10626	4114	10626	4084	0.0	2.601860920666014
chr17	SCAT1	78631918	78631988	0	71	10626	4114	10626	4043	0.0	2.6282463517190204
chr17	SCAT1	78630031	78630315	0	285	10626	4114	10626	3829	0.0	2.7751371115173673
chr17	SCAT1	78631948	78631988	0	41	10626	4114	10626	4073	0.0	2.6088877976921188
chr17	USP36	78796316	78797784	28702	1469	29811	7560	1109	6091	19.53846153846154	0.18207190937448695
chr17	USP36	78796316	78798398	28702	2083	29811	7560	1109	5477	13.779164666346615	0.20248311119225854
chr17	USP36	78836110	78836260	0	151	29811	7560	29811	7409	0.0	4.023619921716831
chr17	USP36	78840399	78840524	0	126	29811	7560	29811	7434	0.0	4.010088781275222
chr17	USP36	78840341	78840398	0	58	29811	7560	29811	7502	0.0	3.9737403359104237
chr17	USP36	78840341	78840524	0	184	29811	7560	29811	7376	0.0	4.04162147505423
chr17	TIMP2	78855963	78857520	4654	1558	15487	5639	10833	4081	2.987163029525032	2.654496446949277
chr17	LGALS3BP	78976942	78976993	0	52	42414	2991	42414	2939	0.0	14.431439265056142
chr17	LGALS3BP	78976994	78977138	132	145	42414	2991	42282	2846	0.9103448275862069	14.856640899508081
chr17	C1QTNF1-AS1	79019958	79020004	0	47	5662	2065	5662	2018	0.0	2.8057482656095143
chr17	SGSH	80209401	80209404	2264	4	319886	3964	317622	3960	566.0	80.20757575757575
chr17	AC127496.1	80969713	80970786	2907	1074	4702	4209	1795	3135	2.706703910614525	0.5725677830940988
chr17	BAIAP2-DT	81034377	81034563	0	187	0	4775	0	4588	0.0	0.0
chr17	CEP131	81198105	81198113	0	9	1932	3992	1932	3983	0.0	0.4850615114235501
chr17	TEPSIN	81238513	81238984	0	472	0	4141	0	3669	0.0	0.0
chr17	AC110285.1	81385291	81385298	0	8	0	2396	0	2388	0.0	0.0
chr17	AC110285.1	81384945	81385127	0	183	0	2396	0	2213	0.0	0.0
chr17	ACTG1	81512605	81512732	0	128	0	2143	0	2015	0.0	0.0
chr17	ACTG1	81512605	81512613	0	9	0	2143	0	2134	0.0	0.0
chr17	ACTG1	81510478	81510478	0	1	0	2143	0	2142	0.0	0.0
chr17	ACTG1	81512614	81512732	0	119	0	2143	0	2024	0.0	0.0
chr17	ACTG1	81512463	81512732	0	270	0	2143	0	1873	0.0	0.0
chr17	ACTG1	81512463	81512604	0	142	0	2143	0	2001	0.0	0.0
chr17	ACTG1	81512463	81512613	0	151	0	2143	0	1992	0.0	0.0
chr17	FAAP100	81551731	81551926	0	196	0	5365	0	5169	0.0	0.0
chr17	NPLOC4	81566387	81566469	0	83	0	7339	0	7256	0.0	0.0
chr17	OXLD1	81666276	81666516	0	241	0	1189	0	948	0.0	0.0
chr17	OXLD1	81666154	81666516	0	363	0	1189	0	826	0.0	0.0
chr17	OXLD1	81666154	81666275	0	122	0	1189	0	1067	0.0	0.0
chr17	OXLD1	81666145	81666516	0	372	0	1189	0	817	0.0	0.0
chr17	OXLD1	81666145	81666275	0	131	0	1189	0	1058	0.0	0.0
chr17	OXLD1	81666145	81666153	0	9	0	1189	0	1180	0.0	0.0
chr17	OXLD1	81666145	81666148	0	4	0	1189	0	1185	0.0	0.0
chr17	OXLD1	81666149	81666516	0	368	0	1189	0	821	0.0	0.0
chr17	OXLD1	81666149	81666275	0	127	0	1189	0	1062	0.0	0.0
chr17	OXLD1	81666149	81666153	0	5	0	1189	0	1184	0.0	0.0
chr17	ARL16	81683535	81683591	0	57	0	2599	0	2542	0.0	0.0
chr17	ARL16	81682442	81682489	0	48	0	2599	0	2551	0.0	0.0
chr17	P4HB	81860326	81860345	0	20	0	4717	0	4697	0.0	0.0
chr17	P4HB	81859178	81859179	0	2	0	4717	0	4715	0.0	0.0
chr17	PYCR1	81937179	81937226	0	48	0	2584	0	2536	0.0	0.0
chr17	PYCR1	81937179	81937191	0	13	0	2584	0	2571	0.0	0.0
chr17	PYCR1	81937257	81937260	0	4	0	2584	0	2580	0.0	0.0
chr17	PYCR1	81937192	81937226	0	35	0	2584	0	2549	0.0	0.0
chr17	PYCR1	81936969	81937178	0	210	0	2584	0	2374	0.0	0.0
chr17	PYCR1	81936969	81937226	0	258	0	2584	0	2326	0.0	0.0
chr17	PYCR1	81936969	81937191	0	223	0	2584	0	2361	0.0	0.0
chr17	CENPX	82019292	82019306	0	15	0	1407	0	1392	0.0	0.0
chr17	CENPX	82019509	82019639	0	131	0	1407	0	1276	0.0	0.0
chr17	DCXR	82036383	82036412	0	30	0	1446	0	1416	0.0	0.0
chr17	DCXR	82036181	82036189	0	9	0	1446	0	1437	0.0	0.0
chr17	DCXR	82036146	82036189	0	44	0	1446	0	1402	0.0	0.0
chr17	DCXR	82036146	82036180	0	35	0	1446	0	1411	0.0	0.0
chr17	DCXR	82037613	82037629	0	17	0	1446	0	1429	0.0	0.0
chr17	RFNG	82051011	82051292	0	282	0	2763	0	2481	0.0	0.0
chr17	DUS1L	82061556	82061616	0	61	0	3907	0	3846	0.0	0.0
chr17	FASN	82086253	82086258	0	6	0	9367	0	9361	0.0	0.0
chr17	CCDC57	82198313	82198335	0	23	0	9455	0	9432	0.0	0.0
chr17	CCDC57	82207730	82207845	0	116	0	9455	0	9339	0.0	0.0
chr17	SECTM1	82333694	82333698	0	5	0	2913	0	2908	0.0	0.0
chr17	OGFOD3	82415397	82415404	0	8	0	3642	0	3634	0.0	0.0
chr17	OGFOD3	82403894	82403935	0	42	0	3642	0	3600	0.0	0.0
chr17	OGFOD3	82418405	82418410	0	6	0	3642	0	3636	0.0	0.0
chr17	CYBC1	82449169	82449172	0	4	0	3566	0	3562	0.0	0.0
chr17	CYBC1	82450479	82450698	0	220	0	3566	0	3346	0.0	0.0
chr17	CYBC1	82450479	82450531	0	53	0	3566	0	3513	0.0	0.0
chr17	CYBC1	82450532	82450698	0	167	0	3566	0	3399	0.0	0.0
chr17	B3GNTL1	83048668	83048705	0	38	0	6597	0	6559	0.0	0.0
chr17	AC139099.1	83227620	83227647	0	28	0	2628	0	2600	0.0	0.0
chr17	AC129507.4	321611	321631	0	21	0	434	0	413	0.0	0.0
chr17	AC129507.1	331718	331721	0	4	0	1968	0	1964	0.0	0.0
chr17	WDR81	1724787	1728626	2598	3840	20536	8095	17938	4255	0.6765625	4.215746180963572
chr17	SERPINF1	1762114	1762273	201	160	7858	2082	7657	1922	1.25625	3.9838709677419355
chr17	RPA1	1830127	1830134	0	8	4367	5478	4367	5470	0.0	0.7983546617915905
chr17	DPH1	2036654	2036686	154	33	8460	4551	8306	4518	4.666666666666667	1.83842408145197
chr17	DPH1	2041876	2042231	117	356	8460	4551	8343	4195	0.32865168539325845	1.9887961859356376
chr17	PAFAH1B1	2593703	2594006	91249	304	135004	9736	43755	9432	300.1611842105263	4.638994910941475
chr17	ASPA	3476301	3476395	258	95	114382	5827	114124	5732	2.7157894736842105	19.909979064898813
chr17	CTNS	3655327	3655352	0	26	1581	4697	1581	4671	0.0	0.3384714193962749
chr17	CTNS	3636704	3636708	0	5	1581	4697	1581	4692	0.0	0.33695652173913043
chr17	CTNS	3636832	3636887	0	56	1581	4697	1581	4641	0.0	0.34065934065934067
chr17	EMC6	3668900	3669012	0	113	0	774	0	661	0.0	0.0
chr17	CYB5D2	4143314	4144005	0	692	2299	2188	2299	1496	0.0	1.536764705882353
chr17	CYB5D2	4143764	4144005	0	242	2299	2188	2299	1946	0.0	1.1813977389516959
chr17	CYB5D2	4143314	4143763	0	450	2299	2188	2299	1738	0.0	1.3227848101265822
chr17	ARRB2	4719290	4719420	0	131	141399	3784	141399	3653	0.0	38.70763755817136
chr17	ARRB2	4716609	4716671	186	63	141399	3784	141213	3721	2.9523809523809526	37.95028218220909
chr17	PLD2	4819550	4819582	0	33	6591	4796	6591	4763	0.0	1.3837917279025824
chr17	PLD2	4808417	4808451	0	35	6591	4796	6591	4761	0.0	1.3843730308758664
chr17	MINK1	4886618	4886626	123	9	458480	6924	458357	6915	13.666666666666666	66.28445408532177
chr17	RNF167	4940643	4940726	0	84	0	2282	0	2198	0.0	0.0
chr17	RNF167	4940231	4940360	0	130	0	2282	0	2152	0.0	0.0
chr17	ENO3	4948348	4948373	0	26	492	4037	492	4011	0.0	0.12266267763649963
chr17	ENO3	4951183	4951224	0	42	492	4037	492	3995	0.0	0.12315394242803504
chr17	ENO3	4951215	4951224	0	10	492	4037	492	4027	0.0	0.12217531661286317
chr17	ENO3	4951183	4951214	0	32	492	4037	492	4005	0.0	0.12284644194756554
chr17	ZNF232-AS1	5112102	5112118	34	17	6369	1476	6335	1459	2.0	4.3420150788211105
chr17	MIS12	5486421	5486684	0	264	5414	3162	5414	2898	0.0	1.8681849551414769
chr17	AC007846.1	5837217	5837249	0	33	51	1825	51	1792	0.0	0.028459821428571428
chr17	PIMREG	6445343	6445404	0	62	255	2570	255	2508	0.0	0.10167464114832536
chr17	TXNDC17	6641101	6641152	0	52	0	2558	0	2506	0.0	0.0
chr17	TXNDC17	6641101	6641227	0	127	0	2558	0	2431	0.0	0.0
chr17	TXNDC17	6641153	6641227	0	75	0	2558	0	2483	0.0	0.0
chr17	TXNDC17	6641835	6641932	0	98	0	2558	0	2460	0.0	0.0
chr17	ALOX12P2	6899707	6899760	470	54	154147	5629	153677	5575	8.703703703703704	27.565381165919284
chr17	ALOX12P2	6854436	6854453	0	18	154147	5629	154147	5611	0.0	27.472286579932277
chr17	ALOX12P2	6894514	6894519	0	6	154147	5629	154147	5623	0.0	27.413658189578516
chr17	ALOX12P2	6895200	6895203	0	4	154147	5629	154147	5625	0.0	27.40391111111111
chr17	RNASEK	7012758	7012761	0	4	0	1124	0	1120	0.0	0.0
chr17	C17ORF49	7016526	7016685	0	160	0	1569	0	1409	0.0	0.0
chr17	RNASEK	7012762	7012777	0	16	0	1124	0	1108	0.0	0.0
chr17	RNASEK	7012758	7012777	0	20	0	1124	0	1104	0.0	0.0
chr17	RNASEK	7013517	7013535	0	19	0	1124	0	1105	0.0	0.0
chr17	ACADVL	7223859	7223875	0	17	147589	3886	147589	3869	0.0	38.146549495993796
chr17	ELP5	7254767	7254803	333	37	14478	2734	14145	2697	9.0	5.244716351501668
chr17	ELP5	7252338	7252345	5	8	14478	2734	14473	2726	0.625	5.309244314013206
chr17	SLC2A4	7284940	7285000	26	61	27329	4007	27303	3946	0.4262295081967213	6.919158641662443
chr17	EIF5A	7308114	7308133	0	20	161522	2599	161522	2579	0.0	62.6297014346646
chr17	TNK1	7384254	7384376	0	123	14594	3534	14594	3411	0.0	4.278510700674289
chr17	EIF4A1	7573534	7573547	363	14	1451973	4446	1451610	4432	25.928571428571427	327.5293321299639
chr17	EIF4A1	7577917	7578244	134171	328	1451973	4446	1317802	4118	409.0579268292683	320.0101991257892
chr17	MPDU1	7586778	7586838	0	61	48263	2956	48263	2895	0.0	16.671157167530225
chr17	WRAP53	7687604	7688561	0	958	102	3629	102	2671	0.0	0.038187944590041184
chr17	DNAH2	7717832	7718799	0	968	534685	16910	534685	15942	0.0	33.539392798895996
chr17	CHD3	7909339	7909384	0	46	154	10249	154	10203	0.0	0.01509359992159169
chr17	CNTROB	7948620	7948685	0	66	245	5814	245	5748	0.0	0.042623521224773836
chr17	CNTROB	7949138	7949157	0	20	245	5814	245	5794	0.0	0.042285122540559196
chr17	ODF4	8340161	8340505	357	345	1938	1326	1581	981	1.0347826086956522	1.6116207951070336
chr17	NDEL1	8435920	8436045	0	126	25893	5059	25893	4933	0.0	5.248935738901277
chr17	USP43	9701686	9701700	0	15	0	4991	0	4976	0.0	0.0
chr17	AC005323.2	10406239	10406277	0	39	716	774	716	735	0.0	0.9741496598639455
chr17	ADPRM	10706551	10706554	0	4	129	1949	129	1945	0.0	0.06632390745501285
chr17	ADPRM	10705528	10705615	0	88	129	1949	129	1861	0.0	0.0693175711982805
chr17	TMEM220-AS1	10729877	10729900	0	24	0	2726	0	2702	0.0	0.0
chr17	LINC02096	14840047	14840123	0	77	160	3329	160	3252	0.0	0.04920049200492005
chr17	ZNF286A	15700169	15700366	0	198	0	3177	0	2979	0.0	0.0
chr17	TTC19	16000246	16000382	0	137	4693	4955	4693	4818	0.0	0.9740556247405563
chr17	UBB	16381030	16381036	0	7	1075	1438	1075	1431	0.0	0.7512229210342418
chr17	UBB	16381463	16381515	0	53	1075	1438	1075	1385	0.0	0.776173285198556
chr17	UBB	16381516	16381679	0	164	1075	1438	1075	1274	0.0	0.8437990580847724
chr17	SNHG29	16439030	16439060	6	31	86309	5724	86303	5693	0.1935483870967742	15.159494115580538
chr17	SNHG29	16439394	16439414	90	21	86309	5724	86219	5703	4.285714285714286	15.118183412239173
chr17	SNHG29	16463248	16463317	0	70	86309	5724	86309	5654	0.0	15.265122037495578
chr17	SNHG29	16463318	16464341	102	1024	86309	5724	86207	4700	0.099609375	18.34191489361702
chr17	SNHG29	16463248	16464341	102	1094	86309	5724	86207	4630	0.09323583180987204	18.619222462203023
chr17	SNHG29	16439061	16439414	1164	354	86309	5724	85145	5370	3.288135593220339	15.855679702048418
chr17	SNHG29	16439415	16439703	156	289	86309	5724	86153	5435	0.5397923875432526	15.851517939282429
chr17	SNHG29	16439394	16439703	246	310	86309	5724	86063	5414	0.7935483870967742	15.896379756187661
chr17	SNHG29	16439061	16439245	995	185	86309	5724	85314	5539	5.378378378378378	15.402419209243545
chr17	USP32P1	16794640	16794658	0	19	51	5336	51	5317	0.0	0.009591875117547489
chr17	MPRIP	17138076	17138429	0	354	316713	14685	316713	14331	0.0	22.09985346451748
chr17	NT5M	17344909	17344926	0	18	339	1969	339	1951	0.0	0.17375704766786262
chr17	NT5M	17303818	17303901	0	84	339	1969	339	1885	0.0	0.17984084880636605
chr17	NT5M	17304478	17304481	0	4	339	1969	339	1965	0.0	0.17251908396946564
chr17	DRC3	17973752	17973753	0	2	24777	4609	24777	4607	0.0	5.378120251790754
chr17	DRC3	17972975	17973099	0	125	24777	4609	24777	4484	0.0	5.525646743978591
chr17	DRG2	18093969	18093973	10	5	186286	6021	186276	6016	2.0	30.96343085106383
chr17	DRG2	18099078	18099093	288	16	186286	6021	185998	6005	18.0	30.973855120732722
chr17	DRG2	18099716	18099723	0	8	186286	6021	186286	6013	0.0	30.980542158656245
chr17	DRG2	18106471	18106486	0	16	186286	6021	186286	6005	0.0	31.0218151540383
chr17	MYO15A	18157883	18157900	13326	18	2057429	16458	2044103	16440	740.3333333333334	124.33716545012166
chr17	KRT17P5	18422343	18422813	144	471	13519	3166	13375	2695	0.3057324840764331	4.962894248608534
chr17	KRT17P5	18420418	18420445	0	28	13519	3166	13519	3138	0.0	4.308158062460166
chr17	KRT17P2	18427362	18427374	0	13	3981	2153	3981	2140	0.0	1.8602803738317757
chr17	TRIM16L	18727703	18727758	0	56	6969	3780	6969	3724	0.0	1.871374865735768
chr17	FBXW10	18770049	18770085	0	37	735	3798	735	3761	0.0	0.19542674820526457
chr17	FBXW10	18744750	18745395	0	646	735	3798	735	3152	0.0	0.23318527918781726
chr17	TVP23B	18790961	18791040	0	80	23155	5755	23155	5675	0.0	4.080176211453744
chr17	PRPSAP2	18856404	18856429	0	26	10100	4727	10100	4701	0.0	2.148479047011274
chr17	MAPK7	19378399	19378542	0	144	689	4017	689	3873	0.0	0.17789827007487735
chr17	MAPK7	19378403	19378542	0	140	689	4017	689	3877	0.0	0.1777147278823833
chr17	MAPK7	19378399	19378402	0	4	689	4017	689	4013	0.0	0.17169200099676052
chr17	MAPK7	19378543	19378630	0	88	689	4017	689	3929	0.0	0.1753626877067956
chr17	SLC47A1P1	19594324	19594334	0	11	59444	1413	59444	1402	0.0	42.39942938659058
chr17	SPECC1	20246072	20246574	0	503	77772	19316	77772	18813	0.0	4.13394992824111
chr17	SPECC1	20095913	20096037	28	125	77772	19316	77744	19191	0.224	4.051065603668386
chr17	SPECC1	20232406	20232414	0	9	77772	19316	77772	19307	0.0	4.028176309110685
chr17	SPECC1	20232406	20232451	0	46	77772	19316	77772	19270	0.0	4.035910742086144
chr17	SPECC1	20232415	20232451	0	37	77772	19316	77772	19279	0.0	4.034026661133876
chr17	CCDC144NL-AS1	20956710	20956824	0	115	5125497	10522	5125497	10407	0.0	492.5047564139521
chr17	TBC1D3P5	27419608	27419613	0	6	41531	4122	41531	4116	0.0	10.09013605442177
chr17	KSR1	27483835	27483851	0	17	91952	11040	91952	11023	0.0	8.341830717590492
chr17	KSR1	27623669	27623795	0	127	91952	11040	91952	10913	0.0	8.425914047466325
chr17	TMEM199	28360572	28360576	0	5	276	4566	276	4561	0.0	0.06051304538478404
chr17	SPAG5-AS1	28599840	28599855	5395	16	101862	2896	96467	2880	337.1875	33.49548611111111
chr17	SUPT6H	28673511	28673618	0	108	153	9640	153	9532	0.0	0.01605119597146454
chr17	RPL23A	28720329	28720430	0	102	0	2219	0	2117	0.0	0.0
chr17	NEK8	28734955	28735004	0	50	561	4426	561	4376	0.0	0.12819926873857404
chr17	NEK8	28725973	28726003	0	31	561	4426	561	4395	0.0	0.12764505119453926
chr17	TRAF4	28748136	28748178	0	43	51187	3983	51187	3940	0.0	12.991624365482233
chr17	TRAF4	28747265	28747391	0	127	51187	3983	51187	3856	0.0	13.27463692946058
chr17	ERAL1	28856583	28856685	0	103	1179	2084	1179	1981	0.0	0.5951539626451288
chr17	ERAL1	28858634	28858824	0	191	1179	2084	1179	1893	0.0	0.6228209191759112
chr17	PIPOX	28952456	28952476	0	21	17957	3797	17957	3776	0.0	4.755561440677966
chr17	PIPOX	29044313	29044394	0	82	17957	3797	17957	3715	0.0	4.833647375504711
chr17	TP53I13	29568509	29568548	0	40	0	2803	0	2763	0.0	0.0
chr17	ANKRD13B	29608000	29608110	0	111	2703	3581	2703	3470	0.0	0.7789625360230548
chr17	GOSR1	30481258	30481263	0	6	62971	9580	62971	9574	0.0	6.5772926676415295
chr17	GOSR1	30477465	30477486	375	22	62971	9580	62596	9558	17.045454545454547	6.549068842854154
chr17	AC005562.1	30631896	30631927	0	32	80961	8636	80961	8604	0.0	9.409693165969317
chr17	AC005562.1	30601824	30601828	0	5	80961	8636	80961	8631	0.0	9.380257212374001
chr17	AC005562.1	30631928	30631979	0	52	80961	8636	80961	8584	0.0	9.431616961789375
chr17	AC005562.1	30631896	30631979	0	84	80961	8636	80961	8552	0.0	9.466908325537887
chr17	AC005562.1	30631928	30632099	0	172	80961	8636	80961	8464	0.0	9.565335538752363
chr17	AC005562.1	30631980	30632099	0	120	80961	8636	80961	8516	0.0	9.506928135274777
chr17	AC005562.1	30631896	30632099	0	204	80961	8636	80961	8432	0.0	9.601636622390892
chr17	ADAP2	30956392	30956469	0	78	51	3738	51	3660	0.0	0.013934426229508197
chr17	NF1	31340584	31340645	0	62	99	20076	99	20014	0.0	0.004946537423803338
chr17	RAB11FIP4	31488273	31488432	0	160	0	12597	0	12437	0.0	0.0
chr17	RHOT1	32202901	32202906	0	6	202	5502	202	5496	0.0	0.03675400291120815
chr17	ZNF207	32369746	32369782	0	37	48418	8928	48418	8891	0.0	5.445731638735801
chr17	PSMD11	32444519	32444614	0	96	0	6502	0	6406	0.0	0.0
chr17	PSMD11	32473946	32474081	0	136	0	6502	0	6366	0.0	0.0
chr17	CCL13	34357569	34357589	0	21	0	816	0	795	0.0	0.0
chr17	AC011193.1	34479508	34479895	0	388	0	1763	0	1375	0.0	0.0
chr17	LIG3	34980598	34980622	56	25	2162	10453	2106	10428	2.24	0.20195627157652474
chr17	UNC45B	35170256	35170261	0	6	196	5699	196	5693	0.0	0.034428245213419986
chr17	AC022706.1	35313645	35313706	0	62	68	1393	68	1331	0.0	0.05108940646130729
chr17	AC022706.1	35323269	35323343	0	75	68	1393	68	1318	0.0	0.051593323216995446
chr17	AC022706.1	35323261	35323343	0	83	68	1393	68	1310	0.0	0.051908396946564885
chr17	AC022706.1	35323261	35323268	0	8	68	1393	68	1385	0.0	0.04909747292418772
chr17	AP2B1	35587429	35587597	0	169	13768	7621	13768	7452	0.0	1.8475577026301664
chr17	AP2B1	35587598	35587663	0	66	13768	7621	13768	7555	0.0	1.8223692918596957
chr17	C17ORF50	35764237	35764325	1337	89	5624	1044	4287	955	15.02247191011236	4.489005235602094
chr17	TAF15	35820240	35820248	0	9	20390	5459	20390	5450	0.0	3.7412844036697246
chr17	TAF15	35809577	35809616	184	40	20390	5459	20206	5419	4.6	3.7287322384203727
chr17	PIGW	36535055	36535592	255	538	1071	2801	816	2263	0.4739776951672863	0.3605832965090588
chr17	PIGW	36535593	36535601	0	9	1071	2801	1071	2792	0.0	0.38359598853868193
chr17	MRM1	36602177	36602352	0	176	0	1465	0	1289	0.0	0.0
chr17	AC243830.1	36722809	36724653	1296	1845	1704	2449	408	604	0.7024390243902439	0.6754966887417219
chr17	TADA2A	37437830	37437922	0	93	8597	5170	8597	5077	0.0	1.6933228284419932
chr17	PSMB3	38752814	38752829	0	16	0	1122	0	1106	0.0	0.0
chr17	LRRC37A11P	39032438	39032438	17	1	833	5878	816	5877	17.0	0.1388463501786626
chr17	LRRC37A11P	39044942	39046341	0	1400	833	5878	833	4478	0.0	0.18602054488610986
chr17	RPL19	39202444	39202445	0	2	204	2265	204	2263	0.0	0.0901458241272647
chr17	RPL19	39200350	39200743	0	394	204	2265	204	1871	0.0	0.10903260288615714
chr17	RPL19	39200479	39200743	0	265	204	2265	204	2000	0.0	0.102
chr17	RPL19	39200350	39200478	0	129	204	2265	204	2136	0.0	0.09550561797752809
chr17	PPP1R1B	39627465	39627473	0	9	0	2807	0	2798	0.0	0.0
chr17	PPP1R1B	39628623	39628706	0	84	0	2807	0	2723	0.0	0.0
chr17	STARD3	39657840	39657852	0	13	0	4382	0	4369	0.0	0.0
chr17	STARD3	39662345	39662367	0	23	0	4382	0	4359	0.0	0.0
chr17	ERBB2	39723625	39723660	0	36	0	8554	0	8518	0.0	0.0
chr17	ERBB2	39707142	39707204	0	63	0	8554	0	8491	0.0	0.0
chr17	GRB7	39743277	39743301	0	25	0	3325	0	3300	0.0	0.0
chr17	CSF3	40015846	40015854	0	9	0	2223	0	2214	0.0	0.0
chr17	CSF3	40015515	40015845	0	331	0	2223	0	1892	0.0	0.0
chr17	THRA	40062452	40062548	102	97	46527	7349	46425	7252	1.0515463917525774	6.401682294539437
chr17	RAPGEFL1	40177123	40177284	37454	162	77238	5363	39784	5201	231.19753086419752	7.64929821188233
chr17	RAPGEFL1	40177187	40177284	25931	98	77238	5363	51307	5265	264.6020408163265	9.744919278252612
chr17	RAPGEFL1	40177123	40177186	11523	64	77238	5363	65715	5299	180.046875	12.401396489903755
chr17	RAPGEFL1	40181374	40181486	0	113	77238	5363	77238	5250	0.0	14.712
chr17	WIPF2	40260628	40260667	0	40	531879	8133	531879	8093	0.0	65.72086988755714
chr17	WIPF2	40219493	40219517	0	25	531879	8133	531879	8108	0.0	65.59928465712876
chr17	CDC6	40288038	40288090	0	53	3977	5266	3977	5213	0.0	0.7629004412046806
chr17	CDC6	40287950	40288090	0	141	3977	5266	3977	5125	0.0	0.776
chr17	CDC6	40287950	40288037	0	88	3977	5266	3977	5178	0.0	0.7680571649285438
chr17	CDC6	40288091	40288132	0	42	3977	5266	3977	5224	0.0	0.7612940275650842
chr17	CDC6	40288038	40288132	0	95	3977	5266	3977	5171	0.0	0.7690968864823051
chr17	CDC6	40287950	40288132	0	183	3977	5266	3977	5083	0.0	0.7824119614400944
chr17	TMEM99	40819171	40819208	0	38	48202	3058	48202	3020	0.0	15.96092715231788
chr17	TMEM99	40819209	40819279	0	71	48202	3058	48202	2987	0.0	16.1372614663542
chr17	KRTAP9-1	41190177	41190248	0	72	0	554	0	482	0.0	0.0
chr17	KRTAP9-1	41189947	41189970	0	24	0	554	0	530	0.0	0.0
chr17	FKBP10	41819676	41820049	51	374	51	4057	0	3683	0.13636363636363635	0.0
chr17	FKBP10	41820024	41820049	0	26	51	4057	51	4031	0.0	0.012651947407591168
chr17	KLHL10	41838065	41838126	0	62	207270	2288	207270	2226	0.0	93.11320754716981
chr17	CNP	41966888	41967013	0	126	6100	6383	6100	6257	0.0	0.9749081029247243
chr17	NKIRAS2	42022473	42022640	0	168	0	4020	0	3852	0.0	0.0
chr17	NKIRAS2	42020205	42020269	0	65	0	4020	0	3955	0.0	0.0
chr17	STAT5A	42304647	42304652	0	6	300458	5445	300458	5439	0.0	55.2414046699761
chr17	COASY	42562214	42562487	0	274	1901	3038	1901	2764	0.0	0.6877713458755427
chr17	COASY	42562220	42562487	0	268	1901	3038	1901	2770	0.0	0.6862815884476534
chr17	COASY	42562237	42562487	0	251	1901	3038	1901	2787	0.0	0.6820954431288123
chr17	COASY	42562214	42562219	0	6	1901	3038	1901	3032	0.0	0.6269788918205804
chr17	COASY	42562214	42562236	0	23	1901	3038	1901	3015	0.0	0.630514096185738
chr17	COASY	42562220	42562236	0	17	1901	3038	1901	3021	0.0	0.6292618338298577
chr17	MLX	42567167	42567328	508	162	6314	3476	5806	3314	3.1358024691358026	1.751961375980688
chr17	MLX	42567161	42567328	586	168	6314	3476	5728	3308	3.488095238095238	1.7315598548972189
chr17	MLX	42567161	42567166	78	6	6314	3476	6236	3470	13.0	1.7971181556195965
chr17	TUBG1	42610591	42610629	0	39	183	2419	183	2380	0.0	0.07689075630252101
chr17	RAMP2	42761013	42761075	0	63	13016	1121	13016	1058	0.0	12.302457466918714
chr17	CNTD1	42799185	42799236	0	52	88092	3323	88092	3271	0.0	26.931213696117396
chr17	CNTD1	42799019	42799236	0	218	88092	3323	88092	3105	0.0	28.371014492753623
chr17	CNTD1	42799019	42799184	0	166	88092	3323	88092	3157	0.0	27.903706050047514
chr17	CNTD1	42807865	42807892	0	28	88092	3323	88092	3295	0.0	26.7350531107739
chr17	PSME3	42833506	42833673	0	168	66961	4720	66961	4552	0.0	14.710237258347979
chr17	PSME3	42833674	42833939	765	266	66961	4720	66196	4454	2.8759398496240602	14.862146385271666
chr17	PSME3	42833506	42833939	765	434	66961	4720	66196	4286	1.762672811059908	15.444703686420905
chr17	AOC2	42849291	42849371	0	81	6763	2681	6763	2600	0.0	2.601153846153846
chr17	RPL27	42998832	42998912	0	81	21746	2030	21746	1949	0.0	11.15751667521806
chr17	IFI35	43013374	43013379	0	6	66371	1892	66371	1886	0.0	35.191410392364794
chr17	NBR1	43170612	43170943	614	332	149792	7964	149178	7632	1.8493975903614457	19.54638364779874
chr17	G6PC3	44071184	44071242	0	59	213	4172	213	4113	0.0	0.051787016776075855
chr17	G6PC3	44071812	44071821	0	10	213	4172	213	4162	0.0	0.05117731859682845
chr17	ASB16	44176941	44177230	0	290	2995	2239	2995	1949	0.0	1.5366854797331966
chr17	TMUB2	44189300	44189588	0	289	2028	3574	2028	3285	0.0	0.617351598173516
chr17	TMUB2	44189092	44189588	0	497	2028	3574	2028	3077	0.0	0.6590835229119272
chr17	TMUB2	44189092	44189299	0	208	2028	3574	2028	3366	0.0	0.6024955436720143
chr17	TMUB2	44187401	44187431	0	31	2028	3574	2028	3543	0.0	0.5723962743437765
chr17	GRN	44345335	44345605	0	271	1277	3085	1277	2814	0.0	0.4538024164889837
chr17	GRN	44351101	44351163	0	63	1277	3085	1277	3022	0.0	0.42256783587028457
chr17	MEIOC	44656620	44656682	0	63	3530	8627	3530	8564	0.0	0.41219056515646896
chr17	MEIOC	44665138	44665488	0	351	3530	8627	3530	8276	0.0	0.4265345577573707
chr17	ADAM11	44772463	44772466	0	4	310	4841	310	4837	0.0	0.06408931155675004
chr17	CCDC103	44899830	44899859	0	30	51	3900	51	3870	0.0	0.01317829457364341
chr17	CCDC103	44899844	44899859	0	16	51	3900	51	3884	0.0	0.013130792996910402
chr17	CCDC103	44899830	44899843	0	14	51	3900	51	3886	0.0	0.01312403499742666
chr17	NMT1	45081753	45081995	0	243	10294	7711	10294	7468	0.0	1.378414568826995
chr17	HEXIM2	45161249	45161400	0	152	6364	1994	6364	1842	0.0	3.454940282301846
chr17	HEXIM2	45161940	45162031	51	92	6364	1994	6313	1902	0.5543478260869565	3.3191377497371186
chr17	FMNL1	45232451	45232480	300	30	39242	6173	38942	6143	10.0	6.339247924466873
chr17	MAP3K14-AS1	45262344	45263391	510	1048	13506	4874	12996	3826	0.4866412213740458	3.396759017250392
chr17	MAP3K14-AS1	45266519	45266699	9243	181	13506	4874	4263	4693	51.06629834254144	0.9083741743021522
chr17	KANSL1-AS1	46193739	46193885	0	147	9753	668	9753	521	0.0	18.719769673704416
chr17	GOSR2	46935170	46935225	0	56	279358	11566	279358	11510	0.0	24.270894874022588
chr17	GOSR2	46923222	46923269	390	48	279358	11566	278968	11518	8.125	24.220177114082308
chr17	GOSR2	46923222	46923387	2671	166	279358	11566	276687	11400	16.09036144578313	24.27078947368421
chr17	GOSR2	46923270	46923387	2281	118	279358	11566	277077	11448	19.33050847457627	24.203092243186582
chr17	GOSR2	46923222	46923632	5612	411	279358	11566	273746	11155	13.654501216545013	24.540206185567012
chr17	GOSR2	46923270	46923632	5222	363	279358	11566	274136	11203	14.385674931129477	24.46987414085513
chr17	GOSR2	46923388	46923632	2941	245	279358	11566	276417	11321	12.004081632653062	24.416305980037098
chr17	MYL4	47209092	47209155	0	64	0	1645	0	1581	0.0	0.0
chr17	MYL4	47213827	47213919	0	93	0	1645	0	1552	0.0	0.0
chr17	ITGB3	47291089	47291427	0	339	151	6355	151	6016	0.0	0.025099734042553192
chr17	EFCAB13	47324075	47324099	0	25	6496	6489	6496	6464	0.0	1.004950495049505
chr17	NPEPPS	47579456	47579511	1937	56	36399	9467	34462	9411	34.589285714285715	3.661885028158538
chr17	NPEPPS	47586245	47586249	0	5	36399	9467	36399	9462	0.0	3.846861128725428
chr17	NPEPPS	47619323	47619372	0	50	36399	9467	36399	9417	0.0	3.8652437081873208
chr17	NPEPPS	47619373	47619495	0	123	36399	9467	36399	9344	0.0	3.8954409246575343
chr17	NPEPPS	47619323	47619495	0	173	36399	9467	36399	9294	0.0	3.9163976759199484
chr17	NPEPPS	47585701	47585745	0	45	36399	9467	36399	9422	0.0	3.8631925281256634
chr17	SP2	47896294	47896337	0	44	3815	3654	3815	3610	0.0	1.056786703601108
chr17	PNPO	47941603	47942051	0	449	0	4987	0	4538	0.0	0.0
chr17	PNPO	47941814	47942051	0	238	0	4987	0	4749	0.0	0.0
chr17	PNPO	47941603	47941813	0	211	0	4987	0	4776	0.0	0.0
chr17	PNPO	47944716	47945612	0	897	0	4987	0	4090	0.0	0.0
chr17	CDK5RAP3	47975639	47975653	0	15	0	4158	0	4143	0.0	0.0
chr17	CDK5RAP3	47973651	47973696	0	46	0	4158	0	4112	0.0	0.0
chr17	CDK5RAP3	47973694	47973696	0	3	0	4158	0	4155	0.0	0.0
chr17	CDK5RAP3	47974032	47974035	0	4	0	4158	0	4154	0.0	0.0
chr17	CDK5RAP3	47973651	47973693	0	43	0	4158	0	4115	0.0	0.0
chr17	CDK5RAP3	47971310	47971407	0	98	0	4158	0	4060	0.0	0.0
chr17	CDK5RAP3	47971153	47971171	0	19	0	4158	0	4139	0.0	0.0
chr17	NFE2L1	48050782	48050819	0	38	10434	5475	10434	5437	0.0	1.919073018208571
chr17	NFE2L1	48048848	48048864	0	17	10434	5475	10434	5458	0.0	1.9116892634664713
chr17	NFE2L1	48054762	48055150	0	389	10434	5475	10434	5086	0.0	2.0515139598898937
chr17	SNX11	48112086	48112111	0	26	51	4144	51	4118	0.0	0.01238465274405051
chr17	SNX11	48107597	48107838	0	242	51	4144	51	3902	0.0	0.013070220399794977
chr17	LINC02086	48705351	48705683	0	333	40	3504	40	3171	0.0	0.01261431725007884
chr17	CALCOCO2	48848083	48848166	0	84	11977	7200	11977	7116	0.0	1.6831084879145588
chr17	ATP5MC1	48892841	48892910	0	70	0	1499	0	1429	0.0	0.0
chr17	UBE2Z	48912966	48913021	0	56	0	3711	0	3655	0.0	0.0
chr17	ABI3	49216681	49216698	0	18	0	2279	0	2261	0.0	0.0
chr17	FLJ40194	49252919	49253133	0	215	85156	4893	85156	4678	0.0	18.203505771697305
chr17	ITGA3	50074281	50074292	0	12	0	8655	0	8643	0.0	0.0
chr17	PDK2	50095381	50095553	0	173	0	4742	0	4569	0.0	0.0
chr17	SGCA	50175376	50175449	0	74	0	2358	0	2284	0.0	0.0
chr17	SGCA	50166078	50166136	0	59	0	2358	0	2299	0.0	0.0
chr17	SGCA	50167728	50167736	0	9	0	2358	0	2349	0.0	0.0
chr17	SGCA	50169105	50169254	0	150	0	2358	0	2208	0.0	0.0
chr17	AC015909.1	50209053	50209072	0	20	0	2615	0	2595	0.0	0.0
chr17	AC015909.1	50209073	50209123	0	51	0	2615	0	2564	0.0	0.0
chr17	AC015909.1	50209053	50209123	0	71	0	2615	0	2544	0.0	0.0
chr17	AC015909.1	50209081	50209123	0	43	0	2615	0	2572	0.0	0.0
chr17	AC015909.1	50214175	50214316	0	142	0	2615	0	2473	0.0	0.0
chr17	AC015909.1	50209073	50209080	0	8	0	2615	0	2607	0.0	0.0
chr17	AC015909.1	50209053	50209080	0	28	0	2615	0	2587	0.0	0.0
chr17	AC015909.1	50214175	50214530	0	356	0	2615	0	2259	0.0	0.0
chr17	XYLT2	50346231	50346275	0	45	0	5479	0	5434	0.0	0.0
chr17	EME1	50375513	50375983	0	471	0	3178	0	2707	0.0	0.0
chr17	ACSF2	50472525	50472579	0	55	0	5152	0	5097	0.0	0.0
chr17	ACSF2	50461288	50461370	0	83	0	5152	0	5069	0.0	0.0
chr17	RSAD1	50484546	50484642	0	97	507	4146	507	4049	0.0	0.12521610274141765
chr17	RSAD1	50483432	50483487	43	56	507	4146	464	4090	0.7678571428571429	0.11344743276283618
chr17	MYCBPAP	50517453	50517497	0	45	0	6482	0	6437	0.0	0.0
chr17	MYCBPAP	50529189	50529430	0	242	0	6482	0	6240	0.0	0.0
chr17	EPN3	50532845	50532985	0	141	153	4499	153	4358	0.0	0.03510784763653052
chr17	EPN3	50532923	50532985	0	63	153	4499	153	4436	0.0	0.03449053201082056
chr17	EPN3	50532845	50532922	0	78	153	4499	153	4421	0.0	0.034607554851843476
chr17	EPN3	50536200	50536278	0	79	153	4499	153	4420	0.0	0.03461538461538462
chr17	SPATA20	50547768	50547954	0	187	0	4742	0	4555	0.0	0.0
chr17	SPATA20	50551191	50551222	0	32	0	4742	0	4710	0.0	0.0
chr17	CACNA1G	50617909	50617929	0	21	357	10101	357	10080	0.0	0.035416666666666666
chr17	CACNA1G	50608020	50608040	0	21	357	10101	357	10080	0.0	0.035416666666666666
chr17	ABCC3	50676454	50676588	0	135	0	8868	0	8733	0.0	0.0
chr17	ABCC3	50658497	50658546	0	50	0	8868	0	8818	0.0	0.0
chr17	ABCC3	50673139	50673169	0	31	0	8868	0	8837	0.0	0.0
chr17	NME2	51166498	51166563	0	66	0	2502	0	2436	0.0	0.0
chr17	LINC02073	51341312	51341683	0	372	0	7442	0	7070	0.0	0.0
chr17	TOM1L1	54901182	54901245	1610	64	28863	7265	27253	7201	25.15625	3.7846132481599777
chr17	PCTP	55751245	55751477	969	233	2601	5817	1632	5584	4.1587982832618025	0.2922636103151863
chr17	AKAP1	57085867	57086074	306	208	27339	5359	27033	5151	1.4711538461538463	5.248107163657542
chr17	AKAP1	57085870	57086074	255	205	27339	5359	27084	5154	1.2439024390243902	5.254947613504075
chr17	RAD51C	58692633	58692685	0	53	8508	5705	8508	5652	0.0	1.505307855626327
chr17	RAD51C	58692686	58692788	0	103	8508	5705	8508	5602	0.0	1.5187433059621565
chr17	RAD51C	58692633	58692788	0	156	8508	5705	8508	5549	0.0	1.5332492340962336
chr17	RAD51C	58692686	58693650	0	965	8508	5705	8508	4740	0.0	1.7949367088607595
chr17	RAD51C	58692789	58693650	0	862	8508	5705	8508	4843	0.0	1.7567623373941772
chr17	RAD51C	58692633	58693650	0	1018	8508	5705	8508	4687	0.0	1.8152336249199914
chr17	RAD51C	58692686	58693811	0	1126	8508	5705	8508	4579	0.0	1.8580476086481765
chr17	RAD51C	58692789	58693811	0	1023	8508	5705	8508	4682	0.0	1.8171721486544212
chr17	RAD51C	58692633	58693811	0	1179	8508	5705	8508	4526	0.0	1.8798055678303138
chr17	RAD51C	58693651	58693811	0	161	8508	5705	8508	5544	0.0	1.5346320346320346
chr17	SMG8	59210262	59211810	0	1549	357	3602	357	2053	0.0	0.17389186556259134
chr17	SMG8	59212943	59213601	306	659	357	3602	51	2943	0.464339908952959	0.017329255861365953
chr17	SMG8	59211811	59212030	0	220	357	3602	357	3382	0.0	0.10555884092253105
chr17	DHX40	59565724	59565783	0	60	0	5857	0	5797	0.0	0.0
chr17	DHX40	59566710	59566794	0	85	0	5857	0	5772	0.0	0.0
chr17	CLTC	59644484	59644495	0	12	127	11871	127	11859	0.0	0.010709166034235601
chr17	VMP1	59707749	59708077	0	329	0	5500	0	5171	0.0	0.0
chr17	AC011921.1	60548567	60548695	0	129	23285	871	23285	742	0.0	31.381401617250674
chr17	BCAS3	61038050	61038054	0	5	5291	8054	5291	8049	0.0	0.6573487389737855
chr17	BCAS3	60887127	60887211	0	85	5291	8054	5291	7969	0.0	0.6639477977161501
chr17	BCAS3	60887312	60887447	0	136	5291	8054	5291	7918	0.0	0.6682242990654206
chr17	EFCAB3	62380590	62380613	0	24	30	3095	30	3071	0.0	0.00976880494952784
chr17	MRC2	62678618	62678646	0	29	14577	6443	14577	6414	0.0	2.272684752104771
chr17	TANC2	63099247	63099357	602	111	14764	19851	14162	19740	5.423423423423423	0.7174265450861196
chr17	ACE	63484970	63485066	0	97	7143	8236	7143	8139	0.0	0.8776262440103206
chr17	KCNH6	63524237	63524369	0	133	5852	4226	5852	4093	0.0	1.4297581236257024
chr17	MAP3K3	63685579	63685590	0	12	89	5824	89	5812	0.0	0.015313145216792843
chr17	MAP3K3	63632799	63632802	0	4	89	5824	89	5820	0.0	0.015292096219931271
chr17	SNHG25	64145996	64146000	0	5	0	280	0	275	0.0	0.0
chr17	CEP95	64531019	64531022	0	4	3660	6734	3660	6730	0.0	0.5438335809806835
chr17	RGS9	65177795	65177803	0	9	4199	7076	4199	7067	0.0	0.5941700863166832
chr17	RGS9	65208008	65208011	0	4	4199	7076	4199	7072	0.0	0.59375
chr17	BPTF	67945897	67946325	0	429	0	14493	0	14064	0.0	0.0
chr17	KPNA2	68035837	68035840	0	4	0	6696	0	6692	0.0	0.0
chr17	AMZ2	68248087	68248157	0	71	0	3654	0	3583	0.0	0.0
chr17	AMZ2	68248111	68248157	0	47	0	3654	0	3607	0.0	0.0
chr17	AMZ2	68248087	68248110	0	24	0	3654	0	3630	0.0	0.0
chr17	AMZ2	68248158	68248162	0	5	0	3654	0	3649	0.0	0.0
chr17	AMZ2	68248087	68248162	0	76	0	3654	0	3578	0.0	0.0
chr17	AMZ2	68248111	68248162	0	52	0	3654	0	3602	0.0	0.0
chr17	AMZ2	68250129	68250470	0	342	0	3654	0	3312	0.0	0.0
chr17	AMZ2	68250471	68250480	0	10	0	3654	0	3644	0.0	0.0
chr17	PRKAR1A	68515567	68515576	0	10	255	6098	255	6088	0.0	0.04188567674113009
chr17	PRKAR1A	68512549	68512579	0	31	255	6098	255	6067	0.0	0.04203065765617274
chr17	PRKAR1A	68512496	68512579	0	84	255	6098	255	6014	0.0	0.04240106418357167
chr17	PRKAR1A	68512496	68512548	0	53	255	6098	255	6045	0.0	0.04218362282878412
chr17	PRKAR1A	68512971	68512978	0	8	255	6098	255	6090	0.0	0.04187192118226601
chr17	PRKAR1A	68512979	68513271	0	293	255	6098	255	5805	0.0	0.04392764857881137
chr17	MAP2K6	69517552	69517613	0	62	204	15176	204	15114	0.0	0.013497419610956728
chr17	MAP2K6	69502685	69502685	0	1	204	15176	204	15175	0.0	0.013443163097199342
chr17	AC118653.1	71596567	71596574	0	8	0	572	0	564	0.0	0.0
chr17	COG1	73206818	73206908	0	91	17914	4290	17914	4199	0.0	4.266253869969041
chr17	C17ORF80	73232630	73232717	662	88	192496	4671	191834	4583	7.5227272727272725	41.85773510800786
chr17	AC124804.1	73518391	73518523	5251	133	177394	4841	172143	4708	39.4812030075188	36.56393372982158
chr17	LINC02092	73787372	73787699	5013	328	32886	3086	27873	2758	15.283536585365853	10.106236403190717
chr17	RPL38	74203711	74203745	0	35	51	3653	51	3618	0.0	0.014096185737976783
chr17	RPL38	74203711	74203770	0	60	51	3653	51	3593	0.0	0.014194266629557473
chr17	RPL38	74203746	74203770	0	25	51	3653	51	3628	0.0	0.014057331863285557
chr17	DNAI2	74312076	74312230	80	155	9837	2878	9757	2723	0.5161290322580645	3.583180315828131
chr17	GPR142	74367749	74367794	0	46	102	1561	102	1515	0.0	0.06732673267326733
chr17	GPR142	74369583	74369634	0	52	102	1561	102	1509	0.0	0.06759443339960239
chr17	GPRC5C	74440047	74440827	0	781	7027	5898	7027	5117	0.0	1.373265585303889
chr17	GPRC5C	74432142	74432523	0	382	7027	5898	7027	5516	0.0	1.2739303843364758
chr17	CD300A	74466656	74466743	0	88	26442	2709	26442	2621	0.0	10.088515833651279
chr17	KCTD2	75032654	75032724	0	71	255	5290	255	5219	0.0	0.048859934853420196
chr17	ARMC7	75110543	75110606	0	64	354	2712	354	2648	0.0	0.1336858006042296
chr17	NUP85	75231980	75232116	0	137	31814	4297	31814	4160	0.0	7.647596153846154
chr17	NUP85	75234789	75234794	0	6	31814	4297	31814	4291	0.0	7.414122582148683
chr17	MRPS7	75265965	75265966	0	2	51	3331	51	3329	0.0	0.015319915890657855
chr17	TMEM94	75491853	75491900	1686	48	201749	7638	200063	7590	35.125	26.358761528326745
chr17	TMEM94	75471930	75471955	0	26	201749	7638	201749	7612	0.0	26.5040725170783
chr17	TMEM94	75491456	75491467	180	12	201749	7638	201569	7626	15.0	26.43181222134802
chr17	TSEN54	75522334	75522521	0	188	0	2942	0	2754	0.0	0.0
chr17	MYO15B	75606022	75606058	0	37	194	12656	194	12619	0.0	0.015373642919407243
chr17	MYO15B	75624250	75624269	0	20	194	12656	194	12636	0.0	0.015352959797404243
chr17	MYO15B	75624640	75624688	0	49	194	12656	194	12607	0.0	0.015388276354406281
chr17	ITGB4	75721564	75721612	0	49	0	6607	0	6558	0.0	0.0
chr17	UNK	75812289	75812360	0	72	153	5560	153	5488	0.0	0.027879008746355686
chr17	TEN1-CDK3	75991578	75991623	0	46	843	3907	843	3861	0.0	0.21833721833721834
chr17	ZACN	76080425	76081118	51	694	6410	3339	6359	2645	0.07348703170028818	2.4041587901701322
chr17	UBALD2	76265404	76265625	0	222	51	1630	51	1408	0.0	0.03622159090909091
chr17	SPHK1	76384807	76385169	0	363	4446	4022	4446	3659	0.0	1.2150860890953812
chr17	PRCD	76543933	76544370	102	438	102	5045	0	4607	0.2328767123287671	0.0
chr17	PRCD	76545637	76547372	0	1736	102	5045	102	3309	0.0	0.030825022665457842
chr17	PRCD	76546132	76547372	0	1241	102	5045	102	3804	0.0	0.026813880126182965
chr17	SNHG16	76561399	76561402	0	4	102	5256	102	5252	0.0	0.01942117288651942
chr17	SNHG16	76558601	76559043	0	443	102	5256	102	4813	0.0	0.021192603365884063
chr17	SNHG16	76557858	76559043	0	1186	102	5256	102	4070	0.0	0.02506142506142506
chr17	METTL23	76726880	76727213	51	334	210	1838	159	1504	0.15269461077844312	0.10571808510638298
chr17	METTL23	76727179	76727213	0	35	210	1838	210	1803	0.0	0.11647254575707154
chr17	METTL23	76726880	76727178	51	299	210	1838	159	1539	0.1705685618729097	0.10331384015594541
chr17	METTL23	76733378	76733381	0	4	210	1838	210	1834	0.0	0.11450381679389313
chr17	METTL23	76726880	76727357	57	478	210	1838	153	1360	0.1192468619246862	0.1125
chr17	METTL23	76727214	76727357	6	144	210	1838	204	1694	0.041666666666666664	0.1204250295159386
chr17	METTL23	76727179	76727357	6	179	210	1838	204	1659	0.0335195530726257	0.12296564195298372
chr17	MFSD11	76737999	76738165	0	167	11553	5442	11553	5275	0.0	2.190142180094787
chr17	MFSD11	76737977	76738165	0	189	11553	5442	11553	5253	0.0	2.1993146773272416
chr17	MFSD11	76737884	76738165	0	282	11553	5442	11553	5160	0.0	2.238953488372093
chr17	MFSD11	76737977	76737998	0	22	11553	5442	11553	5420	0.0	2.131549815498155
chr17	MFSD11	76737884	76737998	0	115	11553	5442	11553	5327	0.0	2.1687629059508167
chr17	MFSD11	76737884	76737976	0	93	11553	5442	11553	5349	0.0	2.1598429613011776
chr17	SNHG20	77088683	77088949	0	267	0	4357	0	4090	0.0	0.0
chr17	SNHG20	77088878	77088949	0	72	0	4357	0	4285	0.0	0.0
chr17	SNHG20	77088950	77088985	0	36	0	4357	0	4321	0.0	0.0
chr17	SNHG20	77088878	77088985	0	108	0	4357	0	4249	0.0	0.0
chr17	SEC14L1	77141055	77141107	0	53	102	8098	102	8045	0.0	0.012678682411435674
chr17	SEPTIN9	77288211	77288214	0	4	51	13488	51	13484	0.0	0.0037822604568377334
chr17	SEPTIN9	77453997	77454363	0	367	51	13488	51	13121	0.0	0.003886898864415822
chr17	SEPTIN9	77454109	77454363	0	255	51	13488	51	13233	0.0	0.003854001360235774
chr17	SEPTIN9	77454364	77454449	0	86	51	13488	51	13402	0.0	0.0038054021787792868
chr17	SEPTIN9	77454109	77454449	0	341	51	13488	51	13147	0.0	0.003879211987525671
chr17	AC021683.3	77517326	77517522	0	197	0	5420	0	5223	0.0	0.0
chr17	AC021683.3	77527146	77527495	0	350	0	5420	0	5070	0.0	0.0
chr17	AC021683.3	77527845	77527858	0	14	0	5420	0	5406	0.0	0.0
chr17	TNRC6C	78051449	78051457	0	9	88002	11136	88002	11127	0.0	7.908870315448908
chr17	TMC8	78130852	78130887	0	36	85	5471	85	5435	0.0	0.015639374425023
chr17	TMC8	78137324	78137358	0	35	85	5471	85	5436	0.0	0.015636497424576894
chr17	TMC8	78132031	78132214	0	184	85	5471	85	5287	0.0	0.01607717041800643
chr17	AFMID	78205739	78205753	0	15	27331	4061	27331	4046	0.0	6.755066732575383
chr17	BIRC5	78216035	78216066	0	32	48990	3820	48990	3788	0.0	12.932946145723337
chr17	BIRC5	78214790	78214793	120	4	48990	3820	48870	3816	30.0	12.806603773584905
chr17	PGS1	78419676	78419725	0	50	13900	4741	13900	4691	0.0	2.963120869750586
chr17	DNAH17-AS1	78485091	78485162	0	72	153	7667	153	7595	0.0	0.02014483212639895
chr17	ENGASE	79083932	79083951	400	20	43529	6011	43129	5991	20.0	7.198965114338174
chr17	ENGASE	79082064	79082877	1599	814	43529	6011	41930	5197	1.9643734643734643	8.068116220896671
chr17	CCDC40	80036692	80036757	655	66	167078	8392	166423	8326	9.924242424242424	19.988349747778045
chr17	GAA	80101626	80101890	1212	265	60511	5083	59299	4818	4.573584905660377	12.30780406807804
chr17	GAA	80101891	80101925	0	35	60511	5083	60511	5048	0.0	11.987123613312203
chr17	CARD14	80204342	80204351	740	10	541794	9239	541054	9229	74.0	58.62541987214216
chr17	CARD14	80170057	80170136	0	80	541794	9239	541794	9159	0.0	59.154274484113984
chr17	CARD14	80198163	80198173	11	11	541794	9239	541783	9228	1.0	58.710771564802776
chr17	ENDOV	80415611	80415821	5135	211	124386	6269	119251	6058	24.33649289099526	19.68487949818422
chr17	BAIAP2	81053740	81053743	0	4	444	8058	444	8054	0.0	0.0551278867643407
chr17	BAIAP2	81085716	81085725	0	10	444	8058	444	8048	0.0	0.055168986083499
chr17	BAIAP2	81053744	81053791	0	48	444	8058	444	8010	0.0	0.05543071161048689
chr17	BAIAP2	81053740	81053791	0	52	444	8058	444	8006	0.0	0.055458406195353485
chr17	BAIAP2	81110956	81110959	0	4	444	8058	444	8054	0.0	0.0551278867643407
chr17	NDUFAF8	81239679	81239682	0	4	0	1254	0	1250	0.0	0.0
chr17	CCDC137	81666901	81667007	0	107	0	2396	0	2289	0.0	0.0
chr17	HGS	81688791	81688827	0	37	0	8542	0	8505	0.0	0.0
chr17	HGS	81690209	81690234	0	26	0	8542	0	8516	0.0	0.0
chr17	HGS	81693963	81693965	0	3	0	8542	0	8539	0.0	0.0
chr17	HGS	81696526	81696529	0	4	0	8542	0	8538	0.0	0.0
chr17	HGS	81696700	81696747	0	48	0	8542	0	8494	0.0	0.0
chr17	HGS	81700478	81700600	0	123	0	8542	0	8419	0.0	0.0
chr17	HGS	81700811	81700814	0	4	0	8542	0	8538	0.0	0.0
chr17	HGS	81701128	81701131	0	4	0	8542	0	8538	0.0	0.0
chr17	HGS	81684892	81685069	0	178	0	8542	0	8364	0.0	0.0
chr17	HGS	81696000	81696041	0	42	0	8542	0	8500	0.0	0.0
chr17	HGS	81696004	81696041	0	38	0	8542	0	8504	0.0	0.0
chr17	HGS	81685690	81685693	0	4	0	8542	0	8538	0.0	0.0
chr17	HGS	81693966	81694050	0	85	0	8542	0	8457	0.0	0.0
chr17	HGS	81693963	81694050	0	88	0	8542	0	8454	0.0	0.0
chr17	HGS	81696000	81696003	0	4	0	8542	0	8538	0.0	0.0
chr17	HGS	81696530	81696531	0	2	0	8542	0	8540	0.0	0.0
chr17	HGS	81696526	81696531	0	6	0	8542	0	8536	0.0	0.0
chr17	HGS	81701419	81701422	0	4	0	8542	0	8538	0.0	0.0
chr17	ANAPC11	81891834	81891841	0	8	0	2490	0	2482	0.0	0.0
chr17	ANAPC11	81894587	81894624	0	38	0	2490	0	2452	0.0	0.0
chr17	ANAPC11	81891842	81891863	0	22	0	2490	0	2468	0.0	0.0
chr17	ANAPC11	81891834	81891863	0	30	0	2490	0	2460	0.0	0.0
chr17	ANAPC11	81899328	81899542	0	215	0	2490	0	2275	0.0	0.0
chr17	ANAPC11	81891830	81891841	0	12	0	2490	0	2478	0.0	0.0
chr17	ASPSCR1	82017089	82017113	0	25	0	8568	0	8543	0.0	0.0
chr17	ASPSCR1	81978340	81978804	0	465	0	8568	0	8103	0.0	0.0
chr17	RAC3	82032459	82032498	0	40	0	1479	0	1439	0.0	0.0
chr17	DCXR-DT	82038269	82038413	0	145	0	585	0	440	0.0	0.0
chr17	GPS1	82052443	82052459	0	17	0	3905	0	3888	0.0	0.0
chr17	GPS1	82051965	82052459	0	495	0	3905	0	3410	0.0	0.0
chr17	SLC16A3	82236845	82236872	0	28	0	5874	0	5846	0.0	0.0
chr17	SLC16A3	82228530	82228545	0	16	0	5874	0	5858	0.0	0.0
chr17	AC132872.5	82273924	82274483	0	560	0	4275	0	3715	0.0	0.0
chr17	HEXD	82441071	82441075	0	5	0	4126	0	4121	0.0	0.0
chr17	HEXD	82439714	82440334	0	621	0	4126	0	3505	0.0	0.0
chr17	NARF	82458509	82458517	0	9	0	6641	0	6632	0.0	0.0
chr17	NARF	82484931	82484950	0	20	0	6641	0	6621	0.0	0.0
chr17	NARF	82460073	82460323	0	251	0	6641	0	6390	0.0	0.0
chr17	FOXK2	82559448	82559480	0	33	0	7313	0	7280	0.0	0.0
chr17	FN3KRP	82720842	82720965	0	124	0	2954	0	2830	0.0	0.0
chr18	CLUL1	616758	616764	0	7	8307	3861	8307	3854	0.0	2.1554229372080953
chr18	AP000829.1	1133895	1133952	0	58	102	2283	102	2225	0.0	0.04584269662921348
chr18	AP005262.1	1509224	1509337	0	114	240	9198	240	9084	0.0	0.026420079260237782
chr18	MYL12A	3252326	3252482	1938	157	4552819	2866	4550881	2709	12.343949044585987	1679.9117755629384
chr18	MYL12B	3262757	3262784	574	28	2669578	1549	2669004	1521	20.5	1754.7692307692307
chr18	TGIF1	3449657	3450070	3444	414	698394	7818	694950	7404	8.318840579710145	93.86142625607779
chr18	TGIF1	3451772	3451775	50	4	698394	7818	698344	7814	12.5	89.37087279242385
chr18	TGIF1	3451763	3451775	191	13	698394	7818	698203	7805	14.692307692307692	89.45586162716208
chr18	TGIF1	3451763	3451771	141	9	698394	7818	698253	7809	15.666666666666666	89.4164425662697
chr18	TGIF1	3451776	3452382	7412	607	698394	7818	690982	7211	12.210873146622735	95.8233254749688
chr18	TGIF1	3451772	3452382	7462	611	698394	7818	690932	7207	12.212765957446809	95.86957125017344
chr18	TGIF1	3451763	3452382	7603	620	698394	7818	690791	7198	12.262903225806452	95.96985273687136
chr18	GAPLINC	3467271	3467296	0	26	2753	1056	2753	1030	0.0	2.6728155339805824
chr18	AP002478.1	3653212	3653335	0	124	204	1765	204	1641	0.0	0.12431444241316271
chr18	LINC01892	5085229	5085962	0	734	102	2813	102	2079	0.0	0.049062049062049064
chr18	LINC00667	5238894	5239049	38770	156	386439	9559	347669	9403	248.52564102564102	36.974263532915025
chr18	LINC00667	5241813	5241889	2319	77	386439	9559	384120	9482	30.116883116883116	40.51044083526682
chr18	LINC00667	5239050	5239196	32478	147	386439	9559	353961	9412	220.9387755102041	37.60741606459838
chr18	LINC00667	5238894	5239196	71248	303	386439	9559	315191	9256	235.14191419141915	34.05261452031115
chr18	LINC00667	5241256	5241812	15975	557	386439	9559	370464	9002	28.68043087971275	41.15352143968007
chr18	LINC00667	5239197	5241812	86352	2616	386439	9559	300087	6943	33.00917431192661	43.22151807575976
chr18	LINC00667	5240709	5241255	8326	547	386439	9559	378113	9012	15.221206581352833	41.95661340434975
chr18	LINC00667	5240820	5241255	5692	436	386439	9559	380747	9123	13.055045871559633	41.734845993642445
chr18	LINC00667	5240965	5241255	4531	291	386439	9559	381908	9268	15.570446735395189	41.207164436771684
chr18	LINC00667	5241256	5241889	18294	634	386439	9559	368145	8925	28.854889589905362	41.24873949579832
chr18	LINC00667	5239197	5241889	88671	2693	386439	9559	297768	6866	32.92647604901597	43.3684823769298
chr18	LINC00667	5240709	5240819	2634	111	386439	9559	383805	9448	23.72972972972973	40.62288314987299
chr18	LINC00667	5239197	5241255	70377	2059	386439	9559	316062	7500	34.18018455560952	42.1416
chr18	LINC00667	5239050	5241255	102855	2206	386439	9559	283584	7353	46.62511332728921	38.5671154630763
chr18	LINC00667	5238894	5241255	141625	2362	386439	9559	244814	7197	59.95977984758679	34.01611782687231
chr18	LINC00667	5240616	5241255	11932	640	386439	9559	374507	8919	18.64375	41.98979706245095
chr18	LINC00667	5240278	5241255	15290	978	386439	9559	371149	8581	15.633946830265849	43.252418133084724
chr18	LINC00667	5240709	5240964	3795	256	386439	9559	382644	9303	14.82421875	41.131247984521124
chr18	LINC00667	5240820	5240964	1161	145	386439	9559	385278	9414	8.006896551724138	40.92606755895475
chr18	MIR3976HG	5793705	5793742	0	38	0	12474	0	12436	0.0	0.0
chr18	MIR3976HG	5750833	5750904	0	72	0	12474	0	12402	0.0	0.0
chr18	MIR3976HG	5762474	5762619	0	146	0	12474	0	12328	0.0	0.0
chr18	ARHGAP28	6868232	6868234	0	3	51	11935	51	11932	0.0	0.0042742205833053975
chr18	NDUFV2	9102798	9103433	9897	636	551539	2300	541642	1664	15.56132075471698	325.50600961538464
chr18	NDUFV2	9102963	9103433	9711	471	551539	2300	541828	1829	20.61783439490446	296.24275560415526
chr18	ANKRD12	9208798	9208803	0	6	79457	12266	79457	12260	0.0	6.4809951060358895
chr18	ANKRD12	9136966	9137096	62	131	79457	12266	79395	12135	0.4732824427480916	6.542645241038319
chr18	TXNDC2	9886081	9886283	0	203	1122	3299	1122	3096	0.0	0.3624031007751938
chr18	LINC01255	11505925	11505956	0	32	0	8070	0	8038	0.0	0.0
chr18	LINC01255	11490966	11490995	0	30	0	8070	0	8040	0.0	0.0
chr18	IMPA2	12012216	12012349	4284	134	441647	3420	437363	3286	31.970149253731343	133.0989044430919
chr18	AP005264.4	12218831	12218832	0	2	0	2207	0	2205	0.0	0.0
chr18	CIDEA	12254422	12254956	0	535	0	1816	0	1281	0.0	0.0
chr18	PRELID3A	12429434	12429436	304	3	174838	2584	174534	2581	101.33333333333333	67.62262688880278
chr18	PSMG2	12658206	12658343	1424	138	1290018	2401	1288594	2263	10.318840579710145	569.4184710561202
chr18	LDLRAD4	13612065	13612774	0	710	3651	29113	3651	28403	0.0	0.1285427595676513
chr18	LDLRAD4	13612775	13613168	0	394	3651	29113	3651	28719	0.0	0.12712838190744802
chr18	RBBP8	22934079	22934159	0	81	1373	5107	1373	5026	0.0	0.27317946677278154
chr18	RBBP8	22934079	22934264	0	186	1373	5107	1373	4921	0.0	0.27900833163991057
chr18	RBBP8	22934160	22934264	0	105	1373	5107	1373	5002	0.0	0.27449020391843265
chr18	CABLES1	23134652	23134670	0	19	0	6524	0	6505	0.0	0.0
chr18	RIOK3	23473484	23473626	0	143	0	4777	0	4634	0.0	0.0
chr18	CABYR	24156043	24156999	0	957	765	3482	765	2525	0.0	0.30297029702970296
chr18	CABYR	24150625	24150631	0	7	765	3482	765	3475	0.0	0.22014388489208633
chr18	IMPACT	24426744	24426792	0	49	102	4343	102	4294	0.0	0.02375407545412203
chr18	IMPACT	24450815	24450867	0	53	102	4343	102	4290	0.0	0.023776223776223775
chr18	AC007922.4	24500610	24500624	0	15	0	857	0	842	0.0	0.0
chr18	LINC01915	24692641	24692670	0	30	408	10136	408	10106	0.0	0.040372056204235104
chr18	LINC01915	24694367	24694527	0	161	408	10136	408	9975	0.0	0.040902255639097745
chr18	AC018697.1	24726758	24726761	0	4	0	8294	0	8290	0.0	0.0
chr18	PSMA8	26144572	26144685	5	114	31	1902	26	1788	0.043859649122807015	0.0145413870246085
chr18	LINC01543	26425128	26425301	0	174	0	1147	0	973	0.0	0.0
chr18	AC012588.1	26688155	26688333	0	179	0	2696	0	2517	0.0	0.0
chr18	TTR	31576169	31576271	0	103	0	2183	0	2080	0.0	0.0
chr18	ASXL3	33578974	33579107	510	134	536974	13548	536464	13414	3.8059701492537314	39.992843298046814
chr18	MAPRE2	35041662	35041766	0	105	0	6148	0	6043	0.0	0.0
chr18	ZNF397	35241072	35241109	0	38	0	8716	0	8678	0.0	0.0
chr18	ZNF397	35241110	35241690	0	581	0	8716	0	8135	0.0	0.0
chr18	ZNF397	35241072	35241690	0	619	0	8716	0	8097	0.0	0.0
chr18	ZNF397	35242885	35242941	0	57	0	8716	0	8659	0.0	0.0
chr18	ZNF271P	35290392	35291232	0	841	0	7454	0	6613	0.0	0.0
chr18	C18ORF21	35972841	35972907	0	67	0	1621	0	1554	0.0	0.0
chr18	KIAA1328	37222118	37225283	51	3166	51	9612	0	6446	0.016108654453569172	0.0
chr18	KIAA1328	36923958	36923961	0	4	51	9612	51	9608	0.0	0.0053080766028309745
chr18	LINC01902	39870969	39875941	3162	4973	3162	12838	0	7865	0.6358335009048864	0.0
chr18	LINC01902	39865912	39866037	0	126	3162	12838	3162	12712	0.0	0.2487413467589679
chr18	SLC14A2	45615547	45615582	0	36	0	4754	0	4718	0.0	0.0
chr18	SLC14A1	45730121	45730471	0	351	51	6081	51	5730	0.0	0.008900523560209424
chr18	SIGLEC15	45837886	45837896	0	11	0	3457	0	3446	0.0	0.0
chr18	HAUS1	46105369	46105408	0	40	51	2132	51	2092	0.0	0.024378585086042064
chr18	CTIF	48758406	48758411	0	6	1681	6386	1681	6380	0.0	0.2634796238244514
chr18	LIPG	49561461	49561890	0	430	0	11485	0	11055	0.0	0.0
chr18	SKA1	50375195	50375239	0	45	102	2904	102	2859	0.0	0.035676810073452254
chr18	SMAD4	51030277	51030623	0	347	51	10684	51	10337	0.0	0.004933733191448196
chr18	DCC	53486953	53486958	0	6	2092	13013	2092	13007	0.0	0.16083647266856307
chr18	POLI	54269662	54270032	1938	371	648582	9485	646644	9114	5.223719676549865	70.95062541145491
chr18	POLI	54284014	54284065	93	52	648582	9485	648489	9433	1.7884615384615385	68.7468461783102
chr18	C18ORF54	54361892	54362431	7036	540	10589	4915	3553	4375	13.02962962962963	0.8121142857142857
chr18	C18ORF54	54361949	54362431	5654	483	10589	4915	4935	4432	11.70600414078675	1.1134927797833936
chr18	C18ORF54	54361892	54361948	1382	57	10589	4915	9207	4858	24.24561403508772	1.8952243721696171
chr18	LINC01905	56063232	56063353	90	122	1272	3707	1182	3585	0.7377049180327869	0.3297071129707113
chr18	LINC01905	56063289	56063353	0	65	1272	3707	1272	3642	0.0	0.34925864909390447
chr18	LINC01905	56063232	56063288	90	57	1272	3707	1182	3650	1.5789473684210527	0.3238356164383562
chr18	AC006305.3	56137826	56137943	1581	118	23005	1531	21424	1413	13.398305084745763	15.16206652512385
chr18	NEDD4L	58091515	58091627	0	113	306	30352	306	30239	0.0	0.01011938225470419
chr18	NEDD4L	58149560	58149569	0	10	306	30352	306	30342	0.0	0.01008503065058335
chr18	NEDD4L	58227889	58227907	0	19	306	30352	306	30333	0.0	0.010088022945307092
chr18	ZNF532	58863687	58863750	0	64	51	9593	51	9529	0.0	0.005352083114702487
chr18	ZNF532	58864987	58865385	0	399	51	9593	51	9194	0.0	0.00554709593212965
chr18	SEC11C	59152613	59152685	0	73	255	3813	255	3740	0.0	0.06818181818181818
chr18	GRP	59225716	59225734	0	19	51	843	51	824	0.0	0.061893203883495146
chr18	AC090621.1	60294312	60294673	0	362	0	998	0	636	0.0	0.0
chr18	AC010928.1	60643579	60643580	0	2	11182	1706	11182	1704	0.0	6.562206572769953
chr18	RELCH	62282443	62282444	0	2	88	10758	88	10756	0.0	0.008181480104127928
chr18	SERPINB12	63558427	63558486	0	60	0	1285	0	1225	0.0	0.0
chr18	SERPINB13	63589713	63589715	0	3	0	4545	0	4542	0.0	0.0
chr18	SERPINB13	63589716	63589742	0	27	0	4545	0	4518	0.0	0.0
chr18	SERPINB13	63589713	63589742	0	30	0	4545	0	4515	0.0	0.0
chr18	SERPINB8	63970171	63970187	0	17	0	5687	0	5670	0.0	0.0
chr18	LINC01924	64147371	64147475	0	105	0	3465	0	3360	0.0	0.0
chr18	AC021701.1	70206483	70206574	0	92	0	2394	0	2302	0.0	0.0
chr18	CNDP2	74497596	74497726	0	131	51630	7642	51630	7511	0.0	6.873918253228598
chr18	CNDP1	74561012	74561018	0	7	7724	6780	7724	6773	0.0	1.140410453270338
chr18	TSHZ1	75211244	75211916	0	673	0	5987	0	5314	0.0	0.0
chr18	LINC01893	76214457	76214493	0	37	0	1662	0	1625	0.0	0.0
chr18	LINC00683	76619571	76620021	0	451	0	14982	0	14531	0.0	0.0
chr18	LINC00683	76620022	76621194	0	1173	0	14982	0	13809	0.0	0.0
chr18	NFATC1	79451042	79451126	0	85	0	9083	0	8998	0.0	0.0
chr18	NFATC1	79486631	79486937	0	307	0	9083	0	8776	0.0	0.0
chr18	ADNP2	80117585	80117650	0	66	0	5664	0	5598	0.0	0.0
chr18	ENOSF1	712359	712502	413	144	2564676	9343	2564263	9199	2.8680555555555554	278.7545385367975
chr18	ENOSF1	712359	712376	26	18	2564676	9343	2564650	9325	1.4444444444444444	275.02949061662196
chr18	ENOSF1	712377	712502	387	126	2564676	9343	2564289	9217	3.0714285714285716	278.212976022567
chr18	LINC00470	1269669	1269685	0	17	0	7735	0	7718	0.0	0.0
chr18	LINC00470	1361142	1361175	0	34	0	7735	0	7701	0.0	0.0
chr18	METTL4	2566820	2567510	31460	691	149200	3516	117740	2825	45.52821997105644	41.67787610619469
chr18	MYOM1	3151693	3151694	0	2	7061	6472	7061	6470	0.0	1.0913446676970633
chr18	AP005329.1	3261271	3261608	0	338	398419	1066	398419	728	0.0	547.2788461538462
chr18	LINC01895	3358401	3358437	0	37	0	2092	0	2055	0.0	0.0
chr18	DLGAP1	3874147	3874152	0	6	153	12099	153	12093	0.0	0.012651947407591168
chr18	EPB41L3	5406764	5406775	0	12	510	9610	510	9598	0.0	0.053136070014586374
chr18	EPB41L3	5488861	5488999	0	139	510	9610	510	9471	0.0	0.05384859043395629
chr18	LINC00668	6929738	6929781	0	44	0	3701	0	3657	0.0	0.0
chr18	PPP4R1	9615018	9615182	1173	165	1112560	7841	1111387	7676	7.109090909090909	144.7872589890568
chr18	LINC01887	10616832	10616833	0	2	0	861	0	859	0.0	0.0
chr18	PIEZO2	10680198	10680273	0	76	0	15683	0	15607	0.0	0.0
chr18	NPIPB1P	11629641	11629644	0	4	10197	1141	10197	1137	0.0	8.968337730870713
chr18	MPPE1	11905737	11905910	7623	174	457280	5862	449657	5688	43.810344827586206	79.05362165963432
chr18	SPIRE1	12656574	12656649	51	76	1136960	6556	1136909	6480	0.6710526315789473	175.44891975308641
chr18	CEP76	12697222	12697227	267	6	230834	5989	230567	5983	44.5	38.53702156108975
chr18	AP005901.1	15325556	15325659	0	104	459	1803	459	1699	0.0	0.2701589170100059
chr18	ABHD3	21663677	21664116	51	440	3741	4348	3690	3908	0.1159090909090909	0.9442169907881269
chr18	MIR133A1HG	21831175	21831320	0	146	0	4362	0	4216	0.0	0.0
chr18	GATA6-AS1	22168043	22168084	0	42	0	2648	0	2606	0.0	0.0
chr18	ANKRD29	23629852	23629855	0	4	31625	6292	31625	6288	0.0	5.029421119592875
chr18	OSBPL1A	24368286	24368365	0	80	18637	7984	18637	7904	0.0	2.35792004048583
chr18	OSBPL1A	24397572	24397653	0	82	18637	7984	18637	7902	0.0	2.358516831181979
chr18	SS18	26091003	26091094	0	92	51	6099	51	6007	0.0	0.008490094889295821
chr18	SS18	26089757	26089823	0	67	51	6099	51	6032	0.0	0.008454907161803714
chr18	DSG2-AS1	31555962	31556575	0	614	0	2000	0	1386	0.0	0.0
chr18	TRAPPC8	31942607	31942950	0	344	58	7830	58	7486	0.0	0.007747795885653219
chr18	ZSCAN30	35290083	35290129	0	47	51	5878	51	5831	0.0	0.008746355685131196
chr18	ZNF24	35344359	35344368	0	10	0	8250	0	8240	0.0	0.0
chr18	INO80C	35480452	35480454	0	3	0	5014	0	5011	0.0	0.0
chr18	SLC39A6	36129100	36129112	0	13	0	3680	0	3667	0.0	0.0
chr18	CELF4	37266532	37266534	0	3	765	4935	765	4932	0.0	0.1551094890510949
chr18	CELF4	37274310	37274312	0	3	765	4935	765	4932	0.0	0.1551094890510949
chr18	CELF4	37321802	37321831	0	30	765	4935	765	4905	0.0	0.1559633027522936
chr18	CELF4	37321802	37321828	0	27	765	4935	765	4908	0.0	0.1558679706601467
chr18	CELF4	37259120	37259179	0	60	765	4935	765	4875	0.0	0.15692307692307692
chr18	CELF4	37321829	37321831	0	3	765	4935	765	4932	0.0	0.1551094890510949
chr18	AC100781.1	38660737	38660738	0	2	0	882	0	880	0.0	0.0
chr18	MIR924HG	39233108	39233401	0	294	51	11691	51	11397	0.0	0.004474861805738352
chr18	MIR924HG	39751830	39751903	0	74	51	11691	51	11617	0.0	0.00439011793061892
chr18	MIR924HG	39340490	39340584	0	95	51	11691	51	11596	0.0	0.004398068299413591
chr18	SYT4	43277247	43277341	0	95	40	2529	40	2434	0.0	0.016433853738701727
chr18	AC090376.1	45181000	45181149	0	150	72	3400	72	3250	0.0	0.022153846153846152
chr18	AC090376.1	45169387	45169430	0	44	72	3400	72	3356	0.0	0.021454112038140644
chr18	ATP5F1A	46089822	46089887	0	66	3591	7373	3591	7307	0.0	0.4914465580949774
chr18	ATP5F1A	46097835	46098170	0	336	3591	7373	3591	7037	0.0	0.5103026858036095
chr18	ATP5F1A	46094979	46095051	0	73	3591	7373	3591	7300	0.0	0.4919178082191781
chr18	LOXHD1	46477639	46477652	2569	14	156997	8983	154428	8969	183.5	17.21797301817371
chr18	LOXHD1	46520297	46520575	0	279	156997	8983	156997	8704	0.0	18.037339154411764
chr18	LOXHD1	46559073	46559168	0	96	156997	8983	156997	8887	0.0	17.66591650725779
chr18	HDHD2	47136301	47136337	0	37	51	4612	51	4575	0.0	0.011147540983606558
chr18	SMAD2	47930251	47930359	0	109	872064	36439	872064	36330	0.0	24.003963666391414
chr18	SMAD2	47930795	47930798	0	4	872064	36439	872064	36435	0.0	23.934787978592013
chr18	ZBTB7C	48165126	48165129	0	4	282	7629	282	7625	0.0	0.03698360655737705
chr18	ZBTB7C	48180329	48180385	0	57	282	7629	282	7572	0.0	0.03724247226624406
chr18	DYM	49368601	49368670	0	70	51	12141	51	12071	0.0	0.004225002071079446
chr18	DYM	49368601	49368616	0	16	51	12141	51	12125	0.0	0.00420618556701031
chr18	DYM	49368617	49368670	0	54	51	12141	51	12087	0.0	0.004219409282700422
chr18	RPL17	49491735	49491744	0	10	102	2096	102	2086	0.0	0.0488974113135187
chr18	RPL17	49492257	49492273	0	17	102	2096	102	2079	0.0	0.049062049062049064
chr18	RPL17	49491531	49491624	0	94	102	2096	102	2002	0.0	0.05094905094905095
chr18	RPL17	49492130	49492256	0	127	102	2096	102	1969	0.0	0.05180294565769426
chr18	RPL17	49492130	49492273	0	144	102	2096	102	1952	0.0	0.05225409836065574
chr18	ACAA2	49813731	49813815	0	85	0	4883	0	4798	0.0	0.0
chr18	ACAA2	49813681	49813815	0	135	0	4883	0	4748	0.0	0.0
chr18	ACAA2	49813681	49813730	0	50	0	4883	0	4833	0.0	0.0
chr18	MBD1	50272823	50272846	0	24	0	5812	0	5788	0.0	0.0
chr18	MBD1	50281362	50281573	0	212	0	5812	0	5600	0.0	0.0
chr18	CXXC1	50284719	50284730	0	12	153	3854	153	3842	0.0	0.03982300884955752
chr18	TCF4	55232508	55232519	0	12	105042	22459	105042	22447	0.0	4.67955628814541
chr18	TCF4	55588037	55588447	0	411	105042	22459	105042	22048	0.0	4.764241654571843
chr18	TCF4	55588037	55588468	0	432	105042	22459	105042	22027	0.0	4.768783765378854
chr18	TCF4	55586920	55587043	0	124	105042	22459	105042	22335	0.0	4.703022162525185
chr18	TCF4	55588448	55588468	0	21	105042	22459	105042	22438	0.0	4.6814332828237815
chr18	TCF4	55585810	55585877	0	68	105042	22459	105042	22391	0.0	4.691259881202269
chr18	TCF4	55585810	55585971	0	162	105042	22459	105042	22297	0.0	4.711037359286003
chr18	TCF4	55401579	55401687	0	109	105042	22459	105042	22350	0.0	4.699865771812081
chr18	TCF4	55422179	55422190	0	12	105042	22459	105042	22447	0.0	4.67955628814541
chr18	TCF4	55422175	55422178	0	4	105042	22459	105042	22455	0.0	4.677889111556446
chr18	TCF4	55422175	55422190	0	16	105042	22459	105042	22443	0.0	4.680390322149445
chr18	TCF4	55401000	55401498	2856	499	105042	22459	102186	21960	5.7234468937875755	4.6532786885245905
chr18	TCF4	55585723	55585809	0	87	105042	22459	105042	22372	0.0	4.695244055068836
chr18	TCF4	55422153	55422178	42	26	105042	22459	105000	22433	1.6153846153846154	4.680604466633977
chr18	TCF4	55422153	55422174	42	22	105042	22459	105000	22437	1.9090909090909092	4.679770022730311
chr18	TCF4	55422153	55422190	42	38	105042	22459	105000	22421	1.105263157894737	4.683109584764283
chr18	LINC01415	55780122	55780147	0	26	2601	4412	2601	4386	0.0	0.5930232558139535
chr18	LINC01539	56095829	56096005	0	177	0	4888	0	4711	0.0	0.0
chr18	LINC01539	56085198	56085203	0	6	0	4888	0	4882	0.0	0.0
chr18	LINC-ROR	57058886	57059201	0	316	305	3868	305	3552	0.0	0.08586711711711711
chr18	FECH	57580054	57580071	0	18	4164	8798	4164	8780	0.0	0.47425968109339406
chr18	NARS1	57621707	57621737	0	31	0	3990	0	3959	0.0	0.0
chr18	LINC01897	57961501	57961504	0	4	0	409	0	405	0.0	0.0
chr18	AC107896.1	58195519	58195597	0	79	0	571	0	492	0.0	0.0
chr18	AC105094.2	61748039	61748073	0	35	0	1162	0	1127	0.0	0.0
chr18	PIGN	62186843	62187021	0	179	0	17779	0	17600	0.0	0.0
chr18	PIGN	62088390	62088754	0	365	0	17779	0	17414	0.0	0.0
chr18	BCL2	63317529	63318080	0	552	51	8671	51	8119	0.0	0.006281561768690725
chr18	KDSR	63355203	63355217	0	15	0	8861	0	8846	0.0	0.0
chr18	FBXO15	74147540	74147668	0	129	5619	6149	5619	6020	0.0	0.9333887043189368
chr18	FBXO15	74147493	74147539	0	47	5619	6149	5619	6102	0.0	0.9208456243854474
chr18	LINC00909	74596427	74597734	0	1308	9479	4420	9479	3112	0.0	3.045951156812339
chr18	LINC00909	74596427	74597256	0	830	9479	4420	9479	3590	0.0	2.6403899721448467
chr18	LINC01927	76638207	76638547	0	341	0	1701	0	1360	0.0	0.0
chr18	LINC01927	76638207	76638783	0	577	0	1701	0	1124	0.0	0.0
chr18	MBP	77016831	77016912	0	82	51	6992	51	6910	0.0	0.007380607814761216
chr18	MBP	76988299	76988493	0	195	51	6992	51	6797	0.0	0.007503310283948801
chr18	LINC01029	77993634	77993695	26	62	204	4456	178	4394	0.41935483870967744	0.04050978607191625
chr18	LINC01896	78978462	78978784	0	323	0	1736	0	1413	0.0	0.0
chr19	LINC01002	203870	203945	2935	76	104844	7755	101909	7679	38.61842105263158	13.271129053262143
chr19	LINC01002	203870	203873	8	4	104844	7755	104836	7751	2.0	13.52548058315056
chr19	LINC01002	209224	209234	0	11	104844	7755	104844	7744	0.0	13.538739669421487
chr19	LINC01002	203874	203945	2927	72	104844	7755	101917	7683	40.65277777777778	13.26526096576858
chr19	LINC01002	204833	204842	0	10	104844	7755	104844	7745	0.0	13.536991607488702
chr19	LINC01002	204817	204832	0	16	104844	7755	104844	7739	0.0	13.547486755394754
chr19	LINC01002	204817	204842	0	26	104844	7755	104844	7729	0.0	13.565014879027041
chr19	LINC01002	223937	223965	344	29	104844	7755	104500	7726	11.862068965517242	13.525757183536111
chr19	PLPP2	291284	291324	8347	41	626713	2033	618366	1992	203.58536585365854	310.42469879518075
chr19	PLPP2	291284	291287	608	4	626713	2033	626105	2029	152.0	308.57811729916216
chr19	PLPP2	291288	291324	7739	37	626713	2033	618974	1996	209.16216216216216	310.10721442885773
chr19	MIER2	308800	308820	1171	21	249456	7934	248285	7913	55.76190476190476	31.376848224440792
chr19	POLRMT	633197	633423	1632	227	397558	4590	395926	4363	7.18942731277533	90.7462754985102
chr19	RNF126	651610	651690	999	81	256371	3235	255372	3154	12.333333333333334	80.96766011414077
chr19	MED16	868410	868414	499	5	326503	3907	326004	3902	99.8	83.54792414146591
chr19	R3HDM4	901419	901420	0	2	365294	2427	365294	2425	0.0	150.63670103092784
chr19	POLR2E	1089471	1089488	12842	18	558582	2591	545740	2573	713.4444444444445	212.10260396424408
chr19	GAMT	1401295	1401363	6654	69	132299	1551	125645	1482	96.43478260869566	84.78070175438596
chr19	C19ORF25	1478653	1478772	301	120	156108	4190	155807	4070	2.5083333333333333	38.28181818181818
chr19	C19ORF25	1479139	1479161	170	23	156108	4190	155938	4167	7.391304347826087	37.42212622990161
chr19	C19ORF25	1479113	1479161	643	49	156108	4190	155465	4141	13.122448979591837	37.54286404250181
chr19	C19ORF25	1479113	1479138	473	26	156108	4190	155635	4164	18.192307692307693	37.37632084534102
chr19	PCSK4	1482352	1482400	968	49	72689	3654	71721	3605	19.755102040816325	19.89486823855756
chr19	ADAMTSL5	1511035	1511074	0	40	9840	2885	9840	2845	0.0	3.4586994727592266
chr19	ADAMTSL5	1507544	1507555	0	12	9840	2885	9840	2873	0.0	3.424991298294466
chr19	MBD3	1592521	1592616	49	96	522318	7530	522269	7434	0.5104166666666666	70.25410277105192
chr19	MBD3	1591984	1592275	8197	292	522318	7530	514121	7238	28.07191780821918	71.030809615916
chr19	TCF3	1631950	1632036	944	87	1279548	5864	1278604	5777	10.850574712643677	221.32664012463215
chr19	ATP8B3	1811488	1811599	11125	112	319716	7043	308591	6931	99.33035714285714	44.523301110950804
chr19	ATP8B3	1791970	1791999	0	30	319716	7043	319716	7013	0.0	45.58904890916869
chr19	ATP8B3	1812067	1812184	52	118	319716	7043	319664	6925	0.4406779661016949	46.16086642599278
chr19	ABHD17A	1881234	1881260	2603	27	286407	4179	283804	4152	96.4074074074074	68.35356454720616
chr19	BTBD2	1990003	1990090	49817	88	1010412	5031	960595	4943	566.1022727272727	194.33441230022254
chr19	MKNK2	2051095	2051216	101	122	410991	5232	410890	5110	0.8278688524590164	80.40900195694717
chr19	MKNK2	2046521	2046602	135	82	410991	5232	410856	5150	1.646341463414634	79.7778640776699
chr19	PLEKHJ1	2236154	2236376	35265	223	439258	3179	403993	2956	158.1390134529148	136.66880920162382
chr19	TIMM13	2427413	2427457	39325	45	262546	1622	223221	1577	873.8888888888889	141.54787571337982
chr19	SGTA	2782569	2783231	9129	663	1100870	7950	1091741	7287	13.76923076923077	149.82036503362153
chr19	SGTA	2768964	2768967	130	4	1100870	7950	1100740	7946	32.5	138.52756103699974
chr19	SGTA	2757564	2757691	503	128	1100870	7950	1100367	7822	3.9296875	140.67591408846843
chr19	TLE2	3006419	3006475	932	57	87042	4108	86110	4051	16.350877192982455	21.25647988151074
chr19	AC010649.1	3302793	3302794	0	2	561	530	561	528	0.0	1.0625
chr19	AC010649.1	3302789	3302792	0	4	561	530	561	526	0.0	1.0665399239543727
chr19	AC010649.1	3302789	3302794	0	6	561	530	561	524	0.0	1.0706106870229009
chr19	DOHH	3500532	3500559	36	28	56286	2126	56250	2098	1.2857142857142858	26.811248808388942
chr19	MFSD12	3557105	3557131	8867	27	832398	4683	823531	4656	328.4074074074074	176.8752147766323
chr19	TBXA2R	3599848	3600236	18608	389	128174	2455	109566	2066	47.83547557840617	53.032913843175216
chr19	CACTIN	3614385	3614395	445	11	268594	5168	268149	5157	40.45454545454545	51.997091332169866
chr19	PIP5K1C	3664821	3664855	3579	35	551178	6975	547599	6940	102.25714285714285	78.90475504322767
chr19	DAPK3	3970920	3971020	555	101	677963	3559	677408	3458	5.4950495049504955	195.89589358010412
chr19	TMIGD2	4294566	4294577	0	12	51	1267	51	1255	0.0	0.04063745019920319
chr19	DPP9	4715528	4715663	7467	136	1325046	6781	1317579	6645	54.904411764705884	198.28126410835213
chr19	DPP9	4715664	4716051	14178	388	1325046	6781	1310868	6393	36.54123711340206	205.04739558892538
chr19	PLIN3	4847690	4847815	105579	126	1133862	1780	1028283	1654	837.9285714285714	621.6946795646917
chr19	PLIN3	4866632	4866878	2499	247	1133862	1780	1131363	1533	10.117408906882591	738.0058708414873
chr19	SAFB2	5616127	5616130	0	4	657904	5607	657904	5603	0.0	117.4199535962877
chr19	LONP1	5711770	5711817	18712	48	1864515	5053	1845803	5005	389.8333333333333	368.7918081918082
chr19	DUS3L	5790818	5790884	464	67	284136	2948	283672	2881	6.925373134328358	98.46303366886498
chr19	FUT6	5834839	5834948	0	110	0	2530	0	2420	0.0	0.0
chr19	RANBP3	5931403	5931417	822	15	669290	7119	668468	7104	54.8	94.09740990990991
chr19	RANBP3	5957906	5957916	0	11	669290	7119	669290	7108	0.0	94.16010129431626
chr19	RFX2	6199475	6199478	128	4	75763	7521	75635	7517	32.0	10.061859784488492
chr19	KHSRP	6415533	6415607	15797	75	2676589	4006	2660792	3931	210.62666666666667	676.8740778427881
chr19	KHSRP	6424137	6424215	418	79	2676589	4006	2676171	3927	5.291139240506329	681.4797555385791
chr19	DENND1C	6481649	6481677	0	29	1708	4369	1708	4340	0.0	0.3935483870967742
chr19	TUBB4A	6500927	6501285	204	359	37197	1824	36993	1465	0.5682451253481894	25.25119453924915
chr19	TUBB4A	6502155	6502187	172	33	37197	1824	37025	1791	5.212121212121212	20.67280848687884
chr19	TNFSF14	6669850	6669957	955	108	105948	4677	104993	4569	8.842592592592593	22.979426570365508
chr19	GPR108	6735539	6735620	1308	82	411943	2886	410635	2804	15.951219512195122	146.44614835948644
chr19	GPR108	6732471	6732474	0	4	411943	2886	411943	2882	0.0	142.93650242886883
chr19	FCER2	7702014	7702017	41	4	55761	2333	55720	2329	10.25	23.924431086303134
chr19	CLEC4G	7732047	7732087	0	41	71	1553	71	1512	0.0	0.046957671957671955
chr19	CD209	7745517	7745999	1520	483	163105	4420	161585	3937	3.1469979296066253	41.04267208534417
chr19	CD209	7745517	7745654	0	138	163105	4420	163105	4282	0.0	38.0908453993461
chr19	CD209	7745517	7745792	47	276	163105	4420	163058	4144	0.17028985507246377	39.347972972972975
chr19	CD209	7745655	7745999	1520	345	163105	4420	161585	4075	4.405797101449275	39.65276073619632
chr19	CD209	7745655	7745792	47	138	163105	4420	163058	4282	0.34057971014492755	38.079869219990655
chr19	CD209	7747305	7747464	81228	160	163105	4420	81877	4260	507.675	19.21995305164319
chr19	CD209	7745793	7745999	1473	207	163105	4420	161632	4213	7.115942028985507	38.365060526940425
chr19	RAB11B-AS1	8376904	8376960	448	57	1366	1160	918	1103	7.859649122807017	0.8322756119673618
chr19	ZNF414	8511475	8511484	0	10	33583	2689	33583	2679	0.0	12.53564762971258
chr19	MYO1F	8541905	8541911	91	7	636432	6070	636341	6063	13.0	104.95480785089889
chr19	MYO1F	8555636	8555657	0	22	636432	6070	636432	6048	0.0	105.23015873015873
chr19	ADAMTS10	8595761	8595771	0	11	19837	5729	19837	5718	0.0	3.469220006995453
chr19	MUC16	8858585	8858598	0	14	30241	43914	30241	43900	0.0	0.6888610478359909
chr19	ZNF266	9418761	9419215	0	455	11502	4513	11502	4058	0.0	2.834401182848694
chr19	ZNF266	9418761	9418764	0	4	11502	4513	11502	4509	0.0	2.5508982035928143
chr19	ZNF266	9418761	9419049	0	289	11502	4513	11502	4224	0.0	2.7230113636363638
chr19	ZNF266	9419050	9419215	0	166	11502	4513	11502	4347	0.0	2.6459627329192545
chr19	ZNF561	9617044	9617047	0	4	245	5565	245	5561	0.0	0.04405682431217407
chr19	ZNF561	9620915	9621160	0	246	245	5565	245	5319	0.0	0.04606128971611205
chr19	ZNF562	9674631	9675013	38651	383	44416	2122	5765	1739	100.91644908616188	3.3151236342725703
chr19	ZNF846	9785925	9785936	0	12	77122	3924	77122	3912	0.0	19.714212678936605
chr19	FBXL12	9818544	9818726	0	183	51	2784	51	2601	0.0	0.0196078431372549
chr19	FBXL12	9818727	9818752	0	26	51	2784	51	2758	0.0	0.01849166062364032
chr19	FBXL12	9818727	9818830	0	104	51	2784	51	2680	0.0	0.019029850746268655
chr19	FBXL12	9818753	9818830	0	78	51	2784	51	2706	0.0	0.018847006651884702
chr19	OLFM2	9857262	9857385	0	124	2253	2508	2253	2384	0.0	0.9450503355704698
chr19	ANGPTL6	10093692	10093811	0	120	0	2187	0	2067	0.0	0.0
chr19	ANGPTL6	10102551	10102566	0	16	0	2187	0	2171	0.0	0.0
chr19	EIF3G	10116799	10116822	0	24	40	3387	40	3363	0.0	0.011894142134998514
chr19	EIF3G	10118861	10118866	0	6	40	3387	40	3381	0.0	0.011830819284235433
chr19	EIF3G	10119066	10119086	0	21	40	3387	40	3366	0.0	0.011883541295306001
chr19	DNMT1	10142027	10142078	0	52	29804	13688	29804	13636	0.0	2.1856849515987093
chr19	DNMT1	10166591	10166596	0	6	29804	13688	29804	13682	0.0	2.1783365005116213
chr19	DNMT1	10137075	10137083	0	9	29804	13688	29804	13679	0.0	2.1788142408070765
chr19	DNMT1	10135438	10135734	0	297	29804	13688	29804	13391	0.0	2.2256739601224704
chr19	FDX2	10315851	10315968	0	118	119	813	119	695	0.0	0.1712230215827338
chr19	ICAM3	10334159	10334227	396	69	11984	2076	11588	2007	5.739130434782608	5.773791728948679
chr19	ICAM3	10335065	10335139	2951	75	11984	2076	9033	2001	39.346666666666664	4.51424287856072
chr19	CDC37	10393258	10393278	42	21	767713	3052	767671	3031	2.0	253.27317716925108
chr19	KEAP1	10502387	10502407	7	21	1410	3562	1403	3541	0.3333333333333333	0.3962157582603784
chr19	S1PR5	10517040	10517396	665	357	80042	2225	79377	1868	1.8627450980392157	42.49304068522484
chr19	AP1M2	10587154	10587188	0	35	71883	2145	71883	2110	0.0	34.06777251184834
chr19	TMED1	10835255	10835289	0	35	3341	1889	3341	1854	0.0	1.8020496224379718
chr19	TMED1	10834818	10834932	28	115	3341	1889	3313	1774	0.24347826086956523	1.8675310033821872
chr19	YIPF2	10928510	10928583	0	74	96909	2417	96909	2343	0.0	41.361075544174135
chr19	KANK2	11195555	11195620	0	66	19075	7137	19075	7071	0.0	2.6976382407014565
chr19	TMEM205	11346126	11346206	0	81	18687	1389	18687	1308	0.0	14.286697247706423
chr19	TMEM205	11346126	11346141	0	16	18687	1389	18687	1373	0.0	13.61034231609614
chr19	TMEM205	11346007	11346125	0	119	18687	1389	18687	1270	0.0	14.714173228346457
chr19	TMEM205	11346007	11346206	0	200	18687	1389	18687	1189	0.0	15.716568544995795
chr19	TMEM205	11346007	11346141	0	135	18687	1389	18687	1254	0.0	14.901913875598087
chr19	TMEM205	11345519	11346125	51	607	18687	1389	18636	782	0.08401976935749589	23.831202046035806
chr19	TMEM205	11345519	11346206	51	688	18687	1389	18636	701	0.07412790697674419	26.5848787446505
chr19	TMEM205	11346142	11346206	0	65	18687	1389	18687	1324	0.0	14.11404833836858
chr19	RGL3	11415936	11415945	0	10	165	3935	165	3925	0.0	0.04203821656050955
chr19	ZNF653	11484041	11484078	0	38	9765	3095	9765	3057	0.0	3.1943081452404316
chr19	ECSIT	11507701	11507989	441	289	2186	2365	1745	2076	1.5259515570934257	0.8405587668593449
chr19	ELOF1	11555344	11555520	298	177	1580769	4090	1580471	3913	1.6836158192090396	403.90263225146947
chr19	ACP5	11578479	11578583	0	105	450	2095	450	1990	0.0	0.22613065326633167
chr19	ACP5	11578023	11578074	0	52	450	2095	450	2043	0.0	0.22026431718061673
chr19	ZNF433	12035536	12035545	0	10	13605	3086	13605	3076	0.0	4.42295188556567
chr19	ZNF625	12147675	12147678	4	4	9047	2215	9043	2211	1.0	4.090004522840344
chr19	ZNF443	12432286	12432375	0	90	16806	2667	16806	2577	0.0	6.521536670547148
chr19	DHPS	12680160	12680200	170	41	2510	2991	2340	2950	4.146341463414634	0.7932203389830509
chr19	DHPS	12680160	12680194	140	35	2510	2991	2370	2956	4.0	0.8017591339648173
chr19	DHPS	12680195	12680200	30	6	2510	2991	2480	2985	5.0	0.830820770519263
chr19	DHPS	12680149	12680200	170	52	2510	2991	2340	2939	3.269230769230769	0.7961891799931949
chr19	DHPS	12680149	12680159	0	11	2510	2991	2510	2980	0.0	0.8422818791946308
chr19	DHPS	12680149	12680194	140	46	2510	2991	2370	2945	3.0434782608695654	0.8047538200339559
chr19	TRIR	12734312	12734334	0	23	4359	1314	4359	1291	0.0	3.3764523625096823
chr19	HOOK2	12774634	12774667	4016	34	352780	5239	348764	5205	118.11764705882354	67.00557156580211
chr19	HOOK2	12778299	12778343	0	45	352780	5239	352780	5194	0.0	67.92067770504428
chr19	HOOK2	12774560	12774633	22253	74	352780	5239	330527	5165	300.7162162162162	63.99361084220716
chr19	HOOK2	12774560	12774667	26269	108	352780	5239	326511	5131	243.2314814814815	63.63496394465017
chr19	SYCE2	12899957	12900002	0	46	72395	1482	72395	1436	0.0	50.41434540389972
chr19	FARSA	12928534	12928571	2	38	95842	2378	95840	2340	0.05263157894736842	40.957264957264954
chr19	TRMT1	13112895	13112907	0	13	422	3150	422	3137	0.0	0.13452343002868983
chr19	TRMT1	13116145	13116185	0	41	422	3150	422	3109	0.0	0.13573496301061436
chr19	TRMT1	13116145	13116170	0	26	422	3150	422	3124	0.0	0.1350832266325224
chr19	TRMT1	13116105	13116144	0	40	422	3150	422	3110	0.0	0.13569131832797426
chr19	TRMT1	13116171	13116185	0	15	422	3150	422	3135	0.0	0.1346092503987241
chr19	STX10	13144763	13144766	0	4	1632	1305	1632	1301	0.0	1.2544196771714067
chr19	CACNA1A	13303536	13303544	0	9	1097868	33625	1097868	33616	0.0	32.65909090909091
chr19	C19ORF57	13905714	13906057	0	344	209813	3853	209813	3509	0.0	59.79281846679966
chr19	PODNL1	13934242	13934252	1756	11	63023	3221	61267	3210	159.63636363636363	19.086292834890966
chr19	C19ORF67	14085292	14085722	0	431	6163	1541	6163	1110	0.0	5.552252252252252
chr19	DDX39A	14410420	14410546	0	127	1145	3413	1145	3286	0.0	0.3484479610468655
chr19	DNAJB1	14527686	14527724	589	39	141620	7011	141031	6972	15.102564102564102	20.22819850831899
chr19	DNAJB1	14529209	14529220	130	12	141620	7011	141490	6999	10.833333333333334	20.215745106443777
chr19	DNAJB1	14529209	14529309	1717	101	141620	7011	139903	6910	17.0	20.24645441389291
chr19	DNAJB1	14527357	14527724	32598	368	141620	7011	109022	6643	88.58152173913044	16.41156104169803
chr19	DNAJB1	14527357	14527685	32009	329	141620	7011	109611	6682	97.2917933130699	16.403920981741994
chr19	SLC1A6	14979308	14979511	0	204	0	7643	0	7439	0.0	0.0
chr19	ILVBL	15125655	15125660	0	6	0	4314	0	4308	0.0	0.0
chr19	ILVBL	15124924	15125068	0	145	0	4314	0	4169	0.0	0.0
chr19	ILVBL	15125379	15125654	0	276	0	4314	0	4038	0.0	0.0
chr19	AKAP8L	15403474	15403656	102	183	3971	4512	3869	4329	0.5573770491803278	0.8937398937398937
chr19	AKAP8L	15403652	15403656	0	5	3971	4512	3971	4507	0.0	0.8810738850676725
chr19	AKAP8L	15418910	15419057	90	148	3971	4512	3881	4364	0.6081081081081081	0.8893217231897342
chr19	ZNF861P	15823673	15823678	0	6	0	703	0	697	0.0	0.0
chr19	LINC01764	15835526	15835634	0	109	0	2347	0	2238	0.0	0.0
chr19	EPS15L1	16361778	16361884	45	107	59138	8149	59093	8042	0.4205607476635514	7.34804774931609
chr19	EPS15L1	16440861	16440883	0	23	59138	8149	59138	8126	0.0	7.277627368939208
chr19	EPS15L1	16402314	16402319	0	6	59138	8149	59138	8143	0.0	7.262433992386098
chr19	SMIM7	16647095	16647118	0	24	242901	4512	242901	4488	0.0	54.12232620320856
chr19	CPAMD8	16975086	16975095	0	10	69925	7832	69925	7822	0.0	8.93952953208898
chr19	USHBP1	17264560	17264669	0	110	17973	5041	17973	4931	0.0	3.64489961468262
chr19	IQCN	18264362	18264922	0	561	91375	7022	91375	6461	0.0	14.142547593251818
chr19	ISYNA1	18435247	18435264	0	18	0	3012	0	2994	0.0	0.0
chr19	ISYNA1	18437598	18437858	0	261	0	3012	0	2751	0.0	0.0
chr19	FKBP8	18543481	18543484	4	4	75043	2467	75039	2463	1.0	30.46650426309379
chr19	FKBP8	18543424	18543480	7	57	75043	2467	75036	2410	0.12280701754385964	31.135269709543568
chr19	CRLF1	18596621	18596662	496	42	46148	2979	45652	2937	11.80952380952381	15.54375212802179
chr19	HOMER3	18941050	18941191	0	142	153	3433	153	3291	0.0	0.04649042844120328
chr19	SUGP2	18993637	18993646	10	10	278945	6566	278935	6556	1.0	42.54652226967663
chr19	SUGP2	19033436	19033487	39823	52	278945	6566	239122	6514	765.8269230769231	36.70893460239484
chr19	TMEM161A	19121307	19121316	0	10	230239	3291	230239	3281	0.0	70.17342273697044
chr19	TMEM161A	19138425	19138455	0	31	230239	3291	230239	3260	0.0	70.62546012269938
chr19	MEF2B	19149216	19149224	0	9	4822	2099	4822	2090	0.0	2.307177033492823
chr19	BORCS8	19192080	19192528	0	449	1944	5232	1944	4783	0.0	0.4064394731340163
chr19	SUGP1	19316246	19316420	0	175	43067	4861	43067	4686	0.0	9.190567648314127
chr19	TSSK6	19514144	19514153	0	10	611	1531	611	1521	0.0	0.4017094017094017
chr19	PBX4	19570098	19570107	0	10	14352	2054	14352	2044	0.0	7.021526418786693
chr19	PBX4	19570585	19570685	0	101	14352	2054	14352	1953	0.0	7.3486943164362515
chr19	GMIP	19642534	19642535	0	2	72535	3751	72535	3749	0.0	19.347826086956523
chr19	LINC00663	19776322	19776325	0	4	167324	1894	167324	1890	0.0	88.53121693121693
chr19	LINC00663	19761256	19761324	881	69	167324	1894	166443	1825	12.768115942028986	91.20164383561644
chr19	LINC00663	19761203	19761324	1399	122	167324	1894	165925	1772	11.467213114754099	93.63713318284424
chr19	LINC00663	19761203	19761255	518	53	167324	1894	166806	1841	9.773584905660377	90.60619228680065
chr19	ZNF43	21845391	21845428	0	38	1091	8432	1091	8394	0.0	0.1299737908029545
chr19	AC003973.1	22026235	22026308	7565	74	100872	5670	93307	5596	102.22972972972973	16.673874195854182
chr19	AC003973.1	22034672	22035096	4289	425	100872	5670	96583	5245	10.091764705882353	18.41429933269781
chr19	ZNF98	22422194	22422245	0	52	102	3299	102	3247	0.0	0.031413612565445025
chr19	LINC01859	23017717	23017729	0	13	102	3966	102	3953	0.0	0.02580318745256767
chr19	LINC01859	23023345	23023518	0	174	102	3966	102	3792	0.0	0.02689873417721519
chr19	LINC01224	23415893	23415902	0	10	48072	3998	48072	3988	0.0	12.054162487462387
chr19	LINC01224	23402176	23403204	28210	1029	48072	3998	19862	2969	27.41496598639456	6.68979454361738
chr19	ERVK-28	27640377	27640433	0	57	0	598	0	541	0.0	0.0
chr19	LINC00662	27684694	27685055	0	362	255	28747	255	28385	0.0	0.008983618108155716
chr19	LINC00662	27746080	27746096	0	17	255	28747	255	28730	0.0	0.008875739644970414
chr19	LINC00662	27746020	27746096	0	77	255	28747	255	28670	0.0	0.0088943146145797
chr19	LINC00662	27746020	27746079	0	60	255	28747	255	28687	0.0	0.008889043817757172
chr19	LINC00662	27771543	27771662	0	120	255	28747	255	28627	0.0	0.008907674572955602
chr19	AC005394.2	28437484	28437580	0	97	0	3123	0	3026	0.0	0.0
chr19	AC005394.2	28726293	28726297	0	5	0	3123	0	3118	0.0	0.0
chr19	LINC01837	32010423	32010520	0	98	1692	7200	1692	7102	0.0	0.23824274852154323
chr19	LINC01837	31967320	31967554	0	235	1692	7200	1692	6965	0.0	0.2429289303661163
chr19	LINC01837	31980108	31980154	0	47	1692	7200	1692	7153	0.0	0.2365441073675381
chr19	SLC7A9	32869676	32869684	0	9	3219	2601	3219	2592	0.0	1.2418981481481481
chr19	AC008555.4	34860448	34860532	0	85	2601	1105	2601	1020	0.0	2.55
chr19	LINC00904	34898837	34898852	0	16	205839	3576	205839	3560	0.0	57.81994382022472
chr19	LINC00904	34904150	34904657	5313	508	205839	3576	200526	3068	10.458661417322835	65.36049543676663
chr19	LINC00904	34904960	34905041	0	82	205839	3576	205839	3494	0.0	58.912135088723524
chr19	LINC00904	34904658	34904959	24118	302	205839	3576	181721	3274	79.86092715231788	55.504276114844224
chr19	LGI4	35131788	35131789	0	2	4633	4379	4633	4377	0.0	1.0584875485492347
chr19	DMKN	35498597	35498714	1224	118	193822	4934	192598	4816	10.372881355932204	39.991279069767444
chr19	DMKN	35510370	35510377	1195	8	193822	4934	192627	4926	149.375	39.104141291108405
chr19	DMKN	35501800	35501821	0	22	193822	4934	193822	4912	0.0	39.45887622149837
chr19	DMKN	35510378	35510481	30629	104	193822	4934	163193	4830	294.50961538461536	33.78737060041408
chr19	DMKN	35500377	35500531	0	155	193822	4934	193822	4779	0.0	40.55702029713329
chr19	SBSN	35526643	35527905	4298	1263	8660	962	4362	-301	3.403008709422011	-14.491694352159469
chr19	TMEM147-AS1	35544111	35545317	0	1207	204	3084	204	1877	0.0	0.10868407032498668
chr19	IGFLR1	35742389	35742394	0	6	6404	1961	6404	1955	0.0	3.275703324808184
chr19	U2AF1L4	35744011	35744068	50	58	102	2606	52	2548	0.8620689655172413	0.02040816326530612
chr19	LINC01529	35790017	35790046	0	30	12	4162	12	4132	0.0	0.002904162633107454
chr19	LINC01529	35792287	35792386	0	100	12	4162	12	4062	0.0	0.0029542097488921715
chr19	NPHS1	35845367	35845397	0	31	102	6717	102	6686	0.0	0.01525575830092731
chr19	TYROBP	35908167	35908173	0	7	0	910	0	903	0.0	0.0
chr19	SYNE4	36006422	36006600	9	179	1088	2554	1079	2375	0.05027932960893855	0.45431578947368423
chr19	ALKBH6	36013309	36013342	0	34	408	2256	408	2222	0.0	0.18361836183618363
chr19	ALKBH6	36013309	36013326	0	18	408	2256	408	2238	0.0	0.18230563002680966
chr19	ALKBH6	36013513	36014173	0	661	408	2256	408	1595	0.0	0.25579937304075234
chr19	ALKBH6	36013327	36013342	0	16	408	2256	408	2240	0.0	0.18214285714285713
chr19	THAP8	36054134	36054147	0	14	83618	1807	83618	1793	0.0	46.63580591187953
chr19	THAP8	36054148	36054347	0	200	83618	1807	83618	1607	0.0	52.03360298693217
chr19	POLR2I	36114797	36114818	1254	22	58282	1141	57028	1119	57.0	50.96336014298481
chr19	POLR2I	36114150	36114175	3904	26	58282	1141	54378	1115	150.15384615384616	48.7695067264574
chr19	COX7A1	36151668	36151694	0	27	367	590	367	563	0.0	0.6518650088809946
chr19	LINC00665	36331446	36331725	0	280	75161	10527	75161	10247	0.0	7.334927295793891
chr19	LINC00665	36326289	36326480	0	192	75161	10527	75161	10335	0.0	7.272472181906144
chr19	LINC00665	36326052	36326288	0	237	75161	10527	75161	10290	0.0	7.304275996112731
chr19	LINC00665	36326052	36326480	0	429	75161	10527	75161	10098	0.0	7.443157060804119
chr19	ZNF566	36489473	36489484	7	12	116	3205	109	3193	0.5833333333333334	0.034137175070466645
chr19	ZNF260	36525154	36525172	979	19	77322	5512	76343	5493	51.526315789473685	13.898234116147824
chr19	ZNF461	36658298	36658334	0	37	20395	2885	20395	2848	0.0	7.161165730337078
chr19	ZNF829	36915795	36916009	897	215	15060	7748	14163	7533	4.1720930232558135	1.8801274392672243
chr19	ZNF585B	37210440	37210457	409	18	6109	4304	5700	4286	22.72222222222222	1.3299113392440505
chr19	ZNF569	37467083	37467257	1686	175	25477	5026	23791	4851	9.634285714285713	4.904349618635333
chr19	ZNF793-AS1	37505845	37505970	918	126	3475	1411	2557	1285	7.285714285714286	1.9898832684824903
chr19	ZNF571	37594086	37594218	0	133	21688	6081	21688	5948	0.0	3.6462676529926026
chr19	ZNF571	37594086	37594739	102	654	21688	6081	21586	5427	0.1559633027522936	3.9775198083655794
chr19	ZFP30	37655046	37655098	0	53	9222	7720	9222	7667	0.0	1.2028172688143994
chr19	WDR87	37896137	37896253	0	117	10763	9205	10763	9088	0.0	1.1843089788732395
chr19	DPF1	38222834	38223081	5227	248	42124	4499	36897	4251	21.076612903225808	8.679604798870853
chr19	YIF1B	38315859	38315867	126	9	12321	4073	12195	4064	14.0	3.000738188976378
chr19	YIF1B	38315716	38315745	300	30	12321	4073	12021	4043	10.0	2.973287162997774
chr19	YIF1B	38315716	38315721	84	6	12321	4073	12237	4067	14.0	3.00885173346447
chr19	YIF1B	38315722	38315745	216	24	12321	4073	12105	4049	9.0	2.9896270684119535
chr19	ECH1	38831308	38831318	0	11	5430	2085	5430	2074	0.0	2.618129218900675
chr19	ECH1	38831695	38831719	0	25	5430	2085	5430	2060	0.0	2.6359223300970873
chr19	ECH1	38831606	38831719	0	114	5430	2085	5430	1971	0.0	2.7549467275494672
chr19	ECH1	38831606	38831694	0	89	5430	2085	5430	1996	0.0	2.720440881763527
chr19	HNRNPL	38849699	38849869	0	171	391	5612	391	5441	0.0	0.07186179011211175
chr19	GMFG	39329543	39329546	4890	4	698429	1395	693539	1391	1222.5	498.5902228612509
chr19	RPS16	39435606	39435656	14288	51	116105	1461	101817	1410	280.15686274509807	72.21063829787234
chr19	RPS16	39433493	39433520	178	28	116105	1461	115927	1433	6.357142857142857	80.89811584089323
chr19	RPS16	39433493	39433516	114	24	116105	1461	115991	1437	4.75	80.71746694502436
chr19	RPS16	39433517	39433520	64	4	116105	1461	116041	1457	16.0	79.64378860672615
chr19	DYRK1B	39833266	39833599	0	334	2488	3204	2488	2870	0.0	0.8668989547038327
chr19	FBL	39840616	39840618	84	3	35643	2147	35559	2144	28.0	16.58535447761194
chr19	FBL	39840616	39840654	1447	39	35643	2147	34196	2108	37.1025641025641	16.22201138519924
chr19	FBL	39840682	39840720	1072	39	35643	2147	34571	2108	27.487179487179485	16.399905123339657
chr19	FBL	39840619	39840654	1363	36	35643	2147	34280	2111	37.861111111111114	16.238749407863573
chr19	ZNF780B	40047374	40047404	0	31	227315	9246	227315	9215	0.0	24.667932718393924
chr19	ZNF780B	40056100	40056187	0	88	227315	9246	227315	9158	0.0	24.821467569338285
chr19	ZNF780A	40090749	40090792	0	44	0	5940	0	5896	0.0	0.0
chr19	AKT2	40235044	40235099	0	56	102	12439	102	12383	0.0	0.008237099248970363
chr19	AKT2	40265221	40265257	0	37	102	12439	102	12402	0.0	0.00822447992259313
chr19	AKT2	40266010	40266204	0	195	102	12439	102	12244	0.0	0.008330610911466842
chr19	AKT2	40284764	40284862	0	99	102	12439	102	12340	0.0	0.00826580226904376
chr19	C19ORF47	40341785	40341837	0	53	253999	2632	253999	2579	0.0	98.48739821636293
chr19	PRX	40414699	40414756	0	58	0	6803	0	6745	0.0	0.0
chr19	PRX	40398560	40398618	0	59	0	6803	0	6744	0.0	0.0
chr19	PRX	40408329	40408332	0	4	0	6803	0	6799	0.0	0.0
chr19	SERTAD3	40442322	40442325	0	4	56	1709	56	1705	0.0	0.03284457478005865
chr19	BLVRB	40458154	40458172	0	19	5655	1617	5655	1598	0.0	3.5387984981226532
chr19	BLVRB	40457498	40458172	2775	675	5655	1617	2880	942	4.111111111111111	3.0573248407643314
chr19	BLVRB	40457498	40458153	2775	656	5655	1617	2880	961	4.2301829268292686	2.9968782518210197
chr19	COQ8B	40705324	40705348	0	25	37112	11023	37112	10998	0.0	3.3744317148572467
chr19	COQ8B	40703368	40703539	0	172	37112	11023	37112	10851	0.0	3.420145608699659
chr19	COQ8B	40715324	40715585	0	262	37112	11023	37112	10761	0.0	3.448750116160208
chr19	COQ8B	40716586	40716860	1831	275	37112	11023	35281	10748	6.658181818181818	3.282564197990324
chr19	COQ8B	40715052	40715055	275	4	37112	11023	36837	11019	68.75	3.3430438333787094
chr19	COQ8B	40715032	40715055	1919	24	37112	11023	35193	10999	79.95833333333333	3.1996545140467316
chr19	COQ8B	40715032	40715051	1644	20	37112	11023	35468	11003	82.2	3.22348450422612
chr19	C19ORF54	40743904	40743913	3474	10	265016	2845	261542	2835	347.4	92.25467372134038
chr19	C19ORF54	40742398	40742513	0	116	265016	2845	265016	2729	0.0	97.1110296812019
chr19	CYP2T1P	40810584	40810660	987	77	21195	1970	20208	1893	12.818181818181818	10.675118858954042
chr19	CYP2A6	40850236	40850245	3	10	4995	2222	4992	2212	0.3	2.2567811934900543
chr19	CYP2A7	40882020	40882029	10	10	538947	2583	538937	2573	1.0	209.45860862806063
chr19	TGFB1	41332039	41332126	357	88	3718	3272	3361	3184	4.056818181818182	1.0555904522613064
chr19	DMAC2	41436391	41436427	0	37	102	2624	102	2587	0.0	0.039427908774642445
chr19	DMAC2	41438217	41438233	0	17	102	2624	102	2607	0.0	0.039125431530494824
chr19	PCAT19	41494539	41495300	0	762	152	5541	152	4779	0.0	0.03180581711655158
chr19	PCAT19	41456590	41456614	0	25	152	5541	152	5516	0.0	0.02755620014503263
chr19	RABAC1	41959114	41959235	0	122	51	1564	51	1442	0.0	0.03536754507628294
chr19	ATP1A3	41994010	41994069	0	60	84	5613	84	5553	0.0	0.015126958400864398
chr19	DEDD2	42215132	42215146	0	15	0	2616	0	2601	0.0	0.0
chr19	DEDD2	42201988	42202049	0	62	0	2616	0	2554	0.0	0.0
chr19	DEDD2	42217607	42217630	0	24	0	2616	0	2592	0.0	0.0
chr19	GSK3A	42232495	42232497	0	3	51	5487	51	5484	0.0	0.009299781181619256
chr19	GSK3A	42234547	42234550	0	4	51	5487	51	5483	0.0	0.009301477293452489
chr19	GSK3A	42239954	42239960	0	7	51	5487	51	5480	0.0	0.009306569343065693
chr19	GSK3A	42239954	42239977	0	24	51	5487	51	5463	0.0	0.009335529928610654
chr19	GSK3A	42242182	42242314	0	133	51	5487	51	5354	0.0	0.009525588345162496
chr19	GSK3A	42232929	42233108	0	180	51	5487	51	5307	0.0	0.009609949123798756
chr19	GSK3A	42236593	42236604	0	12	51	5487	51	5475	0.0	0.009315068493150684
chr19	GSK3A	42239961	42239977	0	17	51	5487	51	5470	0.0	0.009323583180987203
chr19	GSK3A	42239951	42239953	0	3	51	5487	51	5484	0.0	0.009299781181619256
chr19	GSK3A	42239951	42239960	0	10	51	5487	51	5477	0.0	0.00931166697096951
chr19	GSK3A	42239951	42239977	0	27	51	5487	51	5460	0.0	0.00934065934065934
chr19	GSK3A	42241900	42242181	0	282	51	5487	51	5205	0.0	0.009798270893371758
chr19	GSK3A	42241900	42242314	0	415	51	5487	51	5072	0.0	0.010055205047318612
chr19	PAFAH1B3	42299969	42300040	0	72	0	1298	0	1226	0.0	0.0
chr19	PAFAH1B3	42299969	42300007	0	39	0	1298	0	1259	0.0	0.0
chr19	PAFAH1B3	42302436	42302697	0	262	0	1298	0	1036	0.0	0.0
chr19	PAFAH1B3	42300008	42300040	0	33	0	1298	0	1265	0.0	0.0
chr19	ETHE1	43526936	43527095	211	160	1662	1596	1451	1436	1.31875	1.0104456824512535
chr19	PLAUR	43667776	43668042	0	267	2361	4200	2361	3933	0.0	0.6003051106025934
chr19	PLAUR	43667776	43667777	0	2	2361	4200	2361	4198	0.0	0.5624106717484516
chr19	PLAUR	43667778	43668275	0	498	2361	4200	2361	3702	0.0	0.6377633711507293
chr19	PLAUR	43667778	43668042	0	265	2361	4200	2361	3935	0.0	0.6
chr19	SMG9	43739672	43740105	1030	434	10441	7922	9411	7488	2.3732718894009217	1.2568108974358974
chr19	SMG9	43754541	43754562	0	22	10441	7922	10441	7900	0.0	1.3216455696202531
chr19	SMG9	43754375	43754540	0	166	10441	7922	10441	7756	0.0	1.3461835997937082
chr19	SMG9	43754375	43754528	0	154	10441	7922	10441	7768	0.0	1.344104016477858
chr19	SMG9	43754375	43754562	0	188	10441	7922	10441	7734	0.0	1.3500129299198345
chr19	SMG9	43754375	43754376	0	2	10441	7922	10441	7920	0.0	1.3183080808080807
chr19	SMG9	43754529	43754540	0	12	10441	7922	10441	7910	0.0	1.3199747155499368
chr19	SMG9	43754529	43754562	0	34	10441	7922	10441	7888	0.0	1.323656186612576
chr19	SMG9	43754377	43754540	0	164	10441	7922	10441	7758	0.0	1.345836555813354
chr19	SMG9	43754377	43754528	0	152	10441	7922	10441	7770	0.0	1.3437580437580439
chr19	SMG9	43754377	43754562	0	186	10441	7922	10441	7736	0.0	1.3496639089968976
chr19	KCNN4	43769346	43769440	138	95	4672	3224	4534	3129	1.4526315789473685	1.4490252476829657
chr19	KCNN4	43769332	43769440	138	109	4672	3224	4534	3115	1.2660550458715596	1.45553772070626
chr19	KCNN4	43769332	43769345	0	14	4672	3224	4672	3210	0.0	1.4554517133956386
chr19	LYPD5	43820477	43820538	0	62	2805	5338	2805	5276	0.0	0.5316527672479151
chr19	AC006213.2	43901036	43901043	0	8	0	2188	0	2180	0.0	0.0
chr19	ZNF45	43934923	43935228	0	306	0	4108	0	3802	0.0	0.0
chr19	AC006213.1	44002264	44002622	485	359	34570	3370	34085	3011	1.350974930362117	11.320159415476585
chr19	AC067968.2	44024878	44024896	158	19	10325	1074	10167	1055	8.31578947368421	9.63696682464455
chr19	ZNF235	44298807	44298818	0	12	16258	5999	16258	5987	0.0	2.715550359111408
chr19	ZNF112	44340415	44340418	0	4	985	3854	985	3850	0.0	0.2558441558441558
chr19	ZNF285	44401422	44401566	204	145	61172	6726	60968	6581	1.4068965517241379	9.264245555386719
chr19	ZNF285	44392205	44392338	40	134	61172	6726	61132	6592	0.29850746268656714	9.27366504854369
chr19	ZNF229	44442813	44442826	0	14	10764	5508	10764	5494	0.0	1.959228248998908
chr19	ZNF229	44432221	44432238	0	18	10764	5508	10764	5490	0.0	1.960655737704918
chr19	ZNF229	44431766	44432238	612	473	10764	5508	10152	5035	1.2938689217758985	2.0162859980139025
chr19	ZNF229	44431766	44432220	612	455	10764	5508	10152	5053	1.3450549450549452	2.0091035028695825
chr19	ZNF180	44500197	44500273	214	77	26553	4714	26339	4637	2.779220779220779	5.680181151606642
chr19	TRAPPC6A	45178092	45178133	0	42	54730	939	54730	897	0.0	61.01449275362319
chr19	ERCC2	45370132	45370534	24	403	56764	5327	56740	4924	0.05955334987593052	11.52315190901706
chr19	ERCC2	45370470	45370534	0	65	56764	5327	56764	5262	0.0	10.78753325731661
chr19	ERCC1	45423780	45423821	0	42	13301	5262	13301	5220	0.0	2.5480842911877395
chr19	RTN2	45494117	45494164	67363	48	306531	3171	239168	3123	1403.3958333333333	76.58277297470381
chr19	EML2	45639294	45639355	0	62	38578	6562	38578	6500	0.0	5.935076923076923
chr19	DMPK	45777326	45777340	195	15	19126	4865	18931	4850	13.0	3.903298969072165
chr19	DMPK	45779133	45779262	0	130	19126	4865	19126	4735	0.0	4.039281942977825
chr19	DMPK	45780213	45780321	0	109	19126	4865	19126	4756	0.0	4.021446593776282
chr19	SYMPK	45828969	45829053	0	85	344768	10339	344768	10254	0.0	33.6227813536181
chr19	IGFL2-AS1	46190223	46190283	0	61	52041	3342	52041	3281	0.0	15.861322767448948
chr19	PNMA8A	46469937	46470818	0	882	204	3699	204	2817	0.0	0.0724174653887114
chr19	PNMA8A	46469732	46469936	0	205	204	3699	204	3494	0.0	0.05838580423583286
chr19	PNMA8A	46469732	46470818	0	1087	204	3699	204	2612	0.0	0.0781010719754977
chr19	PRKD2	46716814	46716949	2430	136	53693	5270	51263	5134	17.86764705882353	9.985001947798986
chr19	PRKD2	46678365	46678394	0	30	53693	5270	53693	5240	0.0	10.24675572519084
chr19	STRN4	46746148	46746762	0	615	20985	7060	20985	6445	0.0	3.256012412723041
chr19	STRN4	46746763	46746800	0	38	20985	7060	20985	7022	0.0	2.988464824836229
chr19	SLC1A5	46784516	46784593	0	78	0	3202	0	3124	0.0	0.0
chr19	SLC1A5	46784699	46784731	0	33	0	3202	0	3169	0.0	0.0
chr19	AP2S1	46850655	46850762	0	108	531	1456	531	1348	0.0	0.3939169139465875
chr19	MEIS3	47419069	47419430	51	362	5319	4243	5268	3881	0.1408839779005525	1.3573821180108219
chr19	KPTN	47480759	47480762	0	4	6020	2116	6020	2112	0.0	2.850378787878788
chr19	KPTN	47484219	47484233	0	15	6020	2116	6020	2101	0.0	2.8653022370299857
chr19	NAPA	47503392	47503421	0	30	69860	4857	69860	4827	0.0	14.472757406256473
chr19	PLA2G4C	48052953	48052995	0	43	925	5764	925	5721	0.0	0.1616850201013809
chr19	LIG1	48120166	48121168	1836	1003	9796	6607	7960	5604	1.8305084745762712	1.4204139900071378
chr19	CARD8	48249522	48249749	2958	228	357235	11518	354277	11290	12.973684210526315	31.37971656333038
chr19	CCDC114	48320754	48320770	0	17	386	5076	386	5059	0.0	0.07629966396521051
chr19	CCDC114	48321677	48321719	0	43	386	5076	386	5033	0.0	0.0766938207828333
chr19	AC008403.2	48469010	48469428	0	419	20	1864	20	1445	0.0	0.01384083044982699
chr19	DBP	48634348	48634506	37324	159	108622	3763	71298	3604	234.74213836477986	19.78301886792453
chr19	IZUMO1	48745624	48745690	52	67	11163	2382	11111	2315	0.7761194029850746	4.799568034557235
chr19	IZUMO1	48743407	48743443	64	37	11163	2382	11099	2345	1.7297297297297298	4.733049040511727
chr19	FUT1	48755289	48755324	0	36	36732	4347	36732	4311	0.0	8.5205288796103
chr19	HSD17B14	48813432	48813454	0	23	196236	1121	196236	1098	0.0	178.72131147540983
chr19	TULP2	48896429	48896437	0	9	5807	2263	5807	2254	0.0	2.5763087843833183
chr19	TULP2	48881998	48882030	0	33	5807	2263	5807	2230	0.0	2.604035874439462
chr19	TULP2	48898486	48898588	0	103	5807	2263	5807	2160	0.0	2.6884259259259258
chr19	AC008687.1	49036525	49036701	0	177	0	612	0	435	0.0	0.0
chr19	CGB7	49057461	49057663	0	203	51	2976	51	2773	0.0	0.01839163360980887
chr19	TEAD2	49355302	49355310	9	9	36224	2995	36215	2986	1.0	12.12826523777629
chr19	TEAD2	49362328	49362331	226	4	36224	2995	35998	2991	56.5	12.035439652290204
chr19	TEAD2	49362328	49362371	1761	44	36224	2995	34463	2951	40.02272727272727	11.678414096916299
chr19	TEAD2	49362332	49362371	1535	40	36224	2995	34689	2955	38.375	11.739086294416243
chr19	PIH1D1	49451367	49451483	0	117	964	2510	964	2393	0.0	0.4028416213957376
chr19	PIH1D1	49449339	49449473	0	135	964	2510	964	2375	0.0	0.40589473684210525
chr19	PIH1D1	49453375	49453391	27	17	964	2510	937	2493	1.588235294117647	0.3758523866827116
chr19	PIH1D1	49453269	49453391	27	123	964	2510	937	2387	0.21951219512195122	0.3925429409300377
chr19	PIH1D1	49453269	49453374	0	106	964	2510	964	2404	0.0	0.40099833610648916
chr19	NOSIP	49557080	49557088	0	9	2520	2911	2520	2902	0.0	0.8683666436940042
chr19	NOSIP	49556874	49556956	0	83	2520	2911	2520	2828	0.0	0.8910891089108911
chr19	IRF3	49662424	49662591	5708	168	39279	3464	33571	3296	33.976190476190474	10.185376213592233
chr19	IRF3	49665630	49665670	0	41	39279	3464	39279	3423	0.0	11.475021910604733
chr19	IRF3	49665483	49665629	0	147	39279	3464	39279	3317	0.0	11.84172444980404
chr19	IRF3	49665483	49665670	0	188	39279	3464	39279	3276	0.0	11.989926739926739
chr19	IRF3	49661449	49661946	18416	498	39279	3464	20863	2966	36.97991967871486	7.034052596089008
chr19	IRF3	49664673	49665629	712	957	39279	3464	38567	2507	0.7439916405433646	15.383725568408456
chr19	IRF3	49664442	49664551	51	110	39279	3464	39228	3354	0.4636363636363636	11.695885509838998
chr19	IRF3	49664442	49664585	51	144	39279	3464	39228	3320	0.3541666666666667	11.815662650602409
chr19	IRF3	49665630	49665633	0	4	39279	3464	39279	3460	0.0	11.352312138728324
chr19	IRF3	49664552	49664585	0	34	39279	3464	39279	3430	0.0	11.451603498542275
chr19	IRF3	49664552	49664672	51	121	39279	3464	39228	3343	0.4214876033057851	11.734370326054442
chr19	IRF3	49665458	49665629	0	172	39279	3464	39279	3292	0.0	11.931652490886998
chr19	IRF3	49665458	49665482	0	25	39279	3464	39279	3439	0.0	11.421634195987206
chr19	IRF3	49665458	49665670	0	213	39279	3464	39279	3251	0.0	12.082128575822823
chr19	FUZ	49812614	49812636	23	23	39393	2967	39370	2944	1.0	13.372961956521738
chr19	FUZ	49812995	49813131	3342	137	39393	2967	36051	2830	24.394160583941606	12.73886925795053
chr19	FUZ	49812446	49812613	4337	168	39393	2967	35056	2799	25.81547619047619	12.524473026080743
chr19	FUZ	49812446	49812636	4360	191	39393	2967	35033	2776	22.827225130890053	12.619956772334294
chr19	PNKP	49867468	49867493	0	26	39166	3802	39166	3776	0.0	10.372351694915254
chr19	AKT1S1	49877024	49877235	0	212	13909	5298	13909	5086	0.0	2.7347620920173026
chr19	AKT1S1	49876602	49877023	0	422	13909	5298	13909	4876	0.0	2.8525430680885973
chr19	AKT1S1	49876602	49877235	0	634	13909	5298	13909	4664	0.0	2.982204116638079
chr19	IL4I1	49895814	49895924	0	111	139	2507	139	2396	0.0	0.05801335559265442
chr19	NUP62	49929325	49929348	0	24	97	2772	97	2748	0.0	0.03529839883551674
chr19	NUP62	49929325	49929415	0	91	97	2772	97	2681	0.0	0.03618052965311451
chr19	NUP62	49927693	49929324	51	1632	97	2772	46	1140	0.03125	0.04035087719298246
chr19	NUP62	49929349	49929415	0	67	97	2772	97	2705	0.0	0.03585951940850277
chr19	VRK3	50025266	50025344	0	79	3049350	7489	3049350	7410	0.0	411.5182186234818
chr19	VRK3	50025345	50025666	3060	322	3049350	7489	3046290	7167	9.503105590062113	425.0439514441189
chr19	VRK3	50020461	50020583	0	123	3049350	7489	3049350	7366	0.0	413.9763779527559
chr19	FAM71E1	50467555	50467620	0	66	298	1599	298	1533	0.0	0.1943900848010437
chr19	JOSD2	50511074	50511115	2143	42	119	1198	-2024	1156	51.023809523809526	-1.7508650519031141
chr19	ASPDH	50514477	50514489	0	13	14858	1675	14858	1662	0.0	8.939831528279182
chr19	C19ORF48	50799271	50799292	0	22	153	2224	153	2202	0.0	0.06948228882833787
chr19	KLK15	50826877	50826994	0	118	816	1623	816	1505	0.0	0.5421926910299003
chr19	KLK4	50909239	50909250	450	12	107594	1350	107144	1338	37.5	80.07772795216741
chr19	KLK5	50952746	50952948	0	203	0	1576	0	1373	0.0	0.0
chr19	KLK5	50952746	50952896	0	151	0	1576	0	1425	0.0	0.0
chr19	KLK7	50983771	50983849	2842	79	55279	2454	52437	2375	35.9746835443038	22.078736842105265
chr19	KLK11	51024633	51024636	0	4	1128	2286	1128	2282	0.0	0.49430324276950044
chr19	KLK12	51034794	51034804	0	11	0	1762	0	1751	0.0	0.0
chr19	KLK12	51034424	51034583	0	160	0	1762	0	1602	0.0	0.0
chr19	KLK12	51031779	51031874	0	96	0	1762	0	1666	0.0	0.0
chr19	KLK13	51059824	51060034	0	211	38	2594	38	2383	0.0	0.01594628619387327
chr19	KLK13	51059824	51060042	0	219	38	2594	38	2375	0.0	0.016
chr19	KLK13	51060035	51060042	0	8	38	2594	38	2586	0.0	0.014694508894044857
chr19	KLK13	51059744	51059823	0	80	38	2594	38	2514	0.0	0.015115354017501989
chr19	KLK13	51059744	51060034	0	291	38	2594	38	2303	0.0	0.016500217108119844
chr19	KLK13	51059744	51060042	0	299	38	2594	38	2295	0.0	0.016557734204793027
chr19	NKG7	51371939	51372159	0	221	0	924	0	703	0.0	0.0
chr19	LIM2	51387142	51387267	0	126	0	1007	0	881	0.0	0.0
chr19	C19ORF84	51390348	51390476	0	129	0	1466	0	1337	0.0	0.0
chr19	HAS1	51716229	51716254	0	26	0	2243	0	2217	0.0	0.0
chr19	ZNF577	51886820	51887894	0	1075	3742	5101	3742	4026	0.0	0.9294585196224541
chr19	ZNF577	51887831	51887894	0	64	3742	5101	3742	5037	0.0	0.7429025213420687
chr19	ZNF577	51887831	51887842	0	12	3742	5101	3742	5089	0.0	0.735311456081745
chr19	ZNF577	51887843	51887894	0	52	3742	5101	3742	5049	0.0	0.7411368587839177
chr19	ZNF577	51887753	51887894	0	142	3742	5101	3742	4959	0.0	0.754587618471466
chr19	ZNF577	51887753	51887830	0	78	3742	5101	3742	5023	0.0	0.7449731236312961
chr19	ZNF577	51887753	51887842	0	90	3742	5101	3742	5011	0.0	0.7467571343045301
chr19	ZNF577	51887587	51887830	0	244	3742	5101	3742	4857	0.0	0.7704344245418983
chr19	ZNF577	51887587	51887842	0	256	3742	5101	3742	4845	0.0	0.77234262125903
chr19	ZNF577	51887587	51887752	0	166	3742	5101	3742	4935	0.0	0.758257345491388
chr19	ZNF649	51899797	51900091	0	295	3724	3541	3724	3246	0.0	1.1472581638940234
chr19	ZNF615	52000345	52000356	0	12	0	4909	0	4897	0.0	0.0
chr19	ZNF615	52000258	52000344	0	87	0	4909	0	4822	0.0	0.0
chr19	ZNF615	52000258	52000356	0	99	0	4909	0	4810	0.0	0.0
chr19	ZNF616	52122359	52122406	0	48	154	4913	154	4865	0.0	0.031654676258992806
chr19	AC011468.2	52171331	52171334	0	4	0	604	0	600	0.0	0.0
chr19	ZNF528-AS1	52396315	52396363	0	49	68922	4684	68922	4635	0.0	14.86990291262136
chr19	ZNF611	52707391	52707467	324	77	525131	6713	524807	6636	4.207792207792208	79.08484026522001
chr19	ZNF611	52707391	52707419	0	29	525131	6713	525131	6684	0.0	78.56538001196888
chr19	ZNF611	52707420	52707467	324	48	525131	6713	524807	6665	6.75	78.74073518379595
chr19	ZNF320	52897519	52897646	1125	128	53514	6226	52389	6098	8.7890625	8.591177435224663
chr19	ZNF320	52897509	52897518	0	10	53514	6226	53514	6216	0.0	8.60907335907336
chr19	ZNF320	52897509	52897646	1125	138	53514	6226	52389	6088	8.152173913043478	8.60528909329829
chr19	ZNF816	52962716	52962725	0	10	293	3076	293	3066	0.0	0.09556425309849967
chr19	ZNF702P	52980835	52980890	0	56	102	6512	102	6456	0.0	0.015799256505576207
chr19	ZNF702P	53037724	53037768	0	45	102	6512	102	6467	0.0	0.01577238286686253
chr19	ZNF160	53091412	53091635	826	224	95953	7275	95127	7051	3.6875	13.4912778329315
chr19	ZNF415	53132748	53132854	528	107	116925	3790	116397	3683	4.934579439252336	31.60385555253869
chr19	ZNF347	53158679	53159007	9918	329	54978	9136	45060	8807	30.145896656534955	5.116384693993414
chr19	ZNF677	53254598	53254628	58	31	28876	8434	28818	8403	1.8709677419354838	3.429489468047126
chr19	MBOAT7	54189301	54189336	0	36	51	5300	51	5264	0.0	0.009688449848024316
chr19	LILRA6	54241575	54241660	0	86	0	2564	0	2478	0.0	0.0
chr19	LILRB2	54276246	54276262	0	17	71079	3214	71079	3197	0.0	22.23303096653112
chr19	LAIR1	54360915	54361008	0	94	4794	7661	4794	7567	0.0	0.6335403726708074
chr19	LAIR1	54356711	54356926	48	216	4794	7661	4746	7445	0.2222222222222222	0.6374748153122901
chr19	LENG8-AS1	54448561	54448631	0	71	732	1667	732	1596	0.0	0.45864661654135336
chr19	NLRP7	54947631	54947641	0	11	146405	3927	146405	3916	0.0	37.38636363636363
chr19	GP6	55015678	55015681	0	4	51	2711	51	2707	0.0	0.01884004432951607
chr19	RDH13	55047104	55047385	0	282	0	7482	0	7200	0.0	0.0
chr19	TNNT1	55146659	55146679	0	21	0	2115	0	2094	0.0	0.0
chr19	TNNI3	55154707	55154739	0	33	0	2023	0	1990	0.0	0.0
chr19	DNAAF3	55165781	55165856	0	76	0	3314	0	3238	0.0	0.0
chr19	DNAAF3	55166511	55166521	0	11	0	3314	0	3303	0.0	0.0
chr19	HSPBP1	55279929	55280033	0	105	0	1861	0	1756	0.0	0.0
chr19	TMEM150B	55316774	55316784	0	11	0	1723	0	1712	0.0	0.0
chr19	FAM71E2	55362916	55362968	0	53	0	3231	0	3178	0.0	0.0
chr19	SBK3	55545248	55545497	0	250	51	1524	51	1274	0.0	0.040031397174254316
chr19	ZNF784	55624446	55624482	0	37	15027	2026	15027	1989	0.0	7.555052790346908
chr19	NLRP11	55836335	55836708	0	374	25009	4326	25009	3952	0.0	6.328188259109312
chr19	ZSCAN5A	56314619	56314679	0	61	2198	5796	2198	5735	0.0	0.38326068003487357
chr19	ZSCAN5A	56314249	56314679	0	431	2198	5796	2198	5365	0.0	0.40969245107176144
chr19	ZSCAN5A	56314249	56314618	0	370	2198	5796	2198	5426	0.0	0.40508661997788425
chr19	ZSCAN5A	56314249	56314419	0	171	2198	5796	2198	5625	0.0	0.3907555555555556
chr19	ZNF582	56393219	56393440	0	222	0	3346	0	3124	0.0	0.0
chr19	ZNF582	56393219	56393235	0	17	0	3346	0	3329	0.0	0.0
chr19	AC005498.2	56538247	56538251	0	5	0	595	0	590	0.0	0.0
chr19	AC005498.2	56538252	56538355	0	104	0	595	0	491	0.0	0.0
chr19	ZNF835	56671575	56671599	1727	25	82888	3476	81161	3451	69.08	23.518110692552884
chr19	PEG3	56823589	56823591	0	3	3485	8725	3485	8722	0.0	0.3995643201100665
chr19	PEG3	56840581	56840585	0	5	3485	8725	3485	8720	0.0	0.39965596330275227
chr19	ZNF772	57475023	57475031	0	9	74	2414	74	2405	0.0	0.03076923076923077
chr19	ZNF772	57475023	57475046	0	24	74	2414	74	2390	0.0	0.03096234309623431
chr19	ZNF772	57475032	57475046	0	15	74	2414	74	2399	0.0	0.030846185910796166
chr19	ZNF772	57476379	57476632	0	254	74	2414	74	2160	0.0	0.03425925925925926
chr19	ZNF550	57543650	57544235	0	586	0	5093	0	4507	0.0	0.0
chr19	ZNF671	57726907	57727389	20651	483	28880	2912	8229	2429	42.75569358178054	3.387813915191437
chr19	ZNF552	57814532	57814709	1955	178	47422	2758	45467	2580	10.98314606741573	17.622868217054265
chr19	ZNF814	57868457	57868485	883	29	124424	9024	123541	8995	30.448275862068964	13.734408004446914
chr19	ZNF418	57925622	57927975	663	2354	12631	4415	11968	2061	0.2816482582837723	5.806889859291606
chr19	ZNF418	57935283	57935333	129	51	12631	4415	12502	4364	2.5294117647058822	2.8648029330889093
chr19	ZNF418	57935030	57935078	756	49	12631	4415	11875	4366	15.428571428571429	2.7198808978469997
chr19	ZNF606	58002395	58002778	35	384	29416	7642	29381	7258	0.09114583333333333	4.048084871865528
chr19	ZSCAN18	58097929	58098172	1386	244	69126	6534	67740	6290	5.680327868852459	10.769475357710652
chr19	ZSCAN18	58097929	58098113	1386	185	69126	6534	67740	6349	7.491891891891892	10.66939675539455
chr19	ZSCAN18	58098114	58098172	0	59	69126	6534	69126	6475	0.0	10.675830115830117
chr19	ZSCAN18	58118266	58118346	3006	81	69126	6534	66120	6453	37.111111111111114	10.246397024639702
chr19	ZSCAN18	58118318	58118346	703	29	69126	6534	68423	6505	24.24137931034483	10.518524212144504
chr19	AC010642.2	58312969	58313098	81	130	34354	4472	34273	4342	0.6230769230769231	7.893367111929986
chr19	AC010642.2	58314670	58314804	3112	135	34354	4472	31242	4337	23.05185185185185	7.20359695642149
chr19	ZNF837	58369716	58369817	900	102	33361	2049	32461	1947	8.823529411764707	16.672316384180792
chr19	SLC27A5	58511267	58511518	645	252	62811	4687	62166	4435	2.5595238095238093	14.017136414881623
chr19	ZBTB45	58519616	58519740	3478	125	111299	2767	107821	2642	27.824	40.81037093111279
chr19	ZBTB45	58519018	58519261	4180	244	111299	2767	107119	2523	17.131147540983605	42.45699564011098
chr19	CHMP2A	58554776	58554863	0	88	102	1713	102	1625	0.0	0.06276923076923077
chr19	CHMP2A	58554864	58554986	0	123	102	1713	102	1590	0.0	0.06415094339622641
chr19	CHMP2A	58554672	58554863	0	192	102	1713	102	1521	0.0	0.0670611439842209
chr19	CHMP2A	58554672	58554986	0	315	102	1713	102	1398	0.0	0.07296137339055794
chr19	CHMP2A	58554672	58554775	0	104	102	1713	102	1609	0.0	0.06339341205717837
chr19	FSTL3	680775	680879	0	105	250629	3031	250629	2926	0.0	85.65584415584415
chr19	FSTL3	680813	680879	0	67	250629	3031	250629	2964	0.0	84.5576923076923
chr19	FSTL3	680775	680812	0	38	250629	3031	250629	2993	0.0	83.73838957567658
chr19	CFD	859745	859765	0	21	31095	1217	31095	1196	0.0	25.99916387959866
chr19	WDR18	991140	991145	518	6	124301	2003	123783	1997	86.33333333333333	61.98447671507261
chr19	WDR18	989896	990103	140	208	124301	2003	124161	1795	0.6730769230769231	69.17047353760445
chr19	CNN2	1032664	1032696	24249	33	2178034	3020	2153785	2987	734.8181818181819	721.052895882156
chr19	CNN2	1032670	1032696	18116	27	2178034	3020	2159918	2993	670.9629629629629	721.6565319077848
chr19	CNN2	1032664	1032669	6133	6	2178034	3020	2171901	3014	1022.1666666666666	720.6041804910418
chr19	GPX4	1105275	1105280	17848	6	2741694	1885	2723846	1879	2974.6666666666665	1449.625332623736
chr19	CIRBP	1271366	1271467	27052	102	2975831	5567	2948779	5465	265.2156862745098	539.5752973467521
chr19	CIRBP	1267166	1267292	902	127	2975831	5567	2974929	5440	7.102362204724409	546.8619485294117
chr19	CIRBP	1267166	1267366	2045	201	2975831	5567	2973786	5366	10.17412935323383	554.1904584420425
chr19	CIRBP	1267293	1267366	1143	74	2975831	5567	2974688	5493	15.445945945945946	541.541598397961
chr19	CIRBP	1267367	1267443	1208	77	2975831	5567	2974623	5490	15.688311688311689	541.8256830601093
chr19	CIRBP	1274441	1274444	320	4	2975831	5567	2975511	5563	80.0	534.8752471687939
chr19	PWWP3A	1358694	1358700	538	7	784575	9648	784037	9641	76.85714285714286	81.32320298724198
chr19	PWWP3A	1355021	1355135	357	115	784575	9648	784218	9533	3.1043478260869564	82.2635057169831
chr19	PWWP3A	1371387	1371390	172	4	784575	9648	784403	9644	43.0	81.33585649108254
chr19	NDUFS7	1383938	1383942	329	5	242247	4310	241918	4305	65.8	56.19465737514518
chr19	RPS15	1440242	1440253	5934	12	2178720	1135	2172786	1123	494.5	1934.8049866429208
chr19	RPS15	1438429	1438580	1703	152	2178720	1135	2177017	983	11.203947368421053	2214.6663275686674
chr19	APC2	1450331	1450338	0	8	66301	11710	66301	11702	0.0	5.665783626730473
chr19	CSNK1G2	1979619	1979643	4208	25	430261	3302	426053	3277	168.32	130.01312175770522
chr19	SPPL2B	2337195	2337333	0	139	498031	7292	498031	7153	0.0	69.6254718300014
chr19	SPPL2B	2351595	2351657	1909	63	498031	7292	496122	7229	30.3015873015873	68.6294093235579
chr19	GADD45B	2476629	2476630	0	2	211420	1599	211420	1597	0.0	132.38572323105822
chr19	GADD45B	2476403	2476431	211	29	211420	1599	211209	1570	7.275862068965517	134.52802547770702
chr19	THOP1	2807774	2807808	8129	35	564445	6896	556316	6861	232.25714285714287	81.08380702521498
chr19	THOP1	2807781	2807808	7044	28	564445	6896	557401	6868	251.57142857142858	81.15914385556202
chr19	THOP1	2807774	2807780	1085	7	564445	6896	563360	6889	155.0	81.77674553636231
chr19	ZNF555	2841484	2841575	918	92	51392	8546	50474	8454	9.978260869565217	5.970428199668796
chr19	ZNF556	2873619	2873622	0	4	66840	6578	66840	6574	0.0	10.167325829023426
chr19	TLE6	2977611	2977619	8	9	9070	3014	9062	3005	0.8888888888888888	3.0156405990016637
chr19	NCLN	3185957	3186214	33354	258	612717	2813	579363	2555	129.27906976744185	226.75655577299412
chr19	NCLN	3207470	3207490	0	21	612717	2813	612717	2792	0.0	219.4545128939828
chr19	FZR1	3534514	3534522	7	9	528919	6492	528912	6483	0.7777777777777778	81.58445164275798
chr19	GIPC3	3589913	3589925	0	13	66288	4429	66288	4416	0.0	15.01086956521739
chr19	SHD	4283190	4283242	0	53	867	2071	867	2018	0.0	0.4296333002973241
chr19	FSD1	4323147	4323237	53385	91	713335	2824	659950	2733	586.6483516483516	241.47457006952067
chr19	FSD1	4323214	4323237	20074	24	713335	2824	693261	2800	836.4166666666666	247.59321428571428
chr19	FSD1	4323147	4323213	33311	67	713335	2824	680024	2757	497.17910447761193	246.65360899528474
chr19	CAPS	5915066	5915146	3879	81	76809	2457	72930	2376	47.888888888888886	30.694444444444443
chr19	ACSBG2	6135865	6135909	0	45	6700	3462	6700	3417	0.0	1.9607843137254901
chr19	ACSBG2	6135664	6135673	0	10	6700	3462	6700	3452	0.0	1.94090382387022
chr19	ACSBG2	6135910	6135918	0	9	6700	3462	6700	3453	0.0	1.9403417318273966
chr19	ACSBG2	6135865	6135918	0	54	6700	3462	6700	3408	0.0	1.965962441314554
chr19	CLPP	6362526	6362542	13395	17	462189	3032	448794	3015	787.9411764705883	148.85373134328358
chr19	ADGRE1	6928212	6928310	0	99	0	3729	0	3630	0.0	0.0
chr19	PNPLA6	7535203	7535213	598	11	65533	6495	64935	6484	54.36363636363637	10.014651449722393
chr19	TRAPPC5	7680879	7681049	204	171	569436	5480	569232	5309	1.1929824561403508	107.22019212657752
chr19	TRAPPC5	7681027	7681049	0	23	569436	5480	569436	5457	0.0	104.34964266080264
chr19	HNRNPM	8463501	8463504	12	4	26584	4301	26572	4297	3.0	6.183849197114266
chr19	HNRNPM	8465363	8465515	255	153	26584	4301	26329	4148	1.6666666666666667	6.347396335583413
chr19	NFILZ	8674601	8674604	0	4	419	1698	419	1694	0.0	0.2473435655253837
chr19	ZNF561-AS1	9626861	9627806	0	946	94379	6441	94379	5495	0.0	17.175432211101
chr19	UBL5	9827944	9828064	0	121	0	1932	0	1811	0.0	0.0
chr19	UBL5	9827985	9828064	0	80	0	1932	0	1852	0.0	0.0
chr19	UBL5	9827944	9827984	0	41	0	1932	0	1891	0.0	0.0
chr19	PIN1	9849196	9849201	0	6	421	2938	421	2932	0.0	0.14358799454297408
chr19	PIN1	9849202	9849311	0	110	421	2938	421	2828	0.0	0.14886845827439887
chr19	PIN1	9849196	9849311	0	116	421	2938	421	2822	0.0	0.14918497519489723
chr19	PPAN	10110792	10110866	0	75	395	2799	395	2724	0.0	0.145007342143906
chr19	PPAN	10111023	10111084	0	62	395	2799	395	2737	0.0	0.144318597004019
chr19	ICAM5	10291317	10291341	0	25	153489	3835	153489	3810	0.0	40.28582677165355
chr19	ATG4D	10544321	10544325	0	5	1544	2174	1544	2169	0.0	0.7118487782388198
chr19	ATG4D	10547072	10547115	0	44	1544	2174	1544	2130	0.0	0.7248826291079812
chr19	ATG4D	10547083	10547115	0	33	1544	2174	1544	2141	0.0	0.7211583372255955
chr19	ATG4D	10547072	10547082	0	11	1544	2174	1544	2163	0.0	0.713823393435044
chr19	SLC44A2	10635070	10635073	0	4	13539	4084	13539	4080	0.0	3.3183823529411764
chr19	SLC44A2	10625550	10625670	34	121	13539	4084	13505	3963	0.2809917355371901	3.4077718899823366
chr19	ILF3	10655124	10655147	0	24	61657	9698	61657	9674	0.0	6.373475294604093
chr19	CARM1	10908669	10908747	964	79	241107	4435	240143	4356	12.20253164556962	55.12924701561065
chr19	CARM1	10908634	10908747	1209	114	241107	4435	239898	4321	10.605263157894736	55.51909280259199
chr19	CARM1	10908634	10908668	245	35	241107	4435	240862	4400	7.0	54.74136363636364
chr19	SMARCA4	11025509	11025619	51	111	1007126	15628	1007075	15517	0.4594594594594595	64.90139846619836
chr19	CCDC159	11346628	11346634	0	7	24270	3263	24270	3256	0.0	7.453931203931204
chr19	PLPPR2	11363820	11363835	0	16	4482	2858	4482	2842	0.0	1.5770584095707247
chr19	PRKCSH	11435673	11435706	2945	34	155072	4436	152127	4402	86.61764705882354	34.55860972285325
chr19	PRKCSH	11435707	11435710	460	4	155072	4436	154612	4432	115.0	34.88537906137184
chr19	PRKCSH	11435673	11435710	3405	38	155072	4436	151667	4398	89.60526315789474	34.48544793087767
chr19	PRKCSH	11447598	11447618	0	21	155072	4436	155072	4415	0.0	35.12389580973952
chr19	CNN1	11539561	11539569	72	9	258392	2816	258320	2807	8.0	92.02707516921981
chr19	ZNF791	12612317	12612365	0	49	11941	6647	11941	6598	0.0	1.8097908457108214
chr19	WDR83	12670081	12670097	17	17	19016	1664	18999	1647	1.0	11.53551912568306
chr19	BEST2	12751840	12751974	0	135	3906809	2567	3906809	2432	0.0	1606.4181743421052
chr19	MAST1	12858740	12858741	62	2	377052	6561	376990	6559	31.0	57.47674950449764
chr19	GCDH	12891523	12891660	0	138	4111	4015	4111	3877	0.0	1.0603559453185452
chr19	RAD23A	12952821	12952853	0	33	6750	2229	6750	2196	0.0	3.0737704918032787
chr19	NFIX	13025369	13025552	410	184	4126	3883	3716	3699	2.2282608695652173	1.004595836712625
chr19	NFIX	13024681	13024684	60	4	4126	3883	4066	3879	15.0	1.048208301108533
chr19	NFIX	13024683	13024684	30	2	4126	3883	4096	3881	15.0	1.0553980932749292
chr19	NFIX	13024681	13024682	30	2	4126	3883	4096	3881	15.0	1.0553980932749292
chr19	NFIX	13024681	13024719	642	39	4126	3883	3484	3844	16.46153846153846	0.9063475546305931
chr19	NFIX	13024685	13024719	582	35	4126	3883	3544	3848	16.62857142857143	0.920997920997921
chr19	NFIX	13024683	13024719	612	37	4126	3883	3514	3846	16.54054054054054	0.9136765470618825
chr19	NFIX	13024681	13024723	722	43	4126	3883	3404	3840	16.790697674418606	0.8864583333333333
chr19	NFIX	13024685	13024723	662	39	4126	3883	3464	3844	16.974358974358974	0.9011446409989594
chr19	NFIX	13024683	13024723	692	41	4126	3883	3434	3842	16.878048780487806	0.8938053097345132
chr19	NFIX	13024720	13024723	80	4	4126	3883	4046	3879	20.0	1.043052333075535
chr19	CCDC130	13731932	13731950	0	19	51	3082	51	3063	0.0	0.01665034280117532
chr19	MRI1	13766066	13766129	0	64	102	3471	102	3407	0.0	0.029938362195479896
chr19	C19ORF53	13774575	13774707	51	133	51	1201	0	1068	0.38345864661654133	0.0
chr19	CYP4F8	15615281	15615375	0	95	271	4309	271	4214	0.0	0.06430944470811581
chr19	CYP4F3	15640930	15640945	0	16	315	5101	315	5085	0.0	0.061946902654867256
chr19	CYP4F3	15650184	15650290	0	107	315	5101	315	4994	0.0	0.0630756908289948
chr19	CYP4F12	15678330	15678405	0	76	123	4073	123	3997	0.0	0.030773079809857395
chr19	UCA1	15831338	15831356	0	19	561	2973	561	2954	0.0	0.1899119837508463
chr19	LINC00905	16031714	16031870	5	157	5	3588	0	3431	0.03184713375796178	0.0
chr19	LINC00905	16035723	16035726	0	4	5	3588	5	3584	0.0	0.0013950892857142857
chr19	TPM4	16067739	16067962	0	224	51	9477	51	9253	0.0	0.005511725926726467
chr19	TPM4	16095358	16095893	0	536	51	9477	51	8941	0.0	0.005704059948551616
chr19	HSH2D	16148801	16148875	0	75	102	3407	102	3332	0.0	0.030612244897959183
chr19	C19ORF44	16496466	16496692	0	227	40515	4349	40515	4122	0.0	9.82896652110626
chr19	NWD1	16744719	16745147	103436	429	224304	9155	120868	8726	241.1095571095571	13.851478340591337
chr19	NWD1	16738270	16738292	0	23	224304	9155	224304	9132	0.0	24.562417871222078
chr19	MYO9B	17211775	17211786	0	12	248138	9359	248138	9347	0.0	26.54734139296031
chr19	MYO9B	17202884	17203004	934	121	248138	9359	247204	9238	7.7190082644628095	26.759471747131414
chr19	BABAM1	17267517	17267527	143	11	12248	1792	12105	1781	13.0	6.796743402582819
chr19	ANKLE1	17281950	17281982	297	33	118153	3243	117856	3210	9.0	36.715264797507785
chr19	ANKLE1	17283885	17283962	33	78	118153	3243	118120	3165	0.4230769230769231	37.320695102685626
chr19	GTPBP3	17335112	17335122	0	11	85313	3908	85313	3897	0.0	21.891968180651784
chr19	GTPBP3	17337577	17337664	3034	88	85313	3908	82279	3820	34.47727272727273	21.539005235602094
chr19	GTPBP3	17337648	17337664	283	17	85313	3908	85030	3891	16.647058823529413	21.852994088923158
chr19	GTPBP3	17337577	17337647	2751	71	85313	3908	82562	3837	38.74647887323944	21.517331248371125
chr19	BISPR	17405988	17405995	0	8	9874	3025	9874	3017	0.0	3.272787537288697
chr19	BISPR	17405772	17405995	1582	224	9874	3025	8292	2801	7.0625	2.9603712959657265
chr19	BISPR	17405772	17405987	1582	216	9874	3025	8292	2809	7.324074074074074	2.951940192239231
chr19	NIBAN3	17530817	17530885	492	69	4305	6554	3813	6485	7.130434782608695	0.5879722436391673
chr19	MAP1S	17720344	17720430	0	87	2332	3788	2332	3701	0.0	0.6300999729802756
chr19	MAP1S	17720431	17720553	0	123	2332	3788	2332	3665	0.0	0.6362892223738063
chr19	MAP1S	17720344	17720553	0	210	2332	3788	2332	3578	0.0	0.6517607602012297
chr19	MAP1S	17720431	17720591	0	161	2332	3788	2332	3627	0.0	0.6429556106975461
chr19	MAP1S	17720554	17720591	0	38	2332	3788	2332	3750	0.0	0.6218666666666667
chr19	MAP1S	17720344	17720591	0	248	2332	3788	2332	3540	0.0	0.6587570621468927
chr19	FCHO1	17754362	17754466	0	105	8258	5470	8258	5365	0.0	1.5392357875116496
chr19	FCHO1	17754622	17754758	0	137	8258	5470	8258	5333	0.0	1.548471779486218
chr19	FCHO1	17754682	17754758	0	77	8258	5470	8258	5393	0.0	1.5312442054515112
chr19	B3GNT3	17795174	17795206	45	33	198	2754	153	2721	1.3636363636363635	0.05622932745314223
chr19	SSBP4	18419616	18419707	2091	92	51542	2816	49451	2724	22.72826086956522	18.15381791483113
chr19	SSBP4	18433818	18433932	42673	115	51542	2816	8869	2701	371.0695652173913	3.283598667160311
chr19	KXD1	18557915	18557949	12	35	28450	3162	28438	3127	0.34285714285714286	9.09433962264151
chr19	KXD1	18568680	18568689	0	10	28450	3162	28450	3152	0.0	9.026015228426395
chr19	KXD1	18559131	18560550	408	1420	28450	3162	28042	1742	0.28732394366197184	16.097588978185993
chr19	UBA52	18571837	18571887	580	51	38683	2211	38103	2160	11.372549019607844	17.64027777777778
chr19	UBA52	18571888	18571909	110	22	38683	2211	38573	2189	5.0	17.621288259479215
chr19	UBA52	18571888	18572607	37328	720	38683	2211	1355	1491	51.84444444444444	0.9087860496311201
chr19	UBA52	18571910	18572607	37218	698	38683	2211	1465	1513	53.32091690544413	0.9682749504296101
chr19	UBA52	18572146	18572607	34764	462	38683	2211	3919	1749	75.24675324675324	2.2407089765580332
chr19	UBA52	18572180	18572607	34398	428	38683	2211	4285	1783	80.36915887850468	2.403252944475603
chr19	UBA52	18571888	18572145	2564	258	38683	2211	36119	1953	9.937984496124031	18.49411162314388
chr19	UBA52	18571910	18572145	2454	236	38683	2211	36229	1975	10.398305084745763	18.34379746835443
chr19	UBA52	18572146	18572179	366	34	38683	2211	38317	2177	10.764705882352942	17.600826825907212
chr19	TMEM59L	18618223	18618272	0	50	2550	2533	2550	2483	0.0	1.026983487716472
chr19	UPF1	18853072	18853104	0	33	4408	8601	4408	8568	0.0	0.5144724556489262
chr19	ARMC6	19033931	19034013	537	83	66168	4030	65631	3947	6.469879518072289	16.628071953382317
chr19	ARMC6	19055929	19055977	0	49	66168	4030	66168	3981	0.0	16.620949510173322
chr19	SLC25A42	19064047	19064115	0	69	297993	4650	297993	4581	0.0	65.04977079240341
chr19	RFXANK	19192555	19192685	0	131	3315	2341	3315	2210	0.0	1.5
chr19	MAU2	19347364	19347366	0	3	408	10018	408	10015	0.0	0.040738891662506244
chr19	MAU2	19342867	19342875	0	9	408	10018	408	10009	0.0	0.040763313018283544
chr19	NDUFA13	19527353	19527372	0	20	3927	2712	3927	2692	0.0	1.4587667161961366
chr19	ZNF101	19677987	19677990	4	4	39322	4964	39318	4960	1.0	7.927016129032258
chr19	ZNF66	20776451	20776481	0	31	31861	5687	31861	5656	0.0	5.6331329561527586
chr19	ZNF85	20946341	20946389	0	49	0	4677	0	4628	0.0	0.0
chr19	ZNF85	20923404	20923416	0	13	0	4677	0	4664	0.0	0.0
chr19	ZNF493	21397268	21397422	0	155	4080	9218	4080	9063	0.0	0.45018205892088714
chr19	AC092279.1	24058107	24058300	0	194	8378	11997	8378	11803	0.0	0.7098195374057443
chr19	AC092279.1	24058231	24058300	0	70	8378	11997	8378	11927	0.0	0.7024398423744446
chr19	AC092279.1	24058107	24058230	0	124	8378	11997	8378	11873	0.0	0.7056346332013813
chr19	AC006504.5	27793610	27793650	0	41	0	13629	0	13588	0.0	0.0
chr19	AC006504.5	27794123	27794142	0	20	0	13629	0	13609	0.0	0.0
chr19	AC079466.1	28612062	28612154	0	93	0	4063	0	3970	0.0	0.0
chr19	AC007795.1	28869922	28870017	0	96	0	987	0	891	0.0	0.0
chr19	LINC00906	28966473	28966627	0	155	79	6203	79	6048	0.0	0.013062169312169311
chr19	LINC00906	28966401	28967440	0	1040	79	6203	79	5163	0.0	0.015301181483633547
chr19	LINC00906	28966829	28967440	0	612	79	6203	79	5591	0.0	0.014129851547129315
chr19	LINC00906	28966664	28967440	0	777	79	6203	79	5426	0.0	0.014559528197567269
chr19	LINC00906	28966473	28967440	0	968	79	6203	79	5235	0.0	0.015090735434574976
chr19	LINC00906	28966628	28966663	0	36	79	6203	79	6167	0.0	0.012810118371979894
chr19	LINC00906	28966473	28966663	0	191	79	6203	79	6012	0.0	0.013140385894876913
chr19	LINC00906	28966401	28966828	0	428	79	6203	79	5775	0.0	0.01367965367965368
chr19	LINC00906	28966664	28966828	0	165	79	6203	79	6038	0.0	0.013083802583636965
chr19	LINC00906	28966473	28966828	0	356	79	6203	79	5847	0.0	0.013511202325979134
chr19	LINC00906	28966401	28966663	0	263	79	6203	79	5940	0.0	0.0132996632996633
chr19	LINC00906	28966401	28966472	0	72	79	6203	79	6131	0.0	0.012885336812917958
chr19	LINC00906	28966628	28969042	51	2415	79	6203	28	3788	0.02111801242236025	0.007391763463569166
chr19	LINC00906	28966664	28969042	51	2379	79	6203	28	3824	0.021437578814627996	0.007322175732217573
chr19	POP4	29608710	29608744	0	35	51	4182	51	4147	0.0	0.012298046780805401
chr19	POP4	29606326	29606489	0	164	51	4182	51	4018	0.0	0.012692882030861125
chr19	PLEKHF1	29665506	29665795	0	290	0	2299	0	2009	0.0	0.0
chr19	PLEKHF1	29665782	29665795	0	14	0	2299	0	2285	0.0	0.0
chr19	PLEKHF1	29665506	29665781	0	276	0	2299	0	2023	0.0	0.0
chr19	URI1	29980251	29980364	0	114	0	4959	0	4845	0.0	0.0
chr19	LINC01791	31167590	31167833	0	244	0	3441	0	3197	0.0	0.0
chr19	AC011525.2	31588317	31588680	0	364	0	3123	0	2759	0.0	0.0
chr19	AC011525.2	31588319	31588680	0	362	0	3123	0	2761	0.0	0.0
chr19	AC011525.2	31590453	31590478	0	26	0	3123	0	3097	0.0	0.0
chr19	AC011525.2	31588317	31588318	0	2	0	3123	0	3121	0.0	0.0
chr19	LINC01533	32037708	32037863	0	156	0	3749	0	3593	0.0	0.0
chr19	LINC01533	32037712	32037863	0	152	0	3749	0	3597	0.0	0.0
chr19	LINC01533	32039620	32040570	0	951	0	3749	0	2798	0.0	0.0
chr19	LINC01533	32045057	32045060	0	4	0	3749	0	3745	0.0	0.0
chr19	LINC01533	32037708	32037711	0	4	0	3749	0	3745	0.0	0.0
chr19	FAAP24	32972347	32972377	88	31	36704	2193	36616	2162	2.838709677419355	16.93617021276596
chr19	GPI	34359607	34359896	0	290	102	7809	102	7519	0.0	0.013565633727889347
chr19	GPI	34359811	34359896	0	86	102	7809	102	7723	0.0	0.013207302861582287
chr19	GPI	34365020	34365090	0	71	102	7809	102	7738	0.0	0.013181700697854742
chr19	GPI	34365066	34365090	0	25	102	7809	102	7784	0.0	0.013103802672147996
chr19	GPI	34381520	34381598	0	79	102	7809	102	7730	0.0	0.013195342820181113
chr19	ZNF302	34677797	34677856	0	60	95694	4981	95694	4921	0.0	19.44604755131071
chr19	ZNF302	34677834	34677856	0	23	95694	4981	95694	4958	0.0	19.300927793465107
chr19	ZNF302	34677755	34677856	0	102	95694	4981	95694	4879	0.0	19.613445378151262
chr19	ZNF302	34677857	34678103	0	247	95694	4981	95694	4734	0.0	20.214195183776933
chr19	ZNF302	34677797	34678103	0	307	95694	4981	95694	4674	0.0	20.473684210526315
chr19	ZNF302	34677863	34678103	0	241	95694	4981	95694	4740	0.0	20.18860759493671
chr19	ZNF302	34677834	34678103	0	270	95694	4981	95694	4711	0.0	20.31288473784759
chr19	ZNF302	34677755	34678103	0	349	95694	4981	95694	4632	0.0	20.659326424870468
chr19	ZNF302	34677755	34677796	0	42	95694	4981	95694	4939	0.0	19.375177161368697
chr19	ZNF302	34677857	34677862	0	6	95694	4981	95694	4975	0.0	19.234974874371858
chr19	ZNF302	34677797	34677862	0	66	95694	4981	95694	4915	0.0	19.469786368260426
chr19	ZNF302	34677834	34677862	0	29	95694	4981	95694	4952	0.0	19.324313408723746
chr19	ZNF302	34677755	34677862	0	108	95694	4981	95694	4873	0.0	19.63759491073261
chr19	ZNF302	34677797	34677833	0	37	95694	4981	95694	4944	0.0	19.355582524271846
chr19	ZNF302	34677755	34677833	0	79	95694	4981	95694	4902	0.0	19.52141982864137
chr19	ZNF181	34734256	34734360	0	105	153	6016	153	5911	0.0	0.025883945186939605
chr19	ZNF181	34734311	34734360	0	50	153	6016	153	5966	0.0	0.025645323499832385
chr19	ZNF181	34739610	34739621	0	12	153	6016	153	6004	0.0	0.02548301132578281
chr19	ZNF181	34734256	34734310	0	55	153	6016	153	5961	0.0	0.025666834423754403
chr19	AC008555.2	34839787	34839818	1146	32	147140	8366	145994	8334	35.8125	17.517878569714423
chr19	AC008555.2	34839163	34839392	3062	230	147140	8366	144078	8136	13.31304347826087	17.708702064896755
chr19	AC008555.2	34839245	34839392	2807	148	147140	8366	144333	8218	18.966216216216218	17.563032367972742
chr19	AC008555.2	34839163	34839244	255	82	147140	8366	146885	8284	3.1097560975609757	17.731168517624337
chr19	AC008555.2	34839393	34839818	7369	426	147140	8366	139771	7940	17.2981220657277	17.60340050377834
chr19	ZNF30	34927217	34927282	0	66	12821	2751	12821	2685	0.0	4.775046554934823
chr19	FXYD3	35115960	35116040	0	81	2622	3345	2622	3264	0.0	0.8033088235294118
chr19	FXYD7	35151474	35151482	0	9	9573	1691	9573	1682	0.0	5.691438763376932
chr19	FXYD5	35157502	35157617	0	116	20223	2929	20223	2813	0.0	7.189121933878422
chr19	FXYD5	35154810	35154869	0	60	20223	2929	20223	2869	0.0	7.0487974904147785
chr19	FXYD5	35166326	35166428	16	103	20223	2929	20207	2826	0.1553398058252427	7.150389242745931
chr19	LSR	35248503	35249131	1173	629	2685	2695	1512	2066	1.864864864864865	0.7318489835430784
chr19	LSR	35248977	35249131	1173	155	2685	2695	1512	2540	7.567741935483871	0.5952755905511811
chr19	MAG	35295743	35295981	0	239	13	2972	13	2733	0.0	0.004756677643615075
chr19	LINC01766	35596645	35596693	0	49	836	971	836	922	0.0	0.9067245119305857
chr19	LINC01766	35596658	35596693	0	36	836	971	836	935	0.0	0.8941176470588236
chr19	LINC01766	35596645	35596657	0	13	836	971	836	958	0.0	0.872651356993737
chr19	HAUS5	35614060	35614231	0	172	13082	5031	13082	4859	0.0	2.692323523358716
chr19	ETV2	35642157	35642530	6759	374	29563	2008	22804	1634	18.072192513368982	13.95593635250918
chr19	COX6B1	35648894	35648908	9	15	373384	1374	373375	1359	0.6	274.74245768947753
chr19	LIN37	35753194	35753253	0	60	5170	2440	5170	2380	0.0	2.172268907563025
chr19	PROSER3	35762357	35762477	2824	121	205201	4865	202377	4744	23.33884297520661	42.65956998313659
chr19	WDR62	36083189	36083241	0	53	23375	9265	23375	9212	0.0	2.5374511506730353
chr19	TBCB	36121670	36121718	0	49	109829	3141	109829	3092	0.0	35.52037516170763
chr19	CAPNS1	36140158	36140265	471	108	93325	2477	92854	2369	4.361111111111111	39.19544111439426
chr19	ZNF146	36215156	36215196	62	41	629339	3653	629277	3612	1.5121951219512195	174.218438538206
chr19	AC092296.2	36311389	36311503	0	115	50	2027	50	1912	0.0	0.02615062761506276
chr19	ZNF529-AS1	36573526	36573555	508	30	150445	3624	149937	3594	16.933333333333334	41.71869782971619
chr19	ZNF382	36605348	36605446	4419	99	893065	7939	888646	7840	44.63636363636363	113.34770408163266
chr19	ZNF382	36605447	36605730	77282	284	893065	7939	815783	7655	272.11971830985914	106.56864794252122
chr19	ZNF382	36605348	36605730	81701	383	893065	7939	811364	7556	213.31853785900782	107.38009528851244
chr19	ZNF567	36687635	36687686	0	52	72099	4734	72099	4682	0.0	15.399188381033746
chr19	AC020928.1	36773310	36773538	128	229	2634	2122	2506	1893	0.5589519650655022	1.323824617010037
chr19	AC020928.1	36773510	36773538	29	29	2634	2122	2605	2093	1.0	1.2446249402771141
chr19	AC020928.1	36773310	36773509	99	200	2634	2122	2535	1922	0.495	1.3189386056191468
chr19	ZNF568	36973411	36973753	3111	343	21898	9232	18787	8889	9.06997084548105	2.113511081111486
chr19	ZNF383	37235676	37235758	970	83	11201	8163	10231	8080	11.686746987951807	1.2662128712871288
chr19	ZNF527	37379237	37379246	250	10	65488	2491	65238	2481	25.0	26.295042321644498
chr19	ZNF570	37467927	37468044	1342	118	92939	6067	91597	5949	11.372881355932204	15.397041519583123
chr19	ZNF570	37476435	37476493	774	59	92939	6067	92165	6008	13.11864406779661	15.340379494007989
chr19	ZNF793	37507212	37507307	50	96	16523	9645	16473	9549	0.5208333333333334	1.7251021049324538
chr19	AC016582.3	37817702	37817726	1438	25	162882	6940	161444	6915	57.52	23.346926970354303
chr19	SPINT2	38264724	38264998	153	275	7549	3644	7396	3369	0.5563636363636364	2.19531018106263
chr19	CATSPERG	38370065	38370073	0	9	396	6878	396	6869	0.0	0.05765031300043674
chr19	PSMD8	38375293	38375509	336	217	765	3064	429	2847	1.5483870967741935	0.1506849315068493
chr19	SPRED3	38390387	38390479	0	93	9254	5774	9254	5681	0.0	1.62893856715367
chr19	EIF3K	38619318	38619327	0	10	5640	2691	5640	2681	0.0	2.103692651995524
chr19	EIF3K	38619224	38619327	0	104	5640	2691	5640	2587	0.0	2.180131426362582
chr19	EIF3K	38619224	38619317	0	94	5640	2691	5640	2597	0.0	2.1717366191759724
chr19	NFKBIB	38900080	38900211	0	132	75	2113	75	1981	0.0	0.03785966683493185
chr19	PAK4	39125880	39125919	1660	40	20331	7124	18671	7084	41.5	2.635657820440429
chr19	PAK4	39168303	39168312	0	10	20331	7124	20331	7114	0.0	2.857885858869834
chr19	PAK4	39173107	39173376	315	270	20331	7124	20016	6854	1.1666666666666667	2.9203384884738837
chr19	MED29	39393638	39393660	0	23	116054	3844	116054	3821	0.0	30.372677309604814
chr19	ZFP36	39406929	39407109	2641	181	27404	1979	24763	1798	14.591160220994475	13.772525027808676
chr19	PLEKHG2	39423762	39424882	776	1121	424427	7761	423651	6640	0.6922390722569135	63.80286144578313
chr19	PLEKHG2	39424456	39424882	0	427	424427	7761	424427	7334	0.0	57.87114807744751
chr19	TIMM50	39482917	39482963	0	47	0	5589	0	5542	0.0	0.0
chr19	AC005176.1	39640685	39640688	0	4	1197	1839	1197	1835	0.0	0.6523160762942779
chr19	ZNF546	39998333	39998410	957	78	63778	9041	62821	8963	12.26923076923077	7.008925582952137
chr19	MAP3K10	40198512	40198555	0	44	306	4074	306	4030	0.0	0.07593052109181142
chr19	PLD3	40365586	40365930	0	345	937	4360	937	4015	0.0	0.23337484433374844
chr19	PLD3	40348725	40348768	0	44	937	4360	937	4316	0.0	0.2170991658943466
chr19	SHKBP1	40577631	40577709	460	79	13951	3701	13491	3622	5.822784810126582	3.7247377139701823
chr19	LTBP4	40611977	40611984	0	8	957	7848	957	7840	0.0	0.12206632653061225
chr19	SNRPA	40757442	40757504	18	63	44452	2064	44434	2001	0.2857142857142857	22.205897051474263
chr19	SNRPA	40750938	40750977	623	40	44452	2064	43829	2024	15.575	21.654644268774703
chr19	MIA	40775834	40775885	0	52	32857	1167	32857	1115	0.0	29.468161434977578
chr19	RAB4B	40780098	40780099	23	2	144558	2971	144535	2969	11.5	48.68137420006736
chr19	EGLN2	40799639	40799706	0	68	18931	5469	18931	5401	0.0	3.505091649694501
chr19	EGLN2	40799778	40799806	0	29	18931	5469	18931	5440	0.0	3.4799632352941177
chr19	EGLN2	40799807	40799830	0	24	18931	5469	18931	5445	0.0	3.4767676767676767
chr19	EGLN2	40799778	40799830	0	53	18931	5469	18931	5416	0.0	3.495384047267356
chr19	EGLN2	40799807	40799968	51	162	18931	5469	18880	5307	0.3148148148148148	3.557565479555304
chr19	EGLN2	40799831	40799968	51	138	18931	5469	18880	5331	0.3695652173913043	3.541549427874695
chr19	EGLN2	40799778	40799968	51	191	18931	5469	18880	5278	0.2670157068062827	3.577112542629784
chr19	EGLN2	40799969	40799972	0	4	18931	5469	18931	5465	0.0	3.4640439158279963
chr19	CYP2F1	41122906	41122963	6957	58	155940	2330	148983	2272	119.94827586206897	65.57350352112677
chr19	HNRNPUL1	41262982	41263016	1009	35	332756	6669	331747	6634	28.82857142857143	50.00708471510401
chr19	HNRNPUL1	41264693	41264798	0	106	332756	6669	332756	6563	0.0	50.70181319518513
chr19	HNRNPUL1	41265122	41265167	0	46	332756	6669	332756	6623	0.0	50.24248829835422
chr19	HNRNPUL1	41265168	41265343	11572	176	332756	6669	321184	6493	65.75	49.46619436316033
chr19	RPS19	41860290	41860445	2445	156	20791	3216	18346	3060	15.673076923076923	5.995424836601307
chr19	RPS19	41861213	41861225	0	13	20791	3216	20791	3203	0.0	6.491102091788948
chr19	CD79A	41879176	41879289	7087	114	21271	1348	14184	1234	62.166666666666664	11.494327390599675
chr19	ZNF526	42220388	42220635	0	248	51	4233	51	3985	0.0	0.012797992471769134
chr19	CIC	42294299	42294304	0	6	5006	9518	5006	9512	0.0	0.526282590412111
chr19	TMEM145	42314852	42314893	0	42	0	2662	0	2620	0.0	0.0
chr19	TEX101	43414953	43415038	0	86	219	1606	219	1520	0.0	0.14407894736842106
chr19	ZNF576	43596586	43596638	0	53	3415	3483	3415	3430	0.0	0.9956268221574344
chr19	ZNF576	43596639	43596743	0	105	3415	3483	3415	3378	0.0	1.0109532267613972
chr19	ZNF221	43951401	43951410	0	10	11290	2719	11290	2709	0.0	4.167589516426726
chr19	ZNF155	43984246	43984348	357	103	18312	3441	17955	3338	3.466019417475728	5.378969442780108
chr19	ZNF155	43984232	43984348	357	117	18312	3441	17955	3324	3.051282051282051	5.4016245487364625
chr19	ZNF155	43984323	43984348	42	26	18312	3441	18270	3415	1.6153846153846154	5.349926793557833
chr19	ZNF155	43984232	43984245	0	14	18312	3441	18312	3427	0.0	5.343449080828713
chr19	ZNF155	43984246	43984322	315	77	18312	3441	17997	3364	4.090909090909091	5.349881093935791
chr19	ZNF155	43984232	43984322	315	91	18312	3441	17997	3350	3.4615384615384617	5.37223880597015
chr19	ZNF230	44008917	44008991	0	75	250826	6292	250826	6217	0.0	40.34518256393759
chr19	ZNF224	44094489	44094530	6541	42	83758	5649	77217	5607	155.73809523809524	13.771535580524345
chr19	ZNF234	44141616	44141733	1035	118	974353	5221	973318	5103	8.771186440677965	190.7344699196551
chr19	ZNF227	44228573	44228633	0	61	182032	4812	182032	4751	0.0	38.31446011366028
chr19	ZNF233	44266962	44267144	19	183	51739	4057	51720	3874	0.10382513661202186	13.35054207537429
chr19	ZNF233	44259939	44260208	4572	270	51739	4057	47167	3787	16.933333333333334	12.454977554792713
chr19	ZNF233	44260003	44260208	4204	206	51739	4057	47535	3851	20.40776699029126	12.343547130615425
chr19	ZNF233	44259939	44260002	368	64	51739	4057	51371	3993	5.75	12.86526421237165
chr19	PVR	44658766	44658900	0	135	142715	6106	142715	5971	0.0	23.901356556690672
chr19	BCL3	44758414	44758473	0	60	5232	3104	5232	3044	0.0	1.718791064388962
chr19	CBLC	44784402	44784417	2	16	6096	1624	6094	1608	0.125	3.7898009950248754
chr19	TOMM40	44901311	44901452	596	142	11016	1952	10420	1810	4.197183098591549	5.7569060773480665
chr19	APOE	44905842	44905923	0	82	0	2158	0	2076	0.0	0.0
chr19	APOC1	44916326	44916470	0	145	0	1238	0	1093	0.0	0.0
chr19	APOC1	44916360	44916470	0	111	0	1238	0	1127	0.0	0.0
chr19	APOC1	44916326	44916359	0	34	0	1238	0	1204	0.0	0.0
chr19	APOC1P1	44926830	44926832	0	3	16434	925	16434	922	0.0	17.824295010845987
chr19	APOC2	44948819	44948860	0	42	234	1267	234	1225	0.0	0.1910204081632653
chr19	CLPTM1	44954702	44955085	0	384	4553	4812	4553	4428	0.0	1.0282294489611563
chr19	CLASRP	45057883	45057898	0	16	836	4944	836	4928	0.0	0.16964285714285715
chr19	CLASRP	45068055	45068058	0	4	836	4944	836	4940	0.0	0.16923076923076924
chr19	GEMIN7	45079280	45079377	126	98	197	1913	71	1815	1.2857142857142858	0.03911845730027548
chr19	KLC3	45345752	45345799	0	48	653	3536	653	3488	0.0	0.1872133027522936
chr19	POLR1G	45406719	45407235	83248	517	148454	3199	65206	2682	161.0212765957447	24.312453392990307
chr19	POLR1G	45406719	45406724	3704	6	148454	3199	144750	3193	617.3333333333334	45.33354212339493
chr19	QPCTL	45692911	45693103	2146	193	3772	2550	1626	2357	11.119170984455959	0.6898599915146373
chr19	QPCTL	45693104	45693223	867	120	3772	2550	2905	2430	7.225	1.1954732510288066
chr19	QPCTL	45692911	45693223	3013	313	3772	2550	759	2237	9.626198083067093	0.33929369691551187
chr19	DM1-AS	45771676	45771684	0	9	26075	1031	26075	1022	0.0	25.513698630136986
chr19	AC006262.1	46204921	46204940	280	20	648310	4973	648030	4953	14.0	130.8358570563295
chr19	FKRP	46746087	46746090	0	4	51	5171	51	5167	0.0	0.009870330946390556
chr19	FKRP	46747295	46747305	0	11	51	5171	51	5160	0.0	0.009883720930232558
chr19	FKRP	46748718	46748884	0	167	51	5171	51	5004	0.0	0.010191846522781775
chr19	FKRP	46748666	46748884	0	219	51	5171	51	4952	0.0	0.01029886914378029
chr19	FKRP	46748622	46748884	0	263	51	5171	51	4908	0.0	0.01039119804400978
chr19	FKRP	46748666	46748717	0	52	51	5171	51	5119	0.0	0.009962883375659308
chr19	FKRP	46748622	46748717	0	96	51	5171	51	5075	0.0	0.010049261083743842
chr19	FKRP	46748622	46748665	0	44	51	5171	51	5127	0.0	0.00994733762434172
chr19	FKRP	46747682	46747732	0	51	51	5171	51	5120	0.0	0.0099609375
chr19	SAE1	47130859	47131028	0	170	343089	3760	343089	3590	0.0	95.56796657381615
chr19	SAE1	47131029	47131112	0	84	343089	3760	343089	3676	0.0	93.33215451577802
chr19	CCDC9	47257655	47257909	363	255	20940	3789	20577	3534	1.423529411764706	5.82258064516129
chr19	EHD2	47726225	47726319	26	95	57434	3852	57408	3757	0.2736842105263158	15.280276816608996
chr19	NOP53	47752545	47752559	0	15	1817	3435	1817	3420	0.0	0.5312865497076024
chr19	SELENOW	47780918	47781000	2832	83	70412	2027	67580	1944	34.12048192771084	34.76337448559671
chr19	ELSPBP1	48022335	48022339	0	5	3429	1130	3429	1125	0.0	3.048
chr19	ELSPBP1	48022335	48022376	0	42	3429	1130	3429	1088	0.0	3.151654411764706
chr19	ELSPBP1	48022340	48022376	0	37	3429	1130	3429	1093	0.0	3.1372369624885637
chr19	EMP3	48327562	48327623	0	62	0	1570	0	1508	0.0	0.0
chr19	EMP3	48327624	48327664	0	41	0	1570	0	1529	0.0	0.0
chr19	EMP3	48327562	48327664	0	103	0	1570	0	1467	0.0	0.0
chr19	CYTH2	48474950	48474953	0	4	0	6155	0	6151	0.0	0.0
chr19	SPHK2	48619544	48619689	0	146	215551	5205	215551	5059	0.0	42.60743229887329
chr19	SPHK2	48624431	48624439	3507	9	215551	5205	212044	5196	389.6666666666667	40.80908391070054
chr19	SPHK2	48624431	48624855	40023	425	215551	5205	175528	4780	94.17176470588235	36.72133891213389
chr19	SPHK2	48624440	48624855	36516	416	215551	5205	179035	4789	87.77884615384616	37.38463144706619
chr19	FUT2	48696080	48696089	140	10	18654	2363	18514	2353	14.0	7.868253293667658
chr19	NUCB1	48900932	48901121	927	190	88360	3350	87433	3160	4.878947368421053	27.66867088607595
chr19	NUCB1	48900373	48900658	408	286	88360	3350	87952	3064	1.4265734265734267	28.704960835509137
chr19	BAX	48954963	48954964	6	2	116995	1767	116989	1765	3.0	66.28271954674221
chr19	RUVBL2	49009872	49009882	0	11	1899	3172	1899	3161	0.0	0.6007592534008225
chr19	RUVBL2	48993903	48993923	14	21	1899	3172	1885	3151	0.6666666666666666	0.5982227864170104
chr19	CGB2	49032105	49032270	0	166	51	884	51	718	0.0	0.07103064066852367
chr19	SNRNP70	49102174	49103587	153	1414	204	4668	51	3254	0.1082036775106082	0.01567301782421635
chr19	SNRNP70	49102186	49103587	153	1402	204	4668	51	3266	0.10912981455064194	0.015615431720759338
chr19	SNRNP70	49102174	49102185	0	12	204	4668	204	4656	0.0	0.04381443298969072
chr19	TRPM4	49182868	49182922	0	55	6890	6483	6890	6428	0.0	1.0718730553827007
chr19	CD37	49335576	49335609	0	34	20848	3440	20848	3406	0.0	6.120963006459189
chr19	CD37	49335783	49335786	0	4	20848	3440	20848	3436	0.0	6.067520372526193
chr19	DKKL1	49363915	49364008	0	94	3349	1332	3349	1238	0.0	2.7051696284329565
chr19	KASH5	49393401	49393419	15	19	399270	5515	399255	5496	0.7894736842105263	72.64465065502183
chr19	ALDH16A1	49465872	49465905	0	34	381212	3286	381212	3252	0.0	117.22386223862239
chr19	RPL13A	49489913	49489922	50	10	71861	3165	71811	3155	5.0	22.761014263074486
chr19	RPL13A	49489923	49490090	428	168	71861	3165	71433	2997	2.5476190476190474	23.834834834834833
chr19	RPL13A	49489913	49490090	478	178	71861	3165	71383	2987	2.6853932584269664	23.897890860395044
chr19	RPL13A	49490577	49490600	2302	24	71861	3165	69559	3141	95.91666666666667	22.145495065265838
chr19	RPL13A	49490298	49490301	0	4	71861	3165	71861	3161	0.0	22.733628598544765
chr19	RPS11	49496472	49496497	2796	26	28167	1391	25371	1365	107.53846153846153	18.58681318681319
chr19	FCGRT	49513244	49513473	81180	230	274657	3363	193477	3133	352.95652173913044	61.754548356208105
chr19	RCN3	49534302	49534395	168	94	364	1663	196	1569	1.7872340425531914	0.12492033142128744
chr19	RCN3	49542669	49542752	0	84	364	1663	364	1579	0.0	0.2305256491450285
chr19	SCAF1	49646203	49646206	32	4	96712	4476	96680	4472	8.0	21.61896243291592
chr19	BCL2L12	49669116	49669164	0	49	41102	2223	41102	2174	0.0	18.906163753449864
chr19	PRMT1	49676261	49676439	4018	179	78864	4621	74846	4442	22.446927374301676	16.84961728950923
chr19	PRMT1	49680239	49680253	0	15	78864	4621	78864	4606	0.0	17.122014763352148
chr19	PRMT1	49677183	49677316	969	134	78864	4621	77895	4487	7.231343283582089	17.3601515489191
chr19	PRMT1	49677317	49677358	190	42	78864	4621	78674	4579	4.523809523809524	17.181480672635946
chr19	CPT1C	49691890	49691953	2033	64	87612	5093	85579	5029	31.765625	17.017100815271426
chr19	CPT1C	49691619	49691770	0	152	87612	5093	87612	4941	0.0	17.73163327261688
chr19	PTOV1	49850956	49851096	0	141	134864	4048	134864	3907	0.0	34.518556437164065
chr19	PTOV1	49851209	49851499	3519	291	134864	4048	131345	3757	12.092783505154639	34.96007452754858
chr19	ZNF473	50026123	50026173	8	51	330339	6268	330331	6217	0.1568627450980392	53.133504905903166
chr19	NR1H2	50378313	50378439	5892	127	264399	5355	258507	5228	46.39370078740158	49.44663351185922
chr19	POLD1	50409595	50409666	0	72	119377	4790	119377	4718	0.0	25.30245866892751
chr19	POLD1	50415560	50415590	36	31	119377	4790	119341	4759	1.1612903225806452	25.076906913217062
chr19	POLD1	50415591	50415602	0	12	119377	4790	119377	4778	0.0	24.984721640853913
chr19	POLD1	50415560	50415602	36	43	119377	4790	119341	4747	0.8372093023255814	25.14029913629661
chr19	SPIB	50423752	50423755	4	4	219834	4287	219830	4283	1.0	51.32617324305394
chr19	EMC10	50476659	50476723	0	65	155017	9750	155017	9685	0.0	16.00588538977801
chr19	KLK3	50855002	50855424	0	423	44	2916	44	2493	0.0	0.01764941837144003
chr19	KLK3	50858175	50858175	0	1	44	2916	44	2915	0.0	0.01509433962264151
chr19	KLK3	50858316	50858333	0	18	44	2916	44	2898	0.0	0.01518288474810214
chr19	KLK2	50874881	50874966	0	86	9608	5806	9608	5720	0.0	1.6797202797202797
chr19	KLK2	50877009	50877045	0	37	9608	5806	9608	5769	0.0	1.6654532847980585
chr19	SPACA6	51703336	51703337	0	2	0	4122	0	4120	0.0	0.0
chr19	ZNF613	51929825	51929896	0	72	0	3225	0	3153	0.0	0.0
chr19	PPP2R1A	52190175	52190294	1730	120	10684	7147	8954	7027	14.416666666666666	1.2742279777999146
chr19	PPP2R1A	52201514	52201694	423	181	10684	7147	10261	6966	2.3370165745856353	1.473011771461384
chr19	ZNF766	52274583	52274669	0	87	0	6941	0	6854	0.0	0.0
chr19	ZNF610	52347832	52347944	0	113	3673	3557	3673	3444	0.0	1.066492450638792
chr19	ZNF528	52397901	52397904	0	4	2660	7868	2660	7864	0.0	0.3382502543234995
chr19	ZNF534	52434082	52434120	468	39	6524	3285	6056	3246	12.0	1.8656808379544054
chr19	ZNF808	52527712	52527909	0	198	31410	5015	31410	4817	0.0	6.520656009964708
chr19	ZNF761	53445124	53445219	22	96	6961	5617	6939	5521	0.22916666666666666	1.2568375294330738
chr19	ZNF331	53555904	53555908	0	5	38078	8057	38078	8052	0.0	4.729011425732737
chr19	ZNF331	53555419	53555581	0	163	38078	8057	38078	7894	0.0	4.82366354193058
chr19	NDUFA3	54106971	54106978	0	8	153	2142	153	2134	0.0	0.07169634489222118
chr19	NDUFA3	54102889	54102898	0	10	153	2142	153	2132	0.0	0.07176360225140713
chr19	NDUFA3	54102889	54102959	0	71	153	2142	153	2071	0.0	0.07387735393529696
chr19	NDUFA3	54102899	54102959	0	61	153	2142	153	2081	0.0	0.0735223450264296
chr19	CNOT3	54153000	54153082	0	83	45	5828	45	5745	0.0	0.007832898172323759
chr19	TSEN34	54190372	54190450	0	79	0	2983	0	2904	0.0	0.0
chr19	TSEN34	54191038	54191041	0	4	0	2983	0	2979	0.0	0.0
chr19	RPS9	54200889	54200893	0	5	0	3672	0	3667	0.0	0.0
chr19	RPS9	54200889	54200961	0	73	0	3672	0	3599	0.0	0.0
chr19	RPS9	54200894	54200961	0	68	0	3672	0	3604	0.0	0.0
chr19	RPS9	54206463	54206724	0	262	0	3672	0	3410	0.0	0.0
chr19	TTYH1	54419303	54419306	0	4	1323	6918	1323	6914	0.0	0.19135088226786232
chr19	TTYH1	54419307	54419542	0	236	1323	6918	1323	6682	0.0	0.19799461239149954
chr19	TTYH1	54419303	54419542	0	240	1323	6918	1323	6678	0.0	0.19811320754716982
chr19	LENG8	54449307	54449310	0	4	250	5922	250	5918	0.0	0.042244001351808044
chr19	LILRB1	54633245	54633318	51	74	338180	4895	338129	4821	0.6891891891891891	70.13669363202655
chr19	KIR2DL4	54813229	54813295	0	67	0	1732	0	1665	0.0	0.0
chr19	FCAR	54888229	54888294	0	66	50	3333	50	3267	0.0	0.015304560759106214
chr19	FCAR	54888221	54888294	0	74	50	3333	50	3259	0.0	0.015342129487572876
chr19	FCAR	54888221	54888228	0	8	50	3333	50	3325	0.0	0.015037593984962405
chr19	NLRP2	54953286	54953369	4732	84	203387	6333	198655	6249	56.333333333333336	31.78988638182109
chr19	AC011476.3	55006290	55006299	0	10	0	1369	0	1359	0.0	0.0
chr19	RPL28	55386675	55386693	0	19	0	3440	0	3421	0.0	0.0
chr19	U2AF2	55669170	55669181	0	12	2777	4130	2777	4118	0.0	0.674356483729966
chr19	ZNF444	56141321	56141357	0	37	128616	4183	128616	4146	0.0	31.021707670043416
chr19	EDDM13	56297532	56297535	0	4	0	2340	0	2336	0.0	0.0
chr19	ZNF542P	56368221	56368223	0	3	0	4675	0	4672	0.0	0.0
chr19	ZNF542P	56368224	56368460	0	237	0	4675	0	4438	0.0	0.0
chr19	ZNF542P	56368221	56368460	0	240	0	4675	0	4435	0.0	0.0
chr19	ZNF542P	56374758	56374825	0	68	0	4675	0	4607	0.0	0.0
chr19	ZNF542P	56368461	56368466	0	6	0	4675	0	4669	0.0	0.0
chr19	ZNF582-AS1	56394039	56394053	0	15	0	1662	0	1647	0.0	0.0
chr19	ZNF582-AS1	56394054	56394441	0	388	0	1662	0	1274	0.0	0.0
chr19	ZNF583	56404430	56404452	0	23	51	7971	51	7948	0.0	0.006416708605938601
chr19	ZNF667-AS1	56477926	56478381	0	456	153	6804	153	6348	0.0	0.024102079395085067
chr19	ZNF667-AS1	56478277	56478381	0	105	153	6804	153	6699	0.0	0.02283922973578146
chr19	ZNF667-AS1	56478378	56478381	0	4	153	6804	153	6800	0.0	0.0225
chr19	ZNF667-AS1	56478294	56478381	0	88	153	6804	153	6716	0.0	0.022781417510422872
chr19	ZNF667-AS1	56478277	56478377	0	101	153	6804	153	6703	0.0	0.02282560047739818
chr19	ZNF667-AS1	56478294	56478377	0	84	153	6804	153	6720	0.0	0.022767857142857142
chr19	ZNF667-AS1	56478277	56478293	0	17	153	6804	153	6787	0.0	0.02254309709739207
chr19	AC006115.2	56690746	56690762	0	17	51131	16166	51131	16149	0.0	3.1662022416248683
chr19	AC006115.2	56790079	56791307	726	1229	51131	16166	50405	14937	0.5907241659886087	3.374506259623753
chr19	MIMT1	56841440	56841586	0	147	51	2040	51	1893	0.0	0.02694136291600634
chr19	USP29	57120230	57120317	0	88	5968	3882	5968	3794	0.0	1.5730100158144438
chr19	AURKC	57231115	57231120	0	6	51	1747	51	1741	0.0	0.02929350947731189
chr19	AURKC	57231121	57231306	51	186	51	1747	0	1561	0.27419354838709675	0.0
chr19	AURKC	57231115	57231306	51	192	51	1747	0	1555	0.265625	0.0
chr19	AURKC	57232681	57232685	0	5	51	1747	51	1742	0.0	0.029276693455797934
chr19	ZNF17	57411407	57411651	0	245	51	3186	51	2941	0.0	0.017341040462427744
chr19	ZIK1	57584390	57584612	0	223	51	5376	51	5153	0.0	0.009897147292839123
chr19	ZNF211	57633247	57633436	0	190	102	4549	102	4359	0.0	0.02339986235375086
chr19	ZNF551	57682123	57682244	0	122	51688	4707	51688	4585	0.0	11.273282442748092
chr19	AC008969.1	58003337	58004700	37891	1364	60516	5845	22625	4481	27.779325513196483	5.049096183887525
chr19	ZNF135	58060036	58060398	0	363	60582	6389	60582	6026	0.0	10.053435114503817
chr19	ZNF544	58246391	58246427	650	37	16719	6745	16069	6708	17.56756756756757	2.3954979129397733
chr19	ZNF544	58228947	58229256	459	310	16719	6745	16260	6435	1.4806451612903226	2.526806526806527
chr19	ZNF544	58230463	58230497	35	35	16719	6745	16684	6710	1.0	2.4864381520119223
chr19	A1BG-AS1	58353462	58353474	1279	13	125640	3102	124361	3089	98.38461538461539	40.259307219164775
chr19	AC012313.6	58364593	58364599	56	7	24121	1797	24065	1790	8.0	13.44413407821229
chr19	ZNF584	58409166	58409206	798	41	56591	2662	55793	2621	19.463414634146343	21.286913391835178
chr19	ZNF324B	58451705	58451743	0	39	45501	4041	45501	4002	0.0	11.369565217391305
chr19	ZNF324B	58451744	58451753	0	10	45501	4041	45501	4031	0.0	11.287769784172662
chr19	ZNF324B	58451705	58451753	0	49	45501	4041	45501	3992	0.0	11.39804609218437
chr19	ZNF324	58467184	58467758	153	575	14140	5390	13987	4815	0.26608695652173914	2.9048805815160956
chr19	TRIM28	58544212	58545097	0	886	31453	3904	31453	3018	0.0	10.42180251822399
chr20	NRSN2	347507	347512	0	6	887	2380	887	2374	0.0	0.37363100252737996
chr20	RBCK1	421007	421031	3067	25	205085	4749	202018	4724	122.68	42.76418289585097
chr20	RAD21L1	1226141	1226180	0	40	1071	2747	1071	2707	0.0	0.3956409309198375
chr20	RAD21L1	1226141	1226398	0	258	1071	2747	1071	2489	0.0	0.43029329047810366
chr20	RAD21L1	1226181	1226398	0	218	1071	2747	1071	2529	0.0	0.4234875444839858
chr20	SDCBP2-AS1	1325530	1325782	1776	253	734309	5316	732533	5063	7.019762845849803	144.68358680624135
chr20	SIRPA	1934755	1934766	0	12	3318	4967	3318	4955	0.0	0.6696266397578203
chr20	AL121899.1	2207389	2207519	0	131	0	548	0	417	0.0	0.0
chr20	TMC2	2613323	2614020	0	698	560407	5196	560407	4498	0.0	124.59026233881725
chr20	EBF4	2692951	2693148	0	198	21	3015	21	2817	0.0	0.007454739084132056
chr20	ITPA	3209567	3209617	20698	51	101937	1951	81239	1900	405.84313725490193	42.75736842105263
chr20	ITPA	3209536	3209617	32308	82	101937	1951	69629	1869	394.0	37.254681647940075
chr20	CDC25B	3795880	3796731	612	852	183122	4331	182510	3479	0.7183098591549296	52.46047714860592
chr20	AP5S1	3820759	3820854	63	96	24225	5482	24162	5386	0.65625	4.4860750092833275
chr20	AP5S1	3820703	3820854	63	152	24225	5482	24162	5330	0.4144736842105263	4.533208255159475
chr20	AP5S1	3820703	3820758	0	56	24225	5482	24225	5426	0.0	4.4646148175451525
chr20	PANK2	3908136	3908278	31228	143	300313	5369	269085	5226	218.37762237762237	51.48966704936854
chr20	PRNP	4686509	4686512	0	4	102	2740	102	2736	0.0	0.03728070175438596
chr20	MCM8	5951024	5951077	1895	54	187962	7711	186067	7657	35.092592592592595	24.300248138957816
chr20	CRLS1	6007400	6007410	0	11	13965	5374	13965	5363	0.0	2.6039530113742306
chr20	LINC01706	7360697	7360805	0	109	0	1390	0	1281	0.0	0.0
chr20	PLCB1	8150372	8150383	0	12	3834	16902	3834	16890	0.0	0.2269982238010657
chr20	PLCB1	8965152	8965435	0	284	3834	16902	3834	16618	0.0	0.23071368395715489
chr20	LINC01723	12951524	12951567	0	44	0	2909	0	2865	0.0	0.0
chr20	LINC01723	12950762	12950800	0	39	0	2909	0	2870	0.0	0.0
chr20	SNRPB2	16730065	16730164	0	100	0	2615	0	2515	0.0	0.0
chr20	MGME1	17970131	17970370	1018	240	2377	2236	1359	1996	4.241666666666666	0.6808617234468938
chr20	KAT14	18138052	18138554	0	503	111073	4878	111073	4375	0.0	25.388114285714284
chr20	KAT14	18138445	18138554	0	110	111073	4878	111073	4768	0.0	23.295511744966444
chr20	KAT14	18138336	18138554	0	219	111073	4878	111073	4659	0.0	23.84052371753595
chr20	KAT14	18138400	18138554	0	155	111073	4878	111073	4723	0.0	23.517467711200506
chr20	KAT14	18138505	18138554	0	50	111073	4878	111073	4828	0.0	23.006006628003313
chr20	KAT14	18138336	18138444	0	109	111073	4878	111073	4769	0.0	23.290626965820927
chr20	KAT14	18138400	18138444	0	45	111073	4878	111073	4833	0.0	22.982205669356507
chr20	KAT14	18138336	18138399	0	64	111073	4878	111073	4814	0.0	23.072912339011218
chr20	KAT14	18138445	18138504	0	60	111073	4878	111073	4818	0.0	23.053756745537566
chr20	KAT14	18138336	18138504	0	169	111073	4878	111073	4709	0.0	23.587385856869822
chr20	KAT14	18138400	18138504	0	105	111073	4878	111073	4773	0.0	23.271108317619944
chr20	SEC23B	18507670	18507990	0	321	76019	4075	76019	3754	0.0	20.250133191262652
chr20	SEC23B	18507973	18507990	0	18	76019	4075	76019	4057	0.0	18.737737244269166
chr20	SEC23B	18507991	18508030	0	40	76019	4075	76019	4035	0.0	18.83990086741016
chr20	SEC23B	18507670	18508030	0	361	76019	4075	76019	3714	0.0	20.46822832525579
chr20	SEC23B	18507973	18508030	0	58	76019	4075	76019	4017	0.0	18.924321633059495
chr20	SEC23B	18507991	18508054	0	64	76019	4075	76019	4011	0.0	18.95263026676639
chr20	SEC23B	18508031	18508054	0	24	76019	4075	76019	4051	0.0	18.765490002468525
chr20	SEC23B	18507973	18508054	0	82	76019	4075	76019	3993	0.0	19.038066616579012
chr20	SEC23B	18507991	18508297	72739	307	76019	4075	3280	3768	236.93485342019545	0.8704883227176221
chr20	SEC23B	18508031	18508297	72739	267	76019	4075	3280	3808	272.43071161048687	0.8613445378151261
chr20	SEC23B	18508055	18508297	72739	243	76019	4075	3280	3832	299.3374485596708	0.8559498956158664
chr20	SEC23B	18507973	18508297	72739	325	76019	4075	3280	3750	223.81230769230768	0.8746666666666667
chr20	NAA20	20017450	20018041	9764	592	29466	2189	19702	1597	16.493243243243242	12.336881653099562
chr20	CFAP61	20052592	20052661	0	70	51	7956	51	7886	0.0	0.006467156987065686
chr20	CFAP61	20052592	20052732	0	141	51	7956	51	7815	0.0	0.006525911708253359
chr20	CFAP61	20052662	20052732	0	71	51	7956	51	7885	0.0	0.006467977171845276
chr20	KIZ	21205531	21205584	0	54	2332	3152	2332	3098	0.0	0.7527437056165268
chr20	LINC01727	21615528	21615888	0	361	102	7415	102	7054	0.0	0.014459880918627729
chr20	AL118508.1	23180209	23180247	0	39	0	3797	0	3758	0.0	0.0
chr20	AL118508.1	23180529	23180793	0	265	0	3797	0	3532	0.0	0.0
chr20	AL118508.1	23186551	23187640	0	1090	0	3797	0	2707	0.0	0.0
chr20	CST8	23491184	23491342	0	159	0	914	0	755	0.0	0.0
chr20	AL121894.3	23656693	23657210	0	518	0	3234	0	2716	0.0	0.0
chr20	ZNF337-AS1	25624427	25624446	0	20	59579	3182	59579	3162	0.0	18.842188488298547
chr20	AL390198.1	25751339	25752073	357	735	11893	1841	11536	1106	0.4857142857142857	10.430379746835444
chr20	FAM182A	26072824	26072873	0	50	10804	10300	10804	10250	0.0	1.054048780487805
chr20	AL121904.1	26188625	26189017	0	393	0	1326	0	933	0.0	0.0
chr20	HM13	31568225	31568280	0	56	1479	7787	1479	7731	0.0	0.19130772215754754
chr20	HM13	31538262	31538554	0	293	1479	7787	1479	7494	0.0	0.19735788630904724
chr20	HM13	31538360	31538554	0	195	1479	7787	1479	7592	0.0	0.19481032665964174
chr20	HM13	31538262	31538359	0	98	1479	7787	1479	7689	0.0	0.1923527116660164
chr20	TTLL9	31870950	31870953	0	4	2953	5733	2953	5729	0.0	0.5154477221155525
chr20	TM9SF4	32109756	32110039	0	284	853	5182	853	4898	0.0	0.17415271539403837
chr20	ASXL1	32359335	32359642	0	308	641407	10047	641407	9739	0.0	65.85963651298901
chr20	ASXL1	32359643	32359791	0	149	641407	10047	641407	9898	0.0	64.80167710648615
chr20	BPIFB6	33031745	33031747	0	3	2713	1692	2713	1689	0.0	1.6062759029011249
chr20	ZNF341	33757323	33757343	0	21	2859	5472	2859	5451	0.0	0.5244909190974133
chr20	RALY	34072206	34072330	2894	125	230306	7527	227412	7402	23.152	30.723047824912186
chr20	ITCH	34477861	34477906	0	46	34947	10673	34947	10627	0.0	3.2885103980427215
chr20	DYNLRB1	34516462	34516876	231	415	2116	2460	1885	2045	0.5566265060240964	0.921760391198044
chr20	ACSS2	34875128	34875137	0	10	0	5112	0	5102	0.0	0.0
chr20	ACSS2	34914118	34914171	0	54	0	5112	0	5058	0.0	0.0
chr20	ACSS2	34876748	34876823	0	76	0	5112	0	5036	0.0	0.0
chr20	MYH7B	35001527	35001592	0	66	98	8201	98	8135	0.0	0.012046711739397665
chr20	CEP250	35455238	35455242	50	5	154498	10901	154448	10896	10.0	14.17474302496329
chr20	ROMO1	35699452	35699456	0	5	903	681	903	676	0.0	1.3357988165680474
chr20	ROMO1	35699457	35699494	0	38	903	681	903	643	0.0	1.4043545878693624
chr20	AAR2	36236504	36236782	0	279	0	3106	0	2827	0.0	0.0
chr20	DLGAP4	36526007	36526077	0	71	47725	7378	47725	7307	0.0	6.531408238675243
chr20	TGIF2	36573653	36573745	510	93	1455	3979	945	3886	5.483870967741935	0.2431806484817293
chr20	RAB5IF	36609731	36609758	0	28	16567	1286	16567	1258	0.0	13.169316375198727
chr20	NNAT	37522385	37522438	0	54	0	1332	0	1278	0.0	0.0
chr20	NNAT	37522434	37522438	0	5	0	1332	0	1327	0.0	0.0
chr20	NNAT	37522385	37522433	0	49	0	1332	0	1283	0.0	0.0
chr20	LINC01746	37571264	37571298	594	35	35253	1197	34659	1162	16.97142857142857	29.827022375215147
chr20	LINC01746	37577212	37577439	19587	228	35253	1197	15666	969	85.90789473684211	16.1671826625387
chr20	SNHG11	38446853	38447012	0	160	0	4261	0	4101	0.0	0.0
chr20	SNHG11	38446941	38447012	0	72	0	4261	0	4189	0.0	0.0
chr20	SNHG11	38446949	38447012	0	64	0	4261	0	4197	0.0	0.0
chr20	SNHG11	38446968	38447012	0	45	0	4261	0	4216	0.0	0.0
chr20	SNHG11	38446853	38446940	0	88	0	4261	0	4173	0.0	0.0
chr20	SNHG11	38446853	38446948	0	96	0	4261	0	4165	0.0	0.0
chr20	SNHG11	38446941	38446948	0	8	0	4261	0	4253	0.0	0.0
chr20	SNHG11	38446853	38446967	0	115	0	4261	0	4146	0.0	0.0
chr20	SNHG11	38446941	38446967	0	27	0	4261	0	4234	0.0	0.0
chr20	SNHG11	38446949	38446967	0	19	0	4261	0	4242	0.0	0.0
chr20	SNHG11	38447624	38448093	0	470	0	4261	0	3791	0.0	0.0
chr20	RALGAPB	38472928	38473069	0	142	104	11777	104	11635	0.0	0.008938547486033519
chr20	ADIG	38586144	38586257	0	114	0	1037	0	923	0.0	0.0
chr20	LINC01370	40007964	40008459	0	496	153	4191	153	3695	0.0	0.041407307171853855
chr20	LINC01370	40006359	40006442	0	84	153	4191	153	4107	0.0	0.03725346968590212
chr20	LPIN3	41357958	41358034	0	77	0	4686	0	4609	0.0	0.0
chr20	L3MBTL1	43530420	43530889	116007	470	1799354	12176	1683347	11706	246.82340425531916	143.80206731590638
chr20	SGK2	43567964	43567999	0	36	488748	4836	488748	4800	0.0	101.8225
chr20	SGK2	43576380	43576383	0	4	488748	4836	488748	4832	0.0	101.14817880794702
chr20	IFT52	43591030	43591054	0	25	12178	2501	12178	2476	0.0	4.918416801292407
chr20	OSER1-DT	44211078	44211356	0	279	48	9245	48	8966	0.0	0.005353557885344635
chr20	HNF4A	44428458	44428487	14	30	799777	7355	799763	7325	0.4666666666666667	109.18266211604096
chr20	TTPAL	44484429	44484530	0	102	69152	7062	69152	6960	0.0	9.935632183908046
chr20	CCN5	44720114	44720121	0	8	494806	4985	494806	4977	0.0	99.41852521599357
chr20	PABPC1L	44935498	44935502	0	5	0	3854	0	3849	0.0	0.0
chr20	RBPJL	45316581	45316590	0	10	60093	2786	60093	2776	0.0	21.647334293948127
chr20	DBNDD2	45408939	45409036	0	98	0	2769	0	2671	0.0	0.0
chr20	PIGT	45421534	45421583	0	50	204	11655	204	11605	0.0	0.017578629900904783
chr20	PIGT	45416655	45416694	0	40	204	11655	204	11615	0.0	0.01756349547998278
chr20	PIGT	45416665	45416694	0	30	204	11655	204	11625	0.0	0.017548387096774195
chr20	PIGT	45419591	45419638	0	48	204	11655	204	11607	0.0	0.01757560093047299
chr20	PIGT	45416655	45416664	0	10	204	11655	204	11645	0.0	0.017518248175182483
chr20	PIGT	45418980	45419395	0	416	204	11655	204	11239	0.0	0.018151081057033544
chr20	PIGT	45421584	45421664	0	81	204	11655	204	11574	0.0	0.01762571280456195
chr20	PIGT	45421534	45421664	0	131	204	11655	204	11524	0.0	0.01770218674071503
chr20	UBE2C	45815541	45815745	6	205	6	1293	0	1088	0.02926829268292683	0.0
chr20	SNX21	45835110	45835116	0	7	147635	3701	147635	3694	0.0	39.96616134271792
chr20	SNX21	45833941	45834018	0	78	147635	3701	147635	3623	0.0	40.74937896770632
chr20	CTSA	45892881	45892887	0	7	24659	7771	24659	7764	0.0	3.176069036579083
chr20	CTSA	45891380	45891425	0	46	24659	7771	24659	7725	0.0	3.1921035598705503
chr20	CTSA	45891763	45891822	11	60	24659	7771	24648	7711	0.18333333333333332	3.1964725716508884
chr20	CTSA	45891380	45891449	0	70	24659	7771	24659	7701	0.0	3.202051681599792
chr20	CTSA	45891426	45891449	0	24	24659	7771	24659	7747	0.0	3.183038595585388
chr20	CTSA	45895134	45895138	0	5	24659	7771	24659	7766	0.0	3.1752510945145507
chr20	CTSA	45897041	45897806	306	766	24659	7771	24353	7005	0.39947780678851175	3.476516773733048
chr20	NCOA3	47649098	47649109	0	12	85205	8442	85205	8430	0.0	10.1073546856465
chr20	LINC00494	48360884	48360975	0	92	333	5148	333	5056	0.0	0.0658623417721519
chr20	LINC00494	48366634	48367059	0	426	333	5148	333	4722	0.0	0.07052096569250317
chr20	ZFAS1	49278398	49278716	0	319	2295	7898	2295	7579	0.0	0.3028103971500198
chr20	ZFAS1	49278717	49278738	0	22	2295	7898	2295	7876	0.0	0.2913915693245302
chr20	LINC01273	50172227	50172330	0	104	102	1682	102	1578	0.0	0.06463878326996197
chr20	PELATON	50277614	50277980	50	367	356	7207	306	6840	0.1362397820163488	0.04473684210526316
chr20	PELATON	50276391	50276566	0	176	356	7207	356	7031	0.0	0.05063291139240506
chr20	LINC01270	50311920	50312014	0	95	5256	5084	5256	4989	0.0	1.053517739025857
chr20	AL031674.1	52671843	52671960	0	118	187	3306	187	3188	0.0	0.05865746549560853
chr20	DOK5	54475905	54476012	12	108	51	2491	39	2383	0.1111111111111111	0.016365925304238357
chr20	LINC01440	55423247	55423527	0	281	0	5095	0	4814	0.0	0.0
chr20	LINC01440	55423528	55424041	0	514	0	5095	0	4581	0.0	0.0
chr20	AL109828.1	55775645	55776666	306	1022	306	1444	0	422	0.299412915851272	0.0
chr20	CSTF1	56392714	56392815	0	102	0	4800	0	4698	0.0	0.0
chr20	CSTF1	56395722	56395759	0	38	0	4800	0	4762	0.0	0.0
chr20	RAE1	57351359	57351422	0	64	0	3313	0	3249	0.0	0.0
chr20	RAE1	57351920	57351998	0	79	0	3313	0	3234	0.0	0.0
chr20	RAE1	57351571	57351919	0	349	0	3313	0	2964	0.0	0.0
chr20	APCDD1L-DT	58519600	58519625	594	26	24977	5587	24383	5561	22.846153846153847	4.384643049811185
chr20	STX16	58651415	58651434	0	20	0	5049	0	5029	0.0	0.0
chr20	STX16	58651407	58651434	0	28	0	5049	0	5021	0.0	0.0
chr20	STX16	58651407	58651414	0	8	0	5049	0	5041	0.0	0.0
chr20	STX16	58651435	58651531	0	97	0	5049	0	4952	0.0	0.0
chr20	STX16	58651415	58651531	0	117	0	5049	0	4932	0.0	0.0
chr20	STX16	58651407	58651531	0	125	0	5049	0	4924	0.0	0.0
chr20	STX16	58667598	58667608	0	11	0	5049	0	5038	0.0	0.0
chr20	STX16	58652088	58652138	0	51	0	5049	0	4998	0.0	0.0
chr20	GNAS	58839941	58840886	0	946	51	12313	51	11367	0.0	0.0044866719451042494
chr20	GNAS	58888905	58888908	0	4	51	12313	51	12309	0.0	0.004143309773336583
chr20	GNAS	58888905	58889046	0	142	51	12313	51	12171	0.0	0.004190288390436283
chr20	GNAS	58888909	58889046	0	138	51	12313	51	12175	0.0	0.004188911704312115
chr20	GNAS	58889214	58889353	0	140	51	12313	51	12173	0.0	0.004189599934280785
chr20	GNAS	58889333	58889353	0	21	51	12313	51	12292	0.0	0.004149040026033193
chr20	GNAS	58889354	58889549	0	196	51	12313	51	12117	0.0	0.004208962614508541
chr20	GNAS	58889214	58889549	0	336	51	12313	51	11977	0.0	0.004258161476162645
chr20	GNAS	58889407	58889549	0	143	51	12313	51	12170	0.0	0.00419063270336894
chr20	GNAS	58889333	58889549	0	217	51	12313	51	12096	0.0	0.004216269841269841
chr20	GNAS	58889354	58889406	0	53	51	12313	51	12260	0.0	0.004159869494290375
chr20	GNAS	58889214	58889406	0	193	51	12313	51	12120	0.0	0.004207920792079208
chr20	GNAS	58889333	58889406	0	74	51	12313	51	12239	0.0	0.004167007108423891
chr20	GNAS	58889214	58889332	0	119	51	12313	51	12194	0.0	0.004182384779399704
chr20	NELFCD	58993676	58993764	0	89	51	5233	51	5144	0.0	0.009914463452566096
chr20	NELFCD	58994192	58994239	0	48	51	5233	51	5185	0.0	0.009836065573770493
chr20	EDN3	59322418	59322452	0	35	0	3293	0	3258	0.0	0.0
chr20	EDN3	59322453	59322482	0	30	0	3293	0	3263	0.0	0.0
chr20	EDN3	59322418	59322482	0	65	0	3293	0	3228	0.0	0.0
chr20	MIR646HG	60154502	60154506	0	5	2778	22150	2778	22145	0.0	0.1254459245879431
chr20	MIR646HG	60098964	60099032	0	69	2778	22150	2778	22081	0.0	0.12580951949639962
chr20	MIR646HG	60098964	60099069	0	106	2778	22150	2778	22044	0.0	0.1260206859009254
chr20	MIR646HG	60099033	60099069	0	37	2778	22150	2778	22113	0.0	0.1256274589607923
chr20	MIR646HG	60097522	60097664	0	143	2778	22150	2778	22007	0.0	0.12623256236651975
chr20	MIR646HG	60378221	60378255	0	35	2778	22150	2778	22115	0.0	0.12561609767126386
chr20	CDH4	61743628	61743789	0	162	14982	7534	14982	7372	0.0	2.0322843190450355
chr20	SS18L1	62158749	62158942	1836	194	5387	4351	3551	4157	9.463917525773196	0.8542217945633871
chr20	OSBPL2	62242435	62242661	0	227	175526	10826	175526	10599	0.0	16.560618926313804
chr20	OSBPL2	62279340	62279519	1116	180	175526	10826	174410	10646	6.2	16.382678940447118
chr20	OSBPL2	62279350	62279519	1096	170	175526	10826	174430	10656	6.447058823529412	16.36918168168168
chr20	OSBPL2	62279340	62279349	20	10	175526	10826	175506	10816	2.0	16.22651627218935
chr20	LAMA5-AS1	62353209	62353335	0	127	1654	846	1654	719	0.0	2.3004172461752432
chr20	SLC17A9	62962735	62962754	0	20	510	5474	510	5454	0.0	0.09350935093509351
chr20	ARFGAP1	63273411	63273518	0	108	0	6173	0	6065	0.0	0.0
chr20	COL20A1	63328128	63328145	0	18	0	9868	0	9850	0.0	0.0
chr20	COL20A1	63306040	63306060	0	21	0	9868	0	9847	0.0	0.0
chr20	RTEL1	63658460	63658466	0	7	0	5965	0	5958	0.0	0.0
chr20	RTEL1	63695481	63695650	0	170	0	5965	0	5795	0.0	0.0
chr20	RTEL1	63658714	63658752	0	39	0	5965	0	5926	0.0	0.0
chr20	ZGPAT	63733713	63733739	0	27	0	3337	0	3310	0.0	0.0
chr20	ZGPAT	63708119	63708188	0	70	0	3337	0	3267	0.0	0.0
chr20	ZGPAT	63708170	63708188	0	19	0	3337	0	3318	0.0	0.0
chr20	ZGPAT	63708119	63708169	0	51	0	3337	0	3286	0.0	0.0
chr20	AL121845.3	63736397	63736712	0	316	0	3201	0	2885	0.0	0.0
chr20	SLC2A4RG	63742365	63742615	0	251	0	2703	0	2452	0.0	0.0
chr20	PCMTD2	64255871	64255924	0	54	0	5895	0	5841	0.0	0.0
chr20	C20ORF96	290586	290589	0	4	78461	1737	78461	1733	0.0	45.27466820542412
chr20	CSNK2A1	543631	543670	0	40	94575	19650	94575	19610	0.0	4.822794492605813
chr20	CSNK2A1	540827	540888	0	62	94575	19650	94575	19588	0.0	4.828211149683479
chr20	CSNK2A1	539198	539673	51	476	94575	19650	94524	19174	0.10714285714285714	4.929800771878585
chr20	FKBP1A	1371021	1371118	1581	98	82406	4404	80825	4306	16.132653061224488	18.770320483046913
chr20	SIRPB2	1479699	1479992	0	294	0	4491	0	4197	0.0	0.0
chr20	SIRPB2	1479699	1479924	0	226	0	4491	0	4265	0.0	0.0
chr20	SIRPB2	1479925	1479992	0	68	0	4491	0	4423	0.0	0.0
chr20	SIRPD	1551690	1551869	931	180	176	647	-755	467	5.1722222222222225	-1.6167023554603854
chr20	PDYN	1983975	1984201	0	227	204	3531	204	3304	0.0	0.06174334140435835
chr20	ZNF343	2508799	2508879	0	81	574	4645	574	4564	0.0	0.12576687116564417
chr20	IDH3B	2658637	2658757	0	121	235	2575	235	2454	0.0	0.09576202118989405
chr20	IDH3B	2660029	2660066	0	38	235	2575	235	2537	0.0	0.09262908947575876
chr20	SLC4A11	3238979	3239093	703	115	92029	4340	91326	4225	6.113043478260869	21.615621301775146
chr20	C20ORF27	3760006	3760080	0	75	3191	1361	3191	1286	0.0	2.481337480559876
chr20	C20ORF27	3767208	3767661	2928	454	3191	1361	263	907	6.4493392070484585	0.28996692392502754
chr20	PRNT	4740139	4740375	0	237	0	2101	0	1864	0.0	0.0
chr20	PRNT	4740139	4740598	0	460	0	2101	0	1641	0.0	0.0
chr20	PRNT	4740376	4740598	0	223	0	2101	0	1878	0.0	0.0
chr20	TMEM230	5112742	5112959	0	218	596130	3050	596130	2832	0.0	210.4978813559322
chr20	TMEM230	5112729	5112959	0	231	596130	3050	596130	2819	0.0	211.46860588861298
chr20	TMEM230	5112729	5112741	0	13	596130	3050	596130	3037	0.0	196.2891010865986
chr20	TMEM230	5112719	5112959	0	241	596130	3050	596130	2809	0.0	212.22143111427553
chr20	TMEM230	5112719	5112741	0	23	596130	3050	596130	3027	0.0	196.93756194251733
chr20	TMEM230	5112719	5112728	0	10	596130	3050	596130	3040	0.0	196.0953947368421
chr20	LINC00658	5433788	5433961	0	174	51	2892	51	2718	0.0	0.018763796909492272
chr20	LINC00658	5433788	5434113	0	326	51	2892	51	2566	0.0	0.019875292283710055
chr20	LINC00658	5433788	5434170	0	383	51	2892	51	2509	0.0	0.020326823435631726
chr20	LINC00658	5445503	5445623	0	121	51	2892	51	2771	0.0	0.018404907975460124
chr20	LINC00658	5434171	5434356	0	186	51	2892	51	2706	0.0	0.018847006651884702
chr20	LINC00658	5432450	5432541	0	92	51	2892	51	2800	0.0	0.018214285714285714
chr20	LINC00658	5434171	5434196	0	26	51	2892	51	2866	0.0	0.01779483600837404
chr20	LINC00658	5434114	5434170	0	57	51	2892	51	2835	0.0	0.01798941798941799
chr20	LINC00658	5434114	5434356	0	243	51	2892	51	2649	0.0	0.01925254813137033
chr20	LINC00658	5433962	5434113	0	152	51	2892	51	2740	0.0	0.018613138686131386
chr20	LINC00658	5433962	5434170	0	209	51	2892	51	2683	0.0	0.01900857249347745
chr20	LINC00654	5504022	5504296	0	275	23237	8091	23237	7816	0.0	2.973004094165814
chr20	LINC00654	5526339	5526636	17956	298	23237	8091	5281	7793	60.25503355704698	0.677659437957141
chr20	FERMT1	6119403	6119419	0	17	2682	4862	2682	4845	0.0	0.5535603715170279
chr20	SNAP25-AS1	10219221	10219235	0	15	23011	11293	23011	11278	0.0	2.040344032629899
chr20	SNAP25-AS1	10104167	10104284	0	118	23011	11293	23011	11175	0.0	2.059149888143177
chr20	LINC00687	11871898	11871984	0	87	0	1995	0	1908	0.0	0.0
chr20	TASP1	13528432	13528444	0	13	501	2914	501	2901	0.0	0.17269906928645296
chr20	RRBP1	17614736	17614738	0	3	170410	5199	170410	5196	0.0	32.7963818321786
chr20	RRBP1	17658595	17658603	0	9	170410	5199	170410	5190	0.0	32.834296724470136
chr20	SNX5	17968374	17968698	9336	325	322598	6160	313262	5835	28.726153846153846	53.68671808054842
chr20	AL049646.1	18328697	18328891	0	195	5718	3242	5718	3047	0.0	1.8765999343616673
chr20	DZANK1	18466861	18466994	0	134	51349	6644	51349	6510	0.0	7.887711213517665
chr20	LINC00652	18794167	18794469	0	303	51	4119	51	3816	0.0	0.013364779874213837
chr20	AL121830.1	19696543	19696614	0	72	0	2243	0	2171	0.0	0.0
chr20	AL121830.1	19696317	19696614	0	298	0	2243	0	1945	0.0	0.0
chr20	AL121830.1	19696317	19696542	0	226	0	2243	0	2017	0.0	0.0
chr20	AL121830.1	19693551	19693601	0	51	0	2243	0	2192	0.0	0.0
chr20	CRNKL1	20052291	20052477	0	187	337	4575	337	4388	0.0	0.0768003646308113
chr20	CRNKL1	20052291	20052473	0	183	337	4575	337	4392	0.0	0.0767304189435337
chr20	CRNKL1	20052474	20052477	0	4	337	4575	337	4571	0.0	0.07372566178079194
chr20	LINC00237	21093196	21093736	51	541	51	2419	0	1878	0.09426987060998152	0.0
chr20	LINC01427	22274403	22274406	0	4	51	6326	51	6322	0.0	0.008067067383739322
chr20	LINC01427	22276420	22280337	51	3918	51	6326	0	2408	0.013016845329249618	0.0
chr20	LINC00656	23128964	23128984	0	21	5272	1914	5272	1893	0.0	2.7849973586899104
chr20	AL035252.2	25144278	25144295	0	18	0	4406	0	4388	0.0	0.0
chr20	AL035252.2	25147956	25148597	0	642	0	4406	0	3764	0.0	0.0
chr20	ABHD12	25339621	25339693	48	73	49808	4504	49760	4431	0.6575342465753424	11.229970661250283
chr20	MIR663AHG	26194297	26194384	0	88	36	6568	36	6480	0.0	0.005555555555555556
chr20	MIR663AHG	26209146	26209161	0	16	36	6568	36	6552	0.0	0.005494505494505495
chr20	MIR663AHG	26209146	26209168	0	23	36	6568	36	6545	0.0	0.0055003819709702065
chr20	MIR663AHG	26209146	26209262	0	117	36	6568	36	6451	0.0	0.005580530150364285
chr20	MIR663AHG	26209122	26209145	0	24	36	6568	36	6544	0.0	0.005501222493887531
chr20	MIR663AHG	26209122	26209161	0	40	36	6568	36	6528	0.0	0.0055147058823529415
chr20	MIR663AHG	26209122	26209168	0	47	36	6568	36	6521	0.0	0.00552062567090937
chr20	MIR663AHG	26209162	26209168	0	7	36	6568	36	6561	0.0	0.0054869684499314125
chr20	MIR663AHG	26207669	26207672	0	4	36	6568	36	6564	0.0	0.005484460694698354
chr20	MIR663AHG	26208998	26209021	0	24	36	6568	36	6544	0.0	0.005501222493887531
chr20	MIR663AHG	26208864	26208997	0	134	36	6568	36	6434	0.0	0.005595275101025801
chr20	MIR663AHG	26208864	26209021	0	158	36	6568	36	6410	0.0	0.005616224648985959
chr20	MIR663AHG	26192128	26192131	0	4	36	6568	36	6564	0.0	0.005484460694698354
chr20	MIR663AHG	26209146	26209247	0	102	36	6568	36	6466	0.0	0.005567584287039901
chr20	MIR663AHG	26209169	26209262	0	94	36	6568	36	6474	0.0	0.005560704355885079
chr20	MIR663AHG	26208292	26208301	0	10	36	6568	36	6558	0.0	0.0054894784995425435
chr20	MIR663AHG	26209169	26209247	0	79	36	6568	36	6489	0.0	0.005547850208044383
chr20	FRG1CP	28601602	28601655	0	54	0	2742	0	2688	0.0	0.0
chr20	BCL2L1	31721654	31721842	0	189	0	3964	0	3775	0.0	0.0
chr20	BCL2L1	31723847	31723862	0	16	0	3964	0	3948	0.0	0.0
chr20	BCL2L1	31723734	31723862	0	129	0	3964	0	3835	0.0	0.0
chr20	BCL2L1	31723734	31723846	0	113	0	3964	0	3851	0.0	0.0
chr20	DUSP15	31870316	31870574	0	259	51	3591	51	3332	0.0	0.015306122448979591
chr20	DUSP15	31869809	31870046	0	238	51	3591	51	3353	0.0	0.01521025946913212
chr20	NECAB3	33659496	33659651	867	156	79506	4125	78639	3969	5.5576923076923075	19.813303099017386
chr20	RALY-AS1	33991774	33993058	3238	1285	83037	8725	79799	7440	2.5198443579766536	10.725672043010753
chr20	GSS	34936762	34936763	0	2	0	5144	0	5142	0.0	0.0
chr20	GSS	34951723	34951788	0	66	0	5144	0	5078	0.0	0.0
chr20	MMP24OS	35278008	35278044	0	37	98583	5505	98583	5468	0.0	18.029078273591807
chr20	EIF6	35284175	35284379	3109	205	86150	1643	83041	1438	15.165853658536586	57.74756606397775
chr20	EIF6	35284725	35284763	1314	39	86150	1643	84836	1604	33.69230769230769	52.890274314214466
chr20	UQCC1	35381917	35381924	0	8	146229	4188	146229	4180	0.0	34.98301435406699
chr20	FER1L4	35560122	35560161	27	40	18832	9174	18805	9134	0.675	2.0587913291000657
chr20	FER1L4	35576595	35576650	0	56	18832	9174	18832	9118	0.0	2.0653652116692256
chr20	CPNE1	35626566	35626733	10297	168	59737	2948	49440	2780	61.291666666666664	17.784172661870503
chr20	CPNE1	35664759	35664877	144	119	59737	2948	59593	2829	1.2100840336134453	21.065040650406505
chr20	CPNE1	35626562	35626565	200	4	59737	2948	59537	2944	50.0	20.223165760869566
chr20	CPNE1	35626562	35626733	10497	172	59737	2948	49240	2776	61.02906976744186	17.737752161383284
chr20	CPNE1	35664759	35664800	144	42	59737	2948	59593	2906	3.4285714285714284	20.506882312456984
chr20	CPNE1	35664801	35664877	0	77	59737	2948	59737	2871	0.0	20.807035876001393
chr20	NFS1	35699191	35699308	0	118	43987	5562	43987	5444	0.0	8.07990448199853
chr20	NFS1	35698744	35699043	355	300	43987	5562	43632	5262	1.1833333333333333	8.291904218928163
chr20	DSN1	36773393	36773660	1071	268	79798	2481	78727	2213	3.996268656716418	35.57478535924085
chr20	SAMHD1	36935028	36935079	0	52	33	8463	33	8411	0.0	0.003923433598858638
chr20	BLCAP	37527573	37527629	0	57	79	5359	79	5302	0.0	0.014900037721614485
chr20	TGM2	38166402	38166433	0	32	0	7962	0	7930	0.0	0.0
chr20	SNHG17	38422086	38422090	0	5	378	11084	378	11079	0.0	0.03411860276198213
chr20	SNHG17	38422086	38422094	0	9	378	11084	378	11075	0.0	0.03413092550790068
chr20	SNHG17	38434503	38434518	0	16	378	11084	378	11068	0.0	0.03415251174557282
chr20	SNHG17	38435026	38435195	0	170	378	11084	378	10914	0.0	0.034634414513468936
chr20	SNHG17	38422091	38422289	0	199	378	11084	378	10885	0.0	0.03472668810289389
chr20	SNHG17	38422091	38422094	0	4	378	11084	378	11080	0.0	0.03411552346570397
chr20	SNHG17	38427246	38427678	0	433	378	11084	378	10651	0.0	0.03548962538728758
chr20	SNHG17	38422086	38422289	0	204	378	11084	378	10880	0.0	0.03474264705882353
chr20	SNHG17	38422095	38422289	0	195	378	11084	378	10889	0.0	0.034713931490494995
chr20	SNHG17	38425934	38426417	0	484	378	11084	378	10600	0.0	0.035660377358490564
chr20	SNHG17	38429868	38429952	0	85	378	11084	378	10999	0.0	0.034366760614601324
chr20	ZHX3	41202056	41204243	51	2188	51	4825	0	2637	0.02330895795246801	0.0
chr20	ZHX3	41202056	41202281	0	226	51	4825	51	4599	0.0	0.011089367253750815
chr20	ZHX3	41268978	41268988	0	11	51	4825	51	4814	0.0	0.0105941005400914
chr20	ZHX3	41202282	41204243	51	1962	51	4825	0	2863	0.02599388379204893	0.0
chr20	ZHX3	41272138	41272202	0	65	51	4825	51	4760	0.0	0.010714285714285714
chr20	PTPRT	43189643	43189644	0	2	17020	12975	17020	12973	0.0	1.3119556000925
chr20	LINC01260	44663204	44663352	0	149	0	1005	0	856	0.0	0.0
chr20	WFDC5	45110373	45110398	0	26	0	1048	0	1022	0.0	0.0
chr20	WFDC11	45670177	45670180	0	4	0	659	0	655	0.0	0.0
chr20	ELMO2	46393980	46394047	0	68	326	4584	326	4516	0.0	0.07218777679362268
chr20	ZNF334	46513409	46513495	0	87	51	6001	51	5914	0.0	0.008623605005072709
chr20	ZNF334	46512539	46513408	0	870	51	6001	51	5131	0.0	0.00993958292730462
chr20	ZNF334	46512539	46513495	0	957	51	6001	51	5044	0.0	0.010111022997620936
chr20	TP53RK	46689126	46689130	0	5	0	3187	0	3182	0.0	0.0
chr20	ZMYND8	47238757	47238894	0	138	1277	7654	1277	7516	0.0	0.16990420436402343
chr20	SULF2	47785834	47786046	0	213	34610	6098	34610	5885	0.0	5.881053525913339
chr20	ZNFX1	49277929	49278019	0	91	858	9357	858	9266	0.0	0.09259658968271099
chr20	UBE2V1	50115698	50115828	0	131	306	4832	306	4701	0.0	0.0650925335035099
chr20	PEDS1	50130855	50130863	0	9	51	7939	51	7930	0.0	0.006431273644388399
chr20	LINC01275	50165968	50166028	0	61	0	1006	0	945	0.0	0.0
chr20	DPM1	50941104	50941127	0	24	153	1217	153	1193	0.0	0.12824811399832356
chr20	KCNG1	51022653	51022868	0	216	0	5421	0	5205	0.0	0.0
chr20	SALL4	51790021	51791331	48	1311	48	5780	0	4469	0.036613272311212815	0.0
chr20	AC006076.1	53800930	53801141	0	212	0	794	0	582	0.0	0.0
chr20	AURKA	56392153	56392166	0	14	0	2904	0	2890	0.0	0.0
chr20	AURKA	56391942	56392166	0	225	0	2904	0	2679	0.0	0.0
chr20	AURKA	56391942	56392152	0	211	0	2904	0	2693	0.0	0.0
chr20	CTCFL	57525027	57525472	0	446	7077	8679	7077	8233	0.0	0.859589457063039
chr20	CTCFL	57515464	57515712	50	249	7077	8679	7027	8430	0.20080321285140562	0.833570581257414
chr20	PMEPA1	57710459	57710465	0	7	0	5734	0	5727	0.0	0.0
chr20	AL354984.2	58071720	58071999	0	280	0	1026	0	746	0.0	0.0
chr20	PPP4R1L	58235239	58235275	0	37	0	9090	0	9053	0.0	0.0
chr20	PHACTR3-AS1	59628093	59628096	0	4	0	2250	0	2246	0.0	0.0
chr20	AL160412.1	61436479	61437039	1709	561	25171	3576	23462	3015	3.0463458110516934	7.781757877280265
chr20	AL160412.1	61436185	61436478	52416	294	25171	3576	-27245	3282	178.28571428571428	-8.301340645947594
chr20	TAF4	62006509	62006544	0	36	2142	7829	2142	7793	0.0	0.27486205569100475
chr20	PSMA7	62139695	62139779	68	85	4367	1759	4299	1674	0.8	2.568100358422939
chr20	LINC00659	62776795	62776804	0	10	0	1374	0	1364	0.0	0.0
chr20	LINC00659	62776455	62776804	0	350	0	1374	0	1024	0.0	0.0
chr20	LINC00659	62776311	62776794	0	484	0	1374	0	890	0.0	0.0
chr20	LINC00659	62776311	62776804	0	494	0	1374	0	880	0.0	0.0
chr20	LINC00659	62776311	62776454	0	144	0	1374	0	1230	0.0	0.0
chr20	LINC00659	62776455	62776794	0	340	0	1374	0	1034	0.0	0.0
chr20	DIDO1	62926431	62926437	15	7	1109202	13292	1109187	13285	2.142857142857143	83.49168234851336
chr20	CHRNA4	63361089	63361175	0	87	0	11311	0	11224	0.0	0.0
chr21	CU633967.1	5584976	5585063	0	88	0	5133	0	5045	0.0	0.0
chr21	SMIM11B	7745368	7745650	0	283	0	4297	0	4014	0.0	0.0
chr21	FP236383.3	8383922	8384098	0	177	0	4407	0	4230	0.0	0.0
chr21	LINC01666	8759262	8759861	0	600	0	843	0	243	0.0	0.0
chr21	CR381653.1	9325101	9325223	0	123	0	1910	0	1787	0.0	0.0
chr21	BAGE2	10497100	10497109	60	10	108	4098	48	4088	6.0	0.011741682974559686
chr21	BAGE2	10498967	10498986	0	20	108	4098	108	4078	0.0	0.026483570377636097
chr21	ABCC13	14313121	14313131	0	11	0	8015	0	8004	0.0	0.0
chr21	MIR99AHG	16041354	16041464	0	111	255	42307	255	42196	0.0	0.006043226846146554
chr21	MIR99AHG	16589468	16589557	0	90	255	42307	255	42217	0.0	0.006040220764147145
chr21	MIR99AHG	16589541	16589557	0	17	255	42307	255	42290	0.0	0.006029794277607
chr21	MIR99AHG	16589414	16589557	0	144	255	42307	255	42163	0.0	0.006047956739321206
chr21	MIR99AHG	16070549	16070567	0	19	255	42307	255	42288	0.0	0.0060300794551645855
chr21	MIR99AHG	16070568	16070892	0	325	255	42307	255	41982	0.0	0.006074031727883378
chr21	MIR99AHG	16070549	16070892	0	344	255	42307	255	41963	0.0	0.006076781926935634
chr21	MIR99AHG	16125009	16125447	0	439	255	42307	255	41868	0.0	0.006090570364001146
chr21	MIR99AHG	16589414	16589467	0	54	255	42307	255	42253	0.0	0.006035074432584668
chr21	MIR99AHG	16589468	16589540	0	73	255	42307	255	42234	0.0	0.006037789458729933
chr21	MIR99AHG	16589414	16589540	0	127	255	42307	255	42180	0.0	0.00604551920341394
chr21	MIR99AHG	16420573	16420576	0	4	255	42307	255	42303	0.0	0.0060279412807602295
chr21	MIR99AHG	16589558	16589736	0	179	255	42307	255	42128	0.0	0.006052981390049374
chr21	MIR99AHG	16589468	16589736	0	269	255	42307	255	42038	0.0	0.006065940339692659
chr21	MIR99AHG	16589541	16589736	0	196	255	42307	255	42111	0.0	0.006055424948350787
chr21	MIR99AHG	16589414	16589736	0	323	255	42307	255	41984	0.0	0.006073742378048781
chr21	LINC01684	24438434	24438443	0	10	0	9534	0	9524	0.0	0.0
chr21	JAM2	25711556	25711568	0	13	0	5938	0	5925	0.0	0.0
chr21	GABPA	25735071	25735578	0	508	0	5752	0	5244	0.0	0.0
chr21	AP001442.1	25934190	25934366	0	177	0	2606	0	2429	0.0	0.0
chr21	LINC00113	27746033	27746036	0	4	0	616	0	612	0.0	0.0
chr21	LINC00161	28539529	28539884	0	356	0	872	0	516	0.0	0.0
chr21	GRIK1-AS1	29759011	29759014	0	4	0	3102	0	3098	0.0	0.0
chr21	SOD1	31659785	31659841	0	57	0	1981	0	1924	0.0	0.0
chr21	EVA1C	32412194	32413013	0	820	14066	4328	14066	3508	0.0	4.009692132269099
chr21	EVA1C	32501487	32501495	0	9	14066	4328	14066	4319	0.0	3.2567724010187544
chr21	EVA1C	32501496	32501538	0	43	14066	4328	14066	4285	0.0	3.2826137689614936
chr21	EVA1C	32501487	32501538	0	52	14066	4328	14066	4276	0.0	3.2895229186155284
chr21	PAXBP1-AS1	32730662	32732825	0	2164	1122	9689	1122	7525	0.0	0.14910299003322258
chr21	PAXBP1-AS1	32730662	32731577	0	916	1122	9689	1122	8773	0.0	0.12789239712755043
chr21	C21ORF62-AS1	32772309	32772310	0	2	3538	9197	3538	9195	0.0	0.38477433387710713
chr21	C21ORF62-AS1	32772309	32772320	0	12	3538	9197	3538	9185	0.0	0.38519324986390857
chr21	C21ORF62-AS1	32772311	32772320	0	10	3538	9197	3538	9187	0.0	0.38510939370850117
chr21	C21ORF62-AS1	32797043	32797060	0	18	3538	9197	3538	9179	0.0	0.3854450375857937
chr21	OLIG2	33026027	33026260	264	234	2550	2724	2286	2490	1.1282051282051282	0.9180722891566265
chr21	OLIG1	33071686	33071705	0	20	4998	1450	4998	1430	0.0	3.495104895104895
chr21	AP000290.1	33152952	33152978	0	27	0	879	0	852	0.0	0.0
chr21	LINC00649	33931268	33931742	2193	475	89925	8737	87732	8262	4.616842105263158	10.618736383442267
chr21	LINC00649	33931353	33931742	2193	390	89925	8737	87732	8347	5.623076923076923	10.510602611716784
chr21	LINC00310	34183119	34183192	0	74	977	3286	977	3212	0.0	0.30417185554171855
chr21	AP000317.2	34262922	34262938	0	17	0	647	0	630	0.0	0.0
chr21	SMIM11A	34375897	34376179	0	283	0	7871	0	7588	0.0	0.0
chr21	MORC3	36375219	36375308	0	90	5286	6433	5286	6343	0.0	0.8333596090178149
chr21	TTC3	37073365	37073473	0	109	132	15936	132	15827	0.0	0.008340178176533772
chr21	DYRK1A	37365835	37366185	0	351	204518	22440	204518	22089	0.0	9.258816605550274
chr21	DYRK1A	37506224	37506354	0	131	204518	22440	204518	22309	0.0	9.167510870052444
chr21	DSCR8	38122412	38122668	23350	257	62873	835	39523	578	90.85603112840467	68.37889273356402
chr21	DSCR8	38122484	38122668	16077	185	62873	835	46796	650	86.9027027027027	71.99384615384615
chr21	DSCR8	38122412	38122483	7273	72	62873	835	55600	763	101.01388888888889	72.870249017038
chr21	KCNJ15	38297012	38297023	0	12	30542	10358	30542	10346	0.0	2.9520587666731104
chr21	ETS2	38819767	38819871	0	105	1661	4917	1661	4812	0.0	0.34517871986699916
chr21	GET1	39390864	39391476	0	613	0	8656	0	8043	0.0	0.0
chr21	GET1	39390920	39391476	0	557	0	8656	0	8099	0.0	0.0
chr21	GET1	39406059	39406298	0	240	0	8656	0	8416	0.0	0.0
chr21	GET1	39390864	39390919	0	56	0	8656	0	8600	0.0	0.0
chr21	GET1	39380487	39380556	0	70	0	8656	0	8586	0.0	0.0
chr21	GET1	39380557	39380921	0	365	0	8656	0	8291	0.0	0.0
chr21	GET1	39414005	39414591	0	587	0	8656	0	8069	0.0	0.0
chr21	SH3BGR	39445893	39445929	0	37	0	1493	0	1456	0.0	0.0
chr21	SH3BGR	39446082	39446098	0	17	0	1493	0	1476	0.0	0.0
chr21	DSCAM-AS1	40383456	40383584	328	129	1255	1772	927	1643	2.5426356589147288	0.5642118076688983
chr21	BACE2	41241940	41241947	0	8	102	9570	102	9562	0.0	0.010667224430035557
chr21	MX1	41435961	41436029	0	69	51	6893	51	6824	0.0	0.007473622508792497
chr21	LINC00112	41715835	41715860	0	26	0	1428	0	1402	0.0	0.0
chr21	LINC00112	41715861	41716083	0	223	0	1428	0	1205	0.0	0.0
chr21	UMODL1	42088474	42088480	0	7	51	7308	51	7301	0.0	0.006985344473359814
chr21	UMODL1	42085413	42085474	0	62	51	7308	51	7246	0.0	0.0070383659950317414
chr21	ABCG1	42288038	42288073	0	36	51	6143	51	6107	0.0	0.00835107253970853
chr21	UBASH3A	42404059	42404184	0	126	0	3935	0	3809	0.0	0.0
chr21	UBASH3A	42437581	42437596	0	16	0	3935	0	3919	0.0	0.0
chr21	LINC00319	43450922	43450972	0	51	2652	4286	2652	4235	0.0	0.6262101534828808
chr21	PDXK	43732443	43732647	0	205	0	11305	0	11100	0.0	0.0
chr21	RRP1	43789696	43789762	0	67	0	4003	0	3936	0.0	0.0
chr21	ITGB2-AS1	44921328	44921351	0	24	6563	2443	6563	2419	0.0	2.7131045886730054
chr21	FAM207A	44943793	44943837	156	45	1672	1408	1516	1363	3.466666666666667	1.1122523844460748
chr21	ADARB1	45222108	45223577	231180	1470	1089577	8105	858397	6635	157.26530612244898	129.37407686510926
chr21	LINC00334	45234477	45234506	360	30	1508	2102	1148	2072	12.0	0.5540540540540541
chr21	LINC00205	45288166	45288244	0	79	6039	5252	6039	5173	0.0	1.1674076937947033
chr21	COL18A1	45456177	45456881	408	705	101809	8507	101401	7802	0.5787234042553191	12.996795693411945
chr21	PCBP3	45914026	45914094	0	69	55208	6336	55208	6267	0.0	8.809318653263125
chr21	MCM3AP-AS1	46229267	46229363	2185	97	17082	9232	14897	9135	22.52577319587629	1.6307608100711548
chr21	YBEY	46286989	46287123	13265	135	69252	1807	55987	1672	98.25925925925925	33.485047846889955
chr21	YBEY	46286416	46286737	13184	322	69252	1807	56068	1485	40.94409937888199	37.75622895622896
chr21	YBEY	46286738	46286743	576	6	69252	1807	68676	1801	96.0	38.132148806218765
chr21	PCNT	46346982	46346998	0	17	68271	11691	68271	11674	0.0	5.848124036320027
chr21	PCNT	46431979	46432215	51	237	68271	11691	68220	11454	0.21518987341772153	5.9559979046621265
chr21	PRMT2	46635764	46636547	0	784	10517	5492	10517	4708	0.0	2.233857264231096
chr21	FP236241.1	7676337	7676424	0	88	0	5983	0	5895	0.0	0.0
chr21	SMIM34B	7788860	7789472	0	613	0	2314	0	1701	0.0	0.0
chr21	AF127936.1	14753323	14753799	0	477	51	4958	51	4481	0.0	0.011381388083017184
chr21	LINC00320	20782249	20782305	0	57	215	16661	215	16604	0.0	0.012948687063358227
chr21	LINC00320	20757218	20757309	0	92	215	16661	215	16569	0.0	0.012976039592009174
chr21	ATP5PF	25734852	25734937	0	86	0	1583	0	1497	0.0	0.0
chr21	ATP5PF	25734938	25734987	0	50	0	1583	0	1533	0.0	0.0
chr21	ATP5PF	25735314	25735485	0	172	0	1583	0	1411	0.0	0.0
chr21	ATP5PF	25734988	25735485	0	498	0	1583	0	1085	0.0	0.0
chr21	ATP5PF	25734988	25735313	0	326	0	1583	0	1257	0.0	0.0
chr21	ADAMTS1	26840275	26840312	0	38	0	7313	0	7275	0.0	0.0
chr21	ADAMTS1	26842796	26842988	0	193	0	7313	0	7120	0.0	0.0
chr21	AF165147.1	28577152	28577273	0	122	102	9450	102	9328	0.0	0.010934819897084048
chr21	PAXBP1	32755212	32755228	0	17	1143	6180	1143	6163	0.0	0.18546162583157552
chr21	AP000289.1	33114385	33114514	0	130	306	2512	306	2382	0.0	0.12846347607052896
chr21	DNAJC28	33491065	33491416	0	352	0	2483	0	2131	0.0	0.0
chr21	DNAJC28	33491417	33491600	0	184	0	2483	0	2299	0.0	0.0
chr21	GART	33542586	33542658	0	73	102	6725	102	6652	0.0	0.015333734215273603
chr21	GART	33528514	33528517	0	4	102	6725	102	6721	0.0	0.015176313048653474
chr21	GART	33542590	33542658	0	69	102	6725	102	6656	0.0	0.01532451923076923
chr21	GART	33542547	33542585	0	39	102	6725	102	6686	0.0	0.01525575830092731
chr21	GART	33542547	33542658	0	112	102	6725	102	6613	0.0	0.015424164524421594
chr21	RUNX1	35049080	35049166	100	87	229296	15480	229196	15393	1.1494252873563218	14.889625154290911
chr21	SETD4	36060281	36060345	0	65	0	6423	0	6358	0.0	0.0
chr21	CBR3-AS1	36134631	36135298	0	668	1039	8894	1039	8226	0.0	0.1263068319961099
chr21	CBR3-AS1	36134631	36134888	0	258	1039	8894	1039	8636	0.0	0.12031032885595183
chr21	CBR3-AS1	36134631	36134824	0	194	1039	8894	1039	8700	0.0	0.11942528735632184
chr21	CBR3-AS1	36134825	36135298	0	474	1039	8894	1039	8420	0.0	0.12339667458432305
chr21	CBR3-AS1	36134825	36134888	0	64	1039	8894	1039	8830	0.0	0.11766704416761042
chr21	HLCS	36947332	36948164	0	833	0	10535	0	9702	0.0	0.0
chr21	HLCS	36980640	36980782	0	143	0	10535	0	10392	0.0	0.0
chr21	PIGP	37072990	37072998	0	9	0	4217	0	4208	0.0	0.0
chr21	AP001042.1	38904229	38904953	0	725	63652	10133	63652	9408	0.0	6.765731292517007
chr21	AP001042.1	38904229	38904903	0	675	63652	10133	63652	9458	0.0	6.729964051596532
chr21	AP001042.1	38904904	38904953	0	50	63652	10133	63652	10083	0.0	6.312803729048894
chr21	PSMG1	39183063	39183250	0	188	0	2159	0	1971	0.0	0.0
chr21	BRWD1	39210785	39210864	0	80	51	16239	51	16159	0.0	0.003156135899498731
chr21	BRWD1	39255644	39255663	0	20	51	16239	51	16219	0.0	0.0031444602009988287
chr21	BRWD1	39264890	39264984	0	95	51	16239	51	16144	0.0	0.0031590683845391476
chr21	HMGN1	39347113	39347245	0	133	0	4327	0	4194	0.0	0.0
chr21	LCA5L	39445449	39445723	0	275	0	4442	0	4167	0.0	0.0
chr21	TMPRSS2	41494355	41494478	0	124	0	6341	0	6217	0.0	0.0
chr21	TMPRSS2	41506982	41507572	0	591	0	6341	0	5750	0.0	0.0
chr21	TMPRSS2	41506982	41507696	0	715	0	6341	0	5626	0.0	0.0
chr21	TMPRSS2	41507573	41507696	0	124	0	6341	0	6217	0.0	0.0
chr21	TMPRSS2	41507573	41508079	0	507	0	6341	0	5834	0.0	0.0
chr21	TMPRSS2	41507573	41507948	0	376	0	6341	0	5965	0.0	0.0
chr21	TMPRSS2	41507697	41508079	0	383	0	6341	0	5958	0.0	0.0
chr21	TMPRSS2	41507697	41507948	0	252	0	6341	0	6089	0.0	0.0
chr21	TMPRSS2	41507949	41508079	0	131	0	6341	0	6210	0.0	0.0
chr21	WDR4	42873550	42873601	5	52	5	2750	0	2698	0.09615384615384616	0.0
chr21	WDR4	42879406	42879511	0	106	5	2750	5	2644	0.0	0.0018910741301059002
chr21	WDR4	42879406	42879519	0	114	5	2750	5	2636	0.0	0.0018968133535660092
chr21	WDR4	42879512	42879519	0	8	5	2750	5	2742	0.0	0.0018234865061998542
chr21	HSF2BP	43633262	43633270	0	9	0	1918	0	1909	0.0	0.0
chr21	AATBC	43808800	43810229	0	1430	0	4099	0	2669	0.0	0.0
chr21	CFAP410	44331842	44331846	200	5	95838	5144	95638	5139	40.0	18.610235454368553
chr21	CFAP410	44330462	44330821	16349	360	95838	5144	79489	4784	45.41388888888889	16.61559364548495
chr21	UBE2G2	44774566	44774719	0	154	0	6326	0	6172	0.0	0.0
chr21	SUMO3	44808996	44809045	50	50	156	2738	106	2688	1.0	0.03943452380952381
chr21	SUMO3	44813861	44813974	11	114	156	2738	145	2624	0.09649122807017543	0.055259146341463415
chr21	ITGB2	44910599	44910723	853	125	22384	6221	21531	6096	6.824	3.531988188976378
chr21	LINC01547	44938760	44939591	51	832	4743	3203	4692	2371	0.06129807692307692	1.9789118515394348
chr21	LINC01547	44938760	44938834	0	75	4743	3203	4743	3128	0.0	1.516304347826087
chr21	LINC01547	44937538	44939591	2703	2054	4743	3203	2040	1149	1.315968841285297	1.7754569190600522
chr21	LINC01547	44937538	44938834	2652	1297	4743	3203	2091	1906	2.0447185813415576	1.097061909758657
chr21	LINC01547	44937538	44938759	2652	1222	4743	3203	2091	1981	2.1702127659574466	1.0555275113579001
chr21	LINC01547	44937538	44938442	2448	905	4743	3203	2295	2298	2.7049723756906077	0.9986945169712794
chr21	LINC01547	44938443	44939591	255	1149	4743	3203	4488	2054	0.22193211488250653	2.1850048685491723
chr21	LINC01547	44938443	44938834	204	392	4743	3203	4539	2811	0.5204081632653061	1.6147278548559232
chr21	LINC01547	44938443	44938759	204	317	4743	3203	4539	2886	0.6435331230283912	1.5727650727650728
chr21	POFUT2	45283351	45283381	0	31	1781	5242	1781	5211	0.0	0.34177701017079254
chr21	COL18A1-AS1	45423769	45424882	0	1114	102	3458	102	2344	0.0	0.043515358361774746
chr21	FTCD	46136914	46136983	0	70	0	3340	0	3270	0.0	0.0
chr21	FTCD	46136914	46136977	0	64	0	3340	0	3276	0.0	0.0
chr21	FTCD	46136978	46136983	0	6	0	3340	0	3334	0.0	0.0
chr21	LSS	46191065	46191074	4847	10	1517213	7259	1512366	7249	484.7	208.63098358394262
chr21	LSS	46222629	46222661	188	33	1517213	7259	1517025	7226	5.696969696969697	209.93980071962358
chr21	LSS	46228684	46228730	66	47	1517213	7259	1517147	7212	1.4042553191489362	210.364254021076
chr21	MCM3AP	46285698	46286149	16280	452	752321	9494	736041	9042	36.017699115044245	81.40245520902455
chr21	MCM3AP	46285698	46285801	3254	104	752321	9494	749067	9390	31.28846153846154	79.77284345047923
chr21	C21ORF58	46322638	46323135	0	498	2090	4107	2090	3609	0.0	0.5791077860903298
chr22	GAB4	16969612	16969941	0	330	15	3152	15	2822	0.0	0.005315379163713678
chr22	ADA2	17189941	17191681	0	1741	0	8720	0	6979	0.0	0.0
chr22	PI4KAP1	18537291	18537293	0	3	16489	3930	16489	3927	0.0	4.1988795518207285
chr22	PRODH	18936014	18936388	0	375	232	7184	232	6809	0.0	0.03407255103539433
chr22	ESS2	19138214	19138301	0	88	31038	6013	31038	5925	0.0	5.2384810126582275
chr22	CLTCL1	19201328	19201389	18	62	20799	6720	20781	6658	0.2903225806451613	3.121207569840793
chr22	UFD1	19454748	19454800	283	53	125232	7600	124949	7547	5.339622641509434	16.55611501258778
chr22	UFD1	19475469	19475494	20	26	125232	7600	125212	7574	0.7692307692307693	16.531819382096646
chr22	UFD1	19478762	19478823	0	62	125232	7600	125232	7538	0.0	16.61342531175378
chr22	GNB1L	19854659	19854818	4362	160	6073	1660	1711	1500	27.2625	1.1406666666666667
chr22	GNB1L	19854659	19854680	615	22	6073	1660	5458	1638	27.954545454545453	3.3321123321123323
chr22	TXNRD2	19877039	19877107	212	69	10718	6767	10506	6698	3.072463768115942	1.5685279187817258
chr22	TXNRD2	19881035	19881079	0	45	10718	6767	10718	6722	0.0	1.5944659327581077
chr22	TRMT2A	20112910	20112954	25054	45	285369	3878	260315	3833	556.7555555555556	67.91416644925646
chr22	TRMT2A	20116037	20116056	0	20	285369	3878	285369	3858	0.0	73.96811819595645
chr22	TRMT2A	20116882	20117027	81	146	285369	3878	285288	3732	0.5547945205479452	76.44372990353698
chr22	KLHL22	20464857	20465332	51	476	1596	4144	1545	3668	0.10714285714285714	0.4212104689203926
chr22	PI4KA	20726487	20726496	0	10	87995	10761	87995	10751	0.0	8.184820016742629
chr22	TUBA3FP	21013781	21014077	0	297	0	2126	0	1829	0.0	0.0
chr22	P2RX6P	21044883	21044960	0	78	0	477	0	399	0.0	0.0
chr22	FAM230H	21322194	21322301	0	108	267694	5886	267694	5778	0.0	46.32987192800277
chr22	PI4KAP2	21475991	21476000	150	10	3632	6796	3482	6786	15.0	0.5131152372531683
chr22	PI4KAP2	21514129	21514132	8	4	3632	6796	3624	6792	2.0	0.5335689045936396
chr22	YDJC	21629542	21629600	0	59	0	1668	0	1609	0.0	0.0
chr22	PPM1F	21937672	21938202	0	531	4947	9572	4947	9041	0.0	0.5471739851786307
chr22	TOP3B	21982413	21982728	141529	316	354925	6344	213396	6028	447.876582278481	35.40079628400796
chr22	TOP3B	21975904	21975979	26588	76	354925	6344	328337	6268	349.8421052631579	52.383056796426295
chr22	TOP3B	21982199	21982728	150333	530	354925	6344	204592	5814	283.64716981132074	35.189542483660134
chr22	TOP3B	21982199	21982412	8804	214	354925	6344	346121	6130	41.14018691588785	56.463458401305054
chr22	PRAME	22558970	22559173	0	204	612	3814	612	3610	0.0	0.16952908587257617
chr22	PRAME	22556811	22557543	255	733	612	3814	357	3081	0.3478854024556617	0.11587147030185005
chr22	CES5AP1	23373594	23373628	0	35	0	1570	0	1535	0.0	0.0
chr22	GUSBP11	23686830	23686836	0	7	8836	7702	8836	7695	0.0	1.1482781026640676
chr22	GUSBP11	23717030	23717106	0	77	8836	7702	8836	7625	0.0	1.1588196721311474
chr22	GUSBP11	23717030	23717084	0	55	8836	7702	8836	7647	0.0	1.1554858114293187
chr22	GUSBP11	23690231	23690234	0	4	8836	7702	8836	7698	0.0	1.1478306053520395
chr22	GUSBP11	23717085	23717106	0	22	8836	7702	8836	7680	0.0	1.1505208333333334
chr22	GUSBP11	23686789	23686829	0	41	8836	7702	8836	7661	0.0	1.1533742331288344
chr22	GUSBP11	23686789	23686836	0	48	8836	7702	8836	7654	0.0	1.1544290567023778
chr22	GSTT2B	23958284	23958325	0	42	0	1113	0	1071	0.0	0.0
chr22	PIWIL3	24762306	24762396	40	91	528	3826	488	3735	0.43956043956043955	0.13065595716198125
chr22	LRP5L	25359826	25359914	0	89	2058	3674	2058	3585	0.0	0.5740585774058578
chr22	AL022329.1	25564089	25564355	0	267	0	1300	0	1033	0.0	0.0
chr22	MYO18B-AS1	25895110	25895336	0	227	3091	5997	3091	5770	0.0	0.5357019064124784
chr22	MYO18B-AS1	25900269	25900363	0	95	3091	5997	3091	5902	0.0	0.523720772619451
chr22	MYO18B-AS1	25895097	25895109	0	13	3091	5997	3091	5984	0.0	0.5165441176470589
chr22	MYO18B-AS1	25895097	25895336	0	240	3091	5997	3091	5757	0.0	0.5369115858954316
chr22	MYO18B-AS1	25900678	25900823	0	146	3091	5997	3091	5851	0.0	0.5282857631174158
chr22	AL022337.1	26162748	26163143	0	396	0	2023	0	1627	0.0	0.0
chr22	HPS4	26483673	26483763	0	91	0	7752	0	7661	0.0	0.0
chr22	HPS4	26483673	26483743	0	71	0	7752	0	7681	0.0	0.0
chr22	HPS4	26483744	26483763	0	20	0	7752	0	7732	0.0	0.0
chr22	PITPNB	27919101	27919170	0	70	0	5142	0	5072	0.0	0.0
chr22	CHEK2	28741768	28741780	0	13	1581	4425	1581	4412	0.0	0.3583408884859474
chr22	CHEK2	28730419	28730454	0	36	1581	4425	1581	4389	0.0	0.36021872863978127
chr22	CHEK2	28724564	28724884	0	321	1581	4425	1581	4104	0.0	0.385233918128655
chr22	XBP1	28799041	28799055	0	15	0	3034	0	3019	0.0	0.0
chr22	THOC5	29528936	29529160	0	225	5726	7903	5726	7678	0.0	0.745767126855952
chr22	THOC5	29543414	29543427	0	14	5726	7903	5726	7889	0.0	0.7258207630878438
chr22	THOC5	29553447	29553669	0	223	5726	7903	5726	7680	0.0	0.7455729166666667
chr22	ZMAT5	29766871	29766947	0	77	119154	3206	119154	3129	0.0	38.080536912751676
chr22	ASCC2	29801993	29802113	0	121	9396	5178	9396	5057	0.0	1.858018588095709
chr22	ASCC2	29801993	29802060	0	68	9396	5178	9396	5110	0.0	1.838747553816047
chr22	CASTOR1	30289292	30289383	0	92	508	2662	508	2570	0.0	0.19766536964980544
chr22	CASTOR1	30289292	30289295	0	4	508	2662	508	2658	0.0	0.1911211437170805
chr22	CASTOR1	30289296	30289383	0	88	508	2662	508	2574	0.0	0.19735819735819735
chr22	RNF215	30379481	30379546	0	66	36315	5055	36315	4989	0.0	7.27901383042694
chr22	RNF215	30379481	30379709	0	229	36315	5055	36315	4826	0.0	7.524865312888521
chr22	GAL3ST1	30564824	30565075	0	252	14	3105	14	2853	0.0	0.004907115317209955
chr22	GAL3ST1	30558259	30558277	0	19	14	3105	14	3086	0.0	0.004536616979909268
chr22	GAL3ST1	30572686	30572801	0	116	14	3105	14	2989	0.0	0.00468384074941452
chr22	PES1	30584364	30584414	0	51	3521	3945	3521	3894	0.0	0.9042116076014381
chr22	PES1	30605413	30605459	0	47	3521	3945	3521	3898	0.0	0.9032837352488455
chr22	PES1	30591793	30591808	0	16	3521	3945	3521	3929	0.0	0.8961567828964113
chr22	DUSP18	30666806	30667460	15	655	495	2739	480	2084	0.022900763358778626	0.23032629558541268
chr22	MORC2	30928018	30928026	0	9	10186	8653	10186	8644	0.0	1.1783896344285054
chr22	EIF4ENIF1	31454143	31454178	0	36	862	5677	862	5641	0.0	0.152809785499025
chr22	PRR14L	31749992	31750070	0	79	28159	11816	28159	11737	0.0	2.399165033654256
chr22	C22ORF24	31927093	31927097	315	5	2613	5555	2298	5550	63.0	0.41405405405405404
chr22	C22ORF24	31937915	31937987	42	73	2613	5555	2571	5482	0.5753424657534246	0.4689894199197373
chr22	LARGE1	33922476	33922619	0	144	0	14082	0	13938	0.0	0.0
chr22	MB	35617076	35617161	0	86	0	2060	0	1974	0.0	0.0
chr22	APOL4	36201699	36201991	1012	293	1173	4268	161	3975	3.453924914675768	0.04050314465408805
chr22	APOL4	36195094	36195309	0	216	1173	4268	1173	4052	0.0	0.2894866732477789
chr22	FOXRED2	36506911	36507007	0	97	510	5528	510	5431	0.0	0.09390535812925796
chr22	EIF3D	36528791	36528878	0	88	5611	3779	5611	3691	0.0	1.5201842319154701
chr22	EIF3D	36528879	36529074	0	196	5611	3779	5611	3583	0.0	1.5660061401060563
chr22	EIF3D	36528742	36528790	0	49	5611	3779	5611	3730	0.0	1.504289544235925
chr22	EIF3D	36528742	36528878	0	137	5611	3779	5611	3642	0.0	1.5406370126304227
chr22	TEX33	37001836	37002191	0	356	0	810	0	454	0.0	0.0
chr22	IL2RB	37174957	37174992	0	36	1646	4633	1646	4597	0.0	0.3580596040896237
chr22	RAC2	37244113	37244133	0	21	0	2531	0	2510	0.0	0.0
chr22	RAC2	37244134	37244288	0	155	0	2531	0	2376	0.0	0.0
chr22	MFNG	37485915	37485921	0	7	0	3033	0	3026	0.0	0.0
chr22	ANKRD54	37832957	37833157	0	201	0	4400	0	4199	0.0	0.0
chr22	C22ORF23	37953447	37953532	0	86	306	2290	306	2204	0.0	0.13883847549909256
chr22	C22ORF23	37953348	37953446	0	99	306	2290	306	2191	0.0	0.13966225467822913
chr22	C22ORF23	37953348	37953532	0	185	306	2290	306	2105	0.0	0.14536817102137767
chr22	SOX10	37984198	37984337	0	140	1071	3734	1071	3594	0.0	0.29799666110183637
chr22	PLA2G6	38143104	38143112	90	9	28177	8089	28087	8080	10.0	3.4761138613861386
chr22	PLA2G6	38181663	38181782	0	120	28177	8089	28177	7969	0.0	3.5358263270171917
chr22	PLA2G6	38145437	38145561	159	125	28177	8089	28018	7964	1.272	3.5180813661476646
chr22	TMEM184B	38246784	38246804	0	21	74129	6174	74129	6153	0.0	12.047619047619047
chr22	DDX17	38487872	38487877	0	6	51999	8894	51999	8888	0.0	5.850472547254726
chr22	DMC1	38570042	38570052	0	11	26335	3448	26335	3437	0.0	7.662205411696247
chr22	FAM227A	38591360	38591433	0	74	3162	3270	3162	3196	0.0	0.9893617021276596
chr22	RPL3	39319389	39319593	0	205	1326	4693	1326	4488	0.0	0.29545454545454547
chr22	RPL3	39319389	39319497	0	109	1326	4693	1326	4584	0.0	0.2892670157068063
chr22	MRTFA	40416975	40416984	0	10	0	7572	0	7562	0.0	0.0
chr22	MRTFA	40463220	40463241	0	22	0	7572	0	7550	0.0	0.0
chr22	SLC25A17	40797253	40797282	196	30	4692	3372	4496	3342	6.533333333333333	1.3453022142429683
chr22	L3MBTL2-AS1	41213629	41213794	172	166	13133	4463	12961	4297	1.036144578313253	3.01629043518734
chr22	RANGAP1	41285362	41285542	235	181	24986	5891	24751	5710	1.298342541436464	4.334676007005254
chr22	TOB2	41446374	41446377	0	4	408	4343	408	4339	0.0	0.09403088269186448
chr22	POLR3H	41532603	41532657	0	55	36457	6368	36457	6313	0.0	5.7749089181054964
chr22	POLR3H	41543751	41543989	6222	239	36457	6368	30235	6129	26.03347280334728	4.9331049110784795
chr22	SNU13	41688078	41688150	0	73	35940	2935	35940	2862	0.0	12.557651991614255
chr22	SNU13	41687721	41688077	102	357	35940	2935	35838	2578	0.2857142857142857	13.901474010861133
chr22	SNU13	41687721	41688150	102	430	35940	2935	35838	2505	0.2372093023255814	14.306586826347305
chr22	CYP2D7	42141533	42141623	0	91	176	3408	176	3317	0.0	0.05305999397045523
chr22	LINC01315	42368714	42369056	204	343	1020	1327	816	984	0.5947521865889213	0.8292682926829268
chr22	CYB5R3	42646640	42646884	280	245	4528	5573	4248	5328	1.1428571428571428	0.7972972972972973
chr22	A4GALT	42695490	42695573	255	84	3442	3364	3187	3280	3.0357142857142856	0.9716463414634147
chr22	PACSIN2	42959762	42959797	90	36	62413	4388	62323	4352	2.5	14.320542279411764
chr22	PACSIN2	42959571	42959797	1416	227	62413	4388	60997	4161	6.237885462555066	14.659216534486902
chr22	PACSIN2	42959571	42959761	1326	191	62413	4388	61087	4197	6.942408376963351	14.554920181081725
chr22	TTLL1	43069603	43069634	0	32	5677	1880	5677	1848	0.0	3.071969696969697
chr22	WNT7B	45975544	45975688	0	145	72898	4942	72898	4797	0.0	15.196581196581196
chr22	LINC00899	46043939	46044607	0	669	1683	3069	1683	2400	0.0	0.70125
chr22	CDPF1	46247109	46247123	0	15	492	1642	492	1627	0.0	0.30239704978488013
chr22	CDPF1	46247105	46247108	0	4	492	1642	492	1638	0.0	0.30036630036630035
chr22	LINC00898	47627308	47627436	0	129	756	4992	756	4863	0.0	0.1554595928439235
chr22	Z84468.2	48489063	48489158	0	96	51	2513	51	2417	0.0	0.021100537856847332
chr22	Z84468.1	48547193	48547221	0	29	75	2253	75	2224	0.0	0.03372302158273381
chr22	C22ORF34	49624369	49624445	0	77	0	6782	0	6705	0.0	0.0
chr22	TTLL8	50034344	50034355	0	12	0	2723	0	2711	0.0	0.0
chr22	TUBGCP6	50220191	50221273	4057	1083	36064	7417	32007	6334	3.7460757156048015	5.053204925797284
chr22	TUBGCP6	50220191	50220249	88	59	36064	7417	35976	7358	1.4915254237288136	4.889372111986953
chr22	TUBGCP6	50240203	50240223	0	21	36064	7417	36064	7396	0.0	4.876149269875609
chr22	TUBGCP6	50220250	50221273	3969	1024	36064	7417	32095	6393	3.8759765625	5.020334741123103
chr22	HDAC10	50250973	50251100	24	128	5812	4150	5788	4022	0.1875	1.4390850323222277
chr22	MAPK11	50267252	50267255	56	4	3151	2698	3095	2694	14.0	1.1488492947290274
chr22	PLXNB2	50294718	50294724	7	7	348220	7083	348213	7076	1.0	49.210429621254946
chr22	SCO2	50525441	50525470	0	30	0	1355	0	1325	0.0	0.0
chr22	CPT1B	50577323	50577354	0	32	79	4122	79	4090	0.0	0.019315403422982887
chr22	CPT1B	50569166	50569334	0	169	79	4122	79	3953	0.0	0.019984821654439665
chr22	CHKB	50579973	50580055	0	83	0	2709	0	2626	0.0	0.0
chr22	ARSA	50627555	50627944	1365	390	12405	3989	11040	3599	3.5	3.0675187552097807
chr22	ARSA	50627945	50627989	216	45	12405	3989	12189	3944	4.8	3.0905172413793105
chr22	ARSA	50627897	50627944	306	48	12405	3989	12099	3941	6.375	3.0700329865516367
chr22	ARSA	50627897	50627989	522	93	12405	3989	11883	3896	5.612903225806452	3.0500513347022586
chr22	RABL2B	50783038	50783043	24	6	10031	5879	10007	5873	4.0	1.7038991997275668
chr22	RABL2B	50769424	50769453	300	30	10031	5879	9731	5849	10.0	1.663703197127714
chr22	RABL2B	50782890	50783037	60	148	10031	5879	9971	5731	0.40540540540540543	1.7398359797592042
chr22	LINC01664	17122040	17122344	0	305	0	1936	0	1631	0.0	0.0
chr22	HDHD5-AS1	17159552	17159837	0	286	0	633	0	347	0.0	0.0
chr22	BCL2L13	17638701	17638886	2352	186	16710	7270	14358	7084	12.64516129032258	2.0268210050818745
chr22	TUBA8	18110840	18110868	0	29	16815	3649	16815	3620	0.0	4.645027624309392
chr22	DGCR6	18906468	18906484	0	17	0	5168	0	5151	0.0	0.0
chr22	AC007326.5	18939750	18939757	0	8	0	1442	0	1434	0.0	0.0
chr22	SEPTIN5	19718572	19718818	0	247	1020	4211	1020	3964	0.0	0.25731584258324924
chr22	TANGO2	20061682	20061683	0	2	26583	4941	26583	4939	0.0	5.382263616116623
chr22	TANGO2	20036855	20037094	102	240	26583	4941	26481	4701	0.425	5.633056796426292
chr22	TANGO2	20021135	20021246	0	112	26583	4941	26583	4829	0.0	5.504866431973493
chr22	TANGO2	20021247	20021298	0	52	26583	4941	26583	4889	0.0	5.437308242994478
chr22	DGCR8	20106686	20106698	0	13	155746	7302	155746	7289	0.0	21.367265742900262
chr22	RANBP1	20116396	20116430	210	35	73207	4188	72997	4153	6.0	17.576932338068865
chr22	RANBP1	20117913	20118131	0	219	73207	4188	73207	3969	0.0	18.44469639707735
chr22	RANBP1	20118017	20118131	0	115	73207	4188	73207	4073	0.0	17.973729437760863
chr22	RANBP1	20118132	20118313	0	182	73207	4188	73207	4006	0.0	18.274338492261606
chr22	RANBP1	20118017	20118313	0	297	73207	4188	73207	3891	0.0	18.81444358776664
chr22	ZNF74	20394335	20394662	7431	328	25296	5230	17865	4902	22.65548780487805	3.6444308445532436
chr22	MED15	20507736	20507746	0	11	408	8263	408	8252	0.0	0.04944255937954435
chr22	MED15	20537205	20537215	0	11	408	8263	408	8252	0.0	0.04944255937954435
chr22	MED15	20551167	20551347	0	181	408	8263	408	8082	0.0	0.050482553823311065
chr22	TMEM191A	20703693	20703751	0	59	0	2582	0	2523	0.0	0.0
chr22	TMEM191A	20704041	20704056	0	16	0	2582	0	2566	0.0	0.0
chr22	LZTR1	20992898	20992904	0	7	51	6931	51	6924	0.0	0.007365684575389948
chr22	LZTR1	20982572	20982576	0	5	51	6931	51	6926	0.0	0.007363557609009529
chr22	LZTR1	20983090	20983122	0	33	51	6931	51	6898	0.0	0.007393447376051029
chr22	LZTR1	20990526	20990969	0	444	51	6931	51	6487	0.0	0.00786187760135656
chr22	P2RX6	21015261	21015338	0	78	0	4616	0	4538	0.0	0.0
chr22	P2RX6	21015334	21015338	0	5	0	4616	0	4611	0.0	0.0
chr22	P2RX6	21015261	21015333	0	73	0	4616	0	4543	0.0	0.0
chr22	BCRP2	21116002	21116068	217	67	9218	2960	9001	2893	3.2388059701492535	3.111303145523678
chr22	FAM230B	21170498	21170605	0	108	10805	6180	10805	6072	0.0	1.7794795783926218
chr22	TMEM191C	21469004	21469062	0	59	357	4210	357	4151	0.0	0.08600337268128162
chr22	AC245060.7	22307246	22307285	0	40	11646	2909	11646	2869	0.0	4.05925409550366
chr22	GGTLC2	22644709	22644814	0	106	2882	1402	2882	1296	0.0	2.2237654320987654
chr22	RGL4	23688852	23688902	0	51	90	4727	90	4676	0.0	0.01924721984602224
chr22	RGL4	23690948	23692209	0	1262	90	4727	90	3465	0.0	0.025974025974025976
chr22	C22ORF15	23764398	23764402	0	5	102	1345	102	1340	0.0	0.07611940298507462
chr22	C22ORF15	23764398	23764412	0	15	102	1345	102	1330	0.0	0.07669172932330827
chr22	C22ORF15	23764403	23764412	0	10	102	1345	102	1335	0.0	0.07640449438202247
chr22	MMP11	23771300	23771307	0	8	148	4173	148	4165	0.0	0.035534213685474186
chr22	MMP11	23779369	23779416	0	48	148	4173	148	4125	0.0	0.03587878787878788
chr22	MMP11	23779417	23779464	0	48	148	4173	148	4125	0.0	0.03587878787878788
chr22	MMP11	23779369	23779464	0	96	148	4173	148	4077	0.0	0.03630120186411577
chr22	SMARCB1	23800971	23801081	0	111	1377	12335	1377	12224	0.0	0.11264725130890052
chr22	SMARCB1	23801082	23801135	0	54	1377	12335	1377	12281	0.0	0.11212441983551828
chr22	SMARCB1	23800971	23801135	0	165	1377	12335	1377	12170	0.0	0.11314708299096138
chr22	SMARCB1	23791868	23791894	81	27	1377	12335	1296	12308	3.0	0.10529736756581086
chr22	SMARCB1	23801082	23801964	0	883	1377	12335	1377	11452	0.0	0.12024100593782745
chr22	SMARCB1	23801136	23801964	0	829	1377	12335	1377	11506	0.0	0.11967669042238832
chr22	SMARCB1	23800971	23801964	0	994	1377	12335	1377	11341	0.0	0.12141786438585662
chr22	SLC2A11	23858030	23858156	0	127	6841	8383	6841	8256	0.0	0.828609496124031
chr22	GSTT2	23983003	23983044	730	42	21952	1189	21222	1147	17.38095238095238	18.50217959895379
chr22	CABIN1	24098106	24098192	0	87	136011	9431	136011	9344	0.0	14.555971746575343
chr22	SPECC1L	24321324	24322918	13838	1595	26541	7480	12703	5885	8.675862068965516	2.1585386576040784
chr22	ADORA2A	24427727	24427746	0	20	935	4202	935	4182	0.0	0.22357723577235772
chr22	AP000356.5	24568038	24568176	2417	139	5968	3165	3551	3026	17.388489208633093	1.17349636483807
chr22	GGT1	24603336	24603527	0	192	511	4343	511	4151	0.0	0.12310286677908938
chr22	GGT1	24603322	24603527	0	206	511	4343	511	4137	0.0	0.12351945854483926
chr22	GGT1	24603322	24603335	0	14	511	4343	511	4329	0.0	0.11804111804111804
chr22	BCRP3	24647076	24647142	0	67	389	1751	389	1684	0.0	0.23099762470308788
chr22	MIAT	26647312	26647340	0	29	0	13610	0	13581	0.0	0.0
chr22	MIAT	26663399	26663509	0	111	0	13610	0	13499	0.0	0.0
chr22	LINC01422	26860764	26861022	11193	259	272095	9911	260902	9652	43.21621621621622	27.030874430169913
chr22	TTC28-AS1	27997740	27998838	24	1099	510	11188	486	10089	0.02183803457688808	0.04817127564674398
chr22	TTC28-AS1	27997740	27998152	24	413	510	11188	486	10775	0.05811138014527845	0.04510440835266821
chr22	TTC28-AS1	27919546	27919966	0	421	510	11188	510	10767	0.0	0.04736695458344943
chr22	TTC28-AS1	27922179	27922227	0	49	510	11188	510	11139	0.0	0.045785079450579046
chr22	HSCB	28743924	28743978	0	55	0	1462	0	1407	0.0	0.0
chr22	HSCB	28744705	28744709	0	5	0	1462	0	1457	0.0	0.0
chr22	CCDC117	28773035	28773223	0	189	545	4332	545	4143	0.0	0.13154718802799903
chr22	KREMEN1	29073222	29073227	54	6	67444	7935	67390	7929	9.0	8.49918022449237
chr22	KREMEN1	29138783	29138833	0	51	67444	7935	67444	7884	0.0	8.554540842212075
chr22	EWSR1	29299281	29299331	0	51	1634	6389	1634	6338	0.0	0.2578100347112654
chr22	GAS2L1	29306770	29307153	0	384	918	4005	918	3621	0.0	0.2535211267605634
chr22	GAS2L1	29307154	29307186	0	33	918	4005	918	3972	0.0	0.2311178247734139
chr22	NF2	29683065	29683079	10728	15	212315	5395	201587	5380	715.2	37.469702602230484
chr22	UQCR10	29767549	29767607	247	59	298	977	51	918	4.186440677966102	0.05555555555555555
chr22	TCN2	30612962	30613042	0	81	2091	2960	2091	2879	0.0	0.7262938520319555
chr22	MORC2-AS1	30923423	30923451	0	29	0	2729	0	2700	0.0	0.0
chr22	TUG1	30969387	30971779	0	2393	554467	6606	554467	4213	0.0	131.6085924519345
chr22	TUG1	30971611	30971779	0	169	554467	6606	554467	6437	0.0	86.1374864067112
chr22	TUG1	30971770	30971779	0	10	554467	6606	554467	6596	0.0	84.06109763493026
chr22	SMTN	31100954	31101049	0	96	7935	7949	7935	7853	0.0	1.0104418693492934
chr22	INPP5J	31124907	31126010	0	1104	688	4440	688	3336	0.0	0.20623501199040767
chr22	RNF185	31196991	31197157	0	167	1047	3456	1047	3289	0.0	0.3183338400729705
chr22	RNF185	31196991	31197158	0	168	1047	3456	1047	3288	0.0	0.31843065693430656
chr22	RNF185	31197158	31197158	0	1	1047	3456	1047	3455	0.0	0.30303907380607814
chr22	DEPDC5	31797700	31797703	0	4	194832	17819	194832	17815	0.0	10.93640190850407
chr22	DEPDC5	31753997	31754164	0	168	194832	17819	194832	17651	0.0	11.038014843351652
chr22	DEPDC5	31906067	31906094	0	28	194832	17819	194832	17791	0.0	10.951155078410432
chr22	DEPDC5	31810642	31810665	0	24	194832	17819	194832	17795	0.0	10.948693453217196
chr22	DEPDC5	31784876	31785107	0	232	194832	17819	194832	17587	0.0	11.07818274862114
chr22	LARGE-AS1	33727589	33727632	0	44	294	2871	294	2827	0.0	0.10399717014503007
chr22	LARGE-AS1	33725656	33725756	0	101	294	2871	294	2770	0.0	0.10613718411552346
chr22	LARGE-AS1	33732650	33733685	294	1036	294	2871	0	1835	0.28378378378378377	0.0
chr22	LINC01643	34206164	34206194	0	31	612	3786	612	3755	0.0	0.162982689747004
chr22	LINC01643	34213920	34213970	0	51	612	3786	612	3735	0.0	0.163855421686747
chr22	LINC01643	34107990	34107993	0	4	612	3786	612	3782	0.0	0.16181914331041777
chr22	TOM1	35322020	35322037	0	18	0	5019	0	5001	0.0	0.0
chr22	TOM1	35346970	35346972	0	3	0	5019	0	5016	0.0	0.0
chr22	TOM1	35299379	35299494	0	116	0	5019	0	4903	0.0	0.0
chr22	HMOX1	35381197	35381329	0	133	0	2254	0	2121	0.0	0.0
chr22	APOL1	36259857	36259918	0	62	228	2686	228	2624	0.0	0.08689024390243902
chr22	NCF4	36875784	36875787	0	4	51301	2252	51301	2248	0.0	22.82072953736655
chr22	MPST	37019775	37019872	0	98	0	2486	0	2388	0.0	0.0
chr22	GGA1	37616998	37617048	0	51	939	9038	939	8987	0.0	0.10448425503505063
chr22	GGA1	37608984	37609154	0	171	939	9038	939	8867	0.0	0.10589827450095861
chr22	GGA1	37609155	37609356	0	202	939	9038	939	8836	0.0	0.10626980534178361
chr22	TRIOBP	37751517	37751690	0	174	7739	12205	7739	12031	0.0	0.6432549247776577
chr22	EIF3L	37851491	37851561	0	71	37222	4164	37222	4093	0.0	9.094063034449059
chr22	EIF3L	37849483	37850063	0	581	37222	4164	37222	3583	0.0	10.388501255930784
chr22	MICALL1	37927821	37927826	0	6	15680	5852	15680	5846	0.0	2.6821758467328087
chr22	MICALL1	37937793	37937819	0	27	15680	5852	15680	5825	0.0	2.691845493562232
chr22	POLR2F	37956843	37956901	0	59	62990	6258	62990	6199	0.0	10.161316341345378
chr22	POLR2F	37953808	37953860	0	53	62990	6258	62990	6205	0.0	10.151490733279614
chr22	PICK1	38057437	38057489	0	53	1790933	4356	1790933	4303	0.0	416.20567046246805
chr22	PICK1	38057437	38057587	0	151	1790933	4356	1790933	4205	0.0	425.9055885850178
chr22	PICK1	38057490	38057587	0	98	1790933	4356	1790933	4258	0.0	420.6042743071865
chr22	MAFF	38202213	38202238	62649	26	1735677	3894	1673028	3868	2409.576923076923	432.5305067218201
chr22	GTPBP1	38706782	38706856	0	75	2735	8041	2735	7966	0.0	0.34333417022344964
chr22	APOBEC3G	39077169	39077378	0	210	708627	4135	708627	3925	0.0	180.54191082802546
chr22	SYNGR1	39374554	39374660	0	107	230242	5655	230242	5548	0.0	41.5
chr22	ADSL	40363072	40363092	0	21	724	7463	724	7442	0.0	0.09728567589357699
chr22	ADSL	40361636	40361677	0	42	724	7463	724	7421	0.0	0.0975609756097561
chr22	ADSL	40361667	40361677	0	11	724	7463	724	7452	0.0	0.09715512614063339
chr22	ADSL	40361636	40361666	0	31	724	7463	724	7432	0.0	0.09741657696447793
chr22	MCHR1	40679405	40679734	0	330	3480	2441	3480	2111	0.0	1.6485078162008526
chr22	ACO2	41515918	41515992	0	75	42848	9940	42848	9865	0.0	4.343436391282311
chr22	MEI1	41795453	41795542	0	90	52128	6712	52128	6622	0.0	7.871942011476895
chr22	SMDT1	42079906	42079954	15	49	13511	1734	13496	1685	0.30612244897959184	8.009495548961425
chr22	SERHL	42510725	42511927	510	1203	740	2853	230	1650	0.4239401496259352	0.1393939393939394
chr22	SERHL2	42571204	42571901	0	698	8137	2806	8137	2108	0.0	3.8600569259962048
chr22	TSPO	43152128	43152220	0	93	0	1395	0	1302	0.0	0.0
chr22	PNPLA3	43924087	43924098	0	12	0	3195	0	3183	0.0	0.0
chr22	LINC00207	44570589	44570624	0	36	0	1410	0	1374	0.0	0.0
chr22	NUP50	45171144	45171152	0	9	102	6581	102	6572	0.0	0.0155203895313451
chr22	NUP50	45171144	45171177	0	34	102	6581	102	6547	0.0	0.015579654803726898
chr22	NUP50	45171153	45171177	0	25	102	6581	102	6556	0.0	0.015558267236119585
chr22	NUP50	45164729	45164758	0	30	102	6581	102	6551	0.0	0.015570141963059074
chr22	NUP50	45164759	45164955	0	197	102	6581	102	6384	0.0	0.015977443609022556
chr22	NUP50	45164729	45164955	0	227	102	6581	102	6354	0.0	0.016052880075542966
chr22	FAM118A	45309347	45309650	1065	304	1723	5330	658	5026	3.5032894736842106	0.1309192200557103
chr22	FBLN1	45503065	45503490	0	426	38569	7040	38569	6614	0.0	5.8314182038101
chr22	GRAMD4	46626917	46626961	0	45	13290	4923	13290	4878	0.0	2.724477244772448
chr22	TBC1D22A	46792763	46792804	0	42	5965	5336	5965	5294	0.0	1.1267472610502456
chr22	AL117329.1	47631866	47631886	0	21	51	31762	51	31741	0.0	0.0016067546706152926
chr22	AL117329.1	47631776	47631886	0	111	51	31762	51	31651	0.0	0.001611323496887934
chr22	AL117329.1	47635354	47635355	0	2	51	31762	51	31760	0.0	0.001605793450881612
chr22	AL117329.1	47631776	47631865	0	90	51	31762	51	31672	0.0	0.001610255114928012
chr22	AL117329.1	47631887	47632086	0	200	51	31762	51	31562	0.0	0.0016158671820543692
chr22	AL117329.1	47631866	47632086	0	221	51	31762	51	31541	0.0	0.0016169430265368886
chr22	AL117329.1	47631776	47632086	0	311	51	31762	51	31451	0.0	0.0016215700613652984
chr22	MOV10L1	50090186	50091462	0	1277	520	6832	520	5555	0.0	0.09360936093609361
chr22	MOV10L1	50090513	50091462	0	950	520	6832	520	5882	0.0	0.08840530431825909
chr22	MOV10L1	50090398	50091462	0	1065	520	6832	520	5767	0.0	0.09016819837003641
chr22	MOV10L1	50090186	50090512	0	327	520	6832	520	6505	0.0	0.07993850883935434
chr22	MOV10L1	50090398	50090512	0	115	520	6832	520	6717	0.0	0.07741551287777282
chr22	TRABD	50185977	50186001	817	25	29427	2486	28610	2461	32.68	11.625355546525803
chr22	MIOX	50489631	50489644	0	14	0	1806	0	1792	0.0	0.0
chr22	NCAPH2	50508429	50508445	17	17	19	4166	2	4149	1.0	0.00048204386599180526
chr22	CHKB-DT	50583324	50583400	0	77	102	4099	102	4022	0.0	0.02536051715564396
chr22	CHKB-DT	50585683	50585955	0	273	102	4099	102	3826	0.0	0.026659696811291166
chr22	RPL23AP82	50783865	50784072	0	208	7355	4161	7355	3953	0.0	1.8606121932709334
chr22	RPL23AP82	50784022	50784072	0	51	7355	4161	7355	4110	0.0	1.789537712895377
chr22	RPL23AP82	50783865	50784021	0	157	7355	4161	7355	4004	0.0	1.836913086913087
chrX	PLCXD1	283489	283520	277	32	91280	6077	91003	6045	8.65625	15.054259718775848
chrX	CSF2RA	1274819	1274842	0	24	0	3562	0	3538	0.0	0.0
chrX	TBL1X	9534961	9535034	0	74	5090	9022	5090	8948	0.0	0.5688421993741618
chrX	HCCS	11111424	11111460	0	37	438	2309	438	2272	0.0	0.19278169014084506
chrX	HCCS	11111461	11111518	51	58	438	2309	387	2251	0.8793103448275862	0.17192358951577077
chrX	HCCS	11111424	11111518	51	95	438	2309	387	2214	0.5368421052631579	0.17479674796747968
chrX	MSL3	11758689	11758773	0	85	3468	7299	3468	7214	0.0	0.4807319101746604
chrX	MSL3	11759713	11759875	0	163	3468	7299	3468	7136	0.0	0.4859865470852018
chrX	MSL3	11760340	11760498	0	159	3468	7299	3468	7140	0.0	0.4857142857142857
chrX	MSL3	11767047	11767052	0	6	3468	7299	3468	7293	0.0	0.4755244755244755
chrX	MSL3	11767170	11767286	0	117	3468	7299	3468	7182	0.0	0.4828738512949039
chrX	PRPS2	12799391	12799399	0	9	670	2703	670	2694	0.0	0.24870081662954716
chrX	CDKL5	18442391	18442423	0	33	7690	18806	7690	18773	0.0	0.4096308528205401
chrX	CNKSR2	21374919	21374961	0	43	9804	24430	9804	24387	0.0	0.402017468323287
chrX	PDK3	24534069	24534656	255	588	31433	13518	31178	12930	0.4336734693877551	2.411291569992266
chrX	POLA1	24693987	24694004	0	18	10526	14745	10526	14727	0.0	0.7147416310178584
chrX	AL591501.1	34339016	34339033	0	18	151	14454	151	14436	0.0	0.010459961208090883
chrX	MAGEB16	35798419	35798554	0	136	0	1991	0	1855	0.0	0.0
chrX	PRRG1	37349396	37349469	139	74	445	6149	306	6075	1.8783783783783783	0.05037037037037037
chrX	MID1IP1	38801488	38804413	0	2926	0	4839	0	1913	0.0	0.0
chrX	ATP6AP2	40581072	40581102	213	31	11430	6093	11217	6062	6.870967741935484	1.850379412735071
chrX	USP9X	41229780	41229827	0	48	21512	14198	21512	14150	0.0	1.5202826855123674
chrX	DDX3X	41333700	41333783	0	84	2617	11657	2617	11573	0.0	0.22612978484403354
chrX	DDX3X	41333784	41334297	0	514	2617	11657	2617	11143	0.0	0.2348559633850848
chrX	DDX3X	41333700	41334297	0	598	2617	11657	2617	11059	0.0	0.2366398408536034
chrX	DDX3X	41357940	41358000	0	61	2617	11657	2617	11596	0.0	0.22568126940324248
chrX	DDX3X	41357991	41358000	0	10	2617	11657	2617	11647	0.0	0.22469305400532327
chrX	DDX3X	41357940	41357990	0	51	2617	11657	2617	11606	0.0	0.2254868171635361
chrX	DDX3X	41347452	41347454	0	3	2617	11657	2617	11654	0.0	0.22455809164235455
chrX	DDX3X	41344400	41344564	0	165	2617	11657	2617	11492	0.0	0.22772363383223113
chrX	DDX3X	41334770	41334815	0	46	2617	11657	2617	11611	0.0	0.2253897166480062
chrX	KDM6A	45106650	45106713	0	64	0	19804	0	19740	0.0	0.0
chrX	KDM6A	45090833	45090864	0	32	0	19804	0	19772	0.0	0.0
chrX	KRBOX4	46463294	46463308	3897	15	110836	3691	106939	3676	259.8	29.0911316648531
chrX	RBM10	47180038	47180040	0	3	0	3562	0	3559	0.0	0.0
chrX	RBM10	47145486	47145516	0	31	0	3562	0	3531	0.0	0.0
chrX	CDK16	47218050	47218224	0	175	0	5750	0	5575	0.0	0.0
chrX	CDK16	47224477	47224518	0	42	0	5750	0	5708	0.0	0.0
chrX	CDK16	47222343	47222380	0	38	0	5750	0	5712	0.0	0.0
chrX	CXXC1P1	47724335	47724336	0	2	204	2703	204	2701	0.0	0.07552758237689744
chrX	ZNF81	47836988	47837007	672	20	41999	11822	41327	11802	33.6	3.5016946280291474
chrX	FTSJ1	48478681	48478707	0	27	184	2878	184	2851	0.0	0.06453875833041038
chrX	RBM3	48575631	48575667	0	37	4998	5201	4998	5164	0.0	0.9678543764523625
chrX	WDR13	48600627	48600656	0	30	918	7435	918	7405	0.0	0.12397029034436191
chrX	HDAC6	48801432	48801751	52773	320	157384	7947	104611	7627	164.915625	13.715877802543595
chrX	HDAC6	48802023	48802272	0	250	157384	7947	157384	7697	0.0	20.44744705729505
chrX	HDAC6	48802171	48802272	0	102	157384	7947	157384	7845	0.0	20.061695347355002
chrX	HDAC6	48802143	48802272	0	130	157384	7947	157384	7817	0.0	20.13355507227837
chrX	HDAC6	48802236	48802272	0	37	157384	7947	157384	7910	0.0	19.8968394437421
chrX	HDAC6	48802143	48802170	0	28	157384	7947	157384	7919	0.0	19.874226543755526
chrX	HDAC6	48802273	48802551	0	279	157384	7947	157384	7668	0.0	20.52477829942619
chrX	HDAC6	48802171	48802551	0	381	157384	7947	157384	7566	0.0	20.801480306634947
chrX	HDAC6	48802143	48802551	0	409	157384	7947	157384	7538	0.0	20.878747678429292
chrX	HDAC6	48802236	48802551	0	316	157384	7947	157384	7631	0.0	20.62429563622068
chrX	HDAC6	48802171	48802235	0	65	157384	7947	157384	7882	0.0	19.967520933773155
chrX	HDAC6	48802143	48802235	0	93	157384	7947	157384	7854	0.0	20.03870639164757
chrX	HDAC6	48805672	48805779	179	108	157384	7947	157205	7839	1.6574074074074074	20.054216098992217
chrX	PQBP1	48898083	48898093	1665	11	41260	1863	39595	1852	151.36363636363637	21.379589632829372
chrX	PQBP1	48898015	48898093	22299	79	41260	1863	18961	1784	282.26582278481015	10.628363228699552
chrX	PQBP1	48902385	48902517	0	133	41260	1863	41260	1730	0.0	23.84971098265896
chrX	PQBP1	48898015	48898082	20634	68	41260	1863	20626	1795	303.44117647058823	11.490807799442896
chrX	PQBP1	48898351	48898576	357	226	41260	1863	40903	1637	1.579646017699115	24.986560781918143
chrX	CCDC120	49062059	49062117	0	59	83	4272	83	4213	0.0	0.019700925706147638
chrX	CCDC120	49062105	49062117	0	13	83	4272	83	4259	0.0	0.019488142756515614
chrX	CCDC120	49062290	49062325	0	36	83	4272	83	4236	0.0	0.01959395656279509
chrX	CCDC120	49059060	49059095	0	36	83	4272	83	4236	0.0	0.01959395656279509
chrX	CCDC120	49062059	49062104	0	46	83	4272	83	4226	0.0	0.019640321817321345
chrX	MAGIX	49164790	49165090	0	301	0	4936	0	4635	0.0	0.0
chrX	PPP1R3F	49269934	49270873	0	940	0	4334	0	3394	0.0	0.0
chrX	CLCN5	49923483	49923741	0	259	1173	11479	1173	11220	0.0	0.10454545454545454
chrX	MAGED4	52191862	52191873	0	12	102	4286	102	4274	0.0	0.023865231633130556
chrX	XAGE1A	52497458	52497473	0	16	0	943	0	927	0.0	0.0
chrX	SSX2B	52751275	52751318	0	44	7	2265	7	2221	0.0	0.0031517334533993696
chrX	FAM156B	52897410	52898726	0	1317	102	4461	102	3144	0.0	0.03244274809160305
chrX	RIBC1	53422921	53423004	286	84	52895	2329	52609	2245	3.4047619047619047	23.433853006681513
chrX	GNL3L	54540239	54540242	0	4	66397	11968	66397	11964	0.0	5.549732530926112
chrX	GNL3L	54530303	54530419	0	117	66397	11968	66397	11851	0.0	5.602649565437516
chrX	GNL3L	54539102	54539500	0	399	66397	11968	66397	11569	0.0	5.739216872676981
chrX	TRO	54928711	54931031	0	2321	0	4939	0	2618	0.0	0.0
chrX	TRO	54920879	54920888	0	10	0	4939	0	4929	0.0	0.0
chrX	TRO	54920879	54920965	0	87	0	4939	0	4852	0.0	0.0
chrX	TRO	54920889	54920965	0	77	0	4939	0	4862	0.0	0.0
chrX	PAGE2B	55076627	55076677	0	51	0	545	0	494	0.0	0.0
chrX	PAGE2	55090560	55090610	0	51	0	657	0	606	0.0	0.0
chrX	PAGE5	55221825	55221875	0	51	0	757	0	706	0.0	0.0
chrX	PAGE5	55220453	55220651	0	199	0	757	0	558	0.0	0.0
chrX	RRAGB	55717789	55718419	0	631	11717	2726	11717	2095	0.0	5.592840095465394
chrX	AL050309.1	55908518	55908800	0	283	204	12309	204	12026	0.0	0.01696324629968402
chrX	NBDY	56729484	56729589	0	106	294	2378	294	2272	0.0	0.12940140845070422
chrX	EDA	70033523	70033528	0	6	522	7019	522	7013	0.0	0.07443319549408242
chrX	ARR3	70269693	70269740	0	48	127909	1644	127909	1596	0.0	80.14348370927318
chrX	MED12	71137384	71137392	0	9	144	7470	144	7461	0.0	0.019300361881785282
chrX	GJB1	71215272	71215290	0	19	0	4661	0	4642	0.0	0.0
chrX	GJB1	71215272	71217260	0	1989	0	4661	0	2672	0.0	0.0
chrX	GJB1	71215291	71217260	0	1970	0	4661	0	2691	0.0	0.0
chrX	NONO	71294349	71294528	0	180	0	9256	0	9076	0.0	0.0
chrX	NONO	71297462	71297938	0	477	0	9256	0	8779	0.0	0.0
chrX	NONO	71290792	71290806	0	15	0	9256	0	9241	0.0	0.0
chrX	TAF1	71458358	71458366	9	9	1237475	10823	1237466	10814	1.0	114.43184760495654
chrX	PIN4	72181829	72181925	0	97	0	4364	0	4267	0.0	0.0
chrX	JPX	73944466	73944662	0	197	255	19827	255	19630	0.0	0.012990320937340805
chrX	JPX	73944415	73944662	0	248	255	19827	255	19579	0.0	0.013024158537208234
chrX	JPX	73944415	73944465	0	51	255	19827	255	19776	0.0	0.012894417475728155
chrX	JPX	73998845	74000496	0	1652	255	19827	255	18175	0.0	0.014030261348005502
chrX	UPRT	75300966	75301015	0	50	155	3706	155	3656	0.0	0.04239606126914661
chrX	TBX22	80023237	80023240	0	4	2996	2671	2996	2667	0.0	1.1233595800524934
chrX	CYLC1	83861197	83861199	0	3	0	2133	0	2130	0.0	0.0
chrX	APOOL	85074112	85074112	0	1	51	6508	51	6507	0.0	0.007837713231904103
chrX	AC003001.1	85212820	85212878	1316	59	1759	1484	443	1425	22.305084745762713	0.31087719298245614
chrX	AC003001.1	85212873	85212878	362	6	1759	1484	1397	1478	60.333333333333336	0.9451962110960758
chrX	AC003001.1	85212820	85212872	954	53	1759	1484	805	1431	18.0	0.5625436757512229
chrX	ZNF711	85247184	85247188	0	5	5189	5056	5189	5051	0.0	1.0273213225103939
chrX	DACH2	86813005	86813034	0	30	40	2770	40	2740	0.0	0.014598540145985401
chrX	CPXCR1	88747332	88747369	0	38	0	1623	0	1585	0.0	0.0
chrX	AL157778.1	98731578	98731584	0	7	0	2649	0	2642	0.0	0.0
chrX	CSTF2	100833270	100833472	0	203	12	2791	12	2588	0.0	0.00463678516228748
chrX	ARL13A	100988385	100988558	28	174	36	1320	8	1146	0.16091954022988506	0.006980802792321117
chrX	CENPI	101098235	101098248	0	14	1096	4333	1096	4319	0.0	0.25376244501041906
chrX	DRP2	101242983	101243098	0	116	486	8211	486	8095	0.0	0.06003705991352687
chrX	ARMCX4	101486093	101486098	6	6	87	13064	81	13058	1.0	0.006203093888803799
chrX	ARMCX3	101623277	101623430	0	154	0	4243	0	4089	0.0	0.0
chrX	ARMCX5-GPRASP2	102599848	102599859	0	12	51	8165	51	8153	0.0	0.0062553661228995465
chrX	GPRASP1	102651734	102651908	0	175	51	6794	51	6619	0.0	0.007705091403535277
chrX	BHLHB9	102720822	102720825	0	4	0	5486	0	5482	0.0	0.0
chrX	BHLHB9	102721028	102721091	0	64	0	5486	0	5422	0.0	0.0
chrX	LINC00630	102827137	102827144	0	8	335525	11012	335525	11004	0.0	30.49118502362777
chrX	AL117327.1	103405024	103405096	0	73	204	2682	204	2609	0.0	0.07819087773093139
chrX	TCEAL4	103585684	103585760	0	77	0	2405	0	2328	0.0	0.0
chrX	TCEAL4	103586292	103586301	0	10	0	2405	0	2395	0.0	0.0
chrX	TCEAL4	103585625	103585683	0	59	0	2405	0	2346	0.0	0.0
chrX	TCEAL3	103608059	103608070	0	12	91	2257	91	2245	0.0	0.04053452115812917
chrX	TCEAL1	103629562	103629573	0	12	0	1604	0	1592	0.0	0.0
chrX	PLP1	103786622	103786726	14	105	51	5679	37	5574	0.13333333333333333	0.006637961966271977
chrX	PLP1	103776648	103776747	0	100	51	5679	51	5579	0.0	0.00914142319412081
chrX	TMSB15B	103962724	103964294	0	1571	0	8594	0	7023	0.0	0.0
chrX	FAM199X	104188178	104188306	0	129	663	7630	663	7501	0.0	0.08838821490467938
chrX	DNAAF6	107207423	107207426	0	4	0	1964	0	1960	0.0	0.0
chrX	PRPS1	107628483	107628750	0	268	102	3405	102	3137	0.0	0.03251514185527574
chrX	MID2	107917650	107917739	219	90	98008	7565	97789	7475	2.433333333333333	13.082140468227426
chrX	ATG4A	108091837	108091879	0	43	51	2821	51	2778	0.0	0.0183585313174946
chrX	ATG4A	108137885	108137991	0	107	51	2821	51	2714	0.0	0.01879145173176124
chrX	AL035425.1	108737880	108737923	0	44	0	1925	0	1881	0.0	0.0
chrX	TMEM164	110003157	110003178	0	22	204	6593	204	6571	0.0	0.03104550296758484
chrX	ALG13	111682236	111682294	0	59	51	8141	51	8082	0.0	0.006310319227913883
chrX	ALG13	111681300	111681424	0	125	51	8141	51	8016	0.0	0.006362275449101796
chrX	ALG13	111682295	111682300	0	6	51	8141	51	8135	0.0	0.00626920712968654
chrX	ALG13	111682236	111682300	0	65	51	8141	51	8076	0.0	0.006315007429420505
chrX	TRPC5OS	111876190	111876273	0	84	37	3034	37	2950	0.0	0.012542372881355932
chrX	HTR2C	114848109	114848203	0	95	204	4849	204	4754	0.0	0.04291123264619268
chrX	DOCK11	118683218	118683229	0	12	383259	6776	383259	6764	0.0	56.661590774689536
chrX	LINC01285	118841866	118841871	0	6	9996	5759	9996	5753	0.0	1.7375282461324526
chrX	ATP1B4	120366778	120366789	0	12	26	4781	26	4769	0.0	0.00545187670371147
chrX	XIAP	123891310	123891316	0	7	51	3270	51	3263	0.0	0.01562978853815507
chrX	XIAP	123860294	123860545	0	252	51	3270	51	3018	0.0	0.016898608349900597
chrX	STAG2	123960867	123960942	0	76	0	8243	0	8167	0.0	0.0
chrX	SH2D1A	124370312	124370320	0	9	0	2825	0	2816	0.0	0.0
chrX	SH2D1A	124346758	124346779	0	22	0	2825	0	2803	0.0	0.0
chrX	BCORL1	129981753	129981783	0	31	1173	8013	1173	7982	0.0	0.1469556502129792
chrX	SLC25A14	130340345	130340353	0	9	0	2668	0	2659	0.0	0.0
chrX	LINC00629	134549945	134550204	0	260	714	2775	714	2515	0.0	0.28389662027833
chrX	LINC00629	134550066	134550204	0	139	714	2775	714	2636	0.0	0.2708649468892261
chrX	LINC00629	134550041	134550204	0	164	714	2775	714	2611	0.0	0.2734584450402145
chrX	LINC00629	134549945	134550065	0	121	714	2775	714	2654	0.0	0.2690278824415976
chrX	LINC00629	134550041	134550065	0	25	714	2775	714	2750	0.0	0.2596363636363636
chrX	LINC00629	134550205	134550225	0	21	714	2775	714	2754	0.0	0.25925925925925924
chrX	LINC00629	134550066	134550225	0	160	714	2775	714	2615	0.0	0.2730401529636711
chrX	LINC00629	134550041	134550225	0	185	714	2775	714	2590	0.0	0.2756756756756757
chrX	FAM122C	134796448	134796460	0	13	0	7535	0	7522	0.0	0.0
chrX	FAM122C	134839478	134839561	0	84	0	7535	0	7451	0.0	0.0
chrX	FAM122C	134839562	134839603	0	42	0	7535	0	7493	0.0	0.0
chrX	FAM122C	134839478	134839603	0	126	0	7535	0	7409	0.0	0.0
chrX	ETDA	135252805	135252823	1	19	6838	654	6837	635	0.05263157894736842	10.766929133858268
chrX	INTS6L	135577296	135577427	0	132	101548	5582	101548	5450	0.0	18.632660550458716
chrX	INTS6L	135581565	135581631	6	67	101548	5582	101542	5515	0.08955223880597014	18.411967361740707
chrX	SLC9A6	135994890	135994985	2346	96	41289	9929	38943	9833	24.4375	3.9604393369266755
chrX	SLC9A6	135974784	135975082	0	299	41289	9929	41289	9630	0.0	4.287538940809969
chrX	SLC9A6	135985473	135985477	0	5	41289	9929	41289	9924	0.0	4.1605199516324065
chrX	FHL1	136168268	136168288	0	21	335	5097	335	5076	0.0	0.06599684791174153
chrX	FHL1	136167078	136167098	0	21	335	5097	335	5076	0.0	0.06599684791174153
chrX	FHL1	136169866	136169980	0	115	335	5097	335	4982	0.0	0.06724207145724609
chrX	VGLL1	136548868	136549008	0	141	0	1483	0	1342	0.0	0.0
chrX	LINC00892	136640841	136640873	0	33	0	1924	0	1891	0.0	0.0
chrX	LINC00632	140711657	140716289	0	4633	1417	14900	1417	10267	0.0	0.13801499951300283
chrX	LINC00632	140713490	140716289	0	2800	1417	14900	1417	12100	0.0	0.11710743801652893
chrX	LINC00632	140772252	140772358	0	107	1417	14900	1417	14793	0.0	0.09578854863786926
chrX	AFF2	148652120	148652131	0	12	450	14265	450	14253	0.0	0.03157230056830141
chrX	AFF2	148843416	148843433	0	18	450	14265	450	14247	0.0	0.03158559696778269
chrX	AFF2	148962932	148962937	0	6	450	14265	450	14259	0.0	0.031559015358720806
chrX	EOLA1	149541293	149541343	0	51	588	4468	588	4417	0.0	0.13312202852614896
chrX	EOLA1	149541127	149541343	24	217	588	4468	564	4251	0.11059907834101383	0.13267466478475654
chrX	EOLA1	149541127	149541292	24	166	588	4468	564	4302	0.14457831325301204	0.13110181311018132
chrX	EOLA1	149542067	149542085	0	19	588	4468	588	4449	0.0	0.13216453135536074
chrX	LINC00894	149947348	149948175	4131	828	21846	6782	17715	5954	4.989130434782608	2.975310715485388
chrX	MTMR1	150714530	150714532	0	3	0	4511	0	4508	0.0	0.0
chrX	AF274573.1	150919937	150919940	0	4	0	524	0	520	0.0	0.0
chrX	PRRG3	151700157	151700301	0	145	50	5095	50	4950	0.0	0.010101010101010102
chrX	MAGEA2B	152714683	152714857	0	175	3566	2427	3566	2252	0.0	1.5834813499111902
chrX	CSAG3	152759634	152759648	0	15	0	1088	0	1073	0.0	0.0
chrX	CSAG3	152759649	152759684	0	36	0	1088	0	1052	0.0	0.0
chrX	CSAG3	152759634	152759684	0	51	0	1088	0	1037	0.0	0.0
chrX	ZNF185	152959897	152959937	5188	41	315311	4837	310123	4796	126.53658536585365	64.66284403669725
chrX	ZNF185	152918155	152918171	0	17	315311	4837	315311	4820	0.0	65.41721991701245
chrX	BGN	153505351	153505401	0	51	0	1980	0	1929	0.0	0.0
chrX	ATP2B3	153569690	153569756	56	67	17384844	7513	17384788	7446	0.835820895522388	2334.7821649207626
chrX	PLXNB3	153775969	153776214	2291	246	141921	7027	139630	6781	9.3130081300813	20.591358206754165
chrX	SRPK3	153784022	153784024	0	3	66582	4765	66582	4762	0.0	13.981940361192777
chrX	SSR4	153794335	153794585	458	251	11507	2164	11049	1913	1.8247011952191234	5.775744903293257
chrX	AVPR2	153906329	153906416	0	88	2193	2256	2193	2168	0.0	1.011531365313653
chrX	TMEM187	153972861	153972886	0	26	0	1499	0	1473	0.0	0.0
chrX	OPN1LW	154156345	154156533	0	189	77	1248	77	1059	0.0	0.07271010387157696
chrX	OPN1MW	154193459	154193647	0	189	2142	2004	2142	1815	0.0	1.1801652892561985
chrX	OPN1MW2	154230599	154230787	0	189	0	1267	0	1078	0.0	0.0
chrX	TKTL1	154305087	154305124	0	38	9702	3348	9702	3310	0.0	2.931117824773414
chrX	EMD	154379538	154379566	0	29	51	1860	51	1831	0.0	0.02785363189513927
chrX	RPL10	154398395	154398398	0	4	142	4328	142	4324	0.0	0.03283996299722479
chrX	TAZ	154411953	154412006	0	54	16	3645	16	3591	0.0	0.004455583402951824
chrX	TAZ	154413253	154413358	0	106	16	3645	16	3539	0.0	0.004521051144391071
chrX	TAZ	154413340	154413358	0	19	16	3645	16	3626	0.0	0.00441257584114727
chrX	TAZ	154413353	154413358	0	6	16	3645	16	3639	0.0	0.004396812311074471
chrX	TAZ	154413253	154413339	0	87	16	3645	16	3558	0.0	0.004496908375491849
chrX	TAZ	154419624	154419746	0	123	16	3645	16	3522	0.0	0.004542873367404884
chrX	TAZ	154413253	154413352	0	100	16	3645	16	3545	0.0	0.004513399153737658
chrX	TAZ	154413340	154413352	0	13	16	3645	16	3632	0.0	0.004405286343612335
chrX	TAZ	154412866	154412987	0	122	16	3645	16	3523	0.0	0.004541583877377235
chrX	ATP6AP1	154432316	154432459	0	144	459	5136	459	4992	0.0	0.09194711538461539
chrX	ATP6AP1	154432966	154432971	0	6	459	5136	459	5130	0.0	0.08947368421052632
chrX	ATP6AP1	154429175	154429403	0	229	459	5136	459	4907	0.0	0.09353984104340737
chrX	ATP6AP1	154429175	154431657	357	2483	459	5136	102	2653	0.14377768828030607	0.038447041085563516
chrX	ATP6AP1	154429404	154431657	357	2254	459	5136	102	2882	0.15838509316770186	0.03539208882720333
chrX	IKBKG	154542388	154542452	0	65	2745	3473	2745	3408	0.0	0.8054577464788732
chrX	IKBKG	154561764	154561784	0	21	2745	3473	2745	3452	0.0	0.7951911935110081
chrX	DKC1	154768313	154768432	0	120	45295	3861	45295	3741	0.0	12.10772520716386
chrX	AC234781.5	155348891	155348965	0	75	0	434	0	359	0.0	0.0
chrX	VAMP7	155889609	155889612	0	4	0	2623	0	2619	0.0	0.0
chrX	VAMP7	155889548	155889612	0	65	0	2623	0	2558	0.0	0.0
chrX	WASH6P	156023210	156023213	0	4	0	2698	0	2694	0.0	0.0
chrX	WASH6P	156025050	156025100	0	51	0	2698	0	2647	0.0	0.0
chrX	BX890604.1	3828505	3829362	306	858	47606	13199	47300	12341	0.35664335664335667	3.832752613240418
chrX	BX890604.1	3866921	3866948	0	28	47606	13199	47606	13171	0.0	3.614456001822185
chrX	BX890604.1	3822072	3822372	3020	301	47606	13199	44586	12898	10.033222591362126	3.456815010079082
chrX	PUDP	7105619	7105747	0	129	306	3833	306	3704	0.0	0.0826133909287257
chrX	PNPLA4	7927670	7927684	0	15	0	3419	0	3404	0.0	0.0
chrX	FAM9A	8801239	8801309	0	71	0	1600	0	1529	0.0	0.0
chrX	FAM9B	9164292	9164531	0	240	0	6904	0	6664	0.0	0.0
chrX	MID1	10566887	10567000	0	114	120	6672	120	6558	0.0	0.018298261665141813
chrX	ARHGAP6	11265685	11265868	0	184	22703	8912	22703	8728	0.0	2.6011686526122824
chrX	FAM9C	13040479	13040756	0	278	129	5587	129	5309	0.0	0.024298361273309473
chrX	TRAPPC2	13734043	13734048	8	6	62223	5668	62215	5662	1.3333333333333333	10.98816672553868
chrX	GEMIN8	14026051	14026138	40	88	14627	2432	14587	2344	0.45454545454545453	6.223122866894198
chrX	ASB9	15248682	15248742	0	61	3623	2338	3623	2277	0.0	1.5911286780851999
chrX	PIGA	15331215	15331588	52	374	39	5184	-13	4810	0.13903743315508021	-0.002702702702702703
chrX	PIGA	15331215	15331818	52	604	39	5184	-13	4580	0.08609271523178808	-0.0028384279475982535
chrX	PIGA	15331215	15331872	52	658	39	5184	-13	4526	0.0790273556231003	-0.0028722934158197082
chrX	PIGA	15331589	15331818	0	230	39	5184	39	4954	0.0	0.007872426322163908
chrX	PIGA	15331589	15331872	0	284	39	5184	39	4900	0.0	0.007959183673469388
chrX	PIGA	15331819	15331872	0	54	39	5184	39	5130	0.0	0.00760233918128655
chrX	PIGA	15335354	15335370	0	17	39	5184	39	5167	0.0	0.007547900135475131
chrX	PIR	15493155	15493188	0	34	1460	2490	1460	2456	0.0	0.5944625407166124
chrX	RBBP7	16870037	16870045	171	9	507664	7223	507493	7214	19.0	70.34835042971999
chrX	ADGRG2	19037588	19037596	0	9	36	5324	36	5315	0.0	0.006773283160865475
chrX	BCLAF3	19937417	19937503	79	87	3628	5764	3549	5677	0.9080459770114943	0.625154130702836
chrX	AL807742.1	21373982	21374095	0	114	0	5068	0	4954	0.0	0.0
chrX	RPGR	38287860	38287863	0	4	0	8385	0	8381	0.0	0.0
chrX	RPGR	38287093	38287863	0	771	0	8385	0	7614	0.0	0.0
chrX	BCOR	40052112	40052217	0	106	266	9975	266	9869	0.0	0.02695308541898875
chrX	BCOR	40097214	40097929	0	716	266	9975	266	9259	0.0	0.02872880440652338
chrX	BCOR	40053837	40053884	0	48	266	9975	266	9927	0.0	0.026795607937947014
chrX	CASK	41853096	41853113	0	18	13925	19740	13925	19722	0.0	0.7060642936821824
chrX	NDP	43958471	43958716	0	246	0	1823	0	1577	0.0	0.0
chrX	LINC01186	46327303	46327549	7129	247	50220	2534	43091	2287	28.86234817813765	18.84171403585483
chrX	ZNF674	46528334	46528348	30	15	50009	4445	49979	4430	2.0	11.281941309255078
chrX	SLC9A7	46606907	46606922	0	16	1576	2435	1576	2419	0.0	0.6515088879702357
chrX	NDUFB11	47142583	47142612	0	30	341	955	341	925	0.0	0.36864864864864866
chrX	ZNF182	48003903	48003907	0	5	1581	3605	1581	3600	0.0	0.43916666666666665
chrX	ZNF630	48071266	48071464	0	199	1288	3458	1288	3259	0.0	0.39521325559987724
chrX	SLC38A5	48468240	48468303	0	64	258940	3938	258940	3874	0.0	66.84047496128034
chrX	TIMM17B	48897535	48897722	102	188	314668	2570	314566	2382	0.5425531914893617	132.05961376994122
chrX	SLC35A2	48904163	48904744	102	582	3851	2960	3749	2378	0.17525773195876287	1.5765349032800673
chrX	SLC35A2	48909813	48909851	0	39	3851	2960	3851	2921	0.0	1.3183841150290996
chrX	SLC35A2	48911468	48911544	26	77	3851	2960	3825	2883	0.33766233766233766	1.3267429760665972
chrX	SLC35A2	48911468	48911505	0	38	3851	2960	3851	2922	0.0	1.3179329226557153
chrX	SLC35A2	48911545	48911857	1664	313	3851	2960	2187	2647	5.31629392971246	0.8262183604080091
chrX	SLC35A2	48911545	48911711	433	167	3851	2960	3418	2793	2.592814371257485	1.2237737200143215
chrX	SLC35A2	48911506	48911544	26	39	3851	2960	3825	2921	0.6666666666666666	1.309483053748716
chrX	SLC35A2	48911712	48911857	1231	146	3851	2960	2620	2814	8.431506849315069	0.9310589907604833
chrX	OTUD5	48956976	48956979	0	4	135775	3567	135775	3563	0.0	38.10693236037047
chrX	OTUD5	48934695	48934709	4012	15	135775	3567	131763	3552	267.46666666666664	37.095439189189186
chrX	WDR45	49079750	49079788	0	39	1938	3931	1938	3892	0.0	0.49794450154162384
chrX	WDR45	49077836	49077883	0	48	1938	3931	1938	3883	0.0	0.4990986350759722
chrX	WDR45	49079789	49079937	0	149	1938	3931	1938	3782	0.0	0.5124272871496562
chrX	WDR45	49076405	49076428	0	24	1938	3931	1938	3907	0.0	0.49603276170975175
chrX	WDR45	49079746	49079749	0	4	1938	3931	1938	3927	0.0	0.4935064935064935
chrX	WDR45	49079746	49079788	0	43	1938	3931	1938	3888	0.0	0.4984567901234568
chrX	SYP	49197538	49197713	0	176	0	4790	0	4614	0.0	0.0
chrX	SYP	49197486	49197713	0	228	0	4790	0	4562	0.0	0.0
chrX	SYP	49197486	49197537	0	52	0	4790	0	4738	0.0	0.0
chrX	CACNA1F	49226936	49226968	0	33	0	6976	0	6943	0.0	0.0
chrX	MAGED4B	52064447	52064499	0	53	255	4000	255	3947	0.0	0.06460602989612364
chrX	MAGED4B	52062221	52062232	0	12	255	4000	255	3988	0.0	0.06394182547642929
chrX	XAGE1B	52515415	52515430	0	16	0	1419	0	1403	0.0	0.0
chrX	FAM156A	52995305	52995413	153	109	229722	5892	229569	5783	1.4036697247706422	39.69721597786616
chrX	FAM156A	52957087	52957600	0	514	229722	5892	229722	5378	0.0	42.715135738192636
chrX	FAM156A	52957087	52958403	0	1317	229722	5892	229722	4575	0.0	50.212459016393446
chrX	KDM5C	53193772	53193780	34	9	131862	8589	131828	8580	3.7777777777777777	15.364568764568764
chrX	HSD17B10	53431797	53431823	0	27	24435	1118	24435	1091	0.0	22.396883593033913
chrX	HUWE1	53543840	53543884	0	45	128059	17357	128059	17312	0.0	7.397123382624769
chrX	HUWE1	53602563	53602589	0	27	128059	17357	128059	17330	0.0	7.389440276976342
chrX	PHF8	54043761	54043810	0	50	9521	9217	9521	9167	0.0	1.0386167775717248
chrX	PHF8	54043057	54043109	938	53	9521	9217	8583	9164	17.69811320754717	0.9365997381056307
chrX	WNK3	54238867	54239007	0	141	2742	11498	2742	11357	0.0	0.2414369992075372
chrX	FAM104B	55159125	55159127	0	3	0	2504	0	2501	0.0	0.0
chrX	FAM104B	55159121	55159124	0	4	0	2504	0	2500	0.0	0.0
chrX	FAM104B	55159121	55159127	0	7	0	2504	0	2497	0.0	0.0
chrX	FAM104B	55160864	55160973	0	110	0	2504	0	2394	0.0	0.0
chrX	AL159987.1	55656355	55656376	0	22	0	296	0	274	0.0	0.0
chrX	SPIN3	56995215	56995279	0	65	4998	13521	4998	13456	0.0	0.37143281807372175
chrX	SPIN3	56995215	56995240	0	26	4998	13521	4998	13495	0.0	0.37035939236754356
chrX	SPIN3	56995241	56995279	0	39	4998	13521	4998	13482	0.0	0.3707165109034268
chrX	SPIN3	56995215	56995626	0	412	4998	13521	4998	13109	0.0	0.3812647799221909
chrX	SPIN3	56978291	56978578	0	288	4998	13521	4998	13233	0.0	0.37769213330310586
chrX	SPIN3	56995058	56995214	0	157	4998	13521	4998	13364	0.0	0.3739898234061658
chrX	SPIN3	56995058	56995279	0	222	4998	13521	4998	13299	0.0	0.3758177306564403
chrX	SPIN3	56995058	56995240	0	183	4998	13521	4998	13338	0.0	0.3747188484030589
chrX	SPIN3	56995058	56995626	0	569	4998	13521	4998	12952	0.0	0.3858863495985176
chrX	SPIN3	56995241	56995626	0	386	4998	13521	4998	13135	0.0	0.38051008755234106
chrX	SPIN3	56993786	56994721	0	936	4998	13521	4998	12585	0.0	0.39713945172824794
chrX	LINC01278	63238992	63239785	51	794	1956	13947	1905	13153	0.06423173803526448	0.1448338782026914
chrX	ARHGEF9	63754303	63754313	0	11	11987	12238	11987	12227	0.0	0.9803713093972356
chrX	ARHGEF9	63754303	63754919	0	617	11987	12238	11987	11621	0.0	1.0314947078564667
chrX	ARHGEF9	63754303	63754306	0	4	11987	12238	11987	12234	0.0	0.9798103645577898
chrX	ARHGEF9	63754920	63755017	0	98	11987	12238	11987	12140	0.0	0.9873970345963756
chrX	ARHGEF9	63754314	63754919	0	606	11987	12238	11987	11632	0.0	1.030519257221458
chrX	ARHGEF9	63755157	63755206	0	50	11987	12238	11987	12188	0.0	0.9835083688874302
chrX	ARHGEF9	63754307	63754313	0	7	11987	12238	11987	12231	0.0	0.9800506908674679
chrX	ARHGEF9	63656509	63657903	0	1395	11987	12238	11987	10843	0.0	1.1055058563128286
chrX	LAS1L	65520701	65523558	0	2858	188	7818	188	4960	0.0	0.03790322580645161
chrX	SNX12	71068141	71068152	0	12	204	2360	204	2348	0.0	0.0868824531516184
chrX	AL590764.2	71106339	71106357	0	19	0	2383	0	2364	0.0	0.0
chrX	AL590764.2	71106339	71106352	0	14	0	2383	0	2369	0.0	0.0
chrX	AL590764.2	71106353	71106357	0	5	0	2383	0	2378	0.0	0.0
chrX	ZMYM3	71244301	71244321	0	21	51	6928	51	6907	0.0	0.007383813522513392
chrX	ZMYM3	71246594	71246629	0	36	51	6928	51	6892	0.0	0.007399883923389437
chrX	ZMYM3	71254467	71254479	0	13	51	6928	51	6915	0.0	0.00737527114967462
chrX	BX276092.5	71761967	71762414	0	448	0	1393	0	945	0.0	0.0
chrX	RPS4X	72272639	72272677	0	39	102	2058	102	2019	0.0	0.05052005943536404
chrX	HDAC8	72572650	72572692	0	43	89	18208	89	18165	0.0	0.004899532067162125
chrX	HDAC8	72330657	72330689	33	33	89	18208	56	18175	1.0	0.0030811554332874826
chrX	HDAC8	72330690	72330814	5	125	89	18208	84	18083	0.04	0.0046452469169938615
chrX	XIST	73826114	73826736	0	623	6270	13551	6270	12928	0.0	0.4849938118811881
chrX	XIST	73822066	73822069	0	4	6270	13551	6270	13547	0.0	0.4628330995792426
chrX	XIST	73841291	73841380	0	90	6270	13551	6270	13461	0.0	0.4657900601738355
chrX	FTX	74280376	74280392	0	17	14521	26391	14521	26374	0.0	0.550580116781679
chrX	FTX	74292168	74292324	624	157	14521	26391	13897	26234	3.9745222929936306	0.5297324083250743
chrX	ATRX	77651982	77652112	0	131	255	17249	255	17118	0.0	0.014896600070101648
chrX	ATRX	77785844	77785980	0	137	255	17249	255	17112	0.0	0.014901823281907433
chrX	BRWD3	80684009	80684088	0	80	51	14275	51	14195	0.0	0.003592814371257485
chrX	TSPAN6	100636607	100636791	0	185	102	4546	102	4361	0.0	0.023389130933272186
chrX	TRMT2B	101042041	101042231	0	191	8	4036	8	3845	0.0	0.002080624187256177
chrX	TRMT2B	101051250	101051642	0	393	8	4036	8	3643	0.0	0.0021959923140269007
chrX	TIMM8A	101347926	101348059	0	134	0	3083	0	2949	0.0	0.0
chrX	GLA	101398369	101398783	0	415	0	2857	0	2442	0.0	0.0
chrX	GLA	101401631	101401666	0	36	0	2857	0	2821	0.0	0.0
chrX	GLA	101398718	101398783	0	66	0	2857	0	2791	0.0	0.0
chrX	ARMCX6	101617282	101617290	0	9	0	2071	0	2062	0.0	0.0
chrX	ARMCX2	101658460	101658490	0	31	0	3553	0	3522	0.0	0.0
chrX	ARMCX2	101659407	101659417	0	11	0	3553	0	3542	0.0	0.0
chrX	TCP11X2	102463124	102463218	0	95	1036	1930	1036	1835	0.0	0.5645776566757493
chrX	BEX2	103310859	103310894	0	36	0	1137	0	1101	0.0	0.0
chrX	BEX2	103310582	103310858	0	277	0	1137	0	860	0.0	0.0
chrX	BEX2	103310582	103310894	0	313	0	1137	0	824	0.0	0.0
chrX	BEX2	103310582	103310584	0	3	0	1137	0	1134	0.0	0.0
chrX	BEX2	103310585	103310858	0	274	0	1137	0	863	0.0	0.0
chrX	BEX2	103310585	103310894	0	310	0	1137	0	827	0.0	0.0
chrX	MORC4	106941937	106941974	0	38	1815	6036	1815	5998	0.0	0.30260086695565186
chrX	TSC22D3	107776969	107777018	0	50	315	4689	315	4639	0.0	0.06790256520801898
chrX	TSC22D3	107777019	107777270	0	252	315	4689	315	4437	0.0	0.07099391480730223
chrX	PSMD10	108087685	108087763	0	79	0	2395	0	2316	0.0	0.0
chrX	CHRDL1	110795685	110795742	0	58	51	3932	51	3874	0.0	0.013164687661331956
chrX	DCX	111312638	111312640	0	3	0	10073	0	10070	0.0	0.0
chrX	DCX	111330903	111330917	0	15	0	10073	0	10058	0.0	0.0
chrX	DCX	111411969	111412136	0	168	0	10073	0	9905	0.0	0.0
chrX	KLHL13	117972730	117973308	0	579	20595	6416	20595	5837	0.0	3.5283536063046084
chrX	SLC25A5-AS1	119468809	119468980	0	172	0	2106	0	1934	0.0	0.0
chrX	CXORF56	119565124	119565230	193411	107	288142	2588	94731	2481	1807.5794392523364	38.1825876662636
chrX	CUL4B	120538117	120538122	0	6	0	8106	0	8100	0.0	0.0
chrX	THOC2	123620374	123620905	0	532	102	10063	102	9531	0.0	0.010701920050361977
chrX	AL034405.1	129933693	129933700	0	8	0	1797	0	1789	0.0	0.0
chrX	AIFM1	130133312	130133382	0	71	408	10093	408	10022	0.0	0.04071043703851527
chrX	AIFM1	130136044	130136046	0	3	408	10093	408	10090	0.0	0.04043607532210109
chrX	AIFM1	130131666	130131673	0	8	408	10093	408	10085	0.0	0.04045612295488349
chrX	IGSF1	131289405	131289408	0	4	0	7445	0	7441	0.0	0.0
chrX	FIRRE	131756610	131756641	0	32	0	9139	0	9107	0.0	0.0
chrX	FIRRE	131794296	131794322	0	27	0	9139	0	9112	0.0	0.0
chrX	MIR503HG	134545346	134545463	0	118	0	2887	0	2769	0.0	0.0
chrX	MIR503HG	134545464	134545950	0	487	0	2887	0	2400	0.0	0.0
chrX	MOSPD1	134896813	134896815	0	3	51	2593	51	2590	0.0	0.019691119691119693
chrX	ETDB	135119714	135119732	0	19	2142	703	2142	684	0.0	3.1315789473684212
chrX	FMR1-AS1	147911377	147911640	0	264	0	2104	0	1840	0.0	0.0
chrX	FMR1-AS1	147911280	147911376	0	97	0	2104	0	2007	0.0	0.0
chrX	MAGEA9B	149587361	149587392	0	32	941	1926	941	1894	0.0	0.4968321013727561
chrX	EOLA2	149937413	149937431	15570	19	217964	2354	202394	2335	819.4736842105264	86.67837259100642
chrX	CD99L2	150777335	150777442	0	108	867	5777	867	5669	0.0	0.1529370259304992
chrX	AF274853.1	151395876	151396429	0	554	0	4506	0	3952	0.0	0.0
chrX	MAGEA10	152135989	152136060	0	72	6115	2903	6115	2831	0.0	2.160014129282939
chrX	CSAG2	152708834	152708848	3	15	18478	492	18475	477	0.2	38.731656184486376
chrX	CSAG2	152708798	152708833	108	36	18478	492	18370	456	3.0	40.28508771929825
chrX	CSAG2	152708798	152708848	111	51	18478	492	18367	441	2.176470588235294	41.64852607709751
chrX	CSAG1	152733020	152733023	0	4	31273	1096	31273	1092	0.0	28.638278388278387
chrX	MAGEA2	152753612	152753786	0	175	0	2115	0	1940	0.0	0.0
chrX	PNMA5	152991901	152991914	0	14	145825	3432	145825	3418	0.0	42.66383850204798
chrX	CCNQ	153598961	153598964	0	4	3601489	1673	3601489	1669	0.0	2157.872378669862
chrX	PNCK	153673928	153674272	460932	345	3082117	4218	2621185	3873	1336.0347826086957	676.7841466563387
chrX	PNCK	153673299	153673310	228	12	3082117	4218	3081889	4206	19.0	732.7363290537328
chrX	PNCK	153687249	153687429	7979	181	3082117	4218	3074138	4037	44.0828729281768	761.4907109239534
chrX	PNCK	153687249	153687333	4996	85	3082117	4218	3077121	4133	58.77647058823529	744.524800387128
chrX	PNCK	153687334	153687429	2983	96	3082117	4218	3079134	4122	31.072916666666668	747.0
chrX	BCAP31	153702934	153703038	471	105	46135	2972	45664	2867	4.485714285714286	15.927450296477154
chrX	BCAP31	153723507	153724014	0	508	46135	2972	46135	2464	0.0	18.72362012987013
chrX	BCAP31	153723507	153723953	0	447	46135	2972	46135	2525	0.0	18.27128712871287
chrX	BCAP31	153724260	153724332	0	73	46135	2972	46135	2899	0.0	15.914108313211452
chrX	BCAP31	153724200	153724332	0	133	46135	2972	46135	2839	0.0	16.250440295878832
chrX	BCAP31	153724200	153724259	0	60	46135	2972	46135	2912	0.0	15.843063186813186
chrX	BCAP31	153723954	153724014	0	61	46135	2972	46135	2911	0.0	15.848505668155273
chrX	IDH3G	153794245	153794313	0	69	68516	2656	68516	2587	0.0	26.484731349052957
chrX	PDZD4	153808341	153808358	0	18	2078	4353	2078	4335	0.0	0.47935409457900807
chrX	NAA10	153933942	153933959	0	18	0	4351	0	4333	0.0	0.0
chrX	RENBP	153944079	153944120	0	42	0	2045	0	2003	0.0	0.0
chrX	RENBP	153944579	153944582	0	4	0	2045	0	2041	0.0	0.0
chrX	FLNA	154365744	154366022	0	279	83220	9862	83220	9583	0.0	8.684128143587603
chrX	DNASE1L1	154408557	154409110	0	554	204	3587	204	3033	0.0	0.06726013847675569
chrX	FAM3A	154515909	154515967	0	59	5044	4886	5044	4827	0.0	1.0449554588771495
chrX	MPP1	154792141	154792191	0	51	2091	5410	2091	5359	0.0	0.39018473595820113
chrX	F8	155022409	155022430	0	22	663	10987	663	10965	0.0	0.06046511627906977
chrY	PLCXD1	283489	283520	0	32	2324	6077	2324	6045	0.0	0.384449958643507
chrY	CSF2RA	1274819	1274842	0	24	666	3562	666	3538	0.0	0.18824194460146976
chrY	ZFY	2935447	2935769	0	323	0	5444	0	5121	0.0	0.0
chrY	LINC00279	8583696	8583701	0	6	0	14291	0	14285	0.0	0.0
chrY	NLGN4Y	14524709	14524936	0	228	102	8602	102	8374	0.0	0.012180558872701218
chrY	TXLNGY	19567483	19567570	0	88	51	8366	51	8278	0.0	0.006160908431988403
chrY	VAMP7	57076129	57076132	0	4	0	2623	0	2619	0.0	0.0
chrY	VAMP7	57076068	57076132	0	65	0	2623	0	2558	0.0	0.0
chrY	WASH6P	57209730	57209733	0	4	0	2698	0	2694	0.0	0.0
chrY	WASH6P	57211570	57211620	0	51	0	2698	0	2647	0.0	0.0
chrY	TTTY23B	6243552	6243552	0	1	0	861	0	860	0.0	0.0
chrY	FAM197Y9	6263833	6263858	0	26	0	2866	0	2840	0.0	0.0
chrY	AC244213.1	12662525	12662655	0	131	0	1220	0	1089	0.0	0.0
chrY	AC244213.1	12663303	12663359	0	57	0	1220	0	1163	0.0	0.0
chrY	UTY	13355002	13355373	0	372	3078	9223	3078	8851	0.0	0.3477573155575641
chrY	TTTY14	19055964	19056082	0	119	255	17451	255	17332	0.0	0.014712670205400416
chrY	TTTY14	19055874	19055963	0	90	255	17451	255	17361	0.0	0.014688094003801624
chrY	TTTY14	19055874	19056082	0	209	255	17451	255	17242	0.0	0.01478946757916715
chrY	TTTY14	19044541	19044660	0	120	255	17451	255	17331	0.0	0.014713519127574865
chrY	TTTY14	18932650	18932741	0	92	255	17451	255	17359	0.0	0.014689786278011405
chrY	TTTY14	18877369	18878203	0	835	255	17451	255	16616	0.0	0.015346653827636014
chrY	TTTY14	19077044	19077266	0	223	255	17451	255	17228	0.0	0.014801485953099606
chrY	KDM5D	19708243	19708320	0	78	122	9273	122	9195	0.0	0.013268080478520934
chrY	TTTY10	20518270	20519034	0	765	0	8026	0	7261	0.0	0.0
