chrom	geneName	splicedExonStart	splicedExonEnd	splicedExonReadCount(rc)	splicedExonLength(sl)	othersExonsReadCount(RC)	othersExonsLength(L)	RC - rc	L - sl	splicedExonAverageReadCoverage(n)	otherExonsAverageReadCoverage(N)
chr1	LINC01128	851926	852766	741	841	56879	13620	56138	12779	0.8810939357907254	4.392988496752484
chr1	PLEKHN1	974441	975865	2193	1425	5882	3466	3689	2041	1.5389473684210526	1.8074473297403233
chr1	PLEKHN1	970685	971006	2325	322	5882	3466	3557	3144	7.220496894409938	1.1313613231552162
chr1	SCNN1D	1287507	1287836	17334	330	51188	3430	33854	3100	52.527272727272724	10.920645161290322
chr1	MRPL20-AS1	1399519	1400303	102	785	153	2407	51	1622	0.12993630573248408	0.031442663378545004
chr1	MIB2	1629384	1629566	0	183	67209	7887	67209	7704	0.0	8.723909657320872
chr1	MIB2	1626836	1627207	459	372	67209	7887	66750	7515	1.2338709677419355	8.882235528942116
chr1	MMP23B	1632980	1633355	912	376	110201	2013	109289	1637	2.425531914893617	66.76175931582162
chr1	MMP23B	1633747	1634099	22918	353	110201	2013	87283	1660	64.92351274787535	52.58012048192771
chr1	DFFB	3883506	3885429	0	1924	0	3880	0	1956	0.0	0.0
chr1	LINC01646	4593051	4594009	0	959	0	3336	0	2377	0.0	0.0
chr1	KCNAB2	6095529	6096756	0	1228	42121	13510	42121	12282	0.0	3.429490311024263
chr1	KCNAB2	6097268	6097555	153	288	42121	13510	41968	13222	0.53125	3.174103766449856
chr1	KCNAB2	6085203	6086363	360	1161	42121	13510	41761	12349	0.31007751937984496	3.38173131427646
chr1	ESPN	6448640	6449091	32	452	10054	6800	10022	6348	0.07079646017699115	1.5787649653434153
chr1	PER3	7829836	7830161	27	326	22788	7397	22761	7071	0.08282208588957055	3.218922358930844
chr1	TARDBP	11023192	11024183	102	992	153	4648	51	3656	0.1028225806451613	0.013949671772428883
chr1	MFN2	11981809	11982114	2801	306	419893	10140	417092	9834	9.15359477124183	42.4132601179581
chr1	PLEKHM2	15727013	15727832	0	820	1533	4154	1533	3334	0.0	0.45980803839232154
chr1	NECAP2	16458841	16460077	462012	1237	1967543	4594	1505531	3357	373.4939369442199	448.475126601132
chr1	SLC66A1	19312325	19312889	0	565	0	2695	0	2130	0.0	0.0
chr1	EPHB2	22913461	22921500	0	8040	0	11673	0	3633	0.0	0.0
chr1	LYPLA2	23794223	23794600	307	378	790	1850	483	1472	0.8121693121693122	0.328125
chr1	SRRM1	24652433	24652628	0	196	8136	5651	8136	5455	0.0	1.4914757103574703
chr1	SRRM1	24670119	24670315	0	197	8136	5651	8136	5454	0.0	1.4917491749174918
chr1	ZNF593	26170417	26170873	51	457	51	734	0	277	0.11159737417943107	0.0
chr1	ARID1A	26774328	26774901	7948	574	104732	12546	96784	11972	13.846689895470384	8.08419645840294
chr1	PIGV	26794112	26795234	3291	1123	955660	5866	952369	4743	2.9305431878895813	200.79464473961627
chr1	PPP1R8	27850092	27851676	255	1585	603	2822	348	1237	0.1608832807570978	0.2813257881972514
chr1	THEMIS2	27881970	27883043	3250	1074	18413	2665	15163	1591	3.026070763500931	9.530483972344438
chr1	PHACTR4	28496533	28500364	51	3832	3249	7336	3198	3504	0.013308977035490605	0.9126712328767124
chr1	CCDC28B	32204597	32205387	14710	791	43396	2043	28686	1252	18.596713021491784	22.91214057507987
chr1	EIF3I	32221720	32222032	7631	313	17127	5731	9496	5418	24.380191693290733	1.7526762643041713
chr1	EIF3I	32228726	32229208	0	483	17127	5731	17127	5248	0.0	3.2635289634146343
chr1	EIF3I	32230926	32231602	0	677	17127	5731	17127	5054	0.0	3.388800949742778
chr1	EIF3I	32228726	32231019	765	2294	17127	5731	16362	3437	0.33347863993025284	4.760546988652895
chr1	LCK	32274736	32275083	0	348	51	3193	51	2845	0.0	0.017926186291739893
chr1	TEKT2	36087727	36088275	306	549	3897	1969	3591	1420	0.5573770491803278	2.52887323943662
chr1	MAP7D1	36176198	36176581	0	384	198643	4365	198643	3981	0.0	49.897764380808844
chr1	THRAP3	36303795	36305357	32335	1563	68658	4735	36323	3172	20.687779910428663	11.451134930643127
chr1	SH3D21	36321055	36321778	55411	724	176698	6435	121287	5711	76.53453038674033	21.23743652600245
chr1	LINC01685	38476192	38476484	0	293	261	3681	261	3388	0.0	0.07703659976387249
chr1	LINC01685	38474881	38475824	0	944	261	3681	261	2737	0.0	0.09535988308366825
chr1	SZT2	43427529	43428118	0	590	36229	24016	36229	23426	0.0	1.54652949713993
chr1	ARTN	43936068	43936346	714	279	1938	2662	1224	2383	2.5591397849462365	0.5136382710868653
chr1	ATP6V0B	43977025	43978295	32	1271	2958	2433	2926	1162	0.025177025963808025	2.5180722891566263
chr1	CCDC24	43993889	43995162	102	1274	5	2226	-97	952	0.08006279434850863	-0.10189075630252101
chr1	CCDC24	43995600	43995856	0	257	5	2226	5	1969	0.0	0.0025393600812595226
chr1	AL139220.2	44050949	44051494	22503	546	138097	9671	115594	9125	41.214285714285715	12.667835616438357
chr1	KLF17	44129352	44130196	4999	845	106727	3164	101728	2319	5.915976331360946	43.86718413109099
chr1	DMAP1	44213470	44213858	942	389	4135	2653	3193	2264	2.4215938303341904	1.4103356890459364
chr1	ARMH1	44724319	44724668	120	350	20984	3290	20864	2940	0.34285714285714286	7.096598639455783
chr1	MAST2	46032177	46032404	152938	228	583865	7806	430927	7578	670.780701754386	56.86553180258643
chr1	MAST2	46032595	46032718	84350	124	583865	7806	499515	7682	680.241935483871	65.02408227024212
chr1	DIO1	53904665	53904809	0	145	82	2265	82	2120	0.0	0.038679245283018866
chr1	DIO1	53894438	53894547	31	110	82	2265	51	2155	0.2818181818181818	0.023665893271461718
chr1	DIO1	53894188	53894547	82	360	82	2265	0	1905	0.22777777777777777	0.0
chr1	DIO1	53894210	53894547	82	338	82	2265	0	1927	0.24260355029585798	0.0
chr1	MROH7-TTC4	54731485	54731700	0	216	193330	7125	193330	6909	0.0	27.98234187291938
chr1	MIER1	66984571	66988619	0	4049	51	6542	51	2493	0.0	0.02045728038507822
chr1	FPGT-TNNI3K	74370287	74375848	0	5562	0	9928	0	4366	0.0	0.0
chr1	NEXN	77942460	77943895	0	1436	106	4215	106	2779	0.0	0.03814321698452681
chr1	LINC01140	87133613	87136669	0	3057	5678	6060	5678	3003	0.0	1.8907758907758907
chr1	BRDT	91949397	91949682	51	286	29498	4344	29447	4058	0.17832167832167833	7.256530310497782
chr1	MTF2	93110229	93110428	0	200	1241	5924	1241	5724	0.0	0.21680642907058
chr1	FNBP1L	93550946	93554659	1168	3714	454	4512	-714	798	0.31448572967151317	-0.8947368421052632
chr1	LINC02790	95991976	95992509	0	534	0	2786	0	2252	0.0	0.0
chr1	LINC02790	95992009	95992509	0	501	0	2786	0	2285	0.0	0.0
chr1	LINC02790	95992025	95992509	0	485	0	2786	0	2301	0.0	0.0
chr1	AC118553.2	100078450	100080659	0	2210	51	5784	51	3574	0.0	0.014269725797425853
chr1	TRMT13	100140407	100141019	204	613	1644	4144	1440	3531	0.33278955954323003	0.4078164825828377
chr1	AC093157.1	101080388	101083574	51	3187	0	7130	-51	3943	0.016002510197678066	-0.012934313974131372
chr1	AC093157.1	101080886	101083574	51	2689	0	7130	-51	4441	0.01896615842320565	-0.011483900022517451
chr1	RNPC3	103525698	103526262	0	565	51	5469	51	4904	0.0	0.010399673735725938
chr1	LINC02785	108071483	108072697	0	1215	0	4139	0	2924	0.0	0.0
chr1	GPR61	109542421	109544639	0	2219	2480	3508	2480	1289	0.0	1.9239720713731574
chr1	CSF1	109923165	109924190	0	1026	1281	5251	1281	4225	0.0	0.30319526627218935
chr1	CEPT1	111182186	111182318	0	133	0	4458	0	4325	0.0	0.0
chr1	CHIAP2	111281550	111282475	0	926	0	2199	0	1273	0.0	0.0
chr1	NBPF26	120805555	120805765	37	211	35337	6817	35300	6606	0.17535545023696683	5.343627005752347
chr1	NBPF26	120805417	120805765	37	349	35337	6817	35300	6468	0.10601719197707736	5.457637600494744
chr1	LINC00623	120952438	120953460	0	1023	102	2606	102	1583	0.0	0.06443461781427669
chr1	POLR3C	145826453	145826709	0	257	7880	4583	7880	4326	0.0	1.821544151641239
chr1	GNRHR2	145919343	145919900	564	558	1751	2338	1187	1780	1.010752688172043	0.6668539325842696
chr1	POLR3GL	145974824	145974991	0	168	0	1316	0	1148	0.0	0.0
chr1	LINC01719	146057693	146058461	8126	769	34193	2631	26067	1862	10.566970091027308	13.999462943071965
chr1	NBPF12	146987953	146988126	0	174	0	7308	0	7134	0.0	0.0
chr1	CHD1L	147252622	147252735	0	114	0	4200	0	4086	0.0	0.0
chr1	CHD1L	147254869	147254976	0	108	0	4200	0	4092	0.0	0.0
chr1	CHD1L	147255812	147255927	0	116	0	4200	0	4084	0.0	0.0
chr1	CHD1L	147264421	147264584	0	164	0	4200	0	4036	0.0	0.0
chr1	CHD1L	147272170	147272630	0	461	0	4200	0	3739	0.0	0.0
chr1	LINC02805	148162755	148163815	0	1061	0	5857	0	4796	0.0	0.0
chr1	PDE4DIP	148991884	148993882	0	1999	6068	23819	6068	21820	0.0	0.2780934922089826
chr1	SNX27	151693423	151694484	0	1062	157502	16235	157502	15173	0.0	10.380412574968695
chr1	OAZ3	151767162	151767299	0	138	55506	4640	55506	4502	0.0	12.329187027987562
chr1	INTS3	153773192	153774808	408	1617	23309	9073	22901	7456	0.2523191094619666	3.071486051502146
chr1	INTS3	153772339	153772711	0	373	23309	9073	23309	8700	0.0	2.6791954022988507
chr1	CREB3L4	153972743	153973078	0	336	413210	2539	413210	2203	0.0	187.56695415342713
chr1	AQP10	154323588	154325325	47562	1738	143770	2297	96208	559	27.365937859608746	172.10733452593917
chr1	TDRD10	154547408	154548147	0	740	8761	2719	8761	1979	0.0	4.426983324911571
chr1	FLAD1	154992712	154993111	0	400	204753	3992	204753	3592	0.0	57.00250556792873
chr1	FLAD1	154990158	154990528	31168	371	204753	3992	173585	3621	84.01078167115902	47.938414802540734
chr1	SLC50A1	155138179	155138853	0	675	51	1885	51	1210	0.0	0.04214876033057851
chr1	DAP3	155738156	155739010	51	855	57901	4354	57850	3499	0.05964912280701754	16.533295227207773
chr1	LMNA	156114712	156115274	1325	563	324066	7357	322741	6794	2.3534635879218473	47.503826906093614
chr1	LMNA	156137653	156138757	102	1105	324066	7357	323964	6252	0.09230769230769231	51.81765834932821
chr1	LMNA	156135860	156136436	0	577	324066	7357	324066	6780	0.0	47.79734513274336
chr1	LMNA	156114710	156115274	1331	565	324066	7357	322735	6792	2.3557522123893806	47.51693168433451
chr1	SEMA4A	156154549	156154717	0	169	12683	6084	12683	5915	0.0	2.1442096365173287
chr1	TMEM79	156285183	156285983	21175	801	36529	3037	15354	2236	26.43570536828964	6.866726296958855
chr1	RHBG	156377989	156378399	0	411	0	3394	0	2983	0.0	0.0
chr1	RRNAD1	156731990	156732473	294	484	13315	2891	13021	2407	0.6074380165289256	5.409638554216867
chr1	FCRL6	159808960	159809245	1134	286	13471	2371	12337	2085	3.965034965034965	5.917026378896883
chr1	KLHDC9	161098360	161099062	2244	703	5338	1599	3094	896	3.1920341394025606	3.453125
chr1	PPOX	161170906	161171218	332	313	13139	4416	12807	4103	1.060702875399361	3.1213746039483303
chr1	PPOX	161170906	161171181	332	276	13139	4416	12807	4140	1.2028985507246377	3.0934782608695652
chr1	NDUFS2	161213863	161214381	357	519	22843	7304	22486	6785	0.6878612716763006	3.314075165806927
chr1	NDUFS2	161212591	161213182	0	592	22843	7304	22843	6712	0.0	3.4033075089392133
chr1	NDUFS2	161213863	161214299	357	437	22843	7304	22486	6867	0.816933638443936	3.27450123780399
chr1	NDUFS2	161213863	161214395	357	533	22843	7304	22486	6771	0.6697936210131332	3.3209274848619112
chr1	FCGR2C	161589561	161589819	51	259	94	3594	43	3335	0.1969111969111969	0.012893553223388306
chr1	LINC00626	168786753	168787228	0	476	0	1537	0	1061	0.0	0.0
chr1	FMO1	171281977	171283216	0	1240	1326	2776	1326	1536	0.0	0.86328125
chr1	FMO4	171341412	171342084	0	673	714	2552	714	1879	0.0	0.37998935604044703
chr1	CEP350	180110996	180113380	0	2385	3782	14304	3782	11919	0.0	0.31730849903515396
chr1	DHX9	182883138	182883368	0	231	24971	5929	24971	5698	0.0	4.382414882414882
chr1	IGFN1	201206082	201213621	421068	7540	566674	12141	145606	4601	55.84456233421751	31.64659856552923
chr1	ZC3H11A	203801574	203803016	6682	1443	13902	8033	7220	6590	4.63063063063063	1.0955993930197268
chr1	ZC3H11A	203796450	203803016	55336	6567	13902	8033	-41434	1466	8.426374295721029	-28.26330150068213
chr1	ERLNC1	204141407	204142260	0	854	0	1534	0	680	0.0	0.0
chr1	CNTN2	205058180	205058663	306	484	172972	14396	172666	13912	0.6322314049586777	12.41129959746981
chr1	CNTN2	205073655	205074944	18540	1290	172972	14396	154432	13106	14.372093023255815	11.783305356325346
chr1	CDK18	205523146	205523625	0	480	57	5600	57	5120	0.0	0.0111328125
chr1	MIR205HG	209428819	209429408	0	590	0	2601	0	2011	0.0	0.0
chr1	MIR205HG	209428822	209429408	0	587	0	2601	0	2014	0.0	0.0
chr1	ATF3	212615017	212615261	0	245	238746	3955	238746	3710	0.0	64.35202156334232
chr1	ATF3	212615021	212615261	0	241	238746	3955	238746	3714	0.0	64.2827140549273
chr1	ATF3	212619045	212619555	276532	511	238746	3955	-37786	3444	541.1585127201565	-10.971544715447154
chr1	VASH2	212951338	212951818	1107	481	73964	8706	72857	8225	2.3014553014553014	8.857993920972644
chr1	PSEN2	226897719	226899555	154	1837	4542	12917	4388	11080	0.08383233532934131	0.396028880866426
chr1	AL118511.1	230874541	230875565	0	1025	8	1948	8	923	0.0	0.00866738894907909
chr1	TBCE	235435744	235436608	51	865	11570	8049	11519	7184	0.058959537572254334	1.603424276169265
chr1	TBCE	235436385	235436608	51	224	11570	8049	11519	7825	0.22767857142857142	1.4720766773162939
chr1	FMN2	240334108	240334229	0	122	0	9266	0	9144	0.0	0.0
chr1	LINC01341	246790445	246792385	2734	1941	4644	4672	1910	2731	1.4085522926326637	0.6993775173928963
chr1	AL732372.2	498398	498976	0	579	0	6130	0	5551	0.0	0.0
chr1	AL669831.3	764722	765247	0	526	3045	5509	3045	4983	0.0	0.6110776640577965
chr1	C1ORF159	1083914	1084383	0	470	1497	4115	1497	3645	0.0	0.41069958847736626
chr1	C1ORF159	1090352	1091374	153	1023	1497	4115	1344	3092	0.1495601173020528	0.4346701164294955
chr1	CCNL2	1390229	1390371	0	143	59013	6208	59013	6065	0.0	9.730090684253916
chr1	CCNL2	1390765	1391575	24612	811	59013	6208	34401	5397	30.347718865598026	6.374096720400222
chr1	CDK11A	1722587	1722831	0	245	168180	4549	168180	4304	0.0	39.075278810408925
chr1	TMEM52	1918892	1919088	0	197	51	1347	51	1150	0.0	0.04434782608695652
chr1	TMEM52	1919044	1919269	51	226	51	1347	0	1121	0.22566371681415928	0.0
chr1	PRDM16-DT	3059616	3060283	0	668	0	4427	0	3759	0.0	0.0
chr1	PRDM16-DT	3060500	3061331	0	832	0	4427	0	3595	0.0	0.0
chr1	LINC01345	3947956	3949024	0	1069	0	1907	0	838	0.0	0.0
chr1	TNFRSF25	6462862	6463127	0	266	101	3596	101	3330	0.0	0.03033033033033033
chr1	TNFRSF25	6462862	6463147	0	286	101	3596	101	3310	0.0	0.030513595166163143
chr1	PLEKHG5	6467824	6468586	51	763	266	6625	215	5862	0.06684141546526867	0.03667690208120095
chr1	KLHL21	6590723	6595557	276486	4835	300720	6486	24234	1651	57.18428128231644	14.678376741368867
chr1	MAD2L2	11680352	11680613	0	262	0	2907	0	2645	0.0	0.0
chr1	MTHFR	11802880	11804532	11734	1653	160765	6734	149031	5081	7.098608590441621	29.331037197402086
chr1	MTHFR	11802880	11803526	6675	647	160765	6734	154090	6087	10.316846986089644	25.314604895679317
chr1	CROCCP3	16476929	16478437	55405	1509	88415	5234	33010	3725	36.71636845593108	8.861744966442952
chr1	CROCCP3	16491009	16491316	2264	308	88415	5234	86151	4926	7.35064935064935	17.489037758830694
chr1	MST1L	16758802	16759168	0	367	15609	5187	15609	4820	0.0	3.2383817427385893
chr1	ALDH4A1	18871429	18872957	0	1529	0	3649	0	2120	0.0	0.0
chr1	AKR7L	19270747	19270935	0	189	0	2775	0	2586	0.0	0.0
chr1	RAP1GAP	21599493	21599617	0	125	5043	5400	5043	5275	0.0	0.9560189573459715
chr1	LACTBL1	22958684	22958920	0	237	0	1647	0	1410	0.0	0.0
chr1	RSRP1	25242248	25242705	0	458	462	5486	462	5028	0.0	0.09188544152744631
chr1	RSRP1	25243549	25245301	0	1753	462	5486	462	3733	0.0	0.12376105009375837
chr1	RSRP1	25242254	25242705	0	452	462	5486	462	5034	0.0	0.09177592371871275
chr1	AL391650.1	26171616	26171821	0	206	408	1644	408	1438	0.0	0.28372739916550765
chr1	KDF1	26951341	26952412	68	1072	68	1859	0	787	0.06343283582089553	0.0
chr1	CD164L2	27379175	27380195	51	1021	306	1994	255	973	0.04995102840352596	0.2620760534429599
chr1	SNHG12	28579532	28580646	236	1115	1224	3699	988	2584	0.2116591928251121	0.38235294117647056
chr1	SNHG12	28579532	28579981	185	450	1224	3699	1039	3249	0.4111111111111111	0.3197907048322561
chr1	SNHG12	28580559	28581871	918	1313	1224	3699	306	2386	0.6991622239146992	0.12824811399832356
chr1	SNHG12	28580559	28581229	51	671	1224	3699	1173	3028	0.07600596125186289	0.38738441215323643
chr1	MECR	29195940	29196258	0	319	0	4032	0	3713	0.0	0.0
chr1	SDC3	30876551	30878740	0	2190	51	7073	51	4883	0.0	0.010444398935080893
chr1	TMEM234	32215135	32215795	428	661	8945	3451	8517	2790	0.6475037821482602	3.052688172043011
chr1	TMEM234	32216199	32216947	0	749	8945	3451	8945	2702	0.0	3.3105107327905254
chr1	YARS1	32786361	32787075	2588	715	122331	8638	119743	7923	3.6195804195804198	15.11334090622239
chr1	AK2	33007985	33013402	4083	5418	7983	7812	3900	2394	0.7535991140642303	1.6290726817042607
chr1	AK2	33012073	33013402	409	1330	7983	7812	7574	6482	0.3075187969924812	1.1684665226781858
chr1	STK40	36339623	36343448	51	3826	47653	5632	47602	1806	0.013329848405645583	26.357696566998893
chr1	CSF3R	36466042	36466827	57	786	8426	8399	8369	7613	0.07251908396946564	1.0993038224090372
chr1	PPIEL	39547578	39548951	0	1374	16407	3504	16407	2130	0.0	7.70281690140845
chr1	PABPC4	39575758	39576790	0	1033	3670	8427	3670	7394	0.0	0.4963483905869624
chr1	CLDN19	42733092	42736030	2958	2939	2958	3606	0	667	1.0064647839401157	0.0
chr1	P3H1	42746374	42747412	0	1039	648	4271	648	3232	0.0	0.2004950495049505
chr1	MED8	43383916	43385106	0	1191	1071	2710	1071	1519	0.0	0.7050691244239631
chr1	SLC6A9	44000766	44001055	1377	290	104428	5268	103051	4978	4.748275862068965	20.701285656890317
chr1	TCTEX1D4	44806783	44807351	1275	569	3003	1357	1728	788	2.240773286467487	2.1928934010152283
chr1	MUTYH	45331660	45332086	0	427	35062	5148	35062	4721	0.0	7.426816352467697
chr1	POMGNT1	46188682	46189357	0	676	13905	5476	13905	4800	0.0	2.896875
chr1	LRRC41	46278400	46279084	1320	685	6706	7322	5386	6637	1.927007299270073	0.8115112249510321
chr1	LRRC41	46279181	46279614	306	434	6706	7322	6400	6888	0.7050691244239631	0.9291521486643438
chr1	STIL	47299904	47300152	0	249	379	6600	379	6351	0.0	0.059675641631239174
chr1	CALR4P	51567173	51567843	0	671	0	2713	0	2042	0.0	0.0
chr1	TXNDC12	52020130	52021012	0	883	202	2873	202	1990	0.0	0.10150753768844221
chr1	LRP8	53245544	53247056	6832	1513	88986	13559	82154	12046	4.515532055518837	6.82002324423045
chr1	LRP8	53245546	53247056	6708	1511	88986	13559	82278	12048	4.439444076770351	6.8291832669322705
chr1	MYSM1	58661405	58663522	0	2118	0	13140	0	11022	0.0	0.0
chr1	HSD52	59132472	59133330	12535	859	16576	6497	4041	5638	14.59254947613504	0.7167435260730756
chr1	LINC01748	60595537	60596373	0	837	51	15481	51	14644	0.0	0.0034826550122917235
chr1	NFIA-AS2	60952510	60954370	0	1861	0	5402	0	3541	0.0	0.0
chr1	LINC00466	63261741	63262700	51	960	2475	6950	2424	5990	0.053125	0.4046744574290484
chr1	LINC01359	64979576	64979868	0	293	0	5118	0	4825	0.0	0.0
chr1	DEPDC1	68489451	68489608	0	158	102	5916	102	5758	0.0	0.017714484195901353
chr1	ADGRL4	78889763	78891216	0	1454	16274	5737	16274	4283	0.0	3.7996731263133317
chr1	ZNHIT6	85707628	85708433	204	806	663	6213	459	5407	0.2531017369727047	0.08488995746254854
chr1	COL24A1	86156340	86156772	51	433	168909	9632	168858	9199	0.11778290993071594	18.356125665833243
chr1	SELENOF	86880661	86880725	0	65	0	2208	0	2143	0.0	0.0
chr1	GBP2	89106131	89108291	0	2161	5260	7237	5260	5076	0.0	1.0362490149724193
chr1	LINC02609	90835825	90836174	0	350	0	14100	0	13750	0.0	0.0
chr1	CCDC18-AS1	93337376	93339274	102	1899	36241	4958	36139	3059	0.053712480252764615	11.813991500490356
chr1	SLC44A3-AS1	94622718	94624609	408	1892	8896	10264	8488	8372	0.2156448202959831	1.0138557095078835
chr1	COL11A1	103001259	103001969	0	711	51	8948	51	8237	0.0	0.0061915746024037875
chr1	LINC01677	105952503	105953712	0	1210	0	3134	0	1924	0.0	0.0
chr1	CLCC1	108962308	108963453	3356	1146	3798	6514	442	5368	2.9284467713787086	0.0823397913561848
chr1	PSRC1	109280776	109281251	0	476	816	2373	816	1897	0.0	0.430152872957301
chr1	PSRC1	109282679	109283122	0	444	816	2373	816	1929	0.0	0.4230171073094868
chr1	KCNA2	110593579	110602170	458583	8592	582650	18742	124067	10150	53.373254189944134	12.223349753694581
chr1	KCNA2	110593579	110604106	513224	10528	582650	18742	69426	8214	48.7484802431611	8.452154857560263
chr1	PPM1J	112712743	112713031	0	289	0	2461	0	2172	0.0	0.0
chr1	TRIM45	117111059	117112453	0	1395	12397	4375	12397	2980	0.0	4.16006711409396
chr1	PIAS3	145856588	145857006	0	419	0	4092	0	3673	0.0	0.0
chr1	FMO5	147224894	147225339	0	446	0	5996	0	5550	0.0	0.0
chr1	AC239809.3	148226493	148226798	0	306	49367	14907	49367	14601	0.0	3.3810697897404287
chr1	NBPF14	148595542	148595752	27130	211	273751	12061	246621	11850	128.5781990521327	20.811898734177216
chr1	NBPF14	148595542	148595890	73819	349	273751	12061	199932	11712	211.5157593123209	17.070696721311474
chr1	NBPF9	149081964	149082311	0	348	459	8033	459	7685	0.0	0.059726740403383216
chr1	TDRKH	151774412	151774504	0	93	153	4678	153	4585	0.0	0.03336968375136314
chr1	TDRKH	151773493	151774504	0	1012	153	4678	153	3666	0.0	0.041734860883797055
chr1	AL162258.1	153632033	153632240	10172	208	74825	1002	64653	794	48.90384615384615	81.42695214105794
chr1	JTB	153976692	153977013	0	322	1530	1486	1530	1164	0.0	1.3144329896907216
chr1	SHE	154479480	154486062	102	6583	306	7140	204	557	0.015494455415464074	0.36624775583482944
chr1	ADAR	154601040	154602626	4641	1587	24172	9646	19531	8059	2.9243856332703215	2.4235016751457996
chr1	GBAP1	155215562	155215787	0	226	327187	3205	327187	2979	0.0	109.83115139308492
chr1	GBAP1	155216383	155217029	19468	647	327187	3205	307719	2558	30.089644513137557	120.29671618451916
chr1	GBAP1	155217239	155218049	284282	811	327187	3205	42905	2394	350.53267570900124	17.921888053467
chr1	GON4L	155764999	155766709	0	1711	76777	11036	76777	9325	0.0	8.233458445040215
chr1	KHDC4	155913044	155915964	7915	2921	495429	5660	487514	2739	2.7096884628551865	177.98977729098212
chr1	ARHGEF2	155950828	155951272	11710	445	574674	8670	562964	8225	26.314606741573034	68.44547112462006
chr1	PAQR6	156245781	156246250	0	470	10381	2498	10381	2028	0.0	5.118836291913215
chr1	IQGAP3	156525404	156526599	53184	1196	591221	6779	538037	5583	44.468227424749166	96.37058928891277
chr1	HDGF	156742109	156743455	1020	1347	23353	3683	22333	2336	0.7572383073496659	9.560359589041095
chr1	FCRL3	157676480	157678856	0	2377	4554	5345	4554	2968	0.0	1.534366576819407
chr1	LINC01704	158132039	158132656	0	618	10492	2018	10492	1400	0.0	7.494285714285715
chr1	LINC01704	158132045	158133193	0	1149	10492	2018	10492	869	0.0	12.073647871116226
chr1	AIM2	159065909	159066329	0	421	0	1885	0	1464	0.0	0.0
chr1	SNHG28	159837916	159840866	0	2951	41503	3025	41503	74	0.0	560.8513513513514
chr1	SNHG28	159838364	159840866	0	2503	41503	3025	41503	522	0.0	79.50766283524904
chr1	SNHG28	159834501	159840866	71853	6366	41503	3025	-30350	-3341	11.286993402450518	9.084106554923675
chr1	SNHG28	159834522	159836155	35193	1634	41503	3025	6310	1391	21.53794369645043	4.536304816678649
chr1	SNHG28	159834526	159836155	35159	1630	41503	3025	6344	1395	21.56993865030675	4.547670250896057
chr1	SNHG28	159837916	159841235	0	3320	41503	3025	41503	-295	0.0	-140.68813559322035
chr1	SNHG28	159837916	159840881	0	2966	41503	3025	41503	59	0.0	703.4406779661017
chr1	TSTD1	161037630	161038075	0	446	0	1199	0	753	0.0	0.0
chr1	DEDD	161124137	161124526	459	390	106125	2740	105666	2350	1.176923076923077	44.96425531914893
chr1	NR1I3	161230812	161231245	0	434	0	2001	0	1567	0.0	0.0
chr1	MPZ	161304734	161305977	929	1244	1235	2155	306	911	0.7467845659163987	0.3358946212952799
chr1	CD247	167430639	167431746	51	1108	102	2720	51	1612	0.046028880866425995	0.03163771712158809
chr1	GAS5	173864483	173864704	0	222	12849	4337	12849	4115	0.0	3.122478736330498
chr1	GAS5	173863900	173864304	0	405	12849	4337	12849	3932	0.0	3.267802644964395
chr1	GAS5	173864256	173864704	0	449	12849	4337	12849	3888	0.0	3.304783950617284
chr1	GAS5	173864256	173865282	807	1027	12849	4337	12042	3310	0.7857838364167478	3.6380664652567978
chr1	GAS5	173866527	173866796	2754	270	12849	4337	10095	4067	10.2	2.4821735923284978
chr1	GAS5	173865228	173865547	985	320	12849	4337	11864	4017	3.078125	2.95344784665173
chr1	GAS5	173864256	173864506	0	251	12849	4337	12849	4086	0.0	3.144640234948605
chr1	GAS5	173865856	173866206	954	351	12849	4337	11895	3986	2.717948717948718	2.984194681384847
chr1	CRYZL2P-SEC16B	177958839	177960939	0	2101	270	6507	270	4406	0.0	0.061280072628234226
chr1	ABL2	179107717	179109441	4488	1725	15063	11979	10575	10254	2.6017391304347828	1.0313048566413108
chr1	LINC01344	182127296	182127927	0	632	0	6690	0	6058	0.0	0.0
chr1	MIR181A1HG	198897809	198900569	0	2761	0	5396	0	2635	0.0	0.0
chr1	TNNT2	201372026	201372155	0	130	0	5980	0	5850	0.0	0.0
chr1	LMOD1	201899236	201900751	510	1516	663	3970	153	2454	0.33641160949868076	0.06234718826405868
chr1	LINC00303	204036968	204037588	2076	621	2331	1992	255	1371	3.342995169082126	0.18599562363238512
chr1	PIK3C2B	204445955	204446144	0	190	18343	9450	18343	9260	0.0	1.9808855291576675
chr1	KLHDC8A	205343228	205343793	0	566	0	3675	0	3109	0.0	0.0
chr1	SLC26A9	205913053	205915404	0	2352	0	5649	0	3297	0.0	0.0
chr1	RAB7B	205976740	205978928	0	2189	0	3692	0	1503	0.0	0.0
chr1	PROX1-AS1	213915934	213916099	0	166	0	9778	0	9612	0.0	0.0
chr1	LINC02817	221332155	221333985	0	1831	0	2451	0	620	0.0	0.0
chr1	PYCR2	225922203	225922383	0	181	510	3483	510	3302	0.0	0.15445184736523318
chr1	LEFTY2	225939755	225940002	0	248	80	2290	80	2042	0.0	0.039177277179236046
chr1	MRPL55	228108436	228109021	358	586	16924	1672	16566	1086	0.6109215017064846	15.25414364640884
chr1	MRPL55	228108436	228109016	358	581	16924	1672	16566	1091	0.6161790017211703	15.18423464711274
chr1	MRPL55	228108436	228109031	358	596	16924	1672	16566	1076	0.6006711409395973	15.395910780669144
chr1	C1ORF131	231223762	231225523	0	1762	0	3253	0	1491	0.0	0.0
chr1	PCNX2	232984135	232986540	0	2406	4790	12393	4790	9987	0.0	0.47962351056373287
chr1	LINC01354	234531015	234531792	102	778	100244	3246	100142	2468	0.13110539845758354	40.57617504051864
chr1	LINC01139	238485784	238486044	0	261	0	1865	0	1604	0.0	0.0
chr1	LINC01347	243087709	243088232	0	524	51	3859	51	3335	0.0	0.015292353823088457
chr1	CEP170	243185778	243186422	204	645	3504	8930	3300	8285	0.31627906976744186	0.3983101991550996
chr1	OR2B11	247449117	247455064	7294	5948	7549	6226	255	278	1.226294552790854	0.9172661870503597
chr1	ZNF692	248855557	248855946	0	390	0	3751	0	3361	0.0	0.0
chr2	MYT1L	1789146	1792464	0	3319	0	31707	0	28388	0.0	0.0
chr2	MYT1L	1789168	1792007	0	2840	0	31707	0	28867	0.0	0.0
chr2	MYT1L	1789313	1792464	0	3152	0	31707	0	28555	0.0	0.0
chr2	LINC01304	3959563	3960556	0	994	0	6379	0	5385	0.0	0.0
chr2	MIR7515HG	6617201	6618315	0	1115	14908	7267	14908	6152	0.0	2.4232769830949286
chr2	GRASLND	6915822	6917224	0	1403	51	4549	51	3146	0.0	0.01621106166560712
chr2	ID2-AS1	8675743	8676029	0	287	102	6592	102	6305	0.0	0.0161776367961935
chr2	ITGB1BP1	9406660	9407598	0	939	510	6364	510	5425	0.0	0.09400921658986175
chr2	AC064875.1	13002423	13003951	0	1529	3211	4174	3211	2645	0.0	1.2139886578449905
chr2	AC104623.2	16541689	16545695	0	4007	0	4007	0	0	0.0	0.0
chr2	NT5C1B	18584513	18584978	0	466	0	3862	0	3396	0.0	0.0
chr2	LDAH	20685546	20687094	0	1549	2707	3421	2707	1872	0.0	1.4460470085470085
chr2	ADCY3	24918312	24919839	0	1528	0	5388	0	3860	0.0	0.0
chr2	HADHA	26190654	26191628	102	975	6003	4348	5901	3373	0.10461538461538461	1.7494811740290543
chr2	OTOF	26477648	26478042	7701	395	157790	8072	150089	7677	19.49620253164557	19.550475446137813
chr2	OST4	27071325	27071649	0	325	0	602	0	277	0.0	0.0
chr2	EIF2B4	27367745	27367822	0	78	51	2597	51	2519	0.0	0.020246129416435093
chr2	EIF2B4	27369875	27369919	0	45	51	2597	51	2552	0.0	0.019984326018808778
chr2	IFT172	27457840	27458223	41325	384	664046	12448	622721	12064	107.6171875	51.6181200265252
chr2	IFT172	27449293	27449562	43045	270	664046	12448	621001	12178	159.42592592592592	50.993677122680246
chr2	IFT172	27453981	27454418	32590	438	664046	12448	631456	12010	74.40639269406392	52.57751873438801
chr2	IFT172	27458778	27459522	68451	745	664046	12448	595595	11703	91.88053691275168	50.892506194992734
chr2	IFT172	27453629	27454418	34426	790	664046	12448	629620	11658	43.57721518987342	54.00754846457368
chr2	SUPT7L	27660983	27662281	11934	1299	233087	5317	221153	4018	9.187066974595844	55.04056744649079
chr2	HNRNPLL	38602437	38603036	0	600	3688	5109	3688	4509	0.0	0.8179197161233089
chr2	SRSF7	38748578	38749705	0	1128	51	3873	51	2745	0.0	0.018579234972677595
chr2	CDKL4	39178546	39179321	0	776	10972	2083	10972	1307	0.0	8.394797245600612
chr2	LINC01819	43028913	43029897	0	985	1358	3848	1358	2863	0.0	0.4743276283618582
chr2	LINC01819	43032733	43033526	102	794	1358	3848	1256	3054	0.12846347607052896	0.4112639161755075
chr2	CCDC88A	55295596	55296056	0	461	11014	27139	11014	26678	0.0	0.41284953894594795
chr2	CCDC88A	55290654	55291775	51	1122	11014	27139	10963	26017	0.045454545454545456	0.4213783295537533
chr2	PNPT1	55680711	55680918	0	208	2647	4809	2647	4601	0.0	0.5753097152792871
chr2	EFEMP1	55922359	55922691	0	333	1678	3973	1678	3640	0.0	0.460989010989011
chr2	EFEMP1	55922359	55922747	0	389	1678	3973	1678	3584	0.0	0.4681919642857143
chr2	BCL11A	60460681	60462424	0	1744	0	10714	0	8970	0.0	0.0
chr2	XPO1	61498672	61498913	0	242	11664	18326	11664	18084	0.0	0.6449900464499004
chr2	XPO1	61537561	61538356	0	796	11664	18326	11664	17530	0.0	0.665373645179692
chr2	XPO1	61537561	61538231	0	671	11664	18326	11664	17655	0.0	0.6606627017841971
chr2	PCBP1-AS1	69996685	69996888	180	204	332385	25966	332205	25762	0.8823529411764706	12.8951556556168
chr2	PCBP1-AS1	70085815	70086273	0	459	332385	25966	332385	25507	0.0	13.031128709765946
chr2	PCBP1-AS1	70048706	70051305	8415	2600	332385	25966	323970	23366	3.2365384615384616	13.865017546862964
chr2	PCBP1-AS1	70049195	70051305	6069	2111	332385	25966	326316	23855	2.8749407863571768	13.679144833368266
chr2	PCBP1-AS1	70049201	70051305	6069	2105	332385	25966	326316	23861	2.8831353919239904	13.675705125518629
chr2	DCTN1	74366243	74366620	0	378	173698	9854	173698	9476	0.0	18.330308146897426
chr2	MOGS	74463189	74463386	0	198	1581	3170	1581	2972	0.0	0.5319650067294751
chr2	MOGS	74464895	74465400	0	506	1581	3170	1581	2664	0.0	0.5934684684684685
chr2	REG3A	79159329	79159753	0	425	0	1083	0	658	0.0	0.0
chr2	TGOLN2	85326507	85327685	153	1179	408	6949	255	5770	0.1297709923664122	0.04419410745233969
chr2	CAPG	85401528	85401683	0	156	9	2163	9	2007	0.0	0.004484304932735426
chr2	ST3GAL5	85847860	85848204	0	345	136363	15937	136363	15592	0.0	8.745702924576706
chr2	RNF103	86622660	86623865	51	1206	51	6400	0	5194	0.04228855721393035	0.0
chr2	LINC00342	95813315	95813957	73058	643	277274	7663	204216	7020	113.62052877138413	29.09059829059829
chr2	AC092683.1	97422438	97422659	0	222	61622	5579	61622	5357	0.0	11.503080082135524
chr2	LINC02611	98771618	98772142	0	525	0	3496	0	2971	0.0	0.0
chr2	MITD1	99169262	99169610	7322	349	24944	2343	17622	1994	20.979942693409743	8.837512537612838
chr2	REV1	99402243	99402800	0	558	7077	7767	7077	7209	0.0	0.9816895547232626
chr2	PANTR1	104807584	104812618	0	5035	0	9147	0	4112	0.0	0.0
chr2	AC010978.1	105856669	105857177	0	509	102	1458	102	949	0.0	0.10748155953635406
chr2	EDAR	108910775	108911072	0	298	0	4438	0	4140	0.0	0.0
chr2	NPHP1	110163047	110164730	0	1684	0	12937	0	11253	0.0	0.0
chr2	AC112229.1	110423660	110424142	0	483	73	2891	73	2408	0.0	0.0303156146179402
chr2	MIR4435-2HG	111365560	111367575	510	2016	30363	26838	29853	24822	0.25297619047619047	1.202683103698332
chr2	ZC3H8	112230902	112230950	0	49	5511	6384	5511	6335	0.0	0.8699289660615628
chr2	AC079922.2	112642082	112643293	1902	1212	18552	2394	16650	1182	1.5693069306930694	14.086294416243655
chr2	CKAP2L	112755976	112757214	0	1239	4179	4835	4179	3596	0.0	1.1621245828698554
chr2	POTEI	130465651	130465772	0	122	153	6863	153	6741	0.0	0.022696929238985315
chr2	CACNB4	151869176	151870611	0	1436	255	14196	255	12760	0.0	0.019984326018808778
chr2	NR4A2	156326149	156326328	0	180	153	3973	153	3793	0.0	0.040337463749011336
chr2	BAZ2B	159404848	159404910	0	63	22229	18526	22229	18463	0.0	1.2039755186047771
chr2	PLA2R1	159932005	159941992	918	9988	6079	15392	5161	5404	0.09191029235082099	0.9550333086602517
chr2	ITGB6	160200002	160200304	51	303	2040	3902	1989	3599	0.16831683168316833	0.5526535148652404
chr2	SCN1A	165989159	165994416	0	5258	305	18837	305	13579	0.0	0.02246115325134399
chr2	METTL5	169824488	169824905	0	418	0	2425	0	2007	0.0	0.0
chr2	MYO3B-AS1	170344798	170345132	0	335	24637	5707	24637	5372	0.0	4.586187639612807
chr2	MYO3B-AS1	170344798	170345215	0	418	24637	5707	24637	5289	0.0	4.658158442049537
chr2	AC073636.1	176844837	176846377	51	1541	385	3276	334	1735	0.03309539260220636	0.192507204610951
chr2	AC073636.1	176844840	176846377	51	1538	385	3276	334	1738	0.03315994798439532	0.19217491369390102
chr2	ZNF385B	179441981	179443468	2514	1488	3679	5441	1165	3953	1.689516129032258	0.2947128762964837
chr2	OSGEPL1	189761419	189761660	0	242	0	3437	0	3195	0.0	0.0
chr2	ORMDL1	189782421	189783123	0	703	0	4012	0	3309	0.0	0.0
chr2	SF3B1	197418895	197420542	59	1648	561	10241	502	8593	0.035800970873786406	0.05841964389619458
chr2	SF3B1	197418795	197420542	102	1748	561	10241	459	8493	0.05835240274599542	0.054044507241257506
chr2	CFLAR-AS1	201148733	201149200	0	468	102	4158	102	3690	0.0	0.027642276422764227
chr2	FN1	215371908	215372375	0	468	51	13933	51	13465	0.0	0.003787597474935017
chr2	FN1	215371908	215372300	0	393	51	13933	51	13540	0.0	0.0037666174298375183
chr2	CFAP65	219029402	219030208	0	807	145	10236	145	9429	0.0	0.015378088874748118
chr2	CNPPD1	219174777	219175108	0	332	0	2728	0	2396	0.0	0.0
chr2	CUL3	224503651	224503822	0	172	11944	10494	11944	10322	0.0	1.1571400891300136
chr2	MFF-DT	227264668	227268769	0	4102	0	11480	0	7378	0.0	0.0
chr2	MFF-DT	227265874	227268769	0	2896	0	11480	0	8584	0.0	0.0
chr2	SLC19A3	227702168	227702691	8142	524	46205	5687	38063	5163	15.538167938931299	7.372264187487895
chr2	NDUFA10	240011616	240014860	10883	3245	58376	18589	47493	15344	3.3537750385208014	3.0952163712200207
chr2	ANKMY1	240523884	240524381	0	498	0	7366	0	6868	0.0	0.0
chr2	HDLBP	241268953	241269295	0	343	0	11245	0	10902	0.0	0.0
chr2	STK25	241508005	241508362	18076	358	60500	5262	42424	4904	50.49162011173184	8.65089722675367
chr2	RPS7	3575324	3575684	0	361	29198	1880	29198	1519	0.0	19.221856484529294
chr2	RPS7	3575357	3575684	0	328	29198	1880	29198	1552	0.0	18.813144329896907
chr2	AC013460.1	7428542	7429872	0	1331	0	5222	0	3891	0.0	0.0
chr2	MIR3681HG	12131305	12131585	0	281	3315	8436	3315	8155	0.0	0.4064990803188228
chr2	DDX1	15628444	15628839	0	396	561	8850	561	8454	0.0	0.06635911994322215
chr2	DDX1	15627053	15628710	0	1658	561	8850	561	7192	0.0	0.07800333704115685
chr2	DDX1	15628444	15628710	0	267	561	8850	561	8583	0.0	0.06536176162181055
chr2	DDX1	15628637	15628839	0	203	561	8850	561	8647	0.0	0.06487799236729501
chr2	DDX1	15627053	15628839	0	1787	561	8850	561	7063	0.0	0.07942800509698428
chr2	LINC00954	19881566	19882260	0	695	0	6418	0	5723	0.0	0.0
chr2	LINC01884	22537004	22538291	0	1288	0	1354	0	66	0.0	0.0
chr2	TMEM214	27040710	27041694	0	985	141	4115	141	3130	0.0	0.0450479233226837
chr2	CAD	27242619	27242973	0	355	2366	8190	2366	7835	0.0	0.3019783024888322
chr2	LINC01936	30349936	30352431	0	2496	0	4654	0	2158	0.0	0.0
chr2	LINC00486	32928031	32928405	51	375	5408	7058	5357	6683	0.136	0.8015861140206494
chr2	LINC01913	41876762	41877778	0	1017	51	5091	51	4074	0.0	0.012518409425625921
chr2	AHSA2P	61185501	61186497	0	997	960	8068	960	7071	0.0	0.1357658039881205
chr2	UGP2	63885588	63885886	0	299	0	6812	0	6513	0.0	0.0
chr2	AC012368.1	64251118	64251834	0	717	15209	7851	15209	7134	0.0	2.1319035604149144
chr2	AC007389.1	65732892	65733389	0	498	1416	12371	1416	11873	0.0	0.11926219152699402
chr2	TTC31	74490655	74491184	0	530	3002	4040	3002	3510	0.0	0.8552706552706553
chr2	TTC31	74492138	74492445	1808	308	3002	4040	1194	3732	5.87012987012987	0.319935691318328
chr2	ELMOD3	85355075	85357252	0	2178	3486	6400	3486	4222	0.0	0.8256750355281857
chr2	ELMOD3	85390137	85391748	510	1612	3486	6400	2976	4788	0.3163771712158809	0.6215538847117794
chr2	ELMOD3	85371085	85371562	2856	478	3486	6400	630	5922	5.97489539748954	0.10638297872340426
chr2	SH2D6	85436465	85437029	0	565	83	2703	83	2138	0.0	0.03882132834424696
chr2	USP39	85648760	85649280	410	521	41083	3963	40673	3442	0.7869481765834933	11.816676350958746
chr2	KDM3A	86477876	86478265	0	390	9663	8754	9663	8364	0.0	1.1553084648493543
chr2	KDM3A	86478607	86480362	800	1756	9663	8754	8863	6998	0.45558086560364464	1.266504715633038
chr2	KDM3A	86482457	86484158	51	1702	9663	8754	9612	7052	0.029964747356051705	1.3630175836642087
chr2	KDM3A	86489519	86491057	2145	1539	9663	8754	7518	7215	1.3937621832358675	1.041995841995842
chr2	ANKRD36BP2	88804379	88804880	0	502	51	4231	51	3729	0.0	0.013676588897827836
chr2	GPAT2P1	95796488	95797160	663	673	2009	2259	1346	1586	0.9851411589895989	0.8486759142496847
chr2	AC159540.2	97285302	97285523	13997	222	27183	1980	13186	1758	63.049549549549546	7.500568828213879
chr2	AC159540.2	97284877	97285523	44834	647	27183	1980	-17651	1333	69.2952086553323	-13.241560390097524
chr2	RPL31	101002292	101002808	0	517	9176	3899	9176	3382	0.0	2.7131874630396213
chr2	LINC01102	104505865	104507406	0	1542	0	7010	0	5468	0.0	0.0
chr2	LINC01102	104518058	104518401	0	344	0	7010	0	6666	0.0	0.0
chr2	LINC01102	104506590	104507406	0	817	0	7010	0	6193	0.0	0.0
chr2	C2ORF49	105342847	105343223	0	377	102	4599	102	4222	0.0	0.024159166271909047
chr2	AC013268.1	109947363	109947845	0	483	0	3474	0	2991	0.0	0.0
chr2	BCL2L11	111123732	111124139	0	408	1338	6670	1338	6262	0.0	0.21366975407218142
chr2	BCL2L11	111123745	111124139	0	395	1338	6670	1338	6275	0.0	0.21322709163346615
chr2	MERTK	111997322	111997476	1368	155	17071	4566	15703	4411	8.825806451612904	3.5599637270460214
chr2	CHCHD5	112585973	112586365	1377	393	3666	1263	2289	870	3.50381679389313	2.6310344827586207
chr2	PAX8-AS1	113255389	113259584	34304	4196	44812	13369	10508	9173	8.175405147759772	1.1455358116210619
chr2	FAM138B	113577981	113578852	204	872	399	1234	195	362	0.23394495412844038	0.5386740331491713
chr2	WASH2P	113595692	113596203	51	512	6646	2827	6595	2315	0.099609375	2.8488120950323976
chr2	GLI2	120988207	120991380	102	3174	47548	7685	47446	4511	0.03213610586011342	10.517845267124805
chr2	PROC	127423033	127423408	3111	376	5916	2498	2805	2122	8.273936170212766	1.32186616399623
chr2	POTEE	131261725	131261846	0	122	0	4207	0	4085	0.0	0.0
chr2	UBXN4	135753538	135754277	0	740	102	4422	102	3682	0.0	0.027702335687126562
chr2	LINC02631	138601617	138602441	0	825	0	2371	0	1546	0.0	0.0
chr2	LINC02612	150634635	150635356	0	722	0	3285	0	2563	0.0	0.0
chr2	LINC02612	150634635	150635344	0	710	0	3285	0	2575	0.0	0.0
chr2	SCN2A	165326851	165328538	0	1688	51	23956	51	22268	0.0	0.002290282019040776
chr2	SCN1A-AS1	166248194	166249384	0	1191	0	18935	0	17744	0.0	0.0
chr2	AC007405.3	170776502	170777425	510	924	1249	2602	739	1678	0.551948051948052	0.4404052443384982
chr2	HNRNPA3	177219246	177221976	0	2731	51	6245	51	3514	0.0	0.014513375071143995
chr2	CHROMR	178426365	178430889	204	4525	13808	7002	13604	2477	0.045082872928176795	5.492127573677836
chr2	TTN-AS1	178537360	178537691	0	332	1173	21966	1173	21634	0.0	0.054220208930387356
chr2	TTN-AS1	178774226	178778755	0	4530	1173	21966	1173	17436	0.0	0.06727460426703373
chr2	TTN-AS1	178777857	178778755	0	899	1173	21966	1173	21067	0.0	0.055679498742108514
chr2	FAM171B	186747091	186747250	0	160	0	5739	0	5579	0.0	0.0
chr2	NABP1	191685598	191696662	204	11065	459	17438	255	6373	0.018436511522819703	0.04001255295779068
chr2	SLC39A10	195680031	195681050	0	1020	0	6933	0	5913	0.0	0.0
chr2	CCDC150	196729192	196729861	0	670	0	9384	0	8714	0.0	0.0
chr2	HSPE1	197503038	197503381	347	344	171	1592	-176	1248	1.0087209302325582	-0.14102564102564102
chr2	LINC01877	199629063	199631895	0	2833	0	9864	0	7031	0.0	0.0
chr2	LINC01877	199629924	199631895	0	1972	0	9864	0	7892	0.0	0.0
chr2	LINC01877	199630245	199631895	0	1651	0	9864	0	8213	0.0	0.0
chr2	NIF3L1	200891735	200892379	0	645	0	2001	0	1356	0.0	0.0
chr2	NRP2	205682500	205683363	0	864	51	13919	51	13055	0.0	0.0039065492148602065
chr2	TMEM169	216081918	216082232	0	315	12	3631	12	3316	0.0	0.0036188178528347406
chr2	RPL37A	216499085	216499398	0	314	0	5245	0	4931	0.0	0.0
chr2	PLCD4	218636470	218637173	0	704	0	5717	0	5013	0.0	0.0
chr2	ZFAND2B	219208255	219208486	1819	232	11050	2754	9231	2522	7.8405172413793105	3.6601903251387786
chr2	GMPPA	219505457	219505761	1894	305	45282	3037	43388	2732	6.2098360655737705	15.881405563689604
chr2	GMPPA	219506253	219506422	0	170	45282	3037	45282	2867	0.0	15.794209975584234
chr2	AC009950.1	230172098	230172515	0	418	134	5424	134	5006	0.0	0.026767878545745107
chr2	PPP1R7	241182646	241183652	0	1007	0	3700	0	2693	0.0	0.0
chr2	FARP2	241494007	241494840	15218	834	68256	13898	53038	13064	18.247002398081534	4.059859154929577
chr3	SETMAR	4312897	4313761	0	865	258	3571	258	2706	0.0	0.09534368070953436
chr3	BRPF1	9745572	9745930	0	359	313869	6082	313869	5723	0.0	54.84343875589725
chr3	OGG1	9756766	9757191	0	426	40413	7070	40413	6644	0.0	6.082630945213727
chr3	TTLL3	9826996	9827240	104416	245	460783	7028	356367	6783	426.1877551020408	52.53825740822645
chr3	TTLL3	9834680	9835404	19770	725	460783	7028	441013	6303	27.26896551724138	69.96874504204347
chr3	CRELD1	9933833	9934612	6609	780	146828	3805	140219	3025	8.473076923076922	46.353388429752066
chr3	TSEN2	12503261	12503784	0	524	49652	4706	49652	4182	0.0	11.872788139646103
chr3	KCNH8	19450105	19451404	0	1300	0	6105	0	4805	0.0	0.0
chr3	SGO1-AS1	20345659	20346066	0	408	2361	6600	2361	6192	0.0	0.3812984496124031
chr3	OXSM	25790989	25791997	2291	1009	9691	2429	7400	1420	2.270564915758176	5.211267605633803
chr3	LINC01980	27797556	27797911	0	356	51	4756	51	4400	0.0	0.011590909090909091
chr3	LINC01980	27802113	27802850	0	738	51	4756	51	4018	0.0	0.012692882030861125
chr3	LINC01980	27797568	27797911	0	344	51	4756	51	4412	0.0	0.011559383499546692
chr3	LINC01980	27797574	27797911	0	338	51	4756	51	4418	0.0	0.011543684925305569
chr3	C3ORF35	37417018	37418101	6018	1084	9312	7262	3294	6178	5.551660516605166	0.5331822596309486
chr3	CTNNB1	41224953	41225207	0	255	7901	9254	7901	8999	0.0	0.8779864429381042
chr3	CTNNB1	41239133	41239900	2762	768	7901	9254	5139	8486	3.5963541666666665	0.6055856705161442
chr3	CTNNB1	41239133	41239971	3998	839	7901	9254	3903	8415	4.765196662693683	0.4638146167557932
chr3	CTNNB1	41239133	41239947	3830	815	7901	9254	4071	8439	4.699386503067485	0.48240312833274085
chr3	CTNNB1	41239133	41239955	3886	823	7901	9254	4015	8431	4.721749696233293	0.4762187166409679
chr3	CTNNB1	41239133	41239904	2854	772	7901	9254	5047	8482	3.6968911917098444	0.595024758311719
chr3	CTNNB1	41239133	41240443	5916	1311	7901	9254	1985	7943	4.5125858123569795	0.24990557723781948
chr3	TCAIM	44400354	44401334	143398	981	161404	8758	18006	7777	146.17533129459736	2.315288671724315
chr3	ATRIP	48460109	48460799	17276	691	107889	5446	90613	4755	25.001447178002895	19.056361724500526
chr3	ATRIP	48465486	48467645	25264	2160	107889	5446	82625	3286	11.696296296296296	25.144552647595862
chr3	ATRIP	48466629	48467645	13093	1017	107889	5446	94796	4429	12.874139626352015	21.40347708286295
chr3	PRKAR2A-AS1	48848104	48851976	11956	3873	7789	3920	-4167	47	3.0870126516911953	-88.65957446808511
chr3	WDR6	49011634	49014293	70980	2660	137893	4997	66913	2337	26.68421052631579	28.632006846384254
chr3	RBM6	50061461	50062108	8367	648	56121	7225	47754	6577	12.912037037037036	7.2607571841265015
chr3	HEMK1	50579843	50580229	0	387	25305	17946	25305	17559	0.0	1.4411412950623612
chr3	GRM2	51715061	51716137	21283	1077	199821	4215	178538	3138	19.761374187558033	56.89547482472913
chr3	ABHD14A-ACY1	51985851	51987453	17679	1603	22537	4173	4858	2570	11.02869619463506	1.890272373540856
chr3	ABHD14A-ACY1	51987555	51988603	5866	1049	22537	4173	16671	3124	5.591992373689227	5.3364276568501925
chr3	ABHD14A-ACY1	51986604	51987061	2486	458	22537	4173	20051	3715	5.427947598253275	5.397308209959623
chr3	ABHD14A-ACY1	51986414	51987061	5558	648	22537	4173	16979	3525	8.57716049382716	4.816737588652482
chr3	ABHD14A-ACY1	51986414	51987453	14517	1040	22537	4173	8020	3133	13.958653846153846	2.5598467922119372
chr3	ABHD14A-ACY1	51986604	51987453	11445	850	22537	4173	11092	3323	13.464705882352941	3.3379476376767983
chr3	ABHD14A-ACY1	51986414	51987624	17033	1211	22537	4173	5504	2962	14.06523534269199	1.8582039162727886
chr3	ABHD14A-ACY1	51986604	51988603	19589	2000	22537	4173	2948	2173	9.7945	1.3566497929130235
chr3	ABHD14A-ACY1	51986987	51987196	3061	210	22537	4173	19476	3963	14.576190476190476	4.914458743376231
chr3	ABHD14A-ACY1	51985851	51986331	3162	481	22537	4173	19375	3692	6.573804573804574	5.24783315276273
chr3	ABHD14A-ACY1	51986987	51987453	9162	467	22537	4173	13375	3706	19.61884368308351	3.6090124123043714
chr3	PPM1M	52249173	52250595	51	1423	172785	3294	172734	1871	0.035839775122979624	92.32175307322288
chr3	GLYCTK	52292259	52293475	70326	1217	921265	4647	850939	3430	57.78635990139688	248.0871720116618
chr3	PHF7	52414495	52414587	0	93	9997	2348	9997	2255	0.0	4.433259423503326
chr3	PHF7	52419832	52419934	0	103	9997	2348	9997	2245	0.0	4.453006681514476
chr3	PHF7	52421647	52421754	0	108	9997	2348	9997	2240	0.0	4.462946428571429
chr3	C3ORF49	63831679	63832106	867	428	65574	1653	64707	1225	2.0257009345794392	52.82204081632653
chr3	AC109587.1	69013983	69014201	0	219	5256	3711	5256	3492	0.0	1.5051546391752577
chr3	AC129807.1	81840539	81840909	0	371	74	2464	74	2093	0.0	0.035355948399426664
chr3	LINC00879	94989328	94990070	0	743	51	6020	51	5277	0.0	0.009664582148948267
chr3	NXPE3	101816794	101817001	0	208	0	9079	0	8871	0.0	0.0
chr3	NFKBIZ	101853090	101853863	0	774	0	5643	0	4869	0.0	0.0
chr3	DUBR	107246007	107248831	0	2825	4208	13361	4208	10536	0.0	0.39939255884586183
chr3	DUBR	107246007	107247088	0	1082	4208	13361	4208	12279	0.0	0.34269891684990633
chr3	HHLA2	108376492	108378285	102	1794	1867	2940	1765	1146	0.056856187290969896	1.5401396160558465
chr3	DZIP3	108647942	108648962	0	1021	58	6978	58	5957	0.0	0.009736444519053214
chr3	SLC35A5	112580545	112581326	0	782	0	4736	0	3954	0.0	0.0
chr3	ZDHHC23	113948685	113948963	0	279	102	4793	102	4514	0.0	0.02259636685866194
chr3	ZBTB20-AS1	114366966	114367221	0	256	12	5834	12	5578	0.0	0.002151308712800287
chr3	AC079848.2	126247030	126247713	0	684	0	3126	0	2442	0.0	0.0
chr3	COL6A5	130431464	130431949	714	486	26922	9473	26208	8987	1.4691358024691359	2.916212306665183
chr3	NUDT16	131383161	131388830	75	5670	75	6187	0	517	0.013227513227513227	0.0
chr3	NCK1	136945582	136946295	0	714	15	5120	15	4406	0.0	0.003404448479346346
chr3	LINC01213	150238699	150238998	0	300	0	1723	0	1423	0.0	0.0
chr3	EIF2A	150567901	150568046	0	146	0	5921	0	5775	0.0	0.0
chr3	LINC02029	157087858	157088536	0	679	96	2326	96	1647	0.0	0.058287795992714025
chr3	SKIL	170359698	170361429	0	1732	511	7601	511	5869	0.0	0.08706764355086045
chr3	KCNMB2	178825587	178825758	0	172	0	3552	0	3380	0.0	0.0
chr3	TTC14	180608700	180610003	0	1304	1518	5485	1518	4181	0.0	0.36307103563740734
chr3	LINC01206	182001117	182001760	0	644	51	11383	51	10739	0.0	0.004749045534966012
chr3	LINC01206	182002773	182004063	0	1291	51	11383	51	10092	0.0	0.005053507728894174
chr3	LINC01206	182001117	182003122	0	2006	51	11383	51	9377	0.0	0.005438839714194305
chr3	LINC01206	181971563	181971906	0	344	51	11383	51	11039	0.0	0.004619983694175197
chr3	EIF2B5	184143051	184143565	0	515	51	6302	51	5787	0.0	0.008812856402280975
chr3	LINC02020	186440981	186442081	51	1101	51	3478	0	2377	0.04632152588555858	0.0
chr3	KNG1	186741521	186744410	1479	2890	87	2509	-1392	-381	0.5117647058823529	3.6535433070866143
chr3	LINC00884	194487139	194488726	0	1588	0	9432	0	7844	0.0	0.0
chr3	LINC00884	194487145	194488726	0	1582	0	9432	0	7850	0.0	0.0
chr3	MUC20-OT1	195701379	195701669	10919	291	188855	13794	177936	13503	37.52233676975945	13.177516107531659
chr3	MUC20-OT1	195708133	195708807	5209	675	188855	13794	183646	13119	7.717037037037037	13.99847549355896
chr3	MUC20-OT1	195708137	195708841	5153	705	188855	13794	183702	13089	7.309219858156029	14.034838413935365
chr3	MUC20-OT1	195708153	195708435	1409	283	188855	13794	187446	13511	4.978798586572438	13.87358448671453
chr3	MUC20-OT1	195708153	195708513	1983	361	188855	13794	186872	13433	5.4930747922437675	13.911412193850964
chr3	MUC20-OT1	195708153	195708841	4993	689	188855	13794	183862	13105	7.246734397677794	14.02991224723388
chr3	MUC20-OT1	195708177	195708435	1221	259	188855	13794	187634	13535	4.714285714285714	13.862874030291836
chr3	MUC20-OT1	195708428	195708841	3592	414	188855	13794	185263	13380	8.676328502415458	13.846263079222721
chr3	MUC20-OT1	195708177	195708841	4805	665	188855	13794	184050	13129	7.225563909774436	14.018584812247695
chr3	MUC20-OT1	195724679	195726572	1810	1894	188855	13794	187045	11900	0.955649419218585	15.718067226890756
chr3	THUMPD3-AS1	9390289	9391826	10954	1538	14563	6225	3609	4687	7.122236671001301	0.7700021335609132
chr3	CAMK1	9757346	9757846	0	501	3944	2727	3944	2226	0.0	1.7717879604672058
chr3	PRRT3	9945541	9948001	397	2461	1009	3957	612	1496	0.1613165379926859	0.4090909090909091
chr3	SEC13	10319138	10319316	1372	179	271117	4364	269745	4185	7.664804469273743	64.45519713261649
chr3	ACAA1	38126161	38126700	0	540	582	6653	582	6113	0.0	0.09520693603795191
chr3	ALS2CL	46674565	46675976	51	1412	0	7062	-51	5650	0.03611898016997167	-0.009026548672566371
chr3	ALS2CL	46674565	46676402	51	1838	0	7062	-51	5224	0.027747551686615888	-0.009762633996937213
chr3	PRSS43P	46756041	46756629	0	589	0	1677	0	1088	0.0	0.0
chr3	MYL3	46857871	46858272	0	402	0	2814	0	2412	0.0	0.0
chr3	PLXNB1	48419576	48420257	0	682	3101	9551	3101	8869	0.0	0.34964483030781374
chr3	SHISA5	48469360	48469573	335	214	46564	4383	46229	4169	1.5654205607476634	11.088750299832094
chr3	DALRD3	49015818	49016086	367	269	342932	2755	342565	2486	1.3643122676579926	137.79766693483506
chr3	AMT	49416777	49417718	51	942	2924	4678	2873	3736	0.054140127388535034	0.7690042826552462
chr3	AMT	49419709	49420342	102	634	2924	4678	2822	4044	0.1608832807570978	0.6978239366963402
chr3	AMT	49416793	49417718	51	926	2924	4678	2873	3752	0.0550755939524838	0.7657249466950959
chr3	AMT	49418970	49419405	141	436	2924	4678	2783	4242	0.32339449541284404	0.656058462989156
chr3	AMT	49416821	49417718	51	898	2924	4678	2873	3780	0.05679287305122494	0.7600529100529101
chr3	AC104452.1	49422103	49424874	9069	2772	8839	4975	-230	2203	3.2716450216450217	-0.10440308669995461
chr3	GMPPB	49723597	49723951	8728	355	903145	6681	894417	6326	24.585915492957746	141.38744862472336
chr3	CAMKV	49857988	49859881	102	1894	412	3414	310	1520	0.05385427666314678	0.20394736842105263
chr3	CAMKV	49859260	49859881	51	622	412	3414	361	2792	0.0819935691318328	0.12929799426934097
chr3	IFRD2	50289446	50289762	10544	317	514423	3353	503879	3036	33.261829652996845	165.96805006587616
chr3	NPRL2	50349385	50349828	3193	444	40418	2878	37225	2434	7.191441441441442	15.293755135579293
chr3	NPRL2	50347758	50348241	8458	484	40418	2878	31960	2394	17.475206611570247	13.350041771094403
chr3	ABHD14B	51971459	51971892	32714	434	238344	2831	205630	2397	75.3778801843318	85.78639966624948
chr3	TKT	53234982	53235174	0	193	2460	8000	2460	7807	0.0	0.3151018316895094
chr3	SELENOK	53885825	53885912	0	88	2818	2138	2818	2050	0.0	1.3746341463414635
chr3	PDHB	58430656	58430942	0	287	2805	4248	2805	3961	0.0	0.7081545064377682
chr3	FAM107A	58565460	58567364	0	1905	255	5329	255	3424	0.0	0.07447429906542057
chr3	LMOD3	69122092	69122595	612	504	62732	5087	62120	4583	1.2142857142857142	13.554440322932576
chr3	LINC00877	72035752	72036520	0	769	0	8637	0	7868	0.0	0.0
chr3	LINC00877	72060509	72061094	0	586	0	8637	0	8051	0.0	0.0
chr3	LINC00877	72035754	72036520	0	767	0	8637	0	7870	0.0	0.0
chr3	LINC00877	72035761	72036520	0	760	0	8637	0	7877	0.0	0.0
chr3	LINC00877	72059686	72061094	0	1409	0	8637	0	7228	0.0	0.0
chr3	CBLB	105680991	105681818	1632	828	1816	10339	184	9511	1.9710144927536233	0.01934602039743455
chr3	LINC00635	107841895	107842212	0	318	260	7071	260	6753	0.0	0.038501406782170886
chr3	LINC00635	107841661	107842212	0	552	260	7071	260	6519	0.0	0.03988341770210155
chr3	LINC00635	107841663	107842212	0	550	260	7071	260	6521	0.0	0.039871185401012116
chr3	LINC00635	107841667	107842212	0	546	260	7071	260	6525	0.0	0.03984674329501916
chr3	LINC00635	107841668	107842212	0	545	260	7071	260	6526	0.0	0.0398406374501992
chr3	LINC00635	107841671	107842212	0	542	260	7071	260	6529	0.0	0.03982233113799969
chr3	LINC00635	107853872	107855229	0	1358	260	7071	260	5713	0.0	0.04551023980395589
chr3	ATG3	112532509	112534337	0	1829	0	4249	0	2420	0.0	0.0
chr3	DRD3	114131117	114131400	0	284	0	3182	0	2898	0.0	0.0
chr3	CCDC14	123955842	123956115	0	274	0	7677	0	7403	0.0	0.0
chr3	CCDC14	123956354	123956795	0	442	0	7677	0	7235	0.0	0.0
chr3	LINC02614	125886835	125887226	0	392	102	6139	102	5747	0.0	0.01774839046459022
chr3	SLC41A3	126006356	126007225	1224	870	1590	5485	366	4615	1.4068965517241379	0.07930660888407368
chr3	SLC41A3	126006362	126007225	1224	864	1590	5485	366	4621	1.4166666666666667	0.079203635576715
chr3	RAB43	129121285	129121804	847	520	2272	4999	1425	4479	1.6288461538461538	0.31815137307434693
chr3	ASTE1	131024004	131025331	0	1328	0	3157	0	1829	0.0	0.0
chr3	CPNE4	132034566	132035442	459	877	821	5868	362	4991	0.5233751425313569	0.0725305549989982
chr3	TOPBP1	133598174	133598630	0	457	6519	7110	6519	6653	0.0	0.9798587103562303
chr3	PLSCR1	146521543	146522053	0	511	0	3554	0	3043	0.0	0.0
chr3	TM4SF1	149375442	149375769	10200	328	14168	3498	3968	3170	31.097560975609756	1.2517350157728706
chr3	SLC33A1	155829687	155829903	0	217	0	4422	0	4205	0.0	0.0
chr3	SLC33A1	155833467	155834041	0	575	0	4422	0	3847	0.0	0.0
chr3	VEPH1	157459621	157460355	0	735	2931	6465	2931	5730	0.0	0.5115183246073298
chr3	B3GALNT1	161103426	161104406	0	981	51	6044	51	5063	0.0	0.010073079202054119
chr3	MECOM	169144996	169146288	0	1293	0	9118	0	7825	0.0	0.0
chr3	MCCC1	183071209	183071357	0	149	10957	4334	10957	4185	0.0	2.6181600955794506
chr3	KLHL6	183487550	183492228	50869	4679	104543	10287	53674	5608	10.871767471681983	9.570970042796006
chr3	ABCC5	183983752	183987917	306	4166	175332	10992	175026	6826	0.07345175228036485	25.64107823029593
chr3	CLCN2	184355693	184357094	0	1402	0	7330	0	5928	0.0	0.0
chr3	CLCN2	184354903	184355529	0	627	0	7330	0	6703	0.0	0.0
chr3	LINC02052	186456916	186457630	0	715	280	3834	280	3119	0.0	0.08977236293683873
chr3	LINC02052	186455435	186455773	0	339	280	3834	280	3495	0.0	0.08011444921316166
chr3	LINC02052	186456163	186456604	0	442	280	3834	280	3392	0.0	0.08254716981132075
chr3	ATP13A5	193276749	193276830	0	82	22118	5709	22118	5627	0.0	3.930691309756531
chr3	LINC02028	194057636	194058147	0	512	2219	10141	2219	9629	0.0	0.23044968324852008
chr3	LINC00887	194301198	194303465	4080	2268	14018	4875	9938	2607	1.7989417989417988	3.8120444955887995
chr4	CPLX1	792432	792608	0	177	51	2354	51	2177	0.0	0.023426734037666513
chr4	HAUS3	2241519	2242121	70715	603	193335	9687	122620	9084	117.27197346600332	13.49845882870982
chr4	LCORL	17873387	17878213	10098	4827	164395	16931	154297	12104	2.0919825978868865	12.747604097818902
chr4	ARAP2	36073688	36073823	0	136	30	12390	30	12254	0.0	0.002448180186061694
chr4	RPL9	39458193	39458440	4875	248	694582	4943	689707	4695	19.657258064516128	146.9024494142705
chr4	AC114757.1	43992592	43993112	0	521	0	9122	0	8601	0.0	0.0
chr4	LINC02619	58987181	58987955	0	775	0	1391	0	616	0.0	0.0
chr4	LINC02619	58987184	58987889	0	706	0	1391	0	685	0.0	0.0
chr4	LINC02619	58987186	58987974	0	789	0	1391	0	602	0.0	0.0
chr4	THAP9-AS1	82900076	82900566	0	491	0	4254	0	3763	0.0	0.0
chr4	MAPK10	86359657	86360060	0	404	87	36649	87	36245	0.0	0.002400331080148986
chr4	MAPK10	86359657	86360083	0	427	87	36649	87	36222	0.0	0.0024018552261056815
chr4	CENPE	103136140	103136359	0	220	23174	9977	23174	9757	0.0	2.37511530183458
chr4	CYP2U1-AS1	107893066	107893637	0	572	102	6869	102	6297	0.0	0.016198189614101955
chr4	COL25A1	108810720	108813929	0	3210	6537	6485	6537	3275	0.0	1.996030534351145
chr4	COL25A1	109301722	109302367	0	646	6537	6485	6537	5839	0.0	1.1195410172974825
chr4	ARSJ	113978436	113979647	0	1212	0	4875	0	3663	0.0	0.0
chr4	LINC02262	117315151	117316148	0	998	0	2351	0	1353	0.0	0.0
chr4	METTL14-DT	118678043	118680583	51	2541	102	7533	51	4992	0.020070838252656435	0.010216346153846154
chr4	MFSD8	127917824	127920836	0	3013	204	7255	204	4242	0.0	0.04809052333804809
chr4	MFSD8	127917888	127920836	0	2949	204	7255	204	4306	0.0	0.04737575476079889
chr4	MFSD8	127920556	127921771	0	1216	204	7255	204	6039	0.0	0.03378042722305018
chr4	MFSD8	127921523	127921963	0	441	204	7255	204	6814	0.0	0.029938362195479896
chr4	LINC02466	129724172	129725789	0	1618	2800	3930	2800	2312	0.0	1.2110726643598615
chr4	PCDH18	137529601	137532494	0	2894	0	6690	0	3796	0.0	0.0
chr4	LINC01095	146113641	146114465	0	825	1784	3553	1784	2728	0.0	0.6539589442815249
chr4	PDGFC	156767772	156767990	0	219	1479	6013	1479	5794	0.0	0.2552640662754574
chr4	PDGFC	156810836	156811017	0	182	1479	6013	1479	5831	0.0	0.2536443148688047
chr4	NPY1R	163325855	163326705	0	851	0	3904	0	3053	0.0	0.0
chr4	NEK1	169612019	169612583	327	565	7899	8391	7572	7826	0.5787610619469027	0.9675440838231536
chr4	FBXO8	174262763	174263100	408	338	4050	2099	3642	1761	1.2071005917159763	2.0681431005110733
chr4	LINC01093	184897334	184898769	0	1436	0	3158	0	1722	0.0	0.0
chr4	LINC01093	184897347	184897746	0	400	0	3158	0	2758	0.0	0.0
chr4	UVSSA	1383765	1388049	84531	4285	155249	15270	70718	10985	19.727187864644108	6.437687756030951
chr4	ADD1	2904763	2905015	4660	253	353863	11643	349203	11390	18.41897233201581	30.65873573309921
chr4	NOP14-AS1	2934939	2937844	157821	2906	446093	7475	288272	4569	54.3086717136958	63.09301816590064
chr4	NSG1	4385856	4387173	0	1318	1109	4365	1109	3047	0.0	0.36396455530029537
chr4	NSG1	4417234	4419058	1058	1825	1109	4365	51	2540	0.5797260273972603	0.020078740157480315
chr4	STX18-AS1	4648976	4649542	0	567	21734	21284	21734	20717	0.0	1.0490901192257567
chr4	WFS1	6277450	6277687	0	238	98786	4521	98786	4283	0.0	23.064674293719357
chr4	LINC02517	8321956	8322243	0	288	102	1963	102	1675	0.0	0.0608955223880597
chr4	LINC02517	8320116	8320522	0	407	102	1963	102	1556	0.0	0.06555269922879177
chr4	LINC02517	8320138	8320522	0	385	102	1963	102	1578	0.0	0.06463878326996197
chr4	AC005699.1	11770308	11770688	0	381	0	4472	0	4091	0.0	0.0
chr4	FAM200B	15686235	15687148	3288	914	117523	3683	114235	2769	3.597374179431072	41.25496569158541
chr4	FAM200B	15686235	15690447	390275	4213	117523	3683	-272752	-530	92.63588891526229	514.6264150943397
chr4	LIAS	39467517	39468427	10201	911	222853	9122	212652	8211	11.197585071350165	25.898428936792108
chr4	TMEM33	41935128	41935529	0	402	236591	7774	236591	7372	0.0	32.09319045035269
chr4	SLAIN2	48382567	48382927	0	361	301013	6316	301013	5955	0.0	50.547942905121744
chr4	DCUN1D4	51886567	51887244	0	678	0	6539	0	5861	0.0	0.0
chr4	DANCR	52719867	52721683	2997	1817	12541	7739	9544	5922	1.6494221243808476	1.6116176967240796
chr4	REST	56910629	56911536	0	908	3672	7466	3672	6558	0.0	0.5599268069533394
chr4	IGFBP7-AS1	57201132	57201820	255	689	13558	3695	13303	3006	0.37010159651669083	4.425482368596141
chr4	STAP1	67606295	67607337	0	1043	48	1960	48	917	0.0	0.05234460196292257
chr4	LINC01094	78680760	78682725	0	1966	7306	5306	7306	3340	0.0	2.1874251497005988
chr4	LINC01094	78680760	78682683	0	1924	7306	5306	7306	3382	0.0	2.160260201064459
chr4	GPAT3	83536107	83536763	0	657	2037	3536	2037	2879	0.0	0.7075373393539424
chr4	SPP1	87981474	87981798	0	325	0	2329	0	2004	0.0	0.0
chr4	AIMP1	106320865	106321451	5089	587	107291	8611	102202	8024	8.669505962521296	12.73703888334995
chr4	LINC02263	117372363	117372735	0	373	0	12565	0	12192	0.0	0.0
chr4	LINC02263	117372363	117372850	0	488	0	12565	0	12077	0.0	0.0
chr4	SNHG8	118278754	118279137	0	384	0	6609	0	6225	0.0	0.0
chr4	SNHG8	118279388	118279820	0	433	0	6609	0	6176	0.0	0.0
chr4	EXOSC9	121813865	121816447	0	2583	255	3262	255	679	0.0	0.3755522827687776
chr4	INTU	127685441	127687867	0	2427	0	16061	0	13634	0.0	0.0
chr4	LARP1B	128107138	128108901	0	1764	204	8844	204	7080	0.0	0.0288135593220339
chr4	SNHG27	131773565	131774369	0	805	0	4138	0	3333	0.0	0.0
chr4	LINC02462	134455293	134455524	0	232	0	1601	0	1369	0.0	0.0
chr4	AC107223.1	143912330	143912638	0	309	2083	15940	2083	15631	0.0	0.13326082784210863
chr4	MMAA	145655146	145655568	0	423	23327	8168	23327	7745	0.0	3.0118786313750805
chr4	TRIM2	153322647	153324148	0	1502	5256	14876	5256	13374	0.0	0.39300134589502017
chr4	GUCY1A1	155696755	155697122	51	368	102	10473	51	10105	0.13858695652173914	0.005047006432459178
chr4	LINC02433	157572535	157572725	0	191	204	1495	204	1304	0.0	0.15644171779141106
chr4	CLCN3	169697188	169697734	0	547	153	8113	153	7566	0.0	0.020222045995241873
chr4	LINC02431	171040607	171040834	107	228	107	1769	0	1541	0.4692982456140351	0.0
chr4	HAND2-AS1	173530799	173531078	2	280	44	14033	42	13753	0.007142857142857143	0.003053879153639206
chr4	HAND2-AS1	173536847	173541931	0	5085	44	14033	44	8948	0.0	0.0049172999552972736
chr4	TRAPPC11	183708406	183708574	0	169	236	5682	236	5513	0.0	0.04280790857972066
chr4	LINC02436	185055997	185056679	0	683	0	7067	0	6384	0.0	0.0
chr4	LINC02436	185071567	185072073	0	507	0	7067	0	6560	0.0	0.0
chr4	FAM149A	186163423	186163633	30	211	850	5237	820	5026	0.14218009478672985	0.1631516116195782
chr4	LINC02434	188160215	188161153	0	939	0	1294	0	355	0.0	0.0
chr4	LINC02434	188160215	188161139	0	925	0	1294	0	369	0.0	0.0
chr4	LINC01060	188485778	188486620	0	843	0	5920	0	5077	0.0	0.0
chr4	DUX4	190173773	190175284	0	1512	0	2042	0	530	0.0	0.0
chr5	PDCD6	271620	271821	11250	202	1215560	9301	1204310	9099	55.693069306930695	132.35630289042751
chr5	EXOC3	464289	465272	109423	984	1071961	8157	962538	7173	111.20223577235772	134.18904224173986
chr5	SLC9A3-AS1	479781	480216	164710	436	689195	3334	524485	2898	377.77522935779814	180.98171152518978
chr5	SLC6A19	1216557	1216945	0	389	160	5281	160	4892	0.0	0.032706459525756335
chr5	AC124852.1	1958581	1959189	0	609	51	14286	51	13677	0.0	0.003728887914016232
chr5	AC124852.1	2097238	2097792	0	555	51	14286	51	13731	0.0	0.003714223290364868
chr5	LINC01018	6585773	6586604	0	832	99762	7086	99762	6254	0.0	15.951710905020787
chr5	LINC01018	6586227	6587666	51	1440	99762	7086	99711	5646	0.035416666666666666	17.660467587672688
chr5	LINC01018	6586227	6587670	51	1444	99762	7086	99711	5642	0.035318559556786706	17.67298830202056
chr5	AC091951.3	7326065	7326603	0	539	0	1653	0	1114	0.0	0.0
chr5	LINC02217	17440113	17441082	0	970	0	8721	0	7751	0.0	0.0
chr5	LINC02241	20936150	20936712	0	563	0	9146	0	8583	0.0	0.0
chr5	LINC02241	20936150	20937373	0	1224	0	9146	0	7922	0.0	0.0
chr5	LINC02241	20936810	20937257	0	448	0	9146	0	8698	0.0	0.0
chr5	LINC02241	20936818	20937257	0	440	0	9146	0	8706	0.0	0.0
chr5	LINC02241	20936818	20937693	0	876	0	9146	0	8270	0.0	0.0
chr5	PURPL	27493569	27494335	0	767	210	4915	210	4148	0.0	0.05062680810028929
chr5	ZNF131	43161248	43161931	43564	684	265777	8233	222213	7549	63.69005847953216	29.43608424956948
chr5	NNT	43647923	43649308	10645	1386	654496	10606	643851	9220	7.68037518037518	69.8319956616052
chr5	LINC01033	54401642	54403788	0	2147	48	3578	48	1431	0.0	0.033542976939203356
chr5	C5ORF64	61750336	61751770	153	1435	40911	22226	40758	20791	0.10662020905923345	1.9603674666923188
chr5	AC092353.1	66322832	66323341	0	510	1025	4196	1025	3686	0.0	0.27807921866521973
chr5	AC112206.2	67797349	67797756	0	408	278	5824	278	5416	0.0	0.05132939438700148
chr5	SLC30A5	69121746	69121895	0	150	459	5249	459	5099	0.0	0.09001765051970975
chr5	RAD17	69372033	69372217	12828	185	43435	4169	30607	3984	69.34054054054054	7.682479919678715
chr5	MARVELD2	69419370	69420531	3032	1162	6744	4722	3712	3560	2.6092943201376935	1.0426966292134832
chr5	BHMT2	79077479	79077612	51	134	153	3744	102	3610	0.3805970149253731	0.028254847645429362
chr5	COX7C	86619352	86619878	1173	527	3162	1972	1989	1445	2.225806451612903	1.3764705882352941
chr5	TMEM161B-AS1	88269467	88270585	0	1119	3060	27299	3060	26180	0.0	0.11688311688311688
chr5	TMEM161B-AS1	88269467	88282106	102	12640	3060	27299	2958	14659	0.008069620253164557	0.20178729790572345
chr5	HSD17B4	119492099	119493946	0	1848	153	10487	153	8639	0.0	0.017710383146197477
chr5	HSPA4	133101758	133101878	0	121	0	4955	0	4834	0.0	0.0
chr5	AC112178.1	136520174	136521145	0	972	0	2762	0	1790	0.0	0.0
chr5	MYOT	137870440	137871007	0	568	6914	2836	6914	2268	0.0	3.048500881834215
chr5	WNT8A	138090527	138091541	2957	1015	2428	1631	-529	616	2.9133004926108375	-0.8587662337662337
chr5	KIF20A	138181421	138181511	0	91	4872	3854	4872	3763	0.0	1.2947116662237577
chr5	KDM3B	138386021	138386621	0	601	1122	7897	1122	7296	0.0	0.15378289473684212
chr5	REEP2	138445227	138445375	1123	149	5475	3145	4352	2996	7.5369127516778525	1.4526034712950602
chr5	IK	140661619	140661708	0	90	0	2764	0	2674	0.0	0.0
chr5	WDR55	140668233	140668502	0	270	147	4392	147	4122	0.0	0.03566229985443959
chr5	WDR55	140668890	140669248	67	359	147	4392	80	4033	0.18662952646239556	0.01983635011157947
chr5	HARS2	140693490	140693665	0	176	454766	3423	454766	3247	0.0	140.05728364644287
chr5	HARS2	140691452	140691756	0	305	454766	3423	454766	3118	0.0	145.85182809493264
chr5	RELL2	141636949	141638409	0	1461	0	2590	0	1129	0.0	0.0
chr5	ARHGAP26	143207197	143207473	0	277	51	17199	51	16922	0.0	0.0030138281527006265
chr5	CARMN	149423185	149423639	207	455	617006	14357	616799	13902	0.45494505494505494	44.367644943173644
chr5	HMGXB3	150024261	150024680	0	420	71731	6284	71731	5864	0.0	12.232435197817189
chr5	GPX3	151025339	151025493	0	155	52	2903	52	2748	0.0	0.018922852983988356
chr5	G3BP1	151803884	151812785	0	8902	0	10115	0	1213	0.0	0.0
chr5	G3BP1	151803884	151805319	0	1436	0	10115	0	8679	0.0	0.0
chr5	PTTG1	160422301	160422893	102	593	102	1930	0	1337	0.17200674536256325	0.0
chr5	GABRA1	161850596	161850884	0	289	51	6688	51	6399	0.0	0.007969995311767463
chr5	GABRG2	162067464	162068106	0	643	918	19638	918	18995	0.0	0.048328507501974205
chr5	GABRG2	162149107	162155485	51	6379	918	19638	867	13259	0.007994983539739771	0.06538954672298061
chr5	GABRG2	162149107	162151753	0	2647	918	19638	918	16991	0.0	0.05402860337825908
chr5	CCNG1	163437570	163437804	0	235	0	2779	0	2544	0.0	0.0
chr5	NPM1	171406396	171407774	612	1379	8229	6517	7617	5138	0.4437998549673677	1.482483456597898
chr5	SIMC1	176295029	176295262	59	234	2335	5551	2276	5317	0.25213675213675213	0.42806093661839384
chr5	SIMC1	176345182	176345989	2262	808	2335	5551	73	4743	2.7995049504950495	0.015391102677630192
chr5	NSD1	177135086	177136030	153	945	527	15548	374	14603	0.1619047619047619	0.025611175785797437
chr5	FAM153CP	178046871	178047133	10627	263	112828	18718	102201	18455	40.40684410646388	5.537848821457599
chr5	FAM153CP	178048664	178052687	32660	4024	112828	18718	80168	14694	8.116302186878727	5.455832312508507
chr5	FAM153CP	178038837	178039411	2505	575	112828	18718	110323	18143	4.356521739130435	6.080747395689798
chr5	RUFY1	179559691	179560198	0	508	0	5465	0	4957	0.0	0.0
chr5	LINC00847	180834311	180835705	0	1395	510	5657	510	4262	0.0	0.11966213045518535
chr5	LINC00847	180834311	180835726	0	1416	510	5657	510	4241	0.0	0.1202546569205376
chr5	BTNL9	181053468	181054259	0	792	0	5577	0	4785	0.0	0.0
chr5	BRD9	868606	869119	6883	514	714915	9010	708032	8496	13.391050583657588	83.33709981167608
chr5	AC026412.1	1632643	1632906	2624	264	88401	3371	85777	3107	9.93939393939394	27.607660122304473
chr5	AC026412.1	1598919	1599827	20247	909	88401	3371	68154	2462	22.273927392739274	27.682372055239643
chr5	FASTKD3	7866645	7868170	53486	1526	78926	2765	25440	1239	35.04980340760157	20.53268765133172
chr5	CTNND2	11082695	11082846	0	152	0	7298	0	7146	0.0	0.0
chr5	LINC02103	28285963	28286886	0	924	0	1092	0	168	0.0	0.0
chr5	PRLR	35065088	35066102	10000	1015	10163	3630	163	2615	9.852216748768473	0.06233269598470363
chr5	LINC02106	50969216	50969577	0	362	0	608	0	246	0.0	0.0
chr5	SMIM15	61162216	61162468	0	253	0	2891	0	2638	0.0	0.0
chr5	CCDC125	69320236	69320580	0	345	32914	7594	32914	7249	0.0	4.540488343219755
chr5	CCDC125	69320236	69320583	0	348	32914	7594	32914	7246	0.0	4.542368203146563
chr5	TBCA	77691240	77693352	2754	2113	5229	3121	2475	1008	1.3033601514434454	2.455357142857143
chr5	RPS23	82275208	82276255	51	1048	255	3817	204	2769	0.04866412213740458	0.07367280606717226
chr5	LUCAT1	91314079	91314402	0	324	0	15454	0	15130	0.0	0.0
chr5	LUCAT1	91314164	91314402	0	239	0	15454	0	15215	0.0	0.0
chr5	LUCAT1	91314079	91314386	0	308	0	15454	0	15146	0.0	0.0
chr5	LUCAT1	91314079	91314499	0	421	0	15454	0	15033	0.0	0.0
chr5	LUCAT1	91314079	91314377	0	299	0	15454	0	15155	0.0	0.0
chr5	LUCAT1	91310626	91312413	0	1788	0	15454	0	13666	0.0	0.0
chr5	LUCAT1	91310626	91312495	0	1870	0	15454	0	13584	0.0	0.0
chr5	LUCAT1	91310626	91313229	0	2604	0	15454	0	12850	0.0	0.0
chr5	LUCAT1	91312294	91313229	0	936	0	15454	0	14518	0.0	0.0
chr5	LUCAT1	91311645	91312413	0	769	0	15454	0	14685	0.0	0.0
chr5	NR2F1-AS1	93580466	93581199	0	734	6927	22614	6927	21880	0.0	0.3165904936014625
chr5	LINC00491	102636142	102636434	0	293	20523	2811	20523	2518	0.0	8.150516282764098
chr5	AC099520.1	104739255	104739635	0	381	0	4954	0	4573	0.0	0.0
chr5	AC099520.1	104739257	104739635	0	379	0	4954	0	4575	0.0	0.0
chr5	AC011416.3	127227616	127228918	0	1303	0	1800	0	497	0.0	0.0
chr5	HINT1	131159295	131162477	0	3183	49	6082	49	2899	0.0	0.016902380131079683
chr5	HINT1	131159295	131162676	0	3382	49	6082	49	2700	0.0	0.01814814814814815
chr5	FNIP1	131671504	131672924	13775	1421	50875	6738	37100	5317	9.693877551020408	6.977618958059056
chr5	ACSL6	131974892	131976240	2364	1349	77879	15803	75515	14454	1.7524091919940696	5.224505327245053
chr5	ACSL6	131990852	131991813	51	962	77879	15803	77828	14841	0.05301455301455302	5.244121016104036
chr5	HSPA9	138553755	138556592	1020	2838	629	5786	-391	2948	0.3594080338266385	-0.13263229308005428
chr5	APBB3	140561586	140562227	510	642	1560	3183	1050	2541	0.794392523364486	0.4132231404958678
chr5	APBB3	140561586	140561849	0	264	1560	3183	1560	2919	0.0	0.5344295991778006
chr5	NR3C1	143300484	143300763	0	280	102	9176	102	8896	0.0	0.011465827338129496
chr5	NR3C1	143399655	143400852	51	1198	102	9176	51	7978	0.04257095158597663	0.0063925795938831785
chr5	PPP2R2B	146878001	146878785	0	785	60	13227	60	12442	0.0	0.0048223758238225365
chr5	SH3TC2	149026859	149028554	0	1696	4883	12652	4883	10956	0.0	0.4456918583424608
chr5	SH3TC2	149006880	149009001	255	2122	4883	12652	4628	10530	0.12016965127238455	0.43950617283950616
chr5	SH3TC2	149026859	149028718	0	1860	4883	12652	4883	10792	0.0	0.4524647887323944
chr5	ZNF300	150894398	150898184	3876	3787	4168	4410	292	623	1.0235014523369421	0.46869983948635635
chr5	CCNJL	160254128	160255708	51	1581	204	9249	153	7668	0.03225806451612903	0.01995305164319249
chr5	SLU7	160418595	160419081	0	487	0	4786	0	4299	0.0	0.0
chr5	LINC01938	165240461	165240757	0	297	0	3198	0	2901	0.0	0.0
chr5	AC008429.1	172957153	172958257	0	1105	0	2174	0	1069	0.0	0.0
chr5	AC139491.6	176147538	176147870	0	333	0	2756	0	2423	0.0	0.0
chr5	CLK4	178603843	178603934	0	92	45809	7054	45809	6962	0.0	6.579862108589486
chr5	HNRNPH1	179623036	179624669	0	1634	255	5593	255	3959	0.0	0.06441020459712049
chr5	C5ORF60	179642325	179643210	0	886	0	2531	0	1645	0.0	0.0
chr5	MRNIP	179837275	179840959	102	3685	1734	7454	1632	3769	0.0276797829036635	0.43300610241443355
chr5	MRNIP	179853196	179853437	0	242	1734	7454	1734	7212	0.0	0.240432612312812
chr5	ZFP62	180847610	180851493	51	3884	51	3131	0	-753	0.013130792996910402	-0.0
chr5	RACK1	181236928	181237719	0	792	0	5102	0	4310	0.0	0.0
chr6	AL133351.4	3026752	3027426	1866	675	21227	1378	19361	703	2.7644444444444445	27.54054054054054
chr6	RIPK1	3083084	3085408	56493	2325	427461	10181	370968	7856	24.29806451612903	47.22097759674134
chr6	PRPF4B	4060412	4061147	53235	736	332939	7279	279704	6543	72.33016304347827	42.74858627540883
chr6	PRPF4B	4061654	4062299	44800	646	332939	7279	288139	6633	69.3498452012384	43.44022312679029
chr6	HULC	8788821	8790434	8109	1614	31525	47611	23416	45997	5.0241635687732344	0.5090766789138422
chr6	U91328.1	25997902	26001775	77482	3874	73081	3639	-4401	-235	20.00051626226123	18.727659574468085
chr6	BTN3A2	26368564	26368912	2256	349	133873	5358	131617	5009	6.464183381088826	26.276103014573767
chr6	BTN2A3P	26422932	26423759	26690	828	113609	4185	86919	3357	32.234299516908216	25.891867739052724
chr6	LINC00240	27023208	27023923	0	716	867	3236	867	2520	0.0	0.34404761904761905
chr6	LINC00240	27023253	27023925	0	673	867	3236	867	2563	0.0	0.33827545844713225
chr6	LINC00240	27023253	27023931	0	679	867	3236	867	2557	0.0	0.33906922174423154
chr6	MOG	29670700	29672372	0	1673	0	2643	0	970	0.0	0.0
chr6	ATAT1	30642767	30644679	1165925	1913	1239687	3818	73762	1905	609.4746471510716	38.72020997375328
chr6	C6ORF136	30652647	30653109	347507	463	474596	2035	127089	1572	750.5550755939524	80.84541984732824
chr6	MUCL3	30948546	30952499	255	3954	306	5687	51	1733	0.06449165402124431	0.029428736295441432
chr6	CSNK2B	31665233	31665493	1845	261	56959	2558	55114	2297	7.068965517241379	23.993905093600347
chr6	MPIG6B	31724745	31725074	28082	330	379876	2943	351794	2613	85.0969696969697	134.63222349789513
chr6	MSH5-SAPCD1	31762419	31763168	33442	750	199233	3610	165791	2860	44.589333333333336	57.96888111888112
chr6	MSH5-SAPCD1	31764265	31764851	0	587	199233	3610	199233	3023	0.0	65.90572279192855
chr6	CFB	31951554	31952084	46	531	171859	4475	171813	3944	0.08662900188323917	43.56313387423935
chr6	SKIV2L	31969279	31969751	2672	473	15115	4787	12443	4314	5.649048625792812	2.884330088085304
chr6	PPT2-EGFL8	32166137	32166620	0	484	233123	5532	233123	5048	0.0	46.181259904912835
chr6	AL662789.1	32718028	32718440	0	413	0	1019	0	606	0.0	0.0
chr6	HCG25	33249533	33249889	3777	357	145352	4313	141575	3956	10.579831932773109	35.78741152679474
chr6	AL138889.1	33914087	33915115	0	1029	0	14456	0	13427	0.0	0.0
chr6	AL138889.1	33914087	33914792	0	706	0	14456	0	13750	0.0	0.0
chr6	HMGA1	34236872	34237317	51	446	9948	2333	9897	1887	0.11434977578475336	5.24483306836248
chr6	ZNF76	35290640	35291403	0	764	68160	6025	68160	5261	0.0	12.95571184185516
chr6	CNPY3	42935573	42935670	297	98	12929	1725	12632	1627	3.0306122448979593	7.763982790411801
chr6	TJAP1	43504760	43506553	177447	1794	247335	6659	69888	4865	98.9113712374582	14.36546762589928
chr6	TJAP1	43500743	43501687	33512	945	247335	6659	213823	5714	35.46243386243386	37.42089604480224
chr6	TJAP1	43503622	43506553	180846	2932	247335	6659	66489	3727	61.68008185538881	17.839817547625437
chr6	EFHC1	52438303	52438591	0	289	19269	16238	19269	15949	0.0	1.2081635212239012
chr6	TRAM2-AS1	52578049	52578594	0	546	51	8437	51	7891	0.0	0.006463059181345837
chr6	TRAM2-AS1	52577306	52578393	0	1088	51	8437	51	7349	0.0	0.006939719689753708
chr6	ADGRB3	69233033	69233416	0	384	0	6603	0	6219	0.0	0.0
chr6	FAM135A	70524930	70526698	0	1769	60184	9960	60184	8191	0.0	7.347576608472714
chr6	AL391840.1	79420262	79420637	0	376	51	11835	51	11459	0.0	0.004450650143991622
chr6	SLC35A1	87508419	87508596	0	178	0	2003	0	1825	0.0	0.0
chr6	LINC00222	108766995	108768456	531	1462	531	2909	0	1447	0.36320109439124487	0.0
chr6	FIG4	109786301	109789677	94498	3377	543882	19865	449384	16488	27.982824992596978	27.255215914604562
chr6	FIG4	109786301	109788956	91081	2656	543882	19865	452801	17209	34.29254518072289	26.31187169504329
chr6	LINC01013	132131912	132132189	0	278	0	6796	0	6518	0.0	0.0
chr6	LINC00326	133088817	133090069	0	1253	2601	6021	2601	4768	0.0	0.545511744966443
chr6	MYB	135196725	135197323	0	599	1476	5517	1476	4918	0.0	0.30012200081333873
chr6	TNFAIP3	137875687	137875835	0	149	87	4800	87	4651	0.0	0.018705654697914426
chr6	TNFAIP3	137878431	137879351	87	921	87	4800	0	3879	0.09446254071661238	0.0
chr6	AL590617.2	138696596	138697288	51	693	25	2404	-26	1711	0.0735930735930736	-0.015195791934541203
chr6	AL592429.2	139286844	139287307	0	464	367	4873	367	4409	0.0	0.08323882966659106
chr6	VDAC1P8	143503393	143504142	0	750	0	4338	0	3588	0.0	0.0
chr6	VDAC1P8	143505339	143506100	0	762	0	4338	0	3576	0.0	0.0
chr6	ADGB	146724185	146726197	0	2013	0	7809	0	5796	0.0	0.0
chr6	SYTL3	158662749	158663378	9572	630	10339	2914	767	2284	15.193650793650793	0.3358143607705779
chr6	QKI	163563419	163570145	51	6727	2805	12507	2754	5780	0.0075813884346662705	0.4764705882352941
chr6	TBP	170561790	170562233	0	444	0	2328	0	1884	0.0	0.0
chr6	SLC22A23	3271773	3273412	83274	1640	97638	6133	14364	4493	50.77682926829268	3.1969730692187848
chr6	AL033523.1	3653220	3654795	918	1576	2499	14663	1581	13087	0.5824873096446701	0.12080690761824711
chr6	TFAP2A	10409900	10410335	62480	436	977458	7421	914978	6985	143.30275229357798	130.9918396564066
chr6	PRL	22294408	22294584	0	177	0	1437	0	1260	0.0	0.0
chr6	ZSCAN31	28353861	28354204	0	344	33084	3678	33084	3334	0.0	9.923215356928614
chr6	GPX6	28510750	28510904	0	155	0	2026	0	1871	0.0	0.0
chr6	TRIM27	28903001	28904665	0	1665	426	5195	426	3530	0.0	0.1206798866855524
chr6	RNF39	30070265	30071691	0	1427	0	2210	0	783	0.0	0.0
chr6	TRIM31	30102896	30103789	0	894	0	3099	0	2205	0.0	0.0
chr6	HCG18	30291536	30294964	32672	3429	130230	15541	97558	12112	9.52814231554389	8.054656538969617
chr6	CCHCR1	31156730	31157089	0	360	11185	4266	11185	3906	0.0	2.863543266769073
chr6	POU5F1	31165926	31166838	2891	913	15394	2841	12503	1928	3.166484118291347	6.484958506224066
chr6	NCR3	31589781	31590126	744	346	37533	1155	36789	809	2.1502890173410405	45.474660074165634
chr6	LY6G6E	31712340	31712789	4795	450	55208	1107	50413	657	10.655555555555555	76.73211567732116
chr6	TSBP1	32330588	32330609	0	22	49583	2235	49583	2213	0.0	22.40533212833258
chr6	TSBP1	32366272	32366302	0	31	49583	2235	49583	2204	0.0	22.49682395644283
chr6	HLA-DQB2	32756097	32757304	0	1208	0	2031	0	823	0.0	0.0
chr6	DAXX	33318996	33319219	0	224	25	2984	25	2760	0.0	0.009057971014492754
chr6	CUTA	33416549	33416776	52124	228	154924	1281	102800	1053	228.6140350877193	97.62583095916429
chr6	BAK1	33575792	33575928	0	137	0	2219	0	2082	0.0	0.0
chr6	LEMD2	33771221	33772778	0	1558	408	6568	408	5010	0.0	0.081437125748503
chr6	RPS10	34417453	34418424	153	972	153	2123	0	1151	0.1574074074074074	0.0
chr6	TFEB	41705646	41705940	0	295	51	5743	51	5448	0.0	0.009361233480176211
chr6	TRERF1	42268153	42269848	8342	1696	28107	7750	19765	6054	4.918632075471698	3.2647836141394118
chr6	YIPF3	43513068	43513451	102	384	57826	2603	57724	2219	0.265625	26.013519603424967
chr6	GTPBP2	43620489	43622167	51	1679	6139	4733	6088	3054	0.030375223347230494	1.9934512115258678
chr6	GTPBP2	43620489	43621790	51	1302	6139	4733	6088	3431	0.03917050691244239	1.774409793063247
chr6	MRPS18A	43675201	43675617	0	417	0	1390	0	973	0.0	0.0
chr6	MLIP-AS1	54047291	54047594	0	304	0	4048	0	3744	0.0	0.0
chr6	LGSN	63275950	63281220	51	5271	51	2402	0	-2869	0.009675583380762664	-0.0
chr6	EYS	65494662	65495607	0	946	1173	17124	1173	16178	0.0	0.07250587217208555
chr6	AL589935.1	71310295	71310642	0	348	12425	5018	12425	4670	0.0	2.6605995717344753
chr6	KHDC1	73262773	73263184	0	412	0	2448	0	2036	0.0	0.0
chr6	KHDC1	73241316	73241728	0	413	0	2448	0	2035	0.0	0.0
chr6	EEF1A1	73517514	73518264	0	751	3254	6341	3254	5590	0.0	0.5821109123434705
chr6	SNHG5	85678135	85678748	0	614	51	7815	51	7201	0.0	0.007082349673656437
chr6	SNHG5	85678135	85678736	0	602	51	7815	51	7213	0.0	0.007070567031748232
chr6	SNHG5	85678135	85678733	0	599	51	7815	51	7216	0.0	0.007067627494456763
chr6	SNHG5	85677423	85678032	0	610	51	7815	51	7205	0.0	0.007078417765440667
chr6	SNHG5	85677423	85678748	0	1326	51	7815	51	6489	0.0	0.00785945446139621
chr6	SNHG5	85677423	85678188	0	766	51	7815	51	7049	0.0	0.007235068804085686
chr6	SNHG5	85677794	85678032	0	239	51	7815	51	7576	0.0	0.0067317845828933475
chr6	SNHG5	85677794	85678188	0	395	51	7815	51	7420	0.0	0.006873315363881401
chr6	SNHG5	85677794	85678748	0	955	51	7815	51	6860	0.0	0.0074344023323615165
chr6	SNHG5	85677006	85677492	0	487	51	7815	51	7328	0.0	0.006959606986899563
chr6	SNHG5	85677953	85678748	0	796	51	7815	51	7019	0.0	0.007265992306596381
chr6	SNHG5	85677423	85677875	0	453	51	7815	51	7362	0.0	0.0069274653626731865
chr6	SNHG5	85677078	85677492	0	415	51	7815	51	7400	0.0	0.006891891891891892
chr6	SNHG5	85677953	85678736	0	784	51	7815	51	7031	0.0	0.007253591238799602
chr6	SNHG5	85677078	85677875	0	798	51	7815	51	7017	0.0	0.007268063274903805
chr6	SNHG5	85677953	85678188	0	236	51	7815	51	7579	0.0	0.006729119936667106
chr6	SNHG5	85677790	85678032	0	243	51	7815	51	7572	0.0	0.006735340729001585
chr6	MAP3K7	90550467	90552179	11197	1713	18001	7270	6804	5557	6.536485697606539	1.2244016555695518
chr6	PNISR	99403828	99404702	0	875	0	5565	0	4690	0.0	0.0
chr6	LINC02532	106774776	106775000	0	225	17855	11311	17855	11086	0.0	1.6105899332491431
chr6	CD164	109366513	109369017	1466	2505	1466	6868	0	4363	0.5852295409181637	0.0
chr6	SLC22A16	110424686	110425382	6814	697	7510	2809	696	2112	9.776183644189382	0.32954545454545453
chr6	SLC22A16	110456537	110457017	696	481	7510	2809	6814	2328	1.446985446985447	2.926975945017182
chr6	LAMA4	112253955	112254538	0	584	851	11935	851	11351	0.0	0.07497136816139548
chr6	EPB41L2	130869851	130870126	0	276	45	10058	45	9782	0.0	0.004600286240032713
chr6	VNN3	132734252	132734692	0	441	510	5404	510	4963	0.0	0.10276042716099133
chr6	VNN3	132722925	132723907	0	983	510	5404	510	4421	0.0	0.11535851617281158
chr6	VNN2	132752460	132752749	0	290	102	2606	102	2316	0.0	0.04404145077720207
chr6	TARID	133888603	133889212	0	610	0	8097	0	7487	0.0	0.0
chr6	SGK1	134174510	134174861	0	352	0	6257	0	5905	0.0	0.0
chr6	AL138828.1	136095993	136096288	0	296	0	7340	0	7044	0.0	0.0
chr6	BCLAF1	136275842	136276508	0	667	4009	7393	4009	6726	0.0	0.596045197740113
chr6	REPS1	138926400	138930098	561	3699	1246	6039	685	2340	0.1516626115166261	0.29273504273504275
chr6	PLAGL1	143964786	143966230	0	1445	1173	8363	1173	6918	0.0	0.16955767562879445
chr6	PLAGL1	143940301	143942663	306	2363	1173	8363	867	6000	0.12949640287769784	0.1445
chr6	PLAGL1	143964786	143966198	0	1413	1173	8363	1173	6950	0.0	0.1687769784172662
chr6	EPM2A	145686121	145686296	0	176	0	17587	0	17411	0.0	0.0
chr6	SHPRH	145941622	145941874	0	253	3736	17722	3736	17469	0.0	0.2138645600778522
chr6	SHPRH	145954689	145955354	0	666	3736	17722	3736	17056	0.0	0.21904315196998123
chr6	STXBP5-AS1	146844318	146844712	0	395	683	11664	683	11269	0.0	0.06060874966722868
chr6	STXBP5-AS1	146850824	146851331	0	508	683	11664	683	11156	0.0	0.06122266045177483
chr6	RAET1K	150000852	150001668	28642	817	45621	1900	16979	1083	35.057527539779684	15.67774699907664
chr6	SYNE1	152329729	152331890	0	2162	534	42788	534	40626	0.0	0.013144291832816422
chr6	SYNE1	152455885	152456044	0	160	534	42788	534	42628	0.0	0.012526977573425918
chr6	SERAC1	158116184	158117821	0	1638	153	9775	153	8137	0.0	0.018802998648150424
chr6	SOD2	159679063	159682638	3192	3576	28748	6793	25556	3217	0.8926174496644296	7.944047248989742
chr6	PACRG-AS3	163187672	163190982	0	3311	204	8368	204	5057	0.0	0.0403401226023334
chr6	PACRG-AS1	163320400	163324069	0	3670	45	2756	45	-914	0.0	-0.04923413566739606
chr6	TCP10L3	167375965	167378092	7830	2128	23875	8397	16045	6269	3.6795112781954886	2.5594193651300046
chr6	TCP10L3	167372967	167374451	3774	1485	23875	8397	20101	6912	2.5414141414141413	2.908130787037037
chr6	TCP10L3	167376545	167378092	6003	1548	23875	8397	17872	6849	3.877906976744186	2.609432033873558
chr6	FRMD1	168066754	168067129	0	376	0	7718	0	7342	0.0	0.0
chr7	CYP2W1	988276	989640	153	1365	54	2697	-99	1332	0.11208791208791209	-0.07432432432432433
chr7	ZFAND2A-DT	1162961	1163495	0	535	897	2348	897	1813	0.0	0.4947600661886376
chr7	IQCE	2571525	2571654	0	130	97738	9142	97738	9012	0.0	10.84531735463826
chr7	SDK1	4265123	4269000	153	3878	153	12307	0	8429	0.03945332645693656	0.0
chr7	USP42	6139091	6140195	274	1105	16583	7092	16309	5987	0.24796380090497738	2.724068815767496
chr7	ZDHHC4	6577433	6577720	0	288	0	3565	0	3277	0.0	0.0
chr7	C7ORF26	6599828	6600356	0	529	37	2732	37	2203	0.0	0.016795279164775308
chr7	RSPH10B2	6757356	6757931	307	576	50333	4899	50026	4323	0.5329861111111112	11.572056442285449
chr7	RSPH10B2	6754116	6754509	845	394	50333	4899	49488	4505	2.1446700507614214	10.985127635960044
chr7	AC005532.1	7277584	7278071	66813	488	73896	3258	7083	2770	136.91188524590163	2.5570397111913357
chr7	AC004540.1	26493794	26495199	0	1406	477	6357	477	4951	0.0	0.09634417289436477
chr7	AC004947.1	26556473	26557207	2	735	2	2731	0	1996	0.0027210884353741495	0.0
chr7	AC004947.1	26554808	26555227	0	420	2	2731	2	2311	0.0	0.0008654262224145391
chr7	HOXA-AS2	27123459	27124610	51	1152	1908	4914	1857	3762	0.044270833333333336	0.49362041467304624
chr7	AC005162.2	29000968	29001055	0	88	0	4933	0	4845	0.0	0.0
chr7	GARS1	30631447	30632437	19169	991	127003	11228	107834	10237	19.343087790111	10.533750122106087
chr7	GARS1	30594877	30595143	1435	267	127003	11228	125568	10961	5.3745318352059925	11.455889061217043
chr7	GHRHR	30969532	30969964	0	433	647	3152	647	2719	0.0	0.23795513056270687
chr7	EEPD1	36154132	36155202	0	1071	51	4594	51	3523	0.0	0.014476298609139937
chr7	CDK13	40078719	40078851	36	133	85076	22505	85040	22372	0.2706766917293233	3.80118004648668
chr7	AEBP1	44110724	44111057	6092	334	166796	4990	160704	4656	18.239520958083833	34.51546391752577
chr7	AEBP1	44111506	44112050	29169	545	166796	4990	137627	4445	53.52110091743119	30.96220472440945
chr7	AC237221.1	57418627	57419532	0	906	0	4007	0	3101	0.0	0.0
chr7	AC237221.1	57418627	57419535	0	909	0	4007	0	3098	0.0	0.0
chr7	ASL	66075833	66076093	0	261	10965	5629	10965	5368	0.0	2.0426602086438153
chr7	KCTD7	66638855	66639228	0	374	10236	3297	10236	2923	0.0	3.501881628463907
chr7	TYW1	67067284	67067403	0	120	0	3755	0	3635	0.0	0.0
chr7	SPDYE21	67286043	67286437	0	395	0	1301	0	906	0.0	0.0
chr7	STAG3L4	67308576	67309139	0	564	0	3202	0	2638	0.0	0.0
chr7	NCF1	74782938	74783632	5109	695	31538	3153	26429	2458	7.351079136690648	10.752237591537835
chr7	NSUN5P1	75412788	75415023	51	2236	217	2136	166	-100	0.022808586762075134	-1.66
chr7	NSUN5P1	75415591	75416191	0	601	217	2136	217	1535	0.0	0.14136807817589578
chr7	NSUN5P1	75415980	75416191	0	212	217	2136	217	1924	0.0	0.11278586278586279
chr7	SPDYE5	75501361	75501755	0	395	16	3333	16	2938	0.0	0.005445881552076242
chr7	POR	75986158	75986855	4539	698	43202	5746	38663	5048	6.502865329512894	7.6590729001584785
chr7	AC007003.1	76902479	76903112	561	634	1003	1239	442	605	0.8848580441640379	0.7305785123966942
chr7	MAGI2-AS3	79458846	79459640	0	795	0	16832	0	16037	0.0	0.0
chr7	STEAP2	90232336	90237631	0	5296	765	8556	765	3260	0.0	0.23466257668711657
chr7	PEG10	94663333	94665698	0	2366	0	3432	0	1066	0.0	0.0
chr7	PEG10	94663333	94669692	0	6360	0	3432	0	-2928	0.0	-0.0
chr7	ZKSCAN1	100023418	100023932	0	515	181676	10327	181676	9812	0.0	18.515695067264573
chr7	ZSCAN21	100056910	100057405	690	496	97884	2045	97194	1549	1.3911290322580645	62.746287927695285
chr7	STAG3	100220113	100220673	1464	561	80708	8611	79244	8050	2.609625668449198	9.843975155279503
chr7	PILRB	100353372	100354012	0	641	102	3977	102	3336	0.0	0.030575539568345324
chr7	PILRB	100352563	100352914	0	352	102	3977	102	3625	0.0	0.02813793103448276
chr7	PILRB	100352563	100353123	0	561	102	3977	102	3416	0.0	0.029859484777517563
chr7	LRWD1	102465531	102466051	3621	521	4604	2902	983	2381	6.950095969289827	0.4128517429651407
chr7	ARMC10	103083681	103084062	0	382	102	4585	102	4203	0.0	0.02426837972876517
chr7	KMT2E	105090008	105090273	0	266	11085	9981	11085	9715	0.0	1.1410190427174471
chr7	DUS4L-BCAP29	107563970	107564676	122117	707	365323	7282	243206	6575	172.72560113154174	36.989505703422054
chr7	PTPRZ1	122010333	122013889	0	3557	108	8512	108	4955	0.0	0.02179616548940464
chr7	ASB15	123624568	123624814	0	247	51	4927	51	4680	0.0	0.010897435897435897
chr7	IRF5	128947277	128947535	413	259	1077	4365	664	4106	1.5945945945945945	0.16171456405260595
chr7	PRSS1	142751773	142752027	0	255	0	1218	0	963	0.0	0.0
chr7	PRSS2	142773265	142773519	0	255	0	1266	0	1011	0.0	0.0
chr7	EPHB6	142863965	142864749	0	785	80	4742	80	3957	0.0	0.02021733636593379
chr7	GSTK1	143264991	143265296	0	306	423	3842	423	3536	0.0	0.11962669683257919
chr7	OR2F1	143959947	143964360	755	4414	755	5093	0	679	0.1710466696873584	0.0
chr7	ARHGEF35-AS1	144239039	144239388	0	350	0	7882	0	7532	0.0	0.0
chr7	CUL1	148753975	148754150	0	176	20100	4022	20100	3846	0.0	5.226209048361935
chr7	SSPOP	149795538	149796515	0	978	53	19328	53	18350	0.0	0.002888283378746594
chr7	SSPOP	149826449	149827985	0	1537	53	19328	53	17791	0.0	0.0029790343432072397
chr7	SSPOP	149826912	149827985	0	1074	53	19328	53	18254	0.0	0.002903473211350937
chr7	ABCB8	151034272	151034599	0	328	140171	9139	140171	8811	0.0	15.908636931108841
chr7	ASIC3	151052165	151052474	0	310	27069	2756	27069	2446	0.0	11.06663941128373
chr7	AGAP3	151086741	151087072	102	332	306	10457	204	10125	0.3072289156626506	0.020148148148148148
chr7	RBM33	155738059	155740026	51	1968	51	13047	0	11079	0.025914634146341462	0.0
chr7	AC006372.1	157502806	157503908	0	1103	0	1692	0	589	0.0	0.0
chr7	AC073316.1	3158137	3158571	0	435	0	1732	0	1297	0.0	0.0
chr7	RSPH10B	5966862	5967437	0	576	30874	5015	30874	4439	0.0	6.955170083352106
chr7	ZNF12	6688432	6692703	118744	4272	121432	5328	2688	1056	27.795880149812735	2.5454545454545454
chr7	ETV1	13989267	13989666	0	400	484	9310	484	8910	0.0	0.05432098765432099
chr7	AC005165.1	25655205	25656231	0	1027	3	5486	3	4459	0.0	0.0006727965911639381
chr7	HNRNPA2B1	26190992	26192338	367	1347	1337	8930	970	7583	0.27245731254639943	0.12791771066860083
chr7	HNRNPA2B1	26190992	26192577	816	1586	1337	8930	521	7344	0.5145018915510718	0.07094226579520697
chr7	HNRNPA2B1	26189926	26192338	367	2413	1337	8930	970	6517	0.15209283050145048	0.14884149148381157
chr7	HNRNPA2B1	26190992	26191650	0	659	1337	8930	1337	8271	0.0	0.16164913553379276
chr7	HNRNPA2B1	26191055	26192577	816	1523	1337	8930	521	7407	0.535784635587656	0.07033886863777508
chr7	HNRNPA2B1	26191055	26192338	367	1284	1337	8930	970	7646	0.28582554517133957	0.1268637195919435
chr7	HNRNPA2B1	26191055	26191650	0	596	1337	8930	1337	8334	0.0	0.16042716582673386
chr7	GARS1-DT	30576563	30578091	4479	1529	50780	12139	46301	10610	2.929365598430347	4.363901979264845
chr7	HERPUD2	35694183	35695135	0	953	25345	3420	25345	2467	0.0	10.273611674098095
chr7	MRPS24	43869307	43869517	0	211	0	2611	0	2400	0.0	0.0
chr7	POLM	44074130	44074530	418	401	24049	4453	23631	4052	1.0423940149625934	5.831934846989141
chr7	POLM	44073782	44074530	2829	749	24049	4453	21220	3704	3.7770360480640854	5.728941684665227
chr7	MYL7	44140960	44141332	0	373	33	1463	33	1090	0.0	0.030275229357798167
chr7	CAMK2B	44220615	44220901	0	287	13326	7658	13326	7371	0.0	1.8078958078958078
chr7	SNHG15	44983022	44984046	0	1025	0	3016	0	1991	0.0	0.0
chr7	SNHG15	44983821	44984426	0	606	0	3016	0	2410	0.0	0.0
chr7	SNHG15	44983821	44986097	0	2277	0	3016	0	739	0.0	0.0
chr7	SNHG15	44984356	44986097	0	1742	0	3016	0	1274	0.0	0.0
chr7	TBRG4	45108826	45109287	1080	462	76990	5038	75910	4576	2.3376623376623376	16.588723776223777
chr7	TNS3	47275153	47280190	3344	5038	8485	11804	5141	6766	0.6637554585152838	0.7598285545373928
chr7	LINC01446	53811507	53811931	0	425	0	7300	0	6875	0.0	0.0
chr7	LINC01446	53811507	53811942	0	436	0	7300	0	6864	0.0	0.0
chr7	LINC01446	53770079	53771607	0	1529	0	7300	0	5771	0.0	0.0
chr7	LINC00174	66491030	66491471	51	442	187780	11077	187729	10635	0.11538461538461539	17.65199811941702
chr7	NSUN5P2	72948891	72949102	0	212	13027	1874	13027	1662	0.0	7.838146811070999
chr7	MLXIPL	73593201	73594403	2091	1203	67917	4671	65826	3468	1.7381546134663342	18.980968858131487
chr7	TMEM120A	75988082	75988341	105469	260	85419	1694	-20050	1434	405.65	-13.98186889818689
chr7	SPDYE16	76533875	76534119	0	245	0	3612	0	3367	0.0	0.0
chr7	POMZP3	76618182	76618615	0	434	6357	1868	6357	1434	0.0	4.433054393305439
chr7	MAGI2	78255942	78256581	0	640	284	25254	284	24614	0.0	0.011538149020882425
chr7	HGF	81755120	81757303	0	2184	0	8746	0	6562	0.0	0.0
chr7	ABCB1	87600754	87601078	0	325	19041	6455	19041	6130	0.0	3.106199021207178
chr7	CYP51A1	92117043	92117212	746	170	29315	3540	28569	3370	4.3882352941176475	8.477448071216617
chr7	SAMD9L	93145384	93146040	0	657	0	2461	0	1804	0.0	0.0
chr7	SGCE	94587777	94588732	0	956	695	11980	695	11024	0.0	0.06304426705370102
chr7	SGCE	94597748	94598004	0	257	695	11980	695	11723	0.0	0.05928516591316216
chr7	CYP3A5	99662815	99664095	25268	1281	358841	8312	333573	7031	19.725214676034348	47.44318020196274
chr7	CYP3A5	99676114	99676576	3723	463	358841	8312	355118	7849	8.041036717062635	45.24372531532679
chr7	MCM7	100099022	100099403	0	382	153	4099	153	3717	0.0	0.04116222760290557
chr7	GIGYF1	100688591	100689555	102	965	102	6865	0	5900	0.10569948186528498	0.0
chr7	ACHE	100893164	100894233	14116	1070	31893	3736	17777	2666	13.19252336448598	6.668042010502625
chr7	POLR2J3	102566996	102568184	0	1189	51	3918	51	2729	0.0	0.01868816416269696
chr7	NAPEPLD	103099775	103103554	0	3780	51	6140	51	2360	0.0	0.021610169491525423
chr7	TMEM168	112783697	112784953	0	1257	0	7838	0	6581	0.0	0.0
chr7	HRAT17	112953281	112954768	0	1488	51	3836	51	2348	0.0	0.0217206132879046
chr7	HRAT17	112953283	112954768	0	1486	51	3836	51	2350	0.0	0.02170212765957447
chr7	HRAT17	112953383	112954768	0	1386	51	3836	51	2450	0.0	0.020816326530612245
chr7	TFEC	115939948	115942040	0	2093	0	3858	0	1765	0.0	0.0
chr7	NDUFA5	123557403	123557781	0	379	408	7705	408	7326	0.0	0.055692055692055695
chr7	POT1	124822385	124824074	0	1690	0	8237	0	6547	0.0	0.0
chr7	PAX4	127610810	127610985	0	176	2971	2303	2971	2127	0.0	1.3968030089327692
chr7	MKLN1-AS	131326805	131327746	0	942	0	7684	0	6742	0.0	0.0
chr7	PODXL	131508950	131509585	0	636	0	6903	0	6267	0.0	0.0
chr7	AC009275.1	134417971	134418974	0	1004	51	5023	51	4019	0.0	0.012689723811893506
chr7	AC009275.1	134417291	134418219	0	929	51	5023	51	4094	0.0	0.012457254518808011
chr7	AC009275.1	134417291	134418974	0	1684	51	5023	51	3339	0.0	0.015274034141958671
chr7	CREB3L2	137915836	137916012	0	177	51	4960	51	4783	0.0	0.010662763955676354
chr7	WEE2-AS1	141727203	141727642	0	440	0	5092	0	4652	0.0	0.0
chr7	PRSS37	141841015	141841485	0	471	0	2228	0	1757	0.0	0.0
chr7	SMARCD3	151240424	151241653	0	1230	13016	4505	13016	3275	0.0	3.974351145038168
chr7	PRKAG2	151565345	151565885	0	541	26240	14143	26240	13602	0.0	1.9291280694015587
chr7	AC006019.1	154055582	154055925	0	344	204	2877	204	2533	0.0	0.08053691275167785
chr7	AC009403.2	155481879	155484013	0	2135	3581	7213	3581	5078	0.0	0.7051988972036235
chr7	CNPY1	155502013	155503105	1530	1093	1590	2741	60	1648	1.3998170173833486	0.03640776699029126
chr8	FAM87A	377563	380309	0	2747	1846	4628	1846	1881	0.0	0.9813928761297183
chr8	FAM87A	375947	379458	408	3512	1846	4628	1438	1116	0.11617312072892938	1.2885304659498207
chr8	TDRP	489802	492744	714	2943	750	3607	36	664	0.24260958205912334	0.05421686746987952
chr8	ERICH1	625674	627238	1161	1565	52206	9726	51045	8161	0.74185303514377	6.254748192623453
chr8	MCPH1-AS1	6620134	6621635	0	1502	52401	9929	52401	8427	0.0	6.218227127091492
chr8	MIR124-1HG	9900554	9903398	0	2845	0	4885	0	2040	0.0	0.0
chr8	MIR124-1HG	9900544	9903398	0	2855	0	4885	0	2030	0.0	0.0
chr8	PRSS51	10497711	10497971	0	261	0	3044	0	2783	0.0	0.0
chr8	FAM86B1	12186351	12186833	0	483	0	4142	0	3659	0.0	0.0
chr8	ASAH1	18056834	18057623	0	790	6243	9281	6243	8491	0.0	0.735249087268873
chr8	TNFRSF10B	23028330	23028602	51	273	12852	4954	12801	4681	0.18681318681318682	2.7346720786156804
chr8	CLU	27604923	27605335	0	413	25263	5788	25263	5375	0.0	4.700093023255814
chr8	ANK1	41672353	41672912	0	560	68560	10404	68560	9844	0.0	6.964648516863064
chr8	AC083973.1	42265614	42266396	0	783	139966	2277	139966	1494	0.0	93.68540829986613
chr8	RPS20	56074059	56074506	0	448	0	6105	0	5657	0.0	0.0
chr8	AC092819.1	58258525	58260024	0	1500	0	2277	0	777	0.0	0.0
chr8	LINC01592	68881958	68882380	0	423	0	3717	0	3294	0.0	0.0
chr8	AC111149.1	73368378	73369355	0	978	0	1738	0	760	0.0	0.0
chr8	ZFAND1	81714803	81715114	0	312	970	2569	970	2257	0.0	0.42977403633141337
chr8	SNX16	81839611	81840082	0	472	0	4619	0	4147	0.0	0.0
chr8	AC103760.1	86335702	86338387	0	2686	51	3962	51	1276	0.0	0.039968652037617555
chr8	RNF19A	100287906	100288267	0	362	0	5281	0	4919	0.0	0.0
chr8	PABPC1	100721390	100722087	0	698	51	8827	51	8129	0.0	0.006273834419977857
chr8	PABPC1	100721390	100721886	0	497	51	8827	51	8330	0.0	0.006122448979591836
chr8	AP003471.1	104419511	104421500	53647	1990	53647	1990	0	0	26.958291457286432	0.0
chr8	EIF3E	108201742	108203117	0	1376	51	27596	51	26220	0.0	0.0019450800915331808
chr8	LINC01608	111027305	111027599	0	295	0	12963	0	12668	0.0	0.0
chr8	LINC01608	111027305	111027593	0	289	0	12963	0	12674	0.0	0.0
chr8	TRPS1	115603872	115605002	0	1131	102	11061	102	9930	0.0	0.01027190332326284
chr8	FAM83A-AS1	123201171	123201982	0	812	0	2531	0	1719	0.0	0.0
chr8	FER1L6-AS2	124058787	124060792	0	2006	51	4623	51	2617	0.0	0.019487963316774933
chr8	CASC19	127168358	127169117	0	760	51	18096	51	17336	0.0	0.0029418550992155053
chr8	CASC19	127168421	127169117	0	697	51	18096	51	17399	0.0	0.0029312029426978563
chr8	CYRIB	129849242	129849369	0	128	82	7461	82	7333	0.0	0.011182326469384971
chr8	CYRIB	129854265	129854343	0	79	82	7461	82	7382	0.0	0.011108100785694934
chr8	CYRIB	129855610	129855747	0	138	82	7461	82	7323	0.0	0.011197596613409804
chr8	ST3GAL1	133475718	133476600	0	883	0	8868	0	7985	0.0	0.0
chr8	MROH5	141447906	141448088	0	183	2018	4795	2018	4612	0.0	0.4375542064180399
chr8	JRK	142657459	142666520	0	9062	0	6936	0	-2126	0.0	-0.0
chr8	NAPRT	143574784	143575093	0	310	0	2597	0	2287	0.0	0.0
chr8	NAPRT	143574784	143575345	0	562	0	2597	0	2035	0.0	0.0
chr8	NAPRT	143574786	143575093	0	308	0	2597	0	2289	0.0	0.0
chr8	GFUS	143612617	143613295	0	679	0	3184	0	2505	0.0	0.0
chr8	SCRIB	143792484	143792867	2652	384	163329	6452	160677	6068	6.90625	26.479400131839157
chr8	PARP10	143986054	143986460	0	407	0	5815	0	5408	0.0	0.0
chr8	VPS28	144423616	144424132	0	517	51	3187	51	2670	0.0	0.019101123595505618
chr8	VPS28	144424214	144424819	0	606	51	3187	51	2581	0.0	0.0197597830298334
chr8	VPS28	144424945	144425772	51	828	51	3187	0	2359	0.06159420289855073	0.0
chr8	TONSL	144438652	144438735	0	84	1686	5753	1686	5669	0.0	0.29740695007937906
chr8	TONSL	144440350	144440476	0	127	1686	5753	1686	5626	0.0	0.2996800568787771
chr8	TONSL	144440965	144441111	0	147	1686	5753	1686	5606	0.0	0.3007491972886193
chr8	RPL8	144791276	144791495	408	220	408	1672	0	1452	1.8545454545454545	0.0
chr8	AC114550.1	8569186	8569816	0	631	1442	2470	1442	1839	0.0	0.7841218053289831
chr8	ERI1	9029791	9033338	0	3548	5222	6398	5222	2850	0.0	1.832280701754386
chr8	AC022784.1	9189045	9189586	0	542	17392	16960	17392	16418	0.0	1.0593251309538312
chr8	AC022784.1	9325901	9326303	0	403	17392	16960	17392	16557	0.0	1.0504318415171832
chr8	NEIL2	11769709	11770335	102	627	294	3371	192	2744	0.16267942583732056	0.06997084548104957
chr8	FAM66D	12145422	12145700	0	279	0	7125	0	6846	0.0	0.0
chr8	VPS37A	17280238	17280443	0	206	51	5710	51	5504	0.0	0.009265988372093024
chr8	NPM2	22024723	22025306	0	584	16819	1896	16819	1312	0.0	12.819359756097562
chr8	PDLIM2	22585016	22585162	0	147	102	7319	102	7172	0.0	0.01422197434467373
chr8	C8ORF58	22601971	22602312	0	342	0	3102	0	2760	0.0	0.0
chr8	CCAR2	22618826	22619015	0	190	0	6444	0	6254	0.0	0.0
chr8	CCAR2	22619149	22620468	0	1320	0	6444	0	5124	0.0	0.0
chr8	R3HCC1	23289865	23290469	75656	605	238342	2235	162686	1630	125.05123966942149	99.80736196319019
chr8	CDCA2	25460239	25460554	0	316	45	3713	45	3397	0.0	0.013246982631733883
chr8	ERLIN2	37744570	37746550	102	1981	10706	8103	10604	6122	0.05148914689550732	1.7321136883371446
chr8	PLPBP	37765525	37765746	0	222	51	2899	51	2677	0.0	0.01905117669032499
chr8	ADAM9	39090046	39091346	0	1301	23735	17281	23735	15980	0.0	1.4852941176470589
chr8	GINS4	41541808	41545030	17360	3223	27369	5344	10009	2121	5.386286068879926	4.719000471475719
chr8	GPAT4	41598291	41599304	0	1014	10546	7612	10546	6598	0.0	1.5983631403455592
chr8	FNTA	43085159	43085780	0	622	300022	8702	300022	8080	0.0	37.13143564356436
chr8	POMK	43122106	43125767	26344	3662	26862	8233	518	4571	7.1938831239759695	0.11332312404287902
chr8	LINC00293	46848783	46849530	0	748	102	8452	102	7704	0.0	0.0132398753894081
chr8	LINC00293	46854469	46854791	0	323	102	8452	102	8129	0.0	0.012547668839955714
chr8	LINC00293	46854763	46855410	88	648	102	8452	14	7804	0.13580246913580246	0.0017939518195797027
chr8	RP1	54558759	54559320	0	562	504356	15745	504356	15183	0.0	33.21846802344728
chr8	RP1	54679419	54679627	0	209	504356	15745	504356	15536	0.0	32.463697219361485
chr8	AC011124.2	63467141	63469946	0	2806	0	5553	0	2747	0.0	0.0
chr8	LINC01289	63778448	63780922	357	2475	38382	4462	38025	1987	0.14424242424242426	19.136889783593357
chr8	ADHFE1	66453709	66454157	0	449	51	3221	51	2772	0.0	0.0183982683982684
chr8	MCMDC2	66874325	66874586	0	262	0	6364	0	6102	0.0	0.0
chr8	GDAP1	74351273	74351466	0	194	21694	20769	21694	20575	0.0	1.0543863912515188
chr8	GDAP1	74361883	74366582	1020	4700	21694	20769	20674	16069	0.2170212765957447	1.2865766382475574
chr8	GDAP1	74361883	74363053	0	1171	21694	20769	21694	19598	0.0	1.1069496887437493
chr8	ZBTB10	80518402	80518579	0	178	51	10129	51	9951	0.0	0.0051251130539644255
chr8	AC100801.1	85885934	85889653	0	3720	0	4745	0	1025	0.0	0.0
chr8	INTS8	94867139	94867337	0	199	8392	7694	8392	7495	0.0	1.1196797865243495
chr8	GRHL2	101492438	101492789	0	352	2016	6069	2016	5717	0.0	0.3526324995627077
chr8	FZD6	103299955	103300284	296	330	7042	4072	6746	3742	0.896969696969697	1.80277926242651
chr8	AC103993.1	113615503	113616958	0	1456	0	1586	0	130	0.0	0.0
chr8	COL14A1	120270034	120270174	0	141	14	10245	14	10104	0.0	0.0013855898653998416
chr8	LINC00964	124849274	124849953	0	680	348	10517	348	9837	0.0	0.03537663921927417
chr8	LINC00964	124943269	124945051	102	1783	348	10517	246	8734	0.05720695457094784	0.028165788871078543
chr8	LINC00964	124943269	124945746	102	2478	348	10517	246	8039	0.04116222760290557	0.030600820997636523
chr8	PVT1	127795195	127796071	51	877	30944	23370	30893	22493	0.05815279361459521	1.3734495176277064
chr8	PVT1	127854395	127855319	0	925	30944	23370	30944	22445	0.0	1.3786589440855423
chr8	PVT1	128049408	128049748	0	341	30944	23370	30944	23029	0.0	1.3436970775978114
chr8	PTP4A3	141421387	141422345	0	959	0	2881	0	1922	0.0	0.0
chr8	THEM6	142735325	142736927	0	1603	0	2125	0	522	0.0	0.0
chr8	GRINA	143991877	143992373	0	497	0	2462	0	1965	0.0	0.0
chr8	MAF1	144106342	144106674	0	333	2166	2299	2166	1966	0.0	1.1017293997965412
chr8	WDR97	144111100	144111486	0	387	6545	7698	6545	7311	0.0	0.8952263712214471
chr8	MROH1	144261113	144261349	0	237	0	10950	0	10713	0.0	0.0
chr8	SLC52A2	144359622	144360493	0	872	156854	3711	156854	2839	0.0	55.2497358224727
chr8	SLC52A2	144358594	144359423	109710	830	156854	3711	47144	2881	132.18072289156626	16.363762582436653
chr8	ADCK5	144391579	144391866	47913	288	126504	2760	78591	2472	166.36458333333334	31.79247572815534
chr8	KIFC2	144472794	144474202	0	1409	1473	4038	1473	2629	0.0	0.5602890833016356
chr9	DMRT2	1051613	1052138	0	526	0	3147	0	2621	0.0	0.0
chr9	LINC01231	3198185	3198924	0	740	0	5272	0	4532	0.0	0.0
chr9	CD274	5462833	5463121	24477	289	99950	4115	75473	3826	84.6955017301038	19.726346053319393
chr9	PTENP1-AS	33678089	33681073	459	2985	918	4826	459	1841	0.15376884422110554	0.24932102118413904
chr9	CNTFR-AS1	34569511	34571022	50	1512	131	2607	81	1095	0.03306878306878307	0.07397260273972603
chr9	ATP8B5P	35438728	35440453	918	1726	41844	6309	40926	4583	0.5318655851680185	8.92995854243945
chr9	TMEM8B	35829227	35829955	22244	729	221485	16232	199241	15503	30.513031550068586	12.851770625040315
chr9	AL353608.3	68326262	68328690	51	2429	51	5290	0	2861	0.02099629477151091	0.0
chr9	TJP2	69252814	69255187	816	2374	28876	10925	28060	8551	0.34372367312552654	3.2814875453163372
chr9	FAM189A2	69377369	69377744	0	376	0	5150	0	4774	0.0	0.0
chr9	PCA3	76783704	76785677	153	1974	510	12897	357	10923	0.07750759878419453	0.03268332875583631
chr9	AL354733.2	83858863	83859335	0	473	0	3124	0	2651	0.0	0.0
chr9	CTSL	87729572	87731327	0	1756	0	5954	0	4198	0.0	0.0
chr9	CTSL	87730380	87731348	0	969	0	5954	0	4985	0.0	0.0
chr9	CTSL	87730380	87731320	0	941	0	5954	0	5013	0.0	0.0
chr9	CTSL	87729572	87731348	0	1777	0	5954	0	4177	0.0	0.0
chr9	CTSL	87726212	87727729	0	1518	0	5954	0	4436	0.0	0.0
chr9	CTSL	87729572	87730498	0	927	0	5954	0	5027	0.0	0.0
chr9	AL355607.2	91000769	91001901	4836	1133	6111	1533	1275	400	4.268314210061783	3.1875
chr9	FGD3	93032768	93034681	0	1914	0	4169	0	2255	0.0	0.0
chr9	CARD19	93110567	93112289	0	1723	0	1748	0	25	0.0	0.0
chr9	AL589843.1	96687076	96687324	0	249	51	2839	51	2590	0.0	0.019691119691119693
chr9	STRA6LP	97362195	97362441	0	247	706	7167	706	6920	0.0	0.10202312138728324
chr9	STRA6LP	97307735	97308132	0	398	706	7167	706	6769	0.0	0.10429901019352933
chr9	INVS	100292325	100293043	102	719	1032	7153	930	6434	0.14186369958275383	0.14454460677649986
chr9	SLC44A1	105389032	105397346	0	8315	48	5806	48	-2509	0.0	-0.019131127939418093
chr9	RGS3	113583449	113584427	0	979	858	11098	858	10119	0.0	0.08479098725170471
chr9	RABEPK	125200541	125200906	0	366	0	3438	0	3072	0.0	0.0
chr9	GAPVD1	125331925	125332060	0	136	467	13657	467	13521	0.0	0.03453886546853043
chr9	LRSAM1	127460876	127461257	462	382	17882	8123	17420	7741	1.2094240837696335	2.2503552512595273
chr9	LRSAM1	127451514	127452084	0	571	17882	8123	17882	7552	0.0	2.3678495762711864
chr9	LRSAM1	127487494	127487763	4022	270	17882	8123	13860	7853	14.896296296296295	1.7649305997707883
chr9	STXBP1	127694993	127696027	228	1035	109863	8749	109635	7714	0.22028985507246376	14.212470832253047
chr9	CERCAM	128428929	128429036	0	108	8414	5550	8414	5442	0.0	1.546122748989342
chr9	PHYHD1	128941444	128942038	0	595	0	2479	0	1884	0.0	0.0
chr9	USP20	129880112	129881828	51	1717	127	5449	76	3732	0.0297029702970297	0.020364415862808145
chr9	NUP214	131233453	131233704	99246	252	263360	12057	164114	11805	393.8333333333333	13.902075391783143
chr9	POMT1	131522931	131523799	204	869	54510	6345	54306	5476	0.23475258918296893	9.91709276844412
chr9	POMT1	131509742	131510415	2100	674	54510	6345	52410	5671	3.115727002967359	9.241756304002822
chr9	POMT1	131509902	131510415	597	514	54510	6345	53913	5831	1.16147859922179	9.245926942205454
chr9	POMT1	131511336	131512136	350	801	54510	6345	54160	5544	0.4369538077403246	9.769119769119769
chr9	POMT1	131504188	131504649	1326	462	54510	6345	53184	5883	2.8701298701298703	9.040285568587455
chr9	PMPCA	136421831	136423760	0	1930	0	6212	0	4282	0.0	0.0
chr9	CCDC183	136806503	136806867	69	365	2310	2690	2241	2325	0.18904109589041096	0.9638709677419355
chr9	MAMDC4	136857978	136858546	42	569	42002	5342	41960	4773	0.07381370826010544	8.791116698093441
chr9	MAMDC4	136858718	136859132	1124	415	42002	5342	40878	4927	2.708433734939759	8.296732291455246
chr9	MAMDC4	136859208	136860064	1632	857	42002	5342	40370	4485	1.9043173862310385	9.001114827201784
chr9	ARRDC1	137612895	137613510	102	616	1137	2585	1035	1969	0.16558441558441558	0.5256475368207212
chr9	EHMT1	137817438	137818138	0	701	49991	18118	49991	17417	0.0	2.870241717861859
chr9	CBWD1	121088	122090	27281	1003	126699	10402	99418	9399	27.19940179461615	10.577508245558038
chr9	APTX	32973375	32974561	92859	1187	512100	14598	419241	13411	78.22999157540016	31.260979792707477
chr9	FAM219A	34398183	34401122	446551	2940	537607	3788	91056	848	151.88809523809525	107.37735849056604
chr9	VCP	35062002	35062350	332505	349	5212149	8455	4879644	8106	952.7363896848137	601.979274611399
chr9	FANCG	35079440	35079942	20333	503	959169	2822	938836	2319	40.4234592445328	404.84519189305735
chr9	PIGO	35091239	35092767	261538	1529	837939	4627	576401	3098	171.05166775670372	186.05584247901874
chr9	STOML2	35100597	35101011	447107	415	2225602	1815	1778495	1400	1077.366265060241	1270.3535714285715
chr9	FAM214B	35107380	35108349	33427	970	615439	3855	582012	2885	34.46082474226804	201.73726169844022
chr9	FAM166B	35562379	35562528	1015	150	7890	1154	6875	1004	6.766666666666667	6.847609561752988
chr9	CD72	35615942	35616689	10762	748	50728	2901	39966	2153	14.38770053475936	18.562935438922434
chr9	ARHGEF39	35660093	35662002	435906	1910	655104	5665	219198	3755	228.22303664921466	58.37496671105193
chr9	GBA2	35736866	35737939	220199	1074	798815	4739	578616	3665	205.02700186219738	157.87612551159617
chr9	SPAG8	35809403	35810309	84268	907	101098	2480	16830	1573	92.90848952590959	10.6993006993007
chr9	SPAG8	35810438	35810682	1409	245	101098	2480	99689	2235	5.751020408163265	44.603579418344516
chr9	EXOSC3	37780274	37780880	246261	607	636576	6782	390315	6175	405.7018121911038	63.208906882591094
chr9	FAM95C	38540568	38541562	33073	995	137254	3767	104181	2772	33.2391959798995	37.583333333333336
chr9	FAM95C	38542311	38543055	47345	745	137254	3767	89909	3022	63.5503355704698	29.751489080079416
chr9	BX255923.2	41102730	41105159	408	2430	408	4157	0	1727	0.16790123456790124	0.0
chr9	AL845472.1	41269915	41273997	0	4083	0	4083	0	0	0.0	0.0
chr9	MAMDC2-AS1	70153133	70154241	0	1109	5519	9867	5519	8758	0.0	0.6301667047271067
chr9	NMRK1	75068995	75070042	0	1048	204	3129	204	2081	0.0	0.0980297933685728
chr9	AL353743.2	85785993	85786551	0	559	255	7271	255	6712	0.0	0.03799165673420739
chr9	AL353743.2	85786002	85786551	0	550	255	7271	255	6721	0.0	0.03794078262163369
chr9	AL353743.2	85786004	85786551	0	548	255	7271	255	6723	0.0	0.03792949576082106
chr9	LINC02843	88646920	88647660	1664	741	6570	1616	4906	875	2.245614035087719	5.606857142857143
chr9	BICD2	92711362	92715463	0	4102	0	6455	0	2353	0.0	0.0
chr9	NUTM2F	94320207	94320593	0	387	0	2568	0	2181	0.0	0.0
chr9	PTCH1	95449840	95453620	204	3781	103303	17222	103099	13441	0.05395398042845808	7.6704858269474
chr9	PTCH1	95443411	95447451	255	4041	103303	17222	103048	13181	0.06310319227913883	7.817919732948941
chr9	HSD17B3	96249909	96250485	0	577	262	2354	262	1777	0.0	0.14743950478334272
chr9	PTCSC2	97805361	97806024	0	664	1348	2293	1348	1629	0.0	0.8275015346838551
chr9	TRMO	97909959	97910616	0	658	15565	4155	15565	3497	0.0	4.450957963969117
chr9	ALDOB	101424842	101425042	0	201	0	2838	0	2637	0.0	0.0
chr9	ELP1	108917546	108919349	0	1804	379	16260	379	14456	0.0	0.0262174875484228
chr9	RNF183	113301671	113302313	0	643	0	2891	0	2248	0.0	0.0
chr9	KIF12	114093228	114093497	51	270	51	2858	0	2588	0.18888888888888888	0.0
chr9	ASTN2	116425227	116426088	0	862	49233	8314	49233	7452	0.0	6.606682769726248
chr9	RC3H2	122865348	122865657	0	310	102	11585	102	11275	0.0	0.009046563192904656
chr9	AL157935.2	127885185	127886788	2601	1604	5095	3832	2494	2228	1.621571072319202	1.1193895870736086
chr9	PTGES2	128125243	128125441	15460	199	118958	4049	103498	3850	77.68844221105527	26.8825974025974
chr9	CIZ1	128178708	128179415	0	708	42315	7924	42315	7216	0.0	5.864052106430155
chr9	TSC1	132897183	132897610	96200	428	755473	16580	659273	16152	224.7663551401869	40.81680287270926
chr9	GBGT1	133152952	133155312	0	2361	0	4024	0	1663	0.0	0.0
chr9	ABO	133257408	133257542	0	135	0	1706	0	1571	0.0	0.0
chr9	SARDH	133666734	133666870	73	137	66292	5142	66219	5005	0.5328467153284672	13.23056943056943
chr9	SOHLH1	135693406	135694457	0	1052	628	3499	628	2447	0.0	0.256640784634246
chr9	TMEM250	136114588	136117024	0	2437	51	3403	51	966	0.0	0.052795031055900624
chr9	SNHG7	136724657	136725110	1869	454	15951	3819	14082	3365	4.116740088105727	4.184843982169391
chr9	SNHG7	136726310	136727086	12876	777	15951	3819	3075	3042	16.571428571428573	1.0108481262327416
chr9	ABCA2	137010192	137010737	1115	546	786526	10294	785411	9748	2.042124542124542	80.57150184653263
chr9	ABCA2	137011406	137011749	459	344	786526	10294	786067	9950	1.3343023255813953	79.00170854271357
chr9	FAM166A	137245306	137245853	51	548	51	1454	0	906	0.09306569343065693	0.0
chr9	NSMF	137448224	137449491	0	1268	51	3951	51	2683	0.0	0.01900857249347745
chr10	TUBB8	48614	48912	0	299	0	2879	0	2580	0.0	0.0
chr10	PITRM1	3143388	3143731	198307	344	1624774	11641	1426467	11297	576.4738372093024	126.26954058599628
chr10	LINC02669	3502330	3502851	0	522	1233	6362	1233	5840	0.0	0.21113013698630137
chr10	LINC02669	3502330	3502866	0	537	1233	6362	1233	5825	0.0	0.21167381974248928
chr10	KLF6	3775995	3779590	0	3596	29	4846	29	1250	0.0	0.0232
chr10	ASB13	5638866	5640830	102	1965	102	3010	0	1045	0.051908396946564885	0.0
chr10	LINC00710	10946785	10947556	0	772	0	6504	0	5732	0.0	0.0
chr10	LINC00710	10946785	10947319	0	535	0	6504	0	5969	0.0	0.0
chr10	LINC00710	10934523	10935413	0	891	0	6504	0	5613	0.0	0.0
chr10	LINC00710	10946785	10948403	0	1619	0	6504	0	4885	0.0	0.0
chr10	LINC00710	10946064	10946600	0	537	0	6504	0	5967	0.0	0.0
chr10	NUDT5	12170716	12170908	1530	193	38616	4491	37086	4298	7.927461139896373	8.628664495114007
chr10	ACBD5	27240318	27240797	0	480	1481	11777	1481	11297	0.0	0.1310967513499159
chr10	MTPAP	30365148	30365565	51	418	570	8335	519	7917	0.12200956937799043	0.06555513452065176
chr10	MTPAP	30365344	30365565	0	222	570	8335	570	8113	0.0	0.0702576112412178
chr10	ZNF438	30848530	30850367	0	1838	0	4283	0	2445	0.0	0.0
chr10	ITGB1	32932514	32933583	0	1070	3849	12473	3849	11403	0.0	0.3375427519073928
chr10	ZNF248	37828764	37833116	1224	4353	1173	6037	-51	1684	0.2811853893866299	-0.030285035629453682
chr10	ZWINT	56357437	56358459	0	1023	0	2184	0	1161	0.0	0.0
chr10	ZWINT	56360017	56360383	0	367	0	2184	0	1817	0.0	0.0
chr10	ANK3	60059339	60060006	1587	668	54213	22486	52626	21818	2.375748502994012	2.4120451003758365
chr10	ANK3	60138516	60139087	0	572	54213	22486	54213	21914	0.0	2.4738979647713792
chr10	EGR2	62815860	62816366	13	507	13	3602	0	3095	0.02564102564102564	0.0
chr10	DNAJB12	72332829	72335931	1734	3103	2359	5577	625	2474	0.558814050918466	0.2526273241713824
chr10	FAM245A	87396563	87398200	0	1638	0	2032	0	394	0.0	0.0
chr10	IDE	92479276	92480916	0	1641	199	14554	199	12913	0.0	0.015410826299078449
chr10	PLCE1-AS2	94105574	94106159	1683	586	53606	4224	51923	3638	2.872013651877133	14.27240241891149
chr10	ERLIN1	100185513	100186029	32050	517	34007	3502	1957	2985	61.992263056092845	0.6556113902847571
chr10	SEC31B	100505360	100506201	0	842	51	7409	51	6567	0.0	0.0077661032434901784
chr10	PDZD7	101021797	101022385	0	589	408	6620	408	6031	0.0	0.06765047255844801
chr10	PDZD7	101023435	101024068	0	634	408	6620	408	5986	0.0	0.0681590377547611
chr10	POLL	101584601	101584919	549	319	6760	5429	6211	5110	1.7210031347962382	1.2154598825831702
chr10	NT5C2	103097290	103098984	0	1695	4866	8572	4866	6877	0.0	0.707575977897339
chr10	C10ORF120	122697708	122698488	0	781	0	1091	0	310	0.0	0.0
chr10	IDI2-AS1	1035813	1036893	0	1081	41195	3053	41195	1972	0.0	20.88995943204868
chr10	PRKCQ-AS1	6583804	6584195	0	392	102	5311	102	4919	0.0	0.020735921935352713
chr10	CELF2	11328925	11334358	0	5434	0	9833	0	4399	0.0	0.0
chr10	AL157392.3	13654352	13655482	0	1131	14329	9029	14329	7898	0.0	1.8142567738668016
chr10	LINC02654	16278070	16278749	0	680	0	2554	0	1874	0.0	0.0
chr10	VIM	17235845	17236379	0	535	5885	4730	5885	4195	0.0	1.402860548271752
chr10	VIM	17235168	17236379	0	1212	5885	4730	5885	3518	0.0	1.6728254690164865
chr10	KIAA1217	24544980	24547843	612	2864	802	10748	190	7884	0.21368715083798884	0.024099441907661084
chr10	GAD2	26300787	26304558	0	3772	34	2871	34	-901	0.0	-0.03773584905660377
chr10	AL133216.2	38416681	38417204	1581	524	28530	7231	26949	6707	3.017175572519084	4.018040852840316
chr10	LINC00840	43859526	43860360	51	835	28801	7297	28750	6462	0.06107784431137724	4.449086969978335
chr10	ANTXRL	46286997	46287510	765	514	867	2961	102	2447	1.4883268482490273	0.04168369431957499
chr10	C10ORF53	49708360	49710261	0	1902	0	5807	0	3905	0.0	0.0
chr10	LINC01515	65585484	65585802	0	319	419	17753	419	17434	0.0	0.024033497762991855
chr10	DDX50	68906710	68907007	0	298	459	2690	459	2392	0.0	0.19188963210702342
chr10	DDX50	68946351	68946847	0	497	459	2690	459	2193	0.0	0.20930232558139536
chr10	SEC24C	73770279	73770798	52733	520	320641	5320	267908	4800	101.40961538461538	55.814166666666665
chr10	ZSWIM8	73791858	73792852	0	995	1000	7868	1000	6873	0.0	0.14549687181725593
chr10	SAMD8	75176065	75182123	420735	6059	420735	7145	0	1086	69.43967651427629	0.0
chr10	ZNF503-AS1	75358509	75359049	0	541	19920	5296	19920	4755	0.0	4.1892744479495265
chr10	CDHR1	84219078	84219621	0	544	51	7747	51	7203	0.0	0.007080383173677634
chr10	LCOR	96949007	96952196	0	3190	913	26377	913	23187	0.0	0.039375512140423514
chr10	LCOR	96954952	96958877	255	3926	913	26377	658	22451	0.06495160468670402	0.029308271346487908
chr10	LCOR	96954952	96958926	255	3975	913	26377	658	22402	0.06415094339622641	0.02937237746629765
chr10	OLMALINC	100381215	100383372	0	2158	0	12654	0	10496	0.0	0.0
chr10	TWNK	100989643	100989884	0	242	0	3960	0	3718	0.0	0.0
chr10	GBF1	102375358	102375584	0	227	12004	19267	12004	19040	0.0	0.6304621848739496
chr10	GBF1	102382055	102382899	0	845	12004	19267	12004	18422	0.0	0.6516122028009989
chr10	RPARP-AS1	102451398	102452187	0	790	0	4289	0	3499	0.0	0.0
chr10	AS3MT	102890543	102890678	0	136	0	1787	0	1651	0.0	0.0
chr10	PNLIPRP2	116638368	116638480	0	113	7928	1588	7928	1475	0.0	5.374915254237288
chr10	LINC00867	118357526	118357848	0	323	0	4160	0	3837	0.0	0.0
chr10	WDR11	120905875	120906855	100	981	11519	7675	11419	6694	0.1019367991845056	1.7058559904391992
chr10	LINC02641	123361318	123362147	1173	830	1377	5335	204	4505	1.4132530120481928	0.045283018867924525
chr10	AL158835.1	125706581	125707004	0	424	153	4566	153	4142	0.0	0.03693867696764848
chr10	EDRF1	125763300	125764143	0	844	0	7630	0	6786	0.0	0.0
chr10	LINC02667	128914758	128915165	0	408	0	1874	0	1466	0.0	0.0
chr10	PPP2R2D	131943967	131944145	0	179	270342	7403	270342	7224	0.0	37.42275747508306
chr10	SCART1	133459486	133460170	0	685	0	7075	0	6390	0.0	0.0
chr11	PSMD13	244040	244216	52067	177	941344	2848	889277	2671	294.1638418079096	332.9378509921378
chr11	PGGHG	290677	291113	4975	437	79852	5133	74877	4696	11.384439359267734	15.94484667802385
chr11	PKP3	394242	394524	102	283	53186	3762	53084	3479	0.36042402826855124	15.258407588387467
chr11	PTDSS2	490419	491399	132166	981	505397	5471	373231	4490	134.7257900101937	83.1249443207127
chr11	RASSF7	563188	563478	15553	291	117621	2441	102068	2150	53.446735395189	47.47348837209302
chr11	EPS8L2	709552	710486	2836	935	52484	4588	49648	3653	3.033155080213904	13.591021078565563
chr11	CRACR2B	828229	828772	8	544	34138	3193	34130	2649	0.014705882352941176	12.884107210268025
chr11	CD151	838132	838831	612334	700	1920102	3539	1307768	2839	874.7628571428571	460.64388869320186
chr11	FAM99A	1666701	1667856	0	1156	0	1435	0	279	0.0	0.0
chr11	MRPL23	1956255	1956609	0	355	357	2986	357	2631	0.0	0.13568985176738882
chr11	TSSC2	3406498	3407697	2039	1200	7071	3680	5032	2480	1.6991666666666667	2.029032258064516
chr11	OR51E1	4652487	4655488	102	3002	102	3614	0	612	0.03397734843437708	0.0
chr11	OR51L1	5002570	5005536	0	2967	0	3556	0	589	0.0	0.0
chr11	TRIM6	5603245	5603735	0	491	50	3973	50	3482	0.0	0.014359563469270534
chr11	TRIM22	5698314	5698545	759	232	3264	4986	2505	4754	3.271551724137931	0.5269246949936895
chr11	CCKBR	6270645	6272127	0	1483	0	2398	0	915	0.0	0.0
chr11	DNHD1	6497584	6498961	104225	1378	213785	18420	109560	17042	75.63497822931785	6.428822908109376
chr11	DNHD1	6547862	6548402	413	541	213785	18420	213372	17879	0.7634011090573013	11.934224509200739
chr11	ILK	6608693	6608967	0	275	3335	3225	3335	2950	0.0	1.1305084745762712
chr11	OR2AG1	6785017	6791558	0	6542	0	6995	0	453	0.0	0.0
chr11	PPFIBP2	7653023	7653756	0	734	0	8897	0	8163	0.0	0.0
chr11	AKIP1	8911188	8911671	0	484	4539	2242	4539	1758	0.0	2.5819112627986347
chr11	SBF2-AS1	9807847	9811335	14686	3489	15880	4738	1194	1249	4.209229005445686	0.955964771817454
chr11	ADM	10305679	10306098	0	420	0	2167	0	1747	0.0	0.0
chr11	LINC02752	11182326	11183251	0	926	0	2017	0	1091	0.0	0.0
chr11	LDHAL6A	18476383	18476501	0	119	0	2594	0	2475	0.0	0.0
chr11	BDNF-AS	27675296	27676140	1990	845	113219	12372	111229	11527	2.3550295857988166	9.64943176889043
chr11	EIF3M	32593865	32595013	0	1149	151936	7442	151936	6293	0.0	24.143651676465915
chr11	QSER1	32931742	32935435	1377	3694	46805	10924	45428	7230	0.3727666486193828	6.2832641770401105
chr11	NAT10	34143444	34143528	0	85	146787	5257	146787	5172	0.0	28.38109048723898
chr11	AC044839.1	45723319	45723572	0	254	0	6744	0	6490	0.0	0.0
chr11	SLC35C1	45805148	45806336	0	1189	0	3372	0	2183	0.0	0.0
chr11	LARGE2	45922820	45923167	204	348	108068	2871	107864	2523	0.5862068965517241	42.75227903289734
chr11	DGKZ	46374603	46374839	42	237	18415	8820	18373	8583	0.17721518987341772	2.140626820459047
chr11	MDK	46381710	46382133	4849	424	16293	2201	11444	1777	11.43632075471698	6.440067529544176
chr11	ATG13	46668498	46668910	0	413	7415	5435	7415	5022	0.0	1.4765033851055356
chr11	C11ORF49	47161126	47162247	5156	1122	9217	5413	4061	4291	4.595365418894831	0.9463994406898159
chr11	NR1H3	47261546	47262018	79902	473	337523	4063	257621	3590	168.92600422832982	71.76072423398328
chr11	NDUFS3	47580524	47580984	1507	461	6233	4322	4726	3861	3.2689804772234274	1.2240352240352241
chr11	TMX2	57738663	57739039	0	377	0	2143	0	1766	0.0	0.0
chr11	SELENOH	57741808	57741954	0	147	0	1851	0	1704	0.0	0.0
chr11	FAM111A	59143496	59145856	51	2361	153	6384	102	4023	0.021601016518424398	0.02535421327367636
chr11	MS4A1	60462184	60462533	0	350	0	4614	0	4264	0.0	0.0
chr11	TMEM132A	60935863	60937159	0	1297	6731	5092	6731	3795	0.0	1.7736495388669302
chr11	TMEM138	61364251	61364518	0	268	51	4888	51	4620	0.0	0.01103896103896104
chr11	POLR2G	62761794	62762866	0	1073	0	1552	0	479	0.0	0.0
chr11	NUDT22	64226289	64227132	0	844	0	3038	0	2194	0.0	0.0
chr11	DNAJC4	64233893	64234281	0	389	51	2070	51	1681	0.0	0.030339083878643664
chr11	ARL2	65021720	65022184	0	465	0	1837	0	1372	0.0	0.0
chr11	VPS51	65107580	65108022	81935	443	222656	4595	140721	4152	184.9548532731377	33.892341040462426
chr11	MRPL49	65125725	65127363	0	1639	4682	2385	4682	746	0.0	6.2761394101876675
chr11	SCYL1	65538269	65538704	510	436	4220	3914	3710	3478	1.1697247706422018	1.0667050028752156
chr11	SIPA1	65646455	65647065	204	611	69636	4641	69432	4030	0.33387888707037644	17.2287841191067
chr11	RELA-DT	65663426	65665543	502497	2118	575044	3732	72547	1614	237.25070821529744	44.94857496902107
chr11	MUS81	65865810	65866439	1326	630	3891	4721	2565	4091	2.104761904761905	0.6269860669762894
chr11	CTSW	65883214	65883741	597	528	3177	1700	2580	1172	1.1306818181818181	2.2013651877133107
chr11	KLC2	66266432	66267859	825	1428	41538	3969	40713	2541	0.5777310924369747	16.022432113341203
chr11	BBS1	66531655	66532219	275	565	46904	5850	46629	5285	0.48672566371681414	8.822894985808894
chr11	BBS1	66515692	66515933	1644	242	46904	5850	45260	5608	6.793388429752066	8.070613409415122
chr11	SSH3	67306837	67307113	0	277	0	3237	0	2960	0.0	0.0
chr11	TBC1D10C	67409406	67410089	0	684	38	4302	38	3618	0.0	0.010503040353786623
chr11	CARNS1	67420608	67420840	0	233	51	5370	51	5137	0.0	0.009927973525403932
chr11	TCIRG1	68042945	68043497	4627	553	22032	4293	17405	3740	8.367088607594937	4.653743315508021
chr11	IGHMBP2	68936236	68937091	0	856	2932	8643	2932	7787	0.0	0.376524977526647
chr11	MYEOV	69295232	69297287	0	2056	0	3619	0	1563	0.0	0.0
chr11	ANO1	70187737	70189252	1377	1516	11966	6051	10589	4535	0.908311345646438	2.3349503858875416
chr11	IL18BP	71999227	71999662	1155	436	136972	3492	135817	3056	2.6490825688073394	44.44273560209424
chr11	FOLR3	72138960	72139149	0	190	11	1275	11	1085	0.0	0.010138248847926268
chr11	INPPL1	72228347	72228498	0	152	102	6501	102	6349	0.0	0.01606552212946921
chr11	INPPL1	72228726	72228847	0	122	102	6501	102	6379	0.0	0.015989967079479542
chr11	INPPL1	72237123	72237796	0	674	102	6501	102	5827	0.0	0.017504719409644758
chr11	RELT	73394235	73394734	459	500	13415	4843	12956	4343	0.918	2.983191342390053
chr11	MOGAT2	75727969	75728989	1383	1021	11865	3996	10482	2975	1.3545543584720863	3.523361344537815
chr11	RAB30-DT	83072622	83073604	0	983	225	6987	225	6004	0.0	0.03747501665556296
chr11	TMEM126B	85635666	85636536	0	871	102	2156	102	1285	0.0	0.07937743190661478
chr11	MED17	93807500	93809876	0	2377	0	8731	0	6354	0.0	0.0
chr11	LINC02700	94647334	94647578	2749	245	2800	3099	51	2854	11.220408163265306	0.017869656622284513
chr11	AP000787.1	95231124	95232176	0	1053	0	6723	0	5670	0.0	0.0
chr11	BIRC3	102321836	102325362	136774	3527	144378	7530	7604	4003	38.779132407144886	1.8995753185111166
chr11	BIRC2	102348597	102350749	0	2153	153	3556	153	1403	0.0	0.1090520313613685
chr11	DYNC2H1	103154450	103154809	0	360	1780	15101	1780	14741	0.0	0.12075164507156909
chr11	TTC12	113315950	113316315	0	366	46	4931	46	4565	0.0	0.010076670317634174
chr11	HTR3A	113986517	113987046	0	530	0	2686	0	2156	0.0	0.0
chr11	RNF214	117281893	117282270	14810	378	76777	4317	61967	3939	39.17989417989418	15.731657781162731
chr11	PHLDB1	118644071	118644691	0	621	202332	19655	202332	19034	0.0	10.630030471787327
chr11	VPS11	119081458	119081964	51	507	1016	4315	965	3808	0.10059171597633136	0.2534138655462185
chr11	HMBS	119092124	119092523	0	400	730	3568	730	3168	0.0	0.23042929292929293
chr11	PDZD3	119186091	119186690	51	600	78752	3455	78701	2855	0.085	27.56602451838879
chr11	PDZD3	119185474	119185952	76212	479	78752	3455	2540	2976	159.10647181628391	0.853494623655914
chr11	VWA5A	124115449	124116680	153	1232	153	6379	0	5147	0.1241883116883117	0.0
chr11	AP001993.1	127053337	127054334	0	998	0	9479	0	8481	0.0	0.0
chr11	HRAS	532241	532755	120338	515	300430	1889	180092	1374	233.66601941747572	131.07132459970887
chr11	IRF7	613784	614037	4227	254	121981	2356	117754	2102	16.641732283464567	56.01998097050428
chr11	IRF7	615096	615647	39467	552	121981	2356	82514	1804	71.4981884057971	45.73946784922395
chr11	PIDD1	802681	803647	46967	967	186579	4982	139612	4015	48.569803516028955	34.772602739726025
chr11	CHID1	869213	869956	47163	744	713739	4078	666576	3334	63.391129032258064	199.93281343731255
chr11	H19	1995175	1995998	204	824	937	2821	733	1997	0.24757281553398058	0.3670505758637957
chr11	H19	1995875	1996191	102	317	937	2821	835	2504	0.3217665615141956	0.3334664536741214
chr11	TRIM21	4384896	4385853	0	958	0	1942	0	984	0.0	0.0
chr11	TRIM3	6457695	6457847	0	153	10824	6639	10824	6486	0.0	1.6688251618871415
chr11	RRP8	6600925	6601602	416	678	2813	6926	2397	6248	0.6135693215339233	0.3836427656850192
chr11	TPP1	6619195	6619413	608	219	33334	5275	32726	5056	2.776255707762557	6.4727056962025316
chr11	TPP1	6618775	6619267	2394	493	33334	5275	30940	4782	4.855983772819473	6.470096194061062
chr11	DENND2B	8870953	8871367	51	415	290490	10617	290439	10202	0.12289156626506025	28.468829641246813
chr11	TMEM41B	9280653	9283593	2193	2941	8596	4285	6403	1344	0.7456647398843931	4.764136904761905
chr11	EIF4G2	10808704	10808940	0	237	51732	7294	51732	7057	0.0	7.330593736715318
chr11	ABCC8	17396915	17397313	22328	399	76870	9821	54542	9422	55.959899749373434	5.7887921884950115
chr11	ABCC8	17428288	17428670	0	383	76870	9821	76870	9438	0.0	8.144734053824964
chr11	ABCC8	17395851	17397313	42604	1463	76870	9821	34266	8358	29.120984278879014	4.099784637473079
chr11	ABCC8	17397192	17397797	21578	606	76870	9821	55292	9215	35.60726072607261	6.000217037438958
chr11	ABCC8	17396915	17397797	38320	883	76870	9821	38550	8938	43.397508493771234	4.313045424032222
chr11	ABCC8	17395851	17397797	58596	1947	76870	9821	18274	7874	30.09553158705701	2.320802641605283
chr11	ABCC8	17460487	17461825	0	1339	76870	9821	76870	8482	0.0	9.062721056354633
chr11	BDNF	27654892	27659658	0	4767	87154	7518	87154	2751	0.0	31.68084332969829
chr11	PAX6	31801229	31801776	0	548	77755	17695	77755	17147	0.0	4.534612468653409
chr11	PAX6	31803397	31803673	612	277	77755	17695	77143	17418	2.2093862815884475	4.428924101504191
chr11	LMO2	33869345	33869987	0	643	0	2903	0	2260	0.0	0.0
chr11	SLC1A2	35418949	35419558	39	610	12847629	13109	12847590	12499	0.06393442622950819	1027.8894311544923
chr11	PAMR1	35441480	35441693	0	214	51	3879	51	3665	0.0	0.013915416098226467
chr11	AC103855.2	45532648	45533125	0	478	51	4073	51	3595	0.0	0.014186369958275382
chr11	AMBRA1	46541944	46543398	1071	1455	114069	7626	112998	6171	0.7360824742268042	18.311132717549828
chr11	NUP160	47812063	47812429	1500	367	27381	8120	25881	7753	4.087193460490464	3.3381916677415195
chr11	OR5A2	59416968	59426412	183334	9445	183334	9445	0	0	19.410693488618318	0.0
chr11	VWCE	61291263	61291576	0	314	825	4782	825	4468	0.0	0.18464637421665175
chr11	CPSF7	61416104	61416519	64	416	2096	4905	2032	4489	0.15384615384615385	0.4526620628202272
chr11	FTH1	61967311	61967631	0	321	0	1914	0	1593	0.0	0.0
chr11	AP002990.1	62572583	62574908	217672	2326	378550	4072	160878	1746	93.58211521926053	92.14089347079037
chr11	NXF1	62798538	62800486	1094	1949	1354	5978	260	4029	0.5613134940995382	0.06453214197071233
chr11	SNHG1	62852810	62853590	0	781	0	3736	0	2955	0.0	0.0
chr11	SNHG1	62853800	62855216	0	1417	0	3736	0	2319	0.0	0.0
chr11	SNHG1	62851987	62852681	0	695	0	3736	0	3041	0.0	0.0
chr11	SNHG1	62853074	62853590	0	517	0	3736	0	3219	0.0	0.0
chr11	SNHG1	62853800	62854064	0	265	0	3736	0	3471	0.0	0.0
chr11	SNHG1	62853800	62854551	0	752	0	3736	0	2984	0.0	0.0
chr11	SNHG1	62854887	62855885	0	999	0	3736	0	2737	0.0	0.0
chr11	SNHG1	62855423	62855885	0	463	0	3736	0	3273	0.0	0.0
chr11	SNHG1	62852810	62853115	0	306	0	3736	0	3430	0.0	0.0
chr11	SNHG1	62852810	62855216	0	2407	0	3736	0	1329	0.0	0.0
chr11	SNHG1	62854518	62854938	0	421	0	3736	0	3315	0.0	0.0
chr11	SNHG1	62854017	62855216	0	1200	0	3736	0	2536	0.0	0.0
chr11	SNHG1	62854518	62855216	0	699	0	3736	0	3037	0.0	0.0
chr11	SNHG1	62855132	62855885	0	754	0	3736	0	2982	0.0	0.0
chr11	SNHG1	62853551	62855216	0	1666	0	3736	0	2070	0.0	0.0
chr11	SNHG1	62852810	62854551	0	1742	0	3736	0	1994	0.0	0.0
chr11	SNHG1	62854887	62855216	0	330	0	3736	0	3406	0.0	0.0
chr11	SNHG1	62853551	62853833	0	283	0	3736	0	3453	0.0	0.0
chr11	SNHG1	62854017	62854551	0	535	0	3736	0	3201	0.0	0.0
chr11	SNHG1	62853551	62854551	0	1001	0	3736	0	2735	0.0	0.0
chr11	SLC22A8	62993236	62993627	0	392	0	3652	0	3260	0.0	0.0
chr11	SLC22A25	63166043	63168060	0	2018	0	3763	0	1745	0.0	0.0
chr11	C11ORF95	63764867	63765254	211990	388	541457	5954	329467	5566	546.3659793814433	59.19277757815307
chr11	SF1	64764605	64766155	0	1551	0	5987	0	4436	0.0	0.0
chr11	MEN1	64810813	64811294	999	482	272834	4392	271835	3910	2.0726141078838176	69.5230179028133
chr11	NAALADL1	65053217	65053576	2196	360	80493	3759	78297	3399	6.1	23.035304501323917
chr11	NAALADL1	65048151	65048457	821	307	80493	3759	79672	3452	2.6742671009771986	23.079953650057938
chr11	SLC25A45	65375191	65376675	150634	1485	323669	4923	173035	3438	101.43703703703704	50.33013379872018
chr11	KCNK7	65592854	65593383	102	530	2780	1463	2678	933	0.19245283018867926	2.870310825294748
chr11	KCNK7	65592854	65593874	2780	1021	2780	1463	0	442	2.722820763956905	0.0
chr11	RELA	65653600	65655762	348232	2163	2335268	4483	1987036	2320	160.9949144706426	856.4810344827587
chr11	RELA	65653601	65655000	149193	1400	2335268	4483	2186075	3083	106.56642857142857	709.0739539409666
chr11	RNASEH2C	65717708	65719809	102	2102	102	4492	0	2390	0.048525214081826834	0.0
chr11	EFEMP2	65866440	65867079	0	640	13553	4066	13553	3426	0.0	3.9559252772913016
chr11	YIF1A	66284579	66284966	561	388	27940	2353	27379	1965	1.4458762886597938	13.933333333333334
chr11	CTSF	66564087	66564648	0	562	48495	3628	48495	3066	0.0	15.817025440313111
chr11	CTSF	66567443	66567662	3254	220	48495	3628	45241	3408	14.790909090909091	13.27494131455399
chr11	NUDT8	67627937	67628400	0	464	0	1484	0	1020	0.0	0.0
chr11	SHANK2	71118828	71119032	0	205	1312	19063	1312	18858	0.0	0.06957259518506735
chr11	NUMA1	72007188	72008845	204	1658	152128	15188	151924	13530	0.12303980699638119	11.228677014042868
chr11	STARD10	72754728	72755142	6	415	2030	2748	2024	2333	0.014457831325301205	0.8675525075010716
chr11	OR2AT4	75081752	75090364	663	8613	510	1838	-153	-6775	0.07697666318355974	0.022583025830258303
chr11	GDPD4	77216557	77217314	0	758	797	2911	797	2153	0.0	0.37018114259173246
chr11	CCDC90B	83273792	83273992	0	201	0	5909	0	5708	0.0	0.0
chr11	CCDC90B	83273950	83274740	0	791	0	5909	0	5118	0.0	0.0
chr11	CREBZF	85663523	85665102	561	1580	0	4015	-561	2435	0.3550632911392405	-0.23039014373716632
chr11	CREBZF	85660334	85661749	0	1416	0	4015	0	2599	0.0	0.0
chr11	TAF1D	93730676	93731216	0	541	51	5700	51	5159	0.0	0.009885636751308394
chr11	MTMR2	95862271	95865676	408	3406	6134	10675	5726	7269	0.11978860833822666	0.7877287109643692
chr11	CCDC82	96383961	96386293	0	2333	0	14215	0	11882	0.0	0.0
chr11	CASP12	104892330	104892503	0	174	51	1795	51	1621	0.0	0.03146206045650833
chr11	CASP1	105025507	105026356	0	850	0	3706	0	2856	0.0	0.0
chr11	ALG9	111782194	111786520	426	4327	2564	7995	2138	3668	0.09845158308296742	0.5828789531079608
chr11	SLC37A4	119027627	119027872	713	246	2971	4259	2258	4013	2.8983739837398375	0.5626713182157986
chr11	LINC02744	119987951	119988901	0	951	0	1183	0	232	0.0	0.0
chr11	MIR100HG	122064179	122066434	102	2256	189	24445	87	22189	0.04521276595744681	0.003920861688223895
chr11	TMEM218	125102131	125102809	0	679	51	4681	51	4002	0.0	0.012743628185907047
chr11	ACRV1	125677796	125678297	0	502	103	1967	103	1465	0.0	0.07030716723549488
chr11	ARHGAP32	128972452	128975002	0	2551	102	11572	102	9021	0.0	0.011306950448952444
chr11	B3GAT1	134387547	134387940	0	394	0	11757	0	11363	0.0	0.0
chr12	AC005906.2	5021687	5022694	0	1008	0	7869	0	6861	0.0	0.0
chr12	CD9	6235475	6236275	102	801	0	4900	-102	4099	0.12734082397003746	-0.024884118077579898
chr12	TAPBPL	6457405	6457744	0	340	0	3198	0	2858	0.0	0.0
chr12	PTPN6	6954804	6954994	26607	191	355882	4799	329275	4608	139.30366492146598	71.45724826388889
chr12	PHC1	8922632	8922788	0	157	112100	5613	112100	5456	0.0	20.546187683284458
chr12	PHC1	8932562	8933350	79786	789	112100	5613	32314	4824	101.12294043092523	6.698590381426202
chr12	AC092821.3	9567489	9569202	8038	1714	55981	5997	47943	4283	4.689614935822637	11.193789399953303
chr12	CLEC2D	9692827	9693948	102	1122	102	6863	0	5741	0.09090909090909091	0.0
chr12	GABARAPL1	10213835	10214187	0	353	0	3148	0	2795	0.0	0.0
chr12	GABARAPL1	10212882	10213219	0	338	0	3148	0	2810	0.0	0.0
chr12	GABARAPL1	10213428	10214187	0	760	0	3148	0	2388	0.0	0.0
chr12	FAM234B	13080624	13083449	1020	2826	220739	6636	219719	3810	0.3609341825902335	57.66902887139108
chr12	PTPRO	15594936	15597399	0	2464	157	18862	157	16398	0.0	0.009574338333943163
chr12	DDX11	31103576	31104791	0	1216	36	7413	36	6197	0.0	0.0058092625463934166
chr12	IRAK4	43772911	43773072	0	162	0	5626	0	5464	0.0	0.0
chr12	LINC02156	47414659	47415232	0	574	102	2804	102	2230	0.0	0.045739910313901344
chr12	SLC48A1	47780144	47782751	0	2608	0	4924	0	2316	0.0	0.0
chr12	PFKM	48134942	48135383	0	442	6091	6825	6091	6383	0.0	0.9542534858217139
chr12	PFKM	48122646	48122859	2839	214	6091	6825	3252	6611	13.266355140186915	0.4919074270155801
chr12	TROAP	49330144	49331407	594605	1264	793646	3637	199041	2373	470.4153481012658	83.87737041719343
chr12	TROAP	49330144	49330943	421338	800	793646	3637	372308	2837	526.6725	131.2329925978146
chr12	LINC02395	49923781	49924513	510	733	63998	6673	63488	5940	0.6957708049113234	10.688215488215489
chr12	LINC02395	49921925	49923681	4130	1757	63998	6673	59868	4916	2.350597609561753	12.178193653376729
chr12	AQP6	49975464	49977139	13783	1676	19791	4743	6008	3067	8.223747016706444	1.9589175089664166
chr12	LARP4	50441589	50441643	0	55	105070	8113	105070	8058	0.0	13.03921568627451
chr12	TMPRSS12	50885245	50887884	204	2640	602	3340	398	700	0.07727272727272727	0.5685714285714286
chr12	DAZAP2	51240870	51241116	0	247	0	3807	0	3560	0.0	0.0
chr12	TNS2	53059046	53060258	0	1213	0	7370	0	6157	0.0	0.0
chr12	TNS2	53060674	53061264	0	591	0	7370	0	6779	0.0	0.0
chr12	HNRNPA1	54283811	54283967	0	157	51	4239	51	4082	0.0	0.012493875551200392
chr12	HNRNPA1	54283078	54283234	0	157	51	4239	51	4082	0.0	0.012493875551200392
chr12	MUCL1	54856769	54856892	0	124	102	3979	102	3855	0.0	0.026459143968871595
chr12	OR9K2	55129825	55132750	0	2926	0	3123	0	197	0.0	0.0
chr12	TMEM198B	55832958	55833541	0	584	51	4040	51	3456	0.0	0.014756944444444444
chr12	TMEM198B	55834850	55836246	51	1397	51	4040	0	2643	0.03650680028632784	0.0
chr12	TMEM198B	55830840	55831349	0	510	51	4040	51	3530	0.0	0.014447592067988669
chr12	CDK2	55966830	55967934	0	1105	321	3698	321	2593	0.0	0.1237948322406479
chr12	ERBB3	56098499	56098905	0	407	6817	8025	6817	7618	0.0	0.894854292465214
chr12	MYL6	56158357	56158711	0	355	18059	3310	18059	2955	0.0	6.111336717428088
chr12	MYL6	56158361	56158711	0	351	18059	3310	18059	2959	0.0	6.103075363298411
chr12	SLC39A5	56231203	56231561	0	359	0	2914	0	2555	0.0	0.0
chr12	SHMT2	57234002	57234726	0	725	0	3713	0	2988	0.0	0.0
chr12	MARS1	57515919	57516337	0	419	397713	6060	397713	5641	0.0	70.50398865449388
chr12	MARS1	57516244	57516655	0	412	397713	6060	397713	5648	0.0	70.41660764872522
chr12	MARS1	57515919	57516158	0	240	397713	6060	397713	5820	0.0	68.33556701030928
chr12	MBD6	57524028	57524416	0	389	757	4948	757	4559	0.0	0.16604518534766396
chr12	KIF5A	57582601	57583215	102	615	116444	8616	116342	8001	0.16585365853658537	14.540932383452068
chr12	PIP4K2C	57601525	57603418	66234	1894	114363	3262	48129	1368	34.97043294614572	35.18201754385965
chr12	DTX3	57605988	57606252	8704	265	77103	3005	68399	2740	32.845283018867924	24.963138686131387
chr12	OS9	57715759	57716193	4437	435	17230	4766	12793	4331	10.2	2.953821288386054
chr12	TSFM	57783614	57784170	342	557	3486	3221	3144	2664	0.6140035906642729	1.1801801801801801
chr12	RASSF3	64610512	64610743	0	232	7062	4232	7062	4000	0.0	1.7655
chr12	RAB3IP	69812777	69813033	0	257	57874	10469	57874	10212	0.0	5.667254210732471
chr12	PPFIA2-AS1	81292342	81292524	0	183	6	2017	6	1834	0.0	0.003271537622682661
chr12	SOCS2	93572684	93576206	0	3523	153	4478	153	955	0.0	0.16020942408376965
chr12	NEDD1	96907603	96907856	0	254	1892	4482	1892	4228	0.0	0.4474929044465468
chr12	RMST	97492460	97494002	51	1543	78	10114	27	8571	0.03305249513933895	0.003150157507875394
chr12	SLC25A3	98593624	98594135	0	512	51	7682	51	7170	0.0	0.007112970711297071
chr12	SLC25A3	98593685	98594135	0	451	51	7682	51	7231	0.0	0.007052966394689531
chr12	APAF1	98727172	98727316	0	145	127	7025	127	6880	0.0	0.018459302325581396
chr12	RAD9B	110530524	110532086	0	1563	0	3723	0	2160	0.0	0.0
chr12	OAS2	113009086	113011723	0	2638	510	5140	510	2502	0.0	0.2038369304556355
chr12	RFC5	118017689	118018053	0	365	0	3264	0	2899	0.0	0.0
chr12	DYNLL1	120496112	120496553	294	442	306	2491	12	2049	0.665158371040724	0.005856515373352855
chr12	RNF10	120534355	120534968	134760	614	398034	5535	263274	4921	219.47882736156353	53.50010160536476
chr12	HNF1A	120999267	120999627	561	361	167401	4197	166840	3836	1.554016620498615	43.49322210636079
chr12	P2RX7	121177146	121177446	2753	301	65201	5559	62448	5258	9.146179401993356	11.876759224039558
chr12	OGFOD2	122978324	122978569	765	246	43629	3734	42864	3488	3.1097560975609757	12.288990825688073
chr12	ARL6IP4	122982468	122982909	51	442	357	2195	306	1753	0.11538461538461539	0.17455790074158586
chr12	ARL6IP4	122982468	122982908	51	441	357	2195	306	1754	0.11564625850340136	0.17445838084378562
chr12	LINC02359	126096007	126096366	0	360	51	9009	51	8649	0.0	0.005896635449184877
chr12	LINC00943	126745005	126746256	0	1252	0	8509	0	7257	0.0	0.0
chr12	LINC00943	126744769	126745332	0	564	0	8509	0	7945	0.0	0.0
chr12	LINC00943	126744769	126746256	0	1488	0	8509	0	7021	0.0	0.0
chr12	LINC00943	126744769	126745336	0	568	0	8509	0	7941	0.0	0.0
chr12	LINC02368	128120538	128121952	0	1415	0	2377	0	962	0.0	0.0
chr12	EP400P1	132103996	132105304	0	1309	0	11921	0	10612	0.0	0.0
chr12	FBRSL1	132574318	132574564	5423	247	67492	9402	62069	9155	21.955465587044536	6.779792463134899
chr12	P2RX2	132621474	132621972	17229	499	44489	1867	27260	1368	34.52705410821643	19.926900584795323
chr12	P2RX2	132621618	132621972	14186	355	44489	1867	30303	1512	39.96056338028169	20.041666666666668
chr12	ZNF10	133130610	133131014	2784	405	49304	5508	46520	5103	6.874074074074074	9.11620615324319
chr12	AC026369.1	143238	144569	0	1332	0	5449	0	4117	0.0	0.0
chr12	CD27-AS1	6446960	6448150	5611	1191	291043	3028	285432	1837	4.711167086481948	155.37942297223734
chr12	VAMP1	6462236	6464941	102	2706	153	3275	51	569	0.037694013303769404	0.08963093145869948
chr12	CHD4	6583026	6583378	0	353	724713	11254	724713	10901	0.0	66.48133198789102
chr12	PHB2	6967675	6968021	25993	347	312765	2236	286772	1889	74.9077809798271	151.81154049761778
chr12	LPCAT3	6977366	6978507	606096	1142	3123305	4160	2517209	3018	530.7320490367775	834.0652750165673
chr12	CD163	7487358	7488087	153	730	233	5760	80	5030	0.2095890410958904	0.015904572564612324
chr12	LINC00937	8390269	8390969	306	701	10327	5660	10021	4959	0.43651925820256776	2.0207703165960877
chr12	PZP	9202318	9202684	0	367	1100	6291	1100	5924	0.0	0.18568534773801484
chr12	CLEC7A	10116776	10118590	0	1815	0	3288	0	1473	0.0	0.0
chr12	CLEC7A	10129979	10130257	0	279	0	3288	0	3009	0.0	0.0
chr12	PRB3	11267175	11268148	0	974	0	1390	0	416	0.0	0.0
chr12	PRB4	11308220	11308882	0	663	0	927	0	264	0.0	0.0
chr12	PRB1	11353073	11354002	0	930	210	1317	210	387	0.0	0.5426356589147286
chr12	MANSC1	12343091	12343414	0	324	255	5721	255	5397	0.0	0.04724847137298499
chr12	EPS8	15682892	15684302	0	1411	1272	8578	1272	7167	0.0	0.17748011720385098
chr12	PLCZ1	18701500	18701776	0	277	51	2968	51	2691	0.0	0.0189520624303233
chr12	RASSF8-AS1	25952757	25955241	0	2485	12577	9597	12577	7112	0.0	1.7684195725534309
chr12	CAPRIN2	30714958	30716676	612	1719	3570	8052	2958	6333	0.35602094240837695	0.4670772145902416
chr12	CAPRIN2	30719078	30720915	0	1838	3570	8052	3570	6214	0.0	0.5745091728355327
chr12	NELL2	44875814	44876315	0	502	6	6365	6	5863	0.0	0.0010233668770254136
chr12	PCED1B-AS1	47216164	47216434	0	271	0	1838	0	1567	0.0	0.0
chr12	DDX23	48836568	48837037	0	470	106	4903	106	4433	0.0	0.023911572298669075
chr12	RND1	48857144	48858241	0	1098	0	3952	0	2854	0.0	0.0
chr12	WNT10B	48967945	48968319	0	375	102	2607	102	2232	0.0	0.0456989247311828
chr12	PRKAG1	49002273	49003006	0	734	0	3614	0	2880	0.0	0.0
chr12	TUBA1A	49186309	49186833	0	525	1071	3106	1071	2581	0.0	0.41495544362650133
chr12	KRT72	52585588	52586172	3831	585	3891	2164	60	1579	6.5487179487179485	0.03799873337555415
chr12	KRT4	52813596	52814116	0	521	0	2886	0	2365	0.0	0.0
chr12	AC068888.1	53045599	53046061	0	463	0	5374	0	4911	0.0	0.0
chr12	AAAS	53320564	53321257	0	694	306	4055	306	3361	0.0	0.09104433204403452
chr12	AAAS	53307844	53308133	78	290	306	4055	228	3765	0.2689655172413793	0.06055776892430279
chr12	MAP3K12	53486946	53487428	0	483	546	7186	546	6703	0.0	0.08145606444875429
chr12	PMEL	55956948	55957671	51	724	126	3339	75	2615	0.07044198895027624	0.028680688336520075
chr12	SMARCC2	56164302	56164731	2514	430	30332	7617	27818	7187	5.846511627906977	3.870599693891749
chr12	ANKRD52	56237806	56243392	204	5587	335	8841	131	3254	0.03651333452657956	0.04025814382298709
chr12	STAT2	56342617	56343531	1941	915	20980	4706	19039	3791	2.121311475409836	5.022157742020575
chr12	GLS2	56475623	56475977	0	355	3963	3878	3963	3523	0.0	1.124893556627874
chr12	BAZ2A	56615013	56615607	2146	595	290466	10465	288320	9870	3.6067226890756303	29.21175278622087
chr12	DDIT3	57517268	57517753	176	486	1094	1311	918	825	0.36213991769547327	1.1127272727272728
chr12	B4GALNT1	57631199	57631364	1224	166	1054223	7003	1052999	6837	7.373493975903615	154.0147725610648
chr12	AC083805.1	57871995	57872870	1491	876	83625	5555	82134	4679	1.702054794520548	17.5537508014533
chr12	GIHCG	57935838	57936175	10925	338	105441	3815	94516	3477	32.32248520710059	27.183203911417888
chr12	TMBIM4	66138723	66138769	0	47	306	2161	306	2114	0.0	0.14474929044465468
chr12	ZFC3H1	71611057	71611887	0	831	0	9466	0	8635	0.0	0.0
chr12	ZFC3H1	71656342	71657301	0	960	0	9466	0	8506	0.0	0.0
chr12	TRHDE-AS1	72261197	72264621	1785	3425	2847	8148	1062	4723	0.5211678832116788	0.22485708236290494
chr12	TRHDE-AS1	72253550	72254614	102	1065	2847	8148	2745	7083	0.09577464788732394	0.3875476493011436
chr12	TRHDE-AS1	72253550	72255677	1479	2128	2847	8148	1368	6020	0.6950187969924813	0.22724252491694352
chr12	PAWR	79584878	79592693	0	7816	1405	6904	1405	-912	0.0	-1.5405701754385965
chr12	CEP83	94312913	94313017	0	105	876	6852	876	6747	0.0	0.1298354824366385
chr12	CEP83	94412317	94412591	0	275	876	6852	876	6577	0.0	0.13319142466169986
chr12	GOLGA2P5	100157164	100157445	0	282	436	6935	436	6653	0.0	0.06553434540808657
chr12	GOLGA2P5	100157164	100157739	0	576	436	6935	436	6359	0.0	0.06856423966032395
chr12	C12ORF42	103267852	103268962	0	1111	0	4757	0	3646	0.0	0.0
chr12	ALKBH2	109092506	109093472	5357	967	3583	1630	-1774	663	5.539813857290589	-2.6757164404223226
chr12	MMAB	109561039	109561329	0	291	172	6029	172	5738	0.0	0.02997560125479261
chr12	TRPV4	109814410	109814796	0	387	0	3893	0	3506	0.0	0.0
chr12	MAPKAPK5-AS1	111841326	111841710	36	385	94	2732	58	2347	0.09350649350649351	0.024712398806987643
chr12	PXN	120216272	120217116	0	845	16445	7481	16445	6636	0.0	2.4781494876431585
chr12	KDM2B	121429508	121430469	204	962	56377	13372	56173	12410	0.21205821205821207	4.526430298146656
chr12	ZCCHC8	122483278	122483563	255	286	58904	7908	58649	7622	0.8916083916083916	7.694699553922855
chr12	UBC	124911645	124913774	1632	2130	37643	2504	36011	374	0.7661971830985915	96.28609625668449
chr12	LINC00939	125966199	125967342	51	1144	102	6810	51	5666	0.044580419580419584	0.009001058948111542
chr12	LINC00939	125961741	125963083	0	1343	102	6810	102	5467	0.0	0.01865739893908908
chr13	SACS	23328829	23341690	255	12862	306	15925	51	3063	0.01982584357020681	0.01665034280117532
chr13	C1QTNF9B	23891098	23892061	41	964	41	1589	0	625	0.04253112033195021	0.0
chr13	LINC00412	27236281	27236587	0	307	5468	654	5468	347	0.0	15.75792507204611
chr13	HSPH1	31136624	31137524	0	901	460	6340	460	5439	0.0	0.084574370288656
chr13	N4BP2L2	32538617	32538825	0	209	1521	10496	1521	10287	0.0	0.14785651793525809
chr13	N4BP2L2	32538617	32538792	0	176	1521	10496	1521	10320	0.0	0.14738372093023255
chr13	TRPC4	37636842	37637625	0	784	0	3351	0	2567	0.0	0.0
chr13	TRPC4	37639039	37639299	0	261	0	3351	0	3090	0.0	0.0
chr13	TPT1	45340711	45341158	0	448	153	6154	153	5706	0.0	0.026813880126182965
chr13	DHRS12	51767994	51769293	0	1300	0	3227	0	1927	0.0	0.0
chr13	ATP7B	51973934	51975168	59	1235	78021	13652	77962	12417	0.04777327935222672	6.278650237577515
chr13	OR7E104P	63839748	63841623	0	1876	0	4378	0	2502	0.0	0.0
chr13	LINC00393	73545900	73546841	51	942	1419	5042	1368	4100	0.054140127388535034	0.3336585365853659
chr13	DOCK9	98855897	98860522	969	4626	1750	10506	781	5880	0.20946822308690013	0.13282312925170067
chr13	AL390755.1	110045432	110046075	51	644	306	4212	255	3568	0.07919254658385093	0.07146860986547085
chr13	COL4A1	110209888	110210212	0	325	77	12365	77	12040	0.0	0.006395348837209302
chr13	FO681491.1	18413722	18416214	0	2493	0	3454	0	961	0.0	0.0
chr13	ZMYM2	19993062	19993919	0	858	734	12671	734	11813	0.0	0.062134936087361384
chr13	IFT88	20601704	20601933	0	230	82700	6077	82700	5847	0.0	14.144005472892081
chr13	IFT88	20567669	20567997	22872	329	82700	6077	59828	5748	69.51975683890578	10.40848990953375
chr13	MIPEPP3	21301418	21301618	57	201	1930	622	1873	421	0.2835820895522388	4.448931116389549
chr13	TPT1-AS1	45379194	45380001	0	808	51	8229	51	7421	0.0	0.006872389165880609
chr13	TPT1-AS1	45378529	45380001	0	1473	51	8229	51	6756	0.0	0.007548845470692718
chr13	TPT1-AS1	45378529	45379335	0	807	51	8229	51	7422	0.0	0.0068714632174616
chr13	DLEU1	50527865	50528534	1224	670	233640	22973	232416	22303	1.826865671641791	10.420840245706856
chr13	RNASEH2B	50953904	50956503	0	2600	6273	19088	6273	16488	0.0	0.3804585152838428
chr13	EDNRB-AS1	77833364	77834990	0	1627	112	3697	112	2070	0.0	0.05410628019323672
chr13	LINC01068	79570562	79571445	0	884	0	1015	0	131	0.0	0.0
chr13	MBNL2	97346803	97347067	0	265	0	4919	0	4654	0.0	0.0
chr13	ITGBL1	101453882	101454100	0	219	306	6189	306	5970	0.0	0.05125628140703518
chr13	ITGBL1	101567698	101567845	0	148	306	6189	306	6041	0.0	0.05065386525409701
chr13	TPP2	102644908	102646390	0	1483	9	8266	9	6783	0.0	0.0013268465280849183
chr13	LINC00343	105718474	105719202	0	729	153	12772	153	12043	0.0	0.012704475628996098
chr13	LINC00343	105718474	105718852	0	379	153	12772	153	12393	0.0	0.012345679012345678
chr13	LINC00343	105706848	105707629	0	782	153	12772	153	11990	0.0	0.012760633861551293
chr13	LINC00343	105706861	105707629	0	769	153	12772	153	12003	0.0	0.01274681329667583
chr13	LINC00343	105706873	105707629	0	757	153	12772	153	12015	0.0	0.012734082397003745
chr13	LINC00343	105730314	105731715	0	1402	153	12772	153	11370	0.0	0.01345646437994723
chr13	LINC00343	105706875	105707629	0	755	153	12772	153	12017	0.0	0.012731963052342515
chr13	LINC00343	105706889	105707629	0	741	153	12772	153	12031	0.0	0.012717147369295986
chr13	LINC00343	105706896	105707629	0	734	153	12772	153	12038	0.0	0.012709752450573184
chr13	LINC00343	105706898	105707629	0	732	153	12772	153	12040	0.0	0.01270764119601329
chr13	LINC00343	105706899	105707629	0	731	153	12772	153	12041	0.0	0.01270658583174155
chr13	LINC01070	112198230	112201000	0	2771	0	2831	0	60	0.0	0.0
chr14	OR4K2	19878941	19883932	9542	4992	9848	7052	306	2060	1.9114583333333333	0.14854368932038836
chr14	OR4K2	19876244	19883932	9848	7689	9848	7052	0	-637	1.280790740018208	-0.0
chr14	METTL17	20990229	20990598	0	370	102	3390	102	3020	0.0	0.03377483443708609
chr14	METTL17	20993117	20994063	0	947	102	3390	102	2443	0.0	0.04175194433074089
chr14	METTL17	20994793	20995233	0	441	102	3390	102	2949	0.0	0.03458799593082401
chr14	METTL17	20995900	20996292	0	393	102	3390	102	2997	0.0	0.03403403403403404
chr14	ABHD4	22603389	22603762	0	374	0	3045	0	2671	0.0	0.0
chr14	MRPL52	22829886	22830110	0	225	102	2769	102	2544	0.0	0.04009433962264151
chr14	DHRS4L2	24001383	24001517	0	135	17532	2428	17532	2293	0.0	7.645878761447885
chr14	CPNE6	24074050	24074365	0	316	0	3677	0	3361	0.0	0.0
chr14	PCK2	24094310	24094845	0	536	0	3751	0	3215	0.0	0.0
chr14	DCAF11	24115381	24115749	0	369	7849	5675	7849	5306	0.0	1.4792687523558237
chr14	DCAF11	24115381	24115726	0	346	7849	5675	7849	5329	0.0	1.4728842184274724
chr14	DCAF11	24115325	24115749	0	425	7849	5675	7849	5250	0.0	1.495047619047619
chr14	REC8	24179799	24180254	0	456	8	3607	8	3151	0.0	0.0025388765471278957
chr14	GMPR2	24238588	24239242	0	655	0	2910	0	2255	0.0	0.0
chr14	GMPR2	24238245	24239239	0	995	0	2910	0	1915	0.0	0.0
chr14	GMPR2	24238245	24239242	0	998	0	2910	0	1912	0.0	0.0
chr14	NFATC4	24369152	24370594	4835	1443	6525	7075	1690	5632	3.3506583506583505	0.3000710227272727
chr14	NFATC4	24376293	24378001	153	1709	6525	7075	6372	5366	0.08952603861907549	1.1874767051807678
chr14	SCFD1	30674983	30676855	51	1873	51	20324	0	18451	0.027229044313934865	0.0
chr14	SCFD1	30705822	30708065	0	2244	51	20324	51	18080	0.0	0.002820796460176991
chr14	COCH	30874558	30874972	0	415	0	3999	0	3584	0.0	0.0
chr14	SRP54	34982681	34983215	51	535	16402	8450	16351	7915	0.09532710280373832	2.065824384080859
chr14	PRPF39	45096423	45096758	0	336	98	4642	98	4306	0.0	0.02275894101254064
chr14	KLHDC2	49779594	49779806	0	213	0	6332	0	6119	0.0	0.0
chr14	AL139317.5	52791784	52792326	0	543	31421	6856	31421	6313	0.0	4.9771899255504515
chr14	AL365295.1	53169033	53169777	102	745	76819	14298	76717	13553	0.13691275167785236	5.660517966501882
chr14	FAM71D	67208201	67208449	0	249	1938	4520	1938	4271	0.0	0.45375790213064854
chr14	SLC39A9	69458362	69462381	0	4020	2063	7148	2063	3128	0.0	0.6595268542199488
chr14	SRSF5	69771193	69772005	0	813	3779	3622	3779	2809	0.0	1.345318618725525
chr14	LINC01146	88044614	88045481	0	868	0	9300	0	8432	0.0	0.0
chr14	SPATA7	88437837	88438455	0	619	1667	6106	1667	5487	0.0	0.30380900309823217
chr14	ZC3H14	88567857	88568153	0	297	0	20176	0	19879	0.0	0.0
chr14	LINC00642	90456441	90457158	7372	718	25892	5124	18520	4406	10.267409470752089	4.203359055832955
chr14	RIN3	92651581	92653075	0	1495	8810	5916	8810	4421	0.0	1.9927618185930784
chr14	RIN3	92684986	92688049	0	3064	8810	5916	8810	2852	0.0	3.0890603085554
chr14	SERPINA5	94581425	94581710	0	286	2625	3760	2625	3474	0.0	0.7556131260794473
chr14	TCL6	95668125	95669617	1527	1493	2955	10388	1428	8895	1.0227729403884795	0.16053962900505903
chr14	AL133467.3	95691267	95692628	0	1362	95	3681	95	2319	0.0	0.040965933592065545
chr14	AL137786.1	96594663	96595763	0	1101	0	2863	0	1762	0.0	0.0
chr14	AL137786.1	96592749	96593249	0	501	0	2863	0	2362	0.0	0.0
chr14	AL137786.1	96592755	96593249	0	495	0	2863	0	2368	0.0	0.0
chr14	AL137786.1	96592761	96593249	0	489	0	2863	0	2374	0.0	0.0
chr14	AL137786.1	96592767	96593249	0	483	0	2863	0	2380	0.0	0.0
chr14	LINC00618	96945048	96945394	0	347	0	703	0	356	0.0	0.0
chr14	MEG3	100829033	100829749	2409	717	70319	9744	67910	9027	3.3598326359832638	7.522986595768251
chr14	MEG3	100829033	100831534	7340	2502	70319	9744	62979	7242	2.9336530775379694	8.6963545981773
chr14	MEG3	100834631	100835549	19246	919	70319	9744	51073	8825	20.94232861806311	5.7873087818696884
chr14	MEG8	100959801	100961132	0	1332	12150	24817	12150	23485	0.0	0.5173515009580584
chr14	MEG8	100935771	100937488	0	1718	12150	24817	12150	23099	0.0	0.5259967963981125
chr14	MEG8	100986618	100987630	0	1013	12150	24817	12150	23804	0.0	0.5104184170727609
chr14	DYNC1H1	102050070	102050773	0	704	108125	31680	108125	30976	0.0	3.4906056301652892
chr14	EIF5	103334236	103334597	816	362	36624	6699	35808	6337	2.25414364640884	5.650623323339119
chr14	TDRD9	104032016	104032087	0	72	150307	5526	150307	5454	0.0	27.55903923725706
chr14	INF2	104714202	104714856	0	655	51	13399	51	12744	0.0	0.004001883239171375
chr14	LINC02298	105095002	105095768	0	767	0	3493	0	2726	0.0	0.0
chr14	TEP1	20365666	20368559	51	2894	184	11420	133	8526	0.017622667588113337	0.015599343185550082
chr14	TEP1	20377279	20377492	0	214	184	11420	184	11206	0.0	0.016419775120471176
chr14	PIP4P1	20457857	20458702	0	846	0	3028	0	2182	0.0	0.0
chr14	RNASE9	20556092	20558650	0	2559	0	2714	0	155	0.0	0.0
chr14	HNRNPC	21210555	21211306	0	752	612	5164	612	4412	0.0	0.1387126019945603
chr14	HNRNPC	21263310	21263829	0	520	612	5164	612	4644	0.0	0.13178294573643412
chr14	CHD8	21430800	21431858	0	1059	459	13518	459	12459	0.0	0.036840837948470984
chr14	METTL3	21503172	21503577	0	406	0	4373	0	3967	0.0	0.0
chr14	METTL3	21499024	21499600	0	577	0	4373	0	3796	0.0	0.0
chr14	PRMT5	22920528	22921056	0	529	0	3100	0	2571	0.0	0.0
chr14	C14ORF93	22998426	22999402	0	977	0	3210	0	2233	0.0	0.0
chr14	C14ORF93	22998426	22999156	0	731	0	3210	0	2479	0.0	0.0
chr14	SLC7A8	23137920	23138024	0	105	0	4274	0	4169	0.0	0.0
chr14	SLC22A17	23351947	23352451	816	505	390628	4288	389812	3783	1.615841584158416	103.04308749669575
chr14	EFS	23359316	23360039	0	724	4507	3242	4507	2518	0.0	1.789912629070691
chr14	TINF2	24239642	24240155	0	514	0	2610	0	2096	0.0	0.0
chr14	DHRS1	24292183	24292784	0	602	0	4668	0	4066	0.0	0.0
chr14	ADCY4	24334493	24335071	0	579	0	7362	0	6783	0.0	0.0
chr14	ADCY4	24322065	24322708	0	644	0	7362	0	6718	0.0	0.0
chr14	RALGAPA1	35688458	35690003	102	1546	16038	14305	15936	12759	0.06597671410090557	1.2490007053844345
chr14	SEC23A	39103031	39103233	0	203	51	7049	51	6846	0.0	0.007449605609114811
chr14	AL627171.2	49861175	49862316	74	1142	82	1815	8	673	0.0647985989492119	0.01188707280832095
chr14	AL627171.2	49861175	49861896	74	722	82	1815	8	1093	0.10249307479224377	0.007319304666056725
chr14	LINC00520	55793045	55793456	1224	412	32	2977	-1192	2565	2.970873786407767	-0.46471734892787525
chr14	OTX2	56800738	56802355	0	1618	0	2555	0	937	0.0	0.0
chr14	OTX2	56810158	56810448	0	291	0	2555	0	2264	0.0	0.0
chr14	PIGH	67593742	67593952	0	211	0	2424	0	2213	0.0	0.0
chr14	MED6	70583220	70584943	0	1724	0	3828	0	2104	0.0	0.0
chr14	ZFYVE1	72969450	72971114	0	1665	51	5233	51	3568	0.0	0.01429372197309417
chr14	RPS6KL1	74905642	74907124	102	1483	171	4369	69	2886	0.06877950101146325	0.02390852390852391
chr14	NEK9	75105949	75106702	153	754	14785	13134	14632	12380	0.20291777188328913	1.1819063004846526
chr14	DIO2	80206230	80206338	0	109	0	2204	0	2095	0.0	0.0
chr14	CEP128	80830164	80831294	0	1131	638	9385	638	8254	0.0	0.07729585655439787
chr14	LINC01467	81607131	81607698	0	568	0	1224	0	656	0.0	0.0
chr14	LINC02316	86062549	86062960	0	412	1530	3279	1530	2867	0.0	0.533658876874782
chr14	DDX24	94079024	94079747	0	724	0	4993	0	4269	0.0	0.0
chr14	SERPINA9	94469212	94469857	0	646	458	2569	458	1923	0.0	0.23816952678107126
chr14	TCL1A	95712219	95712774	0	556	0	1869	0	1313	0.0	0.0
chr14	LINC00524	101407742	101408258	0	517	0	759	0	242	0.0	0.0
chr14	DIO3OS	101557303	101557819	0	517	0	4042	0	3525	0.0	0.0
chr14	DIO3OS	101557303	101558834	0	1532	0	4042	0	2510	0.0	0.0
chr14	DIO3OS	101557307	101557819	0	513	0	4042	0	3529	0.0	0.0
chr14	MOK	102232534	102233789	34619	1256	47925	7725	13306	6469	27.562898089171973	2.0568866903694545
chr14	IGHG1	105741892	105742222	0	331	51	2768	51	2437	0.0	0.020927369716865
chr15	LINC01193	20979046	20979357	0	312	1224	6672	1224	6360	0.0	0.19245283018867926
chr15	GOLGA8DP	23161094	23161454	0	361	1174	5274	1174	4913	0.0	0.23895786688377774
chr15	PWRN1	24299629	24300430	0	802	51	22178	51	21376	0.0	0.002385853293413174
chr15	PWRN1	24346425	24347317	0	893	51	22178	51	21285	0.0	0.0023960535588442564
chr15	SNHG14	25087466	25089866	0	2401	1269	110104	1269	107703	0.0	0.011782401604412133
chr15	SNHG14	25041973	25042515	0	543	1269	110104	1269	109561	0.0	0.011582588694882302
chr15	SNHG14	25053827	25055230	0	1404	1269	110104	1269	108700	0.0	0.011674333026678934
chr15	SNHG14	25107909	25109403	51	1495	1269	110104	1218	108609	0.03411371237458194	0.01121454023147253
chr15	SNHG14	25115298	25117515	0	2218	1269	110104	1269	107886	0.0	0.011762415883432513
chr15	SNHG14	25108997	25109403	51	407	1269	110104	1218	109697	0.12530712530712532	0.011103311849913854
chr15	SNHG14	25111764	25117515	153	5752	1269	110104	1116	104352	0.02659944367176634	0.010694572217111316
chr15	SNHG14	25103858	25106294	0	2437	1269	110104	1269	107667	0.0	0.011786341218757837
chr15	SNHG14	25101822	25103970	0	2149	1269	110104	1269	107955	0.0	0.011754897874114214
chr15	SNHG14	25093833	25095828	51	1996	1269	110104	1218	108108	0.02555110220440882	0.011266511266511266
chr15	SNHG14	25089613	25091719	0	2107	1269	110104	1269	107997	0.0	0.011750326397955499
chr15	SNHG14	25089545	25091719	0	2175	1269	110104	1269	107929	0.0	0.011757729618545525
chr15	SNHG14	25111764	25115656	153	3893	1269	110104	1116	106211	0.039301310043668124	0.010507386240596548
chr15	SNHG14	25203551	25204300	0	750	1269	110104	1269	109354	0.0	0.011604513780931653
chr15	SNHG14	25245137	25245421	0	285	1269	110104	1269	109819	0.0	0.011555377484770394
chr15	LINC00929	26125208	26126371	0	1164	0	3665	0	2501	0.0	0.0
chr15	GOLGA8F	28382389	28382749	0	361	34059	5682	34059	5321	0.0	6.400864499154294
chr15	HERC2P9	28636486	28637107	0	622	38	8168	38	7546	0.0	0.005035780545984627
chr15	HERC2P9	28640921	28641312	0	392	38	8168	38	7776	0.0	0.004886831275720165
chr15	HERC2P9	28655272	28655691	0	420	38	8168	38	7748	0.0	0.00490449148167269
chr15	FAN1	30904511	30905897	255	1387	141866	15722	141611	14335	0.18385003604902667	9.878688524590164
chr15	FAN1	30925788	30928656	86447	2869	141866	15722	55419	12853	30.13140467061694	4.311756010269976
chr15	CDIN1	36808323	36810244	0	1922	51	9162	51	7240	0.0	0.007044198895027625
chr15	PAK6	40275926	40277487	1467	1562	10384	6404	8917	4842	0.9391805377720871	1.8415943824865757
chr15	CAPN3	42411746	42412315	0	570	290	10244	290	9674	0.0	0.029977258631383088
chr15	CCNDBP1	43194080	43194461	102	382	102	5916	0	5534	0.2670157068062827	0.0
chr15	HYPK	43801517	43804427	4917	2911	15627	7451	10710	4540	1.689110271384404	2.359030837004405
chr15	B2M	44715422	44715701	0	280	0	3042	0	2762	0.0	0.0
chr15	B2M	44717606	44718145	0	540	0	3042	0	2502	0.0	0.0
chr15	GCOM1	57705933	57706955	0	1023	0	8788	0	7765	0.0	0.0
chr15	AQP9	58183960	58185911	0	1952	0	3242	0	1290	0.0	0.0
chr15	SMAD3	67166530	67166853	0	324	9416	7224	9416	6900	0.0	1.3646376811594203
chr15	LRRC49	70936534	70936822	0	289	7240	9178	7240	8889	0.0	0.814489818877264
chr15	CD276	73712933	73714514	0	1582	0	5220	0	3638	0.0	0.0
chr15	PML	74034477	74036394	51	1918	30510	10347	30459	8429	0.026590198123044837	3.613595918851584
chr15	CCDC33	74334974	74336141	21489	1168	39229	6959	17740	5791	18.398116438356166	3.063374201346918
chr15	UBL7-AS1	74461264	74462031	2805	768	13523	2142	10718	1374	3.65234375	7.800582241630276
chr15	AC015871.5	79989904	79990606	0	703	0	703	0	0	0.0	0.0
chr15	ARNT2	80593599	80597928	102	4330	1001	7678	899	3348	0.023556581986143188	0.26851851851851855
chr15	SNHG21	82756903	82757206	309	304	714	1055	405	751	1.0164473684210527	0.5392809587217043
chr15	ZSCAN2	84620601	84622714	0	2114	0	4531	0	2417	0.0	0.0
chr15	MIR9-3HG	89387430	89387881	0	452	0	8103	0	7651	0.0	0.0
chr15	MIR9-3HG	89387816	89389482	0	1667	0	8103	0	6436	0.0	0.0
chr15	MIR9-3HG	89388500	89389522	0	1023	0	8103	0	7080	0.0	0.0
chr15	MIR9-3HG	89388503	89389482	0	980	0	8103	0	7123	0.0	0.0
chr15	MIR9-3HG	89388500	89389482	0	983	0	8103	0	7120	0.0	0.0
chr15	FURIN	90879866	90879984	0	119	41	4749	41	4630	0.0	0.008855291576673866
chr15	FES	90885036	90885585	0	550	4677	4121	4677	3571	0.0	1.3097171660599272
chr15	CHASERR	92883584	92883778	0	195	37	5803	37	5608	0.0	0.006597717546362339
chr15	CHD2	93014695	93014909	22	215	39341	16852	39319	16637	0.10232558139534884	2.3633467572278657
chr15	CHD2	92946037	92946340	153	304	39341	16852	39188	16548	0.5032894736842105	2.36814116509548
chr15	LINC01580	93899234	93899603	0	370	19	2674	19	2304	0.0	0.008246527777777778
chr15	SPATA8	96783434	96784259	102	826	300	1471	198	645	0.1234866828087167	0.30697674418604654
chr15	SYNM	99129366	99135593	204	6228	204	6844	0	616	0.03275529865125241	0.0
chr15	AC027020.1	100559312	100559798	0	487	0	634	0	147	0.0	0.0
chr15	AC015712.6	100861842	100862342	0	501	93	8171	93	7670	0.0	0.0121251629726206
chr15	HERC2P3	20438926	20439655	0	730	2012	9444	2012	8714	0.0	0.23089281615790683
chr15	GOLGA6L2	23439497	23441682	51	2186	153	3047	102	861	0.02333028362305581	0.11846689895470383
chr15	UBE3A	25333727	25340228	0	6502	0	16169	0	9667	0.0	0.0
chr15	SLC12A6	34336409	34338057	4029	1649	5865	9653	1836	8004	2.443298969072165	0.22938530734632684
chr15	LPCAT4	34364193	34364306	0	114	208	3593	208	3479	0.0	0.05978729519977005
chr15	AQR	34873827	34874864	0	1038	6508	13465	6508	12427	0.0	0.523698398648105
chr15	PLCB2	40287908	40288918	7119	1011	14153	6493	7034	5482	7.041543026706232	1.283108354615104
chr15	RMDN3	40754596	40754790	971	195	63126	4467	62155	4272	4.97948717948718	14.549391385767791
chr15	RPAP1	41517797	41518182	0	386	8954	6765	8954	6379	0.0	1.4036682865652923
chr15	UBR1	43025373	43026663	24797	1291	66640	9976	41843	8685	19.207591014717273	4.817846862406448
chr15	ZSCAN29	43369595	43370062	375	468	5365	6474	4990	6006	0.8012820512820513	0.8308358308358308
chr15	STRC	43615432	43616690	0	1259	102	6367	102	5108	0.0	0.019968676585747847
chr15	CATSPER2	43648628	43648844	0	217	2009	5336	2009	5119	0.0	0.3924594647392069
chr15	FRMD5	43873274	43874462	22821	1189	33158	6396	10337	5207	19.193439865433138	1.9852122143268678
chr15	AC084759.2	53976767	53977545	0	779	102	3596	102	2817	0.0	0.0362087326943557
chr15	CCPG1	55359538	55360944	153	1407	204	5580	51	4173	0.10874200426439233	0.012221423436376708
chr15	OAZ2	64691433	64691591	0	159	19730	2806	19730	2647	0.0	7.453721193804307
chr15	CT62	71110243	71112294	2295	2052	2295	2536	0	484	1.118421052631579	0.0
chr15	MYO9A	72117679	72118081	5408	403	20367	14410	14959	14007	13.419354838709678	1.0679660169915042
chr15	STRA6	74202154	74202450	572	297	10514	6568	9942	6271	1.9259259259259258	1.5853930792537076
chr15	CYP1A1	74722272	74723123	0	852	0	3368	0	2516	0.0	0.0
chr15	CYP1A1	74720719	74721053	0	335	0	3368	0	3033	0.0	0.0
chr15	ULK3	74840233	74840641	0	409	9712	3361	9712	2952	0.0	3.289972899728997
chr15	FAM219B	74899991	74902063	1377	2073	300	3076	-1077	1003	0.6642547033285094	-1.073778664007976
chr15	FAM219B	74899991	74902786	1377	2796	300	3076	-1077	280	0.4924892703862661	-3.8464285714285715
chr15	MAN2C1	75355793	75356032	0	240	8773	7504	8773	7264	0.0	1.2077367841409692
chr15	CTSH	78931450	78932458	0	1009	51	11133	51	10124	0.0	0.0050375345713156855
chr15	CTSH	78931450	78935082	0	3633	51	11133	51	7500	0.0	0.0068
chr15	CTSH	78925333	78927781	0	2449	51	11133	51	8684	0.0	0.005872869645324735
chr15	CTSH	78932371	78935082	0	2712	51	11133	51	8421	0.0	0.006056287851799074
chr15	CTSH	78921771	78923118	0	1348	51	11133	51	9785	0.0	0.005212059274399591
chr15	CTSH	78921774	78923118	0	1345	51	11133	51	9788	0.0	0.005210461789946874
chr15	CTSH	78931450	78932041	0	592	51	11133	51	10541	0.0	0.004838250640356702
chr15	CTSH	78931450	78932038	0	589	51	11133	51	10544	0.0	0.004836874051593323
chr15	GOLGA6L10	82344587	82345426	204	840	408	4691	204	3851	0.24285714285714285	0.05297325370033758
chr15	AP3B2	82662167	82662922	0	756	1275758	8150	1275758	7394	0.0	172.53962672437112
chr15	AP3B2	82663126	82663620	0	495	1275758	8150	1275758	7655	0.0	166.65682560418028
chr15	GOLGA2P7	84199310	84203020	0	3711	0	3261	0	-450	0.0	-0.0
chr15	DET1	88530622	88531715	51	1094	153	4789	102	3695	0.04661791590493602	0.027604871447902572
chr15	POLG	89320765	89321260	0	496	155	6927	155	6431	0.0	0.024102005908878867
chr15	LINC01579	93900035	93900599	0	565	179	9355	179	8790	0.0	0.020364050056882823
chr15	LINC01197	95288301	95289554	0	1254	0	13078	0	11824	0.0	0.0
chr15	LINC02254	97427650	97427952	0	303	0	5214	0	4911	0.0	0.0
chr16	DECR2	406684	406952	0	269	153	2636	153	2367	0.0	0.06463878326996197
chr16	PIGQ	574065	574763	1581	699	23122	6456	21541	5757	2.2618025751072963	3.7417057495223207
chr16	RHOT2	670891	671203	2205	313	27744	4192	25539	3879	7.044728434504792	6.583913379737045
chr16	HAGHL	728315	728604	0	290	221403	4949	221403	4659	0.0	47.521571152607855
chr16	HAGHL	727105	727614	891	510	221403	4949	220512	4439	1.7470588235294118	49.67605316512728
chr16	HAGHL	729008	729715	874	708	221403	4949	220529	4241	1.234463276836158	51.99929261966518
chr16	MSLN	768378	768865	5174	488	17916	2494	12742	2006	10.602459016393443	6.351944167497508
chr16	CHTF18	788930	789360	241	431	12796	4621	12555	4190	0.5591647331786543	2.996420047732697
chr16	CRAMP1	1655876	1656992	3476	1117	43996	8617	40520	7500	3.1119068934646372	5.402666666666667
chr16	NUBP2	1787940	1788207	51	268	9482	3124	9431	2856	0.19029850746268656	3.3021708683473388
chr16	NDUFB10	1961496	1961975	0	480	0	679	0	199	0.0	0.0
chr16	TBL3	1977053	1977284	0	232	703	6954	703	6722	0.0	0.10458196965188932
chr16	TBL3	1977513	1977670	0	158	703	6954	703	6796	0.0	0.10344320188346086
chr16	TSC2	2088047	2088325	11649	279	127539	14665	115890	14386	41.75268817204301	8.055748644515502
chr16	DNASE1L2	2237375	2237649	2601	275	6636	1518	4035	1243	9.458181818181819	3.246178600160901
chr16	AMDHD2	2528451	2528718	510	268	26592	3044	26082	2776	1.9029850746268657	9.395533141210375
chr16	SRRM2	2770857	2771410	736	554	127808	11355	127072	10801	1.3285198555956679	11.764836589204704
chr16	IL32	3067376	3067613	0	238	2027	2993	2027	2755	0.0	0.7357531760435572
chr16	IL32	3068989	3069551	51	563	2027	2993	1976	2430	0.0905861456483126	0.8131687242798354
chr16	IL32	3065368	3065826	306	459	2027	2993	1721	2534	0.6666666666666666	0.6791633780584057
chr16	IL32	3065639	3065826	0	188	2027	2993	2027	2805	0.0	0.722638146167558
chr16	IL32	3065661	3065826	0	166	2027	2993	2027	2827	0.0	0.7170145030067209
chr16	DNASE1	3656998	3657341	0	344	74602	8622	74602	8278	0.0	9.012080212611743
chr16	METTL22	8628729	8629110	0	382	0	7747	0	7365	0.0	0.0
chr16	AC012178.1	9517182	9518324	0	1143	0	4432	0	3289	0.0	0.0
chr16	AC012178.1	9517455	9518323	0	869	0	4432	0	3563	0.0	0.0
chr16	AC012178.1	9517182	9518323	0	1142	0	4432	0	3290	0.0	0.0
chr16	AC012178.1	9517182	9518325	0	1144	0	4432	0	3288	0.0	0.0
chr16	NOMO1	14895513	14896156	0	644	16401	5532	16401	4888	0.0	3.3553600654664484
chr16	NPIPA1	14935159	14935397	24552	239	38158	7367	13606	7128	102.72803347280335	1.9088103254769921
chr16	NDE1	15724190	15727000	9855	2811	18222	8104	8367	5293	3.505869797225187	1.58076705082184
chr16	AC138969.1	16333646	16333884	25841	239	27355	7438	1514	7199	108.1213389121339	0.2103069870815391
chr16	IQCK	19763847	19764112	0	266	141203	5005	141203	4739	0.0	29.795948512344378
chr16	TMEM159	21160977	21161278	0	302	648	2567	648	2265	0.0	0.2860927152317881
chr16	SMG1P1	22483030	22483560	9769	531	37496	6698	27727	6167	18.397363465160076	4.496027241770715
chr16	KDM8	27210092	27210621	0	530	12300	3982	12300	3452	0.0	3.563151796060255
chr16	APOBR	28495098	28497996	92823	2899	111056	3802	18233	903	32.01897205933081	20.19158361018826
chr16	ATXN2L	28835932	28837237	83399	1306	107556	6097	24157	4791	63.8583460949464	5.042162387810478
chr16	ATXN2L	28835932	28836485	7070	554	107556	6097	100486	5543	12.76173285198556	18.12845029767274
chr16	LAT	28986381	28986446	9633	66	268017	4040	258384	3974	145.95454545454547	65.01862103673881
chr16	LAT	28986539	28986714	54933	176	268017	4040	213084	3864	312.1193181818182	55.14596273291925
chr16	SPN	29663694	29670876	204	7183	204	7385	0	202	0.02840038980927189	0.0
chr16	MAZ	29807774	29807828	0	55	660470	3213	660470	3158	0.0	209.1418619379354
chr16	PRRT2	29812989	29813933	36734	945	265381	2305	228647	1360	38.871957671957674	168.12279411764706
chr16	SLX1A-SULT1A3	30202689	30203685	6514	997	40996	4064	34482	3067	6.533600802407221	11.242908379523964
chr16	ITGAL	30473964	30474298	9	335	417	9594	408	9259	0.026865671641791045	0.044065233826547145
chr16	ITGAL	30496096	30496566	0	471	417	9594	417	9123	0.0	0.04570864847089773
chr16	BCKDK	31111868	31112567	0	700	13495	3416	13495	2716	0.0	4.968703976435935
chr16	KAT8	31130745	31131359	5151	615	150266	5737	145115	5122	8.37560975609756	28.33170636470129
chr16	KAT8	31130455	31130900	3642	446	150266	5737	146624	5291	8.165919282511211	27.711963711963712
chr16	ARMC5	31462130	31462917	19423	788	85837	4981	66414	4193	24.648477157360407	15.839255902694967
chr16	AC142381.3	31981869	31982189	0	321	102	2178	102	1857	0.0	0.05492730210016155
chr16	AC007614.1	49287719	49289655	0	1937	102	24089	102	22152	0.0	0.004604550379198266
chr16	AC007614.1	49287366	49289655	0	2290	102	24089	102	21799	0.0	0.004679113720812881
chr16	AC007614.1	49287829	49289655	0	1827	102	24089	102	22262	0.0	0.004581798580540832
chr16	CASC22	52272618	52273219	0	602	0	2437	0	1835	0.0	0.0
chr16	CHD9	53209481	53209813	260	333	4499	15474	4239	15141	0.7807807807807807	0.2799682979988112
chr16	MT1E	56626465	56627112	0	648	0	1054	0	406	0.0	0.0
chr16	MT1H	56670505	56671129	247642	625	247642	725	0	100	396.2272	0.0
chr16	KATNB1	57736977	57737283	0	307	0	3360	0	3053	0.0	0.0
chr16	USB1	58002478	58002645	0	168	240	4598	240	4430	0.0	0.05417607223476298
chr16	CCDC113	58259853	58259934	0	82	51	5938	51	5856	0.0	0.008709016393442622
chr16	SETD6	58515790	58516097	2448	308	6423	7506	3975	7198	7.9480519480519485	0.5522367324256738
chr16	FBXL8	67162847	67164174	8	1328	2906	2967	2898	1639	0.006024096385542169	1.7681513117754728
chr16	HSF4	67169278	67169945	2499	668	20186	2898	17687	2230	3.7410179640718564	7.931390134529148
chr16	TMEM208	67228796	67229278	43812	483	206659	1641	162847	1158	90.7080745341615	140.6278065630397
chr16	PLEKHG4	67277509	67280806	510	3298	24073	5721	23563	2423	0.15463917525773196	9.72472141972761
chr16	CARMIL2	67648051	67648314	636	264	89236	5782	88600	5518	2.409090909090909	16.056542225444
chr16	TSNAXIP1	67825666	67826076	102	411	933	3696	831	3285	0.24817518248175183	0.25296803652968036
chr16	TSNAXIP1	67825666	67826282	102	617	933	3696	831	3079	0.16531604538087522	0.2698928223449172
chr16	EDC4	67882957	67883177	0	221	337631	6082	337631	5861	0.0	57.60638116362396
chr16	SLC7A6	68274690	68275249	1563	560	60047	6338	58484	5778	2.7910714285714286	10.12184146763586
chr16	SLC7A6	68297233	68301819	12546	4587	60047	6338	47501	1751	2.7351209941138	27.127926898914907
chr16	CDH1	68813312	68813562	0	251	102	5466	102	5215	0.0	0.01955896452540748
chr16	HPR	72076302	72077246	4387	945	4527	1930	140	985	4.642328042328042	0.14213197969543148
chr16	LINC01568	73420656	73421396	0	741	0	6893	0	6152	0.0	0.0
chr16	PLCG2	81956694	81956879	0	186	28252	13417	28252	13231	0.0	2.135288337994105
chr16	HSD17B2	82090901	82098534	102	7634	0	2501	-102	-5133	0.013361278490961487	0.019871420222092345
chr16	DNAAF1	84169858	84170356	0	499	9728	3756	9728	3257	0.0	2.986797666564323
chr16	SNAI3-AS1	88671276	88671693	357	418	36456	5297	36099	4879	0.854066985645933	7.398852223816355
chr16	TRAPPC2L	88859344	88859750	999	407	8812	3018	7813	2611	2.4545454545454546	2.9923400995787053
chr16	SPG7	89556886	89557747	4109	862	40502	18796	36393	17934	4.7668213457076565	2.029274004683841
chr16	SPG7	89540943	89541384	612	442	40502	18796	39890	18354	1.3846153846153846	2.1733682031164867
chr16	SPG7	89545871	89546181	0	311	40502	18796	40502	18485	0.0	2.191073843657019
chr16	SPG7	89545871	89546760	0	890	40502	18796	40502	17906	0.0	2.26192337763878
chr16	SPG7	89540943	89542279	612	1337	40502	18796	39890	17459	0.45774121166791326	2.2847814880577353
chr16	SPG7	89540943	89541346	612	404	40502	18796	39890	18392	1.5148514851485149	2.1688777729447586
chr16	RPL13	89561577	89561751	2701	175	25337	3088	22636	2913	15.434285714285714	7.770683144524545
chr16	RPL13	89560710	89561063	403	354	25337	3088	24934	2734	1.1384180790960452	9.119970738844184
chr16	CDK10	89693273	89693467	0	195	134	5398	134	5203	0.0	0.025754372477416874
chr16	LINC02193	90222243	90222673	4550	431	10573	4443	6023	4012	10.556844547563806	1.5012462612163509
chr16	LUC7L	188968	190135	2397	1168	5313	6101	2916	4933	2.05222602739726	0.5911210216906547
chr16	CEROX1	975760	976400	102	641	102	2975	0	2334	0.15912636505460218	0.0
chr16	CEROX1	975760	977029	102	1270	102	2975	0	1705	0.08031496062992126	0.0
chr16	MSRB1	1940777	1940892	0	116	0	2025	0	1909	0.0	0.0
chr16	MSRB1	1940777	1941405	0	629	0	2025	0	1396	0.0	0.0
chr16	RPS2	1962060	1962656	0	597	102	1934	102	1337	0.0	0.0762902019446522
chr16	PKD1	2103265	2103895	19698	631	277560	16200	257862	15569	31.217115689381934	16.562528100712957
chr16	ERVK13-1	2669410	2672570	8352	3161	51005	6668	42653	3507	2.6422018348623855	12.162246934702024
chr16	ERVK13-1	2660361	2663407	39175	3047	51005	6668	11830	3621	12.856908434525764	3.2670533001933166
chr16	ERVK13-1	2671023	2672570	6057	1548	51005	6668	44948	5120	3.9127906976744184	8.77890625
chr16	ERVK13-1	2669410	2672562	8336	3153	51005	6668	42669	3515	2.6438312718046304	12.139118065433856
chr16	ELOB	2771413	2772102	0	690	33	1115	33	425	0.0	0.07764705882352942
chr16	PRSS33	2783952	2785171	153	1220	314	2118	161	898	0.12540983606557377	0.17928730512249444
chr16	ZNF213-AS1	3129247	3129653	0	407	11489	9872	11489	9465	0.0	1.2138404648705758
chr16	NMRAL1	4474092	4474792	0	701	9242	3199	9242	2498	0.0	3.6997598078462772
chr16	GLYR1	4803202	4805310	12953	2109	23237	5290	10284	3181	6.141773352299668	3.232945614586608
chr16	PARN	14591912	14593378	46	1467	49697	8816	49651	7349	0.03135650988411725	6.756157300312967
chr16	NPIPA8	18334710	18334967	0	258	0	1617	0	1359	0.0	0.0
chr16	NPIPA9	18374831	18375069	0	239	0	2981	0	2742	0.0	0.0
chr16	NOMO2	18499924	18500567	0	644	284362	6838	284362	6194	0.0	45.909267032612206
chr16	RPS15A	18782967	18784823	0	1857	2653	4037	2653	2180	0.0	1.2169724770642203
chr16	THUMPD1	20733663	20737286	204	3624	294	6379	90	2755	0.056291390728476824	0.032667876588021776
chr16	SMG1P3	21455342	21455872	510	531	106538	7138	106028	6607	0.96045197740113	16.047828061147268
chr16	SMG1P4	21887583	21888113	663	531	83841	5968	83178	5437	1.2485875706214689	15.298510207835204
chr16	ERN2	23700538	23701114	403272	577	1122167	4763	718895	4186	698.9116117850954	171.7379359770664
chr16	NSMCE1	27241352	27241889	735	538	13465	2869	12730	2331	1.3661710037174721	5.461175461175461
chr16	CLN3	28482476	28482672	5135	197	270893	5985	265758	5788	26.065989847715738	45.91534208707671
chr16	AC138894.1	28458385	28458591	0	207	54916	4138	54916	3931	0.0	13.969982192826253
chr16	AC138894.1	28477011	28477635	864	625	54916	4138	54052	3513	1.3824	15.38627953316254
chr16	CLN3	28491713	28492074	42	362	270893	5985	270851	5623	0.11602209944751381	48.16841543659968
chr16	AC138894.1	28477278	28477635	510	358	54916	4138	54406	3780	1.4245810055865922	14.393121693121692
chr16	CLN3	28482326	28482672	6576	347	270893	5985	264317	5638	18.95100864553314	46.881340901028736
chr16	CLN3	28482104	28482382	1379	279	270893	5985	269514	5706	4.942652329749104	47.23343848580441
chr16	CLN3	28482104	28482672	7955	569	270893	5985	262938	5416	13.98066783831283	48.54837518463811
chr16	CLN3	28482104	28482545	5216	442	270893	5985	265677	5543	11.800904977375566	47.930182211798666
chr16	CLN3	28491481	28491835	288	355	270893	5985	270605	5630	0.8112676056338028	48.06483126110124
chr16	CLN3	28482326	28482545	3837	220	270893	5985	267056	5765	17.44090909090909	46.323677363399824
chr16	CLN3	28491481	28492042	288	562	270893	5985	270605	5423	0.5124555160142349	49.899502120597454
chr16	CLN3	28491713	28492042	42	330	270893	5985	270851	5655	0.12727272727272726	47.89584438549956
chr16	SULT1A2	28595366	28595675	0	310	47777	2055	47777	1745	0.0	27.379369627507163
chr16	DOC2A	30009960	30010340	575	381	453809	6385	453234	6004	1.5091863517060367	75.48867421718855
chr16	CCDC189	30760283	30760668	51	386	5237	2142	5186	1756	0.13212435233160622	2.9533029612756265
chr16	CCDC189	30759341	30759724	312	384	5237	2142	4925	1758	0.8125	2.8014789533560864
chr16	RUSF1	31508073	31508384	38380	312	44651	3175	6271	2863	123.01282051282051	2.190359762486902
chr16	SLC6A10P	32882530	32883703	3137	1174	3443	4120	306	2946	2.67206132879046	0.10386965376782077
chr16	ABCC12	48086740	48088085	0	1346	50	8731	50	7385	0.0	0.006770480704129994
chr16	CDH8	61647241	61654101	0	6861	408	13549	408	6688	0.0	0.061004784688995214
chr16	TK2	66509442	66512066	0	2625	58762	8924	58762	6299	0.0	9.328782346404191
chr16	TK2	66548977	66549860	816	884	58762	8924	57946	8040	0.9230769230769231	7.207213930348258
chr16	CMTM4	66614749	66622222	10826	7474	9086	6340	-1740	-1134	1.4484880920524486	1.5343915343915344
chr16	CDH16	66910259	66911315	0	1057	12644	3606	12644	2549	0.0	4.960376618281679
chr16	CIAO2B	66932064	66932300	0	237	0	1010	0	773	0.0	0.0
chr16	EXOC3L1	67184685	67185057	451	373	59390	3057	58939	2684	1.2091152815013404	21.959388971684053
chr16	ATP6V0D1	67438018	67438689	11110	672	27750	6487	16640	5815	16.532738095238095	2.8615649183147034
chr16	TERF2	69368375	69368595	104897	221	493993	3724	389096	3503	474.6470588235294	111.07507850413931
chr16	AARS1	70258032	70259186	9319	1155	132468	9918	123149	8763	8.06839826839827	14.053292251512039
chr16	AARS1	70253267	70253800	4450	534	132468	9918	128018	9384	8.333333333333334	13.642156862745098
chr16	AARS1	70253918	70254734	1708	817	132468	9918	130760	9101	2.090575275397797	14.367651906383914
chr16	AP1G1	71807800	71808150	0	351	59370	10941	59370	10590	0.0	5.606232294617564
chr16	AP1G1	71808504	71808813	0	310	59370	10941	59370	10631	0.0	5.584611043175618
chr16	PMFBP1	72119096	72120089	97663	994	193099	5619	95436	4625	98.25251509054326	20.634810810810812
chr16	LINC01572	72521007	72522623	0	1617	7305	12582	7305	10965	0.0	0.6662106703146374
chr16	AC009053.1	74352039	74352378	2589	340	101391	3342	98802	3002	7.614705882352941	32.912058627581615
chr16	CLEC18B	74412153	74412246	0	94	6100	2892	6100	2798	0.0	2.180128663330951
chr16	LINC01227	80567554	80568113	0	560	0	3106	0	2546	0.0	0.0
chr16	ARLNC1	80829789	80830757	0	969	0	5783	0	4814	0.0	0.0
chr16	ARLNC1	80829790	80830757	0	968	0	5783	0	4815	0.0	0.0
chr16	ARLNC1	80829791	80830757	0	967	0	5783	0	4816	0.0	0.0
chr16	ARLNC1	80829792	80830757	0	966	0	5783	0	4817	0.0	0.0
chr16	HSDL1	84129985	84130431	0	447	117538	3850	117538	3403	0.0	34.53952394945636
chr16	TAF1C	84181745	84182058	0	314	1786	4997	1786	4683	0.0	0.38137945761264147
chr16	AC009123.1	84194388	84195156	0	769	0	1255	0	486	0.0	0.0
chr16	LINC00917	86337360	86338661	0	1302	83	5647	83	4345	0.0	0.019102416570771
chr16	AC010531.4	87291683	87292438	0	756	920	2102	920	1346	0.0	0.6835066864784547
chr16	PIEZO1	88715932	88716119	9608	188	248096	10919	238488	10731	51.1063829787234	22.224210232038022
chr16	CHMP1A	89647034	89647331	48542	298	452900	5318	404358	5020	162.89261744966444	80.54940239043825
chr16	CHMP1A	89656632	89657708	89716	1077	452900	5318	363184	4241	83.30176415970288	85.63640650789908
chr16	SPATA2L	89696356	89698305	51	1950	51	2471	0	521	0.026153846153846153	0.0
chr17	SLC43A2	1616561	1616769	7565	209	707300	10395	699735	10186	36.196172248803826	68.69575888474377
chr17	MYBBP1A	4538901	4539967	0	1067	51	5295	51	4228	0.0	0.012062440870387891
chr17	PELP1	4671690	4673145	51	1456	11311	6512	11260	5056	0.03502747252747253	2.2270569620253164
chr17	SPAG7	4959225	4959916	306	692	306	2744	0	2052	0.4421965317919075	0.0
chr17	ZNF232	5108925	5109868	84	944	3255	2800	3171	1856	0.08898305084745763	1.7085129310344827
chr17	DERL2	5481100	5481389	0	290	453	5129	453	4839	0.0	0.09361438313701177
chr17	SLC16A11	7041995	7042763	0	769	132	1985	132	1216	0.0	0.10855263157894737
chr17	SLC16A11	7043311	7044092	102	782	132	1985	30	1203	0.13043478260869565	0.02493765586034913
chr17	SLC16A11	7041620	7042763	30	1144	132	1985	102	841	0.026223776223776224	0.12128418549346016
chr17	CLEC10A	7074794	7075885	0	1092	5591	2340	5591	1248	0.0	4.479967948717949
chr17	PHF23	7235929	7236767	1071	839	357	2660	-714	1821	1.2765196662693683	-0.39209225700164746
chr17	CTDNEP1	7243590	7244245	1479	656	7204	2647	5725	1991	2.254573170731707	2.8754394776494223
chr17	GPS2	7312660	7313124	12139	465	60351	2507	48212	2042	26.10537634408602	23.610186092066602
chr17	TP53	7676381	7676622	0	242	0	5536	0	5294	0.0	0.0
chr17	PER1	8144055	8144993	0	939	54371	6344	54371	5405	0.0	10.059389454209066
chr17	CTC1	8230293	8230468	0	176	768	8044	768	7868	0.0	0.09761057447890188
chr17	KRBA2	8371308	8372081	71636	774	427112	13409	355476	12635	92.55297157622739	28.134230312623664
chr17	MYH2	10549374	10549623	0	250	592	6406	592	6156	0.0	0.09616634178037686
chr17	COX10-AS1	14033551	14034416	0	866	0	11234	0	10368	0.0	0.0
chr17	TEKT3	15331006	15331614	0	609	9750	2613	9750	2004	0.0	4.865269461077844
chr17	CDRT1	15613614	15614033	14188	420	172142	8798	157954	8378	33.78095238095238	18.853425638577225
chr17	TRIM16	15683035	15684299	0	1265	2054	4831	2054	3566	0.0	0.5759955131800336
chr17	TRIM16	15627965	15629198	779	1234	2054	4831	1275	3597	0.6312803889789304	0.35446205170975814
chr17	ZSWIM7	15976559	15978163	4521	1605	6749	2082	2228	477	2.816822429906542	4.670859538784067
chr17	ZSWIM7	15977578	15977913	0	336	6749	2082	6749	1746	0.0	3.8654066437571593
chr17	ZSWIM7	15977726	15978163	0	438	6749	2082	6749	1644	0.0	4.105231143552311
chr17	ZSWIM7	15977732	15978163	0	432	6749	2082	6749	1650	0.0	4.09030303030303
chr17	CENPV	16348615	16349333	6273	719	1947190	1849	1940917	1130	8.72461752433936	1717.6256637168142
chr17	KRT16P6	16818800	16819162	0	363	255	1817	255	1454	0.0	0.17537826685006877
chr17	TBC1D27P	16929520	16930408	0	889	0	4955	0	4066	0.0	0.0
chr17	SREBF1	17817547	17817916	1325	370	9822	6629	8497	6259	3.581081081081081	1.3575651062470042
chr17	FLII	18244835	18245419	3389	585	158013	5686	154624	5101	5.793162393162393	30.31248774750049
chr17	FLII	18245229	18245419	1905	191	158013	5686	156108	5495	9.973821989528796	28.409099181073703
chr17	FLII	18256908	18257276	63310	369	158013	5686	94703	5317	171.57181571815718	17.8113597893549
chr17	TBC1D28	18641631	18641998	0	368	130498	4165	130498	3797	0.0	34.368712141164075
chr17	B9D1	19343056	19343857	0	802	116	6772	116	5970	0.0	0.019430485762144054
chr17	ULK2	19770829	19776407	1275	5579	30015	9898	28740	4319	0.22853557985302025	6.654318129196573
chr17	KRT16P3	20501512	20501970	102	459	153	2359	51	1900	0.2222222222222222	0.026842105263157896
chr17	KRT16P3	20502064	20502713	0	650	153	2359	153	1709	0.0	0.08952603861907549
chr17	NOS2	27780766	27780906	0	141	1715	4427	1715	4286	0.0	0.40013999066728884
chr17	LYRM9	27878357	27880366	58098	2010	77701	3560	19603	1550	28.904477611940298	12.647096774193548
chr17	UNC119	28546707	28547849	0	1143	255	5095	255	3952	0.0	0.06452429149797571
chr17	PIGS	28570851	28571188	0	338	0	4809	0	4471	0.0	0.0
chr17	SEZ6	28956718	28956757	399	40	89425	4750	89026	4710	9.975	18.90148619957537
chr17	MYO18A	29118030	29118189	11036	160	160023	15087	148987	14927	68.975	9.98104106652375
chr17	TEFM	30898985	30900562	0	1578	0	1841	0	263	0.0	0.0
chr17	SLFN13	35444614	35445693	1020	1080	39566	9056	38546	7976	0.9444444444444444	4.832748244734202
chr17	GAS2L2	35750076	35750318	1275	243	8364	3381	7089	3138	5.246913580246914	2.2590822179732313
chr17	DDX52	37609738	37614353	459	4616	3308	8334	2849	3718	0.09943674176776429	0.7662721893491125
chr17	CWC25	38810275	38810595	0	321	1389	3726	1389	3405	0.0	0.4079295154185022
chr17	PLXDC1	39079103	39079528	0	426	0	9280	0	8854	0.0	0.0
chr17	MED1	39404284	39410721	0	6438	0	8626	0	2188	0.0	0.0
chr17	KRT13	41505055	41505597	0	543	0	2923	0	2380	0.0	0.0
chr17	KRT13	41505055	41505612	0	558	0	2923	0	2365	0.0	0.0
chr17	KRT42P	41626789	41627762	0	974	133	4308	133	3334	0.0	0.039892021595680865
chr17	DNAJC7	41987818	41988896	0	1079	743	9268	743	8189	0.0	0.0907314690438393
chr17	STAT3	42329409	42329647	51	239	1726	9674	1675	9435	0.21338912133891214	0.17753047164811872
chr17	RAMP2-AS1	42760425	42760711	2550	287	334587	4005	332037	3718	8.885017421602788	89.3052716514255
chr17	VAT1	43014606	43016144	35244	1539	75593	3313	40349	1774	22.900584795321638	22.744644870349493
chr17	AC060780.1	43166979	43167849	765	871	57171	6052	56406	5181	0.878300803673938	10.887087434858136
chr17	MEOX1	43661065	43661922	1491	858	3759	2677	2268	1819	1.7377622377622377	1.2468389224848817
chr17	ASB16-AS1	44181622	44183093	3370	1472	1429	2476	-1941	1004	2.2894021739130435	-1.9332669322709164
chr17	GFAP	44915025	44915500	0	476	51	7492	51	7016	0.0	0.007269099201824401
chr17	GFAP	44910091	44910658	0	568	51	7492	51	6924	0.0	0.007365684575389948
chr17	GFAP	44904441	44905149	0	709	51	7492	51	6783	0.0	0.007518796992481203
chr17	OSBPL7	47807372	47808399	102	1028	114	5247	12	4219	0.09922178988326848	0.002844275894761792
chr17	OSBPL7	47816106	47816482	0	377	114	5247	114	4870	0.0	0.023408624229979465
chr17	SCRN2	47837691	47838450	2496	760	2692	3004	196	2244	3.2842105263157895	0.0873440285204991
chr17	MKS1	58206464	58207218	612	755	93257	8985	92645	8230	0.8105960264900662	11.256986634264885
chr17	SEPTIN4	58520742	58521160	15665	419	78318	6797	62653	6378	37.38663484486874	9.82329883976168
chr17	SEPTIN4	58521735	58522101	13399	367	78318	6797	64919	6430	36.509536784741144	10.096267496111976
chr17	AC025048.2	60134755	60135693	510	939	561	3106	51	2167	0.5431309904153354	0.023534840793724043
chr17	AC025048.2	60134755	60135713	510	959	561	3106	51	2147	0.5318039624608968	0.02375407545412203
chr17	STRADA	63741453	63741796	0	344	51	9568	51	9224	0.0	0.005529054640069384
chr17	CCDC47	63756239	63756350	450	112	1613	4370	1163	4258	4.017857142857143	0.2731329262564584
chr17	CSH2	63872011	63872741	0	731	0	1177	0	446	0.0	0.0
chr17	ICAM2	64005106	64005373	0	268	0	1706	0	1438	0.0	0.0
chr17	DDX5	64502161	64502549	411	389	5205	7977	4794	7588	1.056555269922879	0.6317870321560358
chr17	DDX5	64506754	64507562	0	809	5205	7977	5205	7168	0.0	0.7261439732142857
chr17	PLEKHM1P1	64821766	64822393	81	628	248895	8489	248814	7861	0.12898089171974522	31.651698257219184
chr17	AMZ2P1	64972753	64973517	63	765	1129	3863	1066	3098	0.08235294117647059	0.34409296320206584
chr17	ABCA8	68921381	68921492	0	112	34	10965	34	10853	0.0	0.003132774348106514
chr17	ABCA8	68929048	68929234	0	187	34	10965	34	10778	0.0	0.0031545741324921135
chr17	ABCA10	69153304	69154009	0	706	226	8379	226	7673	0.0	0.029453929362700377
chr17	NAT9	74771959	74772277	0	319	21099	2692	21099	2373	0.0	8.891276864728193
chr17	FDXR	74863895	74864347	0	453	102	3392	102	2939	0.0	0.03470568220483158
chr17	GGA3	75240341	75241057	0	717	1734	4272	1734	3555	0.0	0.4877637130801688
chr17	SLC25A19	75288387	75288591	357	205	816	2966	459	2761	1.7414634146341463	0.16624411445128576
chr17	UNC13D	75827224	75828086	0	863	0	6820	0	5957	0.0	0.0
chr17	FBF1	75913912	75914298	0	387	114	6205	114	5818	0.0	0.01959436232382262
chr17	RHBDF2	76487711	76488132	0	422	2682	6598	2682	6176	0.0	0.43426165803108807
chr17	SRSF2	76734114	76736464	0	2351	0	2637	0	286	0.0	0.0
chr17	TMC6	78120176	78121164	135179	989	808848	11377	673669	10388	136.6825075834176	64.85069310743165
chr17	SCAT1	78630031	78630430	0	400	10626	4114	10626	3714	0.0	2.861066235864297
chr17	CANT1	78996991	78997963	102	973	6401	4029	6299	3056	0.10483042137718397	2.06119109947644
chr17	AATK	81120200	81120984	0	785	48	5255	48	4470	0.0	0.010738255033557046
chr17	CEP131	81189596	81189975	224	380	1932	3992	1708	3612	0.5894736842105263	0.4728682170542636
chr17	AC110285.1	81385128	81385407	0	280	0	2396	0	2116	0.0	0.0
chr17	AC110285.1	81385128	81385464	0	337	0	2396	0	2059	0.0	0.0
chr17	ACTG1	81512231	81512781	0	551	0	2143	0	1592	0.0	0.0
chr17	MCRIP1	81822360	81823311	0	952	0	3547	0	2595	0.0	0.0
chr17	PCYT2	81908875	81909321	0	447	0	6666	0	6219	0.0	0.0
chr17	PYCR1	81936747	81937257	0	511	0	2584	0	2073	0.0	0.0
chr17	PYCR1	81932383	81933376	0	994	0	2584	0	1590	0.0	0.0
chr17	PYCR1	81936747	81937300	0	554	0	2584	0	2030	0.0	0.0
chr17	DUS1L	82058340	82058818	0	479	0	3907	0	3428	0.0	0.0
chr17	DPH1	2041767	2043898	2295	2132	8460	4551	6165	2419	1.076454033771107	2.548573790822654
chr17	SGSM2	2362837	2363134	8	298	5914	7230	5906	6932	0.026845637583892617	0.8519907674552799
chr17	PLD2	4818001	4818385	102	385	6591	4796	6489	4411	0.2649350649350649	1.4710949897982317
chr17	MINK1	4890221	4890735	15327	515	458480	6924	443153	6409	29.76116504854369	69.14542050241847
chr17	RNF167	4940486	4940993	0	508	0	2282	0	1774	0.0	0.0
chr17	XAF1	6759255	6759718	0	464	2958	6341	2958	5877	0.0	0.5033180193976519
chr17	ELP5	7258587	7259940	0	1354	14478	2734	14478	1380	0.0	10.491304347826087
chr17	EIF5A	7311349	7311651	3194	303	161522	2599	158328	2296	10.541254125412541	68.9581881533101
chr17	TNFSF13	7560723	7561601	0	879	1036	2282	1036	1403	0.0	0.7384176764076978
chr17	SENP3	7571372	7571969	541825	598	546890	3150	5065	2552	906.061872909699	1.984717868338558
chr17	EIF4A1	7577568	7578244	275151	677	1451973	4446	1176822	3769	406.42688330871493	312.23719819580793
chr17	EIF4A1	7577826	7578244	134584	419	1451973	4446	1317389	4027	321.2028639618138	327.13906133598215
chr17	SHBG	7630151	7630507	0	357	103669	1850	103669	1493	0.0	69.43670462156732
chr17	WRAP53	7688476	7689079	51	604	102	3629	51	3025	0.08443708609271523	0.016859504132231404
chr17	DNAH2	7770556	7770933	330	378	534685	16910	534355	16532	0.873015873015873	32.322465521413015
chr17	DNAH2	7786123	7786687	8863	565	534685	16910	525822	16345	15.686725663716814	32.170204955643925
chr17	CNTROB	7948486	7949137	0	652	245	5814	245	5162	0.0	0.04746222394420767
chr17	PFAS	8256266	8256648	0	383	72300	6403	72300	6020	0.0	12.009966777408637
chr17	RANGRF	8289257	8290092	306	836	268	1335	-38	499	0.3660287081339713	-0.07615230460921844
chr17	NDEL1	8443926	8444357	2376	432	25893	5059	23517	4627	5.5	5.0825588934514805
chr17	ARHGAP44	12955866	12955980	0	115	7881	7135	7881	7020	0.0	1.1226495726495727
chr17	ZNF286A	15700047	15700366	0	320	0	3177	0	2857	0.0	0.0
chr17	TBC1D26	15734703	15735070	0	368	204	5061	204	4693	0.0	0.043468996377583634
chr17	SNHG29	16441073	16442018	1122	946	86309	5724	85187	4778	1.186046511627907	17.82900795311846
chr17	SNHG29	16439326	16440253	1201	928	86309	5724	85108	4796	1.2941810344827587	17.745621351125937
chr17	SNHG29	16439036	16439414	1170	379	86309	5724	85139	5345	3.0870712401055407	15.928718428437792
chr17	SNHG29	16439326	16439703	288	378	86309	5724	86021	5346	0.7619047619047619	16.09072203516648
chr17	SNHG29	16439580	16440253	964	674	86309	5724	85345	5050	1.4302670623145401	16.9
chr17	SNHG29	16439037	16440253	2239	1217	86309	5724	84070	4507	1.839769926047658	18.65320612380741
chr17	SNHG29	16441073	16441502	1122	430	86309	5724	85187	5294	2.609302325581395	16.091235360785795
chr17	DRC3	17973664	17973962	0	299	24777	4609	24777	4310	0.0	5.748723897911833
chr17	DRG2	18099632	18100435	102	804	186286	6021	186184	5217	0.12686567164179105	35.687943262411345
chr17	KRT17P5	18420332	18421016	5148	685	13519	3166	8371	2481	7.515328467153284	3.3740427247077793
chr17	KRT17P5	18422180	18423064	430	885	13519	3166	13089	2281	0.4858757062146893	5.738272687417799
chr17	KRT16P1	18441694	18442343	3179	650	14892	2219	11713	1569	4.890769230769231	7.465264499681326
chr17	FBXW10	18749721	18750137	0	417	735	3798	735	3381	0.0	0.21739130434782608
chr17	EPN2	19281954	19283714	116564	1761	115264	7670	-1300	5909	66.19193639977286	-0.22000338466745642
chr17	ALDH3A2	19648750	19649124	0	375	26972	10618	26972	10243	0.0	2.633212925900615
chr17	ALDH3A2	19648780	19649124	0	345	26972	10618	26972	10273	0.0	2.6255232161978
chr17	CDRT15L2	20580148	20580911	51	764	51	1050	0	286	0.06675392670157068	0.0
chr17	NLK	28194581	28196381	0	1801	862	4703	862	2902	0.0	0.2970365265334252
chr17	PPY2P	28247443	28247950	3060	508	3060	659	0	151	6.0236220472440944	0.0
chr17	SLC13A2	28490306	28490590	0	285	1972	3238	1972	2953	0.0	0.667795462241788
chr17	SLC13A2	28493570	28494105	0	536	1972	3238	1972	2702	0.0	0.7298297557364914
chr17	NEK8	28737305	28737736	0	432	561	4426	561	3994	0.0	0.14046069103655484
chr17	ANKRD13B	29613353	29614761	204	1409	2703	3581	2499	2172	0.1447835344215756	1.1505524861878453
chr17	SUZ12P1	30768833	30769064	0	232	3232	3792	3232	3560	0.0	0.9078651685393259
chr17	TMEM98	32931326	32931659	0	334	0	4903	0	4569	0.0	0.0
chr17	TMEM132E	34626126	34627057	0	932	583	6124	583	5192	0.0	0.11228813559322035
chr17	TAF15	35844476	35845038	255	563	20390	5459	20135	4896	0.45293072824156305	4.112540849673203
chr17	CCL4L2	36211775	36212878	0	1104	0	988	0	-116	0.0	-0.0
chr17	ARHGAP23	38477578	38477896	0	319	70009	8109	70009	7790	0.0	8.987034659820283
chr17	CASC3	40163480	40164166	1428	687	135920	5412	134492	4725	2.078602620087336	28.463915343915343
chr17	NKIRAS2	42022398	42022640	0	243	0	4020	0	3777	0.0	0.0
chr17	COASY	42562147	42563322	1122	1176	1901	3038	779	1862	0.9540816326530612	0.41836734693877553
chr17	COASY	42562150	42562487	0	338	1901	3038	1901	2700	0.0	0.7040740740740741
chr17	NBR2	43138656	43140283	22310	1628	30888	3057	8578	1429	13.703931203931203	6.002799160251924
chr17	TMEM106A	43213020	43213252	3501	233	69150	3586	65649	3353	15.025751072961373	19.57918282135401
chr17	TMUB2	44188934	44189299	0	366	2028	3574	2028	3208	0.0	0.6321695760598504
chr17	TMUB2	44189021	44189299	0	279	2028	3574	2028	3295	0.0	0.6154779969650986
chr17	TMUB2	44188934	44189588	0	655	2028	3574	2028	2919	0.0	0.6947584789311408
chr17	GRN	44345264	44345605	135	342	1277	3085	1142	2743	0.39473684210526316	0.41633248268319356
chr17	GRN	44345301	44345605	24	305	1277	3085	1253	2780	0.07868852459016394	0.4507194244604317
chr17	DBF4B	44750594	44752264	2526	1671	2730	5975	204	4304	1.511669658886894	0.047397769516728624
chr17	ACBD4	45135686	45136232	51	547	17035	3521	16984	2974	0.09323583180987204	5.710827168796234
chr17	FMNL1	45241846	45242146	867	301	39242	6173	38375	5872	2.8803986710963456	6.5352520435967305
chr17	FMNL1	45246209	45246604	1686	396	39242	6173	37556	5777	4.257575757575758	6.500952051237666
chr17	MAP3K14-AS1	45267112	45267490	0	379	13506	4874	13506	4495	0.0	3.0046718576195772
chr17	GOSR2	46923171	46923632	7464	462	279358	11566	271894	11104	16.155844155844157	24.486131123919307
chr17	NPEPPS	47619008	47619784	51	777	36399	9467	36348	8690	0.06563706563706563	4.182738780207135
chr17	NPEPPS	47586364	47587344	0	981	36399	9467	36399	8486	0.0	4.28930002356823
chr17	NPEPPS	47585499	47586398	102	900	36399	9467	36297	8567	0.11333333333333333	4.236839033500642
chr17	NPEPPS	47619277	47619784	0	508	36399	9467	36399	8959	0.0	4.062841835026231
chr17	LRRC46	47834424	47835399	0	976	51	2544	51	1568	0.0	0.032525510204081634
chr17	PNPO	47944615	47945612	0	998	0	4987	0	3989	0.0	0.0
chr17	CDK5RAP3	47981436	47981772	0	337	0	4158	0	3821	0.0	0.0
chr17	CDK5RAP3	47971121	47971407	0	287	0	4158	0	3871	0.0	0.0
chr17	CDK5RAP3	47981436	47981768	0	333	0	4158	0	3825	0.0	0.0
chr17	NFE2L1	48050606	48051628	10302	1023	10434	5475	132	4452	10.070381231671554	0.029649595687331536
chr17	THRA1/BTR	48294346	48294515	0	170	0	1575	0	1405	0.0	0.0
chr17	FLJ40194	49252853	49253133	0	281	85156	4893	85156	4612	0.0	18.46400693842151
chr17	FLJ40194	49252245	49252918	102	674	85156	4893	85054	4219	0.1513353115727003	20.15975349608912
chr17	ITGA3	50075458	50075735	0	278	0	8655	0	8377	0.0	0.0
chr17	AC015909.1	50214100	50214775	0	676	0	2615	0	1939	0.0	0.0
chr17	EME1	50375184	50375983	0	800	0	3178	0	2378	0.0	0.0
chr17	EPN3	50536420	50537118	0	699	153	4499	153	3800	0.0	0.04026315789473684
chr17	SPATA20	50549984	50550312	0	329	0	4742	0	4413	0.0	0.0
chr17	CACNA1G	50626016	50626766	0	751	357	10101	357	9350	0.0	0.038181818181818185
chr17	ABCC3	50677743	50678219	0	477	0	8868	0	8391	0.0	0.0
chr17	AKAP1	57120249	57121342	180	1094	27339	5359	27159	4265	0.16453382084095064	6.367878077373974
chr17	RPS6KB1	59936214	59936541	0	328	26722	5329	26722	5001	0.0	5.3433313337332535
chr17	KCNH6	63535668	63536068	1010	401	5852	4226	4842	3825	2.518703241895262	1.2658823529411765
chr17	BPTF	67893369	67893725	0	357	0	14493	0	14136	0.0	0.0
chr17	AMZ2	68248042	68248705	0	664	0	3654	0	2990	0.0	0.0
chr17	RPL38	74203703	74203958	0	256	51	3653	51	3397	0.0	0.015013246982631734
chr17	RAB37	74745007	74747334	2045	2328	40497	4785	38452	2457	0.8784364261168385	15.64997964997965
chr17	RAB37	74745305	74747335	1885	2031	40497	4785	38612	2754	0.9281142294436239	14.020334059549747
chr17	RAB37	74745007	74747335	2045	2329	40497	4785	38452	2456	0.8780592528982396	15.656351791530945
chr17	RAB37	74745305	74747334	1885	2030	40497	4785	38612	2755	0.9285714285714286	14.01524500907441
chr17	NUP85	75234636	75235201	51	566	31814	4297	31763	3731	0.09010600706713781	8.513267220584293
chr17	MYO15B	75590906	75591246	0	341	194	12656	194	12315	0.0	0.015753146569224524
chr17	MYO15B	75620466	75621176	0	711	194	12656	194	11945	0.0	0.016241105064880704
chr17	SAP30BP	75705610	75706092	0	483	0	7603	0	7120	0.0	0.0
chr17	ITGB4	75757199	75757818	0	620	0	6607	0	5987	0.0	0.0
chr17	PRCD	76543802	76544370	102	569	102	5045	0	4476	0.17926186291739896	0.0
chr17	SNHG16	76557969	76558600	0	632	102	5256	102	4624	0.0	0.022058823529411766
chr17	SNHG16	76558373	76559043	0	671	102	5256	102	4585	0.0	0.022246455834242094
chr17	SNHG16	76557777	76559043	0	1267	102	5256	102	3989	0.0	0.025570318375532714
chr17	SNHG20	77088748	77089271	0	524	0	4357	0	3833	0.0	0.0
chr17	SEC14L1	77213917	77216802	0	2886	102	8098	102	5212	0.0	0.019570222563315427
chr17	SEC14L1	77213917	77217101	0	3185	102	8098	102	4913	0.0	0.020761245674740483
chr17	ENDOV	80429772	80430343	0	572	124386	6269	124386	5697	0.0	21.83359662980516
chr17	ENDOV	80415452	80415821	9425	370	124386	6269	114961	5899	25.472972972972972	19.48821834209188
chr17	ENDOV	80415468	80415821	8865	354	124386	6269	115521	5915	25.04237288135593	19.5301775147929
chr17	HGS	81696606	81696747	0	142	0	8542	0	8400	0.0	0.0
chr17	HGS	81700466	81700600	0	135	0	8542	0	8407	0.0	0.0
chr17	HGS	81701243	81701929	0	687	0	8542	0	7855	0.0	0.0
chr17	GCGR	81811403	81811810	0	408	0	3158	0	2750	0.0	0.0
chr17	GCGR	81812806	81813057	0	252	0	3158	0	2906	0.0	0.0
chr17	SLC16A3	82235982	82236231	0	250	0	5874	0	5624	0.0	0.0
chr17	HEXD	82440996	82441266	0	271	0	4126	0	3855	0.0	0.0
chr17	HEXD	82439630	82440334	0	705	0	4126	0	3421	0.0	0.0
chr18	LINC00667	5238080	5241889	242786	3810	386439	9559	143653	5749	63.723359580052495	24.98747608279701
chr18	LINC00667	5240647	5241889	30060	1243	386439	9559	356379	8316	24.18342719227675	42.8546176046176
chr18	CEP192	13057584	13059312	11241	1729	223433	8599	212192	6870	6.501445922498554	30.886754002911207
chr18	IMPACT	24450778	24453531	0	2754	102	4343	102	1589	0.0	0.06419131529263687
chr18	LINC01915	24694255	24694999	0	745	408	10136	408	9391	0.0	0.04344585241188372
chr18	AQP4-AS1	26933615	26935904	0	2290	0	9052	0	6762	0.0	0.0
chr18	LINC01902	39870829	39876450	3162	5622	3162	12838	0	7216	0.5624332977588047	0.0
chr18	LINC01902	39870829	39875941	3162	5113	3162	12838	0	7725	0.6184236260512419	0.0
chr18	LINC01630	51561180	51564479	52	3300	103	17204	51	13904	0.01575757575757576	0.0036680092059838895
chr18	LINC01919	53577418	53578121	0	704	0	3770	0	3066	0.0	0.0
chr18	ZNF532	58864876	58865385	0	510	51	9593	51	9083	0.0	0.005614884949906419
chr18	LINC01924	64158862	64159294	0	433	0	3465	0	3032	0.0	0.0
chr18	SALL3	78992073	78994905	0	2833	0	7010	0	4177	0.0	0.0
chr18	SALL3	78992073	78995462	0	3390	0	7010	0	3620	0.0	0.0
chr18	MYOM1	3134649	3134824	0	176	7061	6472	7061	6296	0.0	1.1215057179161372
chr18	MYOM1	3149144	3149201	0	58	7061	6472	7061	6414	0.0	1.1008730901153727
chr18	EPB41L3	5398020	5401043	29	3024	510	9610	481	6586	0.00958994708994709	0.07303370786516854
chr18	RPRD1A	35989823	35993300	0	3478	0	5239	0	1761	0.0	0.0
chr18	RPRD1A	36025598	36027075	0	1478	0	5239	0	3761	0.0	0.0
chr18	MIR924HG	39206916	39208789	0	1874	51	11691	51	9817	0.0	0.005195069776917592
chr18	SYT4	43273579	43274394	0	816	40	2529	40	1713	0.0	0.023350846468184472
chr18	AC090376.1	45149916	45150266	0	351	72	3400	72	3049	0.0	0.02361429977041653
chr18	RPL17	49491531	49491833	0	303	102	2096	102	1793	0.0	0.05688789737869492
chr18	TCF4	55227848	55228361	232	514	105042	22459	104810	21945	0.45136186770428016	4.776030986557302
chr18	LINC00305	64148774	64149074	0	301	40	2884	40	2583	0.0	0.01548586914440573
chr18	LINC00305	64148774	64149088	0	315	40	2884	40	2569	0.0	0.015570260801868432
chr18	MBP	77016831	77017065	0	235	51	6992	51	6757	0.0	0.007547728281781856
chr19	WASH5P	65821	66499	41947	679	177770	2546	135823	1867	61.77761413843888	72.74933047670059
chr19	PLPPR3	814433	814749	26502	317	175456	2397	148954	2080	83.60252365930599	71.6125
chr19	PLPPR3	821484	821955	11052	472	175456	2397	164404	1925	23.415254237288135	85.40467532467532
chr19	MED16	867962	868499	48024	538	326503	3907	278479	3369	89.2639405204461	82.65924606708222
chr19	TMEM259	1011366	1011612	107939	247	839035	3940	731096	3693	437.0	197.96804765773084
chr19	CBARP	1228286	1231275	19483	2990	54771	2939	35288	-51	6.516053511705685	-691.9215686274509
chr19	TCF3	1609289	1611849	764369	2561	1279548	5864	515179	3303	298.4650527137837	155.97305479866787
chr19	TCF3	1609291	1611849	764364	2559	1279548	5864	515184	3305	298.6963657678781	155.8801815431165
chr19	TCF3	1619110	1619474	110345	365	1279548	5864	1169203	5499	302.3150684931507	212.62102200400074
chr19	TCF3	1615284	1615821	148954	538	1279548	5864	1130594	5326	276.86617100371745	212.27825760420578
chr19	KLF16	1852398	1854760	247002	2363	296562	2969	49560	606	104.5289885738468	81.78217821782178
chr19	MKNK2	2037464	2039856	225203	2393	410991	5232	185788	2839	94.1090681153364	65.44135258893976
chr19	PLEKHJ1	2233153	2234061	235177	909	439258	3179	204081	2270	258.72057205720574	89.90352422907489
chr19	PLEKHJ1	2235761	2235990	41006	230	439258	3179	398252	2949	178.28695652173914	135.04645642590708
chr19	LSM7	2328386	2328586	17915	201	203833	1691	185918	1490	89.12935323383084	124.77718120805369
chr19	MFSD12	3544198	3544732	58202	535	832398	4683	774196	4148	108.78878504672898	186.64320154291224
chr19	CACTIN	3610644	3612413	96946	1770	268594	5168	171648	3398	54.77175141242938	50.514420247204235
chr19	LONP1	5719703	5720146	71294	444	1864515	5053	1793221	4609	160.57207207207207	389.06942937730526
chr19	SLC25A41	6426036	6426561	0	526	4474	1657	4474	1131	0.0	3.95579133510168
chr19	SH2D3A	6754051	6754425	1122	375	9831	5600	8709	5225	2.992	1.6667942583732058
chr19	ADGRE4P	6981079	6981770	0	692	80	3337	80	2645	0.0	0.030245746691871456
chr19	CD209	7747305	7747511	142467	207	163105	4420	20638	4213	688.2463768115942	4.898647044861144
chr19	ADAMTS10	8585131	8585660	51	530	19837	5729	19786	5199	0.09622641509433963	3.8057318715137525
chr19	ZNF266	9418761	9419299	24	539	11502	4513	11478	3974	0.04452690166975881	2.8882737795671867
chr19	ZGLP1	10308184	10308550	0	367	35279	1531	35279	1164	0.0	30.308419243986254
chr19	RAVER1	10320654	10320951	0	298	6883	4719	6883	4421	0.0	1.5568875819950236
chr19	ICAM3	10335065	10335976	13262	912	11984	2076	-1278	1164	14.541666666666666	-1.097938144329897
chr19	ICAM3	10338681	10339245	255	565	11984	2076	11729	1511	0.45132743362831856	7.762409000661814
chr19	CDC37	10395227	10395543	137420	317	767713	3052	630293	2735	433.50157728706625	230.45447897623401
chr19	CDC37	10395227	10395696	283697	470	767713	3052	484016	2582	603.6106382978724	187.4577846630519
chr19	AP1M2	10583605	10584070	0	466	71883	2145	71883	1679	0.0	42.81298391899941
chr19	TMEM205	11345519	11346268	51	750	18687	1389	18636	639	0.068	29.164319248826292
chr19	ECSIT	11507701	11508048	459	348	2186	2365	1727	2017	1.3189655172413792	0.8562221120475955
chr19	ACP5	11577592	11578194	218	603	450	2095	232	1492	0.3615257048092869	0.1554959785522788
chr19	RTBDN	12834784	12835415	145	632	392348	2684	392203	2052	0.22943037974683544	191.13206627680313
chr19	STX10	13144061	13144671	663	611	1632	1305	969	694	1.0851063829787233	1.3962536023054755
chr19	DNAJB1	14514781	14517046	16972	2266	141620	7011	124648	4745	7.489849955869373	26.269336143308745
chr19	SLC1A6	14976760	14977777	0	1018	0	7643	0	6625	0.0	0.0
chr19	AKAP8L	15403474	15403715	102	242	3971	4512	3869	4270	0.4214876033057851	0.9060889929742388
chr19	RASAL3	15451623	15452815	1020	1193	20251	4353	19231	3160	0.8549874266554903	6.085759493670886
chr19	RASAL3	15452044	15452815	0	772	20251	4353	20251	3581	0.0	5.655124266964535
chr19	PGLYRP2	15468644	15469929	56018	1286	67441	3114	11423	1828	43.559875583203734	6.24890590809628
chr19	SMIM7	16646147	16647261	45886	1115	242901	4512	197015	3397	41.153363228699554	57.99676184869002
chr19	USHBP1	17258211	17258701	0	491	17973	5041	17973	4550	0.0	3.95010989010989
chr19	USHBP1	17262551	17264150	14145	1600	17973	5041	3828	3441	8.840625	1.112467306015693
chr19	IQCN	18264923	18267526	66401	2604	91375	7022	24974	4418	25.499615975422426	5.652784065187868
chr19	ISYNA1	18437598	18437988	0	391	0	3012	0	2621	0.0	0.0
chr19	ISYNA1	18437859	18438162	0	304	0	3012	0	2708	0.0	0.0
chr19	COMP	18790849	18791305	0	457	51	3110	51	2653	0.0	0.019223520542781758
chr19	SUGP2	18994365	18995280	39630	916	278945	6566	239315	5650	43.26419213973799	42.356637168141596
chr19	SUGP2	19024618	19026226	273	1609	278945	6566	278672	4957	0.16967060285891858	56.21787371393988
chr19	SUGP2	19004167	19004646	33174	480	278945	6566	245771	6086	69.1125	40.38301018731515
chr19	ZNF506	19791561	19792484	28761	924	99417	6969	70656	6045	31.126623376623378	11.688337468982631
chr19	ZNF208	21986727	21987311	0	585	7835	6782	7835	6197	0.0	1.2643214458609005
chr19	LINC01859	23023345	23024353	0	1009	102	3966	102	2957	0.0	0.034494420020290836
chr19	LINC01859	23023345	23024278	0	934	102	3966	102	3032	0.0	0.033641160949868076
chr19	LINC00662	27792999	27793899	0	901	255	28747	255	27846	0.0	0.009157509157509158
chr19	LINC00662	27792999	27794003	0	1005	255	28747	255	27742	0.0	0.009191839088746306
chr19	LINC01837	31886625	31886978	0	354	1692	7200	1692	6846	0.0	0.24715162138475022
chr19	LINC01837	31910173	31910613	0	441	1692	7200	1692	6759	0.0	0.25033288948069243
chr19	LINC01837	31966703	31967633	0	931	1692	7200	1692	6269	0.0	0.2698995055032701
chr19	SLC7A9	32859840	32860650	24	811	3219	2601	3195	1790	0.029593094944512947	1.7849162011173185
chr19	AC008555.4	34860173	34860715	203	543	2601	1105	2398	562	0.3738489871086556	4.266903914590747
chr19	LINC00904	34902201	34903083	51	883	205839	3576	205788	2693	0.057757644394110984	76.4158930560713
chr19	LGI4	35126269	35127017	3791	749	4633	4379	842	3630	5.061415220293725	0.23195592286501376
chr19	DMKN	35510183	35510427	67856	245	193822	4934	125966	4689	276.9632653061224	26.864150138622307
chr19	DMKN	35499957	35500580	86694	624	193822	4934	107128	4310	138.93269230769232	24.855684454756382
chr19	DMKN	35500377	35500580	0	204	193822	4934	193822	4730	0.0	40.97716701902748
chr19	DMKN	35510183	35510510	77924	328	193822	4934	115898	4606	237.5731707317073	25.162396873643075
chr19	U2AF1L4	35743154	35743345	0	192	102	2606	102	2414	0.0	0.04225352112676056
chr19	LINC01529	35789406	35789928	0	523	12	4162	12	3639	0.0	0.0032976092333058533
chr19	LINC01529	35791016	35791852	0	837	12	4162	12	3325	0.0	0.0036090225563909775
chr19	LINC00665	36324923	36327225	51	2303	75161	10527	75110	8224	0.02214502822405558	9.133025291828794
chr19	AC016590.1	37266813	37267611	11200	799	25837	2744	14637	1945	14.017521902377972	7.5254498714652955
chr19	RASGRP4	38409057	38410096	561	1040	4005	4074	3444	3034	0.5394230769230769	1.135135135135135
chr19	RASGRP4	38411114	38411381	2254	268	4005	4074	1751	3806	8.41044776119403	0.4600630583289543
chr19	MAP4K1	38607863	38608033	0	171	23888	3852	23888	3681	0.0	6.489540885628905
chr19	LGALS4	38812430	38812945	1836	516	5088	1410	3252	894	3.558139534883721	3.6375838926174495
chr19	HNRNPL	38840095	38840559	153	465	391	5612	238	5147	0.32903225806451614	0.04624052846318244
chr19	CCER2	38908979	38909325	0	347	0	1062	0	715	0.0	0.0
chr19	GMFG	39328358	39329073	138370	716	698429	1395	560059	679	193.25418994413408	824.8291605301914
chr19	RPS16	39433521	39433761	6014	241	116105	1461	110091	1220	24.95435684647303	90.23852459016393
chr19	RPS16	39433222	39433569	51669	348	116105	1461	64436	1113	148.47413793103448	57.893980233602875
chr19	DYRK1B	39826671	39826987	102	317	2488	3204	2386	2887	0.3217665615141956	0.8264634568756495
chr19	FBL	39834457	39834813	6412	357	35643	2147	29231	1790	17.96078431372549	16.330167597765364
chr19	FBL	39840616	39840787	7701	172	35643	2147	27942	1975	44.77325581395349	14.147848101265822
chr19	CCNP	40222207	40223303	51	1097	51	2051	0	954	0.04649042844120328	0.0
chr19	C19ORF47	40321062	40322376	59231	1315	253999	2632	194768	1317	45.042585551330795	147.88762338648442
chr19	PRX	40393767	40398816	0	5050	0	6803	0	1753	0.0	0.0
chr19	BLVRB	40458173	40458545	0	373	5655	1617	5655	1244	0.0	4.545819935691318
chr19	COQ8B	40705095	40705447	4218	353	37112	11023	32894	10670	11.94900849858357	3.0828491096532336
chr19	COQ8B	40716586	40716882	1924	297	37112	11023	35188	10726	6.478114478114478	3.2806265150102556
chr19	PCAT19	41456360	41457149	51	790	152	5541	101	4751	0.06455696202531645	0.021258682382656283
chr19	PCAT19	41454168	41456487	152	2320	152	5541	0	3221	0.06551724137931035	0.0
chr19	ATP1A3	41966581	41967340	0	760	84	5613	84	4853	0.0	0.01730888110447146
chr19	GSK3A	42230189	42230867	0	679	51	5487	51	4808	0.0	0.010607321131447587
chr19	GSK3A	42242182	42242602	0	421	51	5487	51	5066	0.0	0.010067114093959731
chr19	KCNN4	43766532	43767707	11	1176	4672	3224	4661	2048	0.00935374149659864	2.27587890625
chr19	KCNN4	43774191	43774619	918	429	4672	3224	3754	2795	2.13986013986014	1.3431127012522361
chr19	EML2	45638504	45638873	765	370	38578	6562	37813	6192	2.0675675675675675	6.106750645994832
chr19	IGFL2-AS1	46189028	46190414	202	1387	52041	3342	51839	1955	0.14563806777217014	26.51611253196931
chr19	PRKD2	46716130	46717114	27221	985	53693	5270	26472	4285	27.635532994923857	6.177829638273045
chr19	KPTN	47483934	47484219	2222	286	6020	2116	3798	1830	7.769230769230769	2.0754098360655737
chr19	CCDC114	48296461	48297668	255	1208	386	5076	131	3868	0.21109271523178808	0.03386763185108583
chr19	RPL18	48615330	48615946	0	617	72742	1757	72742	1140	0.0	63.80877192982456
chr19	FUT1	48752489	48753122	20424	634	36732	4347	16308	3713	32.214511041009466	4.392135739294371
chr19	FUT1	48752611	48753122	20195	512	36732	4347	16537	3835	39.443359375	4.31212516297262
chr19	CGB7	49057120	49058057	0	938	51	2976	51	2038	0.0	0.025024533856722278
chr19	IRF3	49664673	49665857	712	1185	39279	3464	38567	2279	0.60084388185654	16.922773146116718
chr19	NUP62	49927693	49929504	51	1812	97	2772	46	960	0.028145695364238412	0.04791666666666667
chr19	KCNC3	50311936	50316091	224620	4156	247146	6800	22526	2644	54.04716073147257	8.5196671709531
chr19	KLK12	51029093	51029457	0	365	0	1762	0	1397	0.0	0.0
chr19	KLK12	51029129	51029457	0	329	0	1762	0	1433	0.0	0.0
chr19	NKG7	51371939	51372202	0	264	0	924	0	660	0.0	0.0
chr19	ZNF577	51886820	51887951	0	1132	3742	5101	3742	3969	0.0	0.9428067523305619
chr19	ZNF577	51886820	51887936	0	1117	3742	5101	3742	3984	0.0	0.9392570281124498
chr19	ZNF649	51899797	51900294	3366	498	3724	3541	358	3043	6.759036144578313	0.11764705882352941
chr19	ZNF528-AS1	52396609	52397267	153	659	68922	4684	68769	4025	0.2321699544764795	17.085465838509318
chr19	ZNF160	53091412	53091720	854	309	95953	7275	95099	6966	2.763754045307443	13.651880562733275
chr19	OSCAR	54094669	54096153	51	1485	51	2089	0	604	0.03434343434343434	0.0
chr19	HSPBP1	55279398	55279856	0	459	0	1861	0	1402	0.0	0.0
chr19	FAM71E2	55360692	55360905	0	214	0	3231	0	3017	0.0	0.0
chr19	ZSCAN5B	56192668	56193179	0	512	182675	2064	182675	1552	0.0	117.70296391752578
chr19	ZNF154	57697366	57701145	561	3780	4546	5717	3985	1937	0.1484126984126984	2.0573051109963862
chr19	CHMP2A	58551565	58551967	0	403	102	1713	102	1310	0.0	0.07786259541984733
chr19	FSTL3	681332	681771	46448	440	250629	3031	204181	2591	105.56363636363636	78.8039367039753
chr19	PTBP1	804291	804702	496564	412	4591127	6449	4094563	6037	1205.2524271844661	678.2446579426868
chr19	ABCA7	1056906	1057429	8638	524	187592	8487	178954	7963	16.484732824427482	22.47318849679769
chr19	ARHGAP45	1080254	1080547	37469	294	605581	6133	568112	5839	127.44557823129252	97.2961123480048
chr19	GPX4	1105365	1105510	747669	146	2741694	1885	1994025	1739	5121.020547945205	1146.6503737780333
chr19	ATP5F1D	1244314	1244825	182829	512	460434	2003	277605	1491	357.087890625	186.1871227364185
chr19	CIRBP	1271980	1273172	2470259	1193	2975831	5567	505572	4374	2070.6278290025148	115.58573388203018
chr19	CIRBP	1271139	1271467	160784	329	2975831	5567	2815047	5238	488.7051671732523	537.4278350515464
chr19	CIRBP	1271139	1271632	168204	494	2975831	5567	2807627	5073	340.49392712550605	553.4451015178396
chr19	CIRBP	1271980	1274810	2743639	2831	2975831	5567	232192	2736	969.1412928293889	84.86549707602339
chr19	CIRBP	1271139	1271365	133732	227	2975831	5567	2842099	5340	589.1277533039647	532.228277153558
chr19	CIRBP	1271980	1274440	2717582	2461	2975831	5567	258249	3106	1104.259244209671	83.14520283322601
chr19	CIRBP	1274306	1274810	50165	505	2975831	5567	2925666	5062	99.33663366336634	577.9664164361913
chr19	NDUFS7	1393241	1395584	88621	2344	242247	4310	153626	1966	37.80759385665529	78.1414038657172
chr19	RPS15	1440018	1440494	1861579	477	2178720	1135	317141	658	3902.6813417190774	481.9772036474164
chr19	CSNK1G2	1978304	1978511	33693	208	430261	3302	396568	3094	161.98557692307693	128.17323852617972
chr19	IZUMO4	2097251	2097495	51	245	2464	2228	2413	1983	0.20816326530612245	1.2168431669188098
chr19	OAZ1	2271384	2271530	401724	147	2684215	2110	2282491	1963	2732.816326530612	1162.7564951604686
chr19	GADD45B	2476355	2476630	38621	276	211420	1599	172799	1323	139.93115942028984	130.61148904006046
chr19	NCLN	3207628	3209575	270767	1948	612717	2813	341950	865	138.99743326488706	395.3179190751445
chr19	HMG20B	3572978	3573347	11234	370	1164444	3473	1153210	3103	30.36216216216216	371.6435707379955
chr19	NMRK2	3938602	3938759	0	158	346	1149	346	991	0.0	0.3491422805247225
chr19	MIR7-3HG	4769132	4769351	0	220	0	2134	0	1914	0.0	0.0
chr19	MIR7-3HG	4769629	4770449	0	821	0	2134	0	1313	0.0	0.0
chr19	CRB3	6466465	6467221	405	757	1997	1605	1592	848	0.535006605019815	1.8773584905660377
chr19	ARHGEF18	7470125	7472477	1989	2353	3939	6116	1950	3763	0.8453038674033149	0.5182035609885729
chr19	ANGPTL4	8373704	8374370	7036	667	8411	2482	1375	1815	10.548725637181409	0.7575757575757576
chr19	HNRNPM	8465323	8465515	255	193	26584	4301	26329	4108	1.3212435233160622	6.409201557935735
chr19	ZNF561-AS1	9626783	9627806	0	1024	94379	6441	94379	5417	0.0	17.422743215802104
chr19	PIN1	9849089	9849682	57	594	421	2938	364	2344	0.09595959595959595	0.1552901023890785
chr19	SHFL	10089110	10089378	0	269	0	3788	0	3519	0.0	0.0
chr19	SHFL	10089306	10089695	0	390	0	3788	0	3398	0.0	0.0
chr19	PDE4A	10461525	10461999	166525	475	332723	6586	166198	6111	350.57894736842104	27.19653084601538
chr19	ATG4D	10544782	10545130	0	349	1544	2174	1544	1825	0.0	0.846027397260274
chr19	ATG4D	10551896	10552121	0	226	1544	2174	1544	1948	0.0	0.7926078028747433
chr19	ILF3	10683916	10685765	1567	1850	61657	9698	60090	7848	0.847027027027027	7.6567278287461775
chr19	QTRT1	10712160	10712628	0	469	15045	2287	15045	1818	0.0	8.275577557755776
chr19	PRKCSH	11436040	11436505	34563	466	155072	4436	120509	3970	74.1695278969957	30.354911838790933
chr19	GCDH	12891159	12891395	102	237	4111	4015	4009	3778	0.43037974683544306	1.0611434621492852
chr19	CCDC130	13758867	13759272	51	406	51	3082	0	2676	0.12561576354679804	0.0
chr19	CYP4F12	15696160	15696512	72	353	123	4073	51	3720	0.20396600566572237	0.013709677419354839
chr19	CYP4F12	15683492	15684882	0	1391	123	4073	123	2682	0.0	0.04586129753914989
chr19	UCA1	15834501	15836327	561	1827	561	2973	0	1146	0.3070607553366174	0.0
chr19	UCA1	15828950	15829338	0	389	561	2973	561	2584	0.0	0.21710526315789475
chr19	UCA1	15828957	15829338	0	382	561	2973	561	2591	0.0	0.21651871864145117
chr19	UCA1	15834501	15835417	561	917	561	2973	0	2056	0.6117775354416576	0.0
chr19	UCA1	15835217	15836240	0	1024	561	2973	561	1949	0.0	0.2878399179066188
chr19	UCA1	15834501	15835416	561	916	561	2973	0	2057	0.6124454148471615	0.0
chr19	UCA1	15834501	15835419	561	919	561	2973	0	2054	0.6104461371055495	0.0
chr19	UCA1	15834501	15835280	561	780	561	2973	0	2193	0.7192307692307692	0.0
chr19	LINC00905	16034479	16035012	0	534	5	3588	5	3054	0.0	0.0016371971185330713
chr19	TPM4	16095263	16095893	0	631	51	9477	51	8846	0.0	0.005765317657698395
chr19	HSH2D	16152551	16153208	0	658	102	3407	102	2749	0.0	0.03710440160058203
chr19	MYO9B	17211650	17213284	236117	1635	248138	9359	12021	7724	144.41406727828746	1.5563179699637493
chr19	OCEL1	17228802	17229215	194	414	3283	1754	3089	1340	0.46859903381642515	2.305223880597015
chr19	BABAM1	17268793	17269091	123	299	12248	1792	12125	1493	0.411371237458194	8.121232417950436
chr19	GTPBP3	17338953	17339266	14844	314	85313	3908	70469	3594	47.27388535031847	19.60740122426266
chr19	BISPR	17413096	17413305	451	210	9874	3025	9423	2815	2.1476190476190475	3.347424511545293
chr19	BISPR	17405740	17406296	3055	557	9874	3025	6819	2468	5.484739676840215	2.762965964343598
chr19	MVB12A	17424930	17425332	14419	403	55436	3168	41017	2765	35.779156327543426	14.834358047016275
chr19	SLC27A1	17486562	17487335	0	774	0	6378	0	5604	0.0	0.0
chr19	RPL18A	17861292	17861472	0	181	204	2968	204	2787	0.0	0.07319698600645856
chr19	ARRDC2	18008169	18008584	0	416	208	3861	208	3445	0.0	0.06037735849056604
chr19	UBA52	18574869	18575241	0	373	38683	2211	38683	1838	0.0	21.046245919477695
chr19	ZNF714	21116806	21125094	43450	8289	43987	9849	537	1560	5.2418868379780434	0.34423076923076923
chr19	GOLGA2P9	22601359	22602038	102	680	352	2661	250	1981	0.15	0.12619888944977284
chr19	AC092279.1	24065462	24066750	0	1289	8378	11997	8378	10708	0.0	0.7824056779977587
chr19	AC006504.5	27805604	27806185	0	582	0	13629	0	13047	0.0	0.0
chr19	AC006504.5	27805927	27806782	0	856	0	13629	0	12773	0.0	0.0
chr19	AC006504.5	27805604	27806782	0	1179	0	13629	0	12450	0.0	0.0
chr19	AC079466.1	28610981	28612154	0	1174	0	4063	0	2889	0.0	0.0
chr19	LINC00906	28967804	28969042	51	1239	79	6203	28	4964	0.04116222760290557	0.0056406124093473006
chr19	LINC00906	28970200	28970670	0	471	79	6203	79	5732	0.0	0.013782274947662248
chr19	LINC01532	29012510	29013108	0	599	0	4140	0	3541	0.0	0.0
chr19	LINC01791	31167512	31167833	0	322	0	3441	0	3119	0.0	0.0
chr19	LINC01533	32039492	32040570	0	1079	0	3749	0	2670	0.0	0.0
chr19	TDRD12	32826097	32826357	0	261	95	7059	95	6798	0.0	0.013974698440717859
chr19	GARRE1	34299678	34300968	918	1291	2440	7440	1522	6149	0.7110766847405112	0.2475199219385266
chr19	SCN1B	35039634	35040449	0	816	413	4311	413	3495	0.0	0.11816881258941345
chr19	HPN	35041721	35042522	0	802	51	3344	51	2542	0.0	0.02006294256490952
chr19	FXYD3	35122764	35122954	0	191	2622	3345	2622	3154	0.0	0.8313253012048193
chr19	FXYD1	35142719	35143035	0	317	789	1919	789	1602	0.0	0.49250936329588013
chr19	FXYD1	35142719	35143050	0	332	789	1919	789	1587	0.0	0.497164461247637
chr19	FXYD7	35151253	35151482	0	230	9573	1691	9573	1461	0.0	6.552361396303901
chr19	USF2	35269445	35269699	0	255	0	2816	0	2561	0.0	0.0
chr19	USF2	35278697	35279074	0	378	0	2816	0	2438	0.0	0.0
chr19	LINC01531	35406584	35409151	16219	2568	16710	3495	491	927	6.315809968847352	0.5296655879180151
chr19	LINC01766	35600640	35601499	0	860	836	971	836	111	0.0	7.531531531531532
chr19	LINC01766	35600640	35601501	0	862	836	971	836	109	0.0	7.669724770642202
chr19	HAUS5	35619612	35620123	0	512	13082	5031	13082	4519	0.0	2.8948882496127464
chr19	ETV2	35642433	35642698	6655	266	29563	2008	22908	1742	25.018796992481203	13.150401836969001
chr19	LIN37	35753086	35754157	3625	1072	5170	2440	1545	1368	3.3815298507462686	1.1293859649122806
chr19	PROSER3	35766767	35768065	20328	1299	205201	4865	184873	3566	15.648960739030024	51.843241727425685
chr19	ARHGAP33	35787167	35788822	0	1656	63	4441	63	2785	0.0	0.022621184919210054
chr19	ZNF568	36949511	36952741	4284	3231	21898	9232	17614	6001	1.3259052924791086	2.9351774704215963
chr19	LINC01535	37262541	37265532	9525	2992	5142	2437	-4383	-555	3.1834893048128343	7.897297297297297
chr19	CATSPERG	38362375	38362832	0	458	396	6878	396	6420	0.0	0.0616822429906542
chr19	FAM98C	38403337	38403694	0	358	6527	2931	6527	2573	0.0	2.5367275553828215
chr19	ACP7	39100579	39100853	739	275	275093	3057	274354	2782	2.6872727272727275	98.61754133716751
chr19	SAMD4B	39380586	39380785	22674	200	211621	5835	188947	5635	113.37	33.53096716947648
chr19	SELENOV	39518607	39518632	0	26	112179	1738	112179	1712	0.0	65.52511682242991
chr19	PLD3	40365552	40365930	0	379	937	4360	937	3981	0.0	0.23536799799045466
chr19	SPTBN4	40549188	40549413	704	226	70491	11711	69787	11485	3.1150442477876106	6.076360470178494
chr19	EGLN2	40807808	40808432	204	625	18931	5469	18727	4844	0.3264	3.866019818331957
chr19	HNRNPUL1	41264371	41264798	561	428	332756	6669	332195	6241	1.310747663551402	53.22784810126582
chr19	TMEM91	41382771	41384083	714	1313	707	1776	-7	463	0.5437928408225438	-0.01511879049676026
chr19	DMRTC2	41850311	41850700	43593	390	112930	2448	69337	2058	111.77692307692308	33.69144800777454
chr19	CD79A	41878989	41879653	16335	665	21271	1348	4936	683	24.56390977443609	7.2269399707174236
chr19	PRR19	42309578	42310813	38	1236	46	2578	8	1342	0.030744336569579287	0.005961251862891207
chr19	TMEM145	42323582	42325064	51	1483	0	2662	-51	1179	0.03438975050573163	-0.043256997455470736
chr19	ZNF226	44165587	44165807	1052	221	136153	5116	135101	4895	4.760180995475113	27.59979570990807
chr19	BCAM	44819581	44820822	3265	1242	6611	4838	3346	3596	2.6288244766505637	0.9304783092324805
chr19	APOC1P1	44926803	44927033	0	231	16434	925	16434	694	0.0	23.680115273775215
chr19	FKRP	46748514	46748884	0	371	51	5171	51	4800	0.0	0.010625
chr19	SELENOW	47780724	47780749	66	26	70412	2027	70346	2001	2.5384615384615383	35.155422288855576
chr19	ZSWIM9	48194652	48197620	8357	2969	19672	3768	11315	799	2.8147524418996297	14.16145181476846
chr19	BAX	48955686	48955833	0	148	116995	1767	116995	1619	0.0	72.26374305126622
chr19	BAX	48960809	48961798	59156	990	116995	1767	57839	777	59.753535353535355	74.43886743886743
chr19	TRPM4	49211163	49211834	2855	672	6890	6483	4035	5811	4.248511904761905	0.6943727413526071
chr19	CPT1C	49713419	49713731	49794	313	87612	5093	37818	4780	159.08626198083067	7.911715481171548
chr19	AP2A1	49799967	49800150	1122	184	21862	6084	20740	5900	6.0978260869565215	3.5152542372881355
chr19	MYH14	50210362	50210770	102	409	495588	7572	495486	7163	0.24938875305623473	69.17297221834427
chr19	MYH14	50286481	50286694	102	214	495588	7572	495486	7358	0.4766355140186916	67.33976624082631
chr19	NR1H2	50376472	50376826	6536	355	264399	5355	257863	5000	18.411267605633803	51.5726
chr19	KLK3	50858028	50858315	0	288	44	2916	44	2628	0.0	0.0167427701674277
chr19	PRPF31	54129056	54129370	0	315	51	2686	51	2371	0.0	0.021509911429776464
chr19	CNOT3	54153714	54155680	0	1967	45	5828	45	3861	0.0	0.011655011655011656
chr19	CNOT3	54153714	54155681	0	1968	45	5828	45	3860	0.0	0.011658031088082901
chr19	TSEN34	54193174	54194536	0	1363	0	2983	0	1620	0.0	0.0
chr19	RPS9	54206552	54207647	0	1096	0	3672	0	2576	0.0	0.0
chr19	RPS9	54206275	54206724	0	450	0	3672	0	3222	0.0	0.0
chr19	KIR3DX1	54532691	54533078	51	388	18870	4481	18819	4093	0.13144329896907217	4.597849987784022
chr19	FCAR	54888006	54889067	0	1062	50	3333	50	2271	0.0	0.022016732716864818
chr19	NLRP2	54969998	54970295	190187	298	203387	6333	13200	6035	638.2114093959732	2.1872410936205466
chr19	EPS8L1	55083377	55083644	0	268	0	4935	0	4667	0.0	0.0
chr19	ZNF582-AS1	56398276	56399168	0	893	0	1662	0	769	0.0	0.0
chr19	ZNF667-AS1	56494162	56495439	0	1278	153	6804	153	5526	0.0	0.02768729641693811
chr19	ZNF667-AS1	56494162	56495437	0	1276	153	6804	153	5528	0.0	0.02767727930535456
chr19	AC006115.2	56789927	56791307	969	1381	51131	16166	50162	14785	0.7016654598117307	3.3927629354075077
chr19	ZNF264	57191500	57191946	0	447	918	12290	918	11843	0.0	0.07751414337583383
chr19	AURKC	57233459	57233608	0	150	51	1747	51	1597	0.0	0.031934877896055106
chr19	ZNF135	58066740	58069405	9406	2666	60582	6389	51176	3723	3.528132033008252	13.74590384098845
chr19	A1BG-AS1	58353713	58355183	70741	1471	125640	3102	54899	1631	48.09041468388851	33.659717964439
chr19	ZNF446	58480175	58481224	6805	1050	17271	4698	10466	3648	6.480952380952381	2.868969298245614
chr20	TMC2	2613193	2614020	0	828	560407	5196	560407	4368	0.0	128.29830586080587
chr20	SMOX	4182088	4182848	0	761	3213	2958	3213	2197	0.0	1.4624487938097406
chr20	PLCB1	8962195	8963010	0	816	3834	16902	3834	16086	0.0	0.23834390152928012
chr20	BTBD3	11917777	11918601	0	825	1852	5915	1852	5090	0.0	0.36385068762278977
chr20	KIZ	21244244	21246622	0	2379	2332	3152	2332	773	0.0	3.0168175937904267
chr20	LINC01727	21615382	21615888	0	507	102	7415	102	6908	0.0	0.014765489287782282
chr20	AL118508.1	23180410	23180793	0	384	0	3797	0	3413	0.0	0.0
chr20	AL118508.1	23186399	23187640	0	1242	0	3797	0	2555	0.0	0.0
chr20	AL118508.1	23180153	23180528	0	376	0	3797	0	3421	0.0	0.0
chr20	AL118508.1	23180167	23180528	0	362	0	3797	0	3435	0.0	0.0
chr20	BPIFB4	33082937	33083874	0	938	19942	2831	19942	1893	0.0	10.53460116217644
chr20	MAP1LC3A	34559735	34560345	0	611	0	1158	0	547	0.0	0.0
chr20	MYH7B	35001244	35001526	0	283	98	8201	98	7918	0.0	0.012376862844152564
chr20	MYH7B	35001947	35002437	0	491	98	8201	98	7710	0.0	0.01271076523994812
chr20	ROMO1	35699450	35699763	182	314	903	681	721	367	0.5796178343949044	1.9645776566757494
chr20	SNHG11	38450261	38450921	0	661	0	4261	0	3600	0.0	0.0
chr20	SNHG11	38450335	38450921	0	587	0	4261	0	3674	0.0	0.0
chr20	SNHG11	38447465	38448730	0	1266	0	4261	0	2995	0.0	0.0
chr20	SNHG11	38450335	38450920	0	586	0	4261	0	3675	0.0	0.0
chr20	SNHG11	38448661	38450447	0	1787	0	4261	0	2474	0.0	0.0
chr20	SNHG11	38447465	38450447	0	2983	0	4261	0	1278	0.0	0.0
chr20	LINC01370	40007902	40008459	0	558	153	4191	153	3633	0.0	0.042113955408753095
chr20	L3MBTL1	43530283	43530889	406589	607	1799354	12176	1392765	11569	669.833607907743	120.38767395626243
chr20	L3MBTL1	43536096	43536458	480535	363	1799354	12176	1318819	11813	1323.7878787878788	111.64132735122323
chr20	L3MBTL1	43540752	43541189	1530	438	1799354	12176	1797824	11738	3.493150684931507	153.16271937297665
chr20	L3MBTL1	43536100	43536458	473281	359	1799354	12176	1326073	11817	1318.33147632312	112.21739866294321
chr20	PIGT	45418771	45419395	0	625	204	11655	204	11030	0.0	0.018495013599274704
chr20	WFDC2	45479438	45480094	0	657	0	1137	0	480	0.0	0.0
chr20	SNX21	45840638	45842881	110904	2244	147635	3701	36731	1457	49.42245989304813	25.210020590253947
chr20	CTSA	45897716	45898109	2298	394	24659	7771	22361	7377	5.83248730964467	3.0311779856310155
chr20	CTSA	45896964	45898109	2604	1146	24659	7771	22055	6625	2.2722513089005236	3.329056603773585
chr20	LINC00494	48365872	48367162	102	1291	333	5148	231	3857	0.07900852052672347	0.05989110707803993
chr20	LINC00494	48366473	48367059	0	587	333	5148	333	4561	0.0	0.07301030475772857
chr20	LINC01273	50172922	50173592	0	671	102	1682	102	1011	0.0	0.10089020771513353
chr20	LINC01270	50311804	50312430	0	627	5256	5084	5256	4457	0.0	1.1792685663002018
chr20	STX16	58651271	58652087	0	817	0	5049	0	4232	0.0	0.0
chr20	STX16	58651282	58652138	0	857	0	5049	0	4192	0.0	0.0
chr20	NELFCD	58994641	58995133	0	493	51	5233	51	4740	0.0	0.010759493670886076
chr20	OSBPL2	62281057	62281879	2073	823	175526	10826	173453	10003	2.5188335358444713	17.340097970608817
chr20	ARFGAP1	63287563	63289788	0	2226	0	6173	0	3947	0.0	0.0
chr20	LIME1	63737820	63738060	0	241	0	2442	0	2201	0.0	0.0
chr20	TCEA2	64069764	64070635	0	872	0	3909	0	3037	0.0	0.0
chr20	TCEA2	64069764	64070414	0	651	0	3909	0	3258	0.0	0.0
chr20	SLC52A3	760079	761824	51	1746	255	5203	204	3457	0.029209621993127148	0.05901070292160833
chr20	SIRPB2	1479699	1480065	0	367	0	4491	0	4124	0.0	0.0
chr20	IDH3B	2658394	2658837	0	444	235	2575	235	2131	0.0	0.11027686532144533
chr20	LZTS3	3165496	3166360	47233	865	141682	4844	94449	3979	54.60462427745665	23.736868559939683
chr20	GFRA4	3660754	3661289	0	536	0	1566	0	1030	0.0	0.0
chr20	LINC00658	5433788	5434405	0	618	51	2892	51	2274	0.0	0.022427440633245383
chr20	LINC00658	5433788	5434401	0	614	51	2892	51	2278	0.0	0.022388059701492536
chr20	LINC00658	5431961	5432638	0	678	51	2892	51	2214	0.0	0.023035230352303523
chr20	LINC00658	5431988	5432638	0	651	51	2892	51	2241	0.0	0.022757697456492636
chr20	LINC00658	5433962	5434405	0	444	51	2892	51	2448	0.0	0.020833333333333332
chr20	LINC00658	5432010	5432638	0	629	51	2892	51	2263	0.0	0.022536456031816175
chr20	MKKS	10412529	10413931	341	1403	103423	7048	103082	5645	0.24305060584461868	18.260761736049602
chr20	AL050403.1	10889948	10890280	0	333	0	2937	0	2604	0.0	0.0
chr20	AL049646.1	18323643	18325234	1122	1592	5718	3242	4596	1650	0.7047738693467337	2.7854545454545456
chr20	RALGAPA2	20412026	20412148	0	123	16036	11690	16036	11567	0.0	1.3863577418518198
chr20	LINC01427	22282353	22282672	0	320	51	6326	51	6006	0.0	0.008491508491508492
chr20	LINC01747	22684744	22685296	0	553	0	4355	0	3802	0.0	0.0
chr20	FAM182B	25774017	25775312	0	1296	11846	6640	11846	5344	0.0	2.216691616766467
chr20	NECAB3	33657086	33657857	76783	772	79506	4125	2723	3353	99.45984455958549	0.8121085594989561
chr20	NECAB3	33659496	33659732	1734	237	79506	4125	77772	3888	7.3164556962025316	20.003086419753085
chr20	NECAB3	33659884	33660395	102	512	79506	4125	79404	3613	0.19921875	21.977304179352338
chr20	EIF6	35284175	35284492	4299	318	86150	1643	81851	1325	13.518867924528301	61.77433962264151
chr20	FER1L4	35563853	35564918	357	1066	18832	9174	18475	8108	0.3348968105065666	2.278613714849531
chr20	FER1L4	35559340	35560638	2295	1299	18832	9174	16537	7875	1.766743648960739	2.099936507936508
chr20	FER1L4	35560122	35560638	1812	517	18832	9174	17020	8657	3.504835589941973	1.9660390435485735
chr20	FER1L4	35559155	35559627	11646	473	18832	9174	7186	8701	24.621564482029598	0.8258820825192507
chr20	DSN1	36770872	36771193	246	322	79798	2481	79552	2159	0.7639751552795031	36.846688281611854
chr20	SAMHD1	36911217	36912552	0	1336	33	8463	33	7127	0.0	0.004630279219868107
chr20	SNHG17	38421005	38422984	0	1980	378	11084	378	9104	0.0	0.04152021089630931
chr20	SNHG17	38421005	38422241	0	1237	378	11084	378	9847	0.0	0.03838732608916421
chr20	SNHG17	38426418	38427444	0	1027	378	11084	378	10057	0.0	0.037585761161380134
chr20	SNHG17	38421005	38422368	0	1364	378	11084	378	9720	0.0	0.03888888888888889
chr20	SNHG17	38420591	38421098	0	508	378	11084	378	10576	0.0	0.035741301059001515
chr20	SNHG17	38425934	38426503	0	570	378	11084	378	10514	0.0	0.03595206391478029
chr20	PLCG1-AS1	41100657	41101289	0	633	0	7746	0	7113	0.0	0.0
chr20	CHD6	41496808	41498226	0	1419	51	14072	51	12653	0.0	0.004030664664506441
chr20	SLC35C2	46358386	46358763	51	378	51	7719	0	7341	0.1349206349206349	0.0
chr20	ELMO2	46368890	46370525	0	1636	326	4584	326	2948	0.0	0.11058344640434192
chr20	PREX1	48632276	48632639	0	364	19289	7548	19289	7184	0.0	2.6849944320712695
chr20	UBE2V1	50115484	50115954	0	471	306	4832	306	4361	0.0	0.07016739279981656
chr20	CTCFL	57525027	57525652	0	626	7077	8679	7077	8053	0.0	0.8788029305848752
chr20	PPP4R1L	58245782	58247506	0	1725	0	9090	0	7365	0.0	0.0
chr20	HAR1B	63095492	63096183	0	692	0	3139	0	2447	0.0	0.0
chr20	EEF1A2	63488013	63488425	0	413	0	3301	0	2888	0.0	0.0
chr20	ARFRP1	63698642	63700702	0	2061	0	2709	0	648	0.0	0.0
chr20	UCKL1	63940949	63941208	0	260	0	3201	0	2941	0.0	0.0
chr21	ANKRD30BP2	13042778	13045270	0	2493	0	4155	0	1662	0.0	0.0
chr21	ABCC13	14316200	14317635	0	1436	0	8015	0	6579	0.0	0.0
chr21	ABCC13	14288403	14291747	0	3345	0	8015	0	4670	0.0	0.0
chr21	LINC01684	24488112	24488912	0	801	0	9534	0	8733	0.0	0.0
chr21	GET1	39390697	39391476	0	780	0	8656	0	7876	0.0	0.0
chr21	GET1	39405913	39406731	0	819	0	8656	0	7837	0.0	0.0
chr21	DSCAM-AS1	40383082	40383584	1255	503	1255	1772	0	1269	2.4950298210735586	0.0
chr21	MX1	41421837	41422095	0	259	51	6893	51	6634	0.0	0.007687669580946638
chr21	UMODL1	42110879	42111710	0	832	51	7308	51	6476	0.0	0.007875231624459543
chr21	GATD3A	44144820	44145723	0	904	153	7961	153	7057	0.0	0.021680600821878986
chr21	AIRE	44292992	44293175	0	184	12121	3922	12121	3738	0.0	3.2426431246655967
chr21	TRPM2	44391271	44391625	0	355	23395	6626	23395	6271	0.0	3.730664965715197
chr21	ADARB1	45222017	45226560	459075	4544	1089577	8105	630502	3561	101.02882922535211	177.05756809884863
chr21	LINC00334	45258450	45259285	0	836	1508	2102	1508	1266	0.0	1.1911532385466035
chr21	PRMT2	46648457	46648619	0	163	10517	5492	10517	5329	0.0	1.973541002064177
chr21	PRMT2	46658744	46659430	0	687	10517	5492	10517	4805	0.0	2.1887617065556713
chr21	CBSL	6444868	6445661	0	794	0	3896	0	3102	0.0	0.0
chr21	CYP4F29P	13846758	13847123	0	366	0	1724	0	1358	0.0	0.0
chr21	AF127936.1	14753323	14753852	0	530	51	4958	51	4428	0.0	0.011517615176151762
chr21	LINC00320	20742586	20743833	0	1248	215	16661	215	15413	0.0	0.013949263608642055
chr21	LINC00320	20742594	20743833	0	1240	215	16661	215	15421	0.0	0.01394202710589456
chr21	LINC00320	20742598	20743833	0	1236	215	16661	215	15425	0.0	0.01393841166936791
chr21	LINC01687	22062008	22062648	0	641	0	3693	0	3052	0.0	0.0
chr21	N6AMT1	28872190	28876491	102	4302	102	4871	0	569	0.023709902370990237	0.0
chr21	CFAP298-TCP10L	32573283	32574676	0	1394	14288	19230	14288	17836	0.0	0.8010764745458623
chr21	CFAP298-TCP10L	32573283	32574124	0	842	14288	19230	14288	18388	0.0	0.777028496845769
chr21	CFAP298-TCP10L	32574575	32576923	3162	2349	14288	19230	11126	16881	1.3461047254150702	0.6590841774776376
chr21	SETD4	36034540	36036251	0	1712	0	6423	0	4711	0.0	0.0
chr21	AP001042.1	38904229	38905423	0	1195	63652	10133	63652	8938	0.0	7.121503692101141
chr21	AP001042.1	38923425	38923693	0	269	63652	10133	63652	9864	0.0	6.452960259529602
chr21	PRDM15	41800183	41801722	51	1540	51	11221	0	9681	0.033116883116883114	0.0
chr21	ZBTB21	41986830	41994108	51	7279	51	8068	0	789	0.007006456930897101	0.0
chr21	TFF3	42313484	42313631	0	148	0	1171	0	1023	0.0	0.0
chr21	CBS	43053190	43053983	0	794	1122	6280	1122	5486	0.0	0.2045205978855268
chr21	ICOSLG	44226833	44230089	0	3257	51	9348	51	6091	0.0	0.008373009358069283
chr21	LINC01547	44933314	44935096	1326	1783	4743	3203	3417	1420	0.7436904094223219	2.406338028169014
chr21	LSS	46188445	46191235	1360067	2791	1517213	7259	157146	4468	487.3045503403798	35.171441360787824
chr21	C21ORF58	46301129	46302154	0	1026	2090	4107	2090	3081	0.0	0.6783511846802986
chr22	ADA2	17189941	17191810	0	1870	0	8720	0	6850	0.0	0.0
chr22	PI4KAP1	18536649	18537412	0	764	16489	3930	16489	3166	0.0	5.208149084017688
chr22	PI4KAP1	18548010	18548469	0	460	16489	3930	16489	3470	0.0	4.751873198847262
chr22	PRODH	18936014	18936553	0	540	232	7184	232	6644	0.0	0.034918723660445516
chr22	GNB1L	19854442	19854816	5961	375	6073	1660	112	1285	15.896	0.08715953307392996
chr22	TXNRD2	19875521	19877234	2346	1714	10718	6767	8372	5053	1.368728121353559	1.6568375222640015
chr22	PI4KAP2	21475210	21476764	4817	1555	3632	6796	-1185	5241	3.097749196141479	-0.22610188895248998
chr22	PI4KAP2	21477996	21478694	0	699	3632	6796	3632	6097	0.0	0.5957028046580285
chr22	PPM1F	21924875	21925662	204	788	4947	9572	4743	8784	0.25888324873096447	0.5399590163934426
chr22	TOP3B	21957026	21958693	714	1668	354925	6344	354211	4676	0.42805755395683454	75.75085543199316
chr22	TOP3B	21962428	21962893	24	466	354925	6344	354901	5878	0.05150214592274678	60.37784960871045
chr22	TOP3B	21957030	21958693	714	1664	354925	6344	354211	4680	0.42908653846153844	75.68611111111112
chr22	TOP3B	21959131	21959736	0	606	354925	6344	354925	5738	0.0	61.85517601951899
chr22	PRAME	22556811	22557580	255	770	612	3814	357	3044	0.33116883116883117	0.11727989487516426
chr22	DERL3	23834502	23837154	0	2653	51	2422	51	-231	0.0	-0.22077922077922077
chr22	DERL3	23836733	23837154	0	422	51	2422	51	2000	0.0	0.0255
chr22	AL022329.1	25563100	25563481	0	382	0	1300	0	918	0.0	0.0
chr22	HPS4	26465454	26466262	0	809	0	7752	0	6943	0.0	0.0
chr22	XBP1	28796046	28796192	0	147	0	3034	0	2887	0.0	0.0
chr22	RASL10A	29312932	29313987	4590	1056	6936	2185	2346	1129	4.346590909090909	2.077945084145261
chr22	THOC5	29544459	29544603	15	145	5726	7903	5711	7758	0.10344827586206896	0.7361433359113173
chr22	RNF215	30379481	30379780	0	300	36315	5055	36315	4755	0.0	7.6372239747634065
chr22	DUSP18	30661444	30664080	1173	2637	495	2739	-678	102	0.4448236632536974	-6.647058823529412
chr22	SELENOM	31105929	31105965	0	37	153	1444	153	1407	0.0	0.10874200426439233
chr22	LARGE1	33162225	33166832	0	4608	0	14082	0	9474	0.0	0.0
chr22	APOL3	36145472	36145599	306	128	118729	5914	118423	5786	2.390625	20.46716211545109
chr22	APOL3	36149045	36149371	3519	327	118729	5914	115210	5587	10.761467889908257	20.62108466081976
chr22	APOL4	36201699	36202055	1122	357	1173	4268	51	3911	3.142857142857143	0.013040143185885963
chr22	IFT27	36775673	36776125	2902	453	8216	3881	5314	3428	6.406181015452539	1.5501750291715286
chr22	ANKRD54	37832957	37833206	0	250	0	4400	0	4150	0.0	0.0
chr22	BAIAP2L2	38086241	38086449	0	209	14612	2163	14612	1954	0.0	7.4779938587512795
chr22	CYP2D7	42141151	42141396	0	246	176	3408	176	3162	0.0	0.055660974067046176
chr22	CYP2D7	42144283	42144577	0	295	176	3408	176	3113	0.0	0.05653710247349823
chr22	LINC00899	46042573	46043699	153	1127	1683	3069	1530	1942	0.13575865128660158	0.787847579814624
chr22	CELSR1	46361173	46364251	1326	3079	17360	15740	16034	12661	0.43065930496914584	1.2664086565042256
chr22	Z84468.1	48546512	48547012	24	501	75	2253	51	1752	0.04790419161676647	0.02910958904109589
chr22	HDAC10	50245674	50246092	0	419	5812	4150	5812	3731	0.0	1.5577593138568748
chr22	PLXNB2	50277852	50278013	15242	162	348220	7083	332978	6921	94.08641975308642	48.11125559890189
chr22	PLXNB2	50278116	50278271	13827	156	348220	7083	334393	6927	88.63461538461539	48.27385592608633
chr22	PLXNB2	50278434	50278519	6293	86	348220	7083	341927	6997	73.17441860465117	48.867657567528944
chr22	PLXNB2	50278595	50278696	12416	102	348220	7083	335804	6981	121.72549019607843	48.1025641025641
chr22	PLXNB2	50278854	50279011	17699	158	348220	7083	330521	6925	112.01898734177215	47.7286642599278
chr22	ARSA	50627555	50628170	2288	616	12405	3989	10117	3373	3.7142857142857144	2.999407056033205
chr22	DUXAP8	15787171	15788699	0	1529	0	9700	0	8171	0.0	0.0
chr22	TPTEP1	16614076	16615111	0	1036	0	5184	0	4148	0.0	0.0
chr22	DGCR5	18987756	18988195	0	440	448	8044	448	7604	0.0	0.058916359810625984
chr22	SEPTIN5	19722236	19723319	600	1084	1020	4211	420	3127	0.5535055350553506	0.1343140390150304
chr22	COMT	19961696	19962815	6054	1120	75391	6477	69337	5357	5.4053571428571425	12.943251820048534
chr22	RANBP1	20126302	20127181	60132	880	73207	4188	13075	3308	68.33181818181818	3.9525392986698913
chr22	MED15	20554935	20555148	0	214	408	8263	408	8049	0.0	0.0506895266492732
chr22	TMEM191A	20703632	20704040	0	409	0	2582	0	2173	0.0	0.0
chr22	CRKL	20949710	20953747	153	4038	6292	5345	6139	1307	0.03789004457652303	4.697016067329763
chr22	P2RX6	21026419	21028008	0	1590	0	4616	0	3026	0.0	0.0
chr22	GGTLC2	22646982	22647290	133	309	2882	1402	2749	1093	0.43042071197411	2.515096065873742
chr22	RGL4	23698554	23698978	0	425	90	4727	90	4302	0.0	0.02092050209205021
chr22	SPECC1L	24321287	24322918	13838	1632	26541	7480	12703	5848	8.479166666666666	2.1721956224350207
chr22	GGT1	24610249	24610531	0	283	511	4343	511	4060	0.0	0.12586206896551724
chr22	GGT1	24628080	24628388	0	309	511	4343	511	4034	0.0	0.12667327714427368
chr22	LINC02554	27316803	27317456	0	654	408	6165	408	5511	0.0	0.07403375068045727
chr22	TTC28-AS1	27997410	27998838	51	1429	510	11188	459	9759	0.03568929321203639	0.04703350753150937
chr22	TTC28-AS1	27999429	28001658	153	2230	510	11188	357	8958	0.06860986547085202	0.039852645679839246
chr22	TTC28-AS1	27997410	27998152	51	743	510	11188	459	10445	0.06864064602960969	0.04394447103877453
chr22	TTC28-AS1	27997985	27998838	0	854	510	11188	510	10334	0.0	0.04935165473195278
chr22	GAS2L1	29307057	29308738	0	1682	918	4005	918	2323	0.0	0.3951786482996126
chr22	NF2	29683019	29683915	98050	897	212315	5395	114265	4498	109.3088071348941	25.4035126722988
chr22	SMTN	31080449	31080754	74	306	7935	7949	7861	7643	0.24183006535947713	1.0285228313489467
chr22	INPP5J	31124844	31126010	0	1167	688	4440	688	3273	0.0	0.2102047051634586
chr22	RNF185	31204488	31207013	1011	2526	1047	3456	36	930	0.4002375296912114	0.03870967741935484
chr22	TOM1	35323495	35323630	0	136	0	5019	0	4883	0.0	0.0
chr22	NCF4	36875652	36876094	306	443	51301	2252	50995	1809	0.690744920993228	28.189607517965726
chr22	ATF4	39521353	39521671	32	319	32	2289	0	1970	0.10031347962382445	0.0
chr22	MCHR1	40680948	40682083	3279	1136	3480	2441	201	1305	2.886443661971831	0.15402298850574714
chr22	C22ORF46	41693462	41698136	37259	4675	37467	5306	208	631	7.969839572192513	0.329635499207607
chr22	SEPTIN3	41994620	41998221	257358	3602	133774	4980	-123584	1378	71.44863964464187	-89.68359941944847
chr22	NDUFA6-DT	42124046	42124562	0	517	26586	5096	26586	4579	0.0	5.8060711945839705
chr22	NDUFA6-DT	42136198	42136714	0	517	26586	5096	26586	4579	0.0	5.8060711945839705
chr22	SERHL	42510630	42511927	510	1298	740	2853	230	1555	0.3929121725731895	0.14790996784565916
chr22	SERHL	42502350	42502768	0	419	740	2853	740	2434	0.0	0.3040262941659819
chr22	PRR5	44702217	44702608	0	392	0	5239	0	4847	0.0	0.0
chr22	NCAPH2	50523016	50523472	0	457	19	4166	19	3709	0.0	0.005122674575357239
chrX	PLCXD1	299096	303353	79805	4258	91280	6077	11475	1819	18.742367308595586	6.308411214953271
chrX	CLCN4	10208044	10208590	0	547	561	7579	561	7032	0.0	0.07977815699658702
chrX	MSL3	11759633	11759875	0	243	3468	7299	3468	7056	0.0	0.4914965986394558
chrX	TMSB4X	12975109	12976361	0	1253	51	1418	51	165	0.0	0.3090909090909091
chrX	LINC01203	13335029	13335545	0	517	2	6494	2	5977	0.0	0.00033461602810774636
chrX	DDX3X	41333347	41334297	0	951	2617	11657	2617	10706	0.0	0.2444423687651784
chrX	DDX3X	41347311	41349886	1428	2576	2617	11657	1189	9081	0.5543478260869565	0.13093271666116066
chrX	DDX3X	41337690	41339083	51	1394	2617	11657	2566	10263	0.036585365853658534	0.2500243593491182
chrX	CDK16	47223551	47223759	0	209	0	5750	0	5541	0.0	0.0
chrX	ARAF	47571322	47571908	0	587	51	3551	51	2964	0.0	0.01720647773279352
chrX	WDR13	48597491	48598037	0	547	918	7435	918	6888	0.0	0.1332752613240418
chrX	HDAC6	48822911	48823588	18717	678	157384	7947	138667	7269	27.606194690265486	19.07648920071537
chrX	HDAC6	48805630	48806464	2330	835	157384	7947	155054	7112	2.7904191616766467	21.80174353205849
chrX	HDAC6	48814674	48814893	1180	220	157384	7947	156204	7727	5.363636363636363	20.21534877701566
chrX	MAGIX	49164706	49165090	0	385	0	4936	0	4551	0.0	0.0
chrX	MAGED4	52191430	52191861	0	432	102	4286	102	3854	0.0	0.026466009340944473
chrX	MAGED4	52191430	52191873	0	444	102	4286	102	3842	0.0	0.02654867256637168
chrX	XAGE5	52812203	52812638	0	436	0	1120	0	684	0.0	0.0
chrX	MAGED2	54809721	54810213	0	493	0	2914	0	2421	0.0	0.0
chrX	MAGED2	54810820	54811129	0	310	0	2914	0	2604	0.0	0.0
chrX	MAGED2	54815247	54816007	0	761	0	2914	0	2153	0.0	0.0
chrX	TRO	54928602	54931031	0	2430	0	4939	0	2509	0.0	0.0
chrX	TRO	54928602	54928710	0	109	0	4939	0	4830	0.0	0.0
chrX	AR	67723685	67730619	4990	6935	7086	12830	2096	5895	0.7195385724585436	0.35555555555555557
chrX	MED12	71137725	71137943	0	219	144	7470	144	7251	0.0	0.01985932974762102
chrX	NLGN3	71167010	71167800	0	791	0	4014	0	3223	0.0	0.0
chrX	NONO	71297376	71298508	0	1133	0	9256	0	8123	0.0	0.0
chrX	NONO	71297835	71298508	0	674	0	9256	0	8582	0.0	0.0
chrX	NONO	71297376	71297938	0	563	0	9256	0	8693	0.0	0.0
chrX	DMRTC1B	72846884	72847277	204	394	204	1921	0	1527	0.5177664974619289	0.0
chrX	JPX	73998953	74000496	0	1544	255	19827	255	18283	0.0	0.013947382814636547
chrX	JPX	73998767	74000496	0	1730	255	19827	255	18097	0.0	0.014090733270707851
chrX	JPX	73944338	73944662	0	325	255	19827	255	19502	0.0	0.013075581991590606
chrX	JPX	73998953	73999669	0	717	255	19827	255	19110	0.0	0.013343799058084773
chrX	JPX	73944340	73944662	0	323	255	19827	255	19504	0.0	0.013074241181296145
chrX	JPX	73998953	73999950	0	998	255	19827	255	18829	0.0	0.013542939083328908
chrX	JPX	73998953	74000201	0	1249	255	19827	255	18578	0.0	0.013725912369469264
chrX	JPX	73944341	73944662	0	322	255	19827	255	19505	0.0	0.013073570879261727
chrX	ZNF711	85246929	85247651	0	723	5189	5056	5189	4333	0.0	1.1975536579736903
chrX	DACH2	86827765	86832602	0	4838	40	2770	40	-2068	0.0	-0.019342359767891684
chrX	ARMCX4	101531643	101533459	0	1817	87	13064	87	11247	0.0	0.007735396105628167
chrX	NXF4	102563206	102563522	0	317	34	2849	34	2532	0.0	0.013428120063191154
chrX	TCEAL4	103585858	103586291	0	434	0	2405	0	1971	0.0	0.0
chrX	H2BW2	104041087	104042454	0	1368	0	1885	0	517	0.0	0.0
chrX	ZCCHC18	104113433	104115842	0	2410	0	2981	0	571	0.0	0.0
chrX	PRPS1	107649939	107651026	0	1088	102	3405	102	2317	0.0	0.0440224428139836
chrX	RBMX2	130411347	130411525	0	179	0	2642	0	2463	0.0	0.0
chrX	FAM122C	134807190	134807708	0	519	0	7535	0	7016	0.0	0.0
chrX	INTS6L	135581527	135582510	119800	984	101548	5582	-18252	4598	121.7479674796748	-3.969551979121357
chrX	SLC9A6	135985434	135985827	0	394	41289	9929	41289	9535	0.0	4.330256948085999
chrX	LINC00892	136640773	136642426	0	1654	0	1924	0	270	0.0	0.0
chrX	LINC00632	140711620	140716289	0	4670	1417	14900	1417	10230	0.0	0.13851417399804497
chrX	LINC00632	140772077	140775905	204	3829	1417	14900	1213	11071	0.05327761817706973	0.10956553156896395
chrX	MAGEC3	141896881	141897832	102	952	153	2774	51	1822	0.10714285714285714	0.027991218441273325
chrX	LINC00894	149945347	149948175	36670	2829	21846	6782	-14824	3953	12.962177447861436	-3.7500632431065015
chrX	ZNF275	153346818	153352926	13254	6109	27442	7519	14188	1410	2.169585856932395	10.062411347517731
chrX	SRPK3	153783973	153784213	0	241	66582	4765	66582	4524	0.0	14.717506631299734
chrX	SRPK3	153781115	153781346	714	232	66582	4765	65868	4533	3.0775862068965516	14.530774321641298
chrX	RPL10	154398376	154398542	0	167	142	4328	142	4161	0.0	0.034126411920211486
chrX	TAZ	154419704	154420094	0	391	16	3645	16	3254	0.0	0.004917025199754148
chrX	TAZ	154419542	154420094	0	553	16	3645	16	3092	0.0	0.00517464424320828
chrX	TAZ	154420902	154421706	0	805	16	3645	16	2840	0.0	0.005633802816901409
chrX	TAZ	154420031	154420264	0	234	16	3645	16	3411	0.0	0.004690706537672237
chrX	TAZ	154419542	154419746	0	205	16	3645	16	3440	0.0	0.004651162790697674
chrX	ATP6AP1	154429047	154431657	357	2611	459	5136	102	2525	0.13672922252010725	0.0403960396039604
chrX	DKC1	154774601	154775273	50707	673	45295	3861	-5412	3188	75.3447251114413	-1.697616060225847
chrX	PIGA	15331215	15331992	52	778	39	5184	-13	4406	0.06683804627249357	-0.0029505220154334997
chrX	RAI2	17800048	17802034	306	1987	306	2626	0	639	0.1540010065425264	0.0
chrX	TAB3	30842965	30846644	34104	3680	29195	9842	-4909	6162	9.267391304347827	-0.796656929568322
chrX	RPGR	38287093	38288041	0	949	0	8385	0	7436	0.0	0.0
chrX	CXORF38	40626920	40630773	1377	3854	1377	5893	0	2039	0.3572911261027504	0.0
chrX	SLC38A5	48458538	48459034	244984	497	258940	3938	13956	3441	492.9255533199195	4.055797733217088
chrX	TIMM17B	48893899	48894225	1550	327	314668	2570	313118	2243	4.740061162079511	139.59786000891663
chrX	WDR45	49100581	49101144	1836	564	1938	3931	102	3367	3.25531914893617	0.030294030294030293
chrX	FOXP3	49256750	49257012	0	263	0	3100	0	2837	0.0	0.0
chrX	FOXP3	49251333	49251765	0	433	0	3100	0	2667	0.0	0.0
chrX	MAGED4B	52062221	52062664	102	444	255	4000	153	3556	0.22972972972972974	0.04302587176602925
chrX	ALAS2	55020319	55020504	0	186	5710	2059	5710	1873	0.0	3.0485851575013347
chrX	SPIN3	56978291	56978660	0	370	4998	13521	4998	13151	0.0	0.3800471447038248
chrX	SPIN3	56993786	56994949	0	1164	4998	13521	4998	12357	0.0	0.40446710366593835
chrX	SPIN2B	57119681	57120631	1223	951	1388	1178	165	227	1.2860147213459516	0.7268722466960352
chrX	LINC01278	63238992	63239830	51	839	1956	13947	1905	13108	0.060786650774731825	0.1453310955141898
chrX	ARHGEF9	63635002	63638209	0	3208	11987	12238	11987	9030	0.0	1.3274640088593577
chrX	ZC4H2	64919041	64919204	0	164	4233	3190	4233	3026	0.0	1.398876404494382
chrX	LAS1L	65520701	65523707	0	3007	188	7818	188	4811	0.0	0.0390771149449179
chrX	LAS1L	65520701	65522285	0	1585	188	7818	188	6233	0.0	0.030162040750842292
chrX	LAS1L	65522430	65523707	0	1278	188	7818	188	6540	0.0	0.02874617737003058
chrX	AL590764.2	71105999	71106426	0	428	0	2383	0	1955	0.0	0.0
chrX	HDAC8	72329567	72330876	102	1310	89	18208	-13	16898	0.07786259541984733	-0.0007693218132323352
chrX	HDAC8	72567581	72568030	0	450	89	18208	89	17758	0.0	0.005011825656042347
chrX	DMRTC1	72873549	72873942	0	394	0	1860	0	1466	0.0	0.0
chrX	NEXMIF	74732855	74739498	255	6644	11971	12341	11716	5697	0.038380493678506926	2.0565209759522554
chrX	NEXMIF	74732855	74744477	11971	11623	11971	12341	0	718	1.029940634947948	0.0
chrX	ATRX	77681519	77684593	0	3075	255	17249	255	14174	0.0	0.01799068717369832
chrX	TRMT2B	101051250	101051733	0	484	8	4036	8	3552	0.0	0.0022522522522522522
chrX	TIMM8A	101345660	101348401	0	2742	0	3083	0	341	0.0	0.0
chrX	BTK	101353869	101353988	0	120	0	4323	0	4203	0.0	0.0
chrX	GLA	101398369	101398946	0	578	0	2857	0	2279	0.0	0.0
chrX	AC235565.2	102369585	102370152	0	568	1094	4954	1094	4386	0.0	0.24943000455996353
chrX	TMSB15B-AS1	103918408	103919080	0	673	51	2837	51	2164	0.0	0.02356746765249538
chrX	RBM41	107088435	107088839	0	405	765	4714	765	4309	0.0	0.1775353910420051
chrX	PSMD10	108087952	108088099	0	148	0	2395	0	2247	0.0	0.0
chrX	COL4A6	108164876	108165038	0	163	0	9330	0	9167	0.0	0.0
chrX	UPF3B	119837756	119837932	0	177	51	3097	51	2920	0.0	0.017465753424657535
chrX	ELF4	130069299	130069677	0	379	0	4268	0	3889	0.0	0.0
chrX	ELF4	130081255	130081539	0	285	0	4268	0	3983	0.0	0.0
chrX	ENOX2	130665642	130665749	0	108	30	4295	30	4187	0.0	0.007165034631000717
chrX	CT55	135156539	135157503	51	965	51	1733	0	768	0.05284974093264249	0.0
chrX	RBMX	136872267	136875168	0	2902	0	4833	0	1931	0.0	0.0
chrX	FMR1-AS1	147909430	147911817	0	2388	0	2104	0	-284	0.0	-0.0
chrX	AC244197.3	149532881	149534374	0	1494	102	9717	102	8223	0.0	0.012404232032105071
chrX	TMEM185A	149596556	149598255	0	1700	0	4993	0	3293	0.0	0.0
chrX	MAGEA10	152135760	152136080	1351	321	6115	2903	4764	2582	4.2087227414330215	1.8450813323005422
chrX	CSAG1	152727483	152728224	31273	742	31273	1096	0	354	42.14690026954178	0.0
chrX	PNMA5	152991901	152992217	1791	317	145825	3432	144034	3115	5.649842271293376	46.23884430176565
chrX	PNCK	153671879	153672200	0	322	3082117	4218	3082117	3896	0.0	791.0977926078028
chrX	IRAK1	154019430	154019812	969	383	86164	3637	85195	3254	2.5300261096605743	26.18162261831592
chrX	FLNA	154365744	154366224	0	481	83220	9862	83220	9381	0.0	8.871122481611769
chrX	SLC10A3	154487305	154489082	56114	1778	59940	2016	3826	238	31.560179977502813	16.07563025210084
chrX	FAM3A	154515759	154516242	0	484	5044	4886	5044	4402	0.0	1.145842798727851
chrX	CTAG1B	154617608	154618273	0	666	0	1000	0	334	0.0	0.0
chrY	PLCXD1	299096	303353	713	4258	2324	6077	1611	1819	0.16744950681070925	0.88565145684442
chrY	TSPY2	6246222	6246754	0	533	0	1378	0	845	0.0	0.0
chrY	TSPY4	9337509	9338013	0	505	0	1370	0	865	0.0	0.0
chrY	TSPY8	9357842	9358328	0	487	0	1232	0	745	0.0	0.0
chrY	TSPY3	9398466	9398952	0	487	0	1332	0	845	0.0	0.0
chrY	TXLNGY	19588369	19589612	0	1244	51	8366	51	7122	0.0	0.007160909856781803
chrY	TTTY14	18819354	18819786	0	433	255	17451	255	17018	0.0	0.014984134445880832
chrY	TTTY14	19041369	19043346	0	1978	255	17451	255	15473	0.0	0.016480320558392037
chrY	TTTY14	19043162	19044695	0	1534	255	17451	255	15917	0.0	0.016020606898284852
